split,index,nodes,total_values_for_nodes,edges,total_values_for_edges,total_values_for_graph
train,0,186,190464,2658,2658,193122
train,1,183,187392,2379,2379,189771
train,2,190,194560,2590,2590,197150
train,3,146,149504,2010,2010,151514
train,4,90,92160,986,986,93146
train,5,152,155648,2256,2256,157904
train,6,74,75776,882,882,76658
train,7,210,215040,3378,3378,218418
train,8,114,116736,1454,1454,118190
train,9,142,145408,1764,1764,147172
train,10,132,135168,1938,1938,137106
train,11,77,78848,891,891,79739
train,12,172,176128,2004,2004,178132
train,13,141,144384,2035,2035,146419
train,14,158,161792,2050,2050,163842
train,15,100,102400,1272,1272,103672
train,16,172,176128,2516,2516,178644
train,17,131,134144,1727,1727,135871
train,18,178,182272,2374,2374,184646
train,19,70,71680,788,788,72468
train,20,118,120832,1518,1518,122350
train,21,93,95232,1165,1165,96397
train,22,120,122880,1594,1594,124474
train,23,106,108544,1562,1562,110106
train,24,189,193536,2795,2795,196331
train,25,156,159744,2282,2282,162026
train,26,137,140288,1885,1885,142173
train,27,192,196608,2796,2796,199404
train,28,121,123904,1541,1541,125445
train,29,84,86016,1092,1092,87108
train,30,94,96256,1204,1204,97460
train,31,149,152576,2087,2087,154663
train,32,212,217088,2932,2932,220020
train,33,245,250880,3713,3713,254593
train,34,194,198656,2634,2634,201290
train,35,146,149504,1974,1974,151478
train,36,141,144384,2059,2059,146443
train,37,147,150528,1943,1943,152471
train,38,98,100352,1276,1276,101628
train,39,182,186368,2652,2652,189020
train,40,185,189440,2573,2573,192013
train,41,156,159744,2298,2298,162042
train,42,96,98304,1236,1236,99540
train,43,141,144384,1933,1933,146317
train,44,118,120832,1420,1420,122252
train,45,151,154624,2007,2007,156631
train,46,170,174080,2398,2398,176478
train,47,188,192512,2394,2394,194906
train,48,121,123904,1717,1717,125621
train,49,127,130048,1779,1779,131827
train,50,174,178176,2744,2744,180920
train,51,118,120832,1586,1586,122418
train,52,144,147456,1988,1988,149444
train,53,190,194560,2606,2606,197166
train,54,64,65536,726,726,66262
train,55,107,109568,1293,1293,110861
train,56,104,106496,1304,1304,107800
train,57,183,187392,2501,2501,189893
train,58,227,232448,3123,3123,235571
train,59,202,206848,3202,3202,210050
train,60,123,125952,1553,1553,127505
train,61,118,120832,1494,1494,122326
train,62,206,210944,2660,2660,213604
train,63,188,192512,2588,2588,195100
train,64,163,166912,2255,2255,169167
train,65,140,143360,1670,1670,145030
train,66,64,65536,730,730,66266
train,67,72,73728,724,724,74452
train,68,137,140288,1801,1801,142089
train,69,202,206848,2660,2660,209508
train,70,142,145408,1784,1784,147192
train,71,121,123904,1463,1463,125367
train,72,67,68608,711,711,69319
train,73,145,148480,1919,1919,150399
train,74,105,107520,1235,1235,108755
train,75,60,61440,658,658,62098
train,76,193,197632,2515,2515,200147
train,77,152,155648,1948,1948,157596
train,78,204,208896,2832,2832,211728
train,79,131,134144,1767,1767,135911
train,80,214,219136,2958,2958,222094
train,81,167,171008,2137,2137,173145
train,82,134,137216,1814,1814,139030
train,83,209,214016,2723,2723,216739
train,84,192,196608,2606,2606,199214
train,85,75,76800,971,971,77771
train,86,172,176128,2662,2662,178790
train,87,118,120832,1618,1618,122450
train,88,174,178176,2214,2214,180390
train,89,213,218112,2791,2791,220903
train,90,172,176128,2384,2384,178512
train,91,157,160768,2513,2513,163281
train,92,247,252928,3753,3753,256681
train,93,126,129024,1504,1504,130528
train,94,99,101376,1355,1355,102731
train,95,206,210944,2610,2610,213554
train,96,185,189440,2681,2681,192121
train,97,101,103424,1161,1161,104585
train,98,179,183296,2431,2431,185727
train,99,88,90112,1124,1124,91236
train,100,172,176128,2408,2408,178536
train,101,128,131072,1724,1724,132796
train,102,139,142336,1757,1757,144093
train,103,136,139264,1920,1920,141184
train,104,213,218112,2781,2781,220893
train,105,180,184320,2574,2574,186894
train,106,94,96256,1002,1002,97258
train,107,125,128000,1501,1501,129501
train,108,130,133120,1638,1638,134758
train,109,120,122880,1628,1628,124508
train,110,119,121856,1723,1723,123579
train,111,104,106496,1284,1284,107780
train,112,192,196608,2270,2270,198878
train,113,187,191488,2579,2579,194067
train,114,102,104448,1356,1356,105804
train,115,232,237568,3256,3256,240824
train,116,194,198656,2794,2794,201450
train,117,176,180224,2518,2518,182742
train,118,98,100352,1150,1150,101502
train,119,179,183296,2659,2659,185955
train,120,186,190464,3050,3050,193514
train,121,126,129024,1824,1824,130848
train,122,114,116736,1492,1492,118228
train,123,154,157696,2264,2264,159960
train,124,159,162816,2063,2063,164879
train,125,101,103424,1241,1241,104665
train,126,77,78848,899,899,79747
train,127,110,112640,1434,1434,114074
train,128,132,135168,1714,1714,136882
train,129,204,208896,3030,3030,211926
train,130,121,123904,1599,1599,125503
train,131,188,192512,2660,2660,195172
train,132,128,131072,1508,1508,132580
train,133,142,145408,1784,1784,147192
train,134,92,94208,1092,1092,95300
train,135,88,90112,982,982,91094
train,136,106,108544,1306,1306,109850
train,137,169,173056,2243,2243,175299
train,138,214,219136,3588,3588,222724
train,139,190,194560,2694,2694,197254
train,140,166,169984,2220,2220,172204
train,141,115,117760,1447,1447,119207
train,142,120,122880,1590,1590,124470
train,143,124,126976,1712,1712,128688
train,144,165,168960,2251,2251,171211
train,145,146,149504,1994,1994,151498
train,146,66,67584,754,754,68338
train,147,106,108544,1206,1206,109750
train,148,152,155648,2074,2074,157722
train,149,115,117760,1543,1543,119303
train,150,155,158720,2103,2103,160823
train,151,69,70656,717,717,71373
train,152,136,139264,1370,1370,140634
train,153,185,189440,2463,2463,191903
train,154,144,147456,1958,1958,149414
train,155,135,138240,1707,1707,139947
train,156,153,156672,2091,2091,158763
train,157,221,226304,2991,2991,229295
train,158,154,157696,2388,2388,160084
train,159,147,150528,2007,2007,152535
train,160,80,81920,854,854,82774
train,161,108,110592,1274,1274,111866
train,162,110,112640,1398,1398,114038
train,163,91,93184,1107,1107,94291
train,164,218,223232,3038,3038,226270
train,165,190,194560,2570,2570,197130
train,166,193,197632,2547,2547,200179
train,167,95,97280,1097,1097,98377
train,168,79,80896,869,869,81765
train,169,55,56320,601,601,56921
train,170,89,91136,1065,1065,92201
train,171,180,184320,2900,2900,187220
train,172,100,102400,1276,1276,103676
train,173,187,191488,2781,2781,194269
train,174,158,161792,2206,2206,163998
train,175,158,161792,2172,2172,163964
train,176,142,145408,1740,1740,147148
train,177,177,181248,2475,2475,183723
train,178,190,194560,2622,2622,197182
train,179,142,145408,2186,2186,147594
train,180,174,178176,2442,2442,180618
train,181,58,59392,628,628,60020
train,182,76,77824,936,936,78760
train,183,147,150528,2369,2369,152897
train,184,134,137216,1764,1764,138980
train,185,175,179200,2547,2547,181747
train,186,125,128000,1607,1607,129607
train,187,159,162816,2079,2079,164895
train,188,152,155648,2094,2094,157742
train,189,137,140288,2017,2017,142305
train,190,224,229376,3136,3136,232512
train,191,157,160768,2415,2415,163183
train,192,141,144384,1849,1849,146233
train,193,212,217088,2580,2580,219668
train,194,110,112640,1474,1474,114114
train,195,137,140288,1879,1879,142167
train,196,171,175104,2529,2529,177633
train,197,65,66560,701,701,67261
train,198,127,130048,1661,1661,131709
train,199,138,141312,2032,2032,143344
train,200,161,164864,2479,2479,167343
train,201,166,169984,2278,2278,172262
train,202,192,196608,2852,2852,199460
train,203,173,177152,2583,2583,179735
train,204,135,138240,1703,1703,139943
train,205,160,163840,1968,1968,165808
train,206,143,146432,1915,1915,148347
train,207,264,270336,3856,3856,274192
train,208,154,157696,1996,1996,159692
train,209,168,172032,2236,2236,174268
train,210,160,163840,2222,2222,166062
train,211,155,158720,2315,2315,161035
train,212,103,105472,1187,1187,106659
train,213,165,168960,2437,2437,171397
train,214,113,115712,1495,1495,117207
train,215,187,191488,2683,2683,194171
train,216,147,150528,1865,1865,152393
train,217,130,133120,1644,1644,134764
train,218,117,119808,1457,1457,121265
train,219,59,60416,667,667,61083
train,220,144,147456,1832,1832,149288
train,221,144,147456,2162,2162,149618
train,222,149,152576,1917,1917,154493
train,223,62,63488,712,712,64200
train,224,135,138240,1743,1743,139983
train,225,159,162816,2417,2417,165233
train,226,127,130048,1727,1727,131775
train,227,162,165888,2244,2244,168132
train,228,144,147456,2088,2088,149544
train,229,92,94208,1200,1200,95408
train,230,84,86016,934,934,86950
train,231,232,237568,3502,3502,241070
train,232,164,167936,2546,2546,170482
train,233,163,166912,2099,2099,169011
train,234,103,105472,1331,1331,106803
train,235,107,109568,1391,1391,110959
train,236,147,150528,2191,2191,152719
train,237,131,134144,1765,1765,135909
train,238,185,189440,2599,2599,192039
train,239,236,241664,3294,3294,244958
train,240,159,162816,2035,2035,164851
train,241,299,306176,4221,4221,310397
train,242,142,145408,1808,1808,147216
train,243,147,150528,1911,1911,152439
train,244,144,147456,1782,1782,149238
train,245,122,124928,1604,1604,126532
train,246,171,175104,2165,2165,177269
train,247,74,75776,864,864,76640
train,248,182,186368,2672,2672,189040
train,249,98,100352,1128,1128,101480
train,250,132,135168,1880,1880,137048
train,251,182,186368,2592,2592,188960
train,252,81,82944,1005,1005,83949
train,253,151,154624,2003,2003,156627
train,254,130,133120,1778,1778,134898
train,255,128,131072,1618,1618,132690
train,256,130,133120,1946,1946,135066
train,257,152,155648,2300,2300,157948
train,258,137,140288,1861,1861,142149
train,259,154,157696,2180,2180,159876
train,260,69,70656,767,767,71423
train,261,115,117760,1693,1693,119453
train,262,154,157696,2006,2006,159702
train,263,148,151552,2024,2024,153576
train,264,142,145408,1682,1682,147090
train,265,88,90112,990,990,91102
train,266,201,205824,2605,2605,208429
train,267,113,115712,1483,1483,117195
train,268,200,204800,2532,2532,207332
train,269,160,163840,2366,2366,166206
train,270,181,185344,2529,2529,187873
train,271,135,138240,1711,1711,139951
train,272,185,189440,2623,2623,192063
train,273,160,163840,2146,2146,165986
train,274,92,94208,1060,1060,95268
train,275,155,158720,2191,2191,160911
train,276,107,109568,1309,1309,110877
train,277,117,119808,1419,1419,121227
train,278,136,139264,1952,1952,141216
train,279,278,284672,4000,4000,288672
train,280,157,160768,2251,2251,163019
train,281,135,138240,1695,1695,139935
train,282,118,120832,1604,1604,122436
train,283,150,153600,1922,1922,155522
train,284,112,114688,1496,1496,116184
train,285,184,188416,2552,2552,190968
train,286,198,202752,2590,2590,205342
train,287,193,197632,2633,2633,200265
train,288,157,160768,2263,2263,163031
train,289,56,57344,562,562,57906
train,290,216,221184,3224,3224,224408
train,291,118,120832,1566,1566,122398
train,292,154,157696,2170,2170,159866
train,293,157,160768,2099,2099,162867
train,294,181,185344,2405,2405,187749
train,295,168,172032,2464,2464,174496
train,296,166,169984,2324,2324,172308
train,297,160,163840,2004,2004,165844
train,298,108,110592,1410,1410,112002
train,299,150,153600,2114,2114,155714
train,300,86,88064,1026,1026,89090
train,301,83,84992,1021,1021,86013
train,302,166,169984,2122,2122,172106
train,303,84,86016,1058,1058,87074
train,304,117,119808,1643,1643,121451
train,305,157,160768,2273,2273,163041
train,306,223,228352,3147,3147,231499
train,307,194,198656,2600,2600,201256
train,308,146,149504,1890,1890,151394
train,309,78,79872,822,822,80694
train,310,136,139264,1804,1804,141068
train,311,144,147456,2012,2012,149468
train,312,172,176128,2578,2578,178706
train,313,162,165888,2332,2332,168220
train,314,190,194560,3084,3084,197644
train,315,111,113664,1495,1495,115159
train,316,163,166912,2119,2119,169031
train,317,126,129024,1624,1624,130648
train,318,174,178176,2532,2532,180708
train,319,140,143360,1666,1666,145026
train,320,87,89088,1059,1059,90147
train,321,214,219136,3002,3002,222138
train,322,190,194560,2694,2694,197254
train,323,161,164864,2291,2291,167155
train,324,104,106496,1278,1278,107774
train,325,155,158720,2275,2275,160995
train,326,91,93184,977,977,94161
train,327,80,81920,1054,1054,82974
train,328,179,183296,2587,2587,185883
train,329,109,111616,1367,1367,112983
train,330,109,111616,1419,1419,113035
train,331,73,74752,923,923,75675
train,332,163,166912,2423,2423,169335
train,333,153,156672,2231,2231,158903
train,334,106,108544,1438,1438,109982
train,335,97,99328,1189,1189,100517
train,336,119,121856,1513,1513,123369
train,337,58,59392,624,624,60016
train,338,172,176128,2248,2248,178376
train,339,300,307200,4168,4168,311368
train,340,117,119808,1613,1613,121421
train,341,205,209920,2755,2755,212675
train,342,139,142336,2035,2035,144371
train,343,82,83968,868,868,84836
train,344,141,144384,1871,1871,146255
train,345,243,248832,3367,3367,252199
train,346,179,183296,2687,2687,185983
train,347,145,148480,2127,2127,150607
train,348,90,92160,1132,1132,93292
train,349,171,175104,2253,2253,177357
train,350,181,185344,2385,2385,187729
train,351,150,153600,2344,2344,155944
train,352,132,135168,1698,1698,136866
train,353,148,151552,1914,1914,153466
train,354,181,185344,2349,2349,187693
train,355,114,116736,1394,1394,118130
train,356,269,275456,3903,3903,279359
train,357,121,123904,1619,1619,125523
train,358,120,122880,1510,1510,124390
train,359,180,184320,2238,2238,186558
train,360,107,109568,1433,1433,111001
train,361,120,122880,1448,1448,124328
train,362,114,116736,1332,1332,118068
train,363,127,130048,1537,1537,131585
train,364,85,87040,989,989,88029
train,365,188,192512,2612,2612,195124
train,366,133,136192,1923,1923,138115
train,367,204,208896,3410,3410,212306
train,368,129,132096,1671,1671,133767
train,369,119,121856,1613,1613,123469
train,370,115,117760,1501,1501,119261
train,371,156,159744,2134,2134,161878
train,372,121,123904,1515,1515,125419
train,373,179,183296,2545,2545,185841
train,374,124,126976,1802,1802,128778
train,375,171,175104,2567,2567,177671
train,376,158,161792,2184,2184,163976
train,377,231,236544,3329,3329,239873
train,378,100,102400,1186,1186,103586
train,379,150,153600,2012,2012,155612
train,380,123,125952,1501,1501,127453
train,381,205,209920,2921,2921,212841
train,382,181,185344,2429,2429,187773
train,383,109,111616,1233,1233,112849
train,384,89,91136,1099,1099,92235
train,385,92,94208,1056,1056,95264
train,386,80,81920,960,960,82880
train,387,188,192512,2728,2728,195240
train,388,223,228352,3199,3199,231551
train,389,81,82944,971,971,83915
train,390,139,142336,1727,1727,144063
train,391,128,131072,1664,1664,132736
train,392,116,118784,1422,1422,120206
train,393,37,37888,361,361,38249
train,394,99,101376,1263,1263,102639
train,395,95,97280,1143,1143,98423
train,396,141,144384,1719,1719,146103
train,397,132,135168,1594,1594,136762
train,398,63,64512,675,675,65187
train,399,236,241664,3220,3220,244884
train,400,161,164864,2225,2225,167089
train,401,108,110592,1500,1500,112092
train,402,106,108544,1270,1270,109814
train,403,150,153600,2152,2152,155752
train,404,111,113664,1473,1473,115137
train,405,152,155648,2054,2054,157702
train,406,132,135168,1896,1896,137064
train,407,141,144384,1819,1819,146203
train,408,153,156672,2257,2257,158929
train,409,167,171008,2419,2419,173427
train,410,149,152576,2077,2077,154653
train,411,163,166912,2323,2323,169235
train,412,120,122880,1592,1592,124472
train,413,65,66560,747,747,67307
train,414,159,162816,2101,2101,164917
train,415,194,198656,2700,2700,201356
train,416,111,113664,1495,1495,115159
train,417,74,75776,814,814,76590
train,418,173,177152,2277,2277,179429
train,419,196,200704,2792,2792,203496
train,420,93,95232,1045,1045,96277
train,421,193,197632,2659,2659,200291
train,422,143,146432,1851,1851,148283
train,423,131,134144,1669,1669,135813
train,424,114,116736,1344,1344,118080
train,425,139,142336,1925,1925,144261
train,426,273,279552,4197,4197,283749
train,427,170,174080,2342,2342,176422
train,428,93,95232,1119,1119,96351
train,429,159,162816,2055,2055,164871
train,430,168,172032,2480,2480,174512
train,431,94,96256,1208,1208,97464
train,432,58,59392,606,606,59998
train,433,168,172032,2400,2400,174432
train,434,106,108544,1310,1310,109854
train,435,262,268288,4072,4072,272360
train,436,65,66560,673,673,67233
train,437,75,76800,879,879,77679
train,438,151,154624,2023,2023,156647
train,439,132,135168,1818,1818,136986
train,440,197,201728,2941,2941,204669
train,441,183,187392,2493,2493,189885
train,442,136,139264,1780,1780,141044
train,443,83,84992,965,965,85957
train,444,217,222208,3115,3115,225323
train,445,133,136192,1813,1813,138005
train,446,189,193536,2595,2595,196131
train,447,156,159744,1980,1980,161724
train,448,99,101376,1197,1197,102573
train,449,182,186368,2464,2464,188832
train,450,91,93184,1135,1135,94319
train,451,185,189440,2629,2629,192069
train,452,115,117760,1453,1453,119213
train,453,163,166912,2421,2421,169333
train,454,148,151552,2056,2056,153608
train,455,70,71680,798,798,72478
train,456,137,140288,1969,1969,142257
train,457,122,124928,1622,1622,126550
train,458,167,171008,2313,2313,173321
train,459,56,57344,642,642,57986
train,460,165,168960,2173,2173,171133
train,461,117,119808,1603,1603,121411
train,462,147,150528,1823,1823,152351
train,463,172,176128,2368,2368,178496
train,464,82,83968,984,984,84952
train,465,118,120832,1748,1748,122580
train,466,160,163840,2092,2092,165932
train,467,215,220160,2785,2785,222945
train,468,174,178176,2320,2320,180496
train,469,204,208896,2750,2750,211646
train,470,58,59392,638,638,60030
train,471,103,105472,1379,1379,106851
train,472,147,150528,2009,2009,152537
train,473,108,110592,1364,1364,111956
train,474,136,139264,1892,1892,141156
train,475,182,186368,2658,2658,189026
train,476,166,169984,2272,2272,172256
train,477,117,119808,1531,1531,121339
train,478,118,120832,1426,1426,122258
train,479,72,73728,818,818,74546
train,480,104,106496,1228,1228,107724
train,481,148,151552,2120,2120,153672
train,482,143,146432,2023,2023,148455
train,483,67,68608,717,717,69325
train,484,118,120832,1502,1502,122334
train,485,213,218112,2949,2949,221061
train,486,119,121856,1795,1795,123651
train,487,171,175104,2475,2475,177579
train,488,201,205824,2641,2641,208465
train,489,183,187392,2625,2625,190017
train,490,92,94208,1120,1120,95328
train,491,151,154624,2145,2145,156769
train,492,204,208896,2780,2780,211676
train,493,137,140288,1921,1921,142209
train,494,175,179200,2745,2745,181945
train,495,191,195584,2793,2793,198377
train,496,201,205824,2753,2753,208577
train,497,82,83968,1016,1016,84984
train,498,128,131072,1598,1598,132670
train,499,188,192512,2712,2712,195224
train,500,156,159744,1948,1948,161692
train,501,112,114688,1546,1546,116234
train,502,127,130048,1523,1523,131571
train,503,205,209920,2869,2869,212789
train,504,220,225280,3326,3326,228606
train,505,182,186368,2470,2470,188838
train,506,145,148480,2041,2041,150521
train,507,173,177152,2309,2309,179461
train,508,181,185344,2595,2595,187939
train,509,91,93184,1073,1073,94257
train,510,73,74752,841,841,75593
train,511,92,94208,1134,1134,95342
train,512,189,193536,2763,2763,196299
train,513,159,162816,2067,2067,164883
train,514,79,80896,847,847,81743
train,515,190,194560,2666,2666,197226
train,516,99,101376,1285,1285,102661
train,517,135,138240,1711,1711,139951
train,518,106,108544,1398,1398,109942
train,519,178,182272,2602,2602,184874
train,520,46,47104,490,490,47594
train,521,139,142336,1945,1945,144281
train,522,157,160768,2257,2257,163025
train,523,196,200704,2590,2590,203294
train,524,87,89088,1043,1043,90131
train,525,199,203776,2767,2767,206543
train,526,103,105472,1207,1207,106679
train,527,192,196608,2498,2498,199106
train,528,57,58368,595,595,58963
train,529,117,119808,1647,1647,121455
train,530,135,138240,1699,1699,139939
train,531,110,112640,1520,1520,114160
train,532,184,188416,2504,2504,190920
train,533,151,154624,2105,2105,156729
train,534,172,176128,2484,2484,178612
train,535,175,179200,2469,2469,181669
train,536,173,177152,2585,2585,179737
train,537,91,93184,1025,1025,94209
train,538,114,116736,1354,1354,118090
train,539,156,159744,1992,1992,161736
train,540,189,193536,2501,2501,196037
train,541,143,146432,2027,2027,148459
train,542,164,167936,2234,2234,170170
train,543,60,61440,692,692,62132
train,544,247,252928,3337,3337,256265
train,545,174,178176,2570,2570,180746
train,546,304,311296,4632,4632,315928
train,547,122,124928,1628,1628,126556
train,548,103,105472,1315,1315,106787
train,549,97,99328,1137,1137,100465
train,550,125,128000,1513,1513,129513
train,551,155,158720,2015,2015,160735
train,552,141,144384,1767,1767,146151
train,553,182,186368,2324,2324,188692
train,554,58,59392,642,642,60034
train,555,61,62464,737,737,63201
train,556,196,200704,2608,2608,203312
train,557,184,188416,2510,2510,190926
train,558,136,139264,1782,1782,141046
train,559,131,134144,1801,1801,135945
train,560,236,241664,3370,3370,245034
train,561,84,86016,1082,1082,87098
train,562,151,154624,2143,2143,156767
train,563,168,172032,2340,2340,174372
train,564,121,123904,1749,1749,125653
train,565,171,175104,2357,2357,177461
train,566,145,148480,2065,2065,150545
train,567,211,216064,3063,3063,219127
train,568,95,97280,1125,1125,98405
train,569,117,119808,1401,1401,121209
train,570,180,184320,2430,2430,186750
train,571,70,71680,902,902,72582
train,572,108,110592,1398,1398,111990
train,573,176,180224,2290,2290,182514
train,574,176,180224,2466,2466,182690
train,575,205,209920,2601,2601,212521
train,576,178,182272,2620,2620,184892
train,577,147,150528,1831,1831,152359
train,578,245,250880,3745,3745,254625
train,579,187,191488,2731,2731,194219
train,580,115,117760,1573,1573,119333
train,581,149,152576,2051,2051,154627
train,582,181,185344,2277,2277,187621
train,583,192,196608,2726,2726,199334
train,584,114,116736,1424,1424,118160
train,585,126,129024,1654,1654,130678
train,586,192,196608,2884,2884,199492
train,587,65,66560,799,799,67359
train,588,112,114688,1404,1404,116092
train,589,53,54272,561,561,54833
train,590,163,166912,2211,2211,169123
train,591,70,71680,804,804,72484
train,592,99,101376,1209,1209,102585
train,593,143,146432,1889,1889,148321
train,594,150,153600,2050,2050,155650
train,595,115,117760,1809,1809,119569
train,596,102,104448,1274,1274,105722
train,597,161,164864,2203,2203,167067
train,598,165,168960,2345,2345,171305
train,599,156,159744,2120,2120,161864
train,600,123,125952,1787,1787,127739
train,601,140,143360,1868,1868,145228
train,602,111,113664,1371,1371,115035
train,603,222,227328,3092,3092,230420
train,604,92,94208,1200,1200,95408
train,605,134,137216,2194,2194,139410
train,606,79,80896,1085,1085,81981
train,607,198,202752,2964,2964,205716
train,608,137,140288,1801,1801,142089
train,609,63,64512,715,715,65227
train,610,57,58368,625,625,58993
train,611,207,211968,2877,2877,214845
train,612,166,169984,2374,2374,172358
train,613,92,94208,1128,1128,95336
train,614,149,152576,2179,2179,154755
train,615,141,144384,1681,1681,146065
train,616,132,135168,1978,1978,137146
train,617,112,114688,1488,1488,116176
train,618,207,211968,3045,3045,215013
train,619,95,97280,1191,1191,98471
train,620,169,173056,2431,2431,175487
train,621,112,114688,1612,1612,116300
train,622,77,78848,853,853,79701
train,623,102,104448,1172,1172,105620
train,624,168,172032,2354,2354,174386
train,625,219,224256,2921,2921,227177
train,626,137,140288,1963,1963,142251
train,627,79,80896,1051,1051,81947
train,628,105,107520,1465,1465,108985
train,629,215,220160,2963,2963,223123
train,630,126,129024,1680,1680,130704
train,631,122,124928,1706,1706,126634
train,632,149,152576,2003,2003,154579
train,633,142,145408,2152,2152,147560
train,634,120,122880,1476,1476,124356
train,635,114,116736,1620,1620,118356
train,636,172,176128,2542,2542,178670
train,637,84,86016,1020,1020,87036
train,638,154,157696,2270,2270,159966
train,639,68,69632,716,716,70348
train,640,140,143360,1906,1906,145266
train,641,162,165888,2354,2354,168242
train,642,90,92160,1178,1178,93338
train,643,164,167936,2056,2056,169992
train,644,115,117760,1583,1583,119343
train,645,166,169984,2518,2518,172502
train,646,115,117760,1391,1391,119151
train,647,87,89088,1161,1161,90249
train,648,149,152576,2067,2067,154643
train,649,119,121856,1517,1517,123373
train,650,103,105472,1263,1263,106735
train,651,78,79872,938,938,80810
train,652,119,121856,1631,1631,123487
train,653,141,144384,1703,1703,146087
train,654,97,99328,1151,1151,100479
train,655,172,176128,2324,2324,178452
train,656,95,97280,1299,1299,98579
train,657,223,228352,3055,3055,231407
train,658,177,181248,2325,2325,183573
train,659,129,132096,1733,1733,133829
train,660,188,192512,2312,2312,194824
train,661,88,90112,1012,1012,91124
train,662,137,140288,1967,1967,142255
train,663,126,129024,1676,1676,130700
train,664,127,130048,1661,1661,131709
train,665,120,122880,1492,1492,124372
train,666,133,136192,1759,1759,137951
train,667,110,112640,1278,1278,113918
train,668,145,148480,1945,1945,150425
train,669,71,72704,777,777,73481
train,670,67,68608,679,679,69287
train,671,133,136192,1901,1901,138093
train,672,95,97280,1159,1159,98439
train,673,159,162816,2161,2161,164977
train,674,149,152576,2057,2057,154633
train,675,130,133120,1724,1724,134844
train,676,89,91136,1161,1161,92297
train,677,203,207872,3017,3017,210889
train,678,167,171008,2107,2107,173115
train,679,168,172032,2380,2380,174412
train,680,152,155648,2082,2082,157730
train,681,123,125952,1695,1695,127647
train,682,92,94208,1070,1070,95278
train,683,100,102400,1186,1186,103586
train,684,181,185344,2503,2503,187847
train,685,96,98304,1144,1144,99448
train,686,141,144384,2037,2037,146421
train,687,246,251904,3460,3460,255364
train,688,148,151552,1992,1992,153544
train,689,161,164864,2179,2179,167043
train,690,125,128000,1917,1917,129917
train,691,146,149504,1874,1874,151378
train,692,177,181248,2433,2433,183681
train,693,120,122880,1880,1880,124760
train,694,53,54272,565,565,54837
train,695,147,150528,1929,1929,152457
train,696,95,97280,1147,1147,98427
train,697,154,157696,2068,2068,159764
train,698,176,180224,2078,2078,182302
train,699,209,214016,3057,3057,217073
train,700,225,230400,3131,3131,233531
train,701,151,154624,2193,2193,156817
train,702,83,84992,899,899,85891
train,703,112,114688,1304,1304,115992
train,704,150,153600,1834,1834,155434
train,705,111,113664,1541,1541,115205
train,706,109,111616,1265,1265,112881
train,707,151,154624,2281,2281,156905
train,708,95,97280,1259,1259,98539
train,709,164,167936,2240,2240,170176
train,710,174,178176,2386,2386,180562
train,711,123,125952,1725,1725,127677
train,712,124,126976,1572,1572,128548
train,713,116,118784,1532,1532,120316
train,714,169,173056,2395,2395,175451
train,715,141,144384,1731,1731,146115
train,716,95,97280,1197,1197,98477
train,717,144,147456,1936,1936,149392
train,718,163,166912,2155,2155,169067
train,719,205,209920,2901,2901,212821
train,720,114,116736,1392,1392,118128
train,721,168,172032,2324,2324,174356
train,722,135,138240,1665,1665,139905
train,723,95,97280,1123,1123,98403
train,724,175,179200,2485,2485,181685
train,725,108,110592,1286,1286,111878
train,726,118,120832,1498,1498,122330
train,727,142,145408,1830,1830,147238
train,728,115,117760,1509,1509,119269
train,729,143,146432,1723,1723,148155
train,730,104,106496,1316,1316,107812
train,731,107,109568,1333,1333,110901
train,732,136,139264,1912,1912,141176
train,733,186,190464,2394,2394,192858
train,734,193,197632,2551,2551,200183
train,735,246,251904,3332,3332,255236
train,736,148,151552,2184,2184,153736
train,737,76,77824,870,870,78694
train,738,172,176128,2228,2228,178356
train,739,109,111616,1389,1389,113005
train,740,143,146432,1907,1907,148339
train,741,101,103424,1359,1359,104783
train,742,222,227328,3328,3328,230656
train,743,186,190464,2306,2306,192770
train,744,94,96256,1106,1106,97362
train,745,112,114688,1396,1396,116084
train,746,147,150528,2097,2097,152625
train,747,87,89088,1069,1069,90157
train,748,98,100352,1242,1242,101594
train,749,132,135168,1936,1936,137104
train,750,145,148480,1895,1895,150375
train,751,175,179200,2217,2217,181417
train,752,96,98304,1090,1090,99394
train,753,138,141312,1792,1792,143104
train,754,116,118784,1552,1552,120336
train,755,126,129024,1550,1550,130574
train,756,133,136192,1751,1751,137943
train,757,157,160768,2109,2109,162877
train,758,149,152576,1999,1999,154575
train,759,129,132096,1759,1759,133855
train,760,145,148480,1795,1795,150275
train,761,190,194560,2810,2810,197370
train,762,56,57344,684,684,58028
train,763,82,83968,1078,1078,85046
train,764,52,53248,566,566,53814
train,765,136,139264,1878,1878,141142
train,766,161,164864,2129,2129,166993
train,767,201,205824,2913,2913,208737
train,768,194,198656,2810,2810,201466
train,769,96,98304,1090,1090,99394
train,770,89,91136,1101,1101,92237
train,771,125,128000,1669,1669,129669
train,772,182,186368,2422,2422,188790
train,773,167,171008,2313,2313,173321
train,774,157,160768,2075,2075,162843
train,775,189,193536,2523,2523,196059
train,776,120,122880,1546,1546,124426
train,777,107,109568,1447,1447,111015
train,778,94,96256,1108,1108,97364
train,779,97,99328,1195,1195,100523
train,780,147,150528,2021,2021,152549
train,781,85,87040,1093,1093,88133
train,782,128,131072,1640,1640,132712
train,783,125,128000,1765,1765,129765
train,784,104,106496,1412,1412,107908
train,785,65,66560,731,731,67291
train,786,142,145408,1694,1694,147102
train,787,171,175104,2543,2543,177647
train,788,60,61440,668,668,62108
train,789,165,168960,2169,2169,171129
train,790,192,196608,2790,2790,199398
train,791,132,135168,1948,1948,137116
train,792,64,65536,758,758,66294
train,793,192,196608,2582,2582,199190
train,794,151,154624,2191,2191,156815
train,795,94,96256,1048,1048,97304
train,796,133,136192,1845,1845,138037
train,797,106,108544,1278,1278,109822
train,798,89,91136,1075,1075,92211
train,799,182,186368,2378,2378,188746
train,800,128,131072,1678,1678,132750
train,801,161,164864,2301,2301,167165
train,802,105,107520,1345,1345,108865
train,803,156,159744,1940,1940,161684
train,804,192,196608,2686,2686,199294
train,805,161,164864,2277,2277,167141
train,806,143,146432,2207,2207,148639
train,807,199,203776,2875,2875,206651
train,808,158,161792,2112,2112,163904
train,809,62,63488,628,628,64116
train,810,121,123904,1623,1623,125527
train,811,201,205824,2701,2701,208525
train,812,83,84992,1001,1001,85993
train,813,51,52224,519,519,52743
train,814,206,210944,2754,2754,213698
train,815,167,171008,2315,2315,173323
train,816,184,188416,2786,2786,191202
train,817,205,209920,2681,2681,212601
train,818,66,67584,698,698,68282
train,819,230,235520,3366,3366,238886
train,820,186,190464,2794,2794,193258
train,821,147,150528,2013,2013,152541
train,822,127,130048,1733,1733,131781
train,823,159,162816,2087,2087,164903
train,824,164,167936,2202,2202,170138
train,825,170,174080,2490,2490,176570
train,826,106,108544,1336,1336,109880
train,827,190,194560,2774,2774,197334
train,828,181,185344,2501,2501,187845
train,829,117,119808,1377,1377,121185
train,830,187,191488,2641,2641,194129
train,831,75,76800,889,889,77689
train,832,164,167936,2170,2170,170106
train,833,185,189440,2523,2523,191963
train,834,160,163840,2036,2036,165876
train,835,170,174080,2386,2386,176466
train,836,177,181248,2235,2235,183483
train,837,117,119808,1529,1529,121337
train,838,84,86016,1038,1038,87054
train,839,189,193536,2717,2717,196253
train,840,67,68608,795,795,69403
train,841,152,155648,1914,1914,157562
train,842,87,89088,1139,1139,90227
train,843,103,105472,1295,1295,106767
train,844,91,93184,1055,1055,94239
train,845,132,135168,1594,1594,136762
train,846,172,176128,2444,2444,178572
train,847,137,140288,1833,1833,142121
train,848,147,150528,2113,2113,152641
train,849,188,192512,2584,2584,195096
train,850,140,143360,1910,1910,145270
train,851,133,136192,1819,1819,138011
train,852,89,91136,1133,1133,92269
train,853,123,125952,1749,1749,127701
train,854,130,133120,1906,1906,135026
train,855,108,110592,1390,1390,111982
train,856,175,179200,2387,2387,181587
train,857,63,64512,711,711,65223
train,858,114,116736,1402,1402,118138
train,859,203,207872,3171,3171,211043
train,860,221,226304,3007,3007,229311
train,861,100,102400,1386,1386,103786
train,862,124,126976,1808,1808,128784
train,863,227,232448,3325,3325,235773
train,864,170,174080,2312,2312,176392
train,865,141,144384,1913,1913,146297
train,866,70,71680,766,766,72446
train,867,98,100352,1288,1288,101640
train,868,81,82944,929,929,83873
train,869,160,163840,2550,2550,166390
train,870,114,116736,1536,1536,118272
train,871,106,108544,1406,1406,109950
train,872,106,108544,1362,1362,109906
train,873,106,108544,1332,1332,109876
train,874,152,155648,2156,2156,157804
train,875,83,84992,991,991,85983
train,876,181,185344,2745,2745,188089
train,877,199,203776,2813,2813,206589
train,878,142,145408,1950,1950,147358
train,879,150,153600,1952,1952,155552
train,880,141,144384,1773,1773,146157
train,881,86,88064,1056,1056,89120
train,882,132,135168,1654,1654,136822
train,883,159,162816,1975,1975,164791
train,884,143,146432,1859,1859,148291
train,885,108,110592,1290,1290,111882
train,886,213,218112,2821,2821,220933
train,887,112,114688,1406,1406,116094
train,888,104,106496,1338,1338,107834
train,889,109,111616,1555,1555,113171
train,890,165,168960,2559,2559,171519
train,891,72,73728,796,796,74524
train,892,149,152576,2077,2077,154653
train,893,167,171008,2159,2159,173167
train,894,176,180224,2460,2460,182684
train,895,200,204800,2752,2752,207552
train,896,72,73728,850,850,74578
train,897,180,184320,2466,2466,186786
train,898,180,184320,2390,2390,186710
train,899,108,110592,1450,1450,112042
train,900,162,165888,2498,2498,168386
train,901,110,112640,1394,1394,114034
train,902,125,128000,1649,1649,129649
train,903,115,117760,1417,1417,119177
train,904,43,44032,497,497,44529
train,905,81,82944,1047,1047,83991
train,906,208,212992,2770,2770,215762
train,907,175,179200,2329,2329,181529
train,908,204,208896,2762,2762,211658
train,909,133,136192,1843,1843,138035
train,910,219,224256,2761,2761,227017
train,911,134,137216,1732,1732,138948
train,912,69,70656,733,733,71389
train,913,128,131072,1686,1686,132758
train,914,122,124928,1778,1778,126706
train,915,125,128000,1507,1507,129507
train,916,141,144384,2021,2021,146405
train,917,111,113664,1523,1523,115187
train,918,97,99328,1223,1223,100551
train,919,156,159744,2258,2258,162002
train,920,150,153600,2398,2398,155998
train,921,136,139264,1720,1720,140984
train,922,90,92160,1202,1202,93362
train,923,143,146432,1825,1825,148257
train,924,181,185344,2647,2647,187991
train,925,188,192512,2592,2592,195104
train,926,126,129024,1632,1632,130656
train,927,105,107520,1307,1307,108827
train,928,80,81920,866,866,82786
train,929,112,114688,1430,1430,116118
train,930,48,49152,522,522,49674
train,931,139,142336,1797,1797,144133
train,932,217,222208,2819,2819,225027
train,933,137,140288,1893,1893,142181
train,934,142,145408,1672,1672,147080
train,935,75,76800,885,885,77685
train,936,155,158720,2183,2183,160903
train,937,127,130048,1671,1671,131719
train,938,129,132096,1763,1763,133859
train,939,161,164864,2143,2143,167007
train,940,111,113664,1563,1563,115227
train,941,214,219136,2948,2948,222084
train,942,165,168960,2231,2231,171191
train,943,154,157696,1954,1954,159650
train,944,90,92160,1098,1098,93258
train,945,131,134144,1623,1623,135767
train,946,134,137216,1704,1704,138920
train,947,91,93184,1249,1249,94433
train,948,136,139264,1740,1740,141004
train,949,73,74752,937,937,75689
train,950,196,200704,2808,2808,203512
train,951,180,184320,2268,2268,186588
train,952,161,164864,2409,2409,167273
train,953,156,159744,1938,1938,161682
train,954,182,186368,2370,2370,188738
train,955,128,131072,1600,1600,132672
train,956,80,81920,846,846,82766
train,957,116,118784,1506,1506,120290
train,958,166,169984,2290,2290,172274
train,959,66,67584,704,704,68288
train,960,127,130048,1543,1543,131591
train,961,94,96256,1196,1196,97452
train,962,128,131072,1676,1676,132748
train,963,160,163840,2088,2088,165928
train,964,107,109568,1287,1287,110855
train,965,106,108544,1382,1382,109926
train,966,248,253952,3376,3376,257328
train,967,159,162816,2089,2089,164905
train,968,174,178176,2586,2586,180762
train,969,105,107520,1363,1363,108883
train,970,181,185344,2625,2625,187969
train,971,183,187392,2759,2759,190151
train,972,85,87040,1111,1111,88151
train,973,204,208896,3130,3130,212026
train,974,128,131072,1628,1628,132700
train,975,196,200704,2596,2596,203300
train,976,119,121856,1451,1451,123307
train,977,158,161792,2030,2030,163822
train,978,119,121856,1575,1575,123431
train,979,183,187392,2535,2535,189927
train,980,235,240640,3435,3435,244075
train,981,145,148480,1877,1877,150357
train,982,66,67584,722,722,68306
train,983,81,82944,1047,1047,83991
train,984,146,149504,2008,2008,151512
train,985,207,211968,2941,2941,214909
train,986,92,94208,1086,1086,95294
train,987,163,166912,2125,2125,169037
train,988,184,188416,2544,2544,190960
train,989,112,114688,1534,1534,116222
train,990,96,98304,1214,1214,99518
train,991,140,143360,1708,1708,145068
train,992,118,120832,1550,1550,122382
train,993,68,69632,754,754,70386
train,994,153,156672,1927,1927,158599
train,995,147,150528,1883,1883,152411
train,996,168,172032,2310,2310,174342
train,997,111,113664,1383,1383,115047
train,998,174,178176,2496,2496,180672
train,999,128,131072,1624,1624,132696
train,1000,76,77824,872,872,78696
train,1001,87,89088,983,983,90071
train,1002,123,125952,1707,1707,127659
train,1003,149,152576,1971,1971,154547
train,1004,115,117760,1411,1411,119171
train,1005,150,153600,2090,2090,155690
train,1006,107,109568,1375,1375,110943
train,1007,179,183296,2505,2505,185801
train,1008,161,164864,2375,2375,167239
train,1009,116,118784,1422,1422,120206
train,1010,129,132096,1621,1621,133717
train,1011,101,103424,1203,1203,104627
train,1012,126,129024,1734,1734,130758
train,1013,117,119808,1473,1473,121281
train,1014,138,141312,1980,1980,143292
train,1015,106,108544,1350,1350,109894
train,1016,108,110592,1318,1318,111910
train,1017,114,116736,1434,1434,118170
train,1018,172,176128,2524,2524,178652
train,1019,151,154624,1979,1979,156603
train,1020,137,140288,2277,2277,142565
train,1021,161,164864,2335,2335,167199
train,1022,147,150528,1745,1745,152273
train,1023,188,192512,2882,2882,195394
train,1024,123,125952,1581,1581,127533
train,1025,122,124928,1530,1530,126458
train,1026,170,174080,2420,2420,176500
train,1027,141,144384,1897,1897,146281
train,1028,82,83968,1034,1034,85002
train,1029,118,120832,1332,1332,122164
train,1030,66,67584,768,768,68352
train,1031,125,128000,1607,1607,129607
train,1032,199,203776,2821,2821,206597
train,1033,166,169984,2066,2066,172050
train,1034,183,187392,2477,2477,189869
train,1035,135,138240,1925,1925,140165
train,1036,117,119808,1541,1541,121349
train,1037,139,142336,2017,2017,144353
train,1038,113,115712,1511,1511,117223
train,1039,147,150528,2037,2037,152565
train,1040,157,160768,2239,2239,163007
train,1041,118,120832,1414,1414,122246
train,1042,78,79872,836,836,80708
train,1043,109,111616,1399,1399,113015
train,1044,113,115712,1447,1447,117159
train,1045,80,81920,858,858,82778
train,1046,123,125952,1619,1619,127571
train,1047,95,97280,1201,1201,98481
train,1048,118,120832,1468,1468,122300
train,1049,153,156672,2159,2159,158831
train,1050,124,126976,1632,1632,128608
train,1051,184,188416,2502,2502,190918
train,1052,122,124928,1556,1556,126484
train,1053,145,148480,1861,1861,150341
train,1054,150,153600,2022,2022,155622
train,1055,129,132096,1591,1591,133687
train,1056,92,94208,1128,1128,95336
train,1057,138,141312,1706,1706,143018
train,1058,78,79872,904,904,80776
train,1059,105,107520,1281,1281,108801
train,1060,84,86016,936,936,86952
train,1061,164,167936,2160,2160,170096
train,1062,127,130048,1759,1759,131807
train,1063,162,165888,2150,2150,168038
train,1064,171,175104,2191,2191,177295
train,1065,73,74752,863,863,75615
train,1066,146,149504,1874,1874,151378
train,1067,122,124928,1520,1520,126448
train,1068,152,155648,1984,1984,157632
train,1069,121,123904,1665,1665,125569
train,1070,160,163840,2192,2192,166032
train,1071,126,129024,1912,1912,130936
train,1072,128,131072,1688,1688,132760
train,1073,112,114688,1430,1430,116118
train,1074,80,81920,952,952,82872
train,1075,118,120832,1578,1578,122410
train,1076,171,175104,2345,2345,177449
train,1077,165,168960,2231,2231,171191
train,1078,102,104448,1294,1294,105742
train,1079,190,194560,2496,2496,197056
train,1080,151,154624,2169,2169,156793
train,1081,155,158720,1885,1885,160605
train,1082,122,124928,1400,1400,126328
train,1083,92,94208,1106,1106,95314
train,1084,117,119808,1485,1485,121293
train,1085,96,98304,1172,1172,99476
train,1086,98,100352,1252,1252,101604
train,1087,59,60416,653,653,61069
train,1088,62,63488,722,722,64210
train,1089,135,138240,1895,1895,140135
train,1090,180,184320,2792,2792,187112
train,1091,120,122880,1720,1720,124600
train,1092,131,134144,1601,1601,135745
train,1093,227,232448,3185,3185,235633
train,1094,131,134144,1577,1577,135721
train,1095,84,86016,994,994,87010
train,1096,159,162816,1919,1919,164735
train,1097,201,205824,2749,2749,208573
train,1098,189,193536,2755,2755,196291
train,1099,160,163840,2246,2246,166086
train,1100,192,196608,2460,2460,199068
train,1101,93,95232,1251,1251,96483
train,1102,139,142336,1797,1797,144133
train,1103,205,209920,3105,3105,213025
train,1104,100,102400,1086,1086,103486
train,1105,59,60416,631,631,61047
train,1106,148,151552,2208,2208,153760
train,1107,177,181248,2369,2369,183617
train,1108,60,61440,640,640,62080
train,1109,207,211968,3193,3193,215161
train,1110,149,152576,1885,1885,154461
train,1111,104,106496,1224,1224,107720
train,1112,177,181248,2243,2243,183491
train,1113,125,128000,1693,1693,129693
train,1114,149,152576,1895,1895,154471
train,1115,149,152576,2063,2063,154639
train,1116,78,79872,846,846,80718
train,1117,211,216064,2941,2941,219005
train,1118,130,133120,1492,1492,134612
train,1119,128,131072,1584,1584,132656
train,1120,129,132096,1873,1873,133969
train,1121,89,91136,983,983,92119
train,1122,144,147456,1860,1860,149316
train,1123,88,90112,972,972,91084
train,1124,55,56320,587,587,56907
train,1125,135,138240,1819,1819,140059
train,1126,211,216064,2951,2951,219015
train,1127,240,245760,3472,3472,249232
train,1128,61,62464,655,655,63119
train,1129,81,82944,893,893,83837
train,1130,147,150528,2013,2013,152541
train,1131,139,142336,1943,1943,144279
train,1132,121,123904,1665,1665,125569
train,1133,211,216064,3227,3227,219291
train,1134,72,73728,870,870,74598
train,1135,63,64512,747,747,65259
train,1136,137,140288,2003,2003,142291
train,1137,145,148480,2063,2063,150543
train,1138,173,177152,2533,2533,179685
train,1139,75,76800,835,835,77635
train,1140,200,204800,2754,2754,207554
train,1141,88,90112,1040,1040,91152
train,1142,84,86016,1028,1028,87044
train,1143,191,195584,2431,2431,198015
train,1144,154,157696,1996,1996,159692
train,1145,149,152576,2271,2271,154847
train,1146,102,104448,1352,1352,105800
train,1147,137,140288,1759,1759,142047
train,1148,126,129024,1468,1468,130492
train,1149,164,167936,2326,2326,170262
train,1150,170,174080,2614,2614,176694
train,1151,145,148480,2095,2095,150575
train,1152,147,150528,1897,1897,152425
train,1153,124,126976,1722,1722,128698
train,1154,110,112640,1470,1470,114110
train,1155,205,209920,3033,3033,212953
train,1156,138,141312,1782,1782,143094
train,1157,161,164864,2247,2247,167111
train,1158,157,160768,2143,2143,162911
train,1159,106,108544,1268,1268,109812
train,1160,73,74752,793,793,75545
train,1161,181,185344,2497,2497,187841
train,1162,174,178176,2390,2390,180566
train,1163,142,145408,2218,2218,147626
train,1164,224,229376,3546,3546,232922
train,1165,101,103424,1331,1331,104755
train,1166,131,134144,1753,1753,135897
train,1167,95,97280,1231,1231,98511
train,1168,66,67584,674,674,68258
train,1169,109,111616,1273,1273,112889
train,1170,143,146432,1929,1929,148361
train,1171,123,125952,1531,1531,127483
train,1172,99,101376,1183,1183,102559
train,1173,231,236544,3465,3465,240009
train,1174,82,83968,1076,1076,85044
train,1175,181,185344,2557,2557,187901
train,1176,140,143360,1896,1896,145256
train,1177,161,164864,2165,2165,167029
train,1178,89,91136,1199,1199,92335
train,1179,175,179200,2573,2573,181773
train,1180,64,65536,714,714,66250
train,1181,37,37888,367,367,38255
train,1182,101,103424,1107,1107,104531
train,1183,262,268288,3836,3836,272124
train,1184,113,115712,1441,1441,117153
train,1185,147,150528,1941,1941,152469
train,1186,153,156672,2491,2491,159163
train,1187,178,182272,2712,2712,184984
train,1188,222,227328,3314,3314,230642
train,1189,119,121856,1437,1437,123293
train,1190,185,189440,2787,2787,192227
train,1191,159,162816,2109,2109,164925
train,1192,91,93184,1149,1149,94333
train,1193,170,174080,2332,2332,176412
train,1194,153,156672,1961,1961,158633
train,1195,112,114688,1534,1534,116222
train,1196,104,106496,1358,1358,107854
train,1197,139,142336,1803,1803,144139
train,1198,118,120832,1460,1460,122292
train,1199,162,165888,2398,2398,168286
train,1200,99,101376,1239,1239,102615
train,1201,161,164864,2281,2281,167145
train,1202,122,124928,1590,1590,126518
train,1203,183,187392,2571,2571,189963
train,1204,157,160768,1955,1955,162723
train,1205,48,49152,472,472,49624
train,1206,105,107520,1341,1341,108861
train,1207,102,104448,1212,1212,105660
train,1208,149,152576,1997,1997,154573
train,1209,164,167936,2280,2280,170216
train,1210,138,141312,1732,1732,143044
train,1211,103,105472,1229,1229,106701
train,1212,147,150528,1953,1953,152481
train,1213,238,243712,3440,3440,247152
train,1214,175,179200,2505,2505,181705
train,1215,94,96256,1236,1236,97492
train,1216,111,113664,1483,1483,115147
train,1217,142,145408,2172,2172,147580
train,1218,163,166912,2381,2381,169293
train,1219,94,96256,1294,1294,97550
train,1220,145,148480,1847,1847,150327
train,1221,231,236544,3615,3615,240159
train,1222,113,115712,1445,1445,117157
train,1223,131,134144,1639,1639,135783
train,1224,133,136192,1985,1985,138177
train,1225,49,50176,569,569,50745
train,1226,146,149504,2106,2106,151610
train,1227,161,164864,2205,2205,167069
train,1228,229,234496,3581,3581,238077
train,1229,82,83968,942,942,84910
train,1230,154,157696,2046,2046,159742
train,1231,72,73728,814,814,74542
train,1232,165,168960,2239,2239,171199
train,1233,187,191488,2465,2465,193953
train,1234,145,148480,1925,1925,150405
train,1235,166,169984,2274,2274,172258
train,1236,65,66560,741,741,67301
train,1237,136,139264,2004,2004,141268
train,1238,116,118784,1430,1430,120214
train,1239,109,111616,1273,1273,112889
train,1240,134,137216,1966,1966,139182
train,1241,142,145408,1808,1808,147216
train,1242,123,125952,1533,1533,127485
train,1243,85,87040,1063,1063,88103
train,1244,106,108544,1194,1194,109738
train,1245,160,163840,2274,2274,166114
train,1246,112,114688,1346,1346,116034
train,1247,141,144384,2023,2023,146407
train,1248,45,46080,439,439,46519
train,1249,136,139264,1804,1804,141068
train,1250,126,129024,1810,1810,130834
train,1251,56,57344,622,622,57966
train,1252,240,245760,3538,3538,249298
train,1253,146,149504,2202,2202,151706
train,1254,79,80896,955,955,81851
train,1255,146,149504,2108,2108,151612
train,1256,44,45056,420,420,45476
train,1257,99,101376,1297,1297,102673
train,1258,97,99328,1141,1141,100469
train,1259,148,151552,2062,2062,153614
train,1260,133,136192,1953,1953,138145
train,1261,164,167936,2184,2184,170120
train,1262,150,153600,2182,2182,155782
train,1263,171,175104,2203,2203,177307
train,1264,129,132096,1697,1697,133793
train,1265,151,154624,1999,1999,156623
train,1266,111,113664,1477,1477,115141
train,1267,135,138240,1765,1765,140005
train,1268,171,175104,2285,2285,177389
train,1269,149,152576,2049,2049,154625
train,1270,80,81920,980,980,82900
train,1271,125,128000,1349,1349,129349
train,1272,102,104448,1224,1224,105672
train,1273,139,142336,1861,1861,144197
train,1274,81,82944,1039,1039,83983
train,1275,128,131072,1808,1808,132880
train,1276,85,87040,985,985,88025
train,1277,133,136192,1835,1835,138027
train,1278,170,174080,2338,2338,176418
train,1279,127,130048,1667,1667,131715
train,1280,203,207872,2807,2807,210679
train,1281,140,143360,2046,2046,145406
train,1282,115,117760,1473,1473,119233
train,1283,133,136192,1627,1627,137819
train,1284,98,100352,1284,1284,101636
train,1285,107,109568,1361,1361,110929
train,1286,190,194560,2770,2770,197330
train,1287,153,156672,1995,1995,158667
train,1288,66,67584,768,768,68352
train,1289,115,117760,1479,1479,119239
train,1290,198,202752,2958,2958,205710
train,1291,174,178176,2392,2392,180568
train,1292,52,53248,582,582,53830
train,1293,139,142336,1647,1647,143983
train,1294,99,101376,1265,1265,102641
train,1295,112,114688,1534,1534,116222
train,1296,99,101376,1227,1227,102603
train,1297,115,117760,1687,1687,119447
train,1298,98,100352,1152,1152,101504
train,1299,142,145408,1790,1790,147198
train,1300,129,132096,2009,2009,134105
train,1301,110,112640,1332,1332,113972
train,1302,151,154624,2145,2145,156769
train,1303,130,133120,1626,1626,134746
train,1304,103,105472,1199,1199,106671
train,1305,173,177152,2457,2457,179609
train,1306,137,140288,2039,2039,142327
train,1307,81,82944,1037,1037,83981
train,1308,74,75776,952,952,76728
train,1309,126,129024,1476,1476,130500
train,1310,101,103424,1305,1305,104729
train,1311,203,207872,3003,3003,210875
train,1312,216,221184,3480,3480,224664
train,1313,122,124928,1618,1618,126546
train,1314,178,182272,2270,2270,184542
train,1315,188,192512,2704,2704,195216
train,1316,100,102400,1194,1194,103594
train,1317,225,230400,3617,3617,234017
train,1318,160,163840,2448,2448,166288
train,1319,234,239616,3550,3550,243166
train,1320,102,104448,1208,1208,105656
train,1321,161,164864,2189,2189,167053
train,1322,124,126976,1488,1488,128464
train,1323,101,103424,1325,1325,104749
train,1324,180,184320,2606,2606,186926
train,1325,100,102400,1232,1232,103632
train,1326,169,173056,2481,2481,175537
train,1327,145,148480,1831,1831,150311
train,1328,200,204800,2942,2942,207742
train,1329,164,167936,2260,2260,170196
train,1330,166,169984,2022,2022,172006
train,1331,65,66560,723,723,67283
train,1332,119,121856,1675,1675,123531
train,1333,235,240640,3165,3165,243805
train,1334,137,140288,1773,1773,142061
train,1335,122,124928,1656,1656,126584
train,1336,134,137216,1942,1942,139158
train,1337,162,165888,2328,2328,168216
train,1338,105,107520,1235,1235,108755
train,1339,172,176128,2402,2402,178530
train,1340,204,208896,2900,2900,211796
train,1341,167,171008,2345,2345,173353
train,1342,111,113664,1495,1495,115159
train,1343,39,39936,391,391,40327
train,1344,161,164864,2153,2153,167017
train,1345,131,134144,1715,1715,135859
train,1346,56,57344,684,684,58028
train,1347,138,141312,1886,1886,143198
train,1348,135,138240,1747,1747,139987
train,1349,81,82944,895,895,83839
train,1350,194,198656,2548,2548,201204
train,1351,108,110592,1400,1400,111992
train,1352,194,198656,2692,2692,201348
train,1353,45,46080,459,459,46539
train,1354,148,151552,2036,2036,153588
train,1355,105,107520,1317,1317,108837
train,1356,198,202752,2824,2824,205576
train,1357,168,172032,2496,2496,174528
train,1358,87,89088,979,979,90067
train,1359,69,70656,787,787,71443
train,1360,144,147456,2150,2150,149606
train,1361,162,165888,2108,2108,167996
train,1362,87,89088,971,971,90059
train,1363,64,65536,720,720,66256
train,1364,251,257024,3655,3655,260679
train,1365,146,149504,1852,1852,151356
train,1366,120,122880,1708,1708,124588
train,1367,109,111616,1475,1475,113091
train,1368,133,136192,1787,1787,137979
train,1369,56,57344,584,584,57928
train,1370,130,133120,1674,1674,134794
train,1371,130,133120,1668,1668,134788
train,1372,236,241664,3098,3098,244762
train,1373,231,236544,3397,3397,239941
train,1374,105,107520,1287,1287,108807
train,1375,118,120832,1584,1584,122416
train,1376,176,180224,2330,2330,182554
train,1377,189,193536,2581,2581,196117
train,1378,154,157696,2204,2204,159900
train,1379,135,138240,1741,1741,139981
train,1380,146,149504,2046,2046,151550
train,1381,155,158720,2081,2081,160801
train,1382,102,104448,1302,1302,105750
train,1383,184,188416,2594,2594,191010
train,1384,115,117760,1283,1283,119043
train,1385,115,117760,1473,1473,119233
train,1386,108,110592,1384,1384,111976
train,1387,36,36864,372,372,37236
train,1388,98,100352,1226,1226,101578
train,1389,169,173056,2209,2209,175265
train,1390,149,152576,1821,1821,154397
train,1391,187,191488,2717,2717,194205
train,1392,188,192512,2766,2766,195278
train,1393,63,64512,745,745,65257
train,1394,142,145408,1988,1988,147396
train,1395,201,205824,2521,2521,208345
train,1396,100,102400,1252,1252,103652
train,1397,180,184320,2610,2610,186930
train,1398,61,62464,743,743,63207
train,1399,84,86016,1002,1002,87018
train,1400,241,246784,3571,3571,250355
train,1401,77,78848,883,883,79731
train,1402,204,208896,3062,3062,211958
train,1403,202,206848,2908,2908,209756
train,1404,61,62464,599,599,63063
train,1405,175,179200,2349,2349,181549
train,1406,117,119808,1571,1571,121379
train,1407,195,199680,2717,2717,202397
train,1408,161,164864,2377,2377,167241
train,1409,176,180224,2318,2318,182542
train,1410,155,158720,2201,2201,160921
train,1411,119,121856,1665,1665,123521
train,1412,87,89088,941,941,90029
train,1413,106,108544,1188,1188,109732
train,1414,132,135168,1754,1754,136922
train,1415,162,165888,2392,2392,168280
train,1416,248,253952,3828,3828,257780
train,1417,136,139264,1782,1782,141046
train,1418,196,200704,2676,2676,203380
train,1419,158,161792,1966,1966,163758
train,1420,172,176128,2578,2578,178706
train,1421,152,155648,2076,2076,157724
train,1422,223,228352,3369,3369,231721
train,1423,104,106496,1510,1510,108006
train,1424,158,161792,2268,2268,164060
train,1425,152,155648,2166,2166,157814
train,1426,183,187392,2755,2755,190147
train,1427,151,154624,2079,2079,156703
train,1428,106,108544,1346,1346,109890
train,1429,94,96256,1292,1292,97548
train,1430,178,182272,2322,2322,184594
train,1431,131,134144,1727,1727,135871
train,1432,150,153600,2114,2114,155714
train,1433,190,194560,2670,2670,197230
train,1434,173,177152,2435,2435,179587
train,1435,119,121856,1577,1577,123433
train,1436,190,194560,2836,2836,197396
train,1437,209,214016,2817,2817,216833
train,1438,174,178176,2062,2062,180238
train,1439,185,189440,2509,2509,191949
train,1440,100,102400,1098,1098,103498
train,1441,136,139264,1990,1990,141254
train,1442,195,199680,2563,2563,202243
train,1443,166,169984,2196,2196,172180
train,1444,157,160768,2163,2163,162931
train,1445,56,57344,580,580,57924
train,1446,179,183296,2345,2345,185641
train,1447,132,135168,1796,1796,136964
train,1448,104,106496,1236,1236,107732
train,1449,197,201728,3051,3051,204779
train,1450,195,199680,2741,2741,202421
train,1451,148,151552,2138,2138,153690
train,1452,172,176128,2244,2244,178372
train,1453,160,163840,2230,2230,166070
train,1454,136,139264,1978,1978,141242
train,1455,200,204800,2820,2820,207620
train,1456,172,176128,2220,2220,178348
train,1457,217,222208,3181,3181,225389
train,1458,142,145408,2018,2018,147426
train,1459,148,151552,1792,1792,153344
train,1460,206,210944,2792,2792,213736
train,1461,134,137216,1808,1808,139024
train,1462,183,187392,2563,2563,189955
train,1463,110,112640,1356,1356,113996
train,1464,87,89088,1115,1115,90203
train,1465,126,129024,1886,1886,130910
train,1466,229,234496,3205,3205,237701
train,1467,154,157696,2220,2220,159916
train,1468,161,164864,2267,2267,167131
train,1469,185,189440,2703,2703,192143
train,1470,87,89088,1163,1163,90251
train,1471,52,53248,572,572,53820
train,1472,174,178176,2620,2620,180796
train,1473,221,226304,3465,3465,229769
train,1474,174,178176,2502,2502,180678
train,1475,158,161792,2038,2038,163830
train,1476,177,181248,2435,2435,183683
train,1477,119,121856,1867,1867,123723
train,1478,102,104448,1306,1306,105754
train,1479,156,159744,2286,2286,162030
train,1480,108,110592,1244,1244,111836
train,1481,174,178176,2722,2722,180898
train,1482,203,207872,2935,2935,210807
train,1483,165,168960,2149,2149,171109
train,1484,132,135168,1854,1854,137022
train,1485,145,148480,1949,1949,150429
train,1486,102,104448,1338,1338,105786
train,1487,123,125952,1657,1657,127609
train,1488,224,229376,3154,3154,232530
train,1489,126,129024,1442,1442,130466
train,1490,110,112640,1242,1242,113882
train,1491,140,143360,1858,1858,145218
train,1492,180,184320,2430,2430,186750
train,1493,92,94208,1208,1208,95416
train,1494,136,139264,1820,1820,141084
train,1495,56,57344,610,610,57954
train,1496,143,146432,2105,2105,148537
train,1497,208,212992,2800,2800,215792
train,1498,194,198656,3002,3002,201658
train,1499,216,221184,2758,2758,223942
train,1500,136,139264,1782,1782,141046
train,1501,141,144384,1925,1925,146309
train,1502,169,173056,2379,2379,175435
train,1503,194,198656,2704,2704,201360
train,1504,73,74752,895,895,75647
train,1505,72,73728,760,760,74488
train,1506,197,201728,2999,2999,204727
train,1507,175,179200,2401,2401,181601
train,1508,167,171008,2717,2717,173725
train,1509,199,203776,2677,2677,206453
train,1510,250,256000,3598,3598,259598
train,1511,154,157696,2188,2188,159884
train,1512,196,200704,2638,2638,203342
train,1513,216,221184,3094,3094,224278
train,1514,121,123904,1537,1537,125441
train,1515,149,152576,2201,2201,154777
train,1516,126,129024,1644,1644,130668
train,1517,203,207872,3015,3015,210887
train,1518,71,72704,817,817,73521
train,1519,49,50176,611,611,50787
train,1520,125,128000,1657,1657,129657
train,1521,153,156672,2241,2241,158913
train,1522,167,171008,2251,2251,173259
train,1523,119,121856,1545,1545,123401
train,1524,143,146432,1835,1835,148267
train,1525,117,119808,1571,1571,121379
train,1526,67,68608,783,783,69391
train,1527,161,164864,2469,2469,167333
train,1528,134,137216,1678,1678,138894
train,1529,146,149504,2082,2082,151586
train,1530,231,236544,3077,3077,239621
train,1531,168,172032,2346,2346,174378
train,1532,170,174080,2366,2366,176446
train,1533,127,130048,1655,1655,131703
train,1534,163,166912,2471,2471,169383
train,1535,162,165888,2454,2454,168342
train,1536,136,139264,1766,1766,141030
train,1537,171,175104,2441,2441,177545
train,1538,216,221184,2800,2800,223984
train,1539,133,136192,1671,1671,137863
train,1540,120,122880,1600,1600,124480
train,1541,69,70656,837,837,71493
train,1542,148,151552,1936,1936,153488
train,1543,81,82944,1089,1089,84033
train,1544,182,186368,2502,2502,188870
train,1545,122,124928,1716,1716,126644
train,1546,187,191488,2791,2791,194279
train,1547,155,158720,2105,2105,160825
train,1548,189,193536,2721,2721,196257
train,1549,151,154624,2017,2017,156641
train,1550,213,218112,3179,3179,221291
train,1551,211,216064,3419,3419,219483
train,1552,213,218112,3079,3079,221191
train,1553,129,132096,1587,1587,133683
train,1554,85,87040,911,911,87951
train,1555,209,214016,3215,3215,217231
train,1556,160,163840,2196,2196,166036
train,1557,216,221184,3156,3156,224340
train,1558,141,144384,1853,1853,146237
train,1559,135,138240,1855,1855,140095
train,1560,166,169984,2254,2254,172238
train,1561,163,166912,1993,1993,168905
train,1562,161,164864,2227,2227,167091
train,1563,128,131072,1688,1688,132760
train,1564,80,81920,910,910,82830
train,1565,178,182272,2326,2326,184598
train,1566,52,53248,558,558,53806
train,1567,163,166912,2839,2839,169751
train,1568,144,147456,1910,1910,149366
train,1569,181,185344,2327,2327,187671
train,1570,182,186368,2576,2576,188944
train,1571,161,164864,2237,2237,167101
train,1572,131,134144,1723,1723,135867
train,1573,130,133120,1818,1818,134938
train,1574,118,120832,1468,1468,122300
train,1575,93,95232,1169,1169,96401
train,1576,130,133120,1876,1876,134996
train,1577,177,181248,2413,2413,183661
train,1578,122,124928,1592,1592,126520
train,1579,69,70656,785,785,71441
train,1580,95,97280,1247,1247,98527
train,1581,182,186368,2450,2450,188818
train,1582,111,113664,1395,1395,115059
train,1583,116,118784,1554,1554,120338
train,1584,53,54272,599,599,54871
train,1585,140,143360,1900,1900,145260
train,1586,101,103424,1359,1359,104783
train,1587,98,100352,1244,1244,101596
train,1588,197,201728,2899,2899,204627
train,1589,94,96256,1112,1112,97368
train,1590,191,195584,2691,2691,198275
train,1591,161,164864,2401,2401,167265
train,1592,168,172032,2424,2424,174456
train,1593,132,135168,1668,1668,136836
train,1594,133,136192,2115,2115,138307
train,1595,110,112640,1492,1492,114132
train,1596,95,97280,1133,1133,98413
train,1597,92,94208,1130,1130,95338
train,1598,111,113664,1455,1455,115119
train,1599,129,132096,1485,1485,133581
train,1600,160,163840,2268,2268,166108
train,1601,148,151552,2072,2072,153624
train,1602,83,84992,969,969,85961
train,1603,188,192512,2640,2640,195152
train,1604,159,162816,2227,2227,165043
train,1605,147,150528,2029,2029,152557
train,1606,196,200704,2818,2818,203522
train,1607,196,200704,2478,2478,203182
train,1608,167,171008,2459,2459,173467
train,1609,130,133120,1720,1720,134840
train,1610,141,144384,1613,1613,145997
train,1611,119,121856,1433,1433,123289
train,1612,68,69632,772,772,70404
train,1613,98,100352,1150,1150,101502
train,1614,215,220160,3251,3251,223411
train,1615,139,142336,1825,1825,144161
train,1616,70,71680,800,800,72480
train,1617,233,238592,3797,3797,242389
train,1618,234,239616,2984,2984,242600
train,1619,135,138240,1917,1917,140157
train,1620,139,142336,1877,1877,144213
train,1621,186,190464,2452,2452,192916
train,1622,151,154624,2037,2037,156661
train,1623,121,123904,1587,1587,125491
train,1624,166,169984,2146,2146,172130
train,1625,139,142336,1971,1971,144307
train,1626,171,175104,2429,2429,177533
train,1627,143,146432,1905,1905,148337
train,1628,105,107520,1303,1303,108823
train,1629,132,135168,1628,1628,136796
train,1630,198,202752,2836,2836,205588
train,1631,72,73728,876,876,74604
train,1632,125,128000,1823,1823,129823
train,1633,107,109568,1325,1325,110893
train,1634,203,207872,2953,2953,210825
train,1635,52,53248,524,524,53772
train,1636,112,114688,1426,1426,116114
train,1637,202,206848,2728,2728,209576
train,1638,166,169984,2280,2280,172264
train,1639,146,149504,2340,2340,151844
train,1640,151,154624,1837,1837,156461
train,1641,141,144384,1959,1959,146343
train,1642,83,84992,1137,1137,86129
train,1643,181,185344,2537,2537,187881
train,1644,128,131072,1764,1764,132836
train,1645,132,135168,1872,1872,137040
train,1646,201,205824,2761,2761,208585
train,1647,66,67584,772,772,68356
train,1648,179,183296,2209,2209,185505
train,1649,186,190464,2732,2732,193196
train,1650,98,100352,1132,1132,101484
train,1651,174,178176,2436,2436,180612
train,1652,101,103424,1201,1201,104625
train,1653,135,138240,2057,2057,140297
train,1654,212,217088,2816,2816,219904
train,1655,136,139264,1748,1748,141012
train,1656,127,130048,1715,1715,131763
train,1657,170,174080,2476,2476,176556
train,1658,143,146432,1625,1625,148057
train,1659,100,102400,1220,1220,103620
train,1660,187,191488,2677,2677,194165
train,1661,68,69632,750,750,70382
train,1662,104,106496,1294,1294,107790
train,1663,190,194560,2690,2690,197250
train,1664,146,149504,2118,2118,151622
train,1665,177,181248,2613,2613,183861
train,1666,178,182272,2534,2534,184806
train,1667,171,175104,2385,2385,177489
train,1668,112,114688,1556,1556,116244
train,1669,211,216064,3113,3113,219177
train,1670,68,69632,790,790,70422
train,1671,123,125952,1589,1589,127541
train,1672,138,141312,1770,1770,143082
train,1673,123,125952,1683,1683,127635
train,1674,118,120832,1490,1490,122322
train,1675,140,143360,1836,1836,145196
train,1676,159,162816,2193,2193,165009
train,1677,208,212992,2558,2558,215550
train,1678,182,186368,2496,2496,188864
train,1679,40,40960,418,418,41378
train,1680,60,61440,668,668,62108
train,1681,48,49152,510,510,49662
train,1682,137,140288,1767,1767,142055
train,1683,181,185344,2389,2389,187733
train,1684,143,146432,1917,1917,148349
train,1685,159,162816,2227,2227,165043
train,1686,233,238592,3219,3219,241811
train,1687,148,151552,1826,1826,153378
train,1688,146,149504,1974,1974,151478
train,1689,153,156672,2309,2309,158981
train,1690,139,142336,1847,1847,144183
train,1691,207,211968,2835,2835,214803
train,1692,131,134144,1763,1763,135907
train,1693,169,173056,2207,2207,175263
train,1694,125,128000,1503,1503,129503
train,1695,49,50176,521,521,50697
train,1696,42,43008,494,494,43502
train,1697,110,112640,1504,1504,114144
train,1698,257,263168,3517,3517,266685
train,1699,172,176128,2418,2418,178546
train,1700,123,125952,1761,1761,127713
train,1701,176,180224,2414,2414,182638
train,1702,138,141312,2020,2020,143332
train,1703,174,178176,2438,2438,180614
train,1704,161,164864,2429,2429,167293
train,1705,164,167936,2428,2428,170364
train,1706,58,59392,642,642,60034
train,1707,118,120832,1514,1514,122346
train,1708,67,68608,743,743,69351
train,1709,157,160768,2287,2287,163055
train,1710,184,188416,2686,2686,191102
train,1711,117,119808,1477,1477,121285
train,1712,82,83968,1000,1000,84968
train,1713,199,203776,2805,2805,206581
train,1714,202,206848,2934,2934,209782
train,1715,77,78848,931,931,79779
train,1716,194,198656,2632,2632,201288
train,1717,115,117760,1329,1329,119089
train,1718,86,88064,1136,1136,89200
train,1719,173,177152,2597,2597,179749
train,1720,202,206848,3152,3152,210000
train,1721,152,155648,2064,2064,157712
train,1722,144,147456,2014,2014,149470
train,1723,198,202752,2866,2866,205618
train,1724,156,159744,2324,2324,162068
train,1725,185,189440,2869,2869,192309
train,1726,163,166912,2237,2237,169149
train,1727,166,169984,2456,2456,172440
train,1728,122,124928,1540,1540,126468
train,1729,99,101376,1291,1291,102667
train,1730,127,130048,1639,1639,131687
train,1731,59,60416,655,655,61071
train,1732,168,172032,2420,2420,174452
train,1733,178,182272,2482,2482,184754
train,1734,126,129024,1500,1500,130524
train,1735,78,79872,824,824,80696
train,1736,153,156672,2221,2221,158893
train,1737,220,225280,3602,3602,228882
train,1738,173,177152,2473,2473,179625
train,1739,88,90112,1036,1036,91148
train,1740,149,152576,1935,1935,154511
train,1741,180,184320,2536,2536,186856
train,1742,132,135168,1716,1716,136884
train,1743,179,183296,2945,2945,186241
train,1744,104,106496,1362,1362,107858
train,1745,132,135168,1772,1772,136940
train,1746,85,87040,877,877,87917
train,1747,154,157696,1980,1980,159676
train,1748,181,185344,2495,2495,187839
train,1749,108,110592,1336,1336,111928
train,1750,197,201728,3065,3065,204793
train,1751,110,112640,1504,1504,114144
train,1752,31,31744,331,331,32075
train,1753,121,123904,1533,1533,125437
train,1754,153,156672,2037,2037,158709
train,1755,76,77824,946,946,78770
train,1756,78,79872,908,908,80780
train,1757,152,155648,2248,2248,157896
train,1758,114,116736,1354,1354,118090
train,1759,99,101376,1237,1237,102613
train,1760,177,181248,2469,2469,183717
train,1761,109,111616,1389,1389,113005
train,1762,83,84992,1019,1019,86011
train,1763,114,116736,1330,1330,118066
train,1764,154,157696,1852,1852,159548
train,1765,80,81920,864,864,82784
train,1766,159,162816,2107,2107,164923
train,1767,128,131072,1580,1580,132652
train,1768,195,199680,2679,2679,202359
train,1769,128,131072,1660,1660,132732
train,1770,159,162816,2087,2087,164903
train,1771,177,181248,2449,2449,183697
train,1772,233,238592,3399,3399,241991
train,1773,227,232448,3611,3611,236059
train,1774,132,135168,1748,1748,136916
train,1775,94,96256,1158,1158,97414
train,1776,156,159744,2022,2022,161766
train,1777,206,210944,2826,2826,213770
train,1778,109,111616,1305,1305,112921
train,1779,197,201728,2611,2611,204339
train,1780,87,89088,1087,1087,90175
train,1781,148,151552,1866,1866,153418
train,1782,201,205824,3265,3265,209089
train,1783,188,192512,2752,2752,195264
train,1784,94,96256,1200,1200,97456
train,1785,179,183296,2365,2365,185661
train,1786,238,243712,3606,3606,247318
train,1787,101,103424,1219,1219,104643
train,1788,148,151552,2248,2248,153800
train,1789,192,196608,2634,2634,199242
train,1790,127,130048,1649,1649,131697
train,1791,130,133120,1658,1658,134778
train,1792,176,180224,2368,2368,182592
train,1793,135,138240,1829,1829,140069
train,1794,130,133120,1704,1704,134824
train,1795,107,109568,1315,1315,110883
train,1796,82,83968,908,908,84876
train,1797,74,75776,844,844,76620
train,1798,128,131072,1602,1602,132674
train,1799,189,193536,2793,2793,196329
train,1800,140,143360,1860,1860,145220
train,1801,175,179200,2655,2655,181855
train,1802,212,217088,2744,2744,219832
train,1803,187,191488,2713,2713,194201
train,1804,199,203776,2895,2895,206671
train,1805,125,128000,1735,1735,129735
train,1806,99,101376,1393,1393,102769
train,1807,143,146432,1941,1941,148373
train,1808,232,237568,3260,3260,240828
train,1809,56,57344,640,640,57984
train,1810,159,162816,2457,2457,165273
train,1811,113,115712,1453,1453,117165
train,1812,183,187392,2605,2605,189997
train,1813,110,112640,1472,1472,114112
train,1814,84,86016,1034,1034,87050
train,1815,115,117760,1595,1595,119355
train,1816,124,126976,1726,1726,128702
train,1817,96,98304,1160,1160,99464
train,1818,56,57344,646,646,57990
train,1819,112,114688,1452,1452,116140
train,1820,64,65536,600,600,66136
train,1821,189,193536,2735,2735,196271
train,1822,60,61440,736,736,62176
train,1823,134,137216,1804,1804,139020
train,1824,168,172032,2242,2242,174274
train,1825,150,153600,1992,1992,155592
train,1826,175,179200,2543,2543,181743
train,1827,146,149504,1980,1980,151484
train,1828,76,77824,900,900,78724
train,1829,170,174080,2462,2462,176542
train,1830,188,192512,2698,2698,195210
train,1831,151,154624,2219,2219,156843
train,1832,177,181248,2623,2623,183871
train,1833,113,115712,1491,1491,117203
train,1834,93,95232,1063,1063,96295
train,1835,169,173056,2601,2601,175657
train,1836,183,187392,2613,2613,190005
train,1837,180,184320,2562,2562,186882
train,1838,190,194560,2904,2904,197464
train,1839,179,183296,2683,2683,185979
train,1840,91,93184,1067,1067,94251
train,1841,128,131072,1650,1650,132722
train,1842,166,169984,2334,2334,172318
train,1843,188,192512,2544,2544,195056
train,1844,113,115712,1463,1463,117175
train,1845,132,135168,1894,1894,137062
train,1846,136,139264,1726,1726,140990
train,1847,137,140288,1827,1827,142115
train,1848,220,225280,3052,3052,228332
train,1849,199,203776,2721,2721,206497
train,1850,117,119808,1699,1699,121507
train,1851,142,145408,1904,1904,147312
train,1852,132,135168,1854,1854,137022
train,1853,136,139264,1974,1974,141238
train,1854,142,145408,1896,1896,147304
train,1855,129,132096,1793,1793,133889
train,1856,171,175104,2407,2407,177511
train,1857,72,73728,812,812,74540
train,1858,170,174080,2688,2688,176768
train,1859,145,148480,1793,1793,150273
train,1860,102,104448,1222,1222,105670
train,1861,166,169984,2440,2440,172424
train,1862,169,173056,2047,2047,175103
train,1863,154,157696,1860,1860,159556
train,1864,187,191488,2641,2641,194129
train,1865,128,131072,1472,1472,132544
train,1866,115,117760,1417,1417,119177
train,1867,196,200704,2710,2710,203414
train,1868,114,116736,1508,1508,118244
train,1869,181,185344,2391,2391,187735
train,1870,54,55296,608,608,55904
train,1871,125,128000,1609,1609,129609
train,1872,193,197632,2777,2777,200409
train,1873,173,177152,2887,2887,180039
train,1874,169,173056,2365,2365,175421
train,1875,191,195584,2751,2751,198335
train,1876,135,138240,1663,1663,139903
train,1877,127,130048,1599,1599,131647
train,1878,98,100352,1142,1142,101494
train,1879,37,37888,365,365,38253
train,1880,152,155648,2016,2016,157664
train,1881,98,100352,1124,1124,101476
train,1882,97,99328,1125,1125,100453
train,1883,117,119808,1365,1365,121173
train,1884,99,101376,1333,1333,102709
train,1885,76,77824,842,842,78666
train,1886,100,102400,1208,1208,103608
train,1887,109,111616,1259,1259,112875
train,1888,229,234496,3603,3603,238099
train,1889,63,64512,621,621,65133
train,1890,163,166912,2077,2077,168989
train,1891,108,110592,1230,1230,111822
train,1892,150,153600,2108,2108,155708
train,1893,141,144384,1735,1735,146119
train,1894,116,118784,1598,1598,120382
train,1895,101,103424,1189,1189,104613
train,1896,103,105472,1271,1271,106743
train,1897,208,212992,2826,2826,215818
train,1898,148,151552,2392,2392,153944
train,1899,165,168960,2467,2467,171427
train,1900,211,216064,3269,3269,219333
train,1901,155,158720,2079,2079,160799
train,1902,150,153600,1962,1962,155562
train,1903,137,140288,1913,1913,142201
train,1904,153,156672,2077,2077,158749
train,1905,123,125952,1467,1467,127419
train,1906,196,200704,2850,2850,203554
train,1907,194,198656,2822,2822,201478
train,1908,176,180224,2268,2268,182492
train,1909,162,165888,2172,2172,168060
train,1910,191,195584,2727,2727,198311
train,1911,117,119808,1715,1715,121523
train,1912,164,167936,2616,2616,170552
train,1913,202,206848,2732,2732,209580
train,1914,222,227328,3050,3050,230378
train,1915,225,230400,3265,3265,233665
train,1916,211,216064,2949,2949,219013
train,1917,181,185344,2805,2805,188149
train,1918,117,119808,1487,1487,121295
train,1919,70,71680,870,870,72550
train,1920,128,131072,1658,1658,132730
train,1921,144,147456,1980,1980,149436
train,1922,99,101376,1209,1209,102585
train,1923,199,203776,3051,3051,206827
train,1924,110,112640,1344,1344,113984
train,1925,116,118784,1470,1470,120254
train,1926,176,180224,2510,2510,182734
train,1927,216,221184,2752,2752,223936
train,1928,139,142336,2111,2111,144447
train,1929,168,172032,2484,2484,174516
train,1930,129,132096,1639,1639,133735
train,1931,111,113664,1485,1485,115149
train,1932,222,227328,3290,3290,230618
train,1933,130,133120,1838,1838,134958
train,1934,175,179200,2447,2447,181647
train,1935,73,74752,865,865,75617
train,1936,158,161792,2176,2176,163968
train,1937,125,128000,1695,1695,129695
train,1938,118,120832,1634,1634,122466
train,1939,98,100352,1066,1066,101418
train,1940,178,182272,2590,2590,184862
train,1941,100,102400,1140,1140,103540
train,1942,193,197632,2463,2463,200095
train,1943,227,232448,3255,3255,235703
train,1944,55,56320,583,583,56903
train,1945,136,139264,1802,1802,141066
train,1946,48,49152,486,486,49638
train,1947,71,72704,839,839,73543
train,1948,198,202752,2838,2838,205590
train,1949,173,177152,2645,2645,179797
train,1950,189,193536,2515,2515,196051
train,1951,71,72704,859,859,73563
train,1952,141,144384,1891,1891,146275
train,1953,165,168960,2263,2263,171223
train,1954,208,212992,3022,3022,216014
train,1955,50,51200,546,546,51746
train,1956,186,190464,2456,2456,192920
train,1957,67,68608,865,865,69473
train,1958,171,175104,2249,2249,177353
train,1959,146,149504,1784,1784,151288
train,1960,117,119808,1335,1335,121143
train,1961,191,195584,3021,3021,198605
train,1962,115,117760,1317,1317,119077
train,1963,128,131072,1536,1536,132608
train,1964,126,129024,1638,1638,130662
train,1965,110,112640,1356,1356,113996
train,1966,209,214016,2979,2979,216995
train,1967,315,322560,4563,4563,327123
train,1968,79,80896,1143,1143,82039
train,1969,115,117760,1665,1665,119425
train,1970,113,115712,1663,1663,117375
train,1971,108,110592,1538,1538,112130
train,1972,141,144384,2095,2095,146479
train,1973,62,63488,722,722,64210
train,1974,66,67584,756,756,68340
train,1975,88,90112,1100,1100,91212
train,1976,122,124928,1562,1562,126490
train,1977,71,72704,773,773,73477
train,1978,179,183296,2601,2601,185897
train,1979,191,195584,2809,2809,198393
train,1980,200,204800,2734,2734,207534
train,1981,162,165888,2090,2090,167978
train,1982,204,208896,3388,3388,212284
train,1983,90,92160,1110,1110,93270
train,1984,162,165888,2222,2222,168110
train,1985,231,236544,3069,3069,239613
train,1986,139,142336,2015,2015,144351
train,1987,124,126976,1504,1504,128480
train,1988,102,104448,1224,1224,105672
train,1989,85,87040,1077,1077,88117
train,1990,114,116736,1500,1500,118236
train,1991,78,79872,892,892,80764
train,1992,201,205824,2707,2707,208531
train,1993,107,109568,1287,1287,110855
train,1994,154,157696,2116,2116,159812
train,1995,127,130048,1655,1655,131703
train,1996,133,136192,1893,1893,138085
train,1997,101,103424,1213,1213,104637
train,1998,135,138240,1721,1721,139961
train,1999,197,201728,2805,2805,204533
train,2000,111,113664,1515,1515,115179
train,2001,110,112640,1410,1410,114050
train,2002,215,220160,3359,3359,223519
train,2003,125,128000,1725,1725,129725
train,2004,200,204800,2704,2704,207504
train,2005,133,136192,1687,1687,137879
train,2006,149,152576,1977,1977,154553
train,2007,105,107520,1301,1301,108821
train,2008,79,80896,831,831,81727
train,2009,176,180224,2840,2840,183064
train,2010,173,177152,2447,2447,179599
train,2011,170,174080,2464,2464,176544
train,2012,95,97280,1189,1189,98469
train,2013,191,195584,2671,2671,198255
train,2014,119,121856,1489,1489,123345
train,2015,90,92160,1138,1138,93298
train,2016,156,159744,2296,2296,162040
train,2017,53,54272,589,589,54861
train,2018,50,51200,522,522,51722
train,2019,138,141312,1916,1916,143228
train,2020,193,197632,2649,2649,200281
train,2021,198,202752,2750,2750,205502
train,2022,114,116736,1530,1530,118266
train,2023,193,197632,2503,2503,200135
train,2024,123,125952,1707,1707,127659
train,2025,161,164864,2369,2369,167233
train,2026,180,184320,2740,2740,187060
train,2027,105,107520,1233,1233,108753
train,2028,190,194560,2806,2806,197366
train,2029,232,237568,3222,3222,240790
train,2030,176,180224,2340,2340,182564
train,2031,188,192512,2654,2654,195166
train,2032,33,33792,345,345,34137
train,2033,68,69632,714,714,70346
train,2034,268,274432,3812,3812,278244
train,2035,121,123904,1615,1615,125519
train,2036,225,230400,3063,3063,233463
train,2037,130,133120,1864,1864,134984
train,2038,155,158720,2169,2169,160889
train,2039,151,154624,2119,2119,156743
train,2040,95,97280,1255,1255,98535
train,2041,124,126976,1672,1672,128648
train,2042,142,145408,1780,1780,147188
train,2043,117,119808,1453,1453,121261
train,2044,129,132096,1625,1625,133721
train,2045,68,69632,734,734,70366
train,2046,110,112640,1344,1344,113984
train,2047,227,232448,3419,3419,235867
train,2048,127,130048,2039,2039,132087
train,2049,166,169984,2420,2420,172404
train,2050,121,123904,1691,1691,125595
train,2051,176,180224,2520,2520,182744
train,2052,134,137216,1794,1794,139010
train,2053,173,177152,2495,2495,179647
train,2054,195,199680,2577,2577,202257
train,2055,57,58368,685,685,59053
train,2056,189,193536,2711,2711,196247
train,2057,110,112640,1624,1624,114264
train,2058,99,101376,1459,1459,102835
train,2059,137,140288,1891,1891,142179
train,2060,210,215040,2650,2650,217690
train,2061,124,126976,1666,1666,128642
train,2062,146,149504,1712,1712,151216
train,2063,129,132096,2077,2077,134173
train,2064,136,139264,1612,1612,140876
train,2065,79,80896,911,911,81807
train,2066,102,104448,1442,1442,105890
train,2067,111,113664,1489,1489,115153
train,2068,190,194560,2728,2728,197288
train,2069,166,169984,2496,2496,172480
train,2070,150,153600,2182,2182,155782
train,2071,210,215040,3232,3232,218272
train,2072,134,137216,1776,1776,138992
train,2073,142,145408,2016,2016,147424
train,2074,140,143360,1822,1822,145182
train,2075,64,65536,696,696,66232
train,2076,85,87040,963,963,88003
train,2077,180,184320,2504,2504,186824
train,2078,211,216064,3179,3179,219243
train,2079,101,103424,1165,1165,104589
train,2080,90,92160,1076,1076,93236
train,2081,258,264192,3368,3368,267560
train,2082,161,164864,2305,2305,167169
train,2083,91,93184,1241,1241,94425
train,2084,182,186368,2416,2416,188784
train,2085,194,198656,2770,2770,201426
train,2086,90,92160,1000,1000,93160
train,2087,105,107520,1307,1307,108827
train,2088,152,155648,2110,2110,157758
train,2089,195,199680,3179,3179,202859
train,2090,128,131072,1832,1832,132904
train,2091,220,225280,3052,3052,228332
train,2092,91,93184,1095,1095,94279
train,2093,113,115712,1565,1565,117277
train,2094,161,164864,2339,2339,167203
train,2095,171,175104,2599,2599,177703
train,2096,158,161792,2190,2190,163982
train,2097,180,184320,2454,2454,186774
train,2098,155,158720,2273,2273,160993
train,2099,165,168960,2551,2551,171511
train,2100,137,140288,1873,1873,142161
train,2101,71,72704,815,815,73519
train,2102,99,101376,1351,1351,102727
train,2103,87,89088,1115,1115,90203
train,2104,172,176128,2588,2588,178716
train,2105,144,147456,1932,1932,149388
train,2106,171,175104,2433,2433,177537
train,2107,112,114688,1416,1416,116104
train,2108,127,130048,1595,1595,131643
train,2109,165,168960,2363,2363,171323
train,2110,91,93184,1221,1221,94405
train,2111,96,98304,1122,1122,99426
train,2112,149,152576,2369,2369,154945
train,2113,115,117760,1421,1421,119181
train,2114,131,134144,1777,1777,135921
train,2115,131,134144,1817,1817,135961
train,2116,115,117760,1223,1223,118983
train,2117,177,181248,2817,2817,184065
train,2118,156,159744,2202,2202,161946
train,2119,169,173056,2467,2467,175523
train,2120,187,191488,2579,2579,194067
train,2121,157,160768,2509,2509,163277
train,2122,140,143360,2096,2096,145456
train,2123,55,56320,593,593,56913
train,2124,104,106496,1356,1356,107852
train,2125,165,168960,2147,2147,171107
train,2126,183,187392,2733,2733,190125
train,2127,62,63488,702,702,64190
train,2128,82,83968,1018,1018,84986
train,2129,121,123904,1653,1653,125557
train,2130,103,105472,1293,1293,106765
train,2131,79,80896,991,991,81887
train,2132,170,174080,2418,2418,176498
train,2133,155,158720,2369,2369,161089
train,2134,77,78848,933,933,79781
train,2135,162,165888,2268,2268,168156
train,2136,95,97280,1317,1317,98597
train,2137,176,180224,2592,2592,182816
train,2138,173,177152,2721,2721,179873
train,2139,122,124928,1540,1540,126468
train,2140,173,177152,2165,2165,179317
train,2141,84,86016,1024,1024,87040
train,2142,66,67584,846,846,68430
train,2143,166,169984,2258,2258,172242
train,2144,157,160768,1997,1997,162765
train,2145,168,172032,2290,2290,174322
train,2146,184,188416,2780,2780,191196
train,2147,89,91136,1031,1031,92167
train,2148,89,91136,1121,1121,92257
train,2149,180,184320,2746,2746,187066
train,2150,124,126976,1386,1386,128362
train,2151,58,59392,598,598,59990
train,2152,72,73728,822,822,74550
train,2153,105,107520,1443,1443,108963
train,2154,143,146432,1879,1879,148311
train,2155,257,263168,3837,3837,267005
train,2156,82,83968,914,914,84882
train,2157,89,91136,957,957,92093
train,2158,186,190464,2586,2586,193050
train,2159,139,142336,1863,1863,144199
train,2160,97,99328,1223,1223,100551
train,2161,143,146432,1941,1941,148373
train,2162,159,162816,2157,2157,164973
train,2163,113,115712,1493,1493,117205
train,2164,112,114688,1568,1568,116256
train,2165,66,67584,774,774,68358
train,2166,67,68608,689,689,69297
train,2167,133,136192,1639,1639,137831
train,2168,113,115712,1395,1395,117107
train,2169,165,168960,2155,2155,171115
train,2170,101,103424,1263,1263,104687
train,2171,149,152576,2135,2135,154711
train,2172,97,99328,1355,1355,100683
train,2173,112,114688,1452,1452,116140
train,2174,92,94208,1116,1116,95324
train,2175,145,148480,2011,2011,150491
train,2176,131,134144,1653,1653,135797
train,2177,277,283648,4399,4399,288047
train,2178,163,166912,2363,2363,169275
train,2179,145,148480,1799,1799,150279
train,2180,138,141312,1862,1862,143174
train,2181,133,136192,1631,1631,137823
train,2182,146,149504,1964,1964,151468
train,2183,151,154624,2025,2025,156649
train,2184,137,140288,1711,1711,141999
train,2185,82,83968,938,938,84906
train,2186,167,171008,2487,2487,173495
train,2187,148,151552,2030,2030,153582
train,2188,79,80896,877,877,81773
train,2189,193,197632,2689,2689,200321
train,2190,102,104448,1398,1398,105846
train,2191,142,145408,1822,1822,147230
train,2192,118,120832,1628,1628,122460
train,2193,178,182272,2660,2660,184932
train,2194,178,182272,2786,2786,185058
train,2195,215,220160,3123,3123,223283
train,2196,153,156672,2133,2133,158805
train,2197,86,88064,1026,1026,89090
train,2198,104,106496,1278,1278,107774
train,2199,137,140288,2077,2077,142365
train,2200,131,134144,1985,1985,136129
train,2201,198,202752,3088,3088,205840
train,2202,151,154624,1873,1873,156497
train,2203,203,207872,2913,2913,210785
train,2204,155,158720,2109,2109,160829
train,2205,149,152576,2129,2129,154705
train,2206,132,135168,1764,1764,136932
train,2207,73,74752,809,809,75561
train,2208,150,153600,1940,1940,155540
train,2209,219,224256,2917,2917,227173
train,2210,118,120832,1542,1542,122374
train,2211,157,160768,2223,2223,162991
train,2212,113,115712,1363,1363,117075
train,2213,141,144384,1813,1813,146197
train,2214,144,147456,1772,1772,149228
train,2215,120,122880,1466,1466,124346
train,2216,227,232448,2959,2959,235407
train,2217,121,123904,1499,1499,125403
train,2218,176,180224,2526,2526,182750
train,2219,180,184320,2406,2406,186726
train,2220,184,188416,2532,2532,190948
train,2221,199,203776,2801,2801,206577
train,2222,53,54272,561,561,54833
train,2223,143,146432,1723,1723,148155
train,2224,197,201728,2741,2741,204469
train,2225,174,178176,2472,2472,180648
train,2226,154,157696,2074,2074,159770
train,2227,61,62464,689,689,63153
train,2228,154,157696,1914,1914,159610
train,2229,136,139264,1802,1802,141066
train,2230,167,171008,2225,2225,173233
train,2231,119,121856,1577,1577,123433
train,2232,52,53248,528,528,53776
train,2233,160,163840,2396,2396,166236
train,2234,187,191488,2615,2615,194103
train,2235,69,70656,783,783,71439
train,2236,203,207872,2857,2857,210729
train,2237,80,81920,916,916,82836
train,2238,115,117760,1539,1539,119299
train,2239,106,108544,1272,1272,109816
train,2240,127,130048,1453,1453,131501
train,2241,103,105472,1283,1283,106755
train,2242,128,131072,1644,1644,132716
train,2243,145,148480,1889,1889,150369
train,2244,117,119808,1633,1633,121441
train,2245,187,191488,2633,2633,194121
train,2246,126,129024,1656,1656,130680
train,2247,143,146432,1745,1745,148177
train,2248,183,187392,2741,2741,190133
train,2249,118,120832,1888,1888,122720
train,2250,238,243712,3478,3478,247190
train,2251,61,62464,677,677,63141
train,2252,105,107520,1423,1423,108943
train,2253,103,105472,1329,1329,106801
train,2254,191,195584,2913,2913,198497
train,2255,192,196608,2902,2902,199510
train,2256,149,152576,1881,1881,154457
train,2257,200,204800,2598,2598,207398
train,2258,141,144384,1929,1929,146313
train,2259,183,187392,2773,2773,190165
train,2260,118,120832,1518,1518,122350
train,2261,185,189440,2785,2785,192225
train,2262,202,206848,2662,2662,209510
train,2263,90,92160,1034,1034,93194
train,2264,135,138240,1839,1839,140079
train,2265,137,140288,2015,2015,142303
train,2266,263,269312,3741,3741,273053
train,2267,139,142336,1783,1783,144119
train,2268,88,90112,1040,1040,91152
train,2269,88,90112,1126,1126,91238
train,2270,138,141312,1886,1886,143198
train,2271,144,147456,1926,1926,149382
train,2272,129,132096,1671,1671,133767
train,2273,51,52224,639,639,52863
train,2274,174,178176,2270,2270,180446
train,2275,166,169984,2168,2168,172152
train,2276,182,186368,2620,2620,188988
train,2277,164,167936,2266,2266,170202
train,2278,236,241664,3458,3458,245122
train,2279,145,148480,2111,2111,150591
train,2280,164,167936,2154,2154,170090
train,2281,207,211968,2907,2907,214875
train,2282,159,162816,2419,2419,165235
train,2283,196,200704,2918,2918,203622
train,2284,100,102400,1374,1374,103774
train,2285,246,251904,3818,3818,255722
train,2286,124,126976,1652,1652,128628
train,2287,159,162816,2273,2273,165089
train,2288,125,128000,1755,1755,129755
train,2289,98,100352,1356,1356,101708
train,2290,36,36864,376,376,37240
train,2291,182,186368,2432,2432,188800
train,2292,67,68608,759,759,69367
train,2293,130,133120,1704,1704,134824
train,2294,172,176128,2400,2400,178528
train,2295,72,73728,824,824,74552
train,2296,153,156672,2327,2327,158999
train,2297,112,114688,1390,1390,116078
train,2298,142,145408,2004,2004,147412
train,2299,138,141312,1950,1950,143262
train,2300,125,128000,1643,1643,129643
train,2301,134,137216,1784,1784,139000
train,2302,99,101376,1385,1385,102761
train,2303,139,142336,1837,1837,144173
train,2304,200,204800,2602,2602,207402
train,2305,145,148480,2241,2241,150721
train,2306,229,234496,3489,3489,237985
train,2307,75,76800,897,897,77697
train,2308,116,118784,1558,1558,120342
train,2309,145,148480,1983,1983,150463
train,2310,175,179200,2447,2447,181647
train,2311,123,125952,1499,1499,127451
train,2312,161,164864,2353,2353,167217
train,2313,152,155648,2272,2272,157920
train,2314,166,169984,2266,2266,172250
train,2315,180,184320,2346,2346,186666
train,2316,143,146432,1977,1977,148409
train,2317,129,132096,1711,1711,133807
train,2318,114,116736,1510,1510,118246
train,2319,135,138240,1825,1825,140065
train,2320,97,99328,1115,1115,100443
train,2321,164,167936,2388,2388,170324
train,2322,172,176128,2472,2472,178600
train,2323,124,126976,2012,2012,128988
train,2324,141,144384,1803,1803,146187
train,2325,123,125952,1683,1683,127635
train,2326,167,171008,2595,2595,173603
train,2327,181,185344,2289,2289,187633
train,2328,115,117760,1621,1621,119381
train,2329,137,140288,1875,1875,142163
train,2330,76,77824,1040,1040,78864
train,2331,89,91136,1041,1041,92177
train,2332,159,162816,2233,2233,165049
train,2333,122,124928,1764,1764,126692
train,2334,151,154624,2221,2221,156845
train,2335,129,132096,1853,1853,133949
train,2336,203,207872,2789,2789,210661
train,2337,183,187392,2471,2471,189863
train,2338,217,222208,3047,3047,225255
train,2339,119,121856,1443,1443,123299
train,2340,143,146432,1753,1753,148185
train,2341,196,200704,2890,2890,203594
train,2342,147,150528,1791,1791,152319
train,2343,166,169984,2464,2464,172448
train,2344,100,102400,1232,1232,103632
train,2345,126,129024,1556,1556,130580
train,2346,139,142336,1727,1727,144063
train,2347,170,174080,2440,2440,176520
train,2348,87,89088,977,977,90065
train,2349,104,106496,1246,1246,107742
train,2350,148,151552,1990,1990,153542
train,2351,178,182272,2402,2402,184674
train,2352,202,206848,3124,3124,209972
train,2353,69,70656,785,785,71441
train,2354,128,131072,1580,1580,132652
train,2355,79,80896,1023,1023,81919
train,2356,106,108544,1276,1276,109820
train,2357,183,187392,2427,2427,189819
train,2358,119,121856,1661,1661,123517
train,2359,127,130048,1593,1593,131641
train,2360,95,97280,1041,1041,98321
train,2361,204,208896,2602,2602,211498
train,2362,159,162816,1951,1951,164767
train,2363,94,96256,1266,1266,97522
train,2364,197,201728,3249,3249,204977
train,2365,101,103424,1245,1245,104669
train,2366,202,206848,2782,2782,209630
train,2367,199,203776,2703,2703,206479
train,2368,137,140288,1777,1777,142065
train,2369,169,173056,2491,2491,175547
train,2370,170,174080,2224,2224,176304
train,2371,146,149504,1974,1974,151478
train,2372,95,97280,1231,1231,98511
train,2373,187,191488,2647,2647,194135
train,2374,185,189440,2779,2779,192219
train,2375,199,203776,2811,2811,206587
train,2376,122,124928,1432,1432,126360
train,2377,123,125952,1679,1679,127631
train,2378,81,82944,917,917,83861
train,2379,132,135168,1676,1676,136844
train,2380,165,168960,2295,2295,171255
train,2381,132,135168,1712,1712,136880
train,2382,74,75776,872,872,76648
train,2383,198,202752,2858,2858,205610
train,2384,92,94208,1194,1194,95402
train,2385,188,192512,2642,2642,195154
train,2386,134,137216,1774,1774,138990
train,2387,57,58368,645,645,59013
train,2388,77,78848,881,881,79729
train,2389,116,118784,1454,1454,120238
train,2390,169,173056,2311,2311,175367
train,2391,39,39936,403,403,40339
train,2392,86,88064,1242,1242,89306
train,2393,141,144384,1921,1921,146305
train,2394,126,129024,1528,1528,130552
train,2395,106,108544,1490,1490,110034
train,2396,97,99328,1201,1201,100529
train,2397,135,138240,1869,1869,140109
train,2398,117,119808,1389,1389,121197
train,2399,133,136192,1909,1909,138101
train,2400,119,121856,1475,1475,123331
train,2401,117,119808,1523,1523,121331
train,2402,154,157696,2138,2138,159834
train,2403,152,155648,2068,2068,157716
train,2404,172,176128,2342,2342,178470
train,2405,124,126976,1740,1740,128716
train,2406,63,64512,729,729,65241
train,2407,149,152576,1929,1929,154505
train,2408,92,94208,1142,1142,95350
train,2409,160,163840,2282,2282,166122
train,2410,84,86016,996,996,87012
train,2411,125,128000,1375,1375,129375
train,2412,138,141312,1926,1926,143238
train,2413,164,167936,2202,2202,170138
train,2414,148,151552,1888,1888,153440
train,2415,182,186368,2246,2246,188614
train,2416,136,139264,1704,1704,140968
train,2417,129,132096,1903,1903,133999
train,2418,181,185344,2695,2695,188039
train,2419,154,157696,2116,2116,159812
train,2420,188,192512,2680,2680,195192
train,2421,132,135168,1720,1720,136888
train,2422,146,149504,1860,1860,151364
train,2423,257,263168,3759,3759,266927
train,2424,202,206848,2776,2776,209624
train,2425,111,113664,1365,1365,115029
train,2426,181,185344,2589,2589,187933
train,2427,149,152576,1859,1859,154435
train,2428,133,136192,1703,1703,137895
train,2429,32,32768,328,328,33096
train,2430,150,153600,2094,2094,155694
train,2431,92,94208,1132,1132,95340
train,2432,145,148480,2173,2173,150653
train,2433,199,203776,2777,2777,206553
train,2434,192,196608,2746,2746,199354
train,2435,95,97280,1063,1063,98343
train,2436,176,180224,2576,2576,182800
train,2437,129,132096,1701,1701,133797
train,2438,120,122880,1632,1632,124512
train,2439,91,93184,1135,1135,94319
train,2440,159,162816,2189,2189,165005
train,2441,132,135168,1866,1866,137034
train,2442,116,118784,1500,1500,120284
train,2443,155,158720,2083,2083,160803
train,2444,134,137216,1670,1670,138886
train,2445,62,63488,630,630,64118
train,2446,96,98304,1292,1292,99596
train,2447,101,103424,1467,1467,104891
train,2448,106,108544,1366,1366,109910
train,2449,195,199680,2947,2947,202627
train,2450,124,126976,1650,1650,128626
train,2451,129,132096,1785,1785,133881
train,2452,123,125952,1457,1457,127409
train,2453,206,210944,2822,2822,213766
train,2454,160,163840,2122,2122,165962
train,2455,133,136192,1831,1831,138023
train,2456,135,138240,1783,1783,140023
train,2457,174,178176,2402,2402,180578
train,2458,98,100352,1270,1270,101622
train,2459,149,152576,2361,2361,154937
train,2460,95,97280,1055,1055,98335
train,2461,130,133120,1754,1754,134874
train,2462,141,144384,1875,1875,146259
train,2463,192,196608,2792,2792,199400
train,2464,151,154624,1707,1707,156331
train,2465,97,99328,1143,1143,100471
train,2466,202,206848,2832,2832,209680
train,2467,138,141312,1808,1808,143120
train,2468,67,68608,679,679,69287
train,2469,166,169984,2498,2498,172482
train,2470,100,102400,1200,1200,103600
train,2471,95,97280,1223,1223,98503
train,2472,87,89088,1153,1153,90241
train,2473,50,51200,518,518,51718
train,2474,159,162816,2265,2265,165081
train,2475,111,113664,1551,1551,115215
train,2476,209,214016,2877,2877,216893
train,2477,158,161792,1978,1978,163770
train,2478,128,131072,1582,1582,132654
train,2479,99,101376,1365,1365,102741
train,2480,179,183296,2497,2497,185793
train,2481,139,142336,1647,1647,143983
train,2482,144,147456,2058,2058,149514
train,2483,116,118784,1450,1450,120234
train,2484,165,168960,2087,2087,171047
train,2485,80,81920,952,952,82872
train,2486,56,57344,614,614,57958
train,2487,110,112640,1500,1500,114140
train,2488,129,132096,1921,1921,134017
train,2489,168,172032,2330,2330,174362
train,2490,108,110592,1322,1322,111914
train,2491,193,197632,2889,2889,200521
train,2492,101,103424,1105,1105,104529
train,2493,45,46080,487,487,46567
train,2494,92,94208,1080,1080,95288
train,2495,130,133120,1764,1764,134884
train,2496,162,165888,2040,2040,167928
train,2497,65,66560,755,755,67315
train,2498,147,150528,1931,1931,152459
train,2499,161,164864,2431,2431,167295
train,2500,187,191488,2619,2619,194107
train,2501,87,89088,963,963,90051
train,2502,148,151552,1954,1954,153506
train,2503,117,119808,1393,1393,121201
train,2504,163,166912,2099,2099,169011
train,2505,139,142336,1831,1831,144167
train,2506,145,148480,1867,1867,150347
train,2507,128,131072,1560,1560,132632
train,2508,139,142336,1785,1785,144121
train,2509,69,70656,755,755,71411
train,2510,113,115712,1401,1401,117113
train,2511,187,191488,2909,2909,194397
train,2512,126,129024,1558,1558,130582
train,2513,85,87040,1051,1051,88091
train,2514,253,259072,3739,3739,262811
train,2515,155,158720,2225,2225,160945
train,2516,179,183296,2665,2665,185961
train,2517,253,259072,3589,3589,262661
train,2518,156,159744,2084,2084,161828
train,2519,72,73728,802,802,74530
train,2520,72,73728,828,828,74556
train,2521,157,160768,2225,2225,162993
train,2522,189,193536,2753,2753,196289
train,2523,110,112640,1218,1218,113858
train,2524,113,115712,1431,1431,117143
train,2525,196,200704,2602,2602,203306
train,2526,60,61440,738,738,62178
train,2527,170,174080,2424,2424,176504
train,2528,82,83968,1022,1022,84990
train,2529,116,118784,1362,1362,120146
train,2530,140,143360,1712,1712,145072
train,2531,115,117760,1583,1583,119343
train,2532,141,144384,2065,2065,146449
train,2533,78,79872,914,914,80786
train,2534,130,133120,1756,1756,134876
train,2535,52,53248,586,586,53834
train,2536,60,61440,764,764,62204
train,2537,109,111616,1325,1325,112941
train,2538,140,143360,1914,1914,145274
train,2539,62,63488,704,704,64192
train,2540,46,47104,508,508,47612
train,2541,142,145408,1456,1456,146864
train,2542,118,120832,1622,1622,122454
train,2543,157,160768,2271,2271,163039
train,2544,147,150528,2095,2095,152623
train,2545,122,124928,1522,1522,126450
train,2546,173,177152,2411,2411,179563
train,2547,141,144384,2039,2039,146423
train,2548,154,157696,2202,2202,159898
train,2549,69,70656,799,799,71455
train,2550,155,158720,2179,2179,160899
train,2551,161,164864,2455,2455,167319
train,2552,79,80896,907,907,81803
train,2553,182,186368,2486,2486,188854
train,2554,108,110592,1344,1344,111936
train,2555,196,200704,2926,2926,203630
train,2556,151,154624,1761,1761,156385
train,2557,85,87040,1077,1077,88117
train,2558,169,173056,2195,2195,175251
train,2559,92,94208,1036,1036,95244
train,2560,91,93184,1147,1147,94331
train,2561,159,162816,2273,2273,165089
train,2562,144,147456,1760,1760,149216
train,2563,130,133120,1758,1758,134878
train,2564,48,49152,462,462,49614
train,2565,99,101376,1171,1171,102547
train,2566,63,64512,683,683,65195
train,2567,154,157696,2138,2138,159834
train,2568,132,135168,1754,1754,136922
train,2569,122,124928,1580,1580,126508
train,2570,191,195584,2551,2551,198135
train,2571,197,201728,2735,2735,204463
train,2572,133,136192,1643,1643,137835
train,2573,180,184320,2512,2512,186832
train,2574,132,135168,1826,1826,136994
train,2575,219,224256,2831,2831,227087
train,2576,163,166912,2361,2361,169273
train,2577,111,113664,1543,1543,115207
train,2578,88,90112,1028,1028,91140
train,2579,134,137216,1780,1780,138996
train,2580,106,108544,1370,1370,109914
train,2581,123,125952,1613,1613,127565
train,2582,117,119808,1665,1665,121473
train,2583,172,176128,2366,2366,178494
train,2584,153,156672,1923,1923,158595
train,2585,157,160768,2083,2083,162851
train,2586,158,161792,2098,2098,163890
train,2587,185,189440,2509,2509,191949
train,2588,199,203776,2759,2759,206535
train,2589,83,84992,995,995,85987
train,2590,104,106496,1242,1242,107738
train,2591,131,134144,1873,1873,136017
train,2592,187,191488,2635,2635,194123
train,2593,142,145408,1772,1772,147180
train,2594,221,226304,3337,3337,229641
train,2595,170,174080,2426,2426,176506
train,2596,204,208896,3246,3246,212142
train,2597,232,237568,3080,3080,240648
train,2598,140,143360,1692,1692,145052
train,2599,163,166912,2305,2305,169217
train,2600,122,124928,1510,1510,126438
train,2601,126,129024,1676,1676,130700
train,2602,134,137216,1770,1770,138986
train,2603,75,76800,915,915,77715
train,2604,192,196608,2928,2928,199536
train,2605,179,183296,2333,2333,185629
train,2606,163,166912,2227,2227,169139
train,2607,108,110592,1358,1358,111950
train,2608,68,69632,910,910,70542
train,2609,145,148480,1981,1981,150461
train,2610,107,109568,1435,1435,111003
train,2611,104,106496,1176,1176,107672
train,2612,183,187392,2291,2291,189683
train,2613,136,139264,1602,1602,140866
train,2614,178,182272,2634,2634,184906
train,2615,144,147456,2214,2214,149670
train,2616,215,220160,3011,3011,223171
train,2617,62,63488,678,678,64166
train,2618,95,97280,1321,1321,98601
train,2619,151,154624,1941,1941,156565
train,2620,160,163840,2428,2428,166268
train,2621,150,153600,2064,2064,155664
train,2622,118,120832,1454,1454,122286
train,2623,183,187392,2891,2891,190283
train,2624,134,137216,1740,1740,138956
train,2625,202,206848,2514,2514,209362
train,2626,173,177152,2045,2045,179197
train,2627,124,126976,1696,1696,128672
train,2628,213,218112,3009,3009,221121
train,2629,231,236544,3367,3367,239911
train,2630,162,165888,2202,2202,168090
train,2631,168,172032,2026,2026,174058
train,2632,169,173056,2369,2369,175425
train,2633,101,103424,1393,1393,104817
train,2634,107,109568,1431,1431,110999
train,2635,142,145408,2006,2006,147414
train,2636,116,118784,1622,1622,120406
train,2637,173,177152,2353,2353,179505
train,2638,244,249856,3626,3626,253482
train,2639,78,79872,888,888,80760
train,2640,162,165888,1958,1958,167846
train,2641,204,208896,2858,2858,211754
train,2642,55,56320,579,579,56899
train,2643,138,141312,1906,1906,143218
train,2644,158,161792,2222,2222,164014
train,2645,197,201728,2733,2733,204461
train,2646,72,73728,844,844,74572
train,2647,103,105472,1291,1291,106763
train,2648,110,112640,1382,1382,114022
train,2649,188,192512,2614,2614,195126
train,2650,112,114688,1598,1598,116286
train,2651,120,122880,1772,1772,124652
train,2652,122,124928,1706,1706,126634
train,2653,112,114688,1342,1342,116030
train,2654,178,182272,2400,2400,184672
train,2655,138,141312,1874,1874,143186
train,2656,170,174080,2496,2496,176576
train,2657,113,115712,1349,1349,117061
train,2658,95,97280,1267,1267,98547
train,2659,54,55296,594,594,55890
train,2660,110,112640,1388,1388,114028
train,2661,178,182272,2220,2220,184492
train,2662,116,118784,1508,1508,120292
train,2663,165,168960,2157,2157,171117
train,2664,171,175104,2461,2461,177565
train,2665,90,92160,1156,1156,93316
train,2666,100,102400,1180,1180,103580
train,2667,164,167936,2268,2268,170204
train,2668,137,140288,1885,1885,142173
train,2669,123,125952,1587,1587,127539
train,2670,151,154624,2137,2137,156761
train,2671,144,147456,2212,2212,149668
train,2672,114,116736,1490,1490,118226
train,2673,101,103424,1241,1241,104665
train,2674,135,138240,1869,1869,140109
train,2675,92,94208,1164,1164,95372
train,2676,133,136192,2191,2191,138383
train,2677,88,90112,1062,1062,91174
train,2678,165,168960,1957,1957,170917
train,2679,122,124928,1572,1572,126500
train,2680,95,97280,1253,1253,98533
train,2681,129,132096,1567,1567,133663
train,2682,160,163840,2168,2168,166008
train,2683,146,149504,2242,2242,151746
train,2684,163,166912,2211,2211,169123
validation,0,97,99328,1111,1111,100439
validation,1,78,79872,926,926,80798
validation,2,86,88064,1042,1042,89106
validation,3,96,98304,1284,1284,99588
validation,4,155,158720,2109,2109,160829
validation,5,209,214016,3061,3061,217077
validation,6,253,259072,3769,3769,262841
validation,7,193,197632,2857,2857,200489
validation,8,164,167936,2084,2084,170020
validation,9,158,161792,2198,2198,163990
validation,10,177,181248,2217,2217,183465
validation,11,131,134144,1839,1839,135983
validation,12,81,82944,897,897,83841
validation,13,129,132096,1691,1691,133787
validation,14,208,212992,2610,2610,215602
validation,15,211,216064,2871,2871,218935
validation,16,150,153600,2074,2074,155674
validation,17,164,167936,1986,1986,169922
validation,18,199,203776,2977,2977,206753
validation,19,170,174080,2208,2208,176288
validation,20,113,115712,1373,1373,117085
validation,21,149,152576,2049,2049,154625
validation,22,204,208896,2850,2850,211746
validation,23,144,147456,1808,1808,149264
validation,24,120,122880,1434,1434,124314
validation,25,173,177152,2467,2467,179619
validation,26,101,103424,1363,1363,104787
validation,27,49,50176,523,523,50699
validation,28,121,123904,1381,1381,125285
validation,29,122,124928,1498,1498,126426
validation,30,192,196608,2570,2570,199178
validation,31,144,147456,2230,2230,149686
validation,32,147,150528,2113,2113,152641
validation,33,170,174080,2610,2610,176690
validation,34,190,194560,2932,2932,197492
validation,35,56,57344,600,600,57944
validation,36,106,108544,1214,1214,109758
validation,37,114,116736,1400,1400,118136
validation,38,138,141312,1682,1682,142994
validation,39,171,175104,2483,2483,177587
validation,40,155,158720,2153,2153,160873
validation,41,160,163840,2142,2142,165982
validation,42,167,171008,2499,2499,173507
validation,43,78,79872,926,926,80798
validation,44,102,104448,1352,1352,105800
validation,45,162,165888,2486,2486,168374
validation,46,182,186368,2494,2494,188862
validation,47,121,123904,1435,1435,125339
validation,48,191,195584,2719,2719,198303
validation,49,106,108544,1420,1420,109964
validation,50,143,146432,1985,1985,148417
validation,51,141,144384,1851,1851,146235
validation,52,133,136192,1687,1687,137879
validation,53,89,91136,1117,1117,92253
validation,54,149,152576,2229,2229,154805
validation,55,142,145408,2206,2206,147614
validation,56,154,157696,2282,2282,159978
validation,57,124,126976,1568,1568,128544
validation,58,87,89088,1049,1049,90137
validation,59,102,104448,1322,1322,105770
validation,60,150,153600,2170,2170,155770
validation,61,174,178176,2476,2476,180652
validation,62,198,202752,2716,2716,205468
validation,63,177,181248,2365,2365,183613
validation,64,257,263168,4045,4045,267213
validation,65,199,203776,3049,3049,206825
validation,66,106,108544,1348,1348,109892
validation,67,107,109568,1381,1381,110949
validation,68,141,144384,1955,1955,146339
validation,69,103,105472,1285,1285,106757
validation,70,115,117760,1687,1687,119447
validation,71,69,70656,783,783,71439
validation,72,199,203776,2717,2717,206493
validation,73,145,148480,1753,1753,150233
validation,74,114,116736,1406,1406,118142
validation,75,212,217088,2728,2728,219816
validation,76,94,96256,1216,1216,97472
validation,77,112,114688,1538,1538,116226
validation,78,191,195584,3017,3017,198601
validation,79,108,110592,1386,1386,111978
validation,80,37,37888,383,383,38271
validation,81,206,210944,2902,2902,213846
validation,82,179,183296,2561,2561,185857
validation,83,168,172032,2012,2012,174044
validation,84,126,129024,1686,1686,130710
validation,85,133,136192,1861,1861,138053
validation,86,203,207872,2589,2589,210461
validation,87,105,107520,1333,1333,108853
validation,88,154,157696,2222,2222,159918
validation,89,119,121856,1493,1493,123349
validation,90,57,58368,659,659,59027
validation,91,157,160768,2131,2131,162899
validation,92,91,93184,1147,1147,94331
validation,93,131,134144,1901,1901,136045
validation,94,138,141312,1920,1920,143232
validation,95,123,125952,1483,1483,127435
validation,96,66,67584,700,700,68284
validation,97,87,89088,1001,1001,90089
validation,98,77,78848,883,883,79731
validation,99,200,204800,2904,2904,207704
validation,100,151,154624,2127,2127,156751
validation,101,128,131072,1636,1636,132708
validation,102,143,146432,2047,2047,148479
validation,103,52,53248,536,536,53784
validation,104,144,147456,1950,1950,149406
validation,105,187,191488,2825,2825,194313
validation,106,112,114688,1828,1828,116516
validation,107,68,69632,778,778,70410
validation,108,230,235520,2840,2840,238360
validation,109,134,137216,1888,1888,139104
validation,110,154,157696,1920,1920,159616
validation,111,136,139264,1772,1772,141036
validation,112,105,107520,1239,1239,108759
validation,113,62,63488,614,614,64102
validation,114,173,177152,2527,2527,179679
validation,115,114,116736,1392,1392,118128
validation,116,152,155648,2182,2182,157830
validation,117,98,100352,1276,1276,101628
validation,118,120,122880,1672,1672,124552
validation,119,151,154624,1981,1981,156605
validation,120,145,148480,1801,1801,150281
validation,121,133,136192,1855,1855,138047
validation,122,181,185344,2193,2193,187537
validation,123,58,59392,642,642,60034
validation,124,190,194560,2412,2412,196972
validation,125,148,151552,2192,2192,153744
validation,126,99,101376,1321,1321,102697
validation,127,191,195584,2583,2583,198167
validation,128,171,175104,2539,2539,177643
validation,129,142,145408,1882,1882,147290
validation,130,141,144384,1865,1865,146249
validation,131,131,134144,1885,1885,136029
validation,132,156,159744,2248,2248,161992
validation,133,163,166912,1981,1981,168893
validation,134,123,125952,1717,1717,127669
validation,135,183,187392,2521,2521,189913
validation,136,81,82944,881,881,83825
validation,137,149,152576,2013,2013,154589
validation,138,73,74752,879,879,75631
validation,139,144,147456,1814,1814,149270
validation,140,137,140288,1775,1775,142063
validation,141,148,151552,2288,2288,153840
validation,142,123,125952,1607,1607,127559
validation,143,200,204800,2564,2564,207364
validation,144,94,96256,1096,1096,97352
validation,145,122,124928,1656,1656,126584
validation,146,168,172032,2558,2558,174590
validation,147,207,211968,2871,2871,214839
validation,148,94,96256,1244,1244,97500
validation,149,124,126976,1544,1544,128520
validation,150,114,116736,1600,1600,118336
validation,151,125,128000,1613,1613,129613
validation,152,150,153600,1902,1902,155502
validation,153,173,177152,2489,2489,179641
validation,154,63,64512,781,781,65293
validation,155,119,121856,1667,1667,123523
validation,156,164,167936,2186,2186,170122
validation,157,160,163840,2020,2020,165860
validation,158,159,162816,2187,2187,165003
validation,159,132,135168,1660,1660,136828
validation,160,115,117760,1315,1315,119075
validation,161,95,97280,1225,1225,98505
validation,162,128,131072,1806,1806,132878
validation,163,89,91136,1251,1251,92387
validation,164,172,176128,2506,2506,178634
validation,165,235,240640,3577,3577,244217
validation,166,97,99328,1301,1301,100629
validation,167,141,144384,1811,1811,146195
validation,168,190,194560,2720,2720,197280
validation,169,84,86016,974,974,86990
validation,170,172,176128,2324,2324,178452
validation,171,69,70656,799,799,71455
validation,172,159,162816,2099,2099,164915
validation,173,141,144384,2095,2095,146479
validation,174,196,200704,2828,2828,203532
validation,175,175,179200,2581,2581,181781
validation,176,149,152576,2059,2059,154635
validation,177,42,43008,450,450,43458
validation,178,49,50176,511,511,50687
validation,179,173,177152,2585,2585,179737
validation,180,218,223232,3086,3086,226318
validation,181,136,139264,1738,1738,141002
validation,182,178,182272,2450,2450,184722
validation,183,152,155648,2400,2400,158048
validation,184,98,100352,1274,1274,101626
validation,185,100,102400,1388,1388,103788
validation,186,146,149504,2210,2210,151714
validation,187,145,148480,2197,2197,150677
validation,188,116,118784,1480,1480,120264
validation,189,147,150528,2049,2049,152577
validation,190,124,126976,1618,1618,128594
validation,191,138,141312,1894,1894,143206
validation,192,158,161792,2002,2002,163794
validation,193,177,181248,2585,2585,183833
validation,194,102,104448,1348,1348,105796
validation,195,167,171008,2607,2607,173615
validation,196,143,146432,1945,1945,148377
validation,197,112,114688,1458,1458,116146
validation,198,121,123904,1661,1661,125565
validation,199,204,208896,2778,2778,211674
validation,200,117,119808,1351,1351,121159
validation,201,210,215040,3104,3104,218144
validation,202,69,70656,797,797,71453
validation,203,64,65536,740,740,66276
validation,204,189,193536,2635,2635,196171
validation,205,130,133120,1750,1750,134870
validation,206,200,204800,3006,3006,207806
validation,207,176,180224,2480,2480,182704
validation,208,135,138240,1811,1811,140051
validation,209,98,100352,1264,1264,101616
validation,210,139,142336,1765,1765,144101
validation,211,123,125952,1743,1743,127695
validation,212,156,159744,2222,2222,161966
validation,213,119,121856,1717,1717,123573
validation,214,133,136192,1811,1811,138003
validation,215,102,104448,1208,1208,105656
validation,216,154,157696,2012,2012,159708
validation,217,185,189440,2873,2873,192313
validation,218,166,169984,2166,2166,172150
validation,219,181,185344,2717,2717,188061
validation,220,107,109568,1457,1457,111025
validation,221,154,157696,2044,2044,159740
validation,222,164,167936,2318,2318,170254
validation,223,137,140288,1705,1705,141993
validation,224,193,197632,2907,2907,200539
validation,225,99,101376,1143,1143,102519
validation,226,40,40960,458,458,41418
validation,227,112,114688,1528,1528,116216
validation,228,135,138240,1655,1655,139895
validation,229,164,167936,2486,2486,170422
validation,230,138,141312,2004,2004,143316
validation,231,118,120832,1504,1504,122336
validation,232,90,92160,1060,1060,93220
validation,233,116,118784,1568,1568,120352
validation,234,68,69632,728,728,70360
validation,235,192,196608,2636,2636,199244
validation,236,129,132096,1617,1617,133713
validation,237,176,180224,2330,2330,182554
validation,238,118,120832,1604,1604,122436
validation,239,169,173056,2431,2431,175487
validation,240,128,131072,1788,1788,132860
validation,241,139,142336,1909,1909,144245
validation,242,66,67584,748,748,68332
validation,243,108,110592,1320,1320,111912
validation,244,187,191488,2843,2843,194331
validation,245,67,68608,721,721,69329
validation,246,94,96256,1184,1184,97440
validation,247,100,102400,1396,1396,103796
validation,248,176,180224,2486,2486,182710
validation,249,131,134144,1563,1563,135707
validation,250,221,226304,2929,2929,229233
validation,251,135,138240,1697,1697,139937
validation,252,139,142336,1699,1699,144035
validation,253,194,198656,2680,2680,201336
validation,254,136,139264,1880,1880,141144
validation,255,202,206848,2906,2906,209754
validation,256,217,222208,2999,2999,225207
validation,257,207,211968,2731,2731,214699
validation,258,205,209920,3039,3039,212959
validation,259,72,73728,822,822,74550
validation,260,141,144384,1763,1763,146147
validation,261,134,137216,1940,1940,139156
validation,262,156,159744,2188,2188,161932
validation,263,179,183296,2331,2331,185627
validation,264,121,123904,1839,1839,125743
validation,265,87,89088,989,989,90077
validation,266,210,215040,2964,2964,218004
validation,267,173,177152,2459,2459,179611
validation,268,74,75776,794,794,76570
validation,269,160,163840,2154,2154,165994
validation,270,166,169984,2368,2368,172352
validation,271,98,100352,1306,1306,101658
validation,272,72,73728,824,824,74552
validation,273,139,142336,1869,1869,144205
validation,274,66,67584,754,754,68338
validation,275,102,104448,1354,1354,105802
validation,276,87,89088,1015,1015,90103
validation,277,46,47104,508,508,47612
validation,278,185,189440,2485,2485,191925
validation,279,139,142336,1761,1761,144097
validation,280,73,74752,891,891,75643
validation,281,56,57344,606,606,57950
validation,282,143,146432,1933,1933,148365
validation,283,170,174080,2250,2250,176330
validation,284,160,163840,2240,2240,166080
validation,285,146,149504,1970,1970,151474
validation,286,182,186368,2206,2206,188574
validation,287,72,73728,788,788,74516
validation,288,108,110592,1360,1360,111952
validation,289,147,150528,1807,1807,152335
validation,290,120,122880,1404,1404,124284
validation,291,101,103424,1297,1297,104721
validation,292,44,45056,460,460,45516
validation,293,162,165888,2368,2368,168256
validation,294,152,155648,1972,1972,157620
validation,295,199,203776,3081,3081,206857
validation,296,190,194560,2968,2968,197528
validation,297,161,164864,2153,2153,167017
validation,298,144,147456,1954,1954,149410
validation,299,156,159744,2160,2160,161904
validation,300,172,176128,2448,2448,178576
validation,301,134,137216,1954,1954,139170
validation,302,151,154624,2367,2367,156991
validation,303,195,199680,2739,2739,202419
validation,304,107,109568,1353,1353,110921
validation,305,88,90112,1314,1314,91426
validation,306,111,113664,1389,1389,115053
validation,307,146,149504,1812,1812,151316
validation,308,125,128000,1507,1507,129507
validation,309,74,75776,792,792,76568
validation,310,178,182272,2680,2680,184952
validation,311,128,131072,1470,1470,132542
validation,312,98,100352,1316,1316,101668
validation,313,134,137216,1966,1966,139182
validation,314,166,169984,2432,2432,172416
validation,315,140,143360,1718,1718,145078
validation,316,87,89088,1033,1033,90121
validation,317,99,101376,1159,1159,102535
validation,318,133,136192,1799,1799,137991
validation,319,236,241664,3628,3628,245292
validation,320,104,106496,1204,1204,107700
validation,321,78,79872,952,952,80824
validation,322,163,166912,2377,2377,169289
validation,323,132,135168,1862,1862,137030
validation,324,119,121856,1433,1433,123289
validation,325,263,269312,4059,4059,273371
validation,326,85,87040,1045,1045,88085
validation,327,150,153600,2050,2050,155650
validation,328,163,166912,2433,2433,169345
validation,329,169,173056,2441,2441,175497
validation,330,119,121856,1527,1527,123383
validation,331,183,187392,2585,2585,189977
validation,332,224,229376,3626,3626,233002
validation,333,130,133120,1626,1626,134746
validation,334,154,157696,2186,2186,159882
validation,335,73,74752,903,903,75655
validation,336,180,184320,2550,2550,186870
validation,337,105,107520,1273,1273,108793
validation,338,162,165888,2438,2438,168326
validation,339,168,172032,2324,2324,174356
validation,340,189,193536,2539,2539,196075
validation,341,133,136192,1775,1775,137967
validation,342,114,116736,1394,1394,118130
validation,343,118,120832,1496,1496,122328
validation,344,178,182272,2220,2220,184492
validation,345,174,178176,2384,2384,180560
validation,346,161,164864,2431,2431,167295
validation,347,126,129024,1646,1646,130670
validation,348,132,135168,1656,1656,136824
validation,349,188,192512,2662,2662,195174
validation,350,77,78848,765,765,79613
validation,351,136,139264,1718,1718,140982
validation,352,128,131072,1780,1780,132852
validation,353,173,177152,2399,2399,179551
validation,354,134,137216,1800,1800,139016
validation,355,164,167936,2292,2292,170228
validation,356,84,86016,976,976,86992
validation,357,93,95232,1077,1077,96309
validation,358,136,139264,2018,2018,141282
validation,359,157,160768,1953,1953,162721
validation,360,113,115712,1439,1439,117151
validation,361,184,188416,2770,2770,191186
validation,362,181,185344,2387,2387,187731
validation,363,127,130048,1571,1571,131619
validation,364,131,134144,1699,1699,135843
validation,365,181,185344,2605,2605,187949
validation,366,146,149504,1926,1926,151430
validation,367,102,104448,1220,1220,105668
validation,368,185,189440,2417,2417,191857
validation,369,130,133120,1806,1806,134926
validation,370,141,144384,1787,1787,146171
validation,371,49,50176,511,511,50687
validation,372,134,137216,1798,1798,139014
validation,373,209,214016,2781,2781,216797
validation,374,193,197632,2717,2717,200349
validation,375,142,145408,1798,1798,147206
validation,376,176,180224,2198,2198,182422
validation,377,121,123904,1621,1621,125525
validation,378,162,165888,2334,2334,168222
validation,379,109,111616,1513,1513,113129
validation,380,230,235520,3686,3686,239206
validation,381,183,187392,2725,2725,190117
validation,382,193,197632,2689,2689,200321
validation,383,274,280576,3990,3990,284566
validation,384,192,196608,2704,2704,199312
validation,385,156,159744,2116,2116,161860
validation,386,129,132096,1673,1673,133769
validation,387,146,149504,1930,1930,151434
validation,388,129,132096,1839,1839,133935
validation,389,72,73728,856,856,74584
validation,390,123,125952,1643,1643,127595
validation,391,117,119808,1631,1631,121439
validation,392,189,193536,2725,2725,196261
validation,393,150,153600,1966,1966,155566
validation,394,253,259072,3659,3659,262731
validation,395,173,177152,2617,2617,179769
validation,396,93,95232,1147,1147,96379
validation,397,137,140288,1909,1909,142197
validation,398,123,125952,1581,1581,127533
validation,399,169,173056,2297,2297,175353
validation,400,157,160768,2255,2255,163023
validation,401,103,105472,1285,1285,106757
validation,402,162,165888,2214,2214,168102
validation,403,62,63488,684,684,64172
validation,404,108,110592,1466,1466,112058
validation,405,181,185344,2465,2465,187809
validation,406,135,138240,1717,1717,139957
validation,407,96,98304,1176,1176,99480
validation,408,99,101376,1167,1167,102543
validation,409,172,176128,2482,2482,178610
validation,410,99,101376,1231,1231,102607
validation,411,230,235520,3478,3478,238998
validation,412,125,128000,1915,1915,129915
validation,413,153,156672,1875,1875,158547
validation,414,141,144384,1791,1791,146175
validation,415,114,116736,1466,1466,118202
validation,416,136,139264,1846,1846,141110
validation,417,102,104448,1350,1350,105798
validation,418,78,79872,954,954,80826
validation,419,195,199680,2685,2685,202365
validation,420,223,228352,3003,3003,231355
validation,421,61,62464,711,711,63175
validation,422,225,230400,3233,3233,233633
validation,423,168,172032,2246,2246,174278
validation,424,95,97280,1151,1151,98431
validation,425,81,82944,877,877,83821
validation,426,167,171008,2167,2167,173175
validation,427,95,97280,1291,1291,98571
validation,428,169,173056,2395,2395,175451
validation,429,78,79872,846,846,80718
validation,430,96,98304,1142,1142,99446
validation,431,120,122880,1870,1870,124750
validation,432,159,162816,2097,2097,164913
validation,433,118,120832,1452,1452,122284
validation,434,181,185344,2331,2331,187675
validation,435,194,198656,2728,2728,201384
validation,436,242,247808,3462,3462,251270
validation,437,67,68608,745,745,69353
validation,438,126,129024,1640,1640,130664
validation,439,83,84992,1045,1045,86037
validation,440,105,107520,1413,1413,108933
validation,441,47,48128,511,511,48639
validation,442,170,174080,2418,2418,176498
validation,443,168,172032,2278,2278,174310
validation,444,85,87040,1093,1093,88133
validation,445,103,105472,1487,1487,106959
validation,446,158,161792,2344,2344,164136
validation,447,67,68608,721,721,69329
validation,448,156,159744,2268,2268,162012
validation,449,161,164864,2259,2259,167123
validation,450,108,110592,1480,1480,112072
validation,451,113,115712,1567,1567,117279
validation,452,86,88064,1154,1154,89218
validation,453,119,121856,1561,1561,123417
validation,454,116,118784,1646,1646,120430
validation,455,165,168960,2007,2007,170967
validation,456,75,76800,895,895,77695
validation,457,163,166912,2311,2311,169223
validation,458,105,107520,1353,1353,108873
validation,459,137,140288,1647,1647,141935
validation,460,120,122880,1564,1564,124444
validation,461,84,86016,928,928,86944
validation,462,132,135168,1820,1820,136988
validation,463,112,114688,1418,1418,116106
validation,464,153,156672,2053,2053,158725
validation,465,183,187392,2551,2551,189943
validation,466,173,177152,2295,2295,179447
validation,467,153,156672,2141,2141,158813
validation,468,76,77824,872,872,78696
validation,469,185,189440,2635,2635,192075
validation,470,97,99328,1119,1119,100447
validation,471,112,114688,1328,1328,116016
validation,472,172,176128,2498,2498,178626
validation,473,153,156672,1923,1923,158595
validation,474,145,148480,2027,2027,150507
validation,475,152,155648,2284,2284,157932
validation,476,218,223232,3068,3068,226300
validation,477,80,81920,954,954,82874
validation,478,139,142336,1837,1837,144173
validation,479,169,173056,2455,2455,175511
validation,480,165,168960,2347,2347,171307
validation,481,159,162816,2139,2139,164955
validation,482,185,189440,2593,2593,192033
validation,483,131,134144,1599,1599,135743
validation,484,72,73728,868,868,74596
validation,485,129,132096,1593,1593,133689
validation,486,127,130048,1571,1571,131619
validation,487,141,144384,2131,2131,146515
validation,488,178,182272,2608,2608,184880
validation,489,107,109568,1347,1347,110915
validation,490,101,103424,1265,1265,104689
validation,491,223,228352,3115,3115,231467
validation,492,152,155648,2278,2278,157926
validation,493,169,173056,2323,2323,175379
validation,494,131,134144,1783,1783,135927
validation,495,152,155648,1900,1900,157548
validation,496,143,146432,2047,2047,148479
validation,497,169,173056,2425,2425,175481
validation,498,104,106496,1402,1402,107898
validation,499,211,216064,2813,2813,218877
validation,500,161,164864,2121,2121,166985
validation,501,201,205824,3075,3075,208899
validation,502,143,146432,1825,1825,148257
validation,503,159,162816,2471,2471,165287
validation,504,175,179200,2317,2317,181517
validation,505,95,97280,1259,1259,98539
validation,506,130,133120,1818,1818,134938
validation,507,140,143360,1850,1850,145210
validation,508,149,152576,1775,1775,154351
validation,509,158,161792,2214,2214,164006
validation,510,211,216064,2885,2885,218949
validation,511,98,100352,1154,1154,101506
validation,512,111,113664,1405,1405,115069
validation,513,145,148480,1943,1943,150423
validation,514,112,114688,1512,1512,116200
validation,515,191,195584,2805,2805,198389
validation,516,176,180224,2358,2358,182582
validation,517,145,148480,1895,1895,150375
validation,518,149,152576,1921,1921,154497
validation,519,80,81920,860,860,82780
validation,520,115,117760,1583,1583,119343
validation,521,130,133120,1714,1714,134834
validation,522,86,88064,930,930,88994
validation,523,199,203776,2685,2685,206461
validation,524,103,105472,1287,1287,106759
validation,525,155,158720,2145,2145,160865
validation,526,100,102400,1300,1300,103700
validation,527,215,220160,3163,3163,223323
validation,528,82,83968,1000,1000,84968
validation,529,115,117760,1395,1395,119155
validation,530,115,117760,1517,1517,119277
validation,531,141,144384,1777,1777,146161
validation,532,166,169984,2400,2400,172384
validation,533,205,209920,3005,3005,212925
validation,534,151,154624,2149,2149,156773
validation,535,133,136192,1657,1657,137849
validation,536,152,155648,1976,1976,157624
validation,537,170,174080,2624,2624,176704
validation,538,165,168960,2501,2501,171461
validation,539,182,186368,2612,2612,188980
validation,540,148,151552,2138,2138,153690
validation,541,139,142336,1687,1687,144023
validation,542,164,167936,2370,2370,170306
validation,543,127,130048,1627,1627,131675
validation,544,145,148480,1803,1803,150283
validation,545,162,165888,2352,2352,168240
validation,546,115,117760,1535,1535,119295
validation,547,155,158720,2295,2295,161015
validation,548,134,137216,1872,1872,139088
validation,549,211,216064,3481,3481,219545
validation,550,156,159744,1920,1920,161664
validation,551,198,202752,2912,2912,205664
validation,552,91,93184,1017,1017,94201
validation,553,214,219136,3018,3018,222154
validation,554,129,132096,1709,1709,133805
validation,555,127,130048,1587,1587,131635
validation,556,68,69632,780,780,70412
validation,557,123,125952,1579,1579,127531
validation,558,81,82944,985,985,83929
validation,559,175,179200,2357,2357,181557
validation,560,161,164864,2415,2415,167279
validation,561,140,143360,1824,1824,145184
validation,562,77,78848,831,831,79679
validation,563,191,195584,2501,2501,198085
validation,564,221,226304,3119,3119,229423
validation,565,158,161792,2256,2256,164048
validation,566,163,166912,2399,2399,169311
validation,567,242,247808,3974,3974,251782
validation,568,150,153600,1970,1970,155570
validation,569,137,140288,1859,1859,142147
validation,570,245,250880,3473,3473,254353
validation,571,78,79872,980,980,80852
validation,572,227,232448,3461,3461,235909
validation,573,132,135168,1880,1880,137048
validation,574,174,178176,2606,2606,180782
validation,575,33,33792,361,361,34153
validation,576,120,122880,1538,1538,124418
validation,577,182,186368,2328,2328,188696
validation,578,140,143360,1796,1796,145156
validation,579,103,105472,1233,1233,106705
validation,580,93,95232,1203,1203,96435
validation,581,206,210944,2940,2940,213884
validation,582,149,152576,2335,2335,154911
validation,583,79,80896,917,917,81813
validation,584,128,131072,1698,1698,132770
validation,585,142,145408,2094,2094,147502
validation,586,148,151552,2100,2100,153652
validation,587,142,145408,1786,1786,147194
validation,588,148,151552,1690,1690,153242
validation,589,121,123904,1509,1509,125413
validation,590,149,152576,2041,2041,154617
validation,591,125,128000,1555,1555,129555
validation,592,95,97280,1085,1085,98365
validation,593,138,141312,1926,1926,143238
validation,594,185,189440,2691,2691,192131
validation,595,94,96256,1300,1300,97556
validation,596,178,182272,2512,2512,184784
validation,597,143,146432,1917,1917,148349
validation,598,59,60416,627,627,61043
validation,599,61,62464,683,683,63147
validation,600,72,73728,786,786,74514
validation,601,112,114688,1448,1448,116136
validation,602,66,67584,776,776,68360
validation,603,213,218112,2997,2997,221109
validation,604,148,151552,2204,2204,153756
validation,605,105,107520,1243,1243,108763
validation,606,126,129024,1820,1820,130844
validation,607,136,139264,2048,2048,141312
validation,608,161,164864,1921,1921,166785
validation,609,108,110592,1550,1550,112142
validation,610,212,217088,3090,3090,220178
validation,611,155,158720,2539,2539,161259
validation,612,182,186368,2404,2404,188772
validation,613,80,81920,954,954,82874
validation,614,140,143360,1976,1976,145336
validation,615,129,132096,1609,1609,133705
validation,616,142,145408,1924,1924,147332
validation,617,69,70656,871,871,71527
validation,618,113,115712,1517,1517,117229
validation,619,94,96256,1212,1212,97468
validation,620,208,212992,2798,2798,215790
validation,621,157,160768,2089,2089,162857
validation,622,147,150528,1745,1745,152273
validation,623,56,57344,606,606,57950
validation,624,145,148480,1943,1943,150423
validation,625,207,211968,3005,3005,214973
validation,626,73,74752,799,799,75551
validation,627,159,162816,2307,2307,165123
validation,628,117,119808,1333,1333,121141
validation,629,190,194560,2548,2548,197108
validation,630,136,139264,1736,1736,141000
validation,631,147,150528,1729,1729,152257
validation,632,132,135168,1878,1878,137046
validation,633,229,234496,3241,3241,237737
validation,634,207,211968,2633,2633,214601
validation,635,128,131072,1710,1710,132782
validation,636,58,59392,648,648,60040
validation,637,230,235520,3398,3398,238918
validation,638,191,195584,2589,2589,198173
validation,639,275,281600,4083,4083,285683
validation,640,66,67584,788,788,68372
validation,641,162,165888,2640,2640,168528
validation,642,207,211968,2817,2817,214785
validation,643,93,95232,1081,1081,96313
validation,644,127,130048,1777,1777,131825
validation,645,81,82944,937,937,83881
validation,646,138,141312,1940,1940,143252
validation,647,158,161792,2228,2228,164020
validation,648,124,126976,1602,1602,128578
validation,649,222,227328,3278,3278,230606
validation,650,159,162816,2265,2265,165081
validation,651,202,206848,2782,2782,209630
validation,652,59,60416,675,675,61091
validation,653,176,180224,2426,2426,182650
validation,654,159,162816,2033,2033,164849
validation,655,157,160768,2237,2237,163005
validation,656,135,138240,1767,1767,140007
validation,657,177,181248,2495,2495,183743
validation,658,123,125952,1731,1731,127683
validation,659,201,205824,2675,2675,208499
validation,660,177,181248,2537,2537,183785
validation,661,157,160768,2165,2165,162933
validation,662,175,179200,2287,2287,181487
validation,663,91,93184,1155,1155,94339
validation,664,103,105472,1299,1299,106771
validation,665,88,90112,1022,1022,91134
validation,666,103,105472,1385,1385,106857
validation,667,177,181248,2543,2543,183791
validation,668,109,111616,1343,1343,112959
validation,669,130,133120,1914,1914,135034
validation,670,121,123904,1665,1665,125569
validation,671,160,163840,2136,2136,165976
test,0,115,117760,1515,1515,119275
test,1,159,162816,2129,2129,164945
test,2,124,126976,1518,1518,128494
test,3,144,147456,1750,1750,149206
test,4,133,136192,1581,1581,137773
test,5,219,224256,3173,3173,227429
test,6,218,223232,3026,3026,226258
test,7,168,172032,2462,2462,174494
test,8,226,231424,3732,3732,235156
test,9,212,217088,3268,3268,220356
test,10,116,118784,1674,1674,120458
test,11,168,172032,2328,2328,174360
test,12,125,128000,1609,1609,129609
test,13,94,96256,1056,1056,97312
test,14,61,62464,673,673,63137
test,15,129,132096,1659,1659,133755
test,16,121,123904,1611,1611,125515
test,17,94,96256,1164,1164,97420
test,18,146,149504,1808,1808,151312
test,19,186,190464,2692,2692,193156
test,20,131,134144,1783,1783,135927
test,21,111,113664,1279,1279,114943
test,22,164,167936,2306,2306,170242
test,23,263,269312,4001,4001,273313
test,24,179,183296,2609,2609,185905
test,25,179,183296,2517,2517,185813
test,26,209,214016,2779,2779,216795
test,27,139,142336,1787,1787,144123
test,28,79,80896,1071,1071,81967
test,29,42,43008,470,470,43478
test,30,179,183296,2607,2607,185903
test,31,65,66560,729,729,67289
test,32,113,115712,1383,1383,117095
test,33,159,162816,2003,2003,164819
test,34,101,103424,1265,1265,104689
test,35,154,157696,2000,2000,159696
test,36,70,71680,832,832,72512
test,37,87,89088,1051,1051,90139
test,38,98,100352,1212,1212,101564
test,39,145,148480,1685,1685,150165
test,40,177,181248,2611,2611,183859
test,41,91,93184,953,953,94137
test,42,177,181248,2565,2565,183813
test,43,110,112640,1374,1374,114014
test,44,62,63488,724,724,64212
test,45,135,138240,1881,1881,140121
test,46,147,150528,2173,2173,152701
test,47,199,203776,2521,2521,206297
test,48,177,181248,2425,2425,183673
test,49,128,131072,1792,1792,132864
test,50,130,133120,1690,1690,134810
test,51,116,118784,1364,1364,120148
test,52,133,136192,1711,1711,137903
test,53,116,118784,1480,1480,120264
test,54,152,155648,2008,2008,157656
test,55,102,104448,1342,1342,105790
test,56,148,151552,1926,1926,153478
test,57,180,184320,2872,2872,187192
test,58,122,124928,1580,1580,126508
test,59,126,129024,1436,1436,130460
test,60,170,174080,2392,2392,176472
test,61,137,140288,1761,1761,142049
test,62,129,132096,1591,1591,133687
test,63,136,139264,1906,1906,141170
test,64,216,221184,3098,3098,224282
test,65,216,221184,2928,2928,224112
test,66,145,148480,1715,1715,150195
test,67,84,86016,952,952,86968
test,68,197,201728,2939,2939,204667
test,69,129,132096,1545,1545,133641
test,70,116,118784,1474,1474,120258
test,71,120,122880,1582,1582,124462
test,72,176,180224,2500,2500,182724
test,73,68,69632,878,878,70510
test,74,179,183296,2251,2251,185547
test,75,177,181248,2293,2293,183541
test,76,166,169984,2292,2292,172276
test,77,151,154624,2161,2161,156785
test,78,174,178176,2260,2260,180436
test,79,119,121856,1561,1561,123417
test,80,74,75776,996,996,76772
test,81,73,74752,773,773,75525
test,82,166,169984,2296,2296,172280
test,83,160,163840,2122,2122,165962
test,84,180,184320,2570,2570,186890
test,85,116,118784,1452,1452,120236
test,86,102,104448,1336,1336,105784
test,87,144,147456,2172,2172,149628
test,88,215,220160,3083,3083,223243
test,89,82,83968,1026,1026,84994
test,90,158,161792,2190,2190,163982
test,91,189,193536,2829,2829,196365
test,92,183,187392,2699,2699,190091
test,93,128,131072,2106,2106,133178
test,94,159,162816,1979,1979,164795
test,95,246,251904,3372,3372,255276
test,96,83,84992,975,975,85967
test,97,92,94208,1136,1136,95344
test,98,193,197632,2827,2827,200459
test,99,149,152576,1987,1987,154563
test,100,174,178176,2480,2480,180656
test,101,118,120832,1614,1614,122446
test,102,163,166912,2261,2261,169173
test,103,119,121856,1551,1551,123407
test,104,48,49152,500,500,49652
test,105,172,176128,2440,2440,178568
test,106,158,161792,2192,2192,163984
test,107,126,129024,1836,1836,130860
test,108,143,146432,1985,1985,148417
test,109,213,218112,2947,2947,221059
test,110,135,138240,1819,1819,140059
test,111,176,180224,2660,2660,182884
test,112,194,198656,2640,2640,201296
test,113,193,197632,2529,2529,200161
test,114,199,203776,2837,2837,206613
test,115,162,165888,2206,2206,168094
test,116,175,179200,2427,2427,181627
test,117,121,123904,1453,1453,125357
test,118,295,302080,4481,4481,306561
test,119,127,130048,1577,1577,131625
test,120,146,149504,1814,1814,151318
test,121,140,143360,1956,1956,145316
test,122,157,160768,2129,2129,162897
test,123,225,230400,2987,2987,233387
test,124,86,88064,1026,1026,89090
test,125,214,219136,2768,2768,221904
test,126,47,48128,511,511,48639
test,127,126,129024,1724,1724,130748
test,128,142,145408,1902,1902,147310
test,129,185,189440,2471,2471,191911
test,130,117,119808,1569,1569,121377
test,131,61,62464,677,677,63141
test,132,103,105472,1183,1183,106655
test,133,86,88064,1042,1042,89106
test,134,191,195584,2723,2723,198307
test,135,111,113664,1495,1495,115159
test,136,181,185344,2449,2449,187793
test,137,184,188416,2776,2776,191192
test,138,165,168960,2055,2055,171015
test,139,143,146432,1685,1685,148117
test,140,169,173056,2183,2183,175239
test,141,75,76800,821,821,77621
test,142,98,100352,1100,1100,101452
test,143,65,66560,723,723,67283
test,144,147,150528,2311,2311,152839
test,145,111,113664,1483,1483,115147
test,146,157,160768,2107,2107,162875
test,147,94,96256,1176,1176,97432
test,148,127,130048,1685,1685,131733
test,149,151,154624,2061,2061,156685
test,150,61,62464,681,681,63145
test,151,148,151552,1978,1978,153530
test,152,135,138240,2029,2029,140269
test,153,196,200704,2734,2734,203438
test,154,177,181248,2799,2799,184047
test,155,232,237568,3066,3066,240634
test,156,175,179200,3237,3237,182437
test,157,145,148480,1759,1759,150239
test,158,117,119808,1657,1657,121465
test,159,121,123904,1573,1573,125477
test,160,179,183296,2251,2251,185547
test,161,193,197632,2891,2891,200523
test,162,171,175104,2385,2385,177489
test,163,143,146432,1843,1843,148275
test,164,165,168960,2259,2259,171219
test,165,94,96256,1104,1104,97360
test,166,91,93184,1177,1177,94361
test,167,61,62464,669,669,63133
test,168,160,163840,2262,2262,166102
test,169,131,134144,1699,1699,135843
test,170,151,154624,1999,1999,156623
test,171,87,89088,1059,1059,90147
test,172,117,119808,1389,1389,121197
test,173,181,185344,2483,2483,187827
test,174,142,145408,1842,1842,147250
test,175,84,86016,990,990,87006
test,176,131,134144,1923,1923,136067
test,177,139,142336,2037,2037,144373
test,178,100,102400,1294,1294,103694
test,179,103,105472,1179,1179,106651
test,180,202,206848,2768,2768,209616
test,181,149,152576,2369,2369,154945
test,182,44,45056,448,448,45504
test,183,114,116736,1464,1464,118200
test,184,145,148480,1999,1999,150479
test,185,156,159744,1862,1862,161606
test,186,150,153600,1876,1876,155476
test,187,94,96256,1060,1060,97316
test,188,178,182272,2648,2648,184920
test,189,134,137216,1872,1872,139088
test,190,96,98304,1172,1172,99476
test,191,146,149504,2174,2174,151678
test,192,168,172032,2304,2304,174336
test,193,141,144384,1961,1961,146345
test,194,113,115712,1397,1397,117109
test,195,144,147456,1840,1840,149296
test,196,71,72704,761,761,73465
test,197,125,128000,1713,1713,129713
test,198,142,145408,1892,1892,147300
test,199,164,167936,2298,2298,170234
test,200,195,199680,2631,2631,202311
test,201,116,118784,1736,1736,120520
test,202,143,146432,1817,1817,148249
test,203,200,204800,2796,2796,207596
test,204,119,121856,1527,1527,123383
test,205,175,179200,2361,2361,181561
test,206,135,138240,1761,1761,140001
test,207,80,81920,904,904,82824
test,208,162,165888,2394,2394,168282
test,209,97,99328,1319,1319,100647
test,210,136,139264,1952,1952,141216
test,211,158,161792,2100,2100,163892
test,212,127,130048,1437,1437,131485
test,213,160,163840,2338,2338,166178
test,214,151,154624,1851,1851,156475
test,215,157,160768,1955,1955,162723
test,216,126,129024,1660,1660,130684
test,217,230,235520,3436,3436,238956
test,218,154,157696,2076,2076,159772
test,219,199,203776,2929,2929,206705
test,220,126,129024,1718,1718,130742
test,221,189,193536,2799,2799,196335
test,222,65,66560,743,743,67303
test,223,184,188416,2892,2892,191308
test,224,136,139264,1846,1846,141110
test,225,119,121856,1729,1729,123585
test,226,91,93184,1133,1133,94317
test,227,218,223232,3100,3100,226332
test,228,175,179200,2101,2101,181301
test,229,104,106496,1232,1232,107728
test,230,112,114688,1494,1494,116182
test,231,176,180224,2394,2394,182618
test,232,161,164864,2151,2151,167015
test,233,132,135168,1762,1762,136930
test,234,100,102400,1304,1304,103704
test,235,89,91136,1089,1089,92225
test,236,159,162816,2029,2029,164845
test,237,107,109568,1267,1267,110835
test,238,154,157696,1894,1894,159590
test,239,194,198656,2676,2676,201332
test,240,126,129024,1602,1602,130626
test,241,148,151552,1978,1978,153530
test,242,89,91136,1105,1105,92241
test,243,156,159744,2042,2042,161786
test,244,134,137216,1834,1834,139050
test,245,118,120832,1582,1582,122414
test,246,237,242688,3223,3223,245911
test,247,133,136192,1607,1607,137799
test,248,174,178176,2686,2686,180862
test,249,105,107520,1283,1283,108803
test,250,140,143360,1894,1894,145254
test,251,94,96256,1192,1192,97448
test,252,126,129024,1726,1726,130750
test,253,165,168960,2297,2297,171257
test,254,135,138240,1841,1841,140081
test,255,102,104448,1502,1502,105950
test,256,125,128000,1637,1637,129637
test,257,154,157696,2074,2074,159770
test,258,218,223232,2922,2922,226154
test,259,165,168960,2225,2225,171185
test,260,116,118784,1528,1528,120312
test,261,179,183296,2309,2309,185605
test,262,160,163840,2216,2216,166056
test,263,144,147456,1778,1778,149234
test,264,106,108544,1340,1340,109884
test,265,148,151552,2018,2018,153570
test,266,202,206848,2716,2716,209564
test,267,146,149504,2092,2092,151596
test,268,151,154624,1907,1907,156531
test,269,128,131072,1726,1726,132798
test,270,100,102400,1220,1220,103620
test,271,170,174080,2284,2284,176364
test,272,271,277504,3581,3581,281085
test,273,93,95232,1201,1201,96433
test,274,123,125952,1807,1807,127759
test,275,112,114688,1406,1406,116094
test,276,91,93184,1093,1093,94277
test,277,102,104448,1232,1232,105680
test,278,146,149504,1796,1796,151300
test,279,79,80896,907,907,81803
test,280,120,122880,1478,1478,124358
test,281,144,147456,1780,1780,149236
test,282,68,69632,768,768,70400
test,283,107,109568,1375,1375,110943
test,284,154,157696,2330,2330,160026
test,285,127,130048,1807,1807,131855
test,286,118,120832,1576,1576,122408
test,287,189,193536,2575,2575,196111
test,288,128,131072,1654,1654,132726
test,289,144,147456,1770,1770,149226
test,290,200,204800,2706,2706,207506
test,291,88,90112,1090,1090,91202
test,292,157,160768,2087,2087,162855
test,293,185,189440,2519,2519,191959
test,294,216,221184,2974,2974,224158
test,295,165,168960,2241,2241,171201
test,296,86,88064,1014,1014,89078
test,297,190,194560,2620,2620,197180
test,298,163,166912,2707,2707,169619
test,299,211,216064,3109,3109,219173
test,300,186,190464,2306,2306,192770
test,301,61,62464,657,657,63121
test,302,141,144384,1797,1797,146181
test,303,255,261120,3277,3277,264397
test,304,204,208896,2846,2846,211742
test,305,204,208896,2760,2760,211656
test,306,151,154624,2179,2179,156803
test,307,162,165888,2190,2190,168078
test,308,101,103424,1181,1181,104605
test,309,133,136192,1841,1841,138033
test,310,71,72704,823,823,73527
test,311,69,70656,863,863,71519
test,312,112,114688,1388,1388,116076
test,313,66,67584,722,722,68306
test,314,133,136192,1783,1783,137975
test,315,99,101376,1127,1127,102503
test,316,205,209920,2795,2795,212715
test,317,86,88064,1024,1024,89088
test,318,142,145408,1966,1966,147374
test,319,42,43008,428,428,43436
test,320,139,142336,1885,1885,144221
test,321,162,165888,2000,2000,167888
test,322,214,219136,2978,2978,222114
test,323,140,143360,1900,1900,145260
test,324,129,132096,1759,1759,133855
test,325,73,74752,823,823,75575
test,326,166,169984,2216,2216,172200
test,327,155,158720,2029,2029,160749
test,328,90,92160,1146,1146,93306
test,329,205,209920,2915,2915,212835
test,330,112,114688,1368,1368,116056
test,331,122,124928,1456,1456,126384
test,332,90,92160,1186,1186,93346
test,333,166,169984,2392,2392,172376
test,334,95,97280,1107,1107,98387
test,335,219,224256,3387,3387,227643
test,336,74,75776,886,886,76662
test,337,122,124928,1636,1636,126564
test,338,148,151552,2098,2098,153650
test,339,48,49152,484,484,49636
test,340,49,50176,583,583,50759
test,341,99,101376,1329,1329,102705
test,342,109,111616,1399,1399,113015
test,343,187,191488,2309,2309,193797
test,344,153,156672,2155,2155,158827
test,345,126,129024,1696,1696,130720
test,346,166,169984,2142,2142,172126
test,347,184,188416,2602,2602,191018
test,348,157,160768,2217,2217,162985
test,349,121,123904,1533,1533,125437
test,350,130,133120,1730,1730,134850
test,351,104,106496,1288,1288,107784
test,352,167,171008,2327,2327,173335
test,353,149,152576,2279,2279,154855
test,354,82,83968,1102,1102,85070
test,355,300,307200,4676,4676,311876
test,356,131,134144,1981,1981,136125
test,357,114,116736,1256,1256,117992
test,358,138,141312,1858,1858,143170
test,359,173,177152,2399,2399,179551
test,360,149,152576,1905,1905,154481
test,361,167,171008,2375,2375,173383
test,362,60,61440,598,598,62038
test,363,122,124928,1720,1720,126648
test,364,45,46080,483,483,46563
test,365,96,98304,1234,1234,99538
test,366,78,79872,816,816,80688
test,367,120,122880,1762,1762,124642
test,368,156,159744,2386,2386,162130
test,369,78,79872,882,882,80754
test,370,182,186368,2498,2498,188866
test,371,143,146432,1783,1783,148215
test,372,74,75776,856,856,76632
test,373,138,141312,1934,1934,143246
test,374,176,180224,2460,2460,182684
test,375,259,265216,4039,4039,269255
test,376,138,141312,1842,1842,143154
test,377,149,152576,1913,1913,154489
test,378,126,129024,1578,1578,130602
test,379,77,78848,1073,1073,79921
test,380,88,90112,996,996,91108
test,381,180,184320,2596,2596,186916
test,382,158,161792,2024,2024,163816
test,383,66,67584,788,788,68372
test,384,89,91136,1123,1123,92259
test,385,116,118784,1532,1532,120316
test,386,117,119808,1495,1495,121303
test,387,164,167936,2436,2436,170372
test,388,136,139264,1866,1866,141130
test,389,96,98304,1020,1020,99324
test,390,140,143360,1698,1698,145058
test,391,57,58368,673,673,59041
test,392,180,184320,2628,2628,186948
test,393,181,185344,2711,2711,188055
test,394,196,200704,2940,2940,203644
test,395,134,137216,2042,2042,139258
test,396,183,187392,2695,2695,190087
test,397,96,98304,1114,1114,99418
test,398,164,167936,2210,2210,170146
test,399,105,107520,1407,1407,108927
test,400,209,214016,2877,2877,216893
test,401,93,95232,1215,1215,96447
test,402,143,146432,2151,2151,148583
test,403,226,231424,2874,2874,234298
test,404,129,132096,1699,1699,133795
test,405,128,131072,1710,1710,132782
test,406,113,115712,1345,1345,117057
test,407,175,179200,2511,2511,181711
test,408,196,200704,2766,2766,203470
test,409,195,199680,2791,2791,202471
test,410,155,158720,2013,2013,160733
test,411,147,150528,1849,1849,152377
test,412,76,77824,822,822,78646
test,413,200,204800,2758,2758,207558
test,414,115,117760,1531,1531,119291
test,415,175,179200,2451,2451,181651
test,416,233,238592,3337,3337,241929
test,417,211,216064,3007,3007,219071
test,418,191,195584,3093,3093,198677
test,419,105,107520,1343,1343,108863
test,420,117,119808,1453,1453,121261
test,421,90,92160,1060,1060,93220
test,422,126,129024,1368,1368,130392
test,423,100,102400,1298,1298,103698
test,424,165,168960,2587,2587,171547
test,425,81,82944,1049,1049,83993
test,426,112,114688,1758,1758,116446
test,427,101,103424,1269,1269,104693
test,428,122,124928,1872,1872,126800
test,429,95,97280,1189,1189,98469
test,430,131,134144,1517,1517,135661
test,431,96,98304,1154,1154,99458
test,432,171,175104,2509,2509,177613
test,433,173,177152,2347,2347,179499
test,434,141,144384,1899,1899,146283
test,435,119,121856,1689,1689,123545
test,436,147,150528,1963,1963,152491
test,437,186,190464,2988,2988,193452
test,438,169,173056,2597,2597,175653
test,439,150,153600,2278,2278,155878
test,440,239,244736,3657,3657,248393
test,441,174,178176,2216,2216,180392
test,442,129,132096,1683,1683,133779
test,443,144,147456,1886,1886,149342
test,444,67,68608,791,791,69399
test,445,168,172032,2246,2246,174278
test,446,188,192512,2388,2388,194900
test,447,126,129024,1576,1576,130600
test,448,173,177152,2559,2559,179711
test,449,148,151552,1828,1828,153380
test,450,196,200704,2910,2910,203614
test,451,191,195584,2693,2693,198277
test,452,192,196608,2880,2880,199488
test,453,173,177152,2565,2565,179717
test,454,125,128000,1681,1681,129681
test,455,131,134144,1921,1921,136065
test,456,191,195584,2989,2989,198573
test,457,204,208896,2720,2720,211616
test,458,173,177152,2667,2667,179819
test,459,118,120832,1610,1610,122442
test,460,164,167936,2482,2482,170418
test,461,167,171008,2373,2373,173381
test,462,131,134144,1637,1637,135781
test,463,130,133120,1658,1658,134778
test,464,76,77824,884,884,78708
test,465,183,187392,2539,2539,189931
test,466,82,83968,1032,1032,85000
test,467,192,196608,2526,2526,199134
test,468,167,171008,2031,2031,173039
test,469,132,135168,2032,2032,137200
test,470,128,131072,2022,2022,133094
test,471,137,140288,1869,1869,142157
test,472,88,90112,1006,1006,91118
test,473,185,189440,2659,2659,192099
test,474,136,139264,1636,1636,140900
test,475,264,270336,4210,4210,274546
test,476,83,84992,1063,1063,86055
test,477,178,182272,2636,2636,184908
test,478,75,76800,885,885,77685
test,479,96,98304,1278,1278,99582
test,480,171,175104,2593,2593,177697
test,481,202,206848,2840,2840,209688
test,482,144,147456,1864,1864,149320
test,483,71,72704,949,949,73653
test,484,179,183296,2735,2735,186031
test,485,82,83968,988,988,84956
test,486,86,88064,974,974,89038
test,487,149,152576,1989,1989,154565
test,488,190,194560,2604,2604,197164
test,489,174,178176,2526,2526,180702
test,490,121,123904,1465,1465,125369
test,491,175,179200,2543,2543,181743
test,492,143,146432,1795,1795,148227
test,493,137,140288,1917,1917,142205
test,494,73,74752,849,849,75601
test,495,107,109568,1475,1475,111043
test,496,141,144384,2067,2067,146451
test,497,220,225280,3448,3448,228728
test,498,152,155648,2016,2016,157664
test,499,167,171008,2429,2429,173437
test,500,75,76800,931,931,77731
test,501,118,120832,1722,1722,122554
test,502,116,118784,1506,1506,120290
test,503,105,107520,1339,1339,108859
test,504,103,105472,1363,1363,106835
test,505,172,176128,2348,2348,178476
test,506,116,118784,1396,1396,120180
test,507,164,167936,2346,2346,170282
test,508,198,202752,2798,2798,205550
test,509,263,269312,3731,3731,273043
test,510,121,123904,1713,1713,125617
test,511,105,107520,1337,1337,108857
test,512,122,124928,1684,1684,126612
test,513,160,163840,2368,2368,166208
test,514,79,80896,963,963,81859
test,515,142,145408,2074,2074,147482
test,516,115,117760,1527,1527,119287
test,517,113,115712,1415,1415,117127
test,518,178,182272,2634,2634,184906
test,519,143,146432,2137,2137,148569
test,520,80,81920,796,796,82716
test,521,87,89088,1097,1097,90185
test,522,83,84992,945,945,85937
test,523,167,171008,2189,2189,173197
test,524,244,249856,3466,3466,253322
test,525,112,114688,1544,1544,116232
test,526,227,232448,3567,3567,236015
test,527,168,172032,1916,1916,173948
test,528,50,51200,532,532,51732
test,529,41,41984,427,427,42411
test,530,212,217088,2868,2868,219956
test,531,129,132096,1535,1535,133631
test,532,79,80896,977,977,81873
test,533,110,112640,1296,1296,113936
test,534,187,191488,2459,2459,193947
test,535,244,249856,3626,3626,253482
test,536,83,84992,1027,1027,86019
test,537,100,102400,1126,1126,103526
test,538,160,163840,2336,2336,166176
test,539,138,141312,1926,1926,143238
test,540,143,146432,1963,1963,148395
test,541,91,93184,1319,1319,94503
test,542,126,129024,1638,1638,130662
test,543,145,148480,1997,1997,150477
test,544,82,83968,924,924,84892
test,545,173,177152,2371,2371,179523
test,546,135,138240,1989,1989,140229
test,547,152,155648,2058,2058,157706
test,548,204,208896,3178,3178,212074
test,549,92,94208,1032,1032,95240
test,550,123,125952,1625,1625,127577
test,551,150,153600,2318,2318,155918
test,552,109,111616,1459,1459,113075
test,553,92,94208,1164,1164,95372
test,554,113,115712,1435,1435,117147
test,555,80,81920,896,896,82816
test,556,116,118784,1548,1548,120332
test,557,205,209920,3035,3035,212955
test,558,211,216064,3249,3249,219313
test,559,137,140288,1877,1877,142165
test,560,192,196608,2564,2564,199172
test,561,120,122880,1572,1572,124452
test,562,89,91136,1019,1019,92155
test,563,222,227328,3136,3136,230464
test,564,134,137216,1712,1712,138928
test,565,154,157696,2334,2334,160030
test,566,228,233472,3644,3644,237116
test,567,197,201728,2749,2749,204477
test,568,158,161792,2288,2288,164080
test,569,112,114688,1502,1502,116190
test,570,120,122880,1486,1486,124366
test,571,123,125952,1717,1717,127669
test,572,129,132096,1667,1667,133763
test,573,142,145408,1704,1704,147112
test,574,77,78848,979,979,79827
test,575,104,106496,1336,1336,107832
test,576,192,196608,2856,2856,199464
test,577,76,77824,820,820,78644
test,578,126,129024,2118,2118,131142
test,579,99,101376,1209,1209,102585
test,580,171,175104,2435,2435,177539
test,581,87,89088,1037,1037,90125
test,582,156,159744,2226,2226,161970
test,583,117,119808,1505,1505,121313
test,584,269,275456,4035,4035,279491
test,585,215,220160,3071,3071,223231
test,586,139,142336,2079,2079,144415
test,587,99,101376,1249,1249,102625
test,588,53,54272,579,579,54851
test,589,176,180224,2350,2350,182574
test,590,159,162816,2331,2331,165147
test,591,125,128000,1673,1673,129673
test,592,159,162816,2269,2269,165085
test,593,162,165888,2282,2282,168170
test,594,159,162816,1951,1951,164767
test,595,129,132096,1745,1745,133841
test,596,252,258048,3444,3444,261492
test,597,150,153600,2048,2048,155648
test,598,68,69632,818,818,70450
test,599,120,122880,1504,1504,124384
test,600,77,78848,851,851,79699
test,601,140,143360,1806,1806,145166
test,602,105,107520,1249,1249,108769
test,603,107,109568,1461,1461,111029
test,604,161,164864,2133,2133,166997
test,605,209,214016,3137,3137,217153
test,606,207,211968,3091,3091,215059
test,607,170,174080,2244,2244,176324
test,608,144,147456,1776,1776,149232
test,609,79,80896,947,947,81843
test,610,147,150528,2005,2005,152533
test,611,162,165888,2084,2084,167972
test,612,182,186368,2594,2594,188962
test,613,230,235520,2922,2922,238442
test,614,210,215040,3102,3102,218142
test,615,181,185344,2527,2527,187871
test,616,82,83968,1232,1232,85200
test,617,85,87040,1061,1061,88101
test,618,141,144384,1799,1799,146183
test,619,141,144384,1807,1807,146191
test,620,112,114688,1446,1446,116134
test,621,158,161792,2072,2072,163864
test,622,205,209920,3079,3079,212999
test,623,194,198656,2624,2624,201280
test,624,61,62464,603,603,63067
test,625,163,166912,2125,2125,169037
test,626,160,163840,2190,2190,166030
test,627,97,99328,1251,1251,100579
test,628,127,130048,1587,1587,131635
test,629,126,129024,1726,1726,130750
test,630,180,184320,2590,2590,186910
test,631,189,193536,2593,2593,196129
test,632,104,106496,1158,1158,107654
test,633,190,194560,2448,2448,197008
test,634,143,146432,1963,1963,148395
test,635,142,145408,1876,1876,147284
test,636,181,185344,2435,2435,187779
test,637,171,175104,2241,2241,177345
test,638,163,166912,2157,2157,169069
test,639,125,128000,1649,1649,129649
test,640,141,144384,1901,1901,146285
test,641,204,208896,2876,2876,211772
test,642,73,74752,849,849,75601
test,643,130,133120,1920,1920,135040
test,644,176,180224,2490,2490,182714
test,645,157,160768,2021,2021,162789
test,646,238,243712,3564,3564,247276
test,647,66,67584,732,732,68316
test,648,165,168960,2555,2555,171515
test,649,56,57344,622,622,57966
test,650,85,87040,1023,1023,88063
test,651,202,206848,3000,3000,209848
test,652,142,145408,2008,2008,147416
test,653,111,113664,1323,1323,114987
test,654,113,115712,1301,1301,117013
test,655,190,194560,2652,2652,197212
test,656,175,179200,2495,2495,181695
test,657,181,185344,2787,2787,188131
test,658,164,167936,2246,2246,170182
test,659,113,115712,1459,1459,117171
test,660,165,168960,2311,2311,171271
test,661,161,164864,1979,1979,166843
test,662,156,159744,2048,2048,161792
test,663,163,166912,2241,2241,169153
test,664,133,136192,1957,1957,138149
test,665,143,146432,2085,2085,148517
test,666,180,184320,2478,2478,186798
test,667,125,128000,1665,1665,129665
test,668,232,237568,3716,3716,241284
test,669,110,112640,1550,1550,114190
test,670,158,161792,2076,2076,163868
test,671,152,155648,1986,1986,157634
test,672,195,199680,2795,2795,202475
test,673,156,159744,2196,2196,161940
test,674,152,155648,2126,2126,157774
test,675,118,120832,1508,1508,122340
test,676,132,135168,1846,1846,137014
test,677,107,109568,1529,1529,111097
test,678,183,187392,2635,2635,190027
test,679,103,105472,1311,1311,106783
test,680,83,84992,1009,1009,86001
test,681,134,137216,1800,1800,139016
test,682,174,178176,2534,2534,180710
test,683,169,173056,2165,2165,175221
test,684,144,147456,1792,1792,149248
test,685,233,238592,3569,3569,242161
test,686,124,126976,1488,1488,128464
test,687,130,133120,1682,1682,134802
test,688,95,97280,1303,1303,98583
test,689,110,112640,1406,1406,114046
test,690,192,196608,2722,2722,199330
test,691,118,120832,1556,1556,122388
test,692,182,186368,2652,2652,189020
test,693,156,159744,2042,2042,161786
test,694,106,108544,1460,1460,110004
test,695,181,185344,2377,2377,187721
test,696,181,185344,2779,2779,188123
test,697,142,145408,1714,1714,147122
test,698,202,206848,3092,3092,209940
test,699,157,160768,2427,2427,163195
test,700,173,177152,2357,2357,179509
test,701,124,126976,1640,1640,128616
test,702,142,145408,1822,1822,147230
test,703,141,144384,1823,1823,146207
test,704,198,202752,2944,2944,205696
test,705,147,150528,1973,1973,152501
test,706,163,166912,2123,2123,169035
test,707,82,83968,970,970,84938
test,708,94,96256,1130,1130,97386
test,709,129,132096,1581,1581,133677
test,710,110,112640,1320,1320,113960
test,711,83,84992,1165,1165,86157
test,712,195,199680,3013,3013,202693
test,713,58,59392,664,664,60056
test,714,177,181248,2495,2495,183743
test,715,66,67584,856,856,68440
test,716,132,135168,1568,1568,136736
test,717,63,64512,655,655,65167
test,718,90,92160,1086,1086,93246
test,719,58,59392,654,654,60046
test,720,101,103424,1273,1273,104697
test,721,138,141312,1912,1912,143224
test,722,78,79872,934,934,80806
test,723,140,143360,1842,1842,145202
test,724,180,184320,2298,2298,186618
test,725,145,148480,1817,1817,150297
test,726,172,176128,2356,2356,178484
test,727,166,169984,2432,2432,172416
test,728,84,86016,1016,1016,87032
test,729,163,166912,2263,2263,169175
test,730,203,207872,2777,2777,210649
test,731,140,143360,2018,2018,145378
test,732,188,192512,3124,3124,195636
test,733,127,130048,1599,1599,131647
test,734,118,120832,1462,1462,122294
test,735,70,71680,900,900,72580
test,736,60,61440,698,698,62138
test,737,151,154624,1925,1925,156549
test,738,78,79872,958,958,80830
test,739,201,205824,3101,3101,208925
test,740,70,71680,812,812,72492
test,741,213,218112,3109,3109,221221
test,742,201,205824,2851,2851,208675
test,743,113,115712,1387,1387,117099
test,744,72,73728,764,764,74492
test,745,151,154624,2055,2055,156679
test,746,87,89088,889,889,89977
test,747,101,103424,1367,1367,104791
test,748,137,140288,1843,1843,142131
test,749,97,99328,1113,1113,100441
test,750,290,296960,4006,4006,300966
test,751,178,182272,2398,2398,184670
test,752,143,146432,1963,1963,148395
test,753,134,137216,1992,1992,139208
test,754,96,98304,1262,1262,99566
test,755,237,242688,3323,3323,246011
test,756,126,129024,1794,1794,130818
test,757,146,149504,2010,2010,151514
test,758,109,111616,1291,1291,112907
test,759,86,88064,1084,1084,89148
test,760,142,145408,1940,1940,147348
test,761,99,101376,1225,1225,102601
test,762,135,138240,1963,1963,140203
test,763,154,157696,2114,2114,159810
test,764,191,195584,2713,2713,198297
test,765,129,132096,1551,1551,133647
test,766,108,110592,1282,1282,111874
test,767,60,61440,652,652,62092
test,768,68,69632,792,792,70424
test,769,124,126976,1684,1684,128660
test,770,119,121856,1593,1593,123449
test,771,115,117760,1449,1449,119209
test,772,178,182272,2606,2606,184878
test,773,184,188416,2930,2930,191346
test,774,133,136192,1817,1817,138009
test,775,70,71680,792,792,72472
test,776,88,90112,942,942,91054
test,777,140,143360,1868,1868,145228
test,778,123,125952,1775,1775,127727
test,779,61,62464,699,699,63163
test,780,169,173056,2571,2571,175627
test,781,230,235520,3368,3368,238888
test,782,157,160768,2147,2147,162915
test,783,61,62464,675,675,63139
test,784,171,175104,2405,2405,177509
test,785,173,177152,2295,2295,179447
test,786,111,113664,1687,1687,115351
test,787,118,120832,1552,1552,122384
test,788,181,185344,2815,2815,188159
test,789,136,139264,1948,1948,141212
test,790,115,117760,1313,1313,119073
test,791,72,73728,838,838,74566
test,792,135,138240,1931,1931,140171
test,793,143,146432,2221,2221,148653
test,794,189,193536,2727,2727,196263
test,795,52,53248,612,612,53860
test,796,112,114688,1452,1452,116140
test,797,91,93184,1039,1039,94223
test,798,132,135168,1910,1910,137078
test,799,105,107520,1285,1285,108805
test,800,96,98304,1110,1110,99414
test,801,274,280576,4200,4200,284776
test,802,144,147456,1930,1930,149386
test,803,125,128000,1687,1687,129687
test,804,98,100352,1312,1312,101664
test,805,117,119808,1589,1589,121397
test,806,195,199680,2701,2701,202381
test,807,186,190464,2434,2434,192898
test,808,177,181248,2639,2639,183887
test,809,138,141312,1906,1906,143218
test,810,114,116736,1570,1570,118306
test,811,38,38912,380,380,39292
test,812,77,78848,915,915,79763
test,813,175,179200,2357,2357,181557
test,814,194,198656,2772,2772,201428
test,815,51,52224,557,557,52781
test,816,150,153600,2000,2000,155600
test,817,68,69632,776,776,70408
test,818,117,119808,1451,1451,121259
test,819,219,224256,2993,2993,227249
test,820,201,205824,3001,3001,208825
test,821,84,86016,1116,1116,87132
test,822,220,225280,3244,3244,228524
test,823,121,123904,1459,1459,125363
test,824,234,239616,3444,3444,243060
test,825,165,168960,2089,2089,171049
test,826,172,176128,2482,2482,178610
test,827,179,183296,2563,2563,185859
test,828,186,190464,2650,2650,193114
test,829,82,83968,910,910,84878
test,830,133,136192,1745,1745,137937
test,831,142,145408,2058,2058,147466
test,832,114,116736,1486,1486,118222
test,833,77,78848,835,835,79683
test,834,57,58368,603,603,58971
test,835,91,93184,1181,1181,94365
test,836,182,186368,2730,2730,189098
test,837,217,222208,3259,3259,225467
test,838,163,166912,2337,2337,169249
test,839,124,126976,1502,1502,128478
test,840,98,100352,1190,1190,101542
test,841,156,159744,2452,2452,162196
test,842,96,98304,1148,1148,99452
test,843,140,143360,2146,2146,145506
test,844,75,76800,781,781,77581
test,845,62,63488,654,654,64142
test,846,176,180224,2626,2626,182850
test,847,145,148480,1857,1857,150337
test,848,165,168960,2293,2293,171253
test,849,161,164864,2113,2113,166977
test,850,157,160768,2023,2023,162791
test,851,136,139264,2066,2066,141330
test,852,110,112640,1366,1366,114006
test,853,118,120832,1704,1704,122536
test,854,113,115712,1485,1485,117197
test,855,183,187392,2437,2437,189829
test,856,133,136192,1755,1755,137947
test,857,113,115712,1387,1387,117099
test,858,182,186368,2662,2662,189030
test,859,130,133120,1756,1756,134876
test,860,91,93184,1207,1207,94391
test,861,156,159744,1904,1904,161648
test,862,176,180224,2538,2538,182762
test,863,253,259072,3963,3963,263035
test,864,77,78848,843,843,79691
test,865,152,155648,2138,2138,157786
test,866,176,180224,2702,2702,182926
test,867,189,193536,2923,2923,196459
test,868,76,77824,826,826,78650
test,869,165,168960,2231,2231,171191
test,870,104,106496,1244,1244,107740
test,871,84,86016,1050,1050,87066
test,872,126,129024,1582,1582,130606
test,873,146,149504,2334,2334,151838
test,874,131,134144,1843,1843,135987
test,875,54,55296,520,520,55816
test,876,203,207872,2779,2779,210651
test,877,83,84992,949,949,85941
test,878,137,140288,1985,1985,142273
test,879,111,113664,1309,1309,114973
test,880,190,194560,2852,2852,197412
test,881,151,154624,1909,1909,156533
test,882,90,92160,1096,1096,93256
test,883,172,176128,2550,2550,178678
test,884,128,131072,1768,1768,132840
test,885,166,169984,2450,2450,172434
test,886,120,122880,1652,1652,124532
test,887,175,179200,2651,2651,181851
test,888,60,61440,660,660,62100
test,889,170,174080,2216,2216,176296
test,890,78,79872,878,878,80750
test,891,144,147456,1796,1796,149252
test,892,167,171008,2429,2429,173437
test,893,147,150528,2201,2201,152729
test,894,173,177152,2161,2161,179313
test,895,82,83968,976,976,84944
test,896,110,112640,1740,1740,114380
test,897,160,163840,2456,2456,166296
test,898,80,81920,934,934,82854
test,899,207,211968,2825,2825,214793
test,900,244,249856,3164,3164,253020
test,901,129,132096,1659,1659,133755
test,902,143,146432,1671,1671,148103
test,903,151,154624,2293,2293,156917
test,904,93,95232,1119,1119,96351
test,905,179,183296,2559,2559,185855
test,906,107,109568,1323,1323,110891
test,907,91,93184,1095,1095,94279
test,908,105,107520,1275,1275,108795
test,909,57,58368,591,591,58959
test,910,145,148480,2185,2185,150665
test,911,110,112640,1394,1394,114034
test,912,127,130048,1431,1431,131479
test,913,130,133120,1672,1672,134792
test,914,141,144384,1719,1719,146103
test,915,153,156672,2025,2025,158697
test,916,153,156672,1959,1959,158631
test,917,63,64512,701,701,65213
test,918,180,184320,2546,2546,186866
test,919,131,134144,1837,1837,135981
test,920,143,146432,1983,1983,148415
test,921,105,107520,1241,1241,108761
test,922,162,165888,2320,2320,168208
test,923,102,104448,1236,1236,105684
test,924,154,157696,1952,1952,159648
test,925,65,66560,679,679,67239
test,926,152,155648,1950,1950,157598
test,927,174,178176,2494,2494,180670
test,928,151,154624,1819,1819,156443
test,929,81,82944,865,865,83809
test,930,150,153600,1986,1986,155586
test,931,99,101376,1219,1219,102595
test,932,124,126976,1666,1666,128642
test,933,182,186368,2630,2630,188998
test,934,122,124928,1462,1462,126390
test,935,113,115712,1531,1531,117243
test,936,128,131072,1618,1618,132690
test,937,236,241664,3538,3538,245202
test,938,163,166912,2447,2447,169359
test,939,100,102400,1362,1362,103762
test,940,137,140288,1735,1735,142023
test,941,163,166912,2165,2165,169077
test,942,55,56320,625,625,56945
test,943,161,164864,2543,2543,167407
test,944,165,168960,2473,2473,171433
test,945,147,150528,2141,2141,152669
test,946,94,96256,1228,1228,97484
test,947,135,138240,1779,1779,140019
test,948,145,148480,2091,2091,150571
test,949,130,133120,1666,1666,134786
test,950,115,117760,1561,1561,119321
test,951,142,145408,1788,1788,147196
test,952,231,236544,3199,3199,239743
test,953,137,140288,2197,2197,142485
test,954,144,147456,1954,1954,149410
test,955,218,223232,2826,2826,226058
test,956,103,105472,1351,1351,106823
test,957,168,172032,2216,2216,174248
test,958,121,123904,1725,1725,125629
test,959,96,98304,1150,1150,99454
test,960,168,172032,2050,2050,174082
test,961,93,95232,1143,1143,96375
test,962,119,121856,1703,1703,123559
test,963,112,114688,1544,1544,116232
test,964,126,129024,1478,1478,130502
test,965,107,109568,1453,1453,111021
test,966,97,99328,1225,1225,100553
test,967,197,201728,2905,2905,204633
test,968,186,190464,2542,2542,193006
test,969,113,115712,1599,1599,117311
test,970,105,107520,1319,1319,108839
test,971,147,150528,1935,1935,152463
test,972,125,128000,1619,1619,129619
test,973,91,93184,1115,1115,94299
test,974,115,117760,1457,1457,119217
test,975,238,243712,3482,3482,247194
test,976,124,126976,1424,1424,128400
test,977,102,104448,1264,1264,105712
test,978,199,203776,2601,2601,206377
test,979,205,209920,2835,2835,212755
test,980,123,125952,1789,1789,127741
test,981,143,146432,1857,1857,148289
test,982,171,175104,2593,2593,177697
test,983,142,145408,2116,2116,147524
test,984,170,174080,2482,2482,176562
test,985,50,51200,554,554,51754
test,986,84,86016,1088,1088,87104
test,987,149,152576,1915,1915,154491
test,988,176,180224,2424,2424,182648
test,989,216,221184,2974,2974,224158
test,990,110,112640,1346,1346,113986
test,991,67,68608,807,807,69415
test,992,128,131072,1820,1820,132892
test,993,182,186368,2426,2426,188794
test,994,141,144384,1841,1841,146225
test,995,78,79872,894,894,80766
test,996,230,235520,3474,3474,238994
test,997,153,156672,2035,2035,158707
test,998,118,120832,1322,1322,122154
test,999,197,201728,2549,2549,204277
test,1000,145,148480,1947,1947,150427
test,1001,131,134144,1609,1609,135753
test,1002,107,109568,1417,1417,110985
test,1003,120,122880,1734,1734,124614
test,1004,167,171008,2405,2405,173413
test,1005,112,114688,1400,1400,116088
test,1006,99,101376,1271,1271,102647
test,1007,192,196608,2820,2820,199428
test,1008,125,128000,1479,1479,129479
test,1009,177,181248,2245,2245,183493
test,1010,118,120832,1330,1330,122162
test,1011,161,164864,2251,2251,167115
test,1012,169,173056,2569,2569,175625
test,1013,138,141312,1918,1918,143230
test,1014,144,147456,1922,1922,149378
test,1015,114,116736,1490,1490,118226
test,1016,108,110592,1284,1284,111876
test,1017,184,188416,2402,2402,190818
test,1018,96,98304,1096,1096,99400
test,1019,150,153600,1922,1922,155522
test,1020,176,180224,2204,2204,182428
test,1021,138,141312,1804,1804,143116
test,1022,69,70656,727,727,71383
test,1023,88,90112,1074,1074,91186
test,1024,148,151552,2148,2148,153700
test,1025,162,165888,2304,2304,168192
test,1026,48,49152,542,542,49694
test,1027,126,129024,1632,1632,130656
test,1028,171,175104,2203,2203,177307
test,1029,104,106496,1372,1372,107868
test,1030,102,104448,1288,1288,105736
test,1031,59,60416,647,647,61063
test,1032,151,154624,1875,1875,156499
test,1033,145,148480,1947,1947,150427
test,1034,154,157696,1868,1868,159564
test,1035,124,126976,1506,1506,128482
test,1036,66,67584,776,776,68360
test,1037,130,133120,1762,1762,134882
test,1038,125,128000,1771,1771,129771
test,1039,48,49152,570,570,49722
test,1040,54,55296,592,592,55888
test,1041,190,194560,2624,2624,197184
test,1042,115,117760,1453,1453,119213
test,1043,117,119808,1409,1409,121217
test,1044,167,171008,2335,2335,173343
test,1045,199,203776,2665,2665,206441
test,1046,210,215040,2994,2994,218034
test,1047,199,203776,3005,3005,206781
test,1048,143,146432,1773,1773,148205
test,1049,177,181248,2681,2681,183929
test,1050,131,134144,1881,1881,136025
test,1051,129,132096,1693,1693,133789
test,1052,102,104448,1258,1258,105706
test,1053,135,138240,1593,1593,139833
test,1054,194,198656,2394,2394,201050
test,1055,185,189440,2389,2389,191829
test,1056,138,141312,1854,1854,143166
test,1057,210,215040,3100,3100,218140
test,1058,67,68608,821,821,69429
test,1059,78,79872,876,876,80748
test,1060,96,98304,1296,1296,99600
test,1061,246,251904,3624,3624,255528
test,1062,136,139264,1662,1662,140926
test,1063,240,245760,3622,3622,249382
test,1064,109,111616,1469,1469,113085
test,1065,195,199680,2865,2865,202545
test,1066,129,132096,1649,1649,133745
test,1067,101,103424,1259,1259,104683
test,1068,106,108544,1382,1382,109926
test,1069,163,166912,2293,2293,169205
test,1070,159,162816,2297,2297,165113
test,1071,124,126976,1590,1590,128566
test,1072,156,159744,2084,2084,161828
test,1073,120,122880,1518,1518,124398
test,1074,172,176128,2420,2420,178548
test,1075,233,238592,3339,3339,241931
test,1076,135,138240,1827,1827,140067
test,1077,198,202752,2900,2900,205652
test,1078,176,180224,2534,2534,182758
test,1079,275,281600,3971,3971,285571
test,1080,226,231424,3102,3102,234526
test,1081,151,154624,2017,2017,156641
test,1082,105,107520,1443,1443,108963
test,1083,184,188416,2594,2594,191010
test,1084,171,175104,2495,2495,177599
test,1085,163,166912,2397,2397,169309
test,1086,138,141312,2114,2114,143426
test,1087,185,189440,2757,2757,192197
test,1088,153,156672,2021,2021,158693
test,1089,153,156672,2039,2039,158711
test,1090,50,51200,480,480,51680
test,1091,166,169984,2260,2260,172244
test,1092,114,116736,1614,1614,118350
test,1093,57,58368,621,621,58989
test,1094,147,150528,2145,2145,152673
test,1095,175,179200,2403,2403,181603
test,1096,194,198656,2906,2906,201562
test,1097,198,202752,2964,2964,205716
test,1098,183,187392,2481,2481,189873
test,1099,250,256000,3676,3676,259676
test,1100,159,162816,2271,2271,165087
test,1101,182,186368,2642,2642,189010
test,1102,80,81920,934,934,82854
test,1103,72,73728,832,832,74560
test,1104,152,155648,2040,2040,157688
test,1105,221,226304,3417,3417,229721
test,1106,153,156672,2079,2079,158751
test,1107,226,231424,3376,3376,234800
test,1108,130,133120,1842,1842,134962
test,1109,131,134144,1859,1859,136003
test,1110,191,195584,2647,2647,198231
test,1111,128,131072,1732,1732,132804
test,1112,121,123904,1753,1753,125657
test,1113,102,104448,1320,1320,105768
test,1114,201,205824,2899,2899,208723
test,1115,119,121856,1533,1533,123389
test,1116,162,165888,2222,2222,168110
test,1117,90,92160,1002,1002,93162
test,1118,164,167936,2462,2462,170398
test,1119,122,124928,1514,1514,126442
test,1120,146,149504,1980,1980,151484
test,1121,130,133120,1782,1782,134902
test,1122,132,135168,1826,1826,136994
test,1123,69,70656,765,765,71421
test,1124,139,142336,1721,1721,144057
test,1125,238,243712,3246,3246,246958
test,1126,123,125952,1449,1449,127401
test,1127,179,183296,2319,2319,185615
test,1128,112,114688,1430,1430,116118
test,1129,156,159744,2348,2348,162092
test,1130,141,144384,2115,2115,146499
test,1131,164,167936,2226,2226,170162
test,1132,172,176128,2346,2346,178474
test,1133,116,118784,1526,1526,120310
test,1134,169,173056,2305,2305,175361
test,1135,194,198656,2440,2440,201096
test,1136,161,164864,2377,2377,167241
test,1137,165,168960,2151,2151,171111
test,1138,174,178176,2386,2386,180562
test,1139,118,120832,1492,1492,122324
test,1140,142,145408,1716,1716,147124
test,1141,93,95232,1249,1249,96481
test,1142,145,148480,2125,2125,150605
test,1143,187,191488,2577,2577,194065
test,1144,212,217088,2990,2990,220078
test,1145,144,147456,1944,1944,149400
test,1146,212,217088,3504,3504,220592
test,1147,96,98304,1232,1232,99536
test,1148,215,220160,3129,3129,223289
test,1149,212,217088,2708,2708,219796
test,1150,188,192512,2774,2774,195286
test,1151,56,57344,654,654,57998
test,1152,50,51200,556,556,51756
test,1153,68,69632,796,796,70428
test,1154,161,164864,2217,2217,167081
test,1155,185,189440,2519,2519,191959
test,1156,178,182272,2384,2384,184656
test,1157,71,72704,775,775,73479
test,1158,143,146432,1671,1671,148103
test,1159,200,204800,2948,2948,207748
test,1160,183,187392,2615,2615,190007
test,1161,170,174080,2430,2430,176510
test,1162,53,54272,671,671,54943
test,1163,69,70656,791,791,71447
test,1164,102,104448,1332,1332,105780
test,1165,119,121856,1545,1545,123401
test,1166,104,106496,1430,1430,107926
test,1167,153,156672,2207,2207,158879
test,1168,96,98304,1098,1098,99402
test,1169,90,92160,912,912,93072
test,1170,221,226304,3101,3101,229405
test,1171,133,136192,1763,1763,137955
test,1172,113,115712,1357,1357,117069
test,1173,169,173056,2387,2387,175443
test,1174,157,160768,2021,2021,162789
test,1175,106,108544,1316,1316,109860
test,1176,167,171008,2497,2497,173505
test,1177,79,80896,897,897,81793
test,1178,128,131072,1858,1858,132930
test,1179,161,164864,1937,1937,166801
test,1180,120,122880,1508,1508,124388
test,1181,186,190464,2644,2644,193108
test,1182,119,121856,1345,1345,123201
test,1183,114,116736,1558,1558,118294
test,1184,101,103424,1263,1263,104687
test,1185,159,162816,2273,2273,165089
test,1186,168,172032,2266,2266,174298
test,1187,140,143360,1864,1864,145224
test,1188,113,115712,1411,1411,117123
test,1189,65,66560,709,709,67269
test,1190,117,119808,1619,1619,121427
test,1191,184,188416,2506,2506,190922
test,1192,156,159744,2318,2318,162062
test,1193,137,140288,1847,1847,142135
test,1194,163,166912,2353,2353,169265
test,1195,172,176128,2474,2474,178602
test,1196,163,166912,2205,2205,169117
test,1197,161,164864,2383,2383,167247
test,1198,107,109568,1239,1239,110807
test,1199,135,138240,2139,2139,140379
test,1200,176,180224,2466,2466,182690
test,1201,120,122880,1580,1580,124460
test,1202,56,57344,622,622,57966
test,1203,156,159744,2238,2238,161982
test,1204,130,133120,1822,1822,134942
test,1205,112,114688,1454,1454,116142
test,1206,202,206848,2874,2874,209722
test,1207,147,150528,2037,2037,152565
test,1208,181,185344,2309,2309,187653
test,1209,223,228352,2907,2907,231259
test,1210,89,91136,1105,1105,92241
test,1211,103,105472,1243,1243,106715
test,1212,252,258048,3586,3586,261634
test,1213,42,43008,452,452,43460
test,1214,206,210944,2760,2760,213704
test,1215,168,172032,2218,2218,174250
test,1216,114,116736,1736,1736,118472
test,1217,122,124928,1728,1728,126656
test,1218,139,142336,1869,1869,144205
test,1219,187,191488,2727,2727,194215
test,1220,199,203776,2849,2849,206625
test,1221,179,183296,2367,2367,185663
test,1222,127,130048,1653,1653,131701
test,1223,83,84992,1041,1041,86033
test,1224,199,203776,2879,2879,206655
test,1225,177,181248,2381,2381,183629
test,1226,167,171008,2391,2391,173399
test,1227,139,142336,1907,1907,144243
test,1228,181,185344,2293,2293,187637
test,1229,186,190464,2436,2436,192900
test,1230,256,262144,3750,3750,265894
test,1231,147,150528,1959,1959,152487
test,1232,58,59392,622,622,60014
test,1233,157,160768,2207,2207,162975
test,1234,187,191488,2753,2753,194241
test,1235,33,33792,333,333,34125
test,1236,91,93184,1011,1011,94195
test,1237,52,53248,586,586,53834
test,1238,95,97280,1149,1149,98429
test,1239,172,176128,2516,2516,178644
test,1240,188,192512,2848,2848,195360
test,1241,180,184320,2788,2788,187108
test,1242,179,183296,2431,2431,185727
test,1243,154,157696,2212,2212,159908
test,1244,66,67584,862,862,68446
test,1245,64,65536,694,694,66230
test,1246,121,123904,1629,1629,125533
test,1247,143,146432,1989,1989,148421
test,1248,83,84992,967,967,85959
test,1249,182,186368,2726,2726,189094
test,1250,146,149504,1774,1774,151278
test,1251,172,176128,2646,2646,178774
test,1252,114,116736,1516,1516,118252
test,1253,153,156672,2309,2309,158981
test,1254,162,165888,2270,2270,168158
test,1255,140,143360,1788,1788,145148
test,1256,162,165888,2154,2154,168042
test,1257,104,106496,1398,1398,107894
test,1258,146,149504,1894,1894,151398
test,1259,180,184320,2578,2578,186898
test,1260,68,69632,828,828,70460
test,1261,111,113664,1417,1417,115081
test,1262,160,163840,2338,2338,166178
test,1263,191,195584,2877,2877,198461
test,1264,110,112640,1366,1366,114006
test,1265,129,132096,1781,1781,133877
test,1266,135,138240,1679,1679,139919
test,1267,148,151552,1974,1974,153526
test,1268,236,241664,3226,3226,244890
test,1269,171,175104,2259,2259,177363
test,1270,174,178176,2382,2382,180558
test,1271,110,112640,1402,1402,114042
test,1272,50,51200,540,540,51740
test,1273,132,135168,1730,1730,136898
test,1274,128,131072,1626,1626,132698
test,1275,160,163840,2186,2186,166026
test,1276,187,191488,2383,2383,193871
test,1277,217,222208,3049,3049,225257
test,1278,184,188416,2658,2658,191074
test,1279,184,188416,2590,2590,191006
test,1280,119,121856,1499,1499,123355
test,1281,130,133120,1604,1604,134724
test,1282,193,197632,2567,2567,200199
test,1283,130,133120,1740,1740,134860
test,1284,156,159744,2056,2056,161800
test,1285,96,98304,1256,1256,99560
test,1286,242,247808,3846,3846,251654
test,1287,66,67584,746,746,68330
test,1288,46,47104,494,494,47598
test,1289,136,139264,1818,1818,141082
test,1290,160,163840,2140,2140,165980
test,1291,122,124928,1556,1556,126484
test,1292,90,92160,1034,1034,93194
test,1293,195,199680,2535,2535,202215
test,1294,52,53248,528,528,53776
test,1295,118,120832,1490,1490,122322
test,1296,167,171008,1911,1911,172919
test,1297,218,223232,3190,3190,226422
test,1298,131,134144,1659,1659,135803
test,1299,140,143360,1940,1940,145300
test,1300,92,94208,1076,1076,95284
test,1301,90,92160,1066,1066,93226
test,1302,120,122880,1448,1448,124328
test,1303,58,59392,652,652,60044
test,1304,232,237568,3380,3380,240948
test,1305,136,139264,1740,1740,141004
test,1306,166,169984,1988,1988,171972
test,1307,45,46080,475,475,46555
test,1308,178,182272,2562,2562,184834
test,1309,189,193536,2351,2351,195887
test,1310,64,65536,746,746,66282
test,1311,145,148480,1881,1881,150361
test,1312,115,117760,1375,1375,119135
test,1313,120,122880,1766,1766,124646
test,1314,107,109568,1579,1579,111147
test,1315,165,168960,2511,2511,171471
test,1316,191,195584,2615,2615,198199
test,1317,159,162816,2369,2369,165185
test,1318,106,108544,1280,1280,109824
test,1319,50,51200,574,574,51774
test,1320,66,67584,692,692,68276
test,1321,172,176128,2440,2440,178568
test,1322,76,77824,998,998,78822
test,1323,175,179200,2473,2473,181673
test,1324,128,131072,1794,1794,132866
test,1325,168,172032,2286,2286,174318
test,1326,126,129024,1410,1410,130434
test,1327,98,100352,1248,1248,101600
test,1328,216,221184,2928,2928,224112
test,1329,98,100352,1048,1048,101400
test,1330,256,262144,3654,3654,265798
test,1331,161,164864,2483,2483,167347
test,1332,111,113664,1289,1289,114953
test,1333,167,171008,2193,2193,173201
test,1334,212,217088,2760,2760,219848
test,1335,135,138240,1809,1809,140049
test,1336,165,168960,2343,2343,171303
test,1337,115,117760,1547,1547,119307
test,1338,146,149504,2082,2082,151586
test,1339,167,171008,2243,2243,173251
test,1340,82,83968,880,880,84848
test,1341,137,140288,2053,2053,142341
test,1342,132,135168,1746,1746,136914
test,1343,198,202752,2566,2566,205318
test,1344,135,138240,1561,1561,139801
test,1345,147,150528,2081,2081,152609
test,1346,153,156672,1775,1775,158447
test,1347,72,73728,964,964,74692
test,1348,110,112640,1504,1504,114144
test,1349,78,79872,808,808,80680
test,1350,177,181248,2347,2347,183595
test,1351,134,137216,1720,1720,138936
test,1352,76,77824,856,856,78680
test,1353,100,102400,1208,1208,103608
test,1354,109,111616,1429,1429,113045
test,1355,211,216064,3371,3371,219435
test,1356,135,138240,1743,1743,139983
test,1357,56,57344,610,610,57954
test,1358,134,137216,1930,1930,139146
test,1359,123,125952,1611,1611,127563
test,1360,148,151552,1970,1970,153522
test,1361,107,109568,1285,1285,110853
test,1362,132,135168,1608,1608,136776
test,1363,103,105472,1377,1377,106849
test,1364,241,246784,3473,3473,250257
test,1365,175,179200,2735,2735,181935
test,1366,166,169984,2474,2474,172458
test,1367,193,197632,2507,2507,200139
test,1368,119,121856,1619,1619,123475
test,1369,133,136192,1675,1675,137867
test,1370,125,128000,1503,1503,129503
test,1371,118,120832,1572,1572,122404
test,1372,127,130048,1605,1605,131653
test,1373,116,118784,1490,1490,120274
test,1374,183,187392,2853,2853,190245
test,1375,137,140288,1843,1843,142131
test,1376,40,40960,386,386,41346
test,1377,245,250880,3847,3847,254727
test,1378,142,145408,1946,1946,147354
test,1379,41,41984,413,413,42397
test,1380,137,140288,1759,1759,142047
test,1381,85,87040,1091,1091,88131
test,1382,129,132096,1607,1607,133703
test,1383,69,70656,793,793,71449
test,1384,121,123904,1527,1527,125431
test,1385,108,110592,1350,1350,111942
test,1386,186,190464,2590,2590,193054
test,1387,99,101376,1205,1205,102581
test,1388,143,146432,1859,1859,148291
test,1389,111,113664,1491,1491,115155
test,1390,128,131072,1924,1924,132996
test,1391,211,216064,2787,2787,218851
test,1392,161,164864,1993,1993,166857
test,1393,175,179200,2329,2329,181529
test,1394,58,59392,650,650,60042
test,1395,197,201728,2829,2829,204557
test,1396,125,128000,1465,1465,129465
test,1397,180,184320,2726,2726,187046
test,1398,85,87040,883,883,87923
test,1399,168,172032,2226,2226,174258
test,1400,120,122880,1652,1652,124532
test,1401,109,111616,1271,1271,112887
test,1402,104,106496,1222,1222,107718
test,1403,157,160768,2091,2091,162859
test,1404,41,41984,437,437,42421
test,1405,122,124928,1386,1386,126314
test,1406,114,116736,1592,1592,118328
test,1407,193,197632,2717,2717,200349
test,1408,171,175104,2239,2239,177343
test,1409,83,84992,1017,1017,86009
test,1410,184,188416,2554,2554,190970
test,1411,142,145408,1912,1912,147320
test,1412,146,149504,1974,1974,151478
test,1413,158,161792,2168,2168,163960
test,1414,124,126976,1488,1488,128464
test,1415,208,212992,3172,3172,216164
test,1416,108,110592,1262,1262,111854
test,1417,172,176128,2502,2502,178630
test,1418,256,262144,3848,3848,265992
test,1419,142,145408,1856,1856,147264
test,1420,163,166912,2465,2465,169377
test,1421,125,128000,1669,1669,129669
test,1422,122,124928,1882,1882,126810
test,1423,280,286720,3904,3904,290624
test,1424,99,101376,1221,1221,102597
test,1425,229,234496,3373,3373,237869
test,1426,174,178176,2804,2804,180980
test,1427,183,187392,2205,2205,189597
test,1428,158,161792,2138,2138,163930
test,1429,150,153600,2060,2060,155660
test,1430,199,203776,2563,2563,206339
test,1431,149,152576,2057,2057,154633
test,1432,117,119808,1485,1485,121293
test,1433,187,191488,2559,2559,194047
test,1434,66,67584,746,746,68330
test,1435,165,168960,2229,2229,171189
test,1436,173,177152,2475,2475,179627
test,1437,158,161792,1992,1992,163784
test,1438,133,136192,1587,1587,137779
test,1439,53,54272,569,569,54841
test,1440,158,161792,2222,2222,164014
test,1441,94,96256,1068,1068,97324
test,1442,143,146432,2117,2117,148549
test,1443,81,82944,975,975,83919
test,1444,221,226304,2899,2899,229203
test,1445,93,95232,1081,1081,96313
test,1446,80,81920,908,908,82828
test,1447,178,182272,2130,2130,184402
test,1448,114,116736,1524,1524,118260
test,1449,102,104448,1344,1344,105792
test,1450,157,160768,1957,1957,162725
test,1451,83,84992,957,957,85949
test,1452,127,130048,1865,1865,131913
test,1453,72,73728,858,858,74586
test,1454,184,188416,2654,2654,191070
test,1455,220,225280,3414,3414,228694
test,1456,134,137216,1886,1886,139102
test,1457,128,131072,1606,1606,132678
test,1458,70,71680,780,780,72460
test,1459,95,97280,1181,1181,98461
test,1460,174,178176,2440,2440,180616
test,1461,78,79872,910,910,80782
test,1462,146,149504,2078,2078,151582
test,1463,183,187392,2867,2867,190259
test,1464,105,107520,1329,1329,108849
test,1465,162,165888,1924,1924,167812
test,1466,72,73728,896,896,74624
test,1467,183,187392,2397,2397,189789
test,1468,208,212992,2818,2818,215810
test,1469,136,139264,1790,1790,141054
test,1470,149,152576,1935,1935,154511
test,1471,191,195584,2691,2691,198275
test,1472,139,142336,1889,1889,144225
test,1473,136,139264,1734,1734,140998
test,1474,182,186368,2754,2754,189122
test,1475,95,97280,1077,1077,98357
test,1476,84,86016,1026,1026,87042
test,1477,131,134144,1791,1791,135935
test,1478,174,178176,2324,2324,180500
test,1479,131,134144,1755,1755,135899
test,1480,170,174080,2812,2812,176892
test,1481,128,131072,1692,1692,132764
test,1482,124,126976,1774,1774,128750
test,1483,194,198656,2732,2732,201388
test,1484,100,102400,1268,1268,103668
test,1485,98,100352,1340,1340,101692
test,1486,135,138240,2021,2021,140261
test,1487,196,200704,2890,2890,203594
test,1488,152,155648,1924,1924,157572
test,1489,145,148480,1967,1967,150447
test,1490,77,78848,823,823,79671
test,1491,60,61440,682,682,62122
test,1492,68,69632,890,890,70522
test,1493,103,105472,1271,1271,106743
test,1494,158,161792,2068,2068,163860
test,1495,207,211968,2725,2725,214693
test,1496,254,260096,3920,3920,264016
test,1497,149,152576,1919,1919,154495
test,1498,190,194560,2614,2614,197174
test,1499,202,206848,2516,2516,209364
test,1500,104,106496,1418,1418,107914
test,1501,172,176128,2254,2254,178382
test,1502,66,67584,724,724,68308
test,1503,144,147456,1912,1912,149368
test,1504,139,142336,1877,1877,144213
test,1505,145,148480,2021,2021,150501
test,1506,75,76800,1047,1047,77847
test,1507,166,169984,2776,2776,172760
test,1508,120,122880,1466,1466,124346
test,1509,161,164864,2009,2009,166873
test,1510,46,47104,496,496,47600
test,1511,169,173056,2607,2607,175663
test,1512,63,64512,703,703,65215
test,1513,87,89088,1017,1017,90105
test,1514,103,105472,1267,1267,106739
test,1515,133,136192,1839,1839,138031
test,1516,154,157696,2034,2034,159730
test,1517,141,144384,1787,1787,146171
test,1518,72,73728,790,790,74518
test,1519,116,118784,1388,1388,120172
test,1520,156,159744,1922,1922,161666
test,1521,132,135168,2016,2016,137184
test,1522,161,164864,2473,2473,167337
test,1523,168,172032,2324,2324,174356
test,1524,58,59392,592,592,59984
test,1525,98,100352,1362,1362,101714
test,1526,157,160768,2103,2103,162871
test,1527,136,139264,1960,1960,141224
test,1528,176,180224,2300,2300,182524
test,1529,121,123904,1683,1683,125587
test,1530,186,190464,2576,2576,193040
test,1531,169,173056,2409,2409,175465
test,1532,155,158720,2031,2031,160751
test,1533,105,107520,1495,1495,109015
test,1534,138,141312,1892,1892,143204
test,1535,179,183296,2523,2523,185819
test,1536,105,107520,1347,1347,108867
test,1537,147,150528,2207,2207,152735
test,1538,203,207872,2867,2867,210739
test,1539,147,150528,1987,1987,152515
test,1540,194,198656,2704,2704,201360
test,1541,206,210944,3132,3132,214076
test,1542,149,152576,1983,1983,154559
test,1543,153,156672,2275,2275,158947
test,1544,115,117760,1427,1427,119187
test,1545,138,141312,1746,1746,143058
test,1546,176,180224,2230,2230,182454
test,1547,132,135168,1818,1818,136986
test,1548,93,95232,1121,1121,96353
test,1549,135,138240,1751,1751,139991
test,1550,69,70656,881,881,71537
test,1551,180,184320,2610,2610,186930
test,1552,124,126976,1756,1756,128732
test,1553,167,171008,2589,2589,173597
test,1554,111,113664,1493,1493,115157
test,1555,146,149504,1936,1936,151440
test,1556,211,216064,2847,2847,218911
test,1557,147,150528,2083,2083,152611
test,1558,202,206848,2830,2830,209678
test,1559,90,92160,1098,1098,93258
test,1560,208,212992,3054,3054,216046
test,1561,69,70656,903,903,71559
test,1562,151,154624,1931,1931,156555
test,1563,173,177152,2159,2159,179311
test,1564,151,154624,2083,2083,156707
test,1565,148,151552,2232,2232,153784
test,1566,154,157696,2096,2096,159792
test,1567,124,126976,1480,1480,128456
test,1568,150,153600,2048,2048,155648
test,1569,69,70656,775,775,71431
test,1570,103,105472,1303,1303,106775
test,1571,139,142336,1791,1791,144127
test,1572,147,150528,2127,2127,152655
test,1573,101,103424,1181,1181,104605
test,1574,129,132096,1587,1587,133683
test,1575,68,69632,766,766,70398
test,1576,107,109568,1299,1299,110867
test,1577,157,160768,2345,2345,163113
test,1578,163,166912,2161,2161,169073
test,1579,160,163840,2134,2134,165974
test,1580,206,210944,2878,2878,213822
test,1581,100,102400,1364,1364,103764
test,1582,167,171008,2343,2343,173351
test,1583,219,224256,3259,3259,227515
test,1584,102,104448,1182,1182,105630
test,1585,111,113664,1425,1425,115089
test,1586,59,60416,663,663,61079
test,1587,116,118784,1640,1640,120424
test,1588,119,121856,1457,1457,123313
test,1589,170,174080,2296,2296,176376
test,1590,122,124928,1694,1694,126622
test,1591,180,184320,2698,2698,187018
test,1592,91,93184,1213,1213,94397
test,1593,65,66560,779,779,67339
test,1594,194,198656,2578,2578,201234
test,1595,185,189440,2413,2413,191853
test,1596,93,95232,1197,1197,96429
test,1597,199,203776,2671,2671,206447
test,1598,86,88064,964,964,89028
test,1599,139,142336,1609,1609,143945
test,1600,138,141312,1628,1628,142940
test,1601,108,110592,1340,1340,111932
test,1602,161,164864,2109,2109,166973
test,1603,171,175104,2411,2411,177515
test,1604,132,135168,1892,1892,137060
test,1605,120,122880,1698,1698,124578
test,1606,181,185344,2569,2569,187913
test,1607,201,205824,2689,2689,208513
test,1608,209,214016,2721,2721,216737
test,1609,154,157696,2102,2102,159798
test,1610,122,124928,1358,1358,126286
test,1611,103,105472,1455,1455,106927
test,1612,102,104448,1328,1328,105776
test,1613,88,90112,1066,1066,91178
test,1614,173,177152,2323,2323,179475
test,1615,85,87040,991,991,88031
test,1616,140,143360,2092,2092,145452
test,1617,109,111616,1441,1441,113057
test,1618,75,76800,813,813,77613
test,1619,157,160768,1895,1895,162663
test,1620,159,162816,2207,2207,165023
test,1621,131,134144,2009,2009,136153
test,1622,142,145408,1880,1880,147288
test,1623,137,140288,1801,1801,142089
test,1624,94,96256,1116,1116,97372
test,1625,162,165888,2640,2640,168528
test,1626,82,83968,938,938,84906
test,1627,161,164864,2003,2003,166867
test,1628,146,149504,1914,1914,151418
test,1629,212,217088,3188,3188,220276
test,1630,82,83968,862,862,84830
test,1631,117,119808,1603,1603,121411
test,1632,185,189440,2561,2561,192001
test,1633,81,82944,945,945,83889
test,1634,165,168960,2399,2399,171359
test,1635,156,159744,1862,1862,161606
test,1636,135,138240,1681,1681,139921
test,1637,135,138240,1569,1569,139809
test,1638,148,151552,2050,2050,153602
test,1639,119,121856,1693,1693,123549
test,1640,191,195584,2633,2633,198217
test,1641,195,199680,2645,2645,202325
test,1642,175,179200,2749,2749,181949
test,1643,82,83968,1078,1078,85046
test,1644,179,183296,2385,2385,185681
test,1645,176,180224,2538,2538,182762
test,1646,119,121856,1497,1497,123353
test,1647,190,194560,2862,2862,197422
test,1648,145,148480,2035,2035,150515
test,1649,76,77824,776,776,78600
test,1650,123,125952,1725,1725,127677
test,1651,97,99328,1377,1377,100705
test,1652,97,99328,1193,1193,100521
test,1653,147,150528,1821,1821,152349
test,1654,52,53248,496,496,53744
test,1655,115,117760,1489,1489,119249
test,1656,69,70656,711,711,71367
test,1657,130,133120,1724,1724,134844
test,1658,119,121856,1469,1469,123325
test,1659,42,43008,442,442,43450
test,1660,266,272384,3856,3856,276240
test,1661,153,156672,2239,2239,158911
test,1662,122,124928,1600,1600,126528
test,1663,192,196608,2842,2842,199450
test,1664,86,88064,1080,1080,89144
test,1665,83,84992,989,989,85981
test,1666,265,271360,3897,3897,275257
test,1667,105,107520,1327,1327,108847
test,1668,163,166912,2165,2165,169077
test,1669,124,126976,1636,1636,128612
test,1670,170,174080,2316,2316,176396
test,1671,80,81920,890,890,82810
test,1672,155,158720,2091,2091,160811
test,1673,102,104448,1284,1284,105732
test,1674,219,224256,2981,2981,227237
test,1675,122,124928,1646,1646,126574
test,1676,108,110592,1372,1372,111964
test,1677,144,147456,1818,1818,149274
test,1678,197,201728,2979,2979,204707
test,1679,144,147456,1812,1812,149268
test,1680,112,114688,1412,1412,116100
test,1681,65,66560,775,775,67335
test,1682,99,101376,1267,1267,102643
test,1683,124,126976,1480,1480,128456
test,1684,87,89088,1053,1053,90141
test,1685,125,128000,1679,1679,129679
test,1686,148,151552,1842,1842,153394
test,1687,142,145408,1854,1854,147262
test,1688,145,148480,2135,2135,150615
test,1689,103,105472,1153,1153,106625
test,1690,98,100352,1264,1264,101616
test,1691,132,135168,1794,1794,136962
test,1692,131,134144,1779,1779,135923
test,1693,219,224256,3255,3255,227511
test,1694,147,150528,1967,1967,152495
test,1695,162,165888,2494,2494,168382
test,1696,97,99328,1231,1231,100559
test,1697,225,230400,3203,3203,233603
test,1698,177,181248,2167,2167,183415
test,1699,76,77824,824,824,78648
test,1700,164,167936,2112,2112,170048
test,1701,153,156672,1943,1943,158615
test,1702,222,227328,3086,3086,230414
test,1703,158,161792,2128,2128,163920
test,1704,130,133120,1846,1846,134966
test,1705,100,102400,1214,1214,103614
test,1706,182,186368,2560,2560,188928
test,1707,164,167936,2520,2520,170456
test,1708,191,195584,2861,2861,198445
test,1709,214,219136,2750,2750,221886
test,1710,186,190464,2326,2326,192790
test,1711,127,130048,1987,1987,132035
test,1712,135,138240,1619,1619,139859
test,1713,146,149504,1914,1914,151418
test,1714,164,167936,2190,2190,170126
test,1715,87,89088,1023,1023,90111
test,1716,155,158720,2241,2241,160961
test,1717,145,148480,1995,1995,150475
test,1718,56,57344,616,616,57960
test,1719,102,104448,1346,1346,105794
test,1720,110,112640,1260,1260,113900
test,1721,170,174080,2432,2432,176512
test,1722,156,159744,2132,2132,161876
test,1723,156,159744,2196,2196,161940
test,1724,209,214016,3157,3157,217173
test,1725,69,70656,791,791,71447
test,1726,128,131072,1652,1652,132724
test,1727,125,128000,1623,1623,129623
test,1728,218,223232,3152,3152,226384
test,1729,206,210944,2880,2880,213824
test,1730,132,135168,1794,1794,136962
test,1731,83,84992,979,979,85971
test,1732,115,117760,1519,1519,119279
test,1733,124,126976,1630,1630,128606
test,1734,114,116736,1266,1266,118002
test,1735,101,103424,1291,1291,104715
test,1736,37,37888,397,397,38285
test,1737,260,266240,4294,4294,270534
test,1738,96,98304,1262,1262,99566
test,1739,135,138240,2139,2139,140379
test,1740,83,84992,965,965,85957
test,1741,181,185344,2451,2451,187795
test,1742,172,176128,2250,2250,178378
test,1743,103,105472,1129,1129,106601
test,1744,174,178176,2606,2606,180782
test,1745,122,124928,1654,1654,126582
test,1746,131,134144,1633,1633,135777
test,1747,138,141312,1948,1948,143260
test,1748,159,162816,1881,1881,164697
test,1749,132,135168,1652,1652,136820
test,1750,163,166912,2551,2551,169463
test,1751,152,155648,2356,2356,158004
test,1752,130,133120,1602,1602,134722
test,1753,159,162816,2071,2071,164887
test,1754,67,68608,771,771,69379
test,1755,96,98304,1136,1136,99440
test,1756,142,145408,1814,1814,147222
test,1757,98,100352,1154,1154,101506
test,1758,155,158720,1935,1935,160655
test,1759,90,92160,1000,1000,93160
test,1760,129,132096,1817,1817,133913
test,1761,184,188416,2642,2642,191058
test,1762,116,118784,1616,1616,120400
test,1763,72,73728,840,840,74568
test,1764,148,151552,1992,1992,153544
test,1765,117,119808,1483,1483,121291
test,1766,181,185344,2327,2327,187671
test,1767,124,126976,1554,1554,128530
test,1768,94,96256,1212,1212,97468
test,1769,88,90112,1176,1176,91288
test,1770,101,103424,1333,1333,104757
test,1771,135,138240,1625,1625,139865
test,1772,97,99328,1147,1147,100475
test,1773,180,184320,2424,2424,186744
test,1774,67,68608,773,773,69381
test,1775,253,259072,3513,3513,262585
test,1776,134,137216,1902,1902,139118
test,1777,196,200704,2820,2820,203524
test,1778,215,220160,2927,2927,223087
test,1779,61,62464,667,667,63131
test,1780,213,218112,2837,2837,220949
test,1781,164,167936,2100,2100,170036
test,1782,99,101376,1301,1301,102677
test,1783,179,183296,2479,2479,185775
test,1784,166,169984,2468,2468,172452
test,1785,78,79872,1036,1036,80908
test,1786,166,169984,2298,2298,172282
test,1787,146,149504,2194,2194,151698
test,1788,183,187392,2487,2487,189879
test,1789,158,161792,2110,2110,163902
test,1790,61,62464,847,847,63311
test,1791,70,71680,794,794,72474
test,1792,222,227328,3330,3330,230658
test,1793,175,179200,2717,2717,181917
test,1794,81,82944,1023,1023,83967
test,1795,203,207872,2801,2801,210673
test,1796,150,153600,2026,2026,155626
test,1797,89,91136,1047,1047,92183
test,1798,49,50176,519,519,50695
test,1799,196,200704,3010,3010,203714
test,1800,130,133120,1776,1776,134896
test,1801,126,129024,2056,2056,131080
test,1802,116,118784,1430,1430,120214
test,1803,232,237568,3114,3114,240682
test,1804,136,139264,2114,2114,141378
test,1805,152,155648,1866,1866,157514
test,1806,158,161792,2276,2276,164068
test,1807,199,203776,2861,2861,206637
test,1808,162,165888,2174,2174,168062
test,1809,59,60416,631,631,61047
test,1810,181,185344,2655,2655,187999
test,1811,177,181248,2571,2571,183819
test,1812,167,171008,2119,2119,173127
test,1813,101,103424,1371,1371,104795
test,1814,106,108544,1396,1396,109940
test,1815,194,198656,2568,2568,201224
test,1816,105,107520,1279,1279,108799
test,1817,166,169984,2308,2308,172292
test,1818,213,218112,2845,2845,220957
test,1819,144,147456,1808,1808,149264
test,1820,89,91136,1035,1035,92171
test,1821,237,242688,3815,3815,246503
test,1822,100,102400,1328,1328,103728
test,1823,161,164864,2305,2305,167169
test,1824,127,130048,1767,1767,131815
test,1825,64,65536,698,698,66234
test,1826,135,138240,1739,1739,139979
test,1827,80,81920,936,936,82856
test,1828,118,120832,1514,1514,122346
test,1829,79,80896,957,957,81853
test,1830,108,110592,1272,1272,111864
test,1831,243,248832,3363,3363,252195
test,1832,177,181248,2695,2695,183943
test,1833,190,194560,2338,2338,196898
test,1834,72,73728,920,920,74648
test,1835,134,137216,1676,1676,138892
test,1836,162,165888,2166,2166,168054
test,1837,99,101376,1165,1165,102541
test,1838,149,152576,2167,2167,154743
test,1839,198,202752,2566,2566,205318
test,1840,174,178176,2226,2226,180402
test,1841,132,135168,2168,2168,137336
test,1842,179,183296,2517,2517,185813
test,1843,204,208896,2956,2956,211852
test,1844,98,100352,1378,1378,101730
test,1845,125,128000,1785,1785,129785
test,1846,108,110592,1242,1242,111834
test,1847,156,159744,1954,1954,161698
test,1848,145,148480,2167,2167,150647
test,1849,171,175104,2157,2157,177261
test,1850,144,147456,2122,2122,149578
test,1851,206,210944,3070,3070,214014
test,1852,215,220160,2781,2781,222941
test,1853,63,64512,699,699,65211
test,1854,148,151552,2066,2066,153618
test,1855,99,101376,1137,1137,102513
test,1856,149,152576,2029,2029,154605
test,1857,266,272384,4264,4264,276648
test,1858,221,226304,3069,3069,229373
test,1859,167,171008,2309,2309,173317
test,1860,93,95232,1257,1257,96489
test,1861,154,157696,2124,2124,159820
test,1862,161,164864,2065,2065,166929
test,1863,174,178176,2348,2348,180524
test,1864,69,70656,827,827,71483
test,1865,123,125952,1567,1567,127519
test,1866,152,155648,2178,2178,157826
test,1867,176,180224,2174,2174,182398
test,1868,192,196608,2682,2682,199290
test,1869,108,110592,1546,1546,112138
test,1870,194,198656,2678,2678,201334
test,1871,146,149504,2148,2148,151652
test,1872,99,101376,1195,1195,102571
test,1873,146,149504,1880,1880,151384
test,1874,151,154624,2081,2081,156705
test,1875,156,159744,1902,1902,161646
test,1876,92,94208,1162,1162,95370
test,1877,142,145408,1920,1920,147328
test,1878,130,133120,1668,1668,134788
test,1879,165,168960,2295,2295,171255
test,1880,98,100352,1382,1382,101734
test,1881,87,89088,1065,1065,90153
test,1882,85,87040,983,983,88023
test,1883,119,121856,1835,1835,123691
test,1884,129,132096,1675,1675,133771
test,1885,143,146432,1881,1881,148313
test,1886,252,258048,3466,3466,261514
test,1887,240,245760,3380,3380,249140
test,1888,186,190464,2544,2544,193008
test,1889,154,157696,2330,2330,160026
test,1890,143,146432,2001,2001,148433
test,1891,99,101376,1325,1325,102701
test,1892,111,113664,1375,1375,115039
test,1893,223,228352,2989,2989,231341
test,1894,146,149504,1880,1880,151384
test,1895,138,141312,1868,1868,143180
test,1896,97,99328,1191,1191,100519
test,1897,79,80896,931,931,81827
test,1898,133,136192,1715,1715,137907
test,1899,193,197632,2649,2649,200281
test,1900,124,126976,1580,1580,128556
test,1901,202,206848,2856,2856,209704
test,1902,182,186368,2540,2540,188908
test,1903,204,208896,3068,3068,211964
test,1904,125,128000,1647,1647,129647
test,1905,79,80896,999,999,81895
test,1906,145,148480,1981,1981,150461
test,1907,168,172032,2176,2176,174208
test,1908,166,169984,2268,2268,172252
test,1909,121,123904,1545,1545,125449
test,1910,176,180224,2208,2208,182432
test,1911,70,71680,794,794,72474
test,1912,210,215040,3130,3130,218170
test,1913,129,132096,1707,1707,133803
test,1914,127,130048,1547,1547,131595
test,1915,152,155648,2054,2054,157702
test,1916,153,156672,2477,2477,159149
test,1917,150,153600,2188,2188,155788
test,1918,116,118784,1664,1664,120448
test,1919,267,273408,4007,4007,277415
test,1920,136,139264,1824,1824,141088
test,1921,153,156672,2403,2403,159075
test,1922,175,179200,2303,2303,181503
test,1923,183,187392,2457,2457,189849
test,1924,196,200704,2426,2426,203130
test,1925,164,167936,2166,2166,170102
test,1926,138,141312,1752,1752,143064
test,1927,155,158720,2117,2117,160837
test,1928,83,84992,1059,1059,86051
test,1929,112,114688,1466,1466,116154
test,1930,67,68608,821,821,69429
test,1931,63,64512,693,693,65205
test,1932,148,151552,2140,2140,153692
test,1933,122,124928,1592,1592,126520
test,1934,63,64512,775,775,65287
test,1935,199,203776,2847,2847,206623
test,1936,128,131072,1902,1902,132974
test,1937,112,114688,1414,1414,116102
test,1938,117,119808,1633,1633,121441
test,1939,183,187392,2485,2485,189877
test,1940,132,135168,1806,1806,136974
test,1941,158,161792,2140,2140,163932
test,1942,87,89088,911,911,89999
test,1943,162,165888,2256,2256,168144
test,1944,146,149504,2188,2188,151692
test,1945,165,168960,2441,2441,171401
test,1946,129,132096,1709,1709,133805
test,1947,203,207872,3003,3003,210875
test,1948,160,163840,2234,2234,166074
test,1949,86,88064,1006,1006,89070
test,1950,190,194560,2702,2702,197262
test,1951,84,86016,932,932,86948
test,1952,153,156672,2097,2097,158769
test,1953,103,105472,1373,1373,106845
test,1954,127,130048,1641,1641,131689
test,1955,200,204800,2744,2744,207544
test,1956,192,196608,2580,2580,199188
test,1957,111,113664,1371,1371,115035
test,1958,229,234496,3693,3693,238189
test,1959,143,146432,1891,1891,148323
test,1960,129,132096,1633,1633,133729
test,1961,152,155648,2370,2370,158018
test,1962,74,75776,910,910,76686
test,1963,81,82944,897,897,83841
test,1964,158,161792,2198,2198,163990
test,1965,275,281600,3997,3997,285597
test,1966,126,129024,1760,1760,130784
test,1967,125,128000,1759,1759,129759
test,1968,142,145408,1954,1954,147362
test,1969,127,130048,1627,1627,131675
test,1970,110,112640,1208,1208,113848
test,1971,82,83968,928,928,84896
test,1972,131,134144,1775,1775,135919
test,1973,130,133120,1650,1650,134770
test,1974,77,78848,853,853,79701
test,1975,100,102400,1246,1246,103646
test,1976,76,77824,848,848,78672
test,1977,60,61440,656,656,62096
test,1978,165,168960,2501,2501,171461
test,1979,43,44032,437,437,44469
test,1980,146,149504,1984,1984,151488
test,1981,83,84992,1043,1043,86035
test,1982,88,90112,990,990,91102
test,1983,80,81920,916,916,82836
test,1984,159,162816,2209,2209,165025
test,1985,166,169984,2228,2228,172212
test,1986,133,136192,2217,2217,138409
test,1987,253,259072,3683,3683,262755
test,1988,216,221184,2716,2716,223900
test,1989,63,64512,731,731,65243
test,1990,135,138240,1787,1787,140027
test,1991,184,188416,2418,2418,190834
test,1992,126,129024,1718,1718,130742
test,1993,114,116736,1682,1682,118418
test,1994,139,142336,1857,1857,144193
test,1995,119,121856,1507,1507,123363
test,1996,169,173056,2699,2699,175755
test,1997,116,118784,1432,1432,120216
test,1998,166,169984,2270,2270,172254
test,1999,143,146432,2159,2159,148591
test,2000,153,156672,2067,2067,158739
test,2001,147,150528,1863,1863,152391
test,2002,151,154624,1991,1991,156615
test,2003,140,143360,2144,2144,145504
test,2004,102,104448,1296,1296,105744
test,2005,156,159744,1952,1952,161696
test,2006,121,123904,1663,1663,125567
test,2007,49,50176,565,565,50741
test,2008,78,79872,920,920,80792
test,2009,133,136192,1855,1855,138047
test,2010,168,172032,2228,2228,174260
test,2011,99,101376,1393,1393,102769
test,2012,126,129024,1620,1620,130644
test,2013,137,140288,1779,1779,142067
test,2014,181,185344,2631,2631,187975
test,2015,110,112640,1332,1332,113972
test,2016,132,135168,1748,1748,136916
test,2017,219,224256,2961,2961,227217
test,2018,64,65536,784,784,66320
test,2019,155,158720,2175,2175,160895
test,2020,153,156672,2037,2037,158709
test,2021,135,138240,1673,1673,139913
test,2022,86,88064,1042,1042,89106
test,2023,197,201728,2785,2785,204513
test,2024,90,92160,992,992,93152
test,2025,96,98304,1210,1210,99514
test,2026,114,116736,1358,1358,118094
test,2027,159,162816,2079,2079,164895
test,2028,122,124928,1670,1670,126598
test,2029,115,117760,1427,1427,119187
test,2030,112,114688,1662,1662,116350
test,2031,146,149504,2162,2162,151666
test,2032,132,135168,1768,1768,136936
test,2033,90,92160,978,978,93138
test,2034,93,95232,1023,1023,96255
test,2035,160,163840,2052,2052,165892
test,2036,55,56320,591,591,56911
test,2037,158,161792,2312,2312,164104
test,2038,180,184320,2560,2560,186880
test,2039,169,173056,2387,2387,175443
test,2040,86,88064,972,972,89036
test,2041,157,160768,2049,2049,162817
test,2042,125,128000,1939,1939,129939
test,2043,72,73728,764,764,74492
test,2044,184,188416,2674,2674,191090
test,2045,190,194560,2896,2896,197456
test,2046,128,131072,1518,1518,132590
test,2047,145,148480,2007,2007,150487
test,2048,113,115712,1441,1441,117153
test,2049,104,106496,1300,1300,107796
test,2050,163,166912,2083,2083,168995
test,2051,108,110592,1450,1450,112042
test,2052,174,178176,2540,2540,180716
test,2053,148,151552,2044,2044,153596
test,2054,156,159744,2340,2340,162084
test,2055,103,105472,1147,1147,106619
test,2056,132,135168,1704,1704,136872
test,2057,116,118784,1512,1512,120296
test,2058,160,163840,2040,2040,165880
test,2059,118,120832,1732,1732,122564
test,2060,183,187392,2753,2753,190145
test,2061,152,155648,1904,1904,157552
test,2062,135,138240,1649,1649,139889
test,2063,124,126976,1576,1576,128552
test,2064,213,218112,3165,3165,221277
test,2065,137,140288,1783,1783,142071
test,2066,114,116736,1348,1348,118084
test,2067,132,135168,1750,1750,136918
test,2068,210,215040,2944,2944,217984
test,2069,144,147456,2194,2194,149650
test,2070,194,198656,2862,2862,201518
test,2071,122,124928,1664,1664,126592
test,2072,80,81920,1120,1120,83040
test,2073,109,111616,1395,1395,113011
test,2074,113,115712,1337,1337,117049
test,2075,138,141312,1800,1800,143112
test,2076,167,171008,2425,2425,173433
test,2077,57,58368,651,651,59019
test,2078,103,105472,1297,1297,106769
test,2079,101,103424,1293,1293,104717
test,2080,122,124928,1550,1550,126478
test,2081,112,114688,1278,1278,115966
test,2082,130,133120,1914,1914,135034
test,2083,78,79872,886,886,80758
test,2084,169,173056,2589,2589,175645
test,2085,115,117760,1583,1583,119343
test,2086,111,113664,1561,1561,115225
test,2087,153,156672,2135,2135,158807
test,2088,99,101376,1221,1221,102597
test,2089,193,197632,2965,2965,200597
test,2090,61,62464,661,661,63125
test,2091,146,149504,2084,2084,151588
test,2092,108,110592,1432,1432,112024
test,2093,86,88064,1058,1058,89122
test,2094,94,96256,1160,1160,97416
test,2095,130,133120,1786,1786,134906
test,2096,197,201728,2903,2903,204631
test,2097,196,200704,2736,2736,203440
test,2098,192,196608,2578,2578,199186
test,2099,132,135168,1730,1730,136898
test,2100,88,90112,1122,1122,91234
test,2101,241,246784,3267,3267,250051
test,2102,194,198656,2684,2684,201340
test,2103,206,210944,2936,2936,213880
test,2104,173,177152,2271,2271,179423
test,2105,58,59392,614,614,60006
test,2106,134,137216,1608,1608,138824
test,2107,181,185344,2815,2815,188159
test,2108,256,262144,3618,3618,265762
test,2109,161,164864,2443,2443,167307
test,2110,186,190464,2828,2828,193292
test,2111,149,152576,1815,1815,154391
test,2112,151,154624,1963,1963,156587
test,2113,110,112640,1380,1380,114020
test,2114,214,219136,2992,2992,222128
test,2115,206,210944,2590,2590,213534
test,2116,56,57344,546,546,57890
test,2117,142,145408,1900,1900,147308
test,2118,103,105472,1259,1259,106731
test,2119,111,113664,1413,1413,115077
test,2120,62,63488,676,676,64164
test,2121,222,227328,3428,3428,230756
test,2122,143,146432,1975,1975,148407
test,2123,99,101376,1105,1105,102481
test,2124,109,111616,1293,1293,112909
test,2125,166,169984,2474,2474,172458
test,2126,162,165888,2070,2070,167958
test,2127,63,64512,723,723,65235
test,2128,131,134144,1655,1655,135799
test,2129,139,142336,1813,1813,144149
test,2130,169,173056,2431,2431,175487
test,2131,165,168960,2229,2229,171189
test,2132,162,165888,2102,2102,167990
test,2133,78,79872,896,896,80768
test,2134,172,176128,2362,2362,178490
test,2135,115,117760,1579,1579,119339
test,2136,84,86016,1046,1046,87062
test,2137,155,158720,2129,2129,160849
test,2138,88,90112,1036,1036,91148
test,2139,187,191488,2643,2643,194131
test,2140,112,114688,1594,1594,116282
test,2141,135,138240,1765,1765,140005
test,2142,136,139264,1868,1868,141132
test,2143,226,231424,2878,2878,234302
test,2144,219,224256,3013,3013,227269
test,2145,178,182272,2422,2422,184694
test,2146,105,107520,1317,1317,108837
test,2147,171,175104,2239,2239,177343
test,2148,185,189440,2691,2691,192131
test,2149,130,133120,1670,1670,134790
test,2150,126,129024,1708,1708,130732
test,2151,190,194560,2554,2554,197114
test,2152,124,126976,1706,1706,128682
test,2153,133,136192,1775,1775,137967
test,2154,102,104448,1234,1234,105682
test,2155,234,239616,3132,3132,242748
test,2156,169,173056,2333,2333,175389
test,2157,214,219136,3122,3122,222258
test,2158,61,62464,687,687,63151
test,2159,132,135168,1676,1676,136844
test,2160,116,118784,1524,1524,120308
test,2161,172,176128,2512,2512,178640
test,2162,200,204800,2948,2948,207748
test,2163,167,171008,2103,2103,173111
test,2164,126,129024,1746,1746,130770
test,2165,104,106496,1394,1394,107890
test,2166,196,200704,2646,2646,203350
test,2167,165,168960,2257,2257,171217
test,2168,205,209920,3311,3311,213231
test,2169,154,157696,2000,2000,159696
test,2170,138,141312,1918,1918,143230
test,2171,148,151552,2270,2270,153822
test,2172,146,149504,2050,2050,151554
test,2173,176,180224,2318,2318,182542
test,2174,131,134144,1909,1909,136053
test,2175,230,235520,3514,3514,239034
test,2176,151,154624,1961,1961,156585
test,2177,71,72704,835,835,73539
test,2178,191,195584,2731,2731,198315
test,2179,171,175104,2257,2257,177361
test,2180,85,87040,895,895,87935
test,2181,150,153600,2250,2250,155850
test,2182,116,118784,1400,1400,120184
test,2183,190,194560,2714,2714,197274
test,2184,180,184320,2508,2508,186828
test,2185,163,166912,2291,2291,169203
test,2186,262,268288,3894,3894,272182
test,2187,117,119808,1481,1481,121289
test,2188,177,181248,2487,2487,183735
test,2189,126,129024,1714,1714,130738
test,2190,117,119808,1437,1437,121245
test,2191,84,86016,1132,1132,87148
test,2192,94,96256,1130,1130,97386
test,2193,128,131072,1800,1800,132872
test,2194,82,83968,936,936,84904
test,2195,170,174080,2694,2694,176774
test,2196,135,138240,2063,2063,140303
test,2197,114,116736,1546,1546,118282
test,2198,233,238592,3121,3121,241713
test,2199,96,98304,1294,1294,99598
test,2200,108,110592,1500,1500,112092
test,2201,105,107520,1271,1271,108791
test,2202,68,69632,772,772,70404
test,2203,60,61440,684,684,62124
test,2204,126,129024,1514,1514,130538
test,2205,154,157696,1970,1970,159666
test,2206,108,110592,1554,1554,112146
test,2207,90,92160,1450,1450,93610
test,2208,199,203776,2767,2767,206543
test,2209,107,109568,1247,1247,110815
test,2210,145,148480,1915,1915,150395
test,2211,133,136192,1679,1679,137871
test,2212,149,152576,2039,2039,154615
test,2213,128,131072,1778,1778,132850
test,2214,105,107520,1361,1361,108881
test,2215,64,65536,746,746,66282
test,2216,105,107520,1357,1357,108877
test,2217,67,68608,807,807,69415
test,2218,156,159744,2096,2096,161840
test,2219,172,176128,2656,2656,178784
test,2220,190,194560,2646,2646,197206
test,2221,202,206848,2920,2920,209768
test,2222,140,143360,1750,1750,145110
test,2223,125,128000,1465,1465,129465
test,2224,163,166912,2043,2043,168955
test,2225,34,34816,342,342,35158
test,2226,125,128000,1639,1639,129639
test,2227,238,243712,3734,3734,247446
test,2228,117,119808,1457,1457,121265
test,2229,136,139264,1714,1714,140978
test,2230,163,166912,2291,2291,169203
test,2231,62,63488,674,674,64162
test,2232,111,113664,1317,1317,114981
test,2233,155,158720,2059,2059,160779
test,2234,156,159744,2276,2276,162020
test,2235,118,120832,1558,1558,122390
test,2236,146,149504,2014,2014,151518
test,2237,185,189440,2675,2675,192115
test,2238,152,155648,2016,2016,157664
test,2239,141,144384,2105,2105,146489
test,2240,73,74752,845,845,75597
test,2241,111,113664,1455,1455,115119
test,2242,155,158720,2177,2177,160897
test,2243,157,160768,2153,2153,162921
test,2244,90,92160,1054,1054,93214
test,2245,91,93184,1095,1095,94279
test,2246,201,205824,2821,2821,208645
test,2247,195,199680,2515,2515,202195
test,2248,163,166912,1937,1937,168849
test,2249,141,144384,2067,2067,146451
test,2250,181,185344,2529,2529,187873
test,2251,60,61440,704,704,62144
test,2252,151,154624,2039,2039,156663
test,2253,154,157696,2062,2062,159758
test,2254,93,95232,1243,1243,96475
test,2255,195,199680,2875,2875,202555
test,2256,124,126976,1486,1486,128462
test,2257,105,107520,1231,1231,108751
test,2258,179,183296,2363,2363,185659
test,2259,67,68608,879,879,69487
test,2260,156,159744,2176,2176,161920
test,2261,114,116736,1484,1484,118220
test,2262,133,136192,1625,1625,137817
test,2263,217,222208,2903,2903,225111
test,2264,154,157696,2400,2400,160096
test,2265,72,73728,792,792,74520
test,2266,217,222208,3341,3341,225549
test,2267,110,112640,1274,1274,113914
test,2268,147,150528,1957,1957,152485
test,2269,85,87040,999,999,88039
test,2270,224,229376,3196,3196,232572
test,2271,171,175104,2337,2337,177441
test,2272,168,172032,2538,2538,174570
test,2273,113,115712,1479,1479,117191
test,2274,167,171008,2651,2651,173659
test,2275,138,141312,1796,1796,143108
test,2276,227,232448,3395,3395,235843
test,2277,178,182272,2612,2612,184884
test,2278,159,162816,2311,2311,165127
test,2279,93,95232,1221,1221,96453
test,2280,225,230400,3651,3651,234051
test,2281,142,145408,1988,1988,147396
test,2282,215,220160,3151,3151,223311
test,2283,186,190464,2622,2622,193086
test,2284,137,140288,1677,1677,141965
test,2285,139,142336,2013,2013,144349
test,2286,98,100352,1232,1232,101584
test,2287,191,195584,2659,2659,198243
test,2288,117,119808,1545,1545,121353
test,2289,91,93184,1149,1149,94333
test,2290,144,147456,1832,1832,149288
test,2291,143,146432,2003,2003,148435
test,2292,137,140288,1619,1619,141907
test,2293,194,198656,2778,2778,201434
test,2294,181,185344,2361,2361,187705
test,2295,121,123904,1517,1517,125421
test,2296,157,160768,2233,2233,163001
test,2297,144,147456,1918,1918,149374
test,2298,153,156672,2191,2191,158863
test,2299,130,133120,1678,1678,134798
test,2300,146,149504,2076,2076,151580
test,2301,72,73728,852,852,74580
test,2302,182,186368,2560,2560,188928
test,2303,73,74752,863,863,75615
test,2304,186,190464,2588,2588,193052
test,2305,148,151552,2208,2208,153760
test,2306,204,208896,3068,3068,211964
test,2307,101,103424,1303,1303,104727
test,2308,74,75776,860,860,76636
test,2309,193,197632,3175,3175,200807
test,2310,307,314368,4389,4389,318757
test,2311,205,209920,2969,2969,212889
test,2312,152,155648,1916,1916,157564
test,2313,173,177152,2177,2177,179329
test,2314,105,107520,1557,1557,109077
test,2315,159,162816,2161,2161,164977
test,2316,126,129024,1506,1506,130530
test,2317,150,153600,2128,2128,155728
test,2318,188,192512,2764,2764,195276
test,2319,84,86016,960,960,86976
test,2320,182,186368,2404,2404,188772
test,2321,213,218112,2901,2901,221013
test,2322,127,130048,1625,1625,131673
test,2323,175,179200,2407,2407,181607
test,2324,60,61440,696,696,62136
test,2325,188,192512,2730,2730,195242
test,2326,133,136192,1607,1607,137799
test,2327,104,106496,1360,1360,107856
test,2328,164,167936,2366,2366,170302
test,2329,124,126976,1622,1622,128598
test,2330,141,144384,1731,1731,146115
test,2331,148,151552,2034,2034,153586
test,2332,86,88064,1038,1038,89102
test,2333,172,176128,2408,2408,178536
test,2334,140,143360,1942,1942,145302
test,2335,94,96256,1082,1082,97338
test,2336,156,159744,1980,1980,161724
test,2337,85,87040,925,925,87965
test,2338,208,212992,2584,2584,215576
test,2339,130,133120,1750,1750,134870
test,2340,73,74752,879,879,75631
test,2341,176,180224,2456,2456,182680
test,2342,128,131072,1688,1688,132760
test,2343,100,102400,1210,1210,103610
test,2344,103,105472,1393,1393,106865
test,2345,145,148480,2109,2109,150589
test,2346,136,139264,1872,1872,141136
test,2347,173,177152,2481,2481,179633
test,2348,116,118784,1534,1534,120318
test,2349,119,121856,1555,1555,123411
test,2350,196,200704,2732,2732,203436
test,2351,105,107520,1333,1333,108853
test,2352,148,151552,1990,1990,153542
test,2353,150,153600,2062,2062,155662
test,2354,122,124928,1714,1714,126642
test,2355,145,148480,2039,2039,150519
test,2356,145,148480,1859,1859,150339
test,2357,204,208896,2820,2820,211716
test,2358,95,97280,1131,1131,98411
test,2359,106,108544,1364,1364,109908
test,2360,196,200704,2562,2562,203266
test,2361,167,171008,2151,2151,173159
test,2362,173,177152,2301,2301,179453
test,2363,266,272384,3894,3894,276278
test,2364,128,131072,1600,1600,132672
test,2365,94,96256,1282,1282,97538
test,2366,165,168960,2289,2289,171249
test,2367,156,159744,1986,1986,161730
test,2368,212,217088,3236,3236,220324
test,2369,118,120832,1498,1498,122330
test,2370,129,132096,1613,1613,133709
test,2371,54,55296,574,574,55870
test,2372,147,150528,1897,1897,152425
test,2373,53,54272,535,535,54807
test,2374,101,103424,1345,1345,104769
test,2375,107,109568,1359,1359,110927
test,2376,148,151552,1966,1966,153518
test,2377,66,67584,750,750,68334
test,2378,201,205824,2693,2693,208517
test,2379,101,103424,1209,1209,104633
test,2380,130,133120,1696,1696,134816
test,2381,137,140288,2113,2113,142401
test,2382,223,228352,3073,3073,231425
test,2383,167,171008,2311,2311,173319
test,2384,147,150528,1957,1957,152485
test,2385,88,90112,1064,1064,91176
test,2386,139,142336,1819,1819,144155
test,2387,157,160768,2023,2023,162791
test,2388,165,168960,2367,2367,171327
test,2389,120,122880,1480,1480,124360
test,2390,231,236544,3473,3473,240017
test,2391,190,194560,2862,2862,197422
test,2392,121,123904,1511,1511,125415
test,2393,105,107520,1329,1329,108849
test,2394,114,116736,1368,1368,118104
test,2395,148,151552,1988,1988,153540
test,2396,114,116736,1502,1502,118238
test,2397,221,226304,3333,3333,229637
test,2398,180,184320,2602,2602,186922
test,2399,174,178176,2658,2658,180834
test,2400,137,140288,1695,1695,141983
test,2401,172,176128,2414,2414,178542
test,2402,193,197632,2867,2867,200499
test,2403,173,177152,2393,2393,179545
test,2404,120,122880,1528,1528,124408
test,2405,177,181248,2233,2233,183481
test,2406,111,113664,1523,1523,115187
test,2407,152,155648,2340,2340,157988
test,2408,215,220160,2901,2901,223061
test,2409,179,183296,2579,2579,185875
test,2410,129,132096,1611,1611,133707
test,2411,110,112640,1308,1308,113948
test,2412,171,175104,2113,2113,177217
test,2413,194,198656,2716,2716,201372
test,2414,198,202752,2982,2982,205734
test,2415,231,236544,3271,3271,239815
test,2416,125,128000,1753,1753,129753
test,2417,200,204800,2860,2860,207660
test,2418,238,243712,3498,3498,247210
test,2419,136,139264,1588,1588,140852
test,2420,143,146432,1825,1825,148257
test,2421,99,101376,1217,1217,102593
test,2422,164,167936,2236,2236,170172
test,2423,93,95232,1223,1223,96455
test,2424,130,133120,1592,1592,134712
test,2425,170,174080,2504,2504,176584
test,2426,173,177152,2527,2527,179679
test,2427,198,202752,2896,2896,205648
test,2428,173,177152,2241,2241,179393
test,2429,204,208896,2784,2784,211680
test,2430,286,292864,3950,3950,296814
test,2431,152,155648,2238,2238,157886
test,2432,266,272384,3832,3832,276216
test,2433,130,133120,1858,1858,134978
test,2434,113,115712,1445,1445,117157
test,2435,198,202752,2658,2658,205410
test,2436,118,120832,1634,1634,122466
test,2437,81,82944,923,923,83867
test,2438,175,179200,2483,2483,181683
test,2439,71,72704,831,831,73535
test,2440,194,198656,3018,3018,201674
test,2441,189,193536,2889,2889,196425
test,2442,196,200704,2646,2646,203350
test,2443,205,209920,2789,2789,212709
test,2444,126,129024,1508,1508,130532
test,2445,60,61440,664,664,62104
test,2446,168,172032,2312,2312,174344
test,2447,235,240640,3235,3235,243875
test,2448,142,145408,1770,1770,147178
test,2449,118,120832,1354,1354,122186
test,2450,87,89088,1089,1089,90177
test,2451,205,209920,2957,2957,212877
test,2452,84,86016,964,964,86980
test,2453,60,61440,622,622,62062
test,2454,167,171008,2499,2499,173507
test,2455,128,131072,1518,1518,132590
test,2456,118,120832,1440,1440,122272
test,2457,86,88064,992,992,89056
test,2458,155,158720,2097,2097,160817
test,2459,186,190464,2866,2866,193330
test,2460,121,123904,1535,1535,125439
test,2461,164,167936,2252,2252,170188
test,2462,179,183296,2183,2183,185479
test,2463,178,182272,2318,2318,184590
test,2464,185,189440,2853,2853,192293
test,2465,148,151552,1832,1832,153384
test,2466,141,144384,1893,1893,146277
test,2467,152,155648,2038,2038,157686
test,2468,50,51200,542,542,51742
test,2469,310,317440,5240,5240,322680
test,2470,176,180224,2392,2392,182616
test,2471,138,141312,1916,1916,143228
test,2472,79,80896,1115,1115,82011
test,2473,89,91136,1051,1051,92187
test,2474,133,136192,1687,1687,137879
test,2475,158,161792,2328,2328,164120
test,2476,148,151552,1820,1820,153372
test,2477,97,99328,1293,1293,100621
test,2478,136,139264,1820,1820,141084
test,2479,86,88064,1054,1054,89118
test,2480,137,140288,1857,1857,142145
test,2481,81,82944,861,861,83805
test,2482,112,114688,1570,1570,116258
test,2483,117,119808,1545,1545,121353
test,2484,157,160768,2105,2105,162873
test,2485,158,161792,2478,2478,164270
test,2486,166,169984,2380,2380,172364
test,2487,189,193536,2759,2759,196295
test,2488,164,167936,2230,2230,170166
test,2489,98,100352,1332,1332,101684
test,2490,126,129024,1840,1840,130864
test,2491,183,187392,2355,2355,189747
test,2492,60,61440,640,640,62080
test,2493,129,132096,1635,1635,133731
test,2494,167,171008,2395,2395,173403
test,2495,194,198656,2806,2806,201462
test,2496,200,204800,2920,2920,207720
test,2497,172,176128,2486,2486,178614
test,2498,105,107520,1271,1271,108791
test,2499,160,163840,2384,2384,166224
test,2500,112,114688,1394,1394,116082
test,2501,61,62464,713,713,63177
test,2502,138,141312,1884,1884,143196
test,2503,170,174080,2360,2360,176440
test,2504,92,94208,1118,1118,95326
test,2505,124,126976,1692,1692,128668
test,2506,84,86016,1020,1020,87036
test,2507,149,152576,1877,1877,154453
test,2508,179,183296,2703,2703,185999
test,2509,42,43008,422,422,43430
test,2510,139,142336,1791,1791,144127
test,2511,194,198656,2852,2852,201508
test,2512,166,169984,2242,2242,172226
test,2513,187,191488,2459,2459,193947
test,2514,91,93184,1173,1173,94357
test,2515,218,223232,2888,2888,226120
test,2516,58,59392,664,664,60056
test,2517,193,197632,2751,2751,200383
test,2518,138,141312,1662,1662,142974
test,2519,75,76800,863,863,77663
test,2520,98,100352,1260,1260,101612
test,2521,203,207872,3093,3093,210965
test,2522,98,100352,1056,1056,101408
test,2523,129,132096,1625,1625,133721
test,2524,205,209920,2987,2987,212907
test,2525,149,152576,1705,1705,154281
test,2526,146,149504,1866,1866,151370
test,2527,89,91136,1023,1023,92159
test,2528,241,246784,3665,3665,250449
test,2529,72,73728,890,890,74618
test,2530,139,142336,1787,1787,144123
test,2531,51,52224,515,515,52739
test,2532,124,126976,1708,1708,128684
test,2533,123,125952,1617,1617,127569
test,2534,144,147456,1960,1960,149416
test,2535,140,143360,1972,1972,145332
test,2536,87,89088,933,933,90021
test,2537,128,131072,1806,1806,132878
test,2538,185,189440,2299,2299,191739
test,2539,106,108544,1588,1588,110132
test,2540,107,109568,1317,1317,110885
test,2541,169,173056,2239,2239,175295
test,2542,197,201728,3275,3275,205003
test,2543,161,164864,2073,2073,166937
test,2544,173,177152,2487,2487,179639
test,2545,221,226304,3147,3147,229451
test,2546,161,164864,2193,2193,167057
test,2547,81,82944,973,973,83917
test,2548,119,121856,1745,1745,123601
test,2549,159,162816,2151,2151,164967
test,2550,189,193536,2589,2589,196125
test,2551,75,76800,811,811,77611
test,2552,142,145408,2120,2120,147528
test,2553,112,114688,1260,1260,115948
test,2554,95,97280,1139,1139,98419
test,2555,204,208896,2984,2984,211880
test,2556,148,151552,1934,1934,153486
test,2557,174,178176,2558,2558,180734
test,2558,113,115712,1453,1453,117165
test,2559,101,103424,1315,1315,104739
test,2560,158,161792,2456,2456,164248
test,2561,122,124928,1594,1594,126522
test,2562,148,151552,1854,1854,153406
test,2563,108,110592,1176,1176,111768
test,2564,85,87040,1119,1119,88159
test,2565,101,103424,1297,1297,104721
test,2566,119,121856,1587,1587,123443
test,2567,163,166912,2387,2387,169299
test,2568,133,136192,1699,1699,137891
test,2569,136,139264,1916,1916,141180
test,2570,137,140288,1845,1845,142133
test,2571,97,99328,1189,1189,100517
test,2572,48,49152,536,536,49688
test,2573,178,182272,2804,2804,185076
test,2574,195,199680,2817,2817,202497
test,2575,78,79872,1032,1032,80904
test,2576,169,173056,2207,2207,175263
test,2577,49,50176,543,543,50719
test,2578,120,122880,1530,1530,124410
test,2579,109,111616,1469,1469,113085
test,2580,178,182272,2430,2430,184702
test,2581,122,124928,1436,1436,126364
test,2582,128,131072,1858,1858,132930
test,2583,88,90112,890,890,91002
test,2584,128,131072,1654,1654,132726
test,2585,253,259072,3773,3773,262845
test,2586,122,124928,1736,1736,126664
test,2587,115,117760,1289,1289,119049
test,2588,99,101376,1377,1377,102753
test,2589,234,239616,3176,3176,242792
test,2590,146,149504,1824,1824,151328
test,2591,94,96256,1146,1146,97402
test,2592,180,184320,2462,2462,186782
test,2593,201,205824,2663,2663,208487
test,2594,165,168960,2365,2365,171325
test,2595,111,113664,1313,1313,114977
test,2596,154,157696,2022,2022,159718
test,2597,59,60416,653,653,61069
test,2598,141,144384,1873,1873,146257
test,2599,139,142336,1703,1703,144039
test,2600,165,168960,2417,2417,171377
test,2601,168,172032,2284,2284,174316
test,2602,79,80896,985,985,81881
test,2603,58,59392,608,608,60000
test,2604,197,201728,2855,2855,204583
test,2605,41,41984,431,431,42415
test,2606,136,139264,1888,1888,141152
test,2607,94,96256,1142,1142,97398
test,2608,265,271360,3975,3975,275335
test,2609,173,177152,2529,2529,179681
test,2610,76,77824,954,954,78778
test,2611,149,152576,2021,2021,154597
test,2612,143,146432,1759,1759,148191
test,2613,95,97280,1189,1189,98469
test,2614,197,201728,2681,2681,204409
test,2615,127,130048,1665,1665,131713
test,2616,117,119808,1463,1463,121271
test,2617,226,231424,3344,3344,234768
test,2618,154,157696,2096,2096,159792
test,2619,188,192512,2514,2514,195026
test,2620,46,47104,492,492,47596
test,2621,56,57344,646,646,57990
test,2622,201,205824,2915,2915,208739
test,2623,154,157696,2364,2364,160060
test,2624,186,190464,2728,2728,193192
test,2625,142,145408,1870,1870,147278
test,2626,179,183296,2661,2661,185957
test,2627,114,116736,1340,1340,118076
test,2628,81,82944,979,979,83923
test,2629,161,164864,2083,2083,166947
test,2630,62,63488,746,746,64234
test,2631,106,108544,1280,1280,109824
test,2632,156,159744,2066,2066,161810
test,2633,161,164864,2423,2423,167287
test,2634,183,187392,2827,2827,190219
test,2635,116,118784,1426,1426,120210
test,2636,178,182272,2418,2418,184690
test,2637,80,81920,874,874,82794
test,2638,56,57344,722,722,58066
test,2639,196,200704,2936,2936,203640
test,2640,186,190464,2616,2616,193080
test,2641,205,209920,3019,3019,212939
test,2642,87,89088,1079,1079,90167
test,2643,200,204800,3002,3002,207802
test,2644,155,158720,2167,2167,160887
test,2645,145,148480,1893,1893,150373
test,2646,141,144384,1733,1733,146117
test,2647,117,119808,1557,1557,121365
test,2648,191,195584,2839,2839,198423
test,2649,71,72704,801,801,73505
test,2650,162,165888,2378,2378,168266
test,2651,157,160768,2021,2021,162789
test,2652,77,78848,987,987,79835
test,2653,177,181248,2535,2535,183783
test,2654,104,106496,1278,1278,107774
test,2655,249,254976,3531,3531,258507
test,2656,166,169984,2414,2414,172398
test,2657,136,139264,1742,1742,141006
test,2658,165,168960,2187,2187,171147
test,2659,92,94208,1084,1084,95292
test,2660,234,239616,3174,3174,242790
test,2661,193,197632,2735,2735,200367
test,2662,144,147456,2040,2040,149496
test,2663,77,78848,835,835,79683
test,2664,144,147456,1906,1906,149362
test,2665,153,156672,2251,2251,158923
test,2666,92,94208,1078,1078,95286
test,2667,140,143360,1842,1842,145202
test,2668,100,102400,1140,1140,103540
test,2669,181,185344,2451,2451,187795
test,2670,152,155648,2064,2064,157712
test,2671,145,148480,2081,2081,150561
test,2672,121,123904,1415,1415,125319
test,2673,322,329728,4792,4792,334520
test,2674,100,102400,1252,1252,103652
test,2675,62,63488,696,696,64184
test,2676,106,108544,1290,1290,109834
test,2677,118,120832,1480,1480,122312
test,2678,209,214016,2943,2943,216959
test,2679,180,184320,2320,2320,186640
test,2680,156,159744,2142,2142,161886
test,2681,103,105472,1239,1239,106711
test,2682,171,175104,2477,2477,177581
test,2683,184,188416,2488,2488,190904
test,2684,115,117760,1463,1463,119223
test,2685,180,184320,2638,2638,186958
test,2686,102,104448,1116,1116,105564
test,2687,130,133120,1762,1762,134882
test,2688,119,121856,1443,1443,123299
test,2689,171,175104,2325,2325,177429
test,2690,48,49152,576,576,49728
test,2691,168,172032,2496,2496,174528
test,2692,200,204800,2664,2664,207464
test,2693,107,109568,1479,1479,111047
test,2694,170,174080,2302,2302,176382
test,2695,164,167936,2262,2262,170198
test,2696,181,185344,2587,2587,187931
test,2697,154,157696,2134,2134,159830
test,2698,151,154624,1989,1989,156613
test,2699,191,195584,2601,2601,198185
test,2700,162,165888,1974,1974,167862
test,2701,188,192512,2388,2388,194900
test,2702,221,226304,3191,3191,229495
test,2703,155,158720,2203,2203,160923
test,2704,189,193536,2683,2683,196219
test,2705,120,122880,1594,1594,124474
test,2706,63,64512,679,679,65191
test,2707,147,150528,1911,1911,152439
test,2708,166,169984,2240,2240,172224
test,2709,118,120832,1664,1664,122496
test,2710,125,128000,1671,1671,129671
test,2711,119,121856,1647,1647,123503
test,2712,46,47104,470,470,47574
test,2713,157,160768,2253,2253,163021
test,2714,114,116736,1430,1430,118166
test,2715,167,171008,2191,2191,173199
test,2716,135,138240,1835,1835,140075
test,2717,150,153600,2236,2236,155836
test,2718,190,194560,2816,2816,197376
test,2719,123,125952,1557,1557,127509
test,2720,150,153600,2412,2412,156012
test,2721,342,350208,4500,4500,354708
test,2722,265,271360,4145,4145,275505
test,2723,168,172032,2300,2300,174332
test,2724,173,177152,2269,2269,179421
test,2725,83,84992,953,953,85945
test,2726,102,104448,1238,1238,105686
test,2727,159,162816,2367,2367,165183
test,2728,211,216064,3537,3537,219601
test,2729,172,176128,2286,2286,178414
test,2730,171,175104,2479,2479,177583
test,2731,120,122880,1716,1716,124596
test,2732,50,51200,568,568,51768
test,2733,42,43008,430,430,43438
test,2734,217,222208,3165,3165,225373
test,2735,140,143360,1772,1772,145132
test,2736,158,161792,2042,2042,163834
test,2737,132,135168,1886,1886,137054
test,2738,93,95232,1179,1179,96411
test,2739,137,140288,1597,1597,141885
test,2740,172,176128,2646,2646,178774
test,2741,136,139264,1724,1724,140988
test,2742,175,179200,2247,2247,181447
test,2743,147,150528,2185,2185,152713
test,2744,143,146432,2235,2235,148667
test,2745,132,135168,1658,1658,136826
test,2746,169,173056,2277,2277,175333
test,2747,158,161792,2204,2204,163996
test,2748,152,155648,1808,1808,157456
test,2749,58,59392,636,636,60028
test,2750,127,130048,1479,1479,131527
test,2751,188,192512,3062,3062,195574
test,2752,193,197632,2641,2641,200273
test,2753,100,102400,1220,1220,103620
test,2754,71,72704,821,821,73525
test,2755,109,111616,1429,1429,113045
test,2756,83,84992,903,903,85895
test,2757,58,59392,634,634,60026
test,2758,217,222208,3141,3141,225349
test,2759,166,169984,2370,2370,172354
test,2760,155,158720,2187,2187,160907
test,2761,49,50176,493,493,50669
test,2762,107,109568,1305,1305,110873
test,2763,190,194560,2832,2832,197392
test,2764,74,75776,874,874,76650
test,2765,225,230400,3231,3231,233631
test,2766,194,198656,3120,3120,201776
test,2767,152,155648,2054,2054,157702
test,2768,168,172032,2370,2370,174402
test,2769,230,235520,3166,3166,238686
test,2770,91,93184,1209,1209,94393
test,2771,129,132096,1503,1503,133599
test,2772,92,94208,1066,1066,95274
test,2773,111,113664,1399,1399,115063
test,2774,119,121856,1525,1525,123381
test,2775,116,118784,1360,1360,120144
test,2776,217,222208,3227,3227,225435
test,2777,149,152576,1843,1843,154419
test,2778,115,117760,1367,1367,119127
test,2779,249,254976,3535,3535,258511
test,2780,178,182272,2330,2330,184602
test,2781,141,144384,1833,1833,146217
test,2782,79,80896,965,965,81861
test,2783,234,239616,3608,3608,243224
test,2784,107,109568,1293,1293,110861
test,2785,72,73728,844,844,74572
test,2786,125,128000,1583,1583,129583
test,2787,120,122880,1618,1618,124498
test,2788,113,115712,1425,1425,117137
test,2789,107,109568,1247,1247,110815
test,2790,145,148480,1957,1957,150437
test,2791,92,94208,1130,1130,95338
test,2792,150,153600,2110,2110,155710
test,2793,65,66560,751,751,67311
test,2794,175,179200,2199,2199,181399
test,2795,158,161792,2320,2320,164112
test,2796,46,47104,496,496,47600
test,2797,149,152576,1967,1967,154543
test,2798,146,149504,1842,1842,151346
test,2799,208,212992,3104,3104,216096
test,2800,151,154624,2325,2325,156949
test,2801,167,171008,2175,2175,173183
test,2802,69,70656,735,735,71391
test,2803,70,71680,766,766,72446
test,2804,111,113664,1431,1431,115095
test,2805,126,129024,1714,1714,130738
test,2806,169,173056,2133,2133,175189
test,2807,89,91136,1009,1009,92145
test,2808,103,105472,1209,1209,106681
test,2809,104,106496,1420,1420,107916
test,2810,136,139264,1966,1966,141230
test,2811,63,64512,763,763,65275
test,2812,123,125952,1625,1625,127577
test,2813,109,111616,1389,1389,113005
test,2814,113,115712,1325,1325,117037
test,2815,72,73728,816,816,74544
test,2816,88,90112,1022,1022,91134
test,2817,151,154624,1981,1981,156605
test,2818,47,48128,489,489,48617
test,2819,216,221184,3010,3010,224194
test,2820,205,209920,2765,2765,212685
test,2821,157,160768,2093,2093,162861
test,2822,206,210944,2764,2764,213708
test,2823,74,75776,774,774,76550
test,2824,112,114688,1454,1454,116142
test,2825,93,95232,1131,1131,96363
test,2826,143,146432,1865,1865,148297
test,2827,178,182272,2654,2654,184926
test,2828,156,159744,2340,2340,162084
test,2829,127,130048,1805,1805,131853
test,2830,167,171008,2325,2325,173333
test,2831,120,122880,1798,1798,124678
test,2832,85,87040,1141,1141,88181
test,2833,87,89088,1143,1143,90231
test,2834,143,146432,1877,1877,148309
test,2835,147,150528,1881,1881,152409
test,2836,117,119808,1545,1545,121353
test,2837,200,204800,2784,2784,207584
test,2838,63,64512,673,673,65185
test,2839,111,113664,1499,1499,115163
test,2840,162,165888,2332,2332,168220
test,2841,183,187392,2709,2709,190101
test,2842,111,113664,1571,1571,115235
test,2843,104,106496,1262,1262,107758
test,2844,236,241664,3416,3416,245080
test,2845,153,156672,2165,2165,158837
test,2846,155,158720,2243,2243,160963
test,2847,228,233472,3228,3228,236700
test,2848,129,132096,1795,1795,133891
test,2849,50,51200,546,546,51746
test,2850,125,128000,1755,1755,129755
test,2851,141,144384,1781,1781,146165
test,2852,183,187392,2443,2443,189835
test,2853,92,94208,1126,1126,95334
test,2854,165,168960,2207,2207,171167
test,2855,146,149504,2128,2128,151632
test,2856,89,91136,1041,1041,92177
test,2857,133,136192,1845,1845,138037
test,2858,162,165888,2140,2140,168028
test,2859,113,115712,1327,1327,117039
test,2860,158,161792,2396,2396,164188
test,2861,165,168960,2281,2281,171241
test,2862,217,222208,2827,2827,225035
test,2863,183,187392,2561,2561,189953
test,2864,154,157696,1994,1994,159690
test,2865,53,54272,589,589,54861
test,2866,201,205824,2721,2721,208545
test,2867,138,141312,1832,1832,143144
test,2868,63,64512,741,741,65253
test,2869,134,137216,1864,1864,139080
test,2870,157,160768,2161,2161,162929
test,2871,81,82944,971,971,83915
test,2872,136,139264,1976,1976,141240
test,2873,158,161792,2148,2148,163940
test,2874,67,68608,787,787,69395
test,2875,130,133120,1742,1742,134862
test,2876,156,159744,2084,2084,161828
test,2877,139,142336,1685,1685,144021
test,2878,200,204800,2710,2710,207510
test,2879,128,131072,1838,1838,132910
test,2880,131,134144,1657,1657,135801
test,2881,153,156672,1899,1899,158571
test,2882,220,225280,3094,3094,228374
test,2883,107,109568,1427,1427,110995
test,2884,190,194560,2784,2784,197344
test,2885,161,164864,2177,2177,167041
test,2886,129,132096,1783,1783,133879
test,2887,153,156672,2199,2199,158871
test,2888,167,171008,2381,2381,173389
test,2889,250,256000,3556,3556,259556
test,2890,134,137216,1640,1640,138856
test,2891,61,62464,725,725,63189
test,2892,109,111616,1269,1269,112885
test,2893,165,168960,2109,2109,171069
test,2894,112,114688,1284,1284,115972
test,2895,167,171008,2257,2257,173265
test,2896,158,161792,2030,2030,163822
test,2897,111,113664,1403,1403,115067
test,2898,120,122880,1540,1540,124420
test,2899,187,191488,2455,2455,193943
test,2900,186,190464,2340,2340,192804
test,2901,66,67584,750,750,68334
test,2902,160,163840,2120,2120,165960
test,2903,126,129024,1816,1816,130840
test,2904,161,164864,2309,2309,167173
test,2905,161,164864,2301,2301,167165
test,2906,177,181248,2327,2327,183575
test,2907,144,147456,1998,1998,149454
test,2908,50,51200,538,538,51738
test,2909,104,106496,1216,1216,107712
test,2910,173,177152,2237,2237,179389
test,2911,127,130048,1709,1709,131757
test,2912,52,53248,594,594,53842
test,2913,232,237568,3370,3370,240938
test,2914,206,210944,2866,2866,213810
test,2915,180,184320,2506,2506,186826
test,2916,184,188416,2514,2514,190930
test,2917,185,189440,2535,2535,191975
test,2918,88,90112,962,962,91074
test,2919,196,200704,2630,2630,203334
test,2920,73,74752,965,965,75717
test,2921,146,149504,1890,1890,151394
test,2922,121,123904,1593,1593,125497
test,2923,209,214016,3067,3067,217083
test,2924,166,169984,2202,2202,172186
test,2925,84,86016,962,962,86978
test,2926,186,190464,2786,2786,193250
test,2927,151,154624,2101,2101,156725
test,2928,137,140288,1803,1803,142091
test,2929,142,145408,1890,1890,147298
test,2930,147,150528,1923,1923,152451
test,2931,173,177152,2497,2497,179649
test,2932,146,149504,2116,2116,151620
test,2933,135,138240,1801,1801,140041
test,2934,135,138240,1869,1869,140109
test,2935,190,194560,2604,2604,197164
test,2936,179,183296,2661,2661,185957
test,2937,171,175104,2171,2171,177275
test,2938,168,172032,2120,2120,174152
test,2939,120,122880,1532,1532,124412
test,2940,92,94208,1100,1100,95308
test,2941,115,117760,1459,1459,119219
test,2942,160,163840,2164,2164,166004
test,2943,93,95232,1059,1059,96291
test,2944,155,158720,2259,2259,160979
test,2945,183,187392,2635,2635,190027
test,2946,133,136192,1547,1547,137739
test,2947,69,70656,761,761,71417
test,2948,224,229376,3254,3254,232630
test,2949,59,60416,665,665,61081
test,2950,120,122880,1528,1528,124408
test,2951,167,171008,2943,2943,173951
test,2952,230,235520,3314,3314,238834
test,2953,187,191488,2561,2561,194049
test,2954,84,86016,920,920,86936
test,2955,175,179200,2421,2421,181621
test,2956,158,161792,2080,2080,163872
test,2957,130,133120,1684,1684,134804
test,2958,152,155648,2030,2030,157678
test,2959,96,98304,1176,1176,99480
test,2960,159,162816,2233,2233,165049
test,2961,114,116736,1530,1530,118266
test,2962,167,171008,2287,2287,173295
test,2963,108,110592,1412,1412,112004
test,2964,97,99328,1211,1211,100539
test,2965,185,189440,2729,2729,192169
test,2966,110,112640,1442,1442,114082
test,2967,196,200704,3072,3072,203776
test,2968,175,179200,2551,2551,181751
test,2969,159,162816,2159,2159,164975
test,2970,90,92160,1056,1056,93216
test,2971,174,178176,2406,2406,180582
test,2972,136,139264,1908,1908,141172
test,2973,190,194560,2576,2576,197136
test,2974,82,83968,978,978,84946
test,2975,64,65536,680,680,66216
test,2976,147,150528,2199,2199,152727
test,2977,111,113664,1367,1367,115031
test,2978,74,75776,898,898,76674
test,2979,58,59392,654,654,60046
test,2980,157,160768,2303,2303,163071
test,2981,183,187392,2505,2505,189897
test,2982,81,82944,945,945,83889
test,2983,168,172032,2236,2236,174268
test,2984,85,87040,1119,1119,88159
test,2985,112,114688,1560,1560,116248
test,2986,119,121856,1603,1603,123459
test,2987,190,194560,2812,2812,197372
test,2988,282,288768,4310,4310,293078
test,2989,135,138240,1665,1665,139905
test,2990,171,175104,2327,2327,177431
test,2991,62,63488,650,650,64138
test,2992,139,142336,1765,1765,144101
test,2993,104,106496,1290,1290,107786
test,2994,144,147456,1990,1990,149446
test,2995,273,279552,4195,4195,283747
test,2996,151,154624,1979,1979,156603
test,2997,184,188416,2588,2588,191004
test,2998,100,102400,1130,1130,103530
test,2999,151,154624,2205,2205,156829
test,3000,146,149504,1906,1906,151410
test,3001,131,134144,1825,1825,135969
test,3002,175,179200,2109,2109,181309
test,3003,177,181248,2273,2273,183521
test,3004,176,180224,2442,2442,182666
test,3005,94,96256,1068,1068,97324
test,3006,91,93184,1191,1191,94375
test,3007,56,57344,590,590,57934
test,3008,179,183296,2277,2277,185573
test,3009,75,76800,837,837,77637
test,3010,55,56320,635,635,56955
test,3011,132,135168,1814,1814,136982
test,3012,149,152576,1991,1991,154567
test,3013,147,150528,2125,2125,152653
test,3014,105,107520,1297,1297,108817
test,3015,155,158720,2129,2129,160849
test,3016,137,140288,1867,1867,142155
test,3017,146,149504,2034,2034,151538
test,3018,115,117760,1559,1559,119319
test,3019,152,155648,2164,2164,157812
test,3020,220,225280,3076,3076,228356
test,3021,162,165888,2132,2132,168020
test,3022,199,203776,3141,3141,206917
test,3023,150,153600,1942,1942,155542
test,3024,140,143360,1936,1936,145296
test,3025,119,121856,1635,1635,123491
test,3026,157,160768,2157,2157,162925
test,3027,130,133120,1716,1716,134836
test,3028,115,117760,1709,1709,119469
test,3029,191,195584,2901,2901,198485
test,3030,162,165888,2440,2440,168328
test,3031,103,105472,1317,1317,106789
test,3032,97,99328,1193,1193,100521
test,3033,102,104448,1326,1326,105774
test,3034,86,88064,994,994,89058
test,3035,201,205824,2849,2849,208673
test,3036,172,176128,2470,2470,178598
test,3037,184,188416,2246,2246,190662
test,3038,118,120832,1512,1512,122344
test,3039,126,129024,1492,1492,130516
test,3040,137,140288,1707,1707,141995
test,3041,119,121856,1547,1547,123403
test,3042,126,129024,1632,1632,130656
test,3043,112,114688,1514,1514,116202
test,3044,175,179200,2655,2655,181855
test,3045,182,186368,2778,2778,189146
test,3046,167,171008,2275,2275,173283
test,3047,138,141312,1952,1952,143264
test,3048,188,192512,2604,2604,195116
test,3049,213,218112,2901,2901,221013
test,3050,137,140288,1595,1595,141883
test,3051,163,166912,2201,2201,169113
test,3052,129,132096,1725,1725,133821
test,3053,50,51200,528,528,51728
test,3054,122,124928,1534,1534,126462
test,3055,240,245760,3530,3530,249290
test,3056,118,120832,1374,1374,122206
test,3057,188,192512,2774,2774,195286
test,3058,120,122880,1428,1428,124308
test,3059,50,51200,514,514,51714
test,3060,221,226304,3447,3447,229751
test,3061,124,126976,1578,1578,128554
test,3062,91,93184,1283,1283,94467
test,3063,166,169984,2278,2278,172262
test,3064,120,122880,1428,1428,124308
test,3065,113,115712,1699,1699,117411
test,3066,229,234496,3373,3373,237869
test,3067,102,104448,1352,1352,105800
test,3068,189,193536,2551,2551,196087
test,3069,53,54272,559,559,54831
test,3070,197,201728,2755,2755,204483
test,3071,91,93184,1103,1103,94287
test,3072,140,143360,1860,1860,145220
test,3073,129,132096,1997,1997,134093
test,3074,181,185344,2589,2589,187933
test,3075,180,184320,2544,2544,186864
test,3076,126,129024,1586,1586,130610
test,3077,101,103424,1189,1189,104613
test,3078,203,207872,2793,2793,210665
test,3079,168,172032,2312,2312,174344
test,3080,198,202752,2902,2902,205654
test,3081,154,157696,2422,2422,160118
test,3082,125,128000,1753,1753,129753
test,3083,203,207872,3251,3251,211123
test,3084,149,152576,1963,1963,154539
test,3085,187,191488,2527,2527,194015
test,3086,138,141312,1876,1876,143188
test,3087,191,195584,2577,2577,198161
test,3088,268,274432,3554,3554,277986
test,3089,152,155648,1980,1980,157628
test,3090,136,139264,1818,1818,141082
test,3091,218,223232,2934,2934,226166
test,3092,151,154624,1821,1821,156445
test,3093,131,134144,1751,1751,135895
test,3094,167,171008,2455,2455,173463
test,3095,156,159744,2178,2178,161922
test,3096,128,131072,1728,1728,132800
test,3097,185,189440,2501,2501,191941
test,3098,93,95232,1183,1183,96415
test,3099,191,195584,2837,2837,198421
test,3100,175,179200,2261,2261,181461
test,3101,152,155648,2048,2048,157696
test,3102,188,192512,2592,2592,195104
test,3103,128,131072,1674,1674,132746
test,3104,112,114688,1364,1364,116052
test,3105,154,157696,2068,2068,159764
test,3106,141,144384,2161,2161,146545
test,3107,175,179200,2179,2179,181379
test,3108,113,115712,1447,1447,117159
test,3109,77,78848,899,899,79747
test,3110,158,161792,2030,2030,163822
test,3111,106,108544,1438,1438,109982
test,3112,146,149504,2220,2220,151724
test,3113,85,87040,969,969,88009
test,3114,121,123904,1439,1439,125343
test,3115,116,118784,1500,1500,120284
test,3116,171,175104,2155,2155,177259
test,3117,149,152576,1791,1791,154367
test,3118,125,128000,1613,1613,129613
test,3119,48,49152,456,456,49608
test,3120,35,35840,345,345,36185
test,3121,92,94208,1010,1010,95218
test,3122,154,157696,2074,2074,159770
test,3123,104,106496,1362,1362,107858
test,3124,179,183296,2327,2327,185623
test,3125,48,49152,566,566,49718
test,3126,130,133120,1718,1718,134838
test,3127,183,187392,2347,2347,189739
test,3128,85,87040,1073,1073,88113
test,3129,154,157696,2188,2188,159884
test,3130,144,147456,1974,1974,149430
test,3131,169,173056,2247,2247,175303
test,3132,83,84992,1083,1083,86075
test,3133,229,234496,2853,2853,237349
test,3134,154,157696,2060,2060,159756
test,3135,92,94208,1300,1300,95508
test,3136,144,147456,1992,1992,149448
test,3137,176,180224,2394,2394,182618
test,3138,180,184320,2650,2650,186970
test,3139,149,152576,1825,1825,154401
test,3140,145,148480,2031,2031,150511
test,3141,53,54272,601,601,54873
test,3142,161,164864,2243,2243,167107
test,3143,81,82944,961,961,83905
test,3144,185,189440,2443,2443,191883
test,3145,169,173056,2341,2341,175397
test,3146,110,112640,1234,1234,113874
test,3147,165,168960,2387,2387,171347
test,3148,53,54272,601,601,54873
test,3149,199,203776,3077,3077,206853
test,3150,201,205824,3239,3239,209063
test,3151,147,150528,2079,2079,152607
test,3152,123,125952,1521,1521,127473
test,3153,168,172032,2306,2306,174338
test,3154,191,195584,2437,2437,198021
test,3155,86,88064,1158,1158,89222
test,3156,175,179200,2417,2417,181617
test,3157,175,179200,2551,2551,181751
test,3158,107,109568,1315,1315,110883
test,3159,59,60416,621,621,61037
test,3160,235,240640,3681,3681,244321
test,3161,149,152576,2047,2047,154623
test,3162,89,91136,999,999,92135
test,3163,148,151552,2198,2198,153750
test,3164,235,240640,3447,3447,244087
test,3165,164,167936,2204,2204,170140
test,3166,165,168960,2395,2395,171355
test,3167,145,148480,2063,2063,150543
test,3168,139,142336,1939,1939,144275
test,3169,83,84992,913,913,85905
test,3170,88,90112,1150,1150,91262
test,3171,152,155648,1950,1950,157598
test,3172,108,110592,1208,1208,111800
test,3173,77,78848,915,915,79763
test,3174,66,67584,750,750,68334
test,3175,207,211968,2695,2695,214663
test,3176,144,147456,2172,2172,149628
test,3177,182,186368,2596,2596,188964
test,3178,143,146432,1955,1955,148387
test,3179,211,216064,2917,2917,218981
test,3180,133,136192,1551,1551,137743
test,3181,148,151552,2098,2098,153650
test,3182,157,160768,2395,2395,163163
test,3183,151,154624,2035,2035,156659
test,3184,104,106496,1382,1382,107878
test,3185,51,52224,589,589,52813
test,3186,173,177152,2521,2521,179673
test,3187,135,138240,1953,1953,140193
test,3188,158,161792,2344,2344,164136
test,3189,91,93184,1033,1033,94217
test,3190,75,76800,843,843,77643
test,3191,190,194560,2862,2862,197422
test,3192,87,89088,1015,1015,90103
test,3193,220,225280,3268,3268,228548
test,3194,98,100352,1384,1384,101736
test,3195,52,53248,510,510,53758
test,3196,133,136192,1841,1841,138033
test,3197,86,88064,1124,1124,89188
test,3198,147,150528,2183,2183,152711
test,3199,178,182272,2494,2494,184766
test,3200,174,178176,2456,2456,180632
test,3201,95,97280,1149,1149,98429
test,3202,144,147456,1958,1958,149414
test,3203,160,163840,2226,2226,166066
test,3204,107,109568,1469,1469,111037
test,3205,84,86016,1056,1056,87072
test,3206,86,88064,1100,1100,89164
test,3207,133,136192,1741,1741,137933
test,3208,134,137216,1840,1840,139056
test,3209,171,175104,2233,2233,177337
test,3210,121,123904,1775,1775,125679
test,3211,105,107520,1317,1317,108837
test,3212,158,161792,2446,2446,164238
test,3213,140,143360,1798,1798,145158
test,3214,156,159744,2138,2138,161882
test,3215,72,73728,744,744,74472
test,3216,94,96256,1296,1296,97552
test,3217,195,199680,2797,2797,202477
test,3218,176,180224,2346,2346,182570
test,3219,146,149504,2228,2228,151732
test,3220,182,186368,2522,2522,188890
test,3221,141,144384,1941,1941,146325
test,3222,191,195584,2673,2673,198257
test,3223,127,130048,1659,1659,131707
test,3224,172,176128,2494,2494,178622
test,3225,77,78848,949,949,79797
test,3226,124,126976,1554,1554,128530
test,3227,225,230400,2833,2833,233233
test,3228,67,68608,767,767,69375
test,3229,219,224256,3211,3211,227467
test,3230,113,115712,1517,1517,117229
test,3231,156,159744,1996,1996,161740
test,3232,149,152576,1999,1999,154575
test,3233,153,156672,2143,2143,158815
test,3234,174,178176,2208,2208,180384
test,3235,134,137216,1708,1708,138924
test,3236,67,68608,795,795,69403
test,3237,153,156672,2049,2049,158721
test,3238,86,88064,1010,1010,89074
test,3239,247,252928,3299,3299,256227
test,3240,44,45056,462,462,45518
test,3241,169,173056,2267,2267,175323
test,3242,63,64512,711,711,65223
test,3243,123,125952,1659,1659,127611
test,3244,123,125952,1623,1623,127575
test,3245,92,94208,1198,1198,95406
test,3246,166,169984,2452,2452,172436
test,3247,140,143360,1802,1802,145162
test,3248,209,214016,3033,3033,217049
test,3249,117,119808,1405,1405,121213
test,3250,142,145408,1946,1946,147354
test,3251,172,176128,2250,2250,178378
test,3252,98,100352,1270,1270,101622
test,3253,128,131072,1626,1626,132698
test,3254,160,163840,1948,1948,165788
test,3255,158,161792,2100,2100,163892
test,3256,80,81920,868,868,82788
test,3257,159,162816,2035,2035,164851
test,3258,54,55296,608,608,55904
test,3259,130,133120,1574,1574,134694
test,3260,159,162816,2147,2147,164963
test,3261,150,153600,2304,2304,155904
test,3262,65,66560,839,839,67399
test,3263,196,200704,2812,2812,203516
test,3264,118,120832,1642,1642,122474
test,3265,236,241664,3676,3676,245340
test,3266,138,141312,1872,1872,143184
test,3267,74,75776,750,750,76526
test,3268,138,141312,1776,1776,143088
test,3269,129,132096,1613,1613,133709
test,3270,191,195584,2709,2709,198293
test,3271,121,123904,1473,1473,125377
test,3272,100,102400,1290,1290,103690
test,3273,122,124928,1740,1740,126668
test,3274,211,216064,2857,2857,218921
test,3275,197,201728,2889,2889,204617
test,3276,143,146432,1883,1883,148315
test,3277,138,141312,1830,1830,143142
test,3278,101,103424,1245,1245,104669
test,3279,91,93184,1095,1095,94279
test,3280,186,190464,2558,2558,193022
test,3281,197,201728,2485,2485,204213
test,3282,116,118784,1428,1428,120212
test,3283,116,118784,1488,1488,120272
test,3284,226,231424,3076,3076,234500
test,3285,168,172032,2434,2434,174466
test,3286,151,154624,1911,1911,156535
test,3287,207,211968,3005,3005,214973
test,3288,173,177152,2769,2769,179921
test,3289,86,88064,984,984,89048
test,3290,173,177152,2079,2079,179231
test,3291,196,200704,2694,2694,203398
test,3292,123,125952,1655,1655,127607
test,3293,113,115712,1433,1433,117145
test,3294,167,171008,2229,2229,173237
test,3295,177,181248,2345,2345,183593
test,3296,65,66560,751,751,67311
test,3297,109,111616,1369,1369,112985
test,3298,191,195584,2643,2643,198227
test,3299,143,146432,1891,1891,148323
test,3300,188,192512,2716,2716,195228
test,3301,57,58368,651,651,59019
test,3302,161,164864,2519,2519,167383
test,3303,187,191488,2645,2645,194133
test,3304,158,161792,2174,2174,163966
test,3305,77,78848,903,903,79751
test,3306,88,90112,964,964,91076
test,3307,140,143360,1894,1894,145254
test,3308,154,157696,2112,2112,159808
test,3309,189,193536,2351,2351,195887
test,3310,201,205824,2653,2653,208477
test,3311,127,130048,1535,1535,131583
test,3312,186,190464,2704,2704,193168
test,3313,153,156672,1949,1949,158621
test,3314,143,146432,2285,2285,148717
test,3315,93,95232,1191,1191,96423
test,3316,116,118784,1450,1450,120234
test,3317,176,180224,2606,2606,182830
test,3318,105,107520,1445,1445,108965
test,3319,91,93184,1141,1141,94325
test,3320,115,117760,1401,1401,119161
test,3321,147,150528,2087,2087,152615
test,3322,88,90112,996,996,91108
test,3323,97,99328,1309,1309,100637
test,3324,105,107520,1263,1263,108783
test,3325,139,142336,2045,2045,144381
test,3326,165,168960,2431,2431,171391
test,3327,138,141312,1848,1848,143160
test,3328,53,54272,555,555,54827
test,3329,79,80896,941,941,81837
test,3330,151,154624,1959,1959,156583
test,3331,180,184320,2556,2556,186876
test,3332,108,110592,1496,1496,112088
test,3333,129,132096,1741,1741,133837
test,3334,143,146432,1927,1927,148359
test,3335,112,114688,1360,1360,116048
test,3336,63,64512,691,691,65203
test,3337,142,145408,1960,1960,147368
test,3338,220,225280,2976,2976,228256
test,3339,136,139264,1836,1836,141100
test,3340,96,98304,1172,1172,99476
test,3341,86,88064,1214,1214,89278
test,3342,165,168960,2149,2149,171109
test,3343,144,147456,2056,2056,149512
test,3344,198,202752,3002,3002,205754
test,3345,79,80896,899,899,81795
test,3346,70,71680,800,800,72480
test,3347,81,82944,981,981,83925
test,3348,153,156672,2203,2203,158875
test,3349,74,75776,860,860,76636
test,3350,112,114688,1504,1504,116192
test,3351,143,146432,1797,1797,148229
test,3352,152,155648,1884,1884,157532
test,3353,233,238592,3211,3211,241803
test,3354,109,111616,1447,1447,113063
test,3355,131,134144,1615,1615,135759
test,3356,99,101376,1221,1221,102597
test,3357,96,98304,1228,1228,99532
test,3358,70,71680,776,776,72456
test,3359,130,133120,1808,1808,134928
test,3360,113,115712,1479,1479,117191
test,3361,54,55296,608,608,55904
test,3362,62,63488,694,694,64182
test,3363,171,175104,2419,2419,177523
test,3364,174,178176,2540,2540,180716
test,3365,111,113664,1327,1327,114991
test,3366,127,130048,1515,1515,131563
test,3367,104,106496,1240,1240,107736
test,3368,59,60416,693,693,61109
test,3369,143,146432,1879,1879,148311
test,3370,165,168960,2373,2373,171333
test,3371,112,114688,1488,1488,116176
test,3372,160,163840,2002,2002,165842
test,3373,130,133120,1684,1684,134804
test,3374,78,79872,866,866,80738
test,3375,137,140288,1783,1783,142071
test,3376,213,218112,3173,3173,221285
test,3377,194,198656,2928,2928,201584
test,3378,168,172032,2340,2340,174372
test,3379,133,136192,1799,1799,137991
test,3380,111,113664,1375,1375,115039
test,3381,152,155648,2092,2092,157740
test,3382,129,132096,1781,1781,133877
test,3383,212,217088,3054,3054,220142
test,3384,135,138240,1813,1813,140053
test,3385,103,105472,1157,1157,106629
test,3386,163,166912,2287,2287,169199
test,3387,100,102400,1226,1226,103626
test,3388,128,131072,1920,1920,132992
test,3389,166,169984,2280,2280,172264
test,3390,191,195584,2641,2641,198225
test,3391,83,84992,1005,1005,85997
test,3392,102,104448,1164,1164,105612
test,3393,162,165888,2174,2174,168062
test,3394,177,181248,2563,2563,183811
test,3395,118,120832,1550,1550,122382
test,3396,97,99328,1169,1169,100497
test,3397,121,123904,1481,1481,125385
test,3398,147,150528,1925,1925,152453
test,3399,95,97280,1157,1157,98437
test,3400,64,65536,670,670,66206
test,3401,215,220160,2805,2805,222965
test,3402,125,128000,1637,1637,129637
test,3403,105,107520,1547,1547,109067
test,3404,43,44032,511,511,44543
test,3405,171,175104,2477,2477,177581
test,3406,208,212992,3514,3514,216506
test,3407,129,132096,1823,1823,133919
test,3408,122,124928,1506,1506,126434
test,3409,177,181248,2715,2715,183963
test,3410,127,130048,1761,1761,131809
test,3411,129,132096,1863,1863,133959
test,3412,156,159744,2296,2296,162040
test,3413,239,244736,3217,3217,247953
test,3414,149,152576,1955,1955,154531
test,3415,100,102400,1206,1206,103606
test,3416,90,92160,1120,1120,93280
test,3417,125,128000,1733,1733,129733
test,3418,207,211968,2823,2823,214791
test,3419,157,160768,2135,2135,162903
test,3420,165,168960,2487,2487,171447
test,3421,203,207872,2985,2985,210857
test,3422,85,87040,971,971,88011
test,3423,283,289792,4215,4215,294007
test,3424,106,108544,1400,1400,109944
test,3425,132,135168,1746,1746,136914
test,3426,187,191488,2551,2551,194039
test,3427,88,90112,1040,1040,91152
test,3428,188,192512,2518,2518,195030
test,3429,136,139264,1826,1826,141090
test,3430,172,176128,2562,2562,178690
test,3431,75,76800,963,963,77763
test,3432,108,110592,1172,1172,111764
test,3433,47,48128,475,475,48603
test,3434,154,157696,2064,2064,159760
test,3435,144,147456,1904,1904,149360
test,3436,193,197632,2659,2659,200291
test,3437,153,156672,2179,2179,158851
test,3438,104,106496,1330,1330,107826
test,3439,182,186368,2388,2388,188756
test,3440,283,289792,4039,4039,293831
test,3441,112,114688,1520,1520,116208
test,3442,156,159744,1944,1944,161688
test,3443,205,209920,2753,2753,212673
test,3444,110,112640,1398,1398,114038
test,3445,218,223232,3130,3130,226362
test,3446,166,169984,2176,2176,172160
test,3447,119,121856,1461,1461,123317
test,3448,139,142336,1711,1711,144047
test,3449,104,106496,1324,1324,107820
test,3450,179,183296,2567,2567,185863
test,3451,169,173056,2245,2245,175301
test,3452,103,105472,1393,1393,106865
test,3453,193,197632,2923,2923,200555
test,3454,66,67584,862,862,68446
test,3455,132,135168,1894,1894,137062
test,3456,180,184320,2706,2706,187026
test,3457,119,121856,1423,1423,123279
test,3458,236,241664,3088,3088,244752
test,3459,177,181248,2435,2435,183683
test,3460,74,75776,938,938,76714
test,3461,139,142336,1969,1969,144305
test,3462,168,172032,2330,2330,174362
test,3463,128,131072,1530,1530,132602
test,3464,287,293888,4141,4141,298029
test,3465,133,136192,1759,1759,137951
test,3466,166,169984,2696,2696,172680
test,3467,185,189440,2859,2859,192299
test,3468,113,115712,1443,1443,117155
test,3469,121,123904,1819,1819,125723
test,3470,112,114688,1482,1482,116170
test,3471,162,165888,2240,2240,168128
test,3472,154,157696,2002,2002,159698
test,3473,174,178176,2736,2736,180912
test,3474,114,116736,1446,1446,118182
test,3475,192,196608,2590,2590,199198
test,3476,138,141312,1664,1664,142976
test,3477,146,149504,1936,1936,151440
test,3478,75,76800,963,963,77763
test,3479,52,53248,560,560,53808
test,3480,162,165888,2236,2236,168124
test,3481,142,145408,1886,1886,147294
test,3482,131,134144,1829,1829,135973
test,3483,149,152576,2007,2007,154583
test,3484,135,138240,1675,1675,139915
test,3485,84,86016,978,978,86994
test,3486,149,152576,2123,2123,154699
test,3487,133,136192,1715,1715,137907
test,3488,233,238592,3679,3679,242271
test,3489,75,76800,937,937,77737
test,3490,183,187392,2635,2635,190027
test,3491,134,137216,1692,1692,138908
test,3492,172,176128,2138,2138,178266
test,3493,128,131072,1776,1776,132848
test,3494,321,328704,4191,4191,332895
test,3495,133,136192,1755,1755,137947
test,3496,92,94208,1168,1168,95376
test,3497,175,179200,2483,2483,181683
test,3498,221,226304,3059,3059,229363
test,3499,189,193536,2635,2635,196171
test,3500,147,150528,2111,2111,152639
test,3501,137,140288,1923,1923,142211
test,3502,97,99328,1117,1117,100445
test,3503,116,118784,1514,1514,120298
test,3504,227,232448,3237,3237,235685
test,3505,176,180224,2556,2556,182780
test,3506,79,80896,1003,1003,81899
test,3507,166,169984,2318,2318,172302
test,3508,196,200704,3190,3190,203894
test,3509,162,165888,2470,2470,168358
test,3510,134,137216,1714,1714,138930
test,3511,136,139264,1940,1940,141204
test,3512,165,168960,2211,2211,171171
test,3513,151,154624,1953,1953,156577
test,3514,107,109568,1373,1373,110941
test,3515,97,99328,1245,1245,100573
test,3516,187,191488,2561,2561,194049
test,3517,84,86016,960,960,86976
test,3518,55,56320,615,615,56935
test,3519,165,168960,2321,2321,171281
test,3520,61,62464,697,697,63161
test,3521,170,174080,2344,2344,176424
test,3522,280,286720,4138,4138,290858
test,3523,113,115712,1299,1299,117011
test,3524,132,135168,1864,1864,137032
test,3525,100,102400,1098,1098,103498
test,3526,143,146432,1803,1803,148235
test,3527,139,142336,1861,1861,144197
test,3528,221,226304,3239,3239,229543
test,3529,127,130048,1615,1615,131663
test,3530,154,157696,2246,2246,159942
test,3531,118,120832,1498,1498,122330
test,3532,137,140288,1737,1737,142025
test,3533,57,58368,663,663,59031
test,3534,210,215040,3008,3008,218048
test,3535,123,125952,1847,1847,127799
test,3536,175,179200,2321,2321,181521
test,3537,134,137216,1706,1706,138922
test,3538,172,176128,2394,2394,178522
test,3539,158,161792,2028,2028,163820
test,3540,161,164864,2153,2153,167017
test,3541,52,53248,590,590,53838
test,3542,85,87040,965,965,88005
test,3543,100,102400,1444,1444,103844
test,3544,159,162816,2489,2489,165305
test,3545,150,153600,2246,2246,155846
test,3546,169,173056,2421,2421,175477
test,3547,138,141312,1842,1842,143154
test,3548,114,116736,1434,1434,118170
test,3549,54,55296,624,624,55920
test,3550,48,49152,492,492,49644
test,3551,115,117760,1581,1581,119341
test,3552,194,198656,2814,2814,201470
test,3553,181,185344,2655,2655,187999
test,3554,122,124928,1604,1604,126532
test,3555,193,197632,2673,2673,200305
test,3556,172,176128,2370,2370,178498
test,3557,115,117760,1609,1609,119369
test,3558,178,182272,2324,2324,184596
test,3559,114,116736,1304,1304,118040
test,3560,29,29696,305,305,30001
test,3561,150,153600,2080,2080,155680
test,3562,111,113664,1467,1467,115131
test,3563,112,114688,1502,1502,116190
test,3564,146,149504,1996,1996,151500
test,3565,283,289792,4045,4045,293837
test,3566,119,121856,1511,1511,123367
test,3567,103,105472,1251,1251,106723
test,3568,72,73728,820,820,74548
test,3569,163,166912,2533,2533,169445
test,3570,134,137216,1860,1860,139076
test,3571,160,163840,2142,2142,165982
test,3572,171,175104,2237,2237,177341
test,3573,186,190464,2702,2702,193166
test,3574,184,188416,2500,2500,190916
test,3575,87,89088,1075,1075,90163
test,3576,142,145408,1756,1756,147164
test,3577,211,216064,3273,3273,219337
test,3578,183,187392,2675,2675,190067
test,3579,92,94208,992,992,95200
test,3580,121,123904,1463,1463,125367
test,3581,210,215040,3180,3180,218220
test,3582,186,190464,2324,2324,192788
test,3583,144,147456,1764,1764,149220
test,3584,107,109568,1211,1211,110779
test,3585,159,162816,2423,2423,165239
test,3586,102,104448,1308,1308,105756
test,3587,189,193536,2803,2803,196339
test,3588,100,102400,1122,1122,103522
test,3589,155,158720,2255,2255,160975
test,3590,106,108544,1350,1350,109894
test,3591,222,227328,2966,2966,230294
test,3592,196,200704,2858,2858,203562
test,3593,155,158720,2163,2163,160883
test,3594,147,150528,1887,1887,152415
test,3595,158,161792,2110,2110,163902
test,3596,108,110592,1250,1250,111842
test,3597,153,156672,2421,2421,159093
test,3598,110,112640,1298,1298,113938
test,3599,245,250880,3423,3423,254303
test,3600,120,122880,1320,1320,124200
test,3601,279,285696,4137,4137,289833
test,3602,149,152576,2017,2017,154593
test,3603,135,138240,1855,1855,140095
test,3604,193,197632,2797,2797,200429
test,3605,102,104448,1238,1238,105686
test,3606,128,131072,1682,1682,132754
test,3607,165,168960,2221,2221,171181
test,3608,172,176128,2332,2332,178460
test,3609,211,216064,2971,2971,219035
test,3610,209,214016,2941,2941,216957
test,3611,96,98304,1252,1252,99556
test,3612,194,198656,2650,2650,201306
test,3613,184,188416,2332,2332,190748
test,3614,146,149504,1932,1932,151436
test,3615,143,146432,2059,2059,148491
test,3616,98,100352,1164,1164,101516
test,3617,153,156672,2049,2049,158721
test,3618,86,88064,930,930,88994
test,3619,135,138240,1889,1889,140129
test,3620,67,68608,817,817,69425
test,3621,177,181248,2831,2831,184079
test,3622,114,116736,1414,1414,118150
test,3623,137,140288,1861,1861,142149
test,3624,197,201728,2911,2911,204639
test,3625,52,53248,584,584,53832
test,3626,100,102400,1304,1304,103704
test,3627,139,142336,1929,1929,144265
test,3628,88,90112,1218,1218,91330
test,3629,94,96256,1328,1328,97584
test,3630,194,198656,2730,2730,201386
test,3631,186,190464,2608,2608,193072
test,3632,156,159744,2150,2150,161894
test,3633,138,141312,1738,1738,143050
test,3634,136,139264,2046,2046,141310
test,3635,153,156672,2229,2229,158901
test,3636,121,123904,1497,1497,125401
test,3637,101,103424,1295,1295,104719
test,3638,220,225280,3244,3244,228524
test,3639,213,218112,2735,2735,220847
test,3640,93,95232,1137,1137,96369
test,3641,129,132096,1683,1683,133779
test,3642,109,111616,1249,1249,112865
test,3643,232,237568,3274,3274,240842
test,3644,136,139264,1944,1944,141208
test,3645,127,130048,1823,1823,131871
test,3646,100,102400,1196,1196,103596
test,3647,144,147456,2216,2216,149672
test,3648,168,172032,2148,2148,174180
test,3649,199,203776,2967,2967,206743
test,3650,173,177152,2241,2241,179393
test,3651,143,146432,1879,1879,148311
test,3652,60,61440,678,678,62118
test,3653,178,182272,2390,2390,184662
test,3654,202,206848,3248,3248,210096
test,3655,127,130048,1589,1589,131637
test,3656,206,210944,2652,2652,213596
test,3657,98,100352,1252,1252,101604
test,3658,106,108544,1248,1248,109792
test,3659,133,136192,1685,1685,137877
test,3660,72,73728,976,976,74704
test,3661,115,117760,1467,1467,119227
test,3662,119,121856,1623,1623,123479
test,3663,145,148480,2127,2127,150607
test,3664,100,102400,1186,1186,103586
test,3665,172,176128,2018,2018,178146
test,3666,141,144384,1827,1827,146211
test,3667,206,210944,2936,2936,213880
test,3668,82,83968,914,914,84882
test,3669,145,148480,2027,2027,150507
test,3670,187,191488,2829,2829,194317
test,3671,44,45056,470,470,45526
test,3672,114,116736,1570,1570,118306
test,3673,209,214016,3083,3083,217099
test,3674,189,193536,2857,2857,196393
test,3675,202,206848,3004,3004,209852
test,3676,104,106496,1200,1200,107696
test,3677,111,113664,1349,1349,115013
test,3678,111,113664,1461,1461,115125
test,3679,212,217088,3110,3110,220198
test,3680,182,186368,2508,2508,188876
test,3681,123,125952,1505,1505,127457
test,3682,192,196608,2686,2686,199294
test,3683,140,143360,2066,2066,145426
test,3684,167,171008,2217,2217,173225
test,3685,147,150528,2035,2035,152563
test,3686,92,94208,1004,1004,95212
test,3687,157,160768,1927,1927,162695
test,3688,49,50176,573,573,50749
test,3689,168,172032,2370,2370,174402
test,3690,143,146432,1861,1861,148293
test,3691,109,111616,1357,1357,112973
test,3692,130,133120,1826,1826,134946
test,3693,142,145408,1804,1804,147212
test,3694,188,192512,2560,2560,195072
test,3695,70,71680,906,906,72586
test,3696,88,90112,1150,1150,91262
test,3697,259,265216,4217,4217,269433
test,3698,57,58368,595,595,58963
test,3699,121,123904,1545,1545,125449
test,3700,155,158720,2129,2129,160849
test,3701,125,128000,1745,1745,129745
test,3702,186,190464,2504,2504,192968
test,3703,100,102400,1278,1278,103678
test,3704,57,58368,677,677,59045
test,3705,150,153600,2170,2170,155770
test,3706,182,186368,2374,2374,188742
test,3707,106,108544,1300,1300,109844
test,3708,150,153600,2058,2058,155658
test,3709,115,117760,1303,1303,119063
test,3710,116,118784,1448,1448,120232
test,3711,190,194560,2440,2440,197000
test,3712,137,140288,1775,1775,142063
test,3713,80,81920,912,912,82832
test,3714,115,117760,1485,1485,119245
test,3715,231,236544,3633,3633,240177
test,3716,110,112640,1356,1356,113996
test,3717,148,151552,2020,2020,153572
test,3718,129,132096,1685,1685,133781
test,3719,208,212992,2942,2942,215934
test,3720,171,175104,2291,2291,177395
test,3721,117,119808,1609,1609,121417
test,3722,197,201728,3155,3155,204883
test,3723,78,79872,920,920,80792
test,3724,115,117760,1433,1433,119193
test,3725,106,108544,1300,1300,109844
test,3726,77,78848,829,829,79677
test,3727,114,116736,1398,1398,118134
test,3728,121,123904,1761,1761,125665
test,3729,220,225280,3268,3268,228548
test,3730,76,77824,854,854,78678
test,3731,158,161792,2252,2252,164044
test,3732,159,162816,1989,1989,164805
test,3733,237,242688,3383,3383,246071
test,3734,118,120832,1716,1716,122548
test,3735,121,123904,1479,1479,125383
test,3736,199,203776,2773,2773,206549
test,3737,142,145408,1722,1722,147130
test,3738,67,68608,779,779,69387
test,3739,162,165888,2460,2460,168348
test,3740,159,162816,2121,2121,164937
test,3741,158,161792,2086,2086,163878
test,3742,160,163840,2422,2422,166262
test,3743,83,84992,1031,1031,86023
test,3744,66,67584,726,726,68310
test,3745,159,162816,2393,2393,165209
test,3746,66,67584,714,714,68298
test,3747,97,99328,1119,1119,100447
test,3748,191,195584,2747,2747,198331
test,3749,109,111616,1309,1309,112925
test,3750,163,166912,1951,1951,168863
test,3751,108,110592,1322,1322,111914
test,3752,209,214016,2871,2871,216887
test,3753,121,123904,1603,1603,125507
test,3754,174,178176,2468,2468,180644
test,3755,186,190464,2704,2704,193168
test,3756,151,154624,2047,2047,156671
test,3757,163,166912,2185,2185,169097
test,3758,144,147456,1722,1722,149178
test,3759,139,142336,1993,1993,144329
test,3760,136,139264,1732,1732,140996
test,3761,95,97280,1161,1161,98441
test,3762,127,130048,1757,1757,131805
test,3763,125,128000,1687,1687,129687
test,3764,73,74752,839,839,75591
test,3765,102,104448,1324,1324,105772
test,3766,217,222208,3115,3115,225323
test,3767,159,162816,1977,1977,164793
test,3768,40,40960,446,446,41406
test,3769,201,205824,2803,2803,208627
test,3770,116,118784,1672,1672,120456
test,3771,141,144384,1769,1769,146153
test,3772,93,95232,985,985,96217
test,3773,118,120832,1638,1638,122470
test,3774,151,154624,2041,2041,156665
test,3775,128,131072,1548,1548,132620
test,3776,139,142336,1739,1739,144075
test,3777,91,93184,1073,1073,94257
test,3778,101,103424,1319,1319,104743
test,3779,100,102400,1306,1306,103706
test,3780,163,166912,2153,2153,169065
test,3781,62,63488,698,698,64186
test,3782,96,98304,1268,1268,99572
test,3783,166,169984,2294,2294,172278
test,3784,135,138240,1917,1917,140157
test,3785,100,102400,1200,1200,103600
test,3786,155,158720,2137,2137,160857
test,3787,201,205824,2901,2901,208725
test,3788,96,98304,1212,1212,99516
test,3789,138,141312,1666,1666,142978
test,3790,71,72704,729,729,73433
test,3791,222,227328,3206,3206,230534
test,3792,83,84992,1027,1027,86019
test,3793,110,112640,1376,1376,114016
test,3794,77,78848,925,925,79773
test,3795,133,136192,1607,1607,137799
test,3796,49,50176,533,533,50709
test,3797,117,119808,1517,1517,121325
test,3798,54,55296,598,598,55894
test,3799,191,195584,2399,2399,197983
test,3800,164,167936,2112,2112,170048
test,3801,119,121856,1555,1555,123411
test,3802,70,71680,754,754,72434
test,3803,146,149504,2082,2082,151586
test,3804,161,164864,2219,2219,167083
test,3805,231,236544,3235,3235,239779
test,3806,96,98304,1278,1278,99582
test,3807,229,234496,3279,3279,237775
test,3808,191,195584,2691,2691,198275
test,3809,111,113664,1601,1601,115265
test,3810,113,115712,1635,1635,117347
test,3811,185,189440,2443,2443,191883
test,3812,146,149504,1898,1898,151402
test,3813,50,51200,562,562,51762
test,3814,127,130048,1473,1473,131521
test,3815,94,96256,1188,1188,97444
test,3816,185,189440,2799,2799,192239
test,3817,100,102400,1264,1264,103664
test,3818,166,169984,2154,2154,172138
test,3819,125,128000,1469,1469,129469
test,3820,177,181248,2419,2419,183667
test,3821,90,92160,1026,1026,93186
test,3822,161,164864,2301,2301,167165
test,3823,237,242688,3475,3475,246163
test,3824,117,119808,1365,1365,121173
test,3825,128,131072,1708,1708,132780
test,3826,120,122880,1528,1528,124408
test,3827,186,190464,2864,2864,193328
test,3828,86,88064,1106,1106,89170
test,3829,129,132096,1633,1633,133729
test,3830,167,171008,2545,2545,173553
test,3831,193,197632,2671,2671,200303
test,3832,110,112640,1414,1414,114054
test,3833,183,187392,2607,2607,189999
test,3834,128,131072,1676,1676,132748
test,3835,158,161792,2048,2048,163840
test,3836,168,172032,2222,2222,174254
test,3837,112,114688,1478,1478,116166
test,3838,55,56320,635,635,56955
test,3839,182,186368,2384,2384,188752
test,3840,224,229376,3474,3474,232850
test,3841,150,153600,2100,2100,155700
test,3842,127,130048,1705,1705,131753
test,3843,90,92160,1092,1092,93252
test,3844,112,114688,1426,1426,116114
test,3845,115,117760,1541,1541,119301
test,3846,148,151552,2264,2264,153816
test,3847,177,181248,2465,2465,183713
test,3848,135,138240,1771,1771,140011
test,3849,107,109568,1395,1395,110963
test,3850,127,130048,1623,1623,131671
test,3851,161,164864,2297,2297,167161
test,3852,65,66560,707,707,67267
test,3853,208,212992,2708,2708,215700
test,3854,70,71680,836,836,72516
test,3855,71,72704,773,773,73477
test,3856,195,199680,2809,2809,202489
test,3857,152,155648,1962,1962,157610
test,3858,64,65536,764,764,66300
test,3859,177,181248,2449,2449,183697
test,3860,88,90112,982,982,91094
test,3861,163,166912,2219,2219,169131
test,3862,94,96256,1104,1104,97360
test,3863,133,136192,1681,1681,137873
test,3864,202,206848,2738,2738,209586
test,3865,117,119808,1425,1425,121233
test,3866,49,50176,579,579,50755
test,3867,146,149504,1976,1976,151480
test,3868,135,138240,1855,1855,140095
test,3869,175,179200,2449,2449,181649
test,3870,173,177152,2307,2307,179459
test,3871,189,193536,2829,2829,196365
test,3872,114,116736,1424,1424,118160
test,3873,121,123904,1849,1849,125753
test,3874,200,204800,2796,2796,207596
test,3875,72,73728,852,852,74580
test,3876,87,89088,979,979,90067
test,3877,132,135168,1492,1492,136660
test,3878,66,67584,760,760,68344
test,3879,180,184320,2910,2910,187230
test,3880,198,202752,2572,2572,205324
test,3881,144,147456,2082,2082,149538
test,3882,180,184320,2556,2556,186876
test,3883,189,193536,2881,2881,196417
test,3884,117,119808,1485,1485,121293
test,3885,208,212992,2726,2726,215718
test,3886,177,181248,2271,2271,183519
test,3887,151,154624,2027,2027,156651
test,3888,58,59392,638,638,60030
test,3889,193,197632,2681,2681,200313
test,3890,76,77824,1028,1028,78852
test,3891,158,161792,2108,2108,163900
test,3892,96,98304,1068,1068,99372
test,3893,141,144384,1925,1925,146309
test,3894,217,222208,3441,3441,225649
test,3895,114,116736,1350,1350,118086
test,3896,66,67584,724,724,68308
test,3897,114,116736,1514,1514,118250
test,3898,85,87040,951,951,87991
test,3899,117,119808,1647,1647,121455
test,3900,94,96256,1018,1018,97274
test,3901,126,129024,1574,1574,130598
test,3902,111,113664,1323,1323,114987
test,3903,198,202752,2868,2868,205620
test,3904,224,229376,2974,2974,232350
test,3905,110,112640,1400,1400,114040
test,3906,127,130048,1629,1629,131677
test,3907,152,155648,2010,2010,157658
test,3908,167,171008,2163,2163,173171
test,3909,204,208896,3256,3256,212152
test,3910,314,321536,4658,4658,326194
test,3911,163,166912,2223,2223,169135
test,3912,155,158720,2241,2241,160961
test,3913,125,128000,1591,1591,129591
test,3914,145,148480,1929,1929,150409
test,3915,138,141312,1988,1988,143300
test,3916,185,189440,2687,2687,192127
test,3917,62,63488,660,660,64148
test,3918,155,158720,2263,2263,160983
test,3919,146,149504,1928,1928,151432
test,3920,158,161792,2266,2266,164058
test,3921,175,179200,2547,2547,181747
test,3922,170,174080,2166,2166,176246
test,3923,138,141312,1600,1600,142912
test,3924,182,186368,2560,2560,188928
test,3925,107,109568,1319,1319,110887
test,3926,149,152576,1853,1853,154429
test,3927,125,128000,1523,1523,129523
test,3928,132,135168,1762,1762,136930
test,3929,158,161792,2182,2182,163974
test,3930,121,123904,1489,1489,125393
test,3931,213,218112,3227,3227,221339
test,3932,173,177152,2373,2373,179525
test,3933,158,161792,2278,2278,164070
test,3934,59,60416,661,661,61077
test,3935,138,141312,1934,1934,143246
test,3936,162,165888,2260,2260,168148
test,3937,138,141312,1878,1878,143190
test,3938,146,149504,1684,1684,151188
test,3939,139,142336,1725,1725,144061
test,3940,92,94208,1074,1074,95282
test,3941,95,97280,1295,1295,98575
test,3942,140,143360,1862,1862,145222
test,3943,174,178176,2382,2382,180558
test,3944,136,139264,1864,1864,141128
test,3945,140,143360,1794,1794,145154
test,3946,40,40960,398,398,41358
test,3947,129,132096,1681,1681,133777
test,3948,158,161792,2162,2162,163954
test,3949,114,116736,1548,1548,118284
test,3950,136,139264,1788,1788,141052
test,3951,188,192512,2734,2734,195246
test,3952,120,122880,1512,1512,124392
test,3953,104,106496,1404,1404,107900
test,3954,90,92160,1166,1166,93326
test,3955,80,81920,1048,1048,82968
test,3956,168,172032,2300,2300,174332
test,3957,224,229376,2744,2744,232120
test,3958,93,95232,1185,1185,96417
test,3959,133,136192,1783,1783,137975
test,3960,184,188416,2574,2574,190990
test,3961,220,225280,3098,3098,228378
test,3962,90,92160,994,994,93154
test,3963,148,151552,2158,2158,153710
test,3964,161,164864,2099,2099,166963
test,3965,59,60416,627,627,61043
test,3966,97,99328,1257,1257,100585
test,3967,183,187392,2677,2677,190069
test,3968,124,126976,1756,1756,128732
test,3969,98,100352,1240,1240,101592
test,3970,208,212992,2794,2794,215786
test,3971,144,147456,1886,1886,149342
test,3972,222,227328,3198,3198,230526
test,3973,244,249856,3618,3618,253474
test,3974,134,137216,2090,2090,139306
test,3975,96,98304,1148,1148,99452
test,3976,150,153600,1990,1990,155590
test,3977,180,184320,2336,2336,186656
test,3978,126,129024,1754,1754,130778
test,3979,128,131072,1640,1640,132712
test,3980,235,240640,3583,3583,244223
test,3981,117,119808,1397,1397,121205
test,3982,150,153600,2060,2060,155660
test,3983,132,135168,1844,1844,137012
test,3984,75,76800,929,929,77729
test,3985,169,173056,2449,2449,175505
test,3986,232,237568,3336,3336,240904
test,3987,128,131072,1730,1730,132802
test,3988,156,159744,2152,2152,161896
test,3989,192,196608,2730,2730,199338
test,3990,112,114688,1486,1486,116174
test,3991,173,177152,2525,2525,179677
test,3992,251,257024,3771,3771,260795
test,3993,161,164864,2337,2337,167201
test,3994,111,113664,1299,1299,114963
test,3995,190,194560,2668,2668,197228
test,3996,132,135168,1720,1720,136888
test,3997,91,93184,1043,1043,94227
test,3998,132,135168,1844,1844,137012
test,3999,178,182272,2476,2476,184748
test,4000,120,122880,1580,1580,124460
test,4001,188,192512,2644,2644,195156
test,4002,155,158720,2083,2083,160803
test,4003,202,206848,2924,2924,209772
test,4004,172,176128,2364,2364,178492
test,4005,181,185344,2259,2259,187603
test,4006,90,92160,1012,1012,93172
test,4007,188,192512,2812,2812,195324
test,4008,272,278528,3434,3434,281962
test,4009,163,166912,2305,2305,169217
test,4010,164,167936,2304,2304,170240
test,4011,179,183296,2393,2393,185689
test,4012,163,166912,2607,2607,169519
test,4013,94,96256,1090,1090,97346
test,4014,167,171008,2461,2461,173469
test,4015,166,169984,2554,2554,172538
test,4016,126,129024,1584,1584,130608
test,4017,140,143360,1806,1806,145166
test,4018,140,143360,1732,1732,145092
test,4019,66,67584,702,702,68286
test,4020,185,189440,2587,2587,192027
test,4021,155,158720,2217,2217,160937
test,4022,123,125952,1749,1749,127701
test,4023,144,147456,1894,1894,149350
test,4024,189,193536,2375,2375,195911
test,4025,108,110592,1464,1464,112056
test,4026,194,198656,3186,3186,201842
test,4027,70,71680,824,824,72504
test,4028,94,96256,1180,1180,97436
test,4029,144,147456,1866,1866,149322
test,4030,177,181248,2301,2301,183549
test,4031,125,128000,1629,1629,129629
test,4032,108,110592,1554,1554,112146
test,4033,218,223232,3118,3118,226350
test,4034,71,72704,915,915,73619
test,4035,122,124928,1546,1546,126474
test,4036,110,112640,1596,1596,114236
test,4037,90,92160,1080,1080,93240
test,4038,123,125952,1591,1591,127543
test,4039,160,163840,2166,2166,166006
test,4040,151,154624,2073,2073,156697
test,4041,172,176128,2742,2742,178870
test,4042,76,77824,802,802,78626
