split,index,nodes,total_values_for_nodes,edges,total_values_for_edges,total_values_for_graph
train,0,45,46080,331,331,46411
train,1,16,16384,100,100,16484
train,2,31,31744,215,215,31959
train,3,20,20480,128,128,20608
train,4,39,39936,273,273,40209
train,5,21,21504,149,149,21653
train,6,13,13312,85,85,13397
train,7,19,19456,119,119,19575
train,8,19,19456,127,127,19583
train,9,30,30720,210,210,30930
train,10,28,28672,206,206,28878
train,11,22,22528,144,144,22672
train,12,23,23552,163,163,23715
train,13,10,10240,58,58,10298
train,14,13,13312,81,81,13393
train,15,15,15360,93,93,15453
train,16,26,26624,182,182,26806
train,17,9,9216,51,51,9267
train,18,20,20480,134,134,20614
train,19,32,32768,216,216,32984
train,20,13,13312,79,79,13391
train,21,4,4096,16,16,4112
train,22,33,33792,235,235,34027
train,23,17,17408,113,113,17521
train,24,12,12288,72,72,12360
train,25,18,18432,120,120,18552
train,26,21,21504,133,133,21637
train,27,30,30720,204,204,30924
train,28,20,20480,128,128,20608
train,29,5,5120,23,23,5143
train,30,33,33792,219,219,34011
train,31,23,23552,149,149,23701
train,32,4,4096,16,16,4112
train,33,20,20480,140,140,20620
train,34,35,35840,245,245,36085
train,35,29,29696,217,217,29913
train,36,31,31744,245,245,31989
train,37,32,32768,226,226,32994
train,38,33,33792,233,233,34025
train,39,32,32768,222,222,32990
train,40,25,25600,177,177,25777
train,41,17,17408,107,107,17515
train,42,14,14336,92,92,14428
train,43,15,15360,93,93,15453
train,44,32,32768,230,230,32998
train,45,17,17408,107,107,17515
train,46,23,23552,149,149,23701
train,47,26,26624,180,180,26804
train,48,38,38912,260,260,39172
train,49,16,16384,104,104,16488
train,50,13,13312,85,85,13397
train,51,29,29696,191,191,29887
train,52,28,28672,194,194,28866
train,53,23,23552,169,169,23721
train,54,16,16384,102,102,16486
train,55,26,26624,176,176,26800
train,56,13,13312,81,81,13393
train,57,4,4096,16,16,4112
train,58,30,30720,216,216,30936
train,59,24,24576,162,162,24738
train,60,5,5120,23,23,5143
train,61,31,31744,217,217,31961
train,62,23,23552,155,155,23707
train,63,16,16384,104,104,16488
train,64,5,5120,23,23,5143
train,65,16,16384,100,100,16484
train,66,20,20480,138,138,20618
train,67,22,22528,152,152,22680
train,68,21,21504,141,141,21645
train,69,36,36864,268,268,37132
train,70,7,7168,37,37,7205
train,71,14,14336,92,92,14428
train,72,22,22528,148,148,22676
train,73,35,35840,239,239,36079
train,74,9,9216,51,51,9267
train,75,20,20480,128,128,20608
train,76,15,15360,93,93,15453
train,77,35,35840,239,239,36079
train,78,22,22528,148,148,22676
train,79,27,27648,193,193,27841
train,80,13,13312,79,79,13391
train,81,12,12288,72,72,12360
train,82,21,21504,141,141,21645
train,83,10,10240,58,58,10298
train,84,32,32768,220,220,32988
train,85,18,18432,120,120,18552
train,86,25,25600,163,163,25763
train,87,25,25600,171,171,25771
train,88,32,32768,218,218,32986
train,89,11,11264,65,65,11329
train,90,6,6144,30,30,6174
train,91,29,29696,191,191,29887
train,92,16,16384,104,104,16488
train,93,14,14336,86,86,14422
train,94,9,9216,51,51,9267
train,95,19,19456,125,125,19581
train,96,29,29696,191,191,29887
train,97,16,16384,100,100,16484
train,98,16,16384,100,100,16484
train,99,25,25600,163,163,25763
train,100,21,21504,135,135,21639
train,101,26,26624,182,182,26806
train,102,26,26624,170,170,26794
train,103,40,40960,278,278,41238
train,104,17,17408,113,113,17521
train,105,35,35840,243,243,36083
train,106,17,17408,107,107,17515
train,107,19,19456,121,121,19577
train,108,18,18432,116,116,18548
train,109,17,17408,107,107,17515
train,110,17,17408,107,107,17515
train,111,26,26624,188,188,26812
train,112,30,30720,206,206,30926
train,113,20,20480,140,140,20620
train,114,17,17408,107,107,17515
train,115,16,16384,100,100,16484
train,116,7,7168,37,37,7205
train,117,19,19456,121,121,19577
train,118,11,11264,65,65,11329
train,119,55,56320,395,395,56715
train,120,8,8192,40,40,8232
train,121,20,20480,128,128,20608
train,122,7,7168,37,37,7205
train,123,26,26624,176,176,26800
train,124,28,28672,198,198,28870
train,125,25,25600,187,187,25787
train,126,19,19456,125,125,19581
train,127,31,31744,217,217,31961
train,128,18,18432,124,124,18556
train,129,25,25600,163,163,25763
train,130,23,23552,155,155,23707
train,131,30,30720,230,230,30950
train,132,25,25600,179,179,25779
train,133,33,33792,237,237,34029
train,134,50,51200,338,338,51538
train,135,36,36864,256,256,37120
train,136,16,16384,106,106,16490
train,137,38,38912,278,278,39190
train,138,33,33792,233,233,34025
train,139,14,14336,86,86,14422
train,140,29,29696,201,201,29897
train,141,6,6144,30,30,6174
train,142,15,15360,93,93,15453
train,143,14,14336,86,86,14422
train,144,19,19456,125,125,19581
train,145,23,23552,157,157,23709
train,146,13,13312,79,79,13391
train,147,22,22528,146,146,22674
train,148,31,31744,205,205,31949
train,149,11,11264,65,65,11329
train,150,32,32768,216,216,32984
train,151,13,13312,79,79,13391
train,152,18,18432,114,114,18546
train,153,23,23552,161,161,23713
train,154,13,13312,79,79,13391
train,155,10,10240,58,58,10298
train,156,24,24576,174,174,24750
train,157,24,24576,162,162,24738
train,158,27,27648,179,179,27827
train,159,7,7168,37,37,7205
train,160,12,12288,72,72,12360
train,161,24,24576,168,168,24744
train,162,4,4096,16,16,4112
train,163,8,8192,44,44,8236
train,164,23,23552,149,149,23701
train,165,11,11264,71,71,11335
train,166,25,25600,183,183,25783
train,167,7,7168,37,37,7205
train,168,22,22528,154,154,22682
train,169,20,20480,128,128,20608
train,170,27,27648,177,177,27825
train,171,31,31744,213,213,31957
train,172,21,21504,135,135,21639
train,173,11,11264,65,65,11329
train,174,17,17408,107,107,17515
train,175,32,32768,218,218,32986
train,176,10,10240,58,58,10298
train,177,23,23552,153,153,23705
train,178,10,10240,58,58,10298
train,179,30,30720,198,198,30918
train,180,21,21504,137,137,21641
train,181,35,35840,263,263,36103
train,182,23,23552,149,149,23701
train,183,16,16384,100,100,16484
train,184,19,19456,127,127,19583
train,185,21,21504,145,145,21649
train,186,9,9216,53,53,9269
train,187,20,20480,134,134,20614
train,188,27,27648,189,189,27837
train,189,35,35840,245,245,36085
train,190,16,16384,106,106,16490
train,191,11,11264,65,65,11329
train,192,32,32768,232,232,33000
train,193,14,14336,86,86,14422
train,194,29,29696,193,193,29889
train,195,24,24576,160,160,24736
train,196,25,25600,163,163,25763
train,197,11,11264,65,65,11329
train,198,13,13312,77,77,13389
train,199,15,15360,93,93,15453
train,200,17,17408,107,107,17515
train,201,27,27648,193,193,27841
train,202,9,9216,51,51,9267
train,203,15,15360,105,105,15465
train,204,5,5120,23,23,5143
train,205,19,19456,127,127,19583
train,206,19,19456,127,127,19583
train,207,33,33792,245,245,34037
train,208,18,18432,114,114,18546
train,209,18,18432,114,114,18546
train,210,11,11264,65,65,11329
train,211,30,30720,222,222,30942
train,212,23,23552,147,147,23699
train,213,28,28672,190,190,28862
train,214,10,10240,58,58,10298
train,215,23,23552,149,149,23701
train,216,20,20480,124,124,20604
train,217,29,29696,191,191,29887
train,218,8,8192,44,44,8236
train,219,25,25600,169,169,25769
train,220,16,16384,100,100,16484
train,221,24,24576,168,168,24744
train,222,37,37888,255,255,38143
train,223,24,24576,168,168,24744
train,224,26,26624,182,182,26806
train,225,6,6144,30,30,6174
train,226,29,29696,189,189,29885
train,227,28,28672,186,186,28858
train,228,7,7168,37,37,7205
train,229,46,47104,340,340,47444
train,230,21,21504,147,147,21651
train,231,12,12288,72,72,12360
train,232,17,17408,113,113,17521
train,233,11,11264,65,65,11329
train,234,8,8192,44,44,8236
train,235,18,18432,128,128,18560
train,236,16,16384,100,100,16484
train,237,22,22528,152,152,22680
train,238,17,17408,111,111,17519
train,239,8,8192,44,44,8236
train,240,30,30720,220,220,30940
train,241,14,14336,86,86,14422
train,242,13,13312,79,79,13391
train,243,12,12288,72,72,12360
train,244,6,6144,30,30,6174
train,245,22,22528,148,148,22676
train,246,32,32768,224,224,32992
train,247,26,26624,186,186,26810
train,248,10,10240,58,58,10298
train,249,24,24576,166,166,24742
train,250,34,34816,226,226,35042
train,251,8,8192,44,44,8236
train,252,24,24576,164,164,24740
train,253,17,17408,107,107,17515
train,254,27,27648,177,177,27825
train,255,6,6144,30,30,6174
train,256,21,21504,135,135,21639
train,257,11,11264,65,65,11329
train,258,29,29696,203,203,29899
train,259,14,14336,86,86,14422
train,260,22,22528,142,142,22670
train,261,25,25600,173,173,25773
train,262,37,37888,257,257,38145
train,263,34,34816,240,240,35056
train,264,7,7168,37,37,7205
train,265,21,21504,141,141,21645
train,266,16,16384,100,100,16484
train,267,27,27648,189,189,27837
train,268,23,23552,149,149,23701
train,269,36,36864,268,268,37132
train,270,32,32768,230,230,32998
train,271,11,11264,63,63,11327
train,272,20,20480,142,142,20622
train,273,29,29696,219,219,29915
train,274,27,27648,177,177,27825
train,275,32,32768,222,222,32990
train,276,31,31744,217,217,31961
train,277,19,19456,127,127,19583
train,278,28,28672,194,194,28866
train,279,4,4096,16,16,4112
train,280,8,8192,44,44,8236
train,281,22,22528,140,140,22668
train,282,16,16384,100,100,16484
train,283,19,19456,127,127,19583
train,284,18,18432,114,114,18546
train,285,28,28672,184,184,28856
train,286,8,8192,42,42,8234
train,287,41,41984,295,295,42279
train,288,16,16384,102,102,16486
train,289,25,25600,163,163,25763
train,290,12,12288,70,70,12358
train,291,33,33792,225,225,34017
train,292,25,25600,169,169,25769
train,293,42,43008,296,296,43304
train,294,17,17408,107,107,17515
train,295,8,8192,44,44,8236
train,296,39,39936,285,285,40221
train,297,25,25600,171,171,25771
train,298,17,17408,105,105,17513
train,299,7,7168,37,37,7205
train,300,24,24576,170,170,24746
train,301,19,19456,127,127,19583
train,302,21,21504,135,135,21639
train,303,19,19456,121,121,19577
train,304,9,9216,51,51,9267
train,305,5,5120,23,23,5143
train,306,7,7168,37,37,7205
train,307,18,18432,138,138,18570
train,308,19,19456,121,121,19577
train,309,22,22528,142,142,22670
train,310,13,13312,79,79,13391
train,311,25,25600,163,163,25763
train,312,34,34816,244,244,35060
train,313,31,31744,211,211,31955
train,314,11,11264,65,65,11329
train,315,36,36864,256,256,37120
train,316,21,21504,135,135,21639
train,317,23,23552,149,149,23701
train,318,6,6144,30,30,6174
train,319,29,29696,199,199,29895
train,320,24,24576,156,156,24732
train,321,24,24576,158,158,24734
train,322,16,16384,104,104,16488
train,323,18,18432,114,114,18546
train,324,28,28672,202,202,28874
train,325,20,20480,128,128,20608
train,326,24,24576,156,156,24732
train,327,18,18432,124,124,18556
train,328,34,34816,248,248,35064
train,329,11,11264,65,65,11329
train,330,34,34816,238,238,35054
train,331,14,14336,86,86,14422
train,332,23,23552,161,161,23713
train,333,26,26624,170,170,26794
train,334,35,35840,239,239,36079
train,335,36,36864,256,256,37120
train,336,19,19456,121,121,19577
train,337,10,10240,58,58,10298
train,338,29,29696,211,211,29907
train,339,6,6144,30,30,6174
train,340,17,17408,107,107,17515
train,341,39,39936,293,293,40229
train,342,8,8192,44,44,8236
train,343,6,6144,30,30,6174
train,344,5,5120,23,23,5143
train,345,28,28672,198,198,28870
train,346,27,27648,181,181,27829
train,347,14,14336,86,86,14422
train,348,9,9216,51,51,9267
train,349,8,8192,44,44,8236
train,350,30,30720,202,202,30922
train,351,17,17408,107,107,17515
train,352,40,40960,280,280,41240
train,353,14,14336,86,86,14422
train,354,23,23552,155,155,23707
train,355,20,20480,134,134,20614
train,356,23,23552,149,149,23701
train,357,20,20480,138,138,20618
train,358,29,29696,215,215,29911
train,359,16,16384,100,100,16484
train,360,12,12288,72,72,12360
train,361,20,20480,128,128,20608
train,362,18,18432,114,114,18546
train,363,19,19456,121,121,19577
train,364,15,15360,99,99,15459
train,365,22,22528,142,142,22670
train,366,30,30720,198,198,30918
train,367,18,18432,114,114,18546
train,368,32,32768,242,242,33010
train,369,46,47104,326,326,47430
train,370,39,39936,275,275,40211
train,371,11,11264,65,65,11329
train,372,28,28672,200,200,28872
train,373,9,9216,51,51,9267
train,374,12,12288,72,72,12360
train,375,18,18432,114,114,18546
train,376,19,19456,127,127,19583
train,377,14,14336,86,86,14422
train,378,14,14336,86,86,14422
train,379,32,32768,222,222,32990
train,380,19,19456,123,123,19579
train,381,6,6144,30,30,6174
train,382,13,13312,79,79,13391
train,383,9,9216,51,51,9267
train,384,13,13312,85,85,13397
train,385,8,8192,44,44,8236
train,386,12,12288,72,72,12360
train,387,9,9216,51,51,9267
train,388,21,21504,141,141,21645
train,389,29,29696,203,203,29899
train,390,21,21504,141,141,21645
train,391,5,5120,23,23,5143
train,392,19,19456,121,121,19577
train,393,24,24576,162,162,24738
train,394,11,11264,65,65,11329
train,395,21,21504,141,141,21645
train,396,33,33792,229,229,34021
train,397,15,15360,93,93,15453
train,398,14,14336,90,90,14426
train,399,32,32768,228,228,32996
train,400,6,6144,30,30,6174
train,401,38,38912,264,264,39176
train,402,24,24576,162,162,24738
train,403,37,37888,265,265,38153
train,404,44,45056,316,316,45372
train,405,30,30720,232,232,30952
train,406,25,25600,167,167,25767
train,407,11,11264,67,67,11331
train,408,26,26624,182,182,26806
train,409,15,15360,93,93,15453
train,410,19,19456,127,127,19583
train,411,9,9216,51,51,9267
train,412,20,20480,132,132,20612
train,413,27,27648,183,183,27831
train,414,35,35840,263,263,36103
train,415,9,9216,51,51,9267
train,416,25,25600,181,181,25781
train,417,15,15360,91,91,15451
train,418,32,32768,218,218,32986
train,419,15,15360,93,93,15453
train,420,19,19456,121,121,19577
train,421,26,26624,182,182,26806
train,422,10,10240,58,58,10298
train,423,14,14336,86,86,14422
train,424,29,29696,191,191,29887
train,425,11,11264,65,65,11329
train,426,22,22528,158,158,22686
train,427,21,21504,135,135,21639
train,428,24,24576,156,156,24732
train,429,26,26624,180,180,26804
train,430,18,18432,114,114,18546
train,431,25,25600,175,175,25775
train,432,22,22528,150,150,22678
train,433,16,16384,100,100,16484
train,434,24,24576,180,180,24756
train,435,19,19456,135,135,19591
train,436,28,28672,200,200,28872
train,437,20,20480,140,140,20620
train,438,14,14336,86,86,14422
train,439,12,12288,72,72,12360
train,440,12,12288,72,72,12360
train,441,33,33792,225,225,34017
train,442,35,35840,261,261,36101
train,443,11,11264,65,65,11329
train,444,12,12288,72,72,12360
train,445,32,32768,214,214,32982
train,446,14,14336,90,90,14426
train,447,34,34816,230,230,35046
train,448,21,21504,141,141,21645
train,449,28,28672,190,190,28862
train,450,27,27648,201,201,27849
train,451,20,20480,128,128,20608
train,452,9,9216,49,49,9265
train,453,14,14336,86,86,14422
train,454,10,10240,58,58,10298
train,455,12,12288,72,72,12360
train,456,37,37888,273,273,38161
train,457,31,31744,211,211,31955
train,458,6,6144,30,30,6174
train,459,26,26624,188,188,26812
train,460,10,10240,56,56,10296
train,461,30,30720,198,198,30918
train,462,32,32768,244,244,33012
train,463,23,23552,155,155,23707
train,464,16,16384,106,106,16490
train,465,28,28672,190,190,28862
train,466,24,24576,154,154,24730
train,467,25,25600,173,173,25773
train,468,25,25600,175,175,25775
train,469,14,14336,88,88,14424
train,470,21,21504,135,135,21639
train,471,24,24576,178,178,24754
train,472,28,28672,194,194,28866
train,473,16,16384,102,102,16486
train,474,31,31744,217,217,31961
train,475,26,26624,170,170,26794
train,476,30,30720,208,208,30928
train,477,38,38912,288,288,39200
train,478,18,18432,114,114,18546
train,479,22,22528,142,142,22670
train,480,27,27648,193,193,27841
train,481,32,32768,212,212,32980
train,482,5,5120,23,23,5143
train,483,10,10240,58,58,10298
train,484,40,40960,284,284,41244
train,485,16,16384,98,98,16482
train,486,25,25600,161,161,25761
train,487,13,13312,85,85,13397
train,488,27,27648,183,183,27831
train,489,34,34816,240,240,35056
train,490,13,13312,79,79,13391
train,491,31,31744,203,203,31947
train,492,9,9216,51,51,9267
train,493,23,23552,159,159,23711
train,494,8,8192,44,44,8236
train,495,18,18432,116,116,18548
train,496,12,12288,72,72,12360
train,497,19,19456,127,127,19583
train,498,34,34816,238,238,35054
train,499,14,14336,84,84,14420
train,500,25,25600,163,163,25763
train,501,7,7168,37,37,7205
train,502,26,26624,188,188,26812
train,503,44,45056,302,302,45358
train,504,34,34816,238,238,35054
train,505,23,23552,153,153,23705
train,506,17,17408,115,115,17523
train,507,31,31744,217,217,31961
train,508,30,30720,198,198,30918
train,509,31,31744,209,209,31953
train,510,30,30720,210,210,30930
train,511,18,18432,114,114,18546
train,512,10,10240,58,58,10298
train,513,19,19456,135,135,19591
train,514,15,15360,93,93,15453
train,515,15,15360,99,99,15459
train,516,33,33792,225,225,34017
train,517,21,21504,145,145,21649
train,518,14,14336,84,84,14420
train,519,12,12288,72,72,12360
train,520,32,32768,238,238,33006
train,521,17,17408,117,117,17525
train,522,9,9216,51,51,9267
train,523,10,10240,58,58,10298
train,524,16,16384,100,100,16484
train,525,8,8192,44,44,8236
train,526,26,26624,176,176,26800
train,527,29,29696,197,197,29893
train,528,15,15360,93,93,15453
train,529,22,22528,142,142,22670
train,530,16,16384,100,100,16484
train,531,23,23552,149,149,23701
train,532,15,15360,95,95,15455
train,533,22,22528,158,158,22686
train,534,29,29696,191,191,29887
train,535,22,22528,148,148,22676
train,536,46,47104,320,320,47424
train,537,21,21504,147,147,21651
train,538,9,9216,51,51,9267
train,539,24,24576,162,162,24738
train,540,16,16384,100,100,16484
train,541,23,23552,151,151,23703
train,542,5,5120,23,23,5143
train,543,16,16384,100,100,16484
train,544,35,35840,239,239,36079
train,545,38,38912,280,280,39192
train,546,24,24576,162,162,24738
train,547,26,26624,202,202,26826
train,548,21,21504,141,141,21645
train,549,11,11264,71,71,11335
train,550,14,14336,92,92,14428
train,551,34,34816,234,234,35050
train,552,11,11264,67,67,11331
train,553,24,24576,162,162,24738
train,554,21,21504,147,147,21651
train,555,6,6144,30,30,6174
train,556,22,22528,148,148,22676
train,557,14,14336,86,86,14422
train,558,28,28672,190,190,28862
train,559,28,28672,190,190,28862
train,560,14,14336,86,86,14422
train,561,20,20480,128,128,20608
train,562,8,8192,44,44,8236
train,563,18,18432,114,114,18546
train,564,36,36864,246,246,37110
train,565,35,35840,245,245,36085
train,566,39,39936,271,271,40207
train,567,24,24576,162,162,24738
train,568,11,11264,65,65,11329
train,569,9,9216,51,51,9267
train,570,9,9216,51,51,9267
train,571,19,19456,121,121,19577
train,572,21,21504,141,141,21645
train,573,33,33792,231,231,34023
train,574,8,8192,44,44,8236
train,575,34,34816,242,242,35058
train,576,26,26624,170,170,26794
train,577,26,26624,180,180,26804
train,578,21,21504,137,137,21641
train,579,16,16384,100,100,16484
train,580,19,19456,121,121,19577
train,581,23,23552,147,147,23699
train,582,22,22528,152,152,22680
train,583,14,14336,86,86,14422
train,584,29,29696,203,203,29899
train,585,27,27648,179,179,27827
train,586,16,16384,100,100,16484
train,587,19,19456,119,119,19575
train,588,20,20480,128,128,20608
train,589,46,47104,326,326,47430
train,590,24,24576,172,172,24748
train,591,27,27648,175,175,27823
train,592,26,26624,168,168,26792
train,593,15,15360,93,93,15453
train,594,29,29696,197,197,29893
train,595,38,38912,302,302,39214
train,596,14,14336,86,86,14422
train,597,8,8192,44,44,8236
train,598,30,30720,216,216,30936
train,599,21,21504,141,141,21645
train,600,20,20480,130,130,20610
train,601,24,24576,160,160,24736
train,602,6,6144,30,30,6174
train,603,20,20480,128,128,20608
train,604,8,8192,44,44,8236
train,605,17,17408,113,113,17521
train,606,10,10240,58,58,10298
train,607,18,18432,114,114,18546
train,608,19,19456,131,131,19587
train,609,19,19456,125,125,19581
train,610,10,10240,58,58,10298
train,611,27,27648,189,189,27837
train,612,9,9216,51,51,9267
train,613,29,29696,203,203,29899
train,614,11,11264,65,65,11329
train,615,34,34816,246,246,35062
train,616,26,26624,182,182,26806
train,617,9,9216,51,51,9267
train,618,32,32768,244,244,33012
train,619,12,12288,72,72,12360
train,620,34,34816,236,236,35052
train,621,3,3072,9,9,3081
train,622,33,33792,231,231,34023
train,623,13,13312,85,85,13397
train,624,20,20480,128,128,20608
train,625,16,16384,114,114,16498
train,626,26,26624,182,182,26806
train,627,29,29696,197,197,29893
train,628,34,34816,238,238,35054
train,629,9,9216,51,51,9267
train,630,5,5120,23,23,5143
train,631,37,37888,283,283,38171
train,632,21,21504,139,139,21643
train,633,22,22528,148,148,22676
train,634,26,26624,170,170,26794
train,635,8,8192,44,44,8236
train,636,19,19456,121,121,19577
train,637,18,18432,112,112,18544
train,638,23,23552,159,159,23711
train,639,19,19456,127,127,19583
train,640,22,22528,154,154,22682
train,641,37,37888,291,291,38179
train,642,35,35840,233,233,36073
train,643,47,48128,331,331,48459
train,644,29,29696,201,201,29897
train,645,29,29696,213,213,29909
train,646,16,16384,100,100,16484
train,647,15,15360,93,93,15453
train,648,20,20480,136,136,20616
train,649,18,18432,114,114,18546
train,650,14,14336,86,86,14422
train,651,36,36864,246,246,37110
train,652,10,10240,58,58,10298
train,653,19,19456,127,127,19583
train,654,11,11264,65,65,11329
train,655,27,27648,183,183,27831
train,656,13,13312,79,79,13391
train,657,21,21504,147,147,21651
train,658,27,27648,177,177,27825
train,659,5,5120,23,23,5143
train,660,26,26624,170,170,26794
train,661,18,18432,114,114,18546
train,662,21,21504,141,141,21645
train,663,3,3072,9,9,3081
train,664,12,12288,72,72,12360
train,665,11,11264,69,69,11333
train,666,15,15360,93,93,15453
train,667,20,20480,128,128,20608
train,668,8,8192,44,44,8236
train,669,13,13312,79,79,13391
train,670,31,31744,233,233,31977
train,671,15,15360,93,93,15453
train,672,16,16384,100,100,16484
train,673,8,8192,44,44,8236
train,674,12,12288,70,70,12358
train,675,17,17408,113,113,17521
train,676,35,35840,255,255,36095
train,677,24,24576,162,162,24738
train,678,17,17408,109,109,17517
train,679,6,6144,30,30,6174
train,680,11,11264,61,61,11325
train,681,11,11264,65,65,11329
train,682,7,7168,37,37,7205
train,683,16,16384,106,106,16490
train,684,15,15360,101,101,15461
train,685,9,9216,51,51,9267
train,686,6,6144,30,30,6174
train,687,15,15360,93,93,15453
train,688,13,13312,79,79,13391
train,689,18,18432,126,126,18558
train,690,11,11264,65,65,11329
train,691,5,5120,23,23,5143
train,692,10,10240,58,58,10298
train,693,24,24576,170,170,24746
train,694,9,9216,51,51,9267
train,695,52,53248,382,382,53630
train,696,28,28672,188,188,28860
train,697,28,28672,194,194,28866
train,698,13,13312,79,79,13391
train,699,14,14336,86,86,14422
train,700,39,39936,293,293,40229
train,701,13,13312,89,89,13401
train,702,12,12288,72,72,12360
train,703,16,16384,106,106,16490
train,704,24,24576,162,162,24738
train,705,23,23552,155,155,23707
train,706,10,10240,58,58,10298
train,707,33,33792,225,225,34017
train,708,22,22528,148,148,22676
train,709,17,17408,115,115,17523
train,710,30,30720,208,208,30928
train,711,21,21504,135,135,21639
train,712,15,15360,93,93,15453
train,713,21,21504,139,139,21643
train,714,41,41984,285,285,42269
train,715,22,22528,148,148,22676
train,716,29,29696,191,191,29887
train,717,19,19456,121,121,19577
train,718,33,33792,229,229,34021
train,719,30,30720,222,222,30942
train,720,15,15360,95,95,15455
train,721,34,34816,238,238,35054
train,722,11,11264,65,65,11329
train,723,27,27648,199,199,27847
train,724,20,20480,128,128,20608
train,725,16,16384,100,100,16484
train,726,23,23552,155,155,23707
train,727,6,6144,30,30,6174
train,728,27,27648,201,201,27849
train,729,23,23552,169,169,23721
train,730,22,22528,148,148,22676
train,731,16,16384,106,106,16490
train,732,34,34816,244,244,35060
train,733,28,28672,182,182,28854
train,734,26,26624,176,176,26800
train,735,35,35840,239,239,36079
train,736,28,28672,202,202,28874
train,737,5,5120,23,23,5143
train,738,16,16384,100,100,16484
train,739,11,11264,65,65,11329
train,740,26,26624,172,172,26796
train,741,12,12288,72,72,12360
train,742,13,13312,81,81,13393
train,743,13,13312,83,83,13395
train,744,4,4096,16,16,4112
train,745,11,11264,65,65,11329
train,746,22,22528,150,150,22678
train,747,32,32768,224,224,32992
train,748,17,17408,107,107,17515
train,749,15,15360,97,97,15457
train,750,25,25600,163,163,25763
train,751,24,24576,162,162,24738
train,752,11,11264,65,65,11329
train,753,22,22528,148,148,22676
train,754,16,16384,108,108,16492
train,755,24,24576,156,156,24732
train,756,23,23552,175,175,23727
train,757,18,18432,114,114,18546
train,758,10,10240,58,58,10298
train,759,25,25600,163,163,25763
train,760,6,6144,30,30,6174
train,761,28,28672,184,184,28856
train,762,19,19456,131,131,19587
train,763,32,32768,232,232,33000
train,764,21,21504,141,141,21645
train,765,25,25600,161,161,25761
train,766,18,18432,114,114,18546
train,767,12,12288,76,76,12364
train,768,35,35840,259,259,36099
train,769,22,22528,142,142,22670
train,770,22,22528,152,152,22680
train,771,13,13312,79,79,13391
train,772,24,24576,156,156,24732
train,773,24,24576,166,166,24742
train,774,31,31744,217,217,31961
train,775,19,19456,131,131,19587
train,776,40,40960,290,290,41250
train,777,30,30720,214,214,30934
train,778,35,35840,245,245,36085
train,779,32,32768,224,224,32992
train,780,34,34816,244,244,35060
train,781,36,36864,252,252,37116
train,782,28,28672,190,190,28862
train,783,24,24576,158,158,24734
train,784,12,12288,72,72,12360
train,785,10,10240,58,58,10298
train,786,14,14336,86,86,14422
train,787,30,30720,196,196,30916
train,788,46,47104,334,334,47438
train,789,9,9216,51,51,9267
train,790,22,22528,148,148,22676
train,791,11,11264,65,65,11329
train,792,10,10240,58,58,10298
train,793,24,24576,164,164,24740
train,794,10,10240,58,58,10298
train,795,37,37888,263,263,38151
train,796,39,39936,265,265,40201
train,797,7,7168,37,37,7205
train,798,13,13312,79,79,13391
train,799,18,18432,120,120,18552
train,800,32,32768,228,228,32996
train,801,13,13312,79,79,13391
train,802,9,9216,51,51,9267
train,803,24,24576,156,156,24732
train,804,13,13312,79,79,13391
train,805,24,24576,162,162,24738
train,806,34,34816,242,242,35058
train,807,28,28672,202,202,28874
train,808,28,28672,184,184,28856
train,809,5,5120,23,23,5143
train,810,15,15360,93,93,15453
train,811,6,6144,30,30,6174
train,812,27,27648,187,187,27835
train,813,36,36864,248,248,37112
train,814,38,38912,292,292,39204
train,815,35,35840,249,249,36089
train,816,19,19456,121,121,19577
train,817,35,35840,253,253,36093
train,818,28,28672,196,196,28868
train,819,18,18432,120,120,18552
train,820,18,18432,120,120,18552
train,821,20,20480,134,134,20614
train,822,17,17408,115,115,17523
train,823,15,15360,97,97,15457
train,824,26,26624,166,166,26790
train,825,29,29696,215,215,29911
train,826,8,8192,44,44,8236
train,827,36,36864,258,258,37122
train,828,17,17408,107,107,17515
train,829,27,27648,177,177,27825
train,830,37,37888,275,275,38163
train,831,23,23552,149,149,23701
train,832,34,34816,250,250,35066
train,833,12,12288,72,72,12360
train,834,28,28672,190,190,28862
train,835,20,20480,128,128,20608
train,836,34,34816,230,230,35046
train,837,18,18432,114,114,18546
train,838,19,19456,115,115,19571
train,839,25,25600,163,163,25763
train,840,36,36864,258,258,37122
train,841,28,28672,180,180,28852
train,842,9,9216,51,51,9267
train,843,14,14336,86,86,14422
train,844,33,33792,219,219,34011
train,845,7,7168,37,37,7205
train,846,43,44032,325,325,44357
train,847,28,28672,184,184,28856
train,848,16,16384,102,102,16486
train,849,13,13312,79,79,13391
train,850,18,18432,120,120,18552
train,851,8,8192,42,42,8234
train,852,32,32768,226,226,32994
train,853,14,14336,86,86,14422
train,854,20,20480,130,130,20610
train,855,15,15360,93,93,15453
train,856,21,21504,131,131,21635
train,857,41,41984,285,285,42269
train,858,32,32768,220,220,32988
train,859,32,32768,226,226,32994
train,860,6,6144,30,30,6174
train,861,31,31744,213,213,31957
train,862,19,19456,121,121,19577
train,863,10,10240,58,58,10298
train,864,34,34816,238,238,35054
train,865,17,17408,107,107,17515
train,866,28,28672,202,202,28874
train,867,14,14336,86,86,14422
train,868,16,16384,102,102,16486
train,869,29,29696,203,203,29899
train,870,17,17408,113,113,17521
train,871,20,20480,130,130,20610
train,872,24,24576,158,158,24734
train,873,17,17408,107,107,17515
train,874,19,19456,127,127,19583
train,875,37,37888,269,269,38157
train,876,11,11264,65,65,11329
train,877,30,30720,210,210,30930
train,878,24,24576,162,162,24738
train,879,19,19456,127,127,19583
train,880,11,11264,65,65,11329
train,881,10,10240,58,58,10298
train,882,21,21504,141,141,21645
train,883,14,14336,84,84,14420
train,884,7,7168,37,37,7205
train,885,9,9216,51,51,9267
train,886,18,18432,114,114,18546
train,887,17,17408,113,113,17521
train,888,14,14336,86,86,14422
train,889,19,19456,127,127,19583
train,890,23,23552,159,159,23711
train,891,8,8192,44,44,8236
train,892,24,24576,172,172,24748
train,893,20,20480,134,134,20614
train,894,12,12288,78,78,12366
train,895,31,31744,225,225,31969
train,896,30,30720,208,208,30928
train,897,20,20480,128,128,20608
train,898,24,24576,168,168,24744
train,899,16,16384,110,110,16494
train,900,22,22528,156,156,22684
train,901,18,18432,126,126,18558
train,902,17,17408,107,107,17515
train,903,17,17408,105,105,17513
train,904,24,24576,152,152,24728
train,905,9,9216,51,51,9267
train,906,45,46080,337,337,46417
train,907,28,28672,192,192,28864
train,908,25,25600,165,165,25765
train,909,11,11264,65,65,11329
train,910,8,8192,44,44,8236
train,911,24,24576,162,162,24738
train,912,16,16384,106,106,16490
train,913,34,34816,254,254,35070
train,914,7,7168,37,37,7205
train,915,16,16384,106,106,16490
train,916,16,16384,104,104,16488
train,917,24,24576,156,156,24732
train,918,11,11264,65,65,11329
train,919,38,38912,272,272,39184
train,920,15,15360,95,95,15455
train,921,29,29696,197,197,29893
train,922,25,25600,179,179,25779
train,923,12,12288,72,72,12360
train,924,25,25600,167,167,25767
train,925,12,12288,72,72,12360
train,926,17,17408,107,107,17515
train,927,21,21504,145,145,21649
train,928,9,9216,51,51,9267
train,929,29,29696,197,197,29893
train,930,8,8192,44,44,8236
train,931,26,26624,168,168,26792
train,932,9,9216,51,51,9267
train,933,32,32768,228,228,32996
train,934,16,16384,100,100,16484
train,935,28,28672,198,198,28870
train,936,13,13312,79,79,13391
train,937,19,19456,127,127,19583
train,938,22,22528,148,148,22676
train,939,7,7168,37,37,7205
train,940,24,24576,162,162,24738
train,941,25,25600,165,165,25765
train,942,5,5120,23,23,5143
train,943,10,10240,58,58,10298
train,944,19,19456,121,121,19577
train,945,7,7168,35,35,7203
train,946,18,18432,114,114,18546
train,947,19,19456,119,119,19575
train,948,21,21504,137,137,21641
train,949,22,22528,154,154,22682
train,950,20,20480,140,140,20620
train,951,8,8192,44,44,8236
train,952,20,20480,128,128,20608
train,953,11,11264,65,65,11329
train,954,15,15360,93,93,15453
train,955,38,38912,266,266,39178
train,956,7,7168,37,37,7205
train,957,6,6144,30,30,6174
train,958,19,19456,121,121,19577
train,959,24,24576,162,162,24738
train,960,30,30720,198,198,30918
train,961,11,11264,65,65,11329
train,962,29,29696,209,209,29905
train,963,9,9216,51,51,9267
train,964,31,31744,223,223,31967
train,965,8,8192,44,44,8236
train,966,24,24576,156,156,24732
train,967,24,24576,156,156,24732
train,968,31,31744,205,205,31949
train,969,10,10240,58,58,10298
train,970,42,43008,308,308,43316
train,971,21,21504,141,141,21645
train,972,43,44032,305,305,44337
train,973,32,32768,224,224,32992
train,974,28,28672,184,184,28856
train,975,41,41984,281,281,42265
train,976,22,22528,160,160,22688
train,977,13,13312,81,81,13393
train,978,10,10240,58,58,10298
train,979,28,28672,184,184,28856
train,980,15,15360,107,107,15467
train,981,12,12288,72,72,12360
train,982,32,32768,210,210,32978
train,983,3,3072,9,9,3081
train,984,23,23552,159,159,23711
train,985,26,26624,190,190,26814
train,986,36,36864,250,250,37114
train,987,35,35840,251,251,36091
train,988,25,25600,167,167,25767
train,989,17,17408,107,107,17515
train,990,19,19456,121,121,19577
train,991,22,22528,142,142,22670
train,992,44,45056,320,320,45376
train,993,5,5120,23,23,5143
train,994,15,15360,93,93,15453
train,995,30,30720,212,212,30932
train,996,13,13312,81,81,13393
train,997,27,27648,177,177,27825
train,998,32,32768,218,218,32986
train,999,27,27648,205,205,27853
train,1000,30,30720,234,234,30954
train,1001,17,17408,107,107,17515
train,1002,14,14336,84,84,14420
train,1003,37,37888,251,251,38139
train,1004,29,29696,207,207,29903
train,1005,13,13312,79,79,13391
train,1006,34,34816,238,238,35054
train,1007,25,25600,163,163,25763
train,1008,29,29696,209,209,29905
train,1009,31,31744,205,205,31949
train,1010,23,23552,155,155,23707
train,1011,28,28672,194,194,28866
train,1012,9,9216,51,51,9267
train,1013,17,17408,105,105,17513
train,1014,32,32768,228,228,32996
train,1015,15,15360,93,93,15453
train,1016,33,33792,225,225,34017
train,1017,26,26624,184,184,26808
train,1018,35,35840,249,249,36089
train,1019,18,18432,120,120,18552
train,1020,30,30720,210,210,30930
train,1021,13,13312,79,79,13391
train,1022,10,10240,58,58,10298
train,1023,19,19456,123,123,19579
train,1024,14,14336,86,86,14422
train,1025,22,22528,148,148,22676
train,1026,27,27648,197,197,27845
train,1027,31,31744,227,227,31971
train,1028,5,5120,23,23,5143
train,1029,24,24576,154,154,24730
train,1030,13,13312,79,79,13391
train,1031,27,27648,183,183,27831
train,1032,29,29696,201,201,29897
train,1033,22,22528,140,140,22668
train,1034,10,10240,58,58,10298
train,1035,33,33792,229,229,34021
train,1036,20,20480,128,128,20608
train,1037,22,22528,148,148,22676
train,1038,26,26624,172,172,26796
train,1039,24,24576,156,156,24732
train,1040,26,26624,170,170,26794
train,1041,32,32768,242,242,33010
train,1042,26,26624,170,170,26794
train,1043,19,19456,127,127,19583
train,1044,15,15360,93,93,15453
train,1045,11,11264,65,65,11329
train,1046,22,22528,148,148,22676
train,1047,13,13312,81,81,13393
train,1048,12,12288,72,72,12360
train,1049,22,22528,142,142,22670
train,1050,30,30720,214,214,30934
train,1051,22,22528,142,142,22670
train,1052,11,11264,65,65,11329
train,1053,31,31744,217,217,31961
train,1054,17,17408,109,109,17517
train,1055,17,17408,113,113,17521
train,1056,18,18432,114,114,18546
train,1057,18,18432,114,114,18546
train,1058,13,13312,79,79,13391
train,1059,7,7168,37,37,7205
train,1060,24,24576,168,168,24744
train,1061,14,14336,86,86,14422
train,1062,28,28672,190,190,28862
train,1063,22,22528,142,142,22670
train,1064,32,32768,238,238,33006
train,1065,17,17408,107,107,17515
train,1066,19,19456,141,141,19597
train,1067,34,34816,244,244,35060
train,1068,19,19456,127,127,19583
train,1069,24,24576,176,176,24752
train,1070,4,4096,16,16,4112
train,1071,21,21504,135,135,21639
train,1072,22,22528,142,142,22670
train,1073,29,29696,203,203,29899
train,1074,11,11264,63,63,11327
train,1075,32,32768,224,224,32992
train,1076,29,29696,209,209,29905
train,1077,12,12288,72,72,12360
train,1078,9,9216,51,51,9267
train,1079,36,36864,258,258,37122
train,1080,14,14336,86,86,14422
train,1081,16,16384,106,106,16490
train,1082,8,8192,44,44,8236
train,1083,7,7168,37,37,7205
train,1084,15,15360,95,95,15455
train,1085,24,24576,166,166,24742
train,1086,13,13312,79,79,13391
train,1087,23,23552,149,149,23701
train,1088,11,11264,65,65,11329
train,1089,23,23552,159,159,23711
train,1090,30,30720,198,198,30918
train,1091,31,31744,215,215,31959
train,1092,24,24576,182,182,24758
train,1093,12,12288,72,72,12360
train,1094,15,15360,93,93,15453
train,1095,19,19456,135,135,19591
train,1096,37,37888,277,277,38165
train,1097,27,27648,189,189,27837
train,1098,27,27648,187,187,27835
train,1099,27,27648,189,189,27837
train,1100,20,20480,128,128,20608
train,1101,23,23552,159,159,23711
train,1102,28,28672,192,192,28864
train,1103,12,12288,76,76,12364
train,1104,27,27648,189,189,27837
train,1105,27,27648,179,179,27827
train,1106,18,18432,114,114,18546
train,1107,5,5120,23,23,5143
train,1108,17,17408,107,107,17515
train,1109,9,9216,53,53,9269
train,1110,8,8192,40,40,8232
train,1111,37,37888,253,253,38141
train,1112,19,19456,121,121,19577
train,1113,14,14336,96,96,14432
train,1114,42,43008,288,288,43296
train,1115,36,36864,246,246,37110
train,1116,9,9216,51,51,9267
train,1117,29,29696,219,219,29915
train,1118,38,38912,306,306,39218
train,1119,10,10240,58,58,10298
train,1120,15,15360,93,93,15453
train,1121,22,22528,154,154,22682
train,1122,23,23552,161,161,23713
train,1123,11,11264,67,67,11331
train,1124,15,15360,93,93,15453
train,1125,20,20480,126,126,20606
train,1126,17,17408,107,107,17515
train,1127,35,35840,243,243,36083
train,1128,23,23552,163,163,23715
train,1129,20,20480,128,128,20608
train,1130,10,10240,56,56,10296
train,1131,39,39936,267,267,40203
train,1132,11,11264,65,65,11329
train,1133,34,34816,246,246,35062
train,1134,34,34816,238,238,35054
train,1135,24,24576,162,162,24738
train,1136,30,30720,214,214,30934
train,1137,23,23552,155,155,23707
train,1138,24,24576,166,166,24742
train,1139,29,29696,211,211,29907
train,1140,14,14336,90,90,14426
train,1141,5,5120,23,23,5143
train,1142,13,13312,79,79,13391
train,1143,6,6144,30,30,6174
train,1144,11,11264,65,65,11329
train,1145,17,17408,107,107,17515
train,1146,34,34816,256,256,35072
train,1147,15,15360,93,93,15453
train,1148,4,4096,16,16,4112
train,1149,29,29696,199,199,29895
train,1150,7,7168,37,37,7205
train,1151,16,16384,102,102,16486
train,1152,10,10240,58,58,10298
train,1153,18,18432,118,118,18550
train,1154,21,21504,141,141,21645
train,1155,17,17408,107,107,17515
train,1156,41,41984,303,303,42287
train,1157,9,9216,51,51,9267
train,1158,34,34816,238,238,35054
train,1159,20,20480,128,128,20608
train,1160,13,13312,79,79,13391
train,1161,24,24576,162,162,24738
train,1162,37,37888,259,259,38147
train,1163,21,21504,143,143,21647
train,1164,15,15360,93,93,15453
train,1165,21,21504,141,141,21645
train,1166,16,16384,106,106,16490
train,1167,24,24576,162,162,24738
train,1168,10,10240,58,58,10298
train,1169,26,26624,188,188,26812
train,1170,34,34816,242,242,35058
train,1171,15,15360,89,89,15449
train,1172,36,36864,246,246,37110
train,1173,17,17408,107,107,17515
train,1174,16,16384,100,100,16484
train,1175,10,10240,58,58,10298
train,1176,23,23552,149,149,23701
train,1177,10,10240,58,58,10298
train,1178,17,17408,107,107,17515
train,1179,10,10240,58,58,10298
train,1180,24,24576,162,162,24738
train,1181,11,11264,65,65,11329
train,1182,7,7168,37,37,7205
train,1183,14,14336,86,86,14422
train,1184,25,25600,181,181,25781
train,1185,11,11264,69,69,11333
train,1186,12,12288,72,72,12360
train,1187,20,20480,134,134,20614
train,1188,26,26624,170,170,26794
train,1189,32,32768,236,236,33004
train,1190,16,16384,106,106,16490
train,1191,20,20480,128,128,20608
train,1192,34,34816,234,234,35050
train,1193,19,19456,121,121,19577
train,1194,16,16384,106,106,16490
train,1195,13,13312,79,79,13391
train,1196,26,26624,176,176,26800
train,1197,16,16384,100,100,16484
train,1198,5,5120,23,23,5143
train,1199,29,29696,203,203,29899
train,1200,35,35840,255,255,36095
train,1201,12,12288,72,72,12360
train,1202,7,7168,37,37,7205
train,1203,29,29696,197,197,29893
train,1204,35,35840,241,241,36081
train,1205,22,22528,148,148,22676
train,1206,23,23552,149,149,23701
train,1207,11,11264,65,65,11329
train,1208,12,12288,72,72,12360
train,1209,15,15360,99,99,15459
train,1210,33,33792,225,225,34017
train,1211,20,20480,148,148,20628
train,1212,14,14336,86,86,14422
train,1213,30,30720,210,210,30930
train,1214,10,10240,56,56,10296
train,1215,27,27648,195,195,27843
train,1216,10,10240,56,56,10296
train,1217,8,8192,44,44,8236
train,1218,13,13312,79,79,13391
train,1219,24,24576,156,156,24732
train,1220,16,16384,106,106,16490
train,1221,29,29696,205,205,29901
train,1222,6,6144,30,30,6174
train,1223,11,11264,65,65,11329
train,1224,20,20480,128,128,20608
train,1225,16,16384,106,106,16490
train,1226,14,14336,86,86,14422
train,1227,19,19456,131,131,19587
train,1228,36,36864,278,278,37142
train,1229,34,34816,250,250,35066
train,1230,9,9216,51,51,9267
train,1231,6,6144,30,30,6174
train,1232,12,12288,72,72,12360
train,1233,12,12288,72,72,12360
train,1234,31,31744,219,219,31963
train,1235,31,31744,215,215,31959
train,1236,24,24576,168,168,24744
train,1237,25,25600,167,167,25767
train,1238,15,15360,93,93,15453
train,1239,45,46080,345,345,46425
train,1240,15,15360,93,93,15453
train,1241,5,5120,23,23,5143
train,1242,19,19456,121,121,19577
train,1243,23,23552,153,153,23705
train,1244,31,31744,223,223,31967
train,1245,15,15360,95,95,15455
train,1246,18,18432,114,114,18546
train,1247,33,33792,227,227,34019
train,1248,23,23552,155,155,23707
train,1249,5,5120,23,23,5143
train,1250,5,5120,23,23,5143
train,1251,7,7168,37,37,7205
train,1252,14,14336,86,86,14422
train,1253,16,16384,100,100,16484
train,1254,24,24576,162,162,24738
train,1255,12,12288,72,72,12360
train,1256,17,17408,107,107,17515
train,1257,22,22528,148,148,22676
train,1258,28,28672,196,196,28868
train,1259,6,6144,30,30,6174
train,1260,13,13312,79,79,13391
train,1261,18,18432,122,122,18554
train,1262,7,7168,37,37,7205
train,1263,42,43008,294,294,43302
train,1264,27,27648,183,183,27831
train,1265,28,28672,196,196,28868
train,1266,10,10240,58,58,10298
train,1267,29,29696,191,191,29887
train,1268,23,23552,161,161,23713
train,1269,11,11264,65,65,11329
train,1270,21,21504,131,131,21635
train,1271,30,30720,206,206,30926
train,1272,27,27648,179,179,27827
train,1273,20,20480,138,138,20618
train,1274,26,26624,170,170,26794
train,1275,28,28672,186,186,28858
train,1276,25,25600,163,163,25763
train,1277,22,22528,142,142,22670
train,1278,21,21504,137,137,21641
train,1279,26,26624,182,182,26806
train,1280,29,29696,195,195,29891
train,1281,15,15360,97,97,15457
train,1282,42,43008,300,300,43308
train,1283,23,23552,151,151,23703
train,1284,22,22528,158,158,22686
train,1285,11,11264,65,65,11329
train,1286,23,23552,153,153,23705
train,1287,22,22528,148,148,22676
train,1288,28,28672,184,184,28856
train,1289,40,40960,272,272,41232
train,1290,31,31744,211,211,31955
train,1291,11,11264,65,65,11329
train,1292,26,26624,176,176,26800
train,1293,54,55296,404,404,55700
train,1294,22,22528,142,142,22670
train,1295,26,26624,186,186,26810
train,1296,20,20480,138,138,20618
train,1297,11,11264,65,65,11329
train,1298,24,24576,156,156,24732
train,1299,10,10240,58,58,10298
train,1300,31,31744,227,227,31971
train,1301,25,25600,169,169,25769
train,1302,14,14336,88,88,14424
train,1303,27,27648,189,189,27837
train,1304,30,30720,198,198,30918
train,1305,14,14336,86,86,14422
train,1306,20,20480,134,134,20614
train,1307,25,25600,169,169,25769
train,1308,43,44032,311,311,44343
train,1309,7,7168,37,37,7205
train,1310,15,15360,93,93,15453
train,1311,7,7168,37,37,7205
train,1312,29,29696,191,191,29887
train,1313,5,5120,23,23,5143
train,1314,22,22528,142,142,22670
train,1315,14,14336,86,86,14422
train,1316,12,12288,72,72,12360
train,1317,10,10240,58,58,10298
train,1318,14,14336,86,86,14422
train,1319,14,14336,86,86,14422
train,1320,5,5120,23,23,5143
train,1321,6,6144,30,30,6174
train,1322,16,16384,100,100,16484
train,1323,19,19456,125,125,19581
train,1324,17,17408,107,107,17515
train,1325,18,18432,120,120,18552
train,1326,21,21504,133,133,21637
train,1327,6,6144,30,30,6174
train,1328,23,23552,149,149,23701
train,1329,18,18432,114,114,18546
train,1330,14,14336,86,86,14422
train,1331,27,27648,193,193,27841
train,1332,23,23552,149,149,23701
train,1333,21,21504,135,135,21639
train,1334,33,33792,225,225,34017
train,1335,16,16384,102,102,16486
train,1336,22,22528,144,144,22672
train,1337,15,15360,93,93,15453
train,1338,18,18432,114,114,18546
train,1339,29,29696,197,197,29893
train,1340,26,26624,180,180,26804
train,1341,33,33792,257,257,34049
train,1342,20,20480,128,128,20608
train,1343,22,22528,142,142,22670
train,1344,9,9216,51,51,9267
train,1345,37,37888,259,259,38147
train,1346,19,19456,123,123,19579
train,1347,12,12288,72,72,12360
train,1348,10,10240,58,58,10298
train,1349,6,6144,30,30,6174
train,1350,16,16384,100,100,16484
train,1351,17,17408,107,107,17515
train,1352,23,23552,151,151,23703
train,1353,13,13312,79,79,13391
train,1354,9,9216,51,51,9267
train,1355,4,4096,16,16,4112
train,1356,25,25600,169,169,25769
train,1357,35,35840,253,253,36093
train,1358,25,25600,165,165,25765
train,1359,19,19456,121,121,19577
train,1360,11,11264,65,65,11329
train,1361,26,26624,176,176,26800
train,1362,23,23552,149,149,23701
train,1363,4,4096,16,16,4112
train,1364,21,21504,141,141,21645
train,1365,36,36864,252,252,37116
train,1366,33,33792,237,237,34029
train,1367,13,13312,79,79,13391
train,1368,48,49152,364,364,49516
train,1369,20,20480,128,128,20608
train,1370,21,21504,135,135,21639
train,1371,48,49152,330,330,49482
train,1372,24,24576,160,160,24736
train,1373,12,12288,72,72,12360
train,1374,14,14336,92,92,14428
train,1375,15,15360,103,103,15463
train,1376,28,28672,218,218,28890
train,1377,33,33792,237,237,34029
train,1378,12,12288,72,72,12360
train,1379,23,23552,147,147,23699
train,1380,25,25600,175,175,25775
train,1381,33,33792,233,233,34025
train,1382,21,21504,139,139,21643
train,1383,11,11264,65,65,11329
train,1384,26,26624,170,170,26794
train,1385,12,12288,72,72,12360
train,1386,13,13312,81,81,13393
train,1387,13,13312,83,83,13395
train,1388,21,21504,133,133,21637
train,1389,25,25600,179,179,25779
train,1390,5,5120,23,23,5143
train,1391,14,14336,86,86,14422
train,1392,15,15360,97,97,15457
train,1393,33,33792,229,229,34021
train,1394,13,13312,77,77,13389
train,1395,27,27648,191,191,27839
train,1396,28,28672,192,192,28864
train,1397,19,19456,121,121,19577
train,1398,19,19456,121,121,19577
train,1399,27,27648,183,183,27831
train,1400,27,27648,183,183,27831
train,1401,9,9216,51,51,9267
train,1402,14,14336,84,84,14420
train,1403,14,14336,88,88,14424
train,1404,6,6144,30,30,6174
train,1405,17,17408,107,107,17515
train,1406,19,19456,121,121,19577
train,1407,10,10240,58,58,10298
train,1408,17,17408,107,107,17515
train,1409,16,16384,100,100,16484
train,1410,20,20480,134,134,20614
train,1411,41,41984,285,285,42269
train,1412,33,33792,225,225,34017
train,1413,24,24576,162,162,24738
train,1414,23,23552,155,155,23707
train,1415,25,25600,169,169,25769
train,1416,15,15360,99,99,15459
train,1417,15,15360,99,99,15459
train,1418,33,33792,241,241,34033
train,1419,26,26624,170,170,26794
train,1420,19,19456,127,127,19583
train,1421,16,16384,96,96,16480
train,1422,16,16384,100,100,16484
train,1423,24,24576,158,158,24734
train,1424,26,26624,176,176,26800
train,1425,44,45056,330,330,45386
train,1426,8,8192,44,44,8236
train,1427,10,10240,58,58,10298
train,1428,19,19456,121,121,19577
train,1429,25,25600,197,197,25797
train,1430,31,31744,205,205,31949
train,1431,23,23552,149,149,23701
train,1432,11,11264,65,65,11329
train,1433,8,8192,44,44,8236
train,1434,24,24576,162,162,24738
train,1435,24,24576,170,170,24746
train,1436,17,17408,107,107,17515
train,1437,19,19456,121,121,19577
train,1438,22,22528,144,144,22672
train,1439,25,25600,169,169,25769
train,1440,15,15360,99,99,15459
train,1441,12,12288,72,72,12360
train,1442,25,25600,163,163,25763
train,1443,28,28672,196,196,28868
train,1444,19,19456,121,121,19577
train,1445,35,35840,231,231,36071
train,1446,16,16384,100,100,16484
train,1447,27,27648,183,183,27831
train,1448,28,28672,202,202,28874
train,1449,11,11264,65,65,11329
train,1450,10,10240,58,58,10298
train,1451,12,12288,72,72,12360
train,1452,33,33792,227,227,34019
train,1453,10,10240,58,58,10298
train,1454,30,30720,204,204,30924
train,1455,25,25600,169,169,25769
train,1456,13,13312,85,85,13397
train,1457,34,34816,250,250,35066
train,1458,13,13312,81,81,13393
train,1459,19,19456,121,121,19577
train,1460,29,29696,211,211,29907
train,1461,16,16384,100,100,16484
train,1462,18,18432,120,120,18552
train,1463,9,9216,51,51,9267
train,1464,22,22528,142,142,22670
train,1465,14,14336,88,88,14424
train,1466,32,32768,230,230,32998
train,1467,26,26624,176,176,26800
train,1468,14,14336,96,96,14432
train,1469,19,19456,127,127,19583
train,1470,12,12288,72,72,12360
train,1471,32,32768,222,222,32990
train,1472,34,34816,238,238,35054
train,1473,25,25600,175,175,25775
train,1474,24,24576,158,158,24734
train,1475,18,18432,120,120,18552
train,1476,17,17408,107,107,17515
train,1477,12,12288,72,72,12360
train,1478,30,30720,206,206,30926
train,1479,25,25600,169,169,25769
train,1480,16,16384,100,100,16484
train,1481,40,40960,292,292,41252
train,1482,35,35840,257,257,36097
train,1483,6,6144,30,30,6174
train,1484,26,26624,176,176,26800
train,1485,36,36864,246,246,37110
train,1486,28,28672,198,198,28870
train,1487,10,10240,56,56,10296
train,1488,12,12288,76,76,12364
train,1489,6,6144,30,30,6174
train,1490,11,11264,61,61,11325
train,1491,13,13312,79,79,13391
train,1492,13,13312,79,79,13391
train,1493,33,33792,231,231,34023
train,1494,19,19456,121,121,19577
train,1495,8,8192,44,44,8236
train,1496,33,33792,219,219,34011
train,1497,23,23552,149,149,23701
train,1498,36,36864,252,252,37116
train,1499,38,38912,266,266,39178
train,1500,22,22528,152,152,22680
train,1501,15,15360,93,93,15453
train,1502,15,15360,93,93,15453
train,1503,18,18432,118,118,18550
train,1504,10,10240,56,56,10296
train,1505,7,7168,37,37,7205
train,1506,35,35840,255,255,36095
train,1507,6,6144,30,30,6174
train,1508,33,33792,249,249,34041
train,1509,27,27648,197,197,27845
train,1510,15,15360,97,97,15457
train,1511,12,12288,72,72,12360
train,1512,15,15360,93,93,15453
train,1513,8,8192,44,44,8236
train,1514,26,26624,182,182,26806
train,1515,36,36864,266,266,37130
train,1516,11,11264,65,65,11329
train,1517,19,19456,127,127,19583
train,1518,10,10240,58,58,10298
train,1519,11,11264,65,65,11329
train,1520,14,14336,86,86,14422
train,1521,13,13312,79,79,13391
train,1522,11,11264,65,65,11329
train,1523,14,14336,84,84,14420
train,1524,33,33792,241,241,34033
train,1525,16,16384,104,104,16488
train,1526,26,26624,170,170,26794
train,1527,28,28672,198,198,28870
train,1528,35,35840,243,243,36083
train,1529,7,7168,37,37,7205
train,1530,31,31744,227,227,31971
train,1531,24,24576,162,162,24738
train,1532,24,24576,156,156,24732
train,1533,34,34816,228,228,35044
train,1534,16,16384,100,100,16484
train,1535,18,18432,120,120,18552
train,1536,11,11264,65,65,11329
train,1537,16,16384,100,100,16484
train,1538,14,14336,92,92,14428
train,1539,28,28672,198,198,28870
train,1540,10,10240,62,62,10302
train,1541,28,28672,190,190,28862
train,1542,24,24576,156,156,24732
train,1543,15,15360,93,93,15453
train,1544,29,29696,195,195,29891
train,1545,29,29696,191,191,29887
train,1546,21,21504,135,135,21639
train,1547,39,39936,271,271,40207
train,1548,24,24576,156,156,24732
train,1549,14,14336,86,86,14422
train,1550,11,11264,65,65,11329
train,1551,13,13312,79,79,13391
train,1552,21,21504,135,135,21639
train,1553,40,40960,306,306,41266
train,1554,9,9216,51,51,9267
train,1555,21,21504,147,147,21651
train,1556,10,10240,58,58,10298
train,1557,34,34816,244,244,35060
train,1558,15,15360,93,93,15453
train,1559,34,34816,226,226,35042
train,1560,16,16384,100,100,16484
train,1561,6,6144,30,30,6174
train,1562,13,13312,85,85,13397
train,1563,9,9216,51,51,9267
train,1564,8,8192,44,44,8236
train,1565,33,33792,243,243,34035
train,1566,23,23552,157,157,23709
train,1567,15,15360,93,93,15453
train,1568,32,32768,234,234,33002
train,1569,15,15360,93,93,15453
train,1570,33,33792,219,219,34011
train,1571,25,25600,165,165,25765
train,1572,26,26624,176,176,26800
train,1573,26,26624,176,176,26800
train,1574,21,21504,135,135,21639
train,1575,14,14336,86,86,14422
train,1576,7,7168,37,37,7205
train,1577,18,18432,114,114,18546
train,1578,10,10240,58,58,10298
train,1579,40,40960,274,274,41234
train,1580,44,45056,308,308,45364
train,1581,28,28672,184,184,28856
train,1582,44,45056,328,328,45384
train,1583,5,5120,23,23,5143
train,1584,6,6144,30,30,6174
train,1585,13,13312,79,79,13391
train,1586,18,18432,114,114,18546
train,1587,37,37888,267,267,38155
train,1588,11,11264,65,65,11329
train,1589,27,27648,191,191,27839
train,1590,13,13312,79,79,13391
train,1591,25,25600,167,167,25767
train,1592,24,24576,168,168,24744
train,1593,29,29696,201,201,29897
train,1594,32,32768,222,222,32990
train,1595,12,12288,72,72,12360
train,1596,13,13312,79,79,13391
train,1597,12,12288,72,72,12360
train,1598,14,14336,86,86,14422
train,1599,31,31744,217,217,31961
train,1600,24,24576,178,178,24754
train,1601,34,34816,238,238,35054
train,1602,8,8192,44,44,8236
train,1603,14,14336,86,86,14422
train,1604,34,34816,240,240,35056
train,1605,15,15360,93,93,15453
train,1606,23,23552,149,149,23701
train,1607,22,22528,142,142,22670
train,1608,10,10240,58,58,10298
train,1609,21,21504,135,135,21639
train,1610,39,39936,273,273,40209
train,1611,12,12288,72,72,12360
train,1612,19,19456,139,139,19595
train,1613,21,21504,135,135,21639
train,1614,22,22528,142,142,22670
train,1615,17,17408,107,107,17515
train,1616,30,30720,200,200,30920
train,1617,21,21504,135,135,21639
train,1618,13,13312,79,79,13391
train,1619,10,10240,58,58,10298
train,1620,34,34816,258,258,35074
train,1621,17,17408,107,107,17515
train,1622,8,8192,44,44,8236
train,1623,7,7168,37,37,7205
train,1624,29,29696,197,197,29893
train,1625,38,38912,264,264,39176
train,1626,12,12288,74,74,12362
train,1627,16,16384,108,108,16492
train,1628,27,27648,179,179,27827
train,1629,11,11264,65,65,11329
train,1630,14,14336,92,92,14428
train,1631,30,30720,226,226,30946
train,1632,20,20480,130,130,20610
train,1633,19,19456,127,127,19583
train,1634,3,3072,9,9,3081
train,1635,25,25600,173,173,25773
train,1636,34,34816,232,232,35048
train,1637,10,10240,58,58,10298
train,1638,9,9216,51,51,9267
train,1639,12,12288,72,72,12360
train,1640,45,46080,341,341,46421
train,1641,14,14336,92,92,14428
train,1642,25,25600,163,163,25763
train,1643,18,18432,114,114,18546
train,1644,30,30720,204,204,30924
train,1645,9,9216,51,51,9267
train,1646,32,32768,220,220,32988
train,1647,12,12288,72,72,12360
train,1648,4,4096,16,16,4112
train,1649,17,17408,113,113,17521
train,1650,8,8192,44,44,8236
train,1651,21,21504,141,141,21645
train,1652,30,30720,204,204,30924
train,1653,51,52224,351,351,52575
train,1654,31,31744,223,223,31967
train,1655,14,14336,96,96,14432
train,1656,13,13312,79,79,13391
train,1657,18,18432,114,114,18546
train,1658,18,18432,112,112,18544
train,1659,21,21504,147,147,21651
train,1660,10,10240,58,58,10298
train,1661,20,20480,128,128,20608
train,1662,11,11264,65,65,11329
train,1663,14,14336,92,92,14428
train,1664,19,19456,121,121,19577
train,1665,13,13312,79,79,13391
train,1666,13,13312,79,79,13391
train,1667,10,10240,58,58,10298
train,1668,16,16384,110,110,16494
train,1669,9,9216,51,51,9267
train,1670,17,17408,107,107,17515
train,1671,9,9216,51,51,9267
train,1672,11,11264,65,65,11329
train,1673,15,15360,93,93,15453
train,1674,24,24576,174,174,24750
train,1675,27,27648,219,219,27867
train,1676,40,40960,302,302,41262
train,1677,29,29696,213,213,29909
train,1678,18,18432,114,114,18546
train,1679,21,21504,135,135,21639
train,1680,23,23552,149,149,23701
train,1681,35,35840,235,235,36075
train,1682,14,14336,86,86,14422
train,1683,31,31744,215,215,31959
train,1684,18,18432,114,114,18546
train,1685,40,40960,268,268,41228
train,1686,3,3072,9,9,3081
train,1687,10,10240,58,58,10298
train,1688,18,18432,118,118,18550
train,1689,29,29696,197,197,29893
train,1690,35,35840,245,245,36085
train,1691,36,36864,260,260,37124
train,1692,15,15360,93,93,15453
train,1693,16,16384,116,116,16500
train,1694,27,27648,189,189,27837
train,1695,34,34816,226,226,35042
train,1696,14,14336,86,86,14422
train,1697,19,19456,121,121,19577
train,1698,10,10240,58,58,10298
train,1699,27,27648,183,183,27831
train,1700,6,6144,30,30,6174
train,1701,23,23552,149,149,23701
train,1702,25,25600,161,161,25761
train,1703,23,23552,149,149,23701
train,1704,37,37888,277,277,38165
train,1705,39,39936,305,305,40241
train,1706,26,26624,188,188,26812
train,1707,22,22528,142,142,22670
train,1708,10,10240,58,58,10298
train,1709,21,21504,147,147,21651
train,1710,5,5120,23,23,5143
train,1711,7,7168,37,37,7205
train,1712,12,12288,72,72,12360
train,1713,20,20480,126,126,20606
train,1714,14,14336,86,86,14422
train,1715,7,7168,37,37,7205
train,1716,15,15360,93,93,15453
train,1717,40,40960,274,274,41234
train,1718,4,4096,16,16,4112
train,1719,35,35840,279,279,36119
train,1720,23,23552,155,155,23707
train,1721,11,11264,65,65,11329
train,1722,40,40960,270,270,41230
train,1723,22,22528,148,148,22676
train,1724,15,15360,93,93,15453
train,1725,9,9216,53,53,9269
train,1726,13,13312,79,79,13391
train,1727,35,35840,265,265,36105
train,1728,18,18432,114,114,18546
train,1729,18,18432,124,124,18556
train,1730,6,6144,30,30,6174
train,1731,19,19456,121,121,19577
train,1732,23,23552,155,155,23707
train,1733,13,13312,77,77,13389
train,1734,15,15360,99,99,15459
train,1735,27,27648,179,179,27827
train,1736,5,5120,23,23,5143
train,1737,28,28672,184,184,28856
train,1738,31,31744,205,205,31949
train,1739,32,32768,222,222,32990
train,1740,31,31744,221,221,31965
train,1741,39,39936,271,271,40207
train,1742,4,4096,16,16,4112
train,1743,33,33792,225,225,34017
train,1744,11,11264,65,65,11329
train,1745,33,33792,225,225,34017
train,1746,15,15360,93,93,15453
train,1747,6,6144,30,30,6174
train,1748,12,12288,72,72,12360
train,1749,36,36864,246,246,37110
train,1750,31,31744,215,215,31959
train,1751,27,27648,177,177,27825
train,1752,19,19456,123,123,19579
train,1753,44,45056,318,318,45374
train,1754,22,22528,146,146,22674
train,1755,16,16384,106,106,16490
train,1756,30,30720,214,214,30934
train,1757,17,17408,107,107,17515
train,1758,17,17408,107,107,17515
train,1759,11,11264,65,65,11329
train,1760,27,27648,183,183,27831
train,1761,21,21504,135,135,21639
train,1762,14,14336,88,88,14424
train,1763,31,31744,211,211,31955
train,1764,29,29696,207,207,29903
train,1765,16,16384,100,100,16484
train,1766,38,38912,268,268,39180
train,1767,11,11264,65,65,11329
train,1768,11,11264,69,69,11333
train,1769,22,22528,152,152,22680
train,1770,13,13312,79,79,13391
train,1771,28,28672,190,190,28862
train,1772,38,38912,260,260,39172
train,1773,13,13312,77,77,13389
train,1774,14,14336,84,84,14420
train,1775,15,15360,93,93,15453
train,1776,18,18432,122,122,18554
train,1777,3,3072,9,9,3081
train,1778,20,20480,128,128,20608
train,1779,25,25600,163,163,25763
train,1780,21,21504,135,135,21639
train,1781,33,33792,231,231,34023
train,1782,19,19456,125,125,19581
train,1783,21,21504,135,135,21639
train,1784,3,3072,9,9,3081
train,1785,21,21504,141,141,21645
train,1786,21,21504,135,135,21639
train,1787,13,13312,79,79,13391
train,1788,32,32768,242,242,33010
train,1789,18,18432,114,114,18546
train,1790,20,20480,128,128,20608
train,1791,5,5120,23,23,5143
train,1792,17,17408,107,107,17515
train,1793,15,15360,93,93,15453
train,1794,23,23552,149,149,23701
train,1795,21,21504,141,141,21645
train,1796,11,11264,65,65,11329
train,1797,24,24576,156,156,24732
train,1798,19,19456,127,127,19583
train,1799,27,27648,183,183,27831
train,1800,29,29696,195,195,29891
train,1801,41,41984,281,281,42265
train,1802,16,16384,100,100,16484
train,1803,13,13312,75,75,13387
train,1804,13,13312,81,81,13393
train,1805,27,27648,201,201,27849
train,1806,10,10240,58,58,10298
train,1807,25,25600,181,181,25781
train,1808,9,9216,51,51,9267
train,1809,11,11264,63,63,11327
train,1810,16,16384,98,98,16482
train,1811,16,16384,100,100,16484
train,1812,20,20480,128,128,20608
train,1813,9,9216,51,51,9267
train,1814,35,35840,233,233,36073
train,1815,24,24576,162,162,24738
train,1816,13,13312,79,79,13391
train,1817,21,21504,139,139,21643
train,1818,28,28672,190,190,28862
train,1819,9,9216,51,51,9267
train,1820,18,18432,114,114,18546
train,1821,8,8192,44,44,8236
train,1822,17,17408,117,117,17525
train,1823,34,34816,254,254,35070
train,1824,17,17408,113,113,17521
train,1825,32,32768,230,230,32998
train,1826,11,11264,65,65,11329
train,1827,24,24576,162,162,24738
train,1828,15,15360,93,93,15453
train,1829,21,21504,135,135,21639
train,1830,10,10240,58,58,10298
train,1831,19,19456,119,119,19575
train,1832,30,30720,210,210,30930
train,1833,14,14336,86,86,14422
train,1834,13,13312,79,79,13391
train,1835,7,7168,37,37,7205
train,1836,20,20480,134,134,20614
train,1837,18,18432,120,120,18552
train,1838,22,22528,140,140,22668
train,1839,20,20480,128,128,20608
train,1840,15,15360,93,93,15453
train,1841,13,13312,79,79,13391
train,1842,32,32768,234,234,33002
train,1843,18,18432,132,132,18564
train,1844,30,30720,226,226,30946
train,1845,16,16384,106,106,16490
train,1846,9,9216,51,51,9267
train,1847,39,39936,289,289,40225
train,1848,29,29696,191,191,29887
train,1849,32,32768,222,222,32990
train,1850,21,21504,135,135,21639
train,1851,20,20480,128,128,20608
train,1852,39,39936,321,321,40257
train,1853,35,35840,245,245,36085
train,1854,26,26624,170,170,26794
train,1855,5,5120,23,23,5143
train,1856,25,25600,173,173,25773
train,1857,16,16384,106,106,16490
train,1858,28,28672,202,202,28874
train,1859,17,17408,113,113,17521
train,1860,19,19456,123,123,19579
train,1861,8,8192,42,42,8234
train,1862,50,51200,384,384,51584
train,1863,10,10240,58,58,10298
train,1864,14,14336,86,86,14422
train,1865,17,17408,103,103,17511
train,1866,21,21504,135,135,21639
train,1867,28,28672,190,190,28862
train,1868,16,16384,106,106,16490
train,1869,41,41984,287,287,42271
train,1870,32,32768,230,230,32998
train,1871,20,20480,128,128,20608
train,1872,4,4096,16,16,4112
train,1873,20,20480,128,128,20608
train,1874,28,28672,188,188,28860
train,1875,22,22528,148,148,22676
train,1876,10,10240,58,58,10298
train,1877,15,15360,89,89,15449
train,1878,7,7168,37,37,7205
train,1879,15,15360,93,93,15453
train,1880,16,16384,100,100,16484
train,1881,17,17408,107,107,17515
train,1882,7,7168,37,37,7205
train,1883,36,36864,268,268,37132
train,1884,27,27648,189,189,27837
train,1885,29,29696,203,203,29899
train,1886,27,27648,193,193,27841
train,1887,11,11264,65,65,11329
train,1888,6,6144,30,30,6174
train,1889,13,13312,79,79,13391
train,1890,22,22528,140,140,22668
train,1891,12,12288,72,72,12360
train,1892,9,9216,51,51,9267
train,1893,14,14336,86,86,14422
train,1894,9,9216,51,51,9267
train,1895,24,24576,164,164,24740
train,1896,13,13312,79,79,13391
train,1897,13,13312,87,87,13399
train,1898,28,28672,190,190,28862
train,1899,44,45056,336,336,45392
train,1900,9,9216,51,51,9267
train,1901,24,24576,168,168,24744
train,1902,33,33792,237,237,34029
train,1903,16,16384,102,102,16486
train,1904,7,7168,37,37,7205
train,1905,18,18432,114,114,18546
train,1906,23,23552,153,153,23705
train,1907,23,23552,147,147,23699
train,1908,11,11264,65,65,11329
train,1909,12,12288,78,78,12366
train,1910,11,11264,65,65,11329
train,1911,29,29696,189,189,29885
train,1912,5,5120,23,23,5143
train,1913,26,26624,170,170,26794
train,1914,23,23552,155,155,23707
train,1915,6,6144,30,30,6174
train,1916,11,11264,65,65,11329
train,1917,24,24576,164,164,24740
train,1918,6,6144,30,30,6174
train,1919,15,15360,93,93,15453
train,1920,9,9216,51,51,9267
train,1921,36,36864,240,240,37104
train,1922,22,22528,142,142,22670
train,1923,11,11264,65,65,11329
train,1924,6,6144,30,30,6174
train,1925,18,18432,114,114,18546
train,1926,17,17408,105,105,17513
train,1927,17,17408,119,119,17527
train,1928,34,34816,252,252,35068
train,1929,29,29696,207,207,29903
train,1930,13,13312,79,79,13391
train,1931,29,29696,203,203,29899
train,1932,40,40960,286,286,41246
train,1933,6,6144,30,30,6174
train,1934,6,6144,30,30,6174
train,1935,14,14336,86,86,14422
train,1936,17,17408,111,111,17519
train,1937,36,36864,246,246,37110
train,1938,5,5120,23,23,5143
train,1939,30,30720,192,192,30912
train,1940,19,19456,121,121,19577
train,1941,4,4096,16,16,4112
train,1942,10,10240,62,62,10302
train,1943,21,21504,141,141,21645
train,1944,18,18432,124,124,18556
train,1945,34,34816,226,226,35042
train,1946,14,14336,86,86,14422
train,1947,5,5120,23,23,5143
train,1948,21,21504,149,149,21653
train,1949,23,23552,157,157,23709
train,1950,10,10240,58,58,10298
train,1951,6,6144,30,30,6174
train,1952,36,36864,244,244,37108
train,1953,35,35840,253,253,36093
train,1954,13,13312,89,89,13401
train,1955,26,26624,176,176,26800
train,1956,17,17408,107,107,17515
train,1957,15,15360,93,93,15453
train,1958,15,15360,97,97,15457
train,1959,21,21504,135,135,21639
train,1960,29,29696,197,197,29893
train,1961,5,5120,23,23,5143
train,1962,14,14336,86,86,14422
train,1963,39,39936,297,297,40233
train,1964,31,31744,205,205,31949
train,1965,25,25600,173,173,25773
train,1966,29,29696,201,201,29897
train,1967,15,15360,93,93,15453
train,1968,14,14336,86,86,14422
train,1969,33,33792,231,231,34023
train,1970,19,19456,121,121,19577
train,1971,7,7168,37,37,7205
train,1972,19,19456,127,127,19583
train,1973,12,12288,72,72,12360
train,1974,31,31744,237,237,31981
train,1975,22,22528,142,142,22670
train,1976,36,36864,276,276,37140
train,1977,8,8192,44,44,8236
train,1978,7,7168,37,37,7205
train,1979,11,11264,65,65,11329
train,1980,28,28672,184,184,28856
train,1981,37,37888,261,261,38149
train,1982,7,7168,37,37,7205
train,1983,36,36864,258,258,37122
train,1984,22,22528,148,148,22676
train,1985,23,23552,161,161,23713
train,1986,15,15360,93,93,15453
train,1987,15,15360,93,93,15453
train,1988,20,20480,126,126,20606
train,1989,21,21504,141,141,21645
train,1990,7,7168,37,37,7205
train,1991,20,20480,128,128,20608
train,1992,9,9216,51,51,9267
train,1993,8,8192,44,44,8236
train,1994,7,7168,37,37,7205
train,1995,34,34816,242,242,35058
train,1996,9,9216,51,51,9267
train,1997,14,14336,86,86,14422
train,1998,28,28672,188,188,28860
train,1999,19,19456,135,135,19591
train,2000,20,20480,138,138,20618
train,2001,15,15360,93,93,15453
train,2002,16,16384,106,106,16490
train,2003,28,28672,200,200,28872
train,2004,40,40960,292,292,41252
train,2005,22,22528,148,148,22676
train,2006,36,36864,264,264,37128
train,2007,35,35840,245,245,36085
train,2008,34,34816,242,242,35058
train,2009,21,21504,141,141,21645
train,2010,27,27648,177,177,27825
train,2011,24,24576,156,156,24732
train,2012,26,26624,170,170,26794
train,2013,31,31744,209,209,31953
train,2014,7,7168,37,37,7205
train,2015,23,23552,169,169,23721
train,2016,30,30720,202,202,30922
train,2017,15,15360,115,115,15475
train,2018,25,25600,169,169,25769
train,2019,38,38912,260,260,39172
train,2020,18,18432,116,116,18548
train,2021,11,11264,65,65,11329
train,2022,26,26624,188,188,26812
train,2023,6,6144,30,30,6174
train,2024,21,21504,155,155,21659
train,2025,20,20480,124,124,20604
train,2026,35,35840,253,253,36093
train,2027,7,7168,37,37,7205
train,2028,15,15360,93,93,15453
train,2029,20,20480,128,128,20608
train,2030,8,8192,44,44,8236
train,2031,48,49152,334,334,49486
train,2032,15,15360,93,93,15453
train,2033,27,27648,191,191,27839
train,2034,16,16384,100,100,16484
train,2035,10,10240,58,58,10298
train,2036,32,32768,230,230,32998
train,2037,6,6144,30,30,6174
train,2038,25,25600,163,163,25763
train,2039,33,33792,219,219,34011
train,2040,16,16384,100,100,16484
train,2041,50,51200,354,354,51554
train,2042,5,5120,23,23,5143
train,2043,15,15360,93,93,15453
train,2044,32,32768,224,224,32992
train,2045,14,14336,86,86,14422
train,2046,18,18432,118,118,18550
train,2047,13,13312,89,89,13401
train,2048,30,30720,210,210,30930
train,2049,17,17408,107,107,17515
train,2050,16,16384,100,100,16484
train,2051,26,26624,186,186,26810
train,2052,50,51200,370,370,51570
train,2053,18,18432,114,114,18546
train,2054,14,14336,86,86,14422
train,2055,18,18432,116,116,18548
train,2056,5,5120,23,23,5143
train,2057,17,17408,107,107,17515
train,2058,32,32768,242,242,33010
train,2059,15,15360,93,93,15453
train,2060,11,11264,65,65,11329
train,2061,14,14336,84,84,14420
train,2062,18,18432,114,114,18546
train,2063,22,22528,144,144,22672
train,2064,21,21504,143,143,21647
train,2065,25,25600,169,169,25769
train,2066,37,37888,259,259,38147
train,2067,19,19456,121,121,19577
train,2068,26,26624,174,174,26798
train,2069,21,21504,133,133,21637
train,2070,17,17408,107,107,17515
train,2071,19,19456,129,129,19585
train,2072,15,15360,91,91,15451
train,2073,25,25600,163,163,25763
train,2074,8,8192,44,44,8236
train,2075,26,26624,170,170,26794
train,2076,22,22528,154,154,22682
train,2077,21,21504,131,131,21635
train,2078,8,8192,44,44,8236
train,2079,15,15360,93,93,15453
train,2080,32,32768,224,224,32992
train,2081,10,10240,58,58,10298
train,2082,22,22528,148,148,22676
train,2083,27,27648,177,177,27825
train,2084,34,34816,244,244,35060
train,2085,16,16384,100,100,16484
train,2086,9,9216,51,51,9267
train,2087,20,20480,126,126,20606
train,2088,10,10240,58,58,10298
train,2089,24,24576,162,162,24738
train,2090,11,11264,65,65,11329
train,2091,16,16384,108,108,16492
train,2092,18,18432,114,114,18546
train,2093,9,9216,51,51,9267
train,2094,25,25600,169,169,25769
train,2095,4,4096,16,16,4112
train,2096,14,14336,86,86,14422
train,2097,5,5120,23,23,5143
train,2098,23,23552,149,149,23701
train,2099,34,34816,246,246,35062
train,2100,30,30720,218,218,30938
train,2101,36,36864,252,252,37116
train,2102,20,20480,130,130,20610
train,2103,11,11264,65,65,11329
train,2104,7,7168,37,37,7205
train,2105,22,22528,142,142,22670
train,2106,19,19456,127,127,19583
train,2107,49,50176,389,389,50565
train,2108,20,20480,132,132,20612
train,2109,5,5120,23,23,5143
train,2110,13,13312,79,79,13391
train,2111,19,19456,123,123,19579
train,2112,38,38912,276,276,39188
train,2113,8,8192,44,44,8236
train,2114,43,44032,311,311,44343
train,2115,8,8192,44,44,8236
train,2116,26,26624,170,170,26794
train,2117,30,30720,214,214,30934
train,2118,26,26624,176,176,26800
train,2119,7,7168,37,37,7205
train,2120,24,24576,162,162,24738
train,2121,8,8192,44,44,8236
train,2122,21,21504,145,145,21649
train,2123,17,17408,113,113,17521
train,2124,19,19456,121,121,19577
train,2125,22,22528,142,142,22670
train,2126,29,29696,193,193,29889
train,2127,34,34816,242,242,35058
train,2128,9,9216,51,51,9267
train,2129,11,11264,65,65,11329
train,2130,17,17408,107,107,17515
train,2131,4,4096,16,16,4112
train,2132,20,20480,132,132,20612
train,2133,4,4096,16,16,4112
train,2134,25,25600,163,163,25763
train,2135,26,26624,182,182,26806
train,2136,28,28672,190,190,28862
train,2137,6,6144,30,30,6174
train,2138,20,20480,130,130,20610
train,2139,21,21504,133,133,21637
train,2140,12,12288,72,72,12360
train,2141,30,30720,204,204,30924
train,2142,9,9216,51,51,9267
train,2143,24,24576,162,162,24738
train,2144,15,15360,99,99,15459
train,2145,29,29696,205,205,29901
train,2146,12,12288,72,72,12360
train,2147,28,28672,198,198,28870
train,2148,17,17408,117,117,17525
train,2149,20,20480,128,128,20608
train,2150,19,19456,149,149,19605
train,2151,38,38912,276,276,39188
train,2152,27,27648,183,183,27831
train,2153,13,13312,79,79,13391
train,2154,19,19456,141,141,19597
train,2155,12,12288,72,72,12360
train,2156,3,3072,9,9,3081
train,2157,9,9216,51,51,9267
train,2158,12,12288,76,76,12364
train,2159,33,33792,225,225,34017
train,2160,11,11264,65,65,11329
train,2161,13,13312,79,79,13391
train,2162,6,6144,30,30,6174
train,2163,23,23552,159,159,23711
train,2164,37,37888,273,273,38161
train,2165,7,7168,37,37,7205
train,2166,13,13312,83,83,13395
train,2167,12,12288,72,72,12360
train,2168,20,20480,146,146,20626
train,2169,12,12288,78,78,12366
train,2170,22,22528,154,154,22682
train,2171,21,21504,137,137,21641
train,2172,21,21504,147,147,21651
train,2173,30,30720,212,212,30932
train,2174,19,19456,121,121,19577
train,2175,27,27648,189,189,27837
train,2176,26,26624,182,182,26806
train,2177,11,11264,65,65,11329
train,2178,32,32768,218,218,32986
train,2179,12,12288,72,72,12360
train,2180,25,25600,167,167,25767
train,2181,21,21504,141,141,21645
train,2182,9,9216,51,51,9267
train,2183,25,25600,171,171,25771
train,2184,14,14336,94,94,14430
train,2185,3,3072,9,9,3081
train,2186,23,23552,149,149,23701
train,2187,16,16384,98,98,16482
train,2188,18,18432,114,114,18546
train,2189,25,25600,161,161,25761
train,2190,24,24576,162,162,24738
train,2191,38,38912,276,276,39188
train,2192,28,28672,196,196,28868
train,2193,9,9216,51,51,9267
train,2194,27,27648,177,177,27825
train,2195,4,4096,16,16,4112
train,2196,26,26624,180,180,26804
train,2197,17,17408,107,107,17515
train,2198,17,17408,107,107,17515
train,2199,27,27648,177,177,27825
train,2200,15,15360,93,93,15453
train,2201,16,16384,100,100,16484
train,2202,19,19456,127,127,19583
train,2203,7,7168,37,37,7205
train,2204,12,12288,72,72,12360
train,2205,26,26624,172,172,26796
train,2206,23,23552,149,149,23701
train,2207,6,6144,30,30,6174
train,2208,30,30720,228,228,30948
train,2209,28,28672,190,190,28862
train,2210,17,17408,107,107,17515
train,2211,31,31744,227,227,31971
train,2212,36,36864,252,252,37116
train,2213,13,13312,79,79,13391
train,2214,22,22528,152,152,22680
train,2215,30,30720,208,208,30928
train,2216,35,35840,243,243,36083
train,2217,42,43008,328,328,43336
train,2218,26,26624,176,176,26800
train,2219,9,9216,51,51,9267
train,2220,9,9216,51,51,9267
train,2221,9,9216,51,51,9267
train,2222,15,15360,93,93,15453
train,2223,17,17408,107,107,17515
train,2224,30,30720,204,204,30924
train,2225,10,10240,58,58,10298
train,2226,17,17408,113,113,17521
train,2227,21,21504,147,147,21651
train,2228,22,22528,142,142,22670
train,2229,19,19456,127,127,19583
train,2230,34,34816,246,246,35062
train,2231,12,12288,72,72,12360
train,2232,22,22528,148,148,22676
train,2233,29,29696,197,197,29893
train,2234,31,31744,215,215,31959
train,2235,18,18432,120,120,18552
train,2236,27,27648,195,195,27843
train,2237,11,11264,65,65,11329
train,2238,15,15360,95,95,15455
train,2239,6,6144,30,30,6174
train,2240,24,24576,170,170,24746
train,2241,26,26624,186,186,26810
train,2242,23,23552,169,169,23721
train,2243,19,19456,121,121,19577
train,2244,10,10240,58,58,10298
train,2245,9,9216,51,51,9267
train,2246,32,32768,228,228,32996
train,2247,39,39936,283,283,40219
train,2248,30,30720,216,216,30936
train,2249,8,8192,44,44,8236
train,2250,26,26624,188,188,26812
train,2251,17,17408,107,107,17515
train,2252,29,29696,203,203,29899
train,2253,44,45056,330,330,45386
train,2254,3,3072,9,9,3081
train,2255,24,24576,158,158,24734
train,2256,16,16384,100,100,16484
train,2257,11,11264,65,65,11329
train,2258,26,26624,170,170,26794
train,2259,12,12288,70,70,12358
train,2260,38,38912,282,282,39194
train,2261,7,7168,37,37,7205
train,2262,14,14336,92,92,14428
train,2263,28,28672,184,184,28856
train,2264,23,23552,155,155,23707
train,2265,19,19456,127,127,19583
train,2266,21,21504,135,135,21639
train,2267,32,32768,218,218,32986
train,2268,24,24576,162,162,24738
train,2269,29,29696,199,199,29895
train,2270,17,17408,107,107,17515
train,2271,27,27648,177,177,27825
train,2272,33,33792,229,229,34021
train,2273,27,27648,189,189,27837
train,2274,24,24576,158,158,24734
train,2275,20,20480,138,138,20618
train,2276,17,17408,107,107,17515
train,2277,37,37888,263,263,38151
train,2278,10,10240,58,58,10298
train,2279,28,28672,186,186,28858
train,2280,29,29696,191,191,29887
train,2281,13,13312,79,79,13391
train,2282,24,24576,160,160,24736
train,2283,7,7168,37,37,7205
train,2284,23,23552,155,155,23707
train,2285,28,28672,196,196,28868
train,2286,18,18432,114,114,18546
train,2287,36,36864,258,258,37122
train,2288,23,23552,149,149,23701
train,2289,12,12288,78,78,12366
train,2290,31,31744,201,201,31945
train,2291,10,10240,58,58,10298
train,2292,15,15360,103,103,15463
train,2293,16,16384,106,106,16490
train,2294,7,7168,37,37,7205
train,2295,26,26624,186,186,26810
train,2296,29,29696,207,207,29903
train,2297,24,24576,162,162,24738
train,2298,18,18432,114,114,18546
train,2299,26,26624,180,180,26804
train,2300,22,22528,142,142,22670
train,2301,11,11264,65,65,11329
train,2302,35,35840,245,245,36085
train,2303,10,10240,58,58,10298
train,2304,30,30720,210,210,30930
train,2305,30,30720,198,198,30918
train,2306,28,28672,188,188,28860
train,2307,10,10240,58,58,10298
train,2308,36,36864,266,266,37130
train,2309,14,14336,86,86,14422
train,2310,20,20480,140,140,20620
train,2311,23,23552,155,155,23707
train,2312,8,8192,42,42,8234
train,2313,30,30720,204,204,30924
train,2314,13,13312,79,79,13391
train,2315,20,20480,134,134,20614
train,2316,28,28672,184,184,28856
train,2317,21,21504,135,135,21639
train,2318,27,27648,189,189,27837
train,2319,17,17408,111,111,17519
train,2320,17,17408,107,107,17515
train,2321,15,15360,95,95,15455
train,2322,13,13312,85,85,13397
train,2323,31,31744,211,211,31955
train,2324,37,37888,275,275,38163
train,2325,6,6144,30,30,6174
train,2326,23,23552,163,163,23715
train,2327,32,32768,238,238,33006
train,2328,21,21504,147,147,21651
train,2329,21,21504,139,139,21643
train,2330,19,19456,129,129,19585
train,2331,15,15360,93,93,15453
train,2332,38,38912,262,262,39174
train,2333,11,11264,65,65,11329
train,2334,17,17408,107,107,17515
train,2335,29,29696,191,191,29887
train,2336,17,17408,113,113,17521
train,2337,21,21504,135,135,21639
train,2338,16,16384,106,106,16490
train,2339,26,26624,170,170,26794
train,2340,40,40960,274,274,41234
train,2341,15,15360,93,93,15453
train,2342,16,16384,100,100,16484
train,2343,20,20480,134,134,20614
train,2344,25,25600,163,163,25763
train,2345,22,22528,142,142,22670
train,2346,29,29696,195,195,29891
train,2347,14,14336,86,86,14422
train,2348,23,23552,149,149,23701
train,2349,29,29696,203,203,29899
train,2350,43,44032,315,315,44347
train,2351,13,13312,77,77,13389
train,2352,7,7168,37,37,7205
train,2353,16,16384,106,106,16490
train,2354,17,17408,113,113,17521
train,2355,32,32768,220,220,32988
train,2356,33,33792,237,237,34029
train,2357,18,18432,114,114,18546
train,2358,25,25600,167,167,25767
train,2359,12,12288,72,72,12360
train,2360,38,38912,270,270,39182
train,2361,35,35840,231,231,36071
train,2362,8,8192,44,44,8236
train,2363,13,13312,83,83,13395
train,2364,38,38912,260,260,39172
train,2365,35,35840,251,251,36091
train,2366,19,19456,121,121,19577
train,2367,11,11264,65,65,11329
train,2368,20,20480,134,134,20614
train,2369,11,11264,65,65,11329
train,2370,32,32768,224,224,32992
train,2371,25,25600,171,171,25771
train,2372,16,16384,102,102,16486
train,2373,16,16384,106,106,16490
train,2374,13,13312,79,79,13391
train,2375,22,22528,142,142,22670
train,2376,5,5120,23,23,5143
train,2377,6,6144,30,30,6174
train,2378,27,27648,185,185,27833
train,2379,13,13312,79,79,13391
train,2380,12,12288,72,72,12360
train,2381,32,32768,218,218,32986
train,2382,23,23552,155,155,23707
train,2383,12,12288,72,72,12360
train,2384,22,22528,142,142,22670
train,2385,30,30720,216,216,30936
train,2386,26,26624,170,170,26794
train,2387,17,17408,103,103,17511
train,2388,26,26624,186,186,26810
train,2389,29,29696,207,207,29903
train,2390,19,19456,123,123,19579
train,2391,29,29696,195,195,29891
train,2392,12,12288,72,72,12360
train,2393,23,23552,153,153,23705
train,2394,26,26624,188,188,26812
train,2395,24,24576,156,156,24732
train,2396,13,13312,81,81,13393
train,2397,13,13312,79,79,13391
train,2398,9,9216,51,51,9267
train,2399,27,27648,193,193,27841
train,2400,29,29696,213,213,29909
train,2401,22,22528,154,154,22682
train,2402,22,22528,148,148,22676
train,2403,30,30720,198,198,30918
train,2404,20,20480,128,128,20608
train,2405,18,18432,114,114,18546
train,2406,18,18432,120,120,18552
train,2407,22,22528,156,156,22684
train,2408,14,14336,86,86,14422
train,2409,6,6144,30,30,6174
train,2410,10,10240,58,58,10298
train,2411,9,9216,51,51,9267
train,2412,15,15360,91,91,15451
train,2413,10,10240,58,58,10298
train,2414,25,25600,165,165,25765
train,2415,18,18432,114,114,18546
train,2416,30,30720,200,200,30920
train,2417,18,18432,114,114,18546
train,2418,13,13312,83,83,13395
train,2419,18,18432,114,114,18546
train,2420,5,5120,23,23,5143
train,2421,19,19456,133,133,19589
train,2422,6,6144,30,30,6174
train,2423,19,19456,127,127,19583
train,2424,29,29696,199,199,29895
train,2425,12,12288,70,70,12358
train,2426,18,18432,118,118,18550
train,2427,19,19456,131,131,19587
train,2428,22,22528,154,154,22682
train,2429,17,17408,111,111,17519
train,2430,26,26624,170,170,26794
train,2431,28,28672,212,212,28884
train,2432,16,16384,100,100,16484
train,2433,7,7168,37,37,7205
train,2434,22,22528,142,142,22670
train,2435,29,29696,191,191,29887
train,2436,12,12288,72,72,12360
train,2437,17,17408,111,111,17519
train,2438,26,26624,176,176,26800
train,2439,34,34816,236,236,35052
train,2440,30,30720,204,204,30924
train,2441,25,25600,183,183,25783
train,2442,23,23552,155,155,23707
train,2443,28,28672,188,188,28860
train,2444,30,30720,202,202,30922
train,2445,14,14336,86,86,14422
train,2446,9,9216,51,51,9267
train,2447,28,28672,190,190,28862
train,2448,7,7168,35,35,7203
train,2449,28,28672,196,196,28868
train,2450,21,21504,135,135,21639
train,2451,17,17408,117,117,17525
train,2452,19,19456,121,121,19577
train,2453,31,31744,217,217,31961
train,2454,8,8192,44,44,8236
train,2455,18,18432,120,120,18552
train,2456,36,36864,264,264,37128
train,2457,8,8192,44,44,8236
train,2458,30,30720,208,208,30928
train,2459,19,19456,127,127,19583
train,2460,10,10240,58,58,10298
train,2461,51,52224,361,361,52585
train,2462,7,7168,37,37,7205
train,2463,38,38912,264,264,39176
train,2464,26,26624,176,176,26800
train,2465,20,20480,134,134,20614
train,2466,17,17408,113,113,17521
train,2467,22,22528,148,148,22676
train,2468,23,23552,149,149,23701
train,2469,17,17408,119,119,17527
train,2470,8,8192,44,44,8236
train,2471,14,14336,86,86,14422
train,2472,16,16384,100,100,16484
train,2473,23,23552,149,149,23701
train,2474,19,19456,125,125,19581
train,2475,20,20480,128,128,20608
train,2476,17,17408,107,107,17515
train,2477,29,29696,201,201,29897
train,2478,31,31744,219,219,31963
train,2479,27,27648,183,183,27831
train,2480,42,43008,310,310,43318
train,2481,11,11264,65,65,11329
train,2482,30,30720,210,210,30930
train,2483,40,40960,284,284,41244
train,2484,33,33792,231,231,34023
train,2485,28,28672,184,184,28856
train,2486,23,23552,149,149,23701
train,2487,31,31744,213,213,31957
train,2488,33,33792,235,235,34027
train,2489,30,30720,200,200,30920
train,2490,13,13312,79,79,13391
train,2491,25,25600,169,169,25769
train,2492,43,44032,321,321,44353
train,2493,32,32768,216,216,32984
train,2494,29,29696,203,203,29899
train,2495,38,38912,260,260,39172
train,2496,30,30720,204,204,30924
train,2497,40,40960,300,300,41260
train,2498,13,13312,79,79,13391
train,2499,44,45056,320,320,45376
train,2500,28,28672,186,186,28858
train,2501,14,14336,86,86,14422
train,2502,31,31744,217,217,31961
train,2503,35,35840,243,243,36083
train,2504,25,25600,169,169,25769
train,2505,20,20480,134,134,20614
train,2506,14,14336,86,86,14422
train,2507,31,31744,217,217,31961
train,2508,37,37888,253,253,38141
train,2509,13,13312,79,79,13391
train,2510,24,24576,156,156,24732
train,2511,10,10240,58,58,10298
train,2512,6,6144,30,30,6174
train,2513,26,26624,182,182,26806
train,2514,20,20480,138,138,20618
train,2515,14,14336,86,86,14422
train,2516,23,23552,149,149,23701
train,2517,14,14336,86,86,14422
train,2518,28,28672,184,184,28856
train,2519,25,25600,177,177,25777
train,2520,10,10240,56,56,10296
train,2521,21,21504,135,135,21639
train,2522,20,20480,138,138,20618
train,2523,41,41984,281,281,42265
train,2524,3,3072,9,9,3081
train,2525,12,12288,72,72,12360
train,2526,24,24576,162,162,24738
train,2527,36,36864,258,258,37122
train,2528,35,35840,243,243,36083
train,2529,12,12288,72,72,12360
train,2530,12,12288,72,72,12360
train,2531,22,22528,152,152,22680
train,2532,23,23552,151,151,23703
train,2533,20,20480,128,128,20608
train,2534,17,17408,107,107,17515
train,2535,21,21504,135,135,21639
train,2536,9,9216,51,51,9267
train,2537,30,30720,198,198,30918
train,2538,27,27648,183,183,27831
train,2539,32,32768,224,224,32992
train,2540,10,10240,58,58,10298
train,2541,37,37888,259,259,38147
train,2542,10,10240,58,58,10298
train,2543,16,16384,98,98,16482
train,2544,26,26624,178,178,26802
train,2545,17,17408,107,107,17515
train,2546,4,4096,16,16,4112
train,2547,16,16384,100,100,16484
train,2548,6,6144,30,30,6174
train,2549,13,13312,79,79,13391
train,2550,37,37888,267,267,38155
train,2551,30,30720,196,196,30916
train,2552,30,30720,202,202,30922
train,2553,26,26624,176,176,26800
train,2554,28,28672,184,184,28856
train,2555,25,25600,177,177,25777
train,2556,25,25600,177,177,25777
train,2557,50,51200,368,368,51568
train,2558,8,8192,44,44,8236
train,2559,12,12288,72,72,12360
train,2560,6,6144,30,30,6174
train,2561,7,7168,37,37,7205
train,2562,41,41984,279,279,42263
train,2563,27,27648,183,183,27831
train,2564,27,27648,193,193,27841
train,2565,21,21504,135,135,21639
train,2566,21,21504,139,139,21643
train,2567,12,12288,72,72,12360
train,2568,21,21504,141,141,21645
train,2569,10,10240,58,58,10298
train,2570,14,14336,86,86,14422
train,2571,10,10240,58,58,10298
train,2572,29,29696,205,205,29901
train,2573,22,22528,146,146,22674
train,2574,30,30720,220,220,30940
train,2575,21,21504,141,141,21645
train,2576,21,21504,135,135,21639
train,2577,44,45056,318,318,45374
train,2578,22,22528,148,148,22676
train,2579,34,34816,254,254,35070
train,2580,33,33792,239,239,34031
train,2581,23,23552,151,151,23703
train,2582,17,17408,113,113,17521
train,2583,17,17408,113,113,17521
train,2584,21,21504,135,135,21639
train,2585,19,19456,121,121,19577
train,2586,10,10240,58,58,10298
train,2587,9,9216,51,51,9267
train,2588,13,13312,79,79,13391
train,2589,16,16384,104,104,16488
train,2590,7,7168,37,37,7205
train,2591,48,49152,342,342,49494
train,2592,13,13312,79,79,13391
train,2593,18,18432,114,114,18546
train,2594,19,19456,127,127,19583
train,2595,14,14336,84,84,14420
train,2596,27,27648,199,199,27847
train,2597,37,37888,273,273,38161
train,2598,31,31744,223,223,31967
train,2599,20,20480,140,140,20620
train,2600,26,26624,168,168,26792
train,2601,40,40960,296,296,41256
train,2602,20,20480,128,128,20608
train,2603,32,32768,232,232,33000
train,2604,47,48128,351,351,48479
train,2605,9,9216,51,51,9267
train,2606,6,6144,30,30,6174
train,2607,26,26624,180,180,26804
train,2608,25,25600,181,181,25781
train,2609,28,28672,188,188,28860
train,2610,19,19456,131,131,19587
train,2611,24,24576,160,160,24736
train,2612,17,17408,105,105,17513
train,2613,12,12288,80,80,12368
train,2614,8,8192,42,42,8234
train,2615,12,12288,72,72,12360
train,2616,19,19456,133,133,19589
train,2617,9,9216,51,51,9267
train,2618,33,33792,233,233,34025
train,2619,31,31744,211,211,31955
train,2620,30,30720,204,204,30924
train,2621,15,15360,93,93,15453
train,2622,29,29696,217,217,29913
train,2623,12,12288,72,72,12360
train,2624,11,11264,65,65,11329
train,2625,19,19456,129,129,19585
train,2626,41,41984,303,303,42287
train,2627,17,17408,107,107,17515
train,2628,39,39936,281,281,40217
train,2629,18,18432,114,114,18546
train,2630,32,32768,218,218,32986
train,2631,35,35840,245,245,36085
train,2632,25,25600,171,171,25771
train,2633,15,15360,93,93,15453
train,2634,19,19456,123,123,19579
train,2635,24,24576,168,168,24744
train,2636,21,21504,147,147,21651
train,2637,13,13312,79,79,13391
train,2638,29,29696,197,197,29893
train,2639,17,17408,121,121,17529
train,2640,19,19456,121,121,19577
train,2641,23,23552,157,157,23709
train,2642,49,50176,341,341,50517
train,2643,20,20480,140,140,20620
train,2644,9,9216,51,51,9267
train,2645,15,15360,93,93,15453
train,2646,17,17408,113,113,17521
train,2647,24,24576,170,170,24746
train,2648,14,14336,86,86,14422
train,2649,15,15360,93,93,15453
train,2650,25,25600,171,171,25771
train,2651,28,28672,184,184,28856
train,2652,26,26624,170,170,26794
train,2653,22,22528,142,142,22670
train,2654,17,17408,107,107,17515
train,2655,40,40960,294,294,41254
train,2656,16,16384,100,100,16484
train,2657,15,15360,99,99,15459
train,2658,25,25600,175,175,25775
train,2659,15,15360,93,93,15453
train,2660,20,20480,126,126,20606
train,2661,13,13312,79,79,13391
train,2662,27,27648,193,193,27841
train,2663,32,32768,218,218,32986
train,2664,16,16384,100,100,16484
train,2665,12,12288,72,72,12360
train,2666,40,40960,292,292,41252
train,2667,9,9216,51,51,9267
train,2668,11,11264,67,67,11331
train,2669,5,5120,23,23,5143
train,2670,21,21504,135,135,21639
train,2671,23,23552,159,159,23711
train,2672,19,19456,131,131,19587
train,2673,29,29696,211,211,29907
train,2674,14,14336,86,86,14422
train,2675,31,31744,215,215,31959
train,2676,21,21504,145,145,21649
train,2677,19,19456,123,123,19579
train,2678,15,15360,99,99,15459
train,2679,20,20480,128,128,20608
train,2680,8,8192,44,44,8236
train,2681,21,21504,135,135,21639
train,2682,23,23552,149,149,23701
train,2683,18,18432,114,114,18546
train,2684,32,32768,230,230,32998
train,2685,30,30720,200,200,30920
train,2686,38,38912,288,288,39200
train,2687,30,30720,204,204,30924
train,2688,18,18432,118,118,18550
train,2689,24,24576,156,156,24732
train,2690,15,15360,93,93,15453
train,2691,16,16384,110,110,16494
train,2692,33,33792,225,225,34017
train,2693,21,21504,135,135,21639
train,2694,17,17408,107,107,17515
train,2695,40,40960,280,280,41240
train,2696,36,36864,240,240,37104
train,2697,28,28672,190,190,28862
train,2698,17,17408,107,107,17515
train,2699,32,32768,218,218,32986
train,2700,15,15360,93,93,15453
train,2701,18,18432,124,124,18556
train,2702,6,6144,30,30,6174
train,2703,24,24576,172,172,24748
train,2704,25,25600,167,167,25767
train,2705,29,29696,201,201,29897
train,2706,17,17408,113,113,17521
train,2707,28,28672,194,194,28866
train,2708,25,25600,169,169,25769
train,2709,19,19456,121,121,19577
train,2710,18,18432,114,114,18546
train,2711,33,33792,231,231,34023
train,2712,11,11264,65,65,11329
train,2713,11,11264,63,63,11327
train,2714,25,25600,173,173,25773
train,2715,10,10240,58,58,10298
train,2716,47,48128,361,361,48489
train,2717,15,15360,93,93,15453
train,2718,20,20480,128,128,20608
train,2719,26,26624,176,176,26800
train,2720,45,46080,321,321,46401
train,2721,23,23552,149,149,23701
train,2722,37,37888,259,259,38147
train,2723,22,22528,154,154,22682
train,2724,20,20480,134,134,20614
train,2725,20,20480,134,134,20614
train,2726,19,19456,125,125,19581
train,2727,23,23552,153,153,23705
train,2728,29,29696,215,215,29911
train,2729,28,28672,212,212,28884
train,2730,15,15360,93,93,15453
train,2731,22,22528,146,146,22674
train,2732,15,15360,93,93,15453
train,2733,31,31744,223,223,31967
train,2734,15,15360,93,93,15453
train,2735,11,11264,65,65,11329
train,2736,9,9216,51,51,9267
train,2737,28,28672,190,190,28862
train,2738,8,8192,44,44,8236
train,2739,38,38912,272,272,39184
train,2740,17,17408,105,105,17513
train,2741,12,12288,72,72,12360
train,2742,27,27648,181,181,27829
train,2743,17,17408,107,107,17515
train,2744,26,26624,176,176,26800
train,2745,14,14336,86,86,14422
train,2746,22,22528,156,156,22684
train,2747,22,22528,156,156,22684
train,2748,18,18432,120,120,18552
train,2749,17,17408,107,107,17515
train,2750,4,4096,16,16,4112
train,2751,18,18432,114,114,18546
train,2752,19,19456,121,121,19577
train,2753,11,11264,65,65,11329
train,2754,21,21504,139,139,21643
train,2755,31,31744,211,211,31955
train,2756,20,20480,132,132,20612
train,2757,22,22528,146,146,22674
train,2758,25,25600,173,173,25773
train,2759,33,33792,229,229,34021
train,2760,13,13312,79,79,13391
train,2761,5,5120,23,23,5143
train,2762,19,19456,121,121,19577
train,2763,27,27648,185,185,27833
train,2764,15,15360,93,93,15453
train,2765,33,33792,249,249,34041
train,2766,9,9216,53,53,9269
train,2767,25,25600,175,175,25775
train,2768,26,26624,170,170,26794
train,2769,16,16384,100,100,16484
train,2770,7,7168,37,37,7205
train,2771,5,5120,23,23,5143
train,2772,13,13312,79,79,13391
train,2773,24,24576,158,158,24734
train,2774,29,29696,209,209,29905
train,2775,22,22528,142,142,22670
train,2776,20,20480,128,128,20608
train,2777,20,20480,134,134,20614
train,2778,14,14336,96,96,14432
train,2779,18,18432,136,136,18568
train,2780,31,31744,205,205,31949
train,2781,24,24576,162,162,24738
train,2782,20,20480,134,134,20614
train,2783,31,31744,211,211,31955
train,2784,13,13312,79,79,13391
train,2785,26,26624,172,172,26796
train,2786,15,15360,93,93,15453
train,2787,14,14336,86,86,14422
train,2788,42,43008,320,320,43328
train,2789,26,26624,170,170,26794
train,2790,11,11264,65,65,11329
train,2791,22,22528,142,142,22670
train,2792,21,21504,141,141,21645
train,2793,4,4096,16,16,4112
train,2794,39,39936,277,277,40213
train,2795,8,8192,44,44,8236
train,2796,17,17408,107,107,17515
train,2797,12,12288,72,72,12360
train,2798,5,5120,23,23,5143
train,2799,28,28672,208,208,28880
train,2800,14,14336,86,86,14422
train,2801,28,28672,184,184,28856
train,2802,17,17408,107,107,17515
train,2803,20,20480,128,128,20608
train,2804,26,26624,180,180,26804
train,2805,15,15360,107,107,15467
train,2806,10,10240,58,58,10298
train,2807,19,19456,121,121,19577
train,2808,8,8192,44,44,8236
train,2809,34,34816,234,234,35050
train,2810,13,13312,79,79,13391
train,2811,23,23552,167,167,23719
train,2812,20,20480,128,128,20608
train,2813,18,18432,114,114,18546
train,2814,10,10240,58,58,10298
train,2815,17,17408,117,117,17525
train,2816,13,13312,79,79,13391
train,2817,28,28672,194,194,28866
train,2818,21,21504,141,141,21645
train,2819,27,27648,191,191,27839
train,2820,16,16384,100,100,16484
train,2821,10,10240,56,56,10296
train,2822,21,21504,135,135,21639
train,2823,14,14336,86,86,14422
train,2824,19,19456,127,127,19583
train,2825,22,22528,142,142,22670
train,2826,21,21504,141,141,21645
train,2827,19,19456,121,121,19577
train,2828,9,9216,51,51,9267
train,2829,26,26624,178,178,26802
train,2830,24,24576,168,168,24744
train,2831,30,30720,204,204,30924
train,2832,17,17408,105,105,17513
train,2833,11,11264,65,65,11329
train,2834,18,18432,116,116,18548
train,2835,31,31744,215,215,31959
train,2836,17,17408,113,113,17521
train,2837,14,14336,86,86,14422
train,2838,29,29696,203,203,29899
train,2839,13,13312,79,79,13391
train,2840,24,24576,162,162,24738
train,2841,26,26624,170,170,26794
train,2842,10,10240,58,58,10298
train,2843,19,19456,121,121,19577
train,2844,18,18432,124,124,18556
train,2845,14,14336,86,86,14422
train,2846,9,9216,51,51,9267
train,2847,12,12288,72,72,12360
train,2848,14,14336,86,86,14422
train,2849,20,20480,128,128,20608
train,2850,23,23552,167,167,23719
train,2851,26,26624,176,176,26800
train,2852,22,22528,152,152,22680
train,2853,17,17408,117,117,17525
train,2854,21,21504,139,139,21643
train,2855,23,23552,149,149,23701
train,2856,26,26624,176,176,26800
train,2857,30,30720,210,210,30930
train,2858,10,10240,58,58,10298
train,2859,17,17408,107,107,17515
train,2860,34,34816,226,226,35042
train,2861,45,46080,321,321,46401
train,2862,36,36864,268,268,37132
train,2863,27,27648,181,181,27829
train,2864,19,19456,139,139,19595
train,2865,25,25600,169,169,25769
train,2866,11,11264,65,65,11329
train,2867,38,38912,298,298,39210
train,2868,22,22528,142,142,22670
train,2869,29,29696,197,197,29893
train,2870,24,24576,170,170,24746
train,2871,23,23552,149,149,23701
train,2872,18,18432,120,120,18552
train,2873,5,5120,23,23,5143
train,2874,22,22528,152,152,22680
train,2875,14,14336,86,86,14422
train,2876,11,11264,65,65,11329
train,2877,16,16384,100,100,16484
train,2878,29,29696,197,197,29893
train,2879,20,20480,128,128,20608
train,2880,30,30720,204,204,30924
train,2881,39,39936,279,279,40215
train,2882,5,5120,23,23,5143
train,2883,17,17408,107,107,17515
train,2884,37,37888,269,269,38157
train,2885,11,11264,65,65,11329
train,2886,15,15360,99,99,15459
train,2887,21,21504,135,135,21639
train,2888,19,19456,121,121,19577
train,2889,33,33792,231,231,34023
train,2890,11,11264,65,65,11329
train,2891,18,18432,114,114,18546
train,2892,14,14336,86,86,14422
train,2893,20,20480,128,128,20608
train,2894,35,35840,249,249,36089
train,2895,42,43008,304,304,43312
train,2896,12,12288,72,72,12360
train,2897,10,10240,58,58,10298
train,2898,15,15360,97,97,15457
train,2899,25,25600,167,167,25767
train,2900,5,5120,23,23,5143
train,2901,14,14336,84,84,14420
train,2902,12,12288,72,72,12360
train,2903,20,20480,134,134,20614
train,2904,25,25600,161,161,25761
train,2905,12,12288,72,72,12360
train,2906,18,18432,114,114,18546
train,2907,16,16384,100,100,16484
train,2908,11,11264,63,63,11327
train,2909,17,17408,123,123,17531
train,2910,24,24576,162,162,24738
train,2911,22,22528,152,152,22680
train,2912,11,11264,65,65,11329
train,2913,15,15360,91,91,15451
train,2914,24,24576,162,162,24738
train,2915,12,12288,74,74,12362
train,2916,26,26624,182,182,26806
train,2917,11,11264,61,61,11325
train,2918,5,5120,23,23,5143
train,2919,26,26624,170,170,26794
train,2920,9,9216,51,51,9267
train,2921,33,33792,225,225,34017
train,2922,25,25600,163,163,25763
train,2923,23,23552,149,149,23701
train,2924,19,19456,121,121,19577
train,2925,17,17408,107,107,17515
train,2926,26,26624,174,174,26798
train,2927,9,9216,51,51,9267
train,2928,39,39936,277,277,40213
train,2929,7,7168,37,37,7205
train,2930,24,24576,162,162,24738
train,2931,17,17408,113,113,17521
train,2932,20,20480,138,138,20618
train,2933,15,15360,93,93,15453
train,2934,36,36864,262,262,37126
train,2935,37,37888,283,283,38171
train,2936,25,25600,185,185,25785
train,2937,16,16384,100,100,16484
train,2938,41,41984,309,309,42293
train,2939,23,23552,149,149,23701
train,2940,14,14336,86,86,14422
train,2941,22,22528,142,142,22670
train,2942,15,15360,93,93,15453
train,2943,11,11264,65,65,11329
train,2944,9,9216,51,51,9267
train,2945,35,35840,265,265,36105
train,2946,32,32768,220,220,32988
train,2947,25,25600,171,171,25771
train,2948,18,18432,114,114,18546
train,2949,23,23552,153,153,23705
train,2950,6,6144,30,30,6174
train,2951,18,18432,114,114,18546
train,2952,16,16384,100,100,16484
train,2953,28,28672,188,188,28860
train,2954,16,16384,100,100,16484
train,2955,33,33792,235,235,34027
train,2956,27,27648,193,193,27841
train,2957,37,37888,259,259,38147
train,2958,28,28672,184,184,28856
train,2959,28,28672,188,188,28860
train,2960,5,5120,23,23,5143
train,2961,16,16384,100,100,16484
train,2962,33,33792,225,225,34017
train,2963,14,14336,86,86,14422
train,2964,4,4096,16,16,4112
train,2965,29,29696,197,197,29893
train,2966,21,21504,147,147,21651
train,2967,19,19456,123,123,19579
train,2968,26,26624,182,182,26806
train,2969,21,21504,147,147,21651
train,2970,18,18432,118,118,18550
train,2971,19,19456,121,121,19577
train,2972,16,16384,100,100,16484
train,2973,21,21504,135,135,21639
train,2974,31,31744,205,205,31949
train,2975,16,16384,100,100,16484
train,2976,27,27648,195,195,27843
train,2977,41,41984,291,291,42275
train,2978,33,33792,225,225,34017
train,2979,30,30720,204,204,30924
train,2980,25,25600,163,163,25763
train,2981,12,12288,72,72,12360
train,2982,17,17408,107,107,17515
train,2983,33,33792,223,223,34015
train,2984,16,16384,110,110,16494
train,2985,13,13312,85,85,13397
train,2986,22,22528,152,152,22680
train,2987,35,35840,239,239,36079
train,2988,18,18432,114,114,18546
train,2989,21,21504,135,135,21639
train,2990,27,27648,187,187,27835
train,2991,17,17408,107,107,17515
train,2992,10,10240,58,58,10298
train,2993,7,7168,37,37,7205
train,2994,12,12288,70,70,12358
train,2995,27,27648,189,189,27837
train,2996,22,22528,142,142,22670
train,2997,15,15360,93,93,15453
train,2998,3,3072,9,9,3081
train,2999,21,21504,135,135,21639
train,3000,3,3072,9,9,3081
train,3001,41,41984,287,287,42271
train,3002,27,27648,185,185,27833
train,3003,33,33792,229,229,34021
train,3004,7,7168,37,37,7205
train,3005,12,12288,72,72,12360
train,3006,35,35840,255,255,36095
train,3007,15,15360,97,97,15457
train,3008,22,22528,142,142,22670
train,3009,11,11264,65,65,11329
train,3010,32,32768,236,236,33004
train,3011,4,4096,16,16,4112
train,3012,9,9216,49,49,9265
train,3013,13,13312,79,79,13391
train,3014,10,10240,58,58,10298
train,3015,6,6144,30,30,6174
train,3016,14,14336,86,86,14422
train,3017,6,6144,30,30,6174
train,3018,14,14336,98,98,14434
train,3019,2,2048,4,4,2052
train,3020,19,19456,123,123,19579
train,3021,18,18432,120,120,18552
train,3022,5,5120,23,23,5143
train,3023,15,15360,93,93,15453
train,3024,18,18432,112,112,18544
train,3025,26,26624,180,180,26804
train,3026,28,28672,184,184,28856
train,3027,6,6144,30,30,6174
train,3028,22,22528,142,142,22670
train,3029,35,35840,249,249,36089
train,3030,6,6144,30,30,6174
train,3031,24,24576,164,164,24740
train,3032,19,19456,133,133,19589
train,3033,42,43008,296,296,43304
train,3034,29,29696,191,191,29887
train,3035,21,21504,145,145,21649
train,3036,10,10240,58,58,10298
train,3037,21,21504,157,157,21661
train,3038,25,25600,169,169,25769
train,3039,13,13312,79,79,13391
train,3040,20,20480,140,140,20620
train,3041,12,12288,72,72,12360
train,3042,23,23552,161,161,23713
train,3043,14,14336,86,86,14422
train,3044,21,21504,141,141,21645
train,3045,8,8192,44,44,8236
train,3046,28,28672,184,184,28856
train,3047,34,34816,272,272,35088
train,3048,13,13312,81,81,13393
train,3049,17,17408,107,107,17515
train,3050,16,16384,100,100,16484
train,3051,26,26624,188,188,26812
train,3052,33,33792,233,233,34025
train,3053,43,44032,333,333,44365
train,3054,33,33792,239,239,34031
train,3055,28,28672,200,200,28872
train,3056,23,23552,149,149,23701
train,3057,11,11264,69,69,11333
train,3058,22,22528,148,148,22676
train,3059,20,20480,138,138,20618
train,3060,6,6144,30,30,6174
train,3061,15,15360,93,93,15453
train,3062,15,15360,93,93,15453
train,3063,43,44032,323,323,44355
train,3064,21,21504,135,135,21639
train,3065,28,28672,194,194,28866
train,3066,23,23552,149,149,23701
train,3067,31,31744,219,219,31963
train,3068,27,27648,183,183,27831
train,3069,24,24576,172,172,24748
train,3070,30,30720,212,212,30932
train,3071,14,14336,86,86,14422
train,3072,44,45056,318,318,45374
train,3073,10,10240,58,58,10298
train,3074,27,27648,189,189,27837
train,3075,20,20480,128,128,20608
train,3076,15,15360,93,93,15453
train,3077,12,12288,84,84,12372
train,3078,3,3072,9,9,3081
train,3079,19,19456,121,121,19577
train,3080,10,10240,58,58,10298
train,3081,11,11264,65,65,11329
train,3082,14,14336,86,86,14422
train,3083,33,33792,225,225,34017
train,3084,13,13312,79,79,13391
train,3085,13,13312,85,85,13397
train,3086,13,13312,79,79,13391
train,3087,22,22528,142,142,22670
train,3088,31,31744,209,209,31953
train,3089,14,14336,86,86,14422
train,3090,20,20480,134,134,20614
train,3091,25,25600,169,169,25769
train,3092,42,43008,310,310,43318
train,3093,14,14336,90,90,14426
train,3094,17,17408,107,107,17515
train,3095,5,5120,23,23,5143
train,3096,9,9216,51,51,9267
train,3097,24,24576,182,182,24758
train,3098,32,32768,222,222,32990
train,3099,18,18432,120,120,18552
train,3100,6,6144,30,30,6174
train,3101,25,25600,173,173,25773
train,3102,32,32768,222,222,32990
train,3103,37,37888,263,263,38151
train,3104,30,30720,210,210,30930
train,3105,23,23552,155,155,23707
train,3106,23,23552,151,151,23703
train,3107,24,24576,166,166,24742
train,3108,9,9216,51,51,9267
train,3109,9,9216,49,49,9265
train,3110,28,28672,184,184,28856
train,3111,39,39936,267,267,40203
train,3112,16,16384,100,100,16484
train,3113,13,13312,85,85,13397
train,3114,18,18432,114,114,18546
train,3115,25,25600,169,169,25769
train,3116,18,18432,118,118,18550
train,3117,35,35840,243,243,36083
train,3118,21,21504,135,135,21639
train,3119,11,11264,65,65,11329
train,3120,4,4096,16,16,4112
train,3121,18,18432,116,116,18548
train,3122,31,31744,215,215,31959
train,3123,6,6144,30,30,6174
train,3124,35,35840,239,239,36079
train,3125,18,18432,120,120,18552
train,3126,15,15360,93,93,15453
train,3127,25,25600,163,163,25763
train,3128,22,22528,152,152,22680
train,3129,32,32768,228,228,32996
train,3130,27,27648,177,177,27825
train,3131,18,18432,118,118,18550
train,3132,41,41984,315,315,42299
train,3133,15,15360,93,93,15453
train,3134,29,29696,197,197,29893
train,3135,25,25600,167,167,25767
train,3136,16,16384,100,100,16484
train,3137,33,33792,225,225,34017
train,3138,22,22528,152,152,22680
train,3139,19,19456,121,121,19577
train,3140,46,47104,338,338,47442
train,3141,28,28672,194,194,28866
train,3142,25,25600,163,163,25763
train,3143,16,16384,100,100,16484
train,3144,34,34816,232,232,35048
train,3145,28,28672,212,212,28884
train,3146,17,17408,107,107,17515
train,3147,28,28672,194,194,28866
train,3148,6,6144,30,30,6174
train,3149,34,34816,240,240,35056
train,3150,12,12288,78,78,12366
train,3151,12,12288,72,72,12360
train,3152,19,19456,121,121,19577
train,3153,17,17408,113,113,17521
train,3154,17,17408,107,107,17515
train,3155,17,17408,117,117,17525
train,3156,34,34816,236,236,35052
train,3157,22,22528,148,148,22676
train,3158,28,28672,196,196,28868
train,3159,20,20480,134,134,20614
train,3160,33,33792,231,231,34023
train,3161,25,25600,179,179,25779
train,3162,12,12288,72,72,12360
train,3163,12,12288,72,72,12360
train,3164,22,22528,146,146,22674
train,3165,10,10240,58,58,10298
train,3166,41,41984,291,291,42275
train,3167,16,16384,106,106,16490
train,3168,24,24576,156,156,24732
train,3169,21,21504,135,135,21639
train,3170,40,40960,280,280,41240
train,3171,16,16384,106,106,16490
train,3172,12,12288,72,72,12360
train,3173,23,23552,157,157,23709
train,3174,12,12288,72,72,12360
train,3175,11,11264,65,65,11329
train,3176,27,27648,177,177,27825
train,3177,51,52224,385,385,52609
train,3178,34,34816,232,232,35048
train,3179,14,14336,92,92,14428
train,3180,23,23552,151,151,23703
train,3181,17,17408,107,107,17515
train,3182,25,25600,163,163,25763
train,3183,29,29696,199,199,29895
train,3184,13,13312,79,79,13391
train,3185,16,16384,100,100,16484
train,3186,26,26624,182,182,26806
train,3187,25,25600,163,163,25763
train,3188,6,6144,30,30,6174
train,3189,27,27648,183,183,27831
train,3190,16,16384,114,114,16498
train,3191,24,24576,158,158,24734
train,3192,16,16384,102,102,16486
train,3193,16,16384,102,102,16486
train,3194,33,33792,223,223,34015
train,3195,6,6144,30,30,6174
train,3196,12,12288,70,70,12358
train,3197,15,15360,97,97,15457
train,3198,26,26624,170,170,26794
train,3199,11,11264,65,65,11329
train,3200,20,20480,148,148,20628
train,3201,9,9216,51,51,9267
train,3202,25,25600,171,171,25771
train,3203,12,12288,76,76,12364
train,3204,45,46080,327,327,46407
train,3205,12,12288,72,72,12360
train,3206,17,17408,113,113,17521
train,3207,30,30720,210,210,30930
train,3208,21,21504,147,147,21651
train,3209,6,6144,30,30,6174
train,3210,36,36864,260,260,37124
train,3211,27,27648,181,181,27829
train,3212,7,7168,37,37,7205
train,3213,11,11264,65,65,11329
train,3214,27,27648,177,177,27825
train,3215,23,23552,163,163,23715
train,3216,20,20480,128,128,20608
train,3217,22,22528,142,142,22670
train,3218,23,23552,161,161,23713
train,3219,16,16384,106,106,16490
train,3220,11,11264,65,65,11329
train,3221,20,20480,136,136,20616
train,3222,5,5120,23,23,5143
train,3223,37,37888,269,269,38157
train,3224,8,8192,44,44,8236
train,3225,34,34816,246,246,35062
train,3226,9,9216,51,51,9267
train,3227,23,23552,149,149,23701
train,3228,21,21504,135,135,21639
train,3229,22,22528,148,148,22676
train,3230,19,19456,127,127,19583
train,3231,6,6144,30,30,6174
train,3232,16,16384,100,100,16484
train,3233,12,12288,72,72,12360
train,3234,17,17408,107,107,17515
train,3235,16,16384,100,100,16484
train,3236,14,14336,86,86,14422
train,3237,30,30720,202,202,30922
train,3238,8,8192,44,44,8236
train,3239,28,28672,202,202,28874
train,3240,10,10240,58,58,10298
train,3241,10,10240,58,58,10298
train,3242,17,17408,107,107,17515
train,3243,20,20480,130,130,20610
train,3244,19,19456,133,133,19589
train,3245,11,11264,65,65,11329
train,3246,28,28672,196,196,28868
train,3247,21,21504,139,139,21643
train,3248,15,15360,93,93,15453
train,3249,17,17408,113,113,17521
train,3250,16,16384,100,100,16484
train,3251,30,30720,212,212,30932
train,3252,6,6144,30,30,6174
train,3253,39,39936,289,289,40225
train,3254,40,40960,284,284,41244
train,3255,40,40960,282,282,41242
train,3256,28,28672,186,186,28858
train,3257,27,27648,193,193,27841
train,3258,14,14336,84,84,14420
train,3259,30,30720,226,226,30946
train,3260,34,34816,232,232,35048
train,3261,18,18432,114,114,18546
train,3262,35,35840,239,239,36079
train,3263,18,18432,114,114,18546
train,3264,17,17408,117,117,17525
train,3265,17,17408,107,107,17515
train,3266,29,29696,191,191,29887
train,3267,13,13312,79,79,13391
train,3268,19,19456,127,127,19583
train,3269,33,33792,231,231,34023
train,3270,27,27648,183,183,27831
train,3271,24,24576,156,156,24732
train,3272,15,15360,93,93,15453
train,3273,12,12288,68,68,12356
train,3274,19,19456,121,121,19577
train,3275,17,17408,109,109,17517
train,3276,4,4096,16,16,4112
train,3277,42,43008,294,294,43302
train,3278,31,31744,205,205,31949
train,3279,35,35840,239,239,36079
train,3280,24,24576,156,156,24732
train,3281,18,18432,116,116,18548
train,3282,7,7168,37,37,7205
train,3283,25,25600,179,179,25779
train,3284,7,7168,37,37,7205
train,3285,15,15360,93,93,15453
train,3286,16,16384,100,100,16484
train,3287,20,20480,132,132,20612
train,3288,15,15360,99,99,15459
train,3289,25,25600,173,173,25773
train,3290,17,17408,107,107,17515
train,3291,31,31744,221,221,31965
train,3292,28,28672,190,190,28862
train,3293,6,6144,30,30,6174
train,3294,17,17408,113,113,17521
train,3295,41,41984,299,299,42283
train,3296,5,5120,23,23,5143
train,3297,13,13312,95,95,13407
train,3298,12,12288,72,72,12360
train,3299,11,11264,65,65,11329
train,3300,46,47104,328,328,47432
train,3301,18,18432,114,114,18546
train,3302,16,16384,106,106,16490
train,3303,20,20480,134,134,20614
train,3304,19,19456,125,125,19581
train,3305,29,29696,195,195,29891
train,3306,18,18432,114,114,18546
train,3307,25,25600,169,169,25769
train,3308,5,5120,23,23,5143
train,3309,8,8192,44,44,8236
train,3310,6,6144,30,30,6174
train,3311,12,12288,72,72,12360
train,3312,8,8192,44,44,8236
train,3313,27,27648,207,207,27855
train,3314,10,10240,58,58,10298
train,3315,5,5120,23,23,5143
train,3316,16,16384,100,100,16484
train,3317,32,32768,218,218,32986
train,3318,12,12288,72,72,12360
train,3319,29,29696,197,197,29893
train,3320,23,23552,159,159,23711
train,3321,23,23552,155,155,23707
train,3322,26,26624,188,188,26812
train,3323,12,12288,72,72,12360
train,3324,23,23552,149,149,23701
train,3325,17,17408,113,113,17521
train,3326,23,23552,155,155,23707
train,3327,39,39936,275,275,40211
train,3328,32,32768,218,218,32986
train,3329,17,17408,107,107,17515
train,3330,13,13312,79,79,13391
train,3331,11,11264,65,65,11329
train,3332,25,25600,175,175,25775
train,3333,18,18432,112,112,18544
train,3334,33,33792,231,231,34023
train,3335,19,19456,129,129,19585
train,3336,23,23552,151,151,23703
train,3337,27,27648,183,183,27831
train,3338,27,27648,189,189,27837
train,3339,39,39936,275,275,40211
train,3340,20,20480,128,128,20608
train,3341,14,14336,86,86,14422
train,3342,24,24576,156,156,24732
train,3343,19,19456,121,121,19577
train,3344,11,11264,71,71,11335
train,3345,15,15360,93,93,15453
train,3346,8,8192,44,44,8236
train,3347,20,20480,128,128,20608
train,3348,9,9216,49,49,9265
train,3349,34,34816,248,248,35064
train,3350,4,4096,16,16,4112
train,3351,34,34816,242,242,35058
train,3352,6,6144,30,30,6174
train,3353,41,41984,303,303,42287
train,3354,12,12288,74,74,12362
train,3355,17,17408,107,107,17515
train,3356,18,18432,130,130,18562
train,3357,14,14336,94,94,14430
train,3358,35,35840,255,255,36095
train,3359,10,10240,58,58,10298
train,3360,19,19456,117,117,19573
train,3361,22,22528,152,152,22680
train,3362,7,7168,37,37,7205
train,3363,35,35840,263,263,36103
train,3364,17,17408,115,115,17523
train,3365,17,17408,107,107,17515
train,3366,4,4096,16,16,4112
train,3367,13,13312,79,79,13391
train,3368,38,38912,260,260,39172
train,3369,29,29696,205,205,29901
train,3370,11,11264,69,69,11333
train,3371,46,47104,340,340,47444
train,3372,11,11264,65,65,11329
train,3373,31,31744,213,213,31957
train,3374,18,18432,116,116,18548
train,3375,25,25600,173,173,25773
train,3376,35,35840,253,253,36093
train,3377,9,9216,51,51,9267
train,3378,38,38912,272,272,39184
train,3379,30,30720,202,202,30922
train,3380,13,13312,79,79,13391
train,3381,7,7168,37,37,7205
train,3382,20,20480,128,128,20608
train,3383,24,24576,170,170,24746
train,3384,26,26624,176,176,26800
train,3385,28,28672,200,200,28872
train,3386,6,6144,30,30,6174
train,3387,22,22528,148,148,22676
train,3388,21,21504,131,131,21635
train,3389,19,19456,131,131,19587
train,3390,18,18432,114,114,18546
train,3391,33,33792,237,237,34029
train,3392,17,17408,117,117,17525
train,3393,17,17408,113,113,17521
train,3394,13,13312,83,83,13395
train,3395,18,18432,126,126,18558
train,3396,19,19456,121,121,19577
train,3397,41,41984,287,287,42271
train,3398,16,16384,98,98,16482
train,3399,27,27648,197,197,27845
train,3400,22,22528,142,142,22670
train,3401,17,17408,113,113,17521
train,3402,20,20480,134,134,20614
train,3403,31,31744,223,223,31967
train,3404,20,20480,136,136,20616
train,3405,22,22528,142,142,22670
train,3406,3,3072,9,9,3081
train,3407,6,6144,30,30,6174
train,3408,25,25600,163,163,25763
train,3409,21,21504,145,145,21649
train,3410,28,28672,190,190,28862
train,3411,41,41984,299,299,42283
train,3412,12,12288,72,72,12360
train,3413,12,12288,70,70,12358
train,3414,39,39936,261,261,40197
train,3415,20,20480,132,132,20612
train,3416,20,20480,134,134,20614
train,3417,39,39936,271,271,40207
train,3418,32,32768,224,224,32992
train,3419,9,9216,51,51,9267
train,3420,24,24576,156,156,24732
train,3421,5,5120,23,23,5143
train,3422,28,28672,184,184,28856
train,3423,32,32768,224,224,32992
train,3424,35,35840,255,255,36095
train,3425,22,22528,150,150,22678
train,3426,29,29696,201,201,29897
train,3427,12,12288,72,72,12360
train,3428,17,17408,107,107,17515
train,3429,6,6144,30,30,6174
train,3430,19,19456,131,131,19587
train,3431,4,4096,16,16,4112
train,3432,31,31744,213,213,31957
train,3433,34,34816,232,232,35048
train,3434,13,13312,85,85,13397
train,3435,16,16384,100,100,16484
train,3436,26,26624,188,188,26812
train,3437,29,29696,191,191,29887
train,3438,15,15360,91,91,15451
train,3439,8,8192,44,44,8236
train,3440,17,17408,107,107,17515
train,3441,26,26624,186,186,26810
train,3442,17,17408,113,113,17521
train,3443,18,18432,114,114,18546
train,3444,13,13312,81,81,13393
train,3445,20,20480,134,134,20614
train,3446,21,21504,133,133,21637
train,3447,38,38912,266,266,39178
train,3448,23,23552,165,165,23717
train,3449,4,4096,16,16,4112
train,3450,14,14336,84,84,14420
train,3451,37,37888,271,271,38159
train,3452,17,17408,113,113,17521
train,3453,8,8192,44,44,8236
train,3454,27,27648,183,183,27831
train,3455,28,28672,184,184,28856
train,3456,9,9216,51,51,9267
train,3457,14,14336,90,90,14426
train,3458,8,8192,44,44,8236
train,3459,32,32768,228,228,32996
train,3460,39,39936,281,281,40217
train,3461,26,26624,170,170,26794
train,3462,26,26624,170,170,26794
train,3463,16,16384,108,108,16492
train,3464,14,14336,86,86,14422
train,3465,35,35840,247,247,36087
train,3466,22,22528,152,152,22680
train,3467,25,25600,173,173,25773
train,3468,15,15360,93,93,15453
train,3469,13,13312,79,79,13391
train,3470,11,11264,65,65,11329
train,3471,21,21504,139,139,21643
train,3472,29,29696,205,205,29901
train,3473,6,6144,30,30,6174
train,3474,31,31744,225,225,31969
train,3475,12,12288,72,72,12360
train,3476,13,13312,85,85,13397
train,3477,25,25600,173,173,25773
train,3478,28,28672,196,196,28868
train,3479,20,20480,130,130,20610
train,3480,11,11264,65,65,11329
train,3481,32,32768,226,226,32994
train,3482,27,27648,177,177,27825
train,3483,29,29696,197,197,29893
train,3484,17,17408,113,113,17521
train,3485,30,30720,192,192,30912
train,3486,27,27648,185,185,27833
train,3487,15,15360,93,93,15453
train,3488,35,35840,239,239,36079
train,3489,13,13312,79,79,13391
train,3490,36,36864,252,252,37116
train,3491,34,34816,232,232,35048
train,3492,8,8192,44,44,8236
train,3493,37,37888,257,257,38145
train,3494,14,14336,86,86,14422
train,3495,5,5120,23,23,5143
train,3496,10,10240,60,60,10300
train,3497,22,22528,142,142,22670
train,3498,17,17408,113,113,17521
train,3499,22,22528,142,142,22670
train,3500,20,20480,128,128,20608
train,3501,22,22528,148,148,22676
train,3502,14,14336,86,86,14422
train,3503,23,23552,161,161,23713
train,3504,31,31744,241,241,31985
train,3505,21,21504,135,135,21639
train,3506,26,26624,170,170,26794
train,3507,40,40960,284,284,41244
train,3508,10,10240,58,58,10298
train,3509,17,17408,103,103,17511
train,3510,19,19456,121,121,19577
train,3511,18,18432,120,120,18552
train,3512,24,24576,166,166,24742
train,3513,22,22528,148,148,22676
train,3514,29,29696,203,203,29899
train,3515,9,9216,51,51,9267
train,3516,34,34816,226,226,35042
train,3517,28,28672,182,182,28854
train,3518,5,5120,23,23,5143
train,3519,9,9216,51,51,9267
train,3520,16,16384,100,100,16484
train,3521,21,21504,141,141,21645
train,3522,7,7168,37,37,7205
train,3523,9,9216,51,51,9267
train,3524,12,12288,70,70,12358
train,3525,19,19456,133,133,19589
train,3526,30,30720,210,210,30930
train,3527,8,8192,44,44,8236
train,3528,8,8192,44,44,8236
train,3529,25,25600,169,169,25769
train,3530,20,20480,128,128,20608
train,3531,6,6144,30,30,6174
train,3532,19,19456,121,121,19577
train,3533,17,17408,107,107,17515
train,3534,7,7168,37,37,7205
train,3535,6,6144,30,30,6174
train,3536,22,22528,142,142,22670
train,3537,19,19456,131,131,19587
train,3538,26,26624,176,176,26800
train,3539,16,16384,100,100,16484
train,3540,40,40960,294,294,41254
train,3541,22,22528,142,142,22670
train,3542,19,19456,121,121,19577
train,3543,30,30720,214,214,30934
train,3544,7,7168,37,37,7205
train,3545,20,20480,134,134,20614
train,3546,9,9216,57,57,9273
train,3547,5,5120,23,23,5143
train,3548,21,21504,145,145,21649
train,3549,17,17408,107,107,17515
train,3550,32,32768,230,230,32998
train,3551,19,19456,133,133,19589
train,3552,12,12288,72,72,12360
train,3553,23,23552,157,157,23709
train,3554,29,29696,205,205,29901
train,3555,33,33792,225,225,34017
train,3556,13,13312,79,79,13391
train,3557,23,23552,149,149,23701
train,3558,18,18432,112,112,18544
train,3559,6,6144,30,30,6174
train,3560,23,23552,167,167,23719
train,3561,10,10240,58,58,10298
train,3562,21,21504,135,135,21639
train,3563,27,27648,197,197,27845
train,3564,21,21504,145,145,21649
train,3565,24,24576,162,162,24738
train,3566,20,20480,132,132,20612
train,3567,17,17408,107,107,17515
train,3568,6,6144,30,30,6174
train,3569,27,27648,187,187,27835
train,3570,24,24576,156,156,24732
train,3571,16,16384,106,106,16490
train,3572,14,14336,84,84,14420
train,3573,26,26624,190,190,26814
train,3574,12,12288,72,72,12360
train,3575,24,24576,162,162,24738
train,3576,32,32768,218,218,32986
train,3577,28,28672,196,196,28868
train,3578,8,8192,44,44,8236
train,3579,15,15360,93,93,15453
train,3580,24,24576,168,168,24744
train,3581,15,15360,95,95,15455
train,3582,23,23552,159,159,23711
train,3583,7,7168,37,37,7205
train,3584,18,18432,114,114,18546
train,3585,15,15360,93,93,15453
train,3586,19,19456,121,121,19577
train,3587,13,13312,79,79,13391
train,3588,25,25600,163,163,25763
train,3589,20,20480,130,130,20610
train,3590,7,7168,35,35,7203
train,3591,6,6144,30,30,6174
train,3592,41,41984,287,287,42271
train,3593,29,29696,201,201,29897
train,3594,33,33792,231,231,34023
train,3595,20,20480,128,128,20608
train,3596,15,15360,93,93,15453
train,3597,15,15360,93,93,15453
train,3598,26,26624,180,180,26804
train,3599,6,6144,30,30,6174
train,3600,22,22528,148,148,22676
train,3601,23,23552,149,149,23701
train,3602,10,10240,58,58,10298
train,3603,28,28672,194,194,28866
train,3604,37,37888,285,285,38173
train,3605,15,15360,93,93,15453
train,3606,34,34816,242,242,35058
train,3607,43,44032,323,323,44355
train,3608,18,18432,124,124,18556
train,3609,10,10240,58,58,10298
train,3610,17,17408,109,109,17517
train,3611,18,18432,120,120,18552
train,3612,24,24576,162,162,24738
train,3613,29,29696,209,209,29905
train,3614,31,31744,215,215,31959
train,3615,22,22528,142,142,22670
train,3616,20,20480,126,126,20606
train,3617,23,23552,151,151,23703
train,3618,32,32768,222,222,32990
train,3619,40,40960,268,268,41228
train,3620,25,25600,175,175,25775
train,3621,14,14336,92,92,14428
train,3622,26,26624,190,190,26814
train,3623,28,28672,184,184,28856
train,3624,13,13312,79,79,13391
train,3625,13,13312,79,79,13391
train,3626,18,18432,110,110,18542
train,3627,28,28672,204,204,28876
train,3628,21,21504,153,153,21657
train,3629,23,23552,149,149,23701
train,3630,11,11264,65,65,11329
train,3631,11,11264,65,65,11329
train,3632,10,10240,58,58,10298
train,3633,10,10240,58,58,10298
train,3634,18,18432,120,120,18552
train,3635,12,12288,72,72,12360
train,3636,20,20480,134,134,20614
train,3637,36,36864,246,246,37110
train,3638,17,17408,113,113,17521
train,3639,24,24576,156,156,24732
train,3640,14,14336,86,86,14422
train,3641,31,31744,211,211,31955
train,3642,30,30720,210,210,30930
train,3643,25,25600,169,169,25769
train,3644,31,31744,221,221,31965
train,3645,7,7168,37,37,7205
train,3646,16,16384,100,100,16484
train,3647,31,31744,223,223,31967
train,3648,9,9216,51,51,9267
train,3649,21,21504,135,135,21639
train,3650,6,6144,30,30,6174
train,3651,20,20480,128,128,20608
train,3652,24,24576,162,162,24738
train,3653,26,26624,186,186,26810
train,3654,10,10240,58,58,10298
train,3655,17,17408,107,107,17515
train,3656,25,25600,163,163,25763
train,3657,22,22528,148,148,22676
train,3658,30,30720,214,214,30934
train,3659,27,27648,183,183,27831
train,3660,22,22528,142,142,22670
train,3661,3,3072,9,9,3081
train,3662,26,26624,186,186,26810
train,3663,22,22528,148,148,22676
train,3664,11,11264,67,67,11331
train,3665,16,16384,100,100,16484
train,3666,25,25600,169,169,25769
train,3667,41,41984,297,297,42281
train,3668,25,25600,163,163,25763
train,3669,20,20480,138,138,20618
train,3670,20,20480,130,130,20610
train,3671,19,19456,121,121,19577
train,3672,24,24576,166,166,24742
train,3673,27,27648,189,189,27837
train,3674,40,40960,276,276,41236
train,3675,21,21504,135,135,21639
train,3676,26,26624,176,176,26800
train,3677,7,7168,37,37,7205
train,3678,7,7168,37,37,7205
train,3679,14,14336,86,86,14422
train,3680,29,29696,213,213,29909
train,3681,17,17408,107,107,17515
train,3682,10,10240,58,58,10298
train,3683,14,14336,86,86,14422
train,3684,23,23552,153,153,23705
train,3685,22,22528,152,152,22680
train,3686,10,10240,58,58,10298
train,3687,21,21504,145,145,21649
train,3688,28,28672,216,216,28888
train,3689,21,21504,135,135,21639
train,3690,28,28672,196,196,28868
train,3691,30,30720,204,204,30924
train,3692,14,14336,86,86,14422
train,3693,42,43008,294,294,43302
train,3694,14,14336,86,86,14422
train,3695,20,20480,144,144,20624
train,3696,20,20480,158,158,20638
train,3697,25,25600,161,161,25761
train,3698,13,13312,79,79,13391
train,3699,19,19456,121,121,19577
train,3700,17,17408,113,113,17521
train,3701,26,26624,170,170,26794
train,3702,38,38912,260,260,39172
train,3703,32,32768,232,232,33000
train,3704,20,20480,128,128,20608
train,3705,38,38912,260,260,39172
train,3706,16,16384,100,100,16484
train,3707,28,28672,210,210,28882
train,3708,14,14336,86,86,14422
train,3709,30,30720,218,218,30938
train,3710,33,33792,219,219,34011
train,3711,16,16384,100,100,16484
train,3712,13,13312,79,79,13391
train,3713,35,35840,241,241,36081
train,3714,25,25600,177,177,25777
train,3715,29,29696,197,197,29893
train,3716,18,18432,118,118,18550
train,3717,44,45056,332,332,45388
train,3718,22,22528,142,142,22670
train,3719,15,15360,93,93,15453
train,3720,22,22528,148,148,22676
train,3721,23,23552,159,159,23711
train,3722,13,13312,89,89,13401
train,3723,17,17408,107,107,17515
train,3724,20,20480,134,134,20614
train,3725,35,35840,249,249,36089
train,3726,29,29696,201,201,29897
train,3727,4,4096,16,16,4112
train,3728,9,9216,51,51,9267
train,3729,11,11264,65,65,11329
train,3730,38,38912,296,296,39208
train,3731,19,19456,131,131,19587
train,3732,16,16384,104,104,16488
train,3733,27,27648,177,177,27825
train,3734,29,29696,201,201,29897
train,3735,19,19456,127,127,19583
train,3736,42,43008,304,304,43312
train,3737,22,22528,160,160,22688
train,3738,24,24576,160,160,24736
train,3739,19,19456,137,137,19593
train,3740,18,18432,120,120,18552
train,3741,30,30720,206,206,30926
train,3742,26,26624,170,170,26794
train,3743,31,31744,211,211,31955
train,3744,41,41984,291,291,42275
train,3745,23,23552,149,149,23701
train,3746,28,28672,190,190,28862
train,3747,41,41984,275,275,42259
train,3748,11,11264,65,65,11329
train,3749,21,21504,143,143,21647
train,3750,10,10240,58,58,10298
train,3751,28,28672,200,200,28872
train,3752,35,35840,249,249,36089
train,3753,19,19456,125,125,19581
train,3754,20,20480,136,136,20616
train,3755,20,20480,128,128,20608
train,3756,19,19456,127,127,19583
train,3757,7,7168,37,37,7205
train,3758,9,9216,51,51,9267
train,3759,39,39936,301,301,40237
train,3760,12,12288,72,72,12360
train,3761,21,21504,141,141,21645
train,3762,9,9216,51,51,9267
train,3763,20,20480,134,134,20614
train,3764,9,9216,51,51,9267
train,3765,31,31744,211,211,31955
train,3766,33,33792,231,231,34023
train,3767,30,30720,204,204,30924
train,3768,20,20480,128,128,20608
train,3769,23,23552,171,171,23723
train,3770,9,9216,49,49,9265
train,3771,15,15360,93,93,15453
train,3772,28,28672,200,200,28872
train,3773,10,10240,60,60,10300
train,3774,12,12288,72,72,12360
train,3775,30,30720,204,204,30924
train,3776,24,24576,162,162,24738
train,3777,48,49152,340,340,49492
train,3778,48,49152,342,342,49494
train,3779,23,23552,155,155,23707
train,3780,26,26624,176,176,26800
train,3781,29,29696,205,205,29901
train,3782,28,28672,200,200,28872
train,3783,25,25600,163,163,25763
train,3784,44,45056,310,310,45366
train,3785,12,12288,72,72,12360
train,3786,16,16384,104,104,16488
train,3787,14,14336,84,84,14420
train,3788,28,28672,190,190,28862
train,3789,37,37888,269,269,38157
train,3790,17,17408,107,107,17515
train,3791,18,18432,120,120,18552
train,3792,13,13312,79,79,13391
train,3793,31,31744,245,245,31989
train,3794,28,28672,196,196,28868
train,3795,34,34816,242,242,35058
train,3796,22,22528,142,142,22670
train,3797,8,8192,44,44,8236
train,3798,15,15360,99,99,15459
train,3799,32,32768,224,224,32992
train,3800,15,15360,95,95,15455
train,3801,18,18432,120,120,18552
train,3802,18,18432,120,120,18552
train,3803,47,48128,355,355,48483
train,3804,18,18432,114,114,18546
train,3805,4,4096,16,16,4112
train,3806,23,23552,155,155,23707
train,3807,12,12288,72,72,12360
train,3808,10,10240,58,58,10298
train,3809,16,16384,104,104,16488
train,3810,26,26624,176,176,26800
train,3811,40,40960,272,272,41232
train,3812,21,21504,135,135,21639
train,3813,14,14336,86,86,14422
train,3814,17,17408,119,119,17527
train,3815,38,38912,262,262,39174
train,3816,29,29696,201,201,29897
train,3817,10,10240,58,58,10298
train,3818,7,7168,37,37,7205
train,3819,34,34816,242,242,35058
train,3820,24,24576,168,168,24744
train,3821,16,16384,100,100,16484
train,3822,14,14336,86,86,14422
train,3823,23,23552,145,145,23697
train,3824,22,22528,144,144,22672
train,3825,19,19456,121,121,19577
train,3826,18,18432,114,114,18546
train,3827,22,22528,158,158,22686
train,3828,22,22528,142,142,22670
train,3829,27,27648,183,183,27831
train,3830,17,17408,107,107,17515
train,3831,11,11264,65,65,11329
train,3832,17,17408,107,107,17515
train,3833,33,33792,241,241,34033
train,3834,16,16384,106,106,16490
train,3835,4,4096,16,16,4112
train,3836,12,12288,70,70,12358
train,3837,15,15360,93,93,15453
train,3838,43,44032,337,337,44369
train,3839,16,16384,104,104,16488
train,3840,23,23552,165,165,23717
train,3841,28,28672,204,204,28876
train,3842,28,28672,190,190,28862
train,3843,27,27648,183,183,27831
train,3844,33,33792,233,233,34025
train,3845,8,8192,44,44,8236
train,3846,26,26624,170,170,26794
train,3847,20,20480,130,130,20610
train,3848,46,47104,354,354,47458
train,3849,10,10240,58,58,10298
train,3850,25,25600,175,175,25775
train,3851,20,20480,132,132,20612
train,3852,21,21504,139,139,21643
train,3853,25,25600,173,173,25773
train,3854,11,11264,65,65,11329
train,3855,11,11264,63,63,11327
train,3856,24,24576,156,156,24732
train,3857,25,25600,165,165,25765
train,3858,20,20480,138,138,20618
train,3859,12,12288,72,72,12360
train,3860,23,23552,151,151,23703
train,3861,34,34816,246,246,35062
train,3862,25,25600,163,163,25763
train,3863,32,32768,220,220,32988
train,3864,14,14336,86,86,14422
train,3865,24,24576,162,162,24738
train,3866,36,36864,252,252,37116
train,3867,37,37888,253,253,38141
train,3868,28,28672,190,190,28862
train,3869,16,16384,100,100,16484
train,3870,34,34816,228,228,35044
train,3871,19,19456,127,127,19583
train,3872,12,12288,74,74,12362
train,3873,4,4096,16,16,4112
train,3874,6,6144,30,30,6174
train,3875,8,8192,44,44,8236
train,3876,17,17408,113,113,17521
train,3877,21,21504,141,141,21645
train,3878,10,10240,58,58,10298
train,3879,24,24576,172,172,24748
train,3880,7,7168,37,37,7205
train,3881,16,16384,100,100,16484
train,3882,3,3072,9,9,3081
train,3883,22,22528,154,154,22682
train,3884,30,30720,204,204,30924
train,3885,27,27648,183,183,27831
train,3886,16,16384,100,100,16484
train,3887,30,30720,220,220,30940
train,3888,28,28672,208,208,28880
train,3889,18,18432,120,120,18552
train,3890,19,19456,121,121,19577
train,3891,13,13312,79,79,13391
train,3892,16,16384,110,110,16494
train,3893,6,6144,30,30,6174
train,3894,19,19456,121,121,19577
train,3895,33,33792,249,249,34041
train,3896,40,40960,294,294,41254
train,3897,10,10240,56,56,10296
train,3898,27,27648,183,183,27831
train,3899,21,21504,135,135,21639
train,3900,5,5120,23,23,5143
train,3901,24,24576,162,162,24738
train,3902,22,22528,148,148,22676
train,3903,16,16384,100,100,16484
train,3904,21,21504,135,135,21639
train,3905,8,8192,44,44,8236
train,3906,22,22528,142,142,22670
train,3907,9,9216,51,51,9267
train,3908,26,26624,180,180,26804
train,3909,6,6144,30,30,6174
train,3910,18,18432,116,116,18548
train,3911,13,13312,79,79,13391
train,3912,26,26624,180,180,26804
train,3913,6,6144,30,30,6174
train,3914,22,22528,142,142,22670
train,3915,26,26624,176,176,26800
train,3916,11,11264,65,65,11329
train,3917,25,25600,163,163,25763
train,3918,12,12288,74,74,12362
train,3919,26,26624,182,182,26806
train,3920,6,6144,30,30,6174
train,3921,30,30720,208,208,30928
train,3922,14,14336,86,86,14422
train,3923,34,34816,238,238,35054
train,3924,16,16384,110,110,16494
train,3925,28,28672,212,212,28884
train,3926,35,35840,267,267,36107
train,3927,13,13312,79,79,13391
train,3928,20,20480,132,132,20612
train,3929,9,9216,51,51,9267
train,3930,29,29696,193,193,29889
train,3931,26,26624,182,182,26806
train,3932,7,7168,37,37,7205
train,3933,20,20480,128,128,20608
train,3934,27,27648,191,191,27839
train,3935,24,24576,156,156,24732
train,3936,27,27648,187,187,27835
train,3937,27,27648,185,185,27833
train,3938,16,16384,106,106,16490
train,3939,12,12288,72,72,12360
train,3940,31,31744,217,217,31961
train,3941,34,34816,228,228,35044
train,3942,17,17408,113,113,17521
train,3943,13,13312,79,79,13391
train,3944,31,31744,213,213,31957
train,3945,24,24576,156,156,24732
train,3946,25,25600,171,171,25771
train,3947,8,8192,42,42,8234
train,3948,9,9216,51,51,9267
train,3949,41,41984,299,299,42283
train,3950,31,31744,217,217,31961
train,3951,18,18432,114,114,18546
train,3952,21,21504,135,135,21639
train,3953,12,12288,72,72,12360
train,3954,23,23552,149,149,23701
train,3955,14,14336,86,86,14422
train,3956,18,18432,114,114,18546
train,3957,22,22528,140,140,22668
train,3958,34,34816,258,258,35074
train,3959,19,19456,121,121,19577
train,3960,23,23552,161,161,23713
train,3961,11,11264,65,65,11329
train,3962,18,18432,112,112,18544
train,3963,7,7168,37,37,7205
train,3964,31,31744,205,205,31949
train,3965,18,18432,120,120,18552
train,3966,36,36864,250,250,37114
train,3967,21,21504,141,141,21645
train,3968,14,14336,86,86,14422
train,3969,10,10240,58,58,10298
train,3970,34,34816,254,254,35070
train,3971,12,12288,72,72,12360
train,3972,32,32768,218,218,32986
train,3973,14,14336,92,92,14428
train,3974,24,24576,158,158,24734
train,3975,16,16384,106,106,16490
train,3976,42,43008,300,300,43308
train,3977,28,28672,218,218,28890
train,3978,27,27648,183,183,27831
train,3979,9,9216,51,51,9267
train,3980,22,22528,154,154,22682
train,3981,12,12288,72,72,12360
train,3982,29,29696,201,201,29897
train,3983,33,33792,227,227,34019
train,3984,31,31744,211,211,31955
train,3985,17,17408,113,113,17521
train,3986,30,30720,216,216,30936
train,3987,21,21504,145,145,21649
train,3988,28,28672,214,214,28886
train,3989,18,18432,114,114,18546
train,3990,30,30720,212,212,30932
train,3991,25,25600,179,179,25779
train,3992,32,32768,236,236,33004
train,3993,19,19456,119,119,19575
train,3994,22,22528,148,148,22676
train,3995,31,31744,215,215,31959
train,3996,37,37888,265,265,38153
train,3997,16,16384,100,100,16484
train,3998,23,23552,153,153,23705
train,3999,25,25600,181,181,25781
train,4000,10,10240,58,58,10298
train,4001,20,20480,128,128,20608
train,4002,30,30720,214,214,30934
train,4003,29,29696,191,191,29887
train,4004,14,14336,86,86,14422
train,4005,8,8192,44,44,8236
train,4006,23,23552,149,149,23701
train,4007,22,22528,142,142,22670
train,4008,32,32768,218,218,32986
train,4009,18,18432,114,114,18546
train,4010,21,21504,147,147,21651
train,4011,11,11264,65,65,11329
train,4012,5,5120,23,23,5143
train,4013,25,25600,167,167,25767
train,4014,25,25600,171,171,25771
train,4015,30,30720,212,212,30932
train,4016,26,26624,182,182,26806
train,4017,12,12288,72,72,12360
train,4018,13,13312,79,79,13391
train,4019,33,33792,231,231,34023
train,4020,34,34816,274,274,35090
train,4021,34,34816,248,248,35064
train,4022,27,27648,195,195,27843
train,4023,17,17408,113,113,17521
train,4024,38,38912,260,260,39172
train,4025,30,30720,228,228,30948
train,4026,27,27648,199,199,27847
train,4027,14,14336,86,86,14422
train,4028,23,23552,147,147,23699
train,4029,37,37888,267,267,38155
train,4030,13,13312,79,79,13391
train,4031,2,2048,4,4,2052
train,4032,14,14336,86,86,14422
train,4033,8,8192,44,44,8236
train,4034,46,47104,326,326,47430
train,4035,17,17408,121,121,17529
train,4036,33,33792,227,227,34019
train,4037,18,18432,114,114,18546
train,4038,27,27648,181,181,27829
train,4039,30,30720,204,204,30924
train,4040,19,19456,127,127,19583
train,4041,24,24576,160,160,24736
train,4042,4,4096,16,16,4112
train,4043,18,18432,128,128,18560
train,4044,21,21504,141,141,21645
train,4045,14,14336,86,86,14422
train,4046,18,18432,112,112,18544
train,4047,5,5120,23,23,5143
train,4048,8,8192,44,44,8236
train,4049,24,24576,160,160,24736
train,4050,21,21504,135,135,21639
train,4051,22,22528,148,148,22676
train,4052,9,9216,51,51,9267
train,4053,16,16384,100,100,16484
train,4054,25,25600,163,163,25763
train,4055,19,19456,127,127,19583
train,4056,11,11264,65,65,11329
train,4057,27,27648,177,177,27825
train,4058,18,18432,126,126,18558
train,4059,23,23552,153,153,23705
train,4060,7,7168,37,37,7205
train,4061,28,28672,186,186,28858
train,4062,22,22528,148,148,22676
train,4063,11,11264,65,65,11329
train,4064,19,19456,135,135,19591
train,4065,26,26624,168,168,26792
train,4066,11,11264,65,65,11329
train,4067,7,7168,37,37,7205
train,4068,42,43008,330,330,43338
train,4069,9,9216,51,51,9267
train,4070,11,11264,65,65,11329
train,4071,5,5120,23,23,5143
train,4072,17,17408,107,107,17515
train,4073,12,12288,72,72,12360
train,4074,23,23552,161,161,23713
train,4075,9,9216,49,49,9265
train,4076,29,29696,191,191,29887
train,4077,29,29696,215,215,29911
train,4078,11,11264,65,65,11329
train,4079,20,20480,134,134,20614
train,4080,15,15360,93,93,15453
train,4081,31,31744,215,215,31959
train,4082,35,35840,241,241,36081
train,4083,26,26624,188,188,26812
train,4084,20,20480,134,134,20614
train,4085,50,51200,356,356,51556
train,4086,31,31744,229,229,31973
train,4087,26,26624,184,184,26808
train,4088,25,25600,181,181,25781
train,4089,11,11264,65,65,11329
train,4090,12,12288,72,72,12360
train,4091,23,23552,155,155,23707
train,4092,21,21504,141,141,21645
train,4093,8,8192,44,44,8236
train,4094,31,31744,217,217,31961
train,4095,27,27648,175,175,27823
train,4096,8,8192,44,44,8236
train,4097,14,14336,86,86,14422
train,4098,29,29696,197,197,29893
train,4099,35,35840,255,255,36095
train,4100,33,33792,217,217,34009
train,4101,30,30720,228,228,30948
train,4102,3,3072,9,9,3081
train,4103,19,19456,139,139,19595
train,4104,33,33792,227,227,34019
train,4105,17,17408,107,107,17515
train,4106,2,2048,4,4,2052
train,4107,18,18432,118,118,18550
train,4108,12,12288,72,72,12360
train,4109,41,41984,311,311,42295
train,4110,25,25600,175,175,25775
train,4111,31,31744,217,217,31961
train,4112,26,26624,180,180,26804
train,4113,27,27648,187,187,27835
train,4114,8,8192,44,44,8236
train,4115,17,17408,107,107,17515
train,4116,30,30720,208,208,30928
train,4117,12,12288,72,72,12360
train,4118,33,33792,257,257,34049
train,4119,25,25600,175,175,25775
train,4120,11,11264,65,65,11329
train,4121,24,24576,156,156,24732
train,4122,35,35840,255,255,36095
train,4123,19,19456,123,123,19579
train,4124,18,18432,116,116,18548
train,4125,35,35840,245,245,36085
train,4126,14,14336,86,86,14422
train,4127,9,9216,51,51,9267
train,4128,26,26624,184,184,26808
train,4129,39,39936,273,273,40209
train,4130,37,37888,263,263,38151
train,4131,23,23552,155,155,23707
train,4132,12,12288,74,74,12362
train,4133,16,16384,98,98,16482
train,4134,22,22528,152,152,22680
train,4135,12,12288,72,72,12360
train,4136,24,24576,170,170,24746
train,4137,34,34816,232,232,35048
train,4138,24,24576,162,162,24738
train,4139,37,37888,277,277,38165
train,4140,11,11264,65,65,11329
train,4141,19,19456,121,121,19577
train,4142,31,31744,211,211,31955
train,4143,32,32768,248,248,33016
train,4144,9,9216,51,51,9267
train,4145,35,35840,255,255,36095
train,4146,11,11264,65,65,11329
train,4147,42,43008,306,306,43314
train,4148,26,26624,182,182,26806
train,4149,9,9216,49,49,9265
train,4150,28,28672,190,190,28862
train,4151,26,26624,170,170,26794
train,4152,27,27648,199,199,27847
train,4153,26,26624,190,190,26814
train,4154,38,38912,262,262,39174
train,4155,23,23552,155,155,23707
train,4156,16,16384,102,102,16486
train,4157,5,5120,23,23,5143
train,4158,8,8192,42,42,8234
train,4159,18,18432,114,114,18546
train,4160,12,12288,72,72,12360
train,4161,22,22528,146,146,22674
train,4162,15,15360,103,103,15463
train,4163,34,34816,260,260,35076
train,4164,22,22528,148,148,22676
train,4165,13,13312,79,79,13391
train,4166,14,14336,86,86,14422
train,4167,16,16384,100,100,16484
train,4168,20,20480,140,140,20620
train,4169,26,26624,172,172,26796
train,4170,25,25600,175,175,25775
train,4171,15,15360,93,93,15453
train,4172,33,33792,231,231,34023
train,4173,25,25600,173,173,25773
train,4174,29,29696,189,189,29885
train,4175,27,27648,187,187,27835
train,4176,35,35840,239,239,36079
train,4177,16,16384,100,100,16484
train,4178,29,29696,191,191,29887
train,4179,22,22528,148,148,22676
train,4180,20,20480,140,140,20620
train,4181,26,26624,184,184,26808
train,4182,19,19456,121,121,19577
train,4183,14,14336,88,88,14424
train,4184,12,12288,72,72,12360
train,4185,30,30720,198,198,30918
train,4186,27,27648,197,197,27845
train,4187,15,15360,93,93,15453
train,4188,17,17408,107,107,17515
train,4189,27,27648,195,195,27843
train,4190,34,34816,244,244,35060
train,4191,24,24576,162,162,24738
train,4192,19,19456,127,127,19583
train,4193,28,28672,200,200,28872
train,4194,30,30720,206,206,30926
train,4195,13,13312,77,77,13389
train,4196,21,21504,137,137,21641
train,4197,29,29696,209,209,29905
train,4198,40,40960,288,288,41248
train,4199,17,17408,107,107,17515
train,4200,10,10240,58,58,10298
train,4201,23,23552,149,149,23701
train,4202,16,16384,98,98,16482
train,4203,24,24576,166,166,24742
train,4204,31,31744,223,223,31967
train,4205,13,13312,79,79,13391
train,4206,14,14336,86,86,14422
train,4207,27,27648,185,185,27833
train,4208,42,43008,330,330,43338
train,4209,13,13312,79,79,13391
train,4210,39,39936,283,283,40219
train,4211,11,11264,65,65,11329
train,4212,30,30720,220,220,30940
train,4213,21,21504,135,135,21639
train,4214,28,28672,190,190,28862
train,4215,10,10240,58,58,10298
train,4216,27,27648,179,179,27827
train,4217,22,22528,172,172,22700
train,4218,6,6144,30,30,6174
train,4219,37,37888,259,259,38147
train,4220,25,25600,181,181,25781
train,4221,7,7168,37,37,7205
train,4222,20,20480,132,132,20612
train,4223,33,33792,245,245,34037
train,4224,19,19456,125,125,19581
train,4225,9,9216,51,51,9267
train,4226,40,40960,282,282,41242
train,4227,8,8192,46,46,8238
train,4228,16,16384,98,98,16482
train,4229,29,29696,207,207,29903
train,4230,25,25600,173,173,25773
train,4231,20,20480,128,128,20608
train,4232,16,16384,100,100,16484
train,4233,17,17408,107,107,17515
train,4234,18,18432,114,114,18546
train,4235,35,35840,239,239,36079
train,4236,19,19456,121,121,19577
train,4237,15,15360,93,93,15453
train,4238,22,22528,152,152,22680
train,4239,36,36864,256,256,37120
train,4240,18,18432,114,114,18546
train,4241,7,7168,37,37,7205
train,4242,13,13312,79,79,13391
train,4243,14,14336,84,84,14420
train,4244,19,19456,131,131,19587
train,4245,4,4096,16,16,4112
train,4246,27,27648,177,177,27825
train,4247,30,30720,198,198,30918
train,4248,6,6144,30,30,6174
train,4249,16,16384,106,106,16490
train,4250,25,25600,169,169,25769
train,4251,15,15360,99,99,15459
train,4252,22,22528,152,152,22680
train,4253,13,13312,79,79,13391
train,4254,6,6144,30,30,6174
train,4255,11,11264,65,65,11329
train,4256,23,23552,155,155,23707
train,4257,18,18432,114,114,18546
train,4258,26,26624,180,180,26804
train,4259,30,30720,230,230,30950
train,4260,8,8192,44,44,8236
train,4261,13,13312,79,79,13391
train,4262,8,8192,40,40,8232
train,4263,15,15360,93,93,15453
train,4264,9,9216,51,51,9267
train,4265,19,19456,121,121,19577
train,4266,15,15360,93,93,15453
train,4267,9,9216,51,51,9267
train,4268,17,17408,107,107,17515
train,4269,22,22528,142,142,22670
train,4270,19,19456,133,133,19589
train,4271,36,36864,270,270,37134
train,4272,12,12288,70,70,12358
train,4273,21,21504,145,145,21649
train,4274,20,20480,126,126,20606
train,4275,12,12288,72,72,12360
train,4276,29,29696,197,197,29893
train,4277,15,15360,93,93,15453
train,4278,41,41984,289,289,42273
train,4279,16,16384,112,112,16496
train,4280,14,14336,86,86,14422
train,4281,22,22528,142,142,22670
train,4282,3,3072,9,9,3081
train,4283,28,28672,198,198,28870
train,4284,19,19456,121,121,19577
train,4285,17,17408,117,117,17525
train,4286,17,17408,107,107,17515
train,4287,25,25600,191,191,25791
train,4288,17,17408,107,107,17515
train,4289,11,11264,69,69,11333
train,4290,23,23552,155,155,23707
train,4291,9,9216,51,51,9267
train,4292,3,3072,9,9,3081
train,4293,28,28672,190,190,28862
train,4294,33,33792,231,231,34023
train,4295,7,7168,37,37,7205
train,4296,20,20480,128,128,20608
train,4297,11,11264,65,65,11329
train,4298,24,24576,170,170,24746
train,4299,16,16384,106,106,16490
train,4300,2,2048,4,4,2052
train,4301,17,17408,125,125,17533
train,4302,36,36864,252,252,37116
train,4303,23,23552,149,149,23701
train,4304,13,13312,85,85,13397
train,4305,23,23552,147,147,23699
train,4306,39,39936,285,285,40221
train,4307,6,6144,30,30,6174
train,4308,13,13312,79,79,13391
train,4309,43,44032,307,307,44339
train,4310,25,25600,163,163,25763
train,4311,30,30720,204,204,30924
train,4312,29,29696,203,203,29899
train,4313,16,16384,100,100,16484
train,4314,27,27648,177,177,27825
train,4315,28,28672,186,186,28858
train,4316,16,16384,100,100,16484
train,4317,14,14336,92,92,14428
train,4318,15,15360,93,93,15453
train,4319,24,24576,156,156,24732
train,4320,31,31744,221,221,31965
train,4321,14,14336,86,86,14422
train,4322,5,5120,23,23,5143
train,4323,19,19456,121,121,19577
train,4324,17,17408,109,109,17517
train,4325,7,7168,37,37,7205
train,4326,10,10240,58,58,10298
train,4327,13,13312,79,79,13391
train,4328,35,35840,233,233,36073
train,4329,24,24576,172,172,24748
train,4330,8,8192,44,44,8236
train,4331,22,22528,142,142,22670
train,4332,36,36864,262,262,37126
train,4333,29,29696,203,203,29899
train,4334,8,8192,44,44,8236
train,4335,18,18432,114,114,18546
train,4336,6,6144,30,30,6174
train,4337,35,35840,243,243,36083
train,4338,35,35840,245,245,36085
train,4339,31,31744,217,217,31961
train,4340,11,11264,65,65,11329
train,4341,19,19456,121,121,19577
train,4342,27,27648,183,183,27831
train,4343,9,9216,51,51,9267
train,4344,27,27648,211,211,27859
train,4345,8,8192,44,44,8236
train,4346,28,28672,198,198,28870
train,4347,22,22528,142,142,22670
train,4348,43,44032,317,317,44349
train,4349,18,18432,114,114,18546
train,4350,35,35840,241,241,36081
train,4351,24,24576,166,166,24742
train,4352,17,17408,117,117,17525
train,4353,30,30720,226,226,30946
train,4354,43,44032,323,323,44355
train,4355,16,16384,100,100,16484
train,4356,13,13312,75,75,13387
train,4357,28,28672,202,202,28874
train,4358,19,19456,133,133,19589
train,4359,25,25600,169,169,25769
train,4360,27,27648,193,193,27841
train,4361,9,9216,51,51,9267
train,4362,15,15360,93,93,15453
train,4363,21,21504,157,157,21661
train,4364,25,25600,169,169,25769
train,4365,12,12288,72,72,12360
train,4366,22,22528,148,148,22676
train,4367,8,8192,44,44,8236
train,4368,38,38912,274,274,39186
train,4369,17,17408,107,107,17515
train,4370,2,2048,4,4,2052
train,4371,17,17408,105,105,17513
train,4372,6,6144,30,30,6174
train,4373,29,29696,191,191,29887
train,4374,13,13312,79,79,13391
train,4375,30,30720,202,202,30922
train,4376,28,28672,184,184,28856
train,4377,27,27648,181,181,27829
train,4378,27,27648,175,175,27823
train,4379,7,7168,37,37,7205
train,4380,24,24576,162,162,24738
train,4381,7,7168,37,37,7205
train,4382,14,14336,88,88,14424
train,4383,12,12288,78,78,12366
train,4384,23,23552,155,155,23707
train,4385,23,23552,149,149,23701
train,4386,22,22528,156,156,22684
train,4387,29,29696,191,191,29887
train,4388,7,7168,37,37,7205
train,4389,19,19456,127,127,19583
train,4390,27,27648,183,183,27831
train,4391,36,36864,278,278,37142
train,4392,35,35840,239,239,36079
train,4393,20,20480,140,140,20620
train,4394,28,28672,188,188,28860
train,4395,13,13312,79,79,13391
train,4396,13,13312,89,89,13401
train,4397,17,17408,121,121,17529
train,4398,30,30720,204,204,30924
train,4399,36,36864,250,250,37114
train,4400,25,25600,175,175,25775
train,4401,15,15360,93,93,15453
train,4402,13,13312,79,79,13391
train,4403,4,4096,16,16,4112
train,4404,31,31744,223,223,31967
train,4405,10,10240,62,62,10302
train,4406,28,28672,200,200,28872
train,4407,14,14336,86,86,14422
train,4408,31,31744,205,205,31949
train,4409,16,16384,106,106,16490
train,4410,19,19456,121,121,19577
train,4411,17,17408,109,109,17517
train,4412,22,22528,148,148,22676
train,4413,19,19456,121,121,19577
train,4414,17,17408,107,107,17515
train,4415,35,35840,235,235,36075
train,4416,17,17408,107,107,17515
train,4417,27,27648,177,177,27825
train,4418,9,9216,51,51,9267
train,4419,9,9216,51,51,9267
train,4420,38,38912,296,296,39208
train,4421,41,41984,291,291,42275
train,4422,36,36864,246,246,37110
train,4423,23,23552,159,159,23711
train,4424,11,11264,65,65,11329
train,4425,16,16384,104,104,16488
train,4426,26,26624,182,182,26806
train,4427,12,12288,78,78,12366
train,4428,13,13312,83,83,13395
train,4429,19,19456,121,121,19577
train,4430,17,17408,107,107,17515
train,4431,20,20480,138,138,20618
train,4432,27,27648,191,191,27839
train,4433,21,21504,135,135,21639
train,4434,14,14336,86,86,14422
train,4435,20,20480,128,128,20608
train,4436,12,12288,72,72,12360
train,4437,27,27648,193,193,27841
train,4438,22,22528,148,148,22676
train,4439,18,18432,124,124,18556
train,4440,51,52224,383,383,52607
train,4441,19,19456,121,121,19577
train,4442,17,17408,103,103,17511
train,4443,29,29696,199,199,29895
train,4444,23,23552,161,161,23713
train,4445,32,32768,216,216,32984
train,4446,23,23552,155,155,23707
train,4447,25,25600,163,163,25763
train,4448,8,8192,44,44,8236
train,4449,39,39936,287,287,40223
train,4450,15,15360,93,93,15453
train,4451,25,25600,175,175,25775
train,4452,23,23552,149,149,23701
train,4453,22,22528,150,150,22678
train,4454,14,14336,86,86,14422
train,4455,41,41984,307,307,42291
train,4456,22,22528,144,144,22672
train,4457,21,21504,147,147,21651
train,4458,26,26624,176,176,26800
train,4459,21,21504,139,139,21643
train,4460,18,18432,120,120,18552
train,4461,51,52224,371,371,52595
train,4462,18,18432,124,124,18556
train,4463,21,21504,149,149,21653
train,4464,14,14336,86,86,14422
train,4465,7,7168,35,35,7203
train,4466,31,31744,211,211,31955
train,4467,30,30720,210,210,30930
train,4468,17,17408,107,107,17515
train,4469,24,24576,162,162,24738
train,4470,24,24576,156,156,24732
train,4471,21,21504,145,145,21649
train,4472,12,12288,72,72,12360
train,4473,21,21504,141,141,21645
train,4474,10,10240,58,58,10298
train,4475,17,17408,113,113,17521
train,4476,29,29696,199,199,29895
train,4477,10,10240,58,58,10298
train,4478,24,24576,164,164,24740
train,4479,20,20480,128,128,20608
train,4480,10,10240,58,58,10298
train,4481,14,14336,86,86,14422
train,4482,31,31744,223,223,31967
train,4483,12,12288,72,72,12360
train,4484,11,11264,65,65,11329
train,4485,23,23552,149,149,23701
train,4486,20,20480,138,138,20618
train,4487,29,29696,209,209,29905
train,4488,17,17408,107,107,17515
train,4489,23,23552,157,157,23709
train,4490,30,30720,210,210,30930
train,4491,11,11264,63,63,11327
train,4492,21,21504,151,151,21655
train,4493,13,13312,79,79,13391
train,4494,8,8192,44,44,8236
train,4495,24,24576,156,156,24732
train,4496,18,18432,130,130,18562
train,4497,20,20480,134,134,20614
train,4498,34,34816,238,238,35054
train,4499,24,24576,162,162,24738
train,4500,17,17408,107,107,17515
train,4501,24,24576,156,156,24732
train,4502,4,4096,16,16,4112
train,4503,35,35840,253,253,36093
train,4504,9,9216,51,51,9267
train,4505,27,27648,177,177,27825
train,4506,5,5120,23,23,5143
train,4507,14,14336,86,86,14422
train,4508,16,16384,100,100,16484
train,4509,17,17408,107,107,17515
train,4510,5,5120,23,23,5143
train,4511,31,31744,211,211,31955
train,4512,38,38912,274,274,39186
train,4513,17,17408,109,109,17517
train,4514,25,25600,163,163,25763
train,4515,7,7168,37,37,7205
train,4516,7,7168,37,37,7205
train,4517,17,17408,107,107,17515
train,4518,12,12288,72,72,12360
train,4519,27,27648,199,199,27847
train,4520,37,37888,293,293,38181
train,4521,28,28672,196,196,28868
train,4522,19,19456,121,121,19577
train,4523,29,29696,191,191,29887
train,4524,24,24576,172,172,24748
train,4525,17,17408,105,105,17513
train,4526,19,19456,121,121,19577
train,4527,21,21504,135,135,21639
train,4528,34,34816,232,232,35048
train,4529,7,7168,37,37,7205
train,4530,24,24576,156,156,24732
train,4531,15,15360,99,99,15459
train,4532,32,32768,222,222,32990
train,4533,18,18432,118,118,18550
train,4534,34,34816,242,242,35058
train,4535,9,9216,51,51,9267
train,4536,5,5120,23,23,5143
train,4537,8,8192,44,44,8236
train,4538,15,15360,95,95,15455
train,4539,24,24576,160,160,24736
train,4540,19,19456,121,121,19577
train,4541,24,24576,172,172,24748
train,4542,42,43008,318,318,43326
train,4543,17,17408,107,107,17515
train,4544,24,24576,168,168,24744
train,4545,11,11264,67,67,11331
train,4546,24,24576,164,164,24740
train,4547,28,28672,184,184,28856
train,4548,25,25600,163,163,25763
train,4549,20,20480,136,136,20616
train,4550,19,19456,121,121,19577
train,4551,40,40960,284,284,41244
train,4552,14,14336,86,86,14422
train,4553,27,27648,181,181,27829
train,4554,16,16384,106,106,16490
train,4555,34,34816,230,230,35046
train,4556,21,21504,149,149,21653
train,4557,25,25600,163,163,25763
train,4558,35,35840,247,247,36087
train,4559,13,13312,79,79,13391
train,4560,31,31744,219,219,31963
train,4561,18,18432,114,114,18546
train,4562,22,22528,178,178,22706
train,4563,3,3072,9,9,3081
train,4564,32,32768,228,228,32996
train,4565,7,7168,37,37,7205
train,4566,28,28672,190,190,28862
train,4567,25,25600,163,163,25763
train,4568,23,23552,157,157,23709
train,4569,25,25600,169,169,25769
train,4570,29,29696,197,197,29893
train,4571,14,14336,86,86,14422
train,4572,20,20480,128,128,20608
train,4573,18,18432,122,122,18554
train,4574,25,25600,177,177,25777
train,4575,31,31744,217,217,31961
train,4576,22,22528,144,144,22672
train,4577,29,29696,199,199,29895
train,4578,37,37888,271,271,38159
train,4579,22,22528,152,152,22680
train,4580,13,13312,79,79,13391
train,4581,30,30720,206,206,30926
train,4582,19,19456,127,127,19583
train,4583,16,16384,106,106,16490
train,4584,21,21504,137,137,21641
train,4585,25,25600,171,171,25771
train,4586,11,11264,65,65,11329
train,4587,33,33792,225,225,34017
train,4588,34,34816,240,240,35056
train,4589,31,31744,211,211,31955
train,4590,21,21504,141,141,21645
train,4591,8,8192,44,44,8236
train,4592,9,9216,51,51,9267
train,4593,28,28672,190,190,28862
train,4594,25,25600,169,169,25769
train,4595,17,17408,107,107,17515
train,4596,11,11264,65,65,11329
train,4597,20,20480,126,126,20606
train,4598,4,4096,16,16,4112
train,4599,9,9216,51,51,9267
train,4600,34,34816,232,232,35048
train,4601,5,5120,23,23,5143
train,4602,34,34816,234,234,35050
train,4603,14,14336,86,86,14422
train,4604,17,17408,105,105,17513
train,4605,10,10240,58,58,10298
train,4606,20,20480,134,134,20614
train,4607,33,33792,225,225,34017
train,4608,29,29696,221,221,29917
train,4609,4,4096,16,16,4112
train,4610,25,25600,163,163,25763
train,4611,7,7168,37,37,7205
train,4612,21,21504,135,135,21639
train,4613,33,33792,229,229,34021
train,4614,16,16384,100,100,16484
train,4615,19,19456,127,127,19583
train,4616,23,23552,155,155,23707
train,4617,37,37888,253,253,38141
train,4618,21,21504,137,137,21641
train,4619,26,26624,170,170,26794
train,4620,28,28672,196,196,28868
train,4621,12,12288,72,72,12360
train,4622,18,18432,114,114,18546
train,4623,6,6144,30,30,6174
train,4624,34,34816,250,250,35066
train,4625,29,29696,197,197,29893
train,4626,22,22528,154,154,22682
train,4627,18,18432,120,120,18552
train,4628,35,35840,233,233,36073
train,4629,33,33792,255,255,34047
train,4630,20,20480,128,128,20608
train,4631,28,28672,190,190,28862
train,4632,37,37888,269,269,38157
train,4633,22,22528,142,142,22670
train,4634,21,21504,135,135,21639
train,4635,15,15360,93,93,15453
train,4636,27,27648,187,187,27835
train,4637,13,13312,79,79,13391
train,4638,7,7168,37,37,7205
train,4639,34,34816,240,240,35056
train,4640,8,8192,44,44,8236
train,4641,23,23552,149,149,23701
train,4642,8,8192,44,44,8236
train,4643,23,23552,153,153,23705
train,4644,7,7168,37,37,7205
train,4645,24,24576,162,162,24738
train,4646,16,16384,100,100,16484
train,4647,8,8192,44,44,8236
train,4648,17,17408,117,117,17525
train,4649,20,20480,128,128,20608
train,4650,20,20480,134,134,20614
train,4651,27,27648,195,195,27843
train,4652,36,36864,258,258,37122
train,4653,8,8192,44,44,8236
train,4654,11,11264,65,65,11329
train,4655,30,30720,208,208,30928
train,4656,21,21504,133,133,21637
train,4657,10,10240,58,58,10298
train,4658,24,24576,176,176,24752
train,4659,17,17408,107,107,17515
train,4660,22,22528,142,142,22670
train,4661,14,14336,88,88,14424
train,4662,17,17408,107,107,17515
train,4663,20,20480,138,138,20618
train,4664,32,32768,228,228,32996
train,4665,25,25600,173,173,25773
train,4666,13,13312,79,79,13391
train,4667,13,13312,79,79,13391
train,4668,24,24576,156,156,24732
train,4669,40,40960,292,292,41252
train,4670,17,17408,117,117,17525
train,4671,15,15360,97,97,15457
train,4672,15,15360,103,103,15463
train,4673,23,23552,155,155,23707
train,4674,8,8192,42,42,8234
train,4675,30,30720,204,204,30924
train,4676,4,4096,16,16,4112
train,4677,31,31744,227,227,31971
train,4678,11,11264,65,65,11329
train,4679,39,39936,283,283,40219
train,4680,23,23552,145,145,23697
train,4681,16,16384,100,100,16484
train,4682,21,21504,135,135,21639
train,4683,8,8192,44,44,8236
train,4684,11,11264,65,65,11329
train,4685,19,19456,123,123,19579
train,4686,10,10240,58,58,10298
train,4687,24,24576,168,168,24744
train,4688,11,11264,65,65,11329
train,4689,16,16384,106,106,16490
train,4690,24,24576,172,172,24748
train,4691,22,22528,142,142,22670
train,4692,23,23552,155,155,23707
train,4693,41,41984,281,281,42265
train,4694,18,18432,120,120,18552
train,4695,21,21504,141,141,21645
train,4696,25,25600,163,163,25763
train,4697,34,34816,250,250,35066
train,4698,19,19456,127,127,19583
train,4699,23,23552,155,155,23707
train,4700,21,21504,135,135,21639
train,4701,25,25600,169,169,25769
train,4702,10,10240,58,58,10298
train,4703,11,11264,65,65,11329
train,4704,37,37888,271,271,38159
train,4705,16,16384,108,108,16492
train,4706,19,19456,127,127,19583
train,4707,42,43008,288,288,43296
train,4708,35,35840,259,259,36099
train,4709,18,18432,114,114,18546
train,4710,11,11264,65,65,11329
train,4711,22,22528,142,142,22670
train,4712,21,21504,133,133,21637
train,4713,14,14336,86,86,14422
train,4714,23,23552,155,155,23707
train,4715,27,27648,201,201,27849
train,4716,11,11264,65,65,11329
train,4717,15,15360,97,97,15457
train,4718,30,30720,204,204,30924
train,4719,20,20480,134,134,20614
train,4720,38,38912,274,274,39186
train,4721,8,8192,44,44,8236
train,4722,21,21504,135,135,21639
train,4723,15,15360,93,93,15453
train,4724,24,24576,194,194,24770
train,4725,28,28672,206,206,28878
train,4726,3,3072,9,9,3081
train,4727,8,8192,44,44,8236
train,4728,24,24576,156,156,24732
train,4729,20,20480,136,136,20616
train,4730,17,17408,113,113,17521
train,4731,21,21504,135,135,21639
train,4732,28,28672,196,196,28868
train,4733,31,31744,225,225,31969
train,4734,15,15360,99,99,15459
train,4735,10,10240,58,58,10298
train,4736,9,9216,51,51,9267
train,4737,26,26624,176,176,26800
train,4738,44,45056,338,338,45394
train,4739,37,37888,259,259,38147
train,4740,11,11264,65,65,11329
train,4741,14,14336,86,86,14422
train,4742,33,33792,265,265,34057
train,4743,26,26624,182,182,26806
train,4744,23,23552,151,151,23703
train,4745,22,22528,142,142,22670
train,4746,20,20480,128,128,20608
train,4747,43,44032,323,323,44355
train,4748,23,23552,149,149,23701
train,4749,31,31744,225,225,31969
train,4750,36,36864,270,270,37134
train,4751,11,11264,65,65,11329
train,4752,16,16384,100,100,16484
train,4753,7,7168,35,35,7203
train,4754,20,20480,128,128,20608
train,4755,41,41984,285,285,42269
train,4756,20,20480,138,138,20618
train,4757,37,37888,271,271,38159
train,4758,16,16384,106,106,16490
train,4759,16,16384,100,100,16484
train,4760,22,22528,142,142,22670
train,4761,30,30720,200,200,30920
train,4762,14,14336,86,86,14422
train,4763,14,14336,88,88,14424
train,4764,21,21504,145,145,21649
train,4765,36,36864,246,246,37110
train,4766,19,19456,133,133,19589
train,4767,22,22528,142,142,22670
train,4768,20,20480,144,144,20624
train,4769,38,38912,270,270,39182
train,4770,20,20480,128,128,20608
train,4771,13,13312,79,79,13391
train,4772,9,9216,51,51,9267
train,4773,42,43008,302,302,43310
train,4774,16,16384,100,100,16484
train,4775,33,33792,239,239,34031
train,4776,32,32768,224,224,32992
train,4777,17,17408,111,111,17519
train,4778,13,13312,79,79,13391
train,4779,19,19456,121,121,19577
train,4780,11,11264,65,65,11329
train,4781,16,16384,100,100,16484
train,4782,12,12288,72,72,12360
train,4783,14,14336,86,86,14422
train,4784,15,15360,101,101,15461
train,4785,13,13312,79,79,13391
train,4786,13,13312,83,83,13395
train,4787,23,23552,161,161,23713
train,4788,38,38912,314,314,39226
train,4789,24,24576,172,172,24748
train,4790,19,19456,139,139,19595
train,4791,31,31744,211,211,31955
train,4792,26,26624,184,184,26808
train,4793,22,22528,150,150,22678
train,4794,37,37888,253,253,38141
train,4795,24,24576,156,156,24732
train,4796,20,20480,128,128,20608
train,4797,11,11264,65,65,11329
train,4798,18,18432,124,124,18556
train,4799,24,24576,162,162,24738
train,4800,24,24576,156,156,24732
train,4801,9,9216,53,53,9269
train,4802,33,33792,229,229,34021
train,4803,5,5120,23,23,5143
train,4804,6,6144,30,30,6174
train,4805,15,15360,99,99,15459
train,4806,27,27648,177,177,27825
train,4807,6,6144,30,30,6174
train,4808,14,14336,86,86,14422
train,4809,22,22528,150,150,22678
train,4810,16,16384,100,100,16484
train,4811,28,28672,194,194,28866
train,4812,32,32768,234,234,33002
train,4813,15,15360,93,93,15453
train,4814,7,7168,37,37,7205
train,4815,24,24576,162,162,24738
train,4816,25,25600,175,175,25775
train,4817,30,30720,208,208,30928
train,4818,26,26624,176,176,26800
train,4819,17,17408,107,107,17515
train,4820,12,12288,72,72,12360
train,4821,25,25600,173,173,25773
train,4822,22,22528,144,144,22672
train,4823,34,34816,236,236,35052
train,4824,11,11264,65,65,11329
train,4825,37,37888,247,247,38135
train,4826,19,19456,121,121,19577
train,4827,20,20480,134,134,20614
train,4828,24,24576,158,158,24734
train,4829,45,46080,323,323,46403
train,4830,18,18432,114,114,18546
train,4831,25,25600,173,173,25773
train,4832,33,33792,229,229,34021
train,4833,15,15360,93,93,15453
train,4834,21,21504,135,135,21639
train,4835,7,7168,37,37,7205
train,4836,16,16384,100,100,16484
train,4837,24,24576,162,162,24738
train,4838,15,15360,93,93,15453
train,4839,14,14336,92,92,14428
train,4840,8,8192,44,44,8236
train,4841,7,7168,37,37,7205
train,4842,15,15360,93,93,15453
train,4843,25,25600,163,163,25763
train,4844,23,23552,149,149,23701
train,4845,29,29696,197,197,29893
train,4846,28,28672,210,210,28882
train,4847,19,19456,121,121,19577
train,4848,22,22528,148,148,22676
train,4849,15,15360,93,93,15453
train,4850,32,32768,228,228,32996
train,4851,15,15360,99,99,15459
train,4852,24,24576,166,166,24742
train,4853,42,43008,298,298,43306
train,4854,18,18432,124,124,18556
train,4855,17,17408,113,113,17521
train,4856,28,28672,204,204,28876
train,4857,17,17408,107,107,17515
train,4858,28,28672,194,194,28866
train,4859,11,11264,65,65,11329
train,4860,13,13312,81,81,13393
train,4861,13,13312,85,85,13397
train,4862,23,23552,161,161,23713
train,4863,15,15360,97,97,15457
train,4864,18,18432,120,120,18552
train,4865,25,25600,163,163,25763
train,4866,10,10240,58,58,10298
train,4867,39,39936,261,261,40197
train,4868,20,20480,128,128,20608
train,4869,44,45056,322,322,45378
train,4870,24,24576,176,176,24752
train,4871,12,12288,78,78,12366
train,4872,12,12288,72,72,12360
train,4873,25,25600,163,163,25763
train,4874,10,10240,56,56,10296
train,4875,9,9216,51,51,9267
train,4876,24,24576,156,156,24732
train,4877,17,17408,107,107,17515
train,4878,14,14336,86,86,14422
train,4879,21,21504,141,141,21645
train,4880,30,30720,204,204,30924
train,4881,25,25600,175,175,25775
train,4882,14,14336,90,90,14426
train,4883,36,36864,264,264,37128
train,4884,18,18432,114,114,18546
train,4885,6,6144,30,30,6174
train,4886,23,23552,155,155,23707
train,4887,13,13312,81,81,13393
train,4888,20,20480,134,134,20614
train,4889,23,23552,153,153,23705
train,4890,8,8192,44,44,8236
train,4891,25,25600,163,163,25763
train,4892,24,24576,174,174,24750
train,4893,7,7168,37,37,7205
train,4894,29,29696,201,201,29897
train,4895,29,29696,199,199,29895
train,4896,14,14336,84,84,14420
train,4897,23,23552,155,155,23707
train,4898,34,34816,226,226,35042
train,4899,35,35840,257,257,36097
train,4900,29,29696,189,189,29885
train,4901,19,19456,121,121,19577
train,4902,16,16384,100,100,16484
train,4903,16,16384,100,100,16484
train,4904,12,12288,72,72,12360
train,4905,10,10240,58,58,10298
train,4906,27,27648,177,177,27825
train,4907,16,16384,100,100,16484
train,4908,26,26624,184,184,26808
train,4909,39,39936,271,271,40207
train,4910,23,23552,161,161,23713
train,4911,20,20480,134,134,20614
train,4912,34,34816,244,244,35060
train,4913,44,45056,314,314,45370
train,4914,6,6144,30,30,6174
train,4915,26,26624,176,176,26800
train,4916,9,9216,51,51,9267
train,4917,4,4096,16,16,4112
train,4918,27,27648,183,183,27831
train,4919,23,23552,167,167,23719
train,4920,38,38912,326,326,39238
train,4921,27,27648,183,183,27831
train,4922,25,25600,167,167,25767
train,4923,24,24576,162,162,24738
train,4924,36,36864,258,258,37122
train,4925,16,16384,100,100,16484
train,4926,8,8192,44,44,8236
train,4927,35,35840,253,253,36093
train,4928,19,19456,127,127,19583
train,4929,16,16384,100,100,16484
train,4930,16,16384,100,100,16484
train,4931,30,30720,198,198,30918
train,4932,9,9216,51,51,9267
train,4933,22,22528,142,142,22670
train,4934,11,11264,65,65,11329
train,4935,15,15360,103,103,15463
train,4936,32,32768,222,222,32990
train,4937,3,3072,9,9,3081
train,4938,12,12288,72,72,12360
train,4939,22,22528,142,142,22670
train,4940,19,19456,121,121,19577
train,4941,29,29696,193,193,29889
train,4942,18,18432,114,114,18546
train,4943,31,31744,213,213,31957
train,4944,17,17408,119,119,17527
train,4945,20,20480,128,128,20608
train,4946,21,21504,145,145,21649
train,4947,17,17408,107,107,17515
train,4948,19,19456,127,127,19583
train,4949,19,19456,121,121,19577
train,4950,28,28672,190,190,28862
train,4951,9,9216,51,51,9267
train,4952,14,14336,86,86,14422
train,4953,14,14336,86,86,14422
train,4954,20,20480,132,132,20612
train,4955,13,13312,79,79,13391
train,4956,24,24576,162,162,24738
train,4957,22,22528,146,146,22674
train,4958,24,24576,162,162,24738
train,4959,6,6144,30,30,6174
train,4960,8,8192,44,44,8236
train,4961,10,10240,58,58,10298
train,4962,20,20480,140,140,20620
train,4963,27,27648,179,179,27827
train,4964,26,26624,170,170,26794
train,4965,20,20480,144,144,20624
train,4966,20,20480,134,134,20614
train,4967,27,27648,179,179,27827
train,4968,26,26624,170,170,26794
train,4969,20,20480,136,136,20616
train,4970,38,38912,262,262,39174
train,4971,19,19456,127,127,19583
train,4972,24,24576,180,180,24756
train,4973,32,32768,216,216,32984
train,4974,22,22528,140,140,22668
train,4975,8,8192,44,44,8236
train,4976,32,32768,228,228,32996
train,4977,17,17408,107,107,17515
train,4978,18,18432,116,116,18548
train,4979,20,20480,130,130,20610
train,4980,25,25600,179,179,25779
train,4981,10,10240,58,58,10298
train,4982,31,31744,203,203,31947
train,4983,7,7168,37,37,7205
train,4984,16,16384,100,100,16484
train,4985,17,17408,107,107,17515
train,4986,18,18432,120,120,18552
train,4987,26,26624,182,182,26806
train,4988,24,24576,164,164,24740
train,4989,16,16384,100,100,16484
train,4990,27,27648,191,191,27839
train,4991,24,24576,168,168,24744
train,4992,19,19456,127,127,19583
train,4993,37,37888,259,259,38147
train,4994,13,13312,101,101,13413
train,4995,28,28672,182,182,28854
train,4996,23,23552,155,155,23707
train,4997,25,25600,177,177,25777
train,4998,12,12288,72,72,12360
train,4999,43,44032,319,319,44351
train,5000,35,35840,247,247,36087
train,5001,4,4096,16,16,4112
train,5002,22,22528,148,148,22676
train,5003,12,12288,72,72,12360
train,5004,16,16384,100,100,16484
train,5005,34,34816,260,260,35076
train,5006,6,6144,30,30,6174
train,5007,6,6144,30,30,6174
train,5008,27,27648,191,191,27839
train,5009,11,11264,65,65,11329
train,5010,27,27648,189,189,27837
train,5011,13,13312,79,79,13391
train,5012,20,20480,126,126,20606
train,5013,29,29696,201,201,29897
train,5014,15,15360,93,93,15453
train,5015,18,18432,112,112,18544
train,5016,9,9216,51,51,9267
train,5017,6,6144,30,30,6174
train,5018,18,18432,114,114,18546
train,5019,27,27648,197,197,27845
train,5020,10,10240,58,58,10298
train,5021,37,37888,247,247,38135
train,5022,27,27648,193,193,27841
train,5023,24,24576,168,168,24744
train,5024,16,16384,100,100,16484
train,5025,15,15360,99,99,15459
train,5026,30,30720,198,198,30918
train,5027,8,8192,44,44,8236
train,5028,19,19456,121,121,19577
train,5029,18,18432,120,120,18552
train,5030,20,20480,134,134,20614
train,5031,20,20480,132,132,20612
train,5032,19,19456,125,125,19581
train,5033,13,13312,79,79,13391
train,5034,40,40960,302,302,41262
train,5035,29,29696,205,205,29901
train,5036,21,21504,139,139,21643
train,5037,28,28672,184,184,28856
train,5038,9,9216,51,51,9267
train,5039,18,18432,114,114,18546
train,5040,27,27648,187,187,27835
train,5041,24,24576,180,180,24756
train,5042,24,24576,156,156,24732
train,5043,42,43008,308,308,43316
train,5044,8,8192,44,44,8236
train,5045,27,27648,179,179,27827
train,5046,34,34816,242,242,35058
train,5047,8,8192,44,44,8236
train,5048,15,15360,93,93,15453
train,5049,14,14336,86,86,14422
train,5050,6,6144,30,30,6174
train,5051,21,21504,147,147,21651
train,5052,15,15360,91,91,15451
train,5053,13,13312,85,85,13397
train,5054,22,22528,142,142,22670
train,5055,24,24576,178,178,24754
train,5056,41,41984,291,291,42275
train,5057,31,31744,239,239,31983
train,5058,18,18432,114,114,18546
train,5059,21,21504,135,135,21639
train,5060,14,14336,86,86,14422
train,5061,40,40960,278,278,41238
train,5062,26,26624,186,186,26810
train,5063,12,12288,72,72,12360
train,5064,47,48128,347,347,48475
train,5065,29,29696,203,203,29899
train,5066,15,15360,93,93,15453
train,5067,30,30720,208,208,30928
train,5068,17,17408,107,107,17515
train,5069,21,21504,135,135,21639
train,5070,21,21504,135,135,21639
train,5071,30,30720,210,210,30930
train,5072,23,23552,165,165,23717
train,5073,29,29696,201,201,29897
train,5074,8,8192,44,44,8236
train,5075,20,20480,128,128,20608
train,5076,16,16384,104,104,16488
train,5077,15,15360,93,93,15453
train,5078,21,21504,141,141,21645
train,5079,32,32768,218,218,32986
train,5080,13,13312,85,85,13397
train,5081,8,8192,44,44,8236
train,5082,14,14336,90,90,14426
train,5083,35,35840,239,239,36079
train,5084,24,24576,170,170,24746
train,5085,30,30720,204,204,30924
train,5086,10,10240,58,58,10298
train,5087,20,20480,128,128,20608
train,5088,24,24576,160,160,24736
train,5089,20,20480,134,134,20614
train,5090,36,36864,246,246,37110
train,5091,29,29696,209,209,29905
train,5092,6,6144,30,30,6174
train,5093,19,19456,123,123,19579
train,5094,15,15360,93,93,15453
train,5095,11,11264,65,65,11329
train,5096,26,26624,182,182,26806
train,5097,26,26624,170,170,26794
train,5098,16,16384,106,106,16490
train,5099,24,24576,156,156,24732
train,5100,8,8192,44,44,8236
train,5101,30,30720,224,224,30944
train,5102,12,12288,72,72,12360
train,5103,14,14336,86,86,14422
train,5104,7,7168,37,37,7205
train,5105,13,13312,79,79,13391
train,5106,22,22528,148,148,22676
train,5107,36,36864,246,246,37110
train,5108,15,15360,99,99,15459
train,5109,44,45056,318,318,45374
train,5110,35,35840,251,251,36091
train,5111,38,38912,264,264,39176
train,5112,9,9216,51,51,9267
train,5113,24,24576,156,156,24732
train,5114,35,35840,253,253,36093
train,5115,8,8192,44,44,8236
train,5116,25,25600,187,187,25787
train,5117,22,22528,142,142,22670
train,5118,16,16384,100,100,16484
train,5119,15,15360,93,93,15453
train,5120,41,41984,303,303,42287
train,5121,45,46080,303,303,46383
train,5122,24,24576,156,156,24732
train,5123,16,16384,106,106,16490
train,5124,10,10240,58,58,10298
train,5125,10,10240,58,58,10298
train,5126,22,22528,142,142,22670
train,5127,12,12288,72,72,12360
train,5128,32,32768,218,218,32986
train,5129,19,19456,123,123,19579
train,5130,20,20480,140,140,20620
train,5131,24,24576,156,156,24732
train,5132,8,8192,44,44,8236
train,5133,30,30720,204,204,30924
train,5134,39,39936,287,287,40223
train,5135,15,15360,93,93,15453
train,5136,21,21504,141,141,21645
train,5137,13,13312,79,79,13391
train,5138,23,23552,149,149,23701
train,5139,10,10240,58,58,10298
train,5140,19,19456,119,119,19575
train,5141,10,10240,58,58,10298
train,5142,31,31744,215,215,31959
train,5143,14,14336,86,86,14422
train,5144,23,23552,149,149,23701
train,5145,31,31744,231,231,31975
train,5146,17,17408,119,119,17527
train,5147,27,27648,183,183,27831
train,5148,22,22528,148,148,22676
train,5149,40,40960,302,302,41262
train,5150,16,16384,100,100,16484
train,5151,16,16384,100,100,16484
train,5152,26,26624,190,190,26814
train,5153,21,21504,141,141,21645
train,5154,19,19456,121,121,19577
train,5155,22,22528,146,146,22674
train,5156,24,24576,162,162,24738
train,5157,22,22528,142,142,22670
train,5158,19,19456,121,121,19577
train,5159,17,17408,107,107,17515
train,5160,29,29696,209,209,29905
train,5161,27,27648,177,177,27825
train,5162,33,33792,237,237,34029
train,5163,23,23552,153,153,23705
train,5164,19,19456,151,151,19607
train,5165,12,12288,72,72,12360
train,5166,17,17408,105,105,17513
train,5167,22,22528,148,148,22676
train,5168,11,11264,65,65,11329
train,5169,16,16384,104,104,16488
train,5170,31,31744,221,221,31965
train,5171,8,8192,44,44,8236
train,5172,12,12288,72,72,12360
train,5173,10,10240,58,58,10298
train,5174,19,19456,121,121,19577
train,5175,17,17408,117,117,17525
train,5176,12,12288,68,68,12356
train,5177,13,13312,79,79,13391
train,5178,9,9216,51,51,9267
train,5179,19,19456,121,121,19577
train,5180,38,38912,276,276,39188
train,5181,28,28672,190,190,28862
train,5182,28,28672,188,188,28860
train,5183,25,25600,163,163,25763
train,5184,32,32768,220,220,32988
train,5185,45,46080,333,333,46413
train,5186,31,31744,221,221,31965
train,5187,30,30720,198,198,30918
train,5188,26,26624,170,170,26794
train,5189,26,26624,178,178,26802
train,5190,12,12288,72,72,12360
train,5191,13,13312,79,79,13391
train,5192,32,32768,228,228,32996
train,5193,8,8192,44,44,8236
train,5194,3,3072,9,9,3081
train,5195,47,48128,335,335,48463
train,5196,7,7168,33,33,7201
train,5197,22,22528,146,146,22674
train,5198,39,39936,279,279,40215
train,5199,16,16384,100,100,16484
train,5200,10,10240,58,58,10298
train,5201,14,14336,84,84,14420
train,5202,8,8192,44,44,8236
train,5203,31,31744,211,211,31955
train,5204,3,3072,9,9,3081
train,5205,31,31744,217,217,31961
train,5206,34,34816,246,246,35062
train,5207,36,36864,238,238,37102
train,5208,22,22528,160,160,22688
train,5209,31,31744,223,223,31967
train,5210,30,30720,202,202,30922
train,5211,13,13312,79,79,13391
train,5212,14,14336,92,92,14428
train,5213,9,9216,51,51,9267
train,5214,15,15360,91,91,15451
train,5215,12,12288,72,72,12360
train,5216,29,29696,195,195,29891
train,5217,25,25600,163,163,25763
train,5218,14,14336,86,86,14422
train,5219,34,34816,244,244,35060
train,5220,14,14336,86,86,14422
train,5221,8,8192,44,44,8236
train,5222,26,26624,176,176,26800
train,5223,4,4096,16,16,4112
train,5224,22,22528,148,148,22676
train,5225,42,43008,298,298,43306
train,5226,18,18432,114,114,18546
train,5227,36,36864,268,268,37132
train,5228,31,31744,211,211,31955
train,5229,22,22528,152,152,22680
train,5230,22,22528,142,142,22670
train,5231,21,21504,135,135,21639
train,5232,31,31744,217,217,31961
train,5233,14,14336,86,86,14422
train,5234,37,37888,281,281,38169
train,5235,12,12288,72,72,12360
train,5236,6,6144,30,30,6174
train,5237,20,20480,128,128,20608
train,5238,27,27648,181,181,27829
train,5239,29,29696,203,203,29899
train,5240,42,43008,304,304,43312
train,5241,16,16384,100,100,16484
train,5242,18,18432,120,120,18552
train,5243,23,23552,157,157,23709
train,5244,20,20480,142,142,20622
train,5245,16,16384,100,100,16484
train,5246,12,12288,72,72,12360
train,5247,10,10240,58,58,10298
train,5248,16,16384,100,100,16484
train,5249,28,28672,190,190,28862
train,5250,14,14336,92,92,14428
train,5251,21,21504,135,135,21639
train,5252,20,20480,132,132,20612
train,5253,23,23552,151,151,23703
train,5254,14,14336,92,92,14428
train,5255,29,29696,207,207,29903
train,5256,11,11264,65,65,11329
train,5257,11,11264,75,75,11339
train,5258,8,8192,44,44,8236
train,5259,10,10240,58,58,10298
train,5260,33,33792,237,237,34029
train,5261,11,11264,65,65,11329
train,5262,35,35840,239,239,36079
train,5263,39,39936,277,277,40213
train,5264,24,24576,162,162,24738
train,5265,17,17408,107,107,17515
train,5266,21,21504,141,141,21645
train,5267,19,19456,123,123,19579
train,5268,40,40960,316,316,41276
train,5269,8,8192,44,44,8236
train,5270,9,9216,51,51,9267
train,5271,28,28672,200,200,28872
train,5272,18,18432,114,114,18546
train,5273,20,20480,132,132,20612
train,5274,34,34816,252,252,35068
train,5275,16,16384,100,100,16484
train,5276,36,36864,260,260,37124
train,5277,22,22528,152,152,22680
train,5278,15,15360,93,93,15453
train,5279,19,19456,129,129,19585
train,5280,23,23552,161,161,23713
train,5281,38,38912,260,260,39172
train,5282,24,24576,162,162,24738
train,5283,14,14336,86,86,14422
train,5284,25,25600,179,179,25779
train,5285,15,15360,91,91,15451
train,5286,20,20480,128,128,20608
train,5287,36,36864,284,284,37148
train,5288,20,20480,134,134,20614
train,5289,21,21504,135,135,21639
train,5290,18,18432,114,114,18546
train,5291,23,23552,161,161,23713
train,5292,12,12288,72,72,12360
train,5293,14,14336,86,86,14422
train,5294,29,29696,193,193,29889
train,5295,33,33792,221,221,34013
train,5296,27,27648,185,185,27833
train,5297,17,17408,107,107,17515
train,5298,22,22528,148,148,22676
train,5299,25,25600,167,167,25767
train,5300,13,13312,89,89,13401
train,5301,13,13312,79,79,13391
train,5302,9,9216,51,51,9267
train,5303,13,13312,79,79,13391
train,5304,18,18432,114,114,18546
train,5305,25,25600,169,169,25769
train,5306,26,26624,192,192,26816
train,5307,26,26624,188,188,26812
train,5308,11,11264,67,67,11331
train,5309,9,9216,51,51,9267
train,5310,22,22528,162,162,22690
train,5311,4,4096,16,16,4112
train,5312,16,16384,100,100,16484
train,5313,15,15360,93,93,15453
train,5314,39,39936,267,267,40203
train,5315,15,15360,93,93,15453
train,5316,21,21504,135,135,21639
train,5317,19,19456,121,121,19577
train,5318,23,23552,159,159,23711
train,5319,29,29696,203,203,29899
train,5320,34,34816,246,246,35062
train,5321,20,20480,128,128,20608
train,5322,23,23552,153,153,23705
train,5323,31,31744,215,215,31959
train,5324,12,12288,72,72,12360
train,5325,15,15360,93,93,15453
train,5326,20,20480,128,128,20608
train,5327,18,18432,114,114,18546
train,5328,6,6144,30,30,6174
train,5329,33,33792,231,231,34023
train,5330,5,5120,23,23,5143
train,5331,32,32768,236,236,33004
train,5332,21,21504,141,141,21645
train,5333,9,9216,51,51,9267
train,5334,17,17408,107,107,17515
train,5335,12,12288,72,72,12360
train,5336,15,15360,93,93,15453
train,5337,20,20480,134,134,20614
train,5338,6,6144,30,30,6174
train,5339,17,17408,109,109,17517
train,5340,9,9216,49,49,9265
train,5341,40,40960,274,274,41234
train,5342,23,23552,159,159,23711
train,5343,11,11264,65,65,11329
train,5344,24,24576,162,162,24738
train,5345,18,18432,126,126,18558
train,5346,19,19456,137,137,19593
train,5347,4,4096,16,16,4112
train,5348,12,12288,72,72,12360
train,5349,20,20480,128,128,20608
train,5350,23,23552,149,149,23701
train,5351,26,26624,182,182,26806
train,5352,25,25600,169,169,25769
train,5353,19,19456,121,121,19577
train,5354,22,22528,148,148,22676
train,5355,33,33792,249,249,34041
train,5356,6,6144,30,30,6174
train,5357,9,9216,51,51,9267
train,5358,6,6144,30,30,6174
train,5359,17,17408,111,111,17519
train,5360,24,24576,162,162,24738
train,5361,25,25600,179,179,25779
train,5362,29,29696,201,201,29897
train,5363,17,17408,107,107,17515
train,5364,20,20480,140,140,20620
train,5365,17,17408,107,107,17515
train,5366,18,18432,114,114,18546
train,5367,13,13312,85,85,13397
train,5368,28,28672,190,190,28862
train,5369,11,11264,63,63,11327
train,5370,22,22528,148,148,22676
train,5371,18,18432,120,120,18552
train,5372,20,20480,128,128,20608
train,5373,20,20480,134,134,20614
train,5374,18,18432,120,120,18552
train,5375,7,7168,37,37,7205
train,5376,39,39936,289,289,40225
train,5377,14,14336,92,92,14428
train,5378,37,37888,273,273,38161
train,5379,5,5120,23,23,5143
train,5380,31,31744,211,211,31955
train,5381,24,24576,156,156,24732
train,5382,18,18432,114,114,18546
train,5383,27,27648,189,189,27837
train,5384,21,21504,135,135,21639
train,5385,7,7168,35,35,7203
train,5386,18,18432,118,118,18550
train,5387,14,14336,96,96,14432
train,5388,33,33792,237,237,34029
train,5389,28,28672,188,188,28860
train,5390,14,14336,86,86,14422
train,5391,23,23552,151,151,23703
train,5392,12,12288,68,68,12356
train,5393,24,24576,156,156,24732
train,5394,9,9216,47,47,9263
train,5395,9,9216,51,51,9267
train,5396,9,9216,47,47,9263
train,5397,27,27648,189,189,27837
train,5398,13,13312,79,79,13391
train,5399,12,12288,72,72,12360
train,5400,8,8192,44,44,8236
train,5401,26,26624,168,168,26792
train,5402,7,7168,37,37,7205
train,5403,5,5120,23,23,5143
train,5404,24,24576,166,166,24742
train,5405,11,11264,69,69,11333
train,5406,32,32768,230,230,32998
train,5407,26,26624,186,186,26810
train,5408,21,21504,135,135,21639
train,5409,6,6144,30,30,6174
train,5410,29,29696,195,195,29891
train,5411,27,27648,177,177,27825
train,5412,15,15360,89,89,15449
train,5413,12,12288,72,72,12360
train,5414,20,20480,128,128,20608
train,5415,20,20480,140,140,20620
train,5416,40,40960,326,326,41286
train,5417,38,38912,272,272,39184
train,5418,28,28672,194,194,28866
train,5419,26,26624,176,176,26800
train,5420,22,22528,142,142,22670
train,5421,32,32768,228,228,32996
train,5422,22,22528,142,142,22670
train,5423,9,9216,51,51,9267
train,5424,20,20480,128,128,20608
train,5425,17,17408,107,107,17515
train,5426,23,23552,149,149,23701
train,5427,6,6144,30,30,6174
train,5428,29,29696,199,199,29895
train,5429,13,13312,79,79,13391
train,5430,11,11264,65,65,11329
train,5431,35,35840,275,275,36115
train,5432,14,14336,86,86,14422
train,5433,18,18432,114,114,18546
train,5434,17,17408,107,107,17515
train,5435,10,10240,58,58,10298
train,5436,17,17408,109,109,17517
train,5437,24,24576,184,184,24760
train,5438,12,12288,72,72,12360
train,5439,34,34816,250,250,35066
train,5440,18,18432,114,114,18546
train,5441,28,28672,214,214,28886
train,5442,38,38912,282,282,39194
train,5443,13,13312,79,79,13391
train,5444,28,28672,190,190,28862
train,5445,19,19456,127,127,19583
train,5446,24,24576,162,162,24738
train,5447,7,7168,37,37,7205
train,5448,12,12288,72,72,12360
train,5449,21,21504,139,139,21643
train,5450,30,30720,210,210,30930
train,5451,18,18432,114,114,18546
train,5452,41,41984,287,287,42271
train,5453,31,31744,221,221,31965
train,5454,25,25600,169,169,25769
train,5455,41,41984,297,297,42281
train,5456,10,10240,58,58,10298
train,5457,23,23552,169,169,23721
train,5458,27,27648,183,183,27831
train,5459,34,34816,232,232,35048
train,5460,24,24576,166,166,24742
train,5461,19,19456,121,121,19577
train,5462,22,22528,142,142,22670
train,5463,24,24576,162,162,24738
train,5464,27,27648,183,183,27831
train,5465,10,10240,58,58,10298
train,5466,26,26624,170,170,26794
train,5467,4,4096,16,16,4112
train,5468,14,14336,86,86,14422
train,5469,16,16384,100,100,16484
train,5470,26,26624,180,180,26804
train,5471,10,10240,58,58,10298
train,5472,38,38912,270,270,39182
train,5473,19,19456,121,121,19577
train,5474,24,24576,166,166,24742
train,5475,10,10240,58,58,10298
train,5476,35,35840,239,239,36079
train,5477,37,37888,263,263,38151
train,5478,18,18432,120,120,18552
train,5479,3,3072,9,9,3081
train,5480,32,32768,216,216,32984
train,5481,9,9216,51,51,9267
train,5482,24,24576,156,156,24732
train,5483,10,10240,70,70,10310
train,5484,18,18432,114,114,18546
train,5485,23,23552,149,149,23701
train,5486,36,36864,282,282,37146
train,5487,13,13312,79,79,13391
train,5488,9,9216,51,51,9267
train,5489,36,36864,238,238,37102
train,5490,16,16384,100,100,16484
train,5491,35,35840,239,239,36079
train,5492,18,18432,114,114,18546
train,5493,28,28672,184,184,28856
train,5494,35,35840,259,259,36099
train,5495,24,24576,156,156,24732
train,5496,13,13312,79,79,13391
train,5497,27,27648,191,191,27839
train,5498,17,17408,109,109,17517
train,5499,13,13312,83,83,13395
train,5500,15,15360,93,93,15453
train,5501,22,22528,148,148,22676
train,5502,20,20480,128,128,20608
train,5503,28,28672,202,202,28874
train,5504,4,4096,16,16,4112
train,5505,14,14336,86,86,14422
train,5506,9,9216,51,51,9267
train,5507,38,38912,310,310,39222
train,5508,28,28672,190,190,28862
train,5509,22,22528,146,146,22674
train,5510,24,24576,172,172,24748
train,5511,24,24576,174,174,24750
train,5512,23,23552,159,159,23711
train,5513,27,27648,189,189,27837
train,5514,23,23552,161,161,23713
train,5515,14,14336,86,86,14422
train,5516,11,11264,65,65,11329
train,5517,18,18432,114,114,18546
train,5518,13,13312,79,79,13391
train,5519,33,33792,229,229,34021
train,5520,38,38912,288,288,39200
train,5521,23,23552,175,175,23727
train,5522,23,23552,161,161,23713
train,5523,21,21504,139,139,21643
train,5524,20,20480,136,136,20616
train,5525,17,17408,107,107,17515
train,5526,19,19456,121,121,19577
train,5527,21,21504,137,137,21641
train,5528,15,15360,103,103,15463
train,5529,26,26624,180,180,26804
train,5530,26,26624,190,190,26814
train,5531,20,20480,128,128,20608
train,5532,13,13312,79,79,13391
train,5533,14,14336,86,86,14422
train,5534,7,7168,37,37,7205
train,5535,13,13312,79,79,13391
train,5536,35,35840,249,249,36089
train,5537,4,4096,16,16,4112
train,5538,8,8192,44,44,8236
train,5539,14,14336,86,86,14422
train,5540,30,30720,204,204,30924
train,5541,35,35840,245,245,36085
train,5542,34,34816,248,248,35064
train,5543,23,23552,159,159,23711
train,5544,26,26624,184,184,26808
train,5545,8,8192,44,44,8236
train,5546,29,29696,207,207,29903
train,5547,33,33792,233,233,34025
train,5548,21,21504,141,141,21645
train,5549,13,13312,79,79,13391
train,5550,19,19456,133,133,19589
train,5551,39,39936,273,273,40209
train,5552,42,43008,284,284,43292
train,5553,12,12288,72,72,12360
train,5554,24,24576,156,156,24732
train,5555,9,9216,51,51,9267
train,5556,18,18432,114,114,18546
train,5557,22,22528,144,144,22672
train,5558,27,27648,191,191,27839
train,5559,42,43008,298,298,43306
train,5560,12,12288,72,72,12360
train,5561,32,32768,232,232,33000
train,5562,36,36864,256,256,37120
train,5563,16,16384,100,100,16484
train,5564,15,15360,93,93,15453
train,5565,21,21504,137,137,21641
train,5566,10,10240,58,58,10298
train,5567,25,25600,175,175,25775
train,5568,12,12288,72,72,12360
train,5569,18,18432,114,114,18546
train,5570,24,24576,156,156,24732
train,5571,11,11264,65,65,11329
train,5572,33,33792,225,225,34017
train,5573,37,37888,271,271,38159
train,5574,33,33792,235,235,34027
train,5575,17,17408,107,107,17515
train,5576,8,8192,44,44,8236
train,5577,19,19456,121,121,19577
train,5578,10,10240,58,58,10298
train,5579,29,29696,199,199,29895
train,5580,7,7168,37,37,7205
train,5581,22,22528,150,150,22678
train,5582,21,21504,145,145,21649
train,5583,35,35840,239,239,36079
train,5584,13,13312,81,81,13393
train,5585,22,22528,142,142,22670
train,5586,11,11264,65,65,11329
train,5587,11,11264,63,63,11327
train,5588,27,27648,189,189,27837
train,5589,32,32768,224,224,32992
train,5590,31,31744,205,205,31949
train,5591,16,16384,102,102,16486
train,5592,25,25600,173,173,25773
train,5593,24,24576,174,174,24750
train,5594,10,10240,56,56,10296
train,5595,37,37888,263,263,38151
train,5596,19,19456,123,123,19579
train,5597,14,14336,86,86,14422
train,5598,25,25600,169,169,25769
train,5599,9,9216,51,51,9267
train,5600,15,15360,91,91,15451
train,5601,19,19456,121,121,19577
train,5602,25,25600,167,167,25767
train,5603,22,22528,142,142,22670
train,5604,16,16384,98,98,16482
train,5605,21,21504,141,141,21645
train,5606,10,10240,58,58,10298
train,5607,13,13312,85,85,13397
train,5608,24,24576,168,168,24744
train,5609,17,17408,107,107,17515
train,5610,23,23552,149,149,23701
train,5611,17,17408,107,107,17515
train,5612,18,18432,114,114,18546
train,5613,27,27648,195,195,27843
train,5614,27,27648,197,197,27845
train,5615,15,15360,93,93,15453
train,5616,11,11264,65,65,11329
train,5617,18,18432,110,110,18542
train,5618,17,17408,107,107,17515
train,5619,9,9216,51,51,9267
train,5620,7,7168,37,37,7205
train,5621,5,5120,23,23,5143
train,5622,13,13312,79,79,13391
train,5623,27,27648,177,177,27825
train,5624,21,21504,141,141,21645
train,5625,34,34816,256,256,35072
train,5626,21,21504,135,135,21639
train,5627,33,33792,247,247,34039
train,5628,20,20480,128,128,20608
train,5629,24,24576,156,156,24732
train,5630,32,32768,234,234,33002
train,5631,17,17408,107,107,17515
train,5632,11,11264,65,65,11329
train,5633,6,6144,30,30,6174
train,5634,24,24576,162,162,24738
train,5635,22,22528,158,158,22686
train,5636,29,29696,197,197,29893
train,5637,15,15360,103,103,15463
train,5638,17,17408,107,107,17515
train,5639,23,23552,155,155,23707
train,5640,25,25600,163,163,25763
train,5641,25,25600,175,175,25775
train,5642,11,11264,65,65,11329
train,5643,11,11264,65,65,11329
train,5644,18,18432,120,120,18552
train,5645,15,15360,99,99,15459
train,5646,9,9216,51,51,9267
train,5647,24,24576,186,186,24762
train,5648,21,21504,135,135,21639
train,5649,28,28672,206,206,28878
train,5650,19,19456,121,121,19577
train,5651,24,24576,156,156,24732
train,5652,13,13312,83,83,13395
train,5653,22,22528,148,148,22676
train,5654,25,25600,171,171,25771
train,5655,3,3072,9,9,3081
train,5656,6,6144,30,30,6174
train,5657,37,37888,259,259,38147
train,5658,32,32768,236,236,33004
train,5659,28,28672,190,190,28862
train,5660,24,24576,156,156,24732
train,5661,27,27648,191,191,27839
train,5662,15,15360,91,91,15451
train,5663,15,15360,91,91,15451
train,5664,25,25600,177,177,25777
train,5665,35,35840,267,267,36107
train,5666,33,33792,219,219,34011
train,5667,14,14336,86,86,14422
train,5668,11,11264,65,65,11329
train,5669,12,12288,72,72,12360
train,5670,19,19456,121,121,19577
train,5671,6,6144,30,30,6174
train,5672,19,19456,121,121,19577
train,5673,20,20480,128,128,20608
train,5674,22,22528,164,164,22692
train,5675,14,14336,86,86,14422
train,5676,19,19456,127,127,19583
train,5677,19,19456,129,129,19585
train,5678,22,22528,148,148,22676
train,5679,25,25600,169,169,25769
train,5680,18,18432,120,120,18552
train,5681,23,23552,161,161,23713
train,5682,13,13312,79,79,13391
train,5683,35,35840,241,241,36081
train,5684,20,20480,138,138,20618
train,5685,9,9216,51,51,9267
train,5686,22,22528,156,156,22684
train,5687,15,15360,101,101,15461
train,5688,22,22528,142,142,22670
train,5689,37,37888,269,269,38157
train,5690,34,34816,224,224,35040
train,5691,19,19456,127,127,19583
train,5692,5,5120,23,23,5143
train,5693,23,23552,151,151,23703
train,5694,28,28672,210,210,28882
train,5695,27,27648,199,199,27847
train,5696,38,38912,282,282,39194
train,5697,13,13312,79,79,13391
train,5698,32,32768,216,216,32984
train,5699,30,30720,210,210,30930
train,5700,23,23552,155,155,23707
train,5701,3,3072,9,9,3081
train,5702,11,11264,65,65,11329
train,5703,16,16384,106,106,16490
train,5704,17,17408,113,113,17521
train,5705,3,3072,9,9,3081
train,5706,18,18432,128,128,18560
train,5707,18,18432,114,114,18546
train,5708,24,24576,172,172,24748
train,5709,32,32768,228,228,32996
train,5710,30,30720,214,214,30934
train,5711,3,3072,9,9,3081
train,5712,15,15360,93,93,15453
train,5713,31,31744,225,225,31969
train,5714,26,26624,176,176,26800
train,5715,7,7168,37,37,7205
train,5716,28,28672,188,188,28860
train,5717,13,13312,79,79,13391
train,5718,19,19456,135,135,19591
train,5719,12,12288,72,72,12360
train,5720,36,36864,254,254,37118
train,5721,21,21504,139,139,21643
train,5722,7,7168,37,37,7205
train,5723,23,23552,155,155,23707
train,5724,20,20480,128,128,20608
train,5725,14,14336,86,86,14422
train,5726,17,17408,107,107,17515
train,5727,9,9216,51,51,9267
train,5728,29,29696,205,205,29901
train,5729,21,21504,133,133,21637
train,5730,30,30720,204,204,30924
train,5731,6,6144,30,30,6174
train,5732,5,5120,23,23,5143
train,5733,30,30720,214,214,30934
train,5734,16,16384,100,100,16484
train,5735,11,11264,65,65,11329
train,5736,19,19456,127,127,19583
train,5737,27,27648,183,183,27831
train,5738,19,19456,143,143,19599
train,5739,26,26624,176,176,26800
train,5740,8,8192,44,44,8236
train,5741,20,20480,134,134,20614
train,5742,18,18432,114,114,18546
train,5743,5,5120,23,23,5143
train,5744,15,15360,93,93,15453
train,5745,15,15360,89,89,15449
train,5746,9,9216,51,51,9267
train,5747,20,20480,134,134,20614
train,5748,38,38912,298,298,39210
train,5749,26,26624,172,172,26796
train,5750,14,14336,96,96,14432
train,5751,39,39936,271,271,40207
train,5752,33,33792,247,247,34039
train,5753,6,6144,30,30,6174
train,5754,38,38912,272,272,39184
train,5755,17,17408,107,107,17515
train,5756,32,32768,218,218,32986
train,5757,29,29696,213,213,29909
train,5758,15,15360,93,93,15453
train,5759,26,26624,176,176,26800
train,5760,20,20480,128,128,20608
train,5761,36,36864,254,254,37118
train,5762,31,31744,215,215,31959
train,5763,15,15360,99,99,15459
train,5764,17,17408,107,107,17515
train,5765,12,12288,72,72,12360
train,5766,30,30720,208,208,30928
train,5767,5,5120,23,23,5143
train,5768,28,28672,186,186,28858
train,5769,31,31744,217,217,31961
train,5770,25,25600,163,163,25763
train,5771,13,13312,79,79,13391
train,5772,22,22528,142,142,22670
train,5773,21,21504,141,141,21645
train,5774,28,28672,184,184,28856
train,5775,18,18432,114,114,18546
train,5776,30,30720,208,208,30928
train,5777,34,34816,232,232,35048
train,5778,15,15360,93,93,15453
train,5779,18,18432,130,130,18562
train,5780,39,39936,273,273,40209
train,5781,7,7168,37,37,7205
train,5782,11,11264,65,65,11329
train,5783,27,27648,173,173,27821
train,5784,18,18432,114,114,18546
train,5785,14,14336,86,86,14422
train,5786,9,9216,51,51,9267
train,5787,46,47104,338,338,47442
train,5788,28,28672,190,190,28862
train,5789,27,27648,207,207,27855
train,5790,32,32768,228,228,32996
train,5791,11,11264,65,65,11329
train,5792,7,7168,37,37,7205
train,5793,12,12288,72,72,12360
train,5794,8,8192,44,44,8236
train,5795,13,13312,79,79,13391
train,5796,27,27648,177,177,27825
train,5797,33,33792,251,251,34043
train,5798,29,29696,207,207,29903
train,5799,19,19456,127,127,19583
train,5800,31,31744,207,207,31951
train,5801,4,4096,16,16,4112
train,5802,32,32768,212,212,32980
train,5803,16,16384,100,100,16484
train,5804,25,25600,173,173,25773
train,5805,22,22528,148,148,22676
train,5806,20,20480,128,128,20608
train,5807,14,14336,86,86,14422
train,5808,22,22528,146,146,22674
train,5809,9,9216,51,51,9267
train,5810,29,29696,203,203,29899
train,5811,25,25600,175,175,25775
train,5812,19,19456,121,121,19577
train,5813,28,28672,196,196,28868
train,5814,14,14336,86,86,14422
train,5815,6,6144,30,30,6174
train,5816,32,32768,216,216,32984
train,5817,34,34816,242,242,35058
train,5818,6,6144,30,30,6174
train,5819,20,20480,148,148,20628
train,5820,26,26624,178,178,26802
train,5821,4,4096,16,16,4112
train,5822,20,20480,128,128,20608
train,5823,16,16384,116,116,16500
train,5824,20,20480,128,128,20608
train,5825,8,8192,44,44,8236
train,5826,21,21504,141,141,21645
train,5827,16,16384,106,106,16490
train,5828,26,26624,170,170,26794
train,5829,19,19456,121,121,19577
train,5830,24,24576,156,156,24732
train,5831,17,17408,107,107,17515
train,5832,25,25600,169,169,25769
train,5833,23,23552,143,143,23695
train,5834,24,24576,156,156,24732
train,5835,37,37888,285,285,38173
train,5836,34,34816,238,238,35054
train,5837,36,36864,258,258,37122
train,5838,28,28672,190,190,28862
train,5839,26,26624,182,182,26806
train,5840,34,34816,248,248,35064
train,5841,20,20480,144,144,20624
train,5842,21,21504,137,137,21641
train,5843,20,20480,136,136,20616
train,5844,4,4096,16,16,4112
train,5845,12,12288,80,80,12368
train,5846,21,21504,135,135,21639
train,5847,11,11264,65,65,11329
train,5848,16,16384,100,100,16484
train,5849,6,6144,30,30,6174
train,5850,41,41984,287,287,42271
train,5851,22,22528,142,142,22670
train,5852,20,20480,138,138,20618
train,5853,12,12288,72,72,12360
train,5854,8,8192,44,44,8236
train,5855,15,15360,95,95,15455
train,5856,20,20480,128,128,20608
train,5857,22,22528,142,142,22670
train,5858,30,30720,198,198,30918
train,5859,31,31744,221,221,31965
train,5860,10,10240,58,58,10298
train,5861,29,29696,195,195,29891
train,5862,34,34816,232,232,35048
train,5863,16,16384,100,100,16484
train,5864,8,8192,44,44,8236
train,5865,8,8192,44,44,8236
train,5866,10,10240,58,58,10298
train,5867,44,45056,314,314,45370
train,5868,14,14336,92,92,14428
train,5869,21,21504,147,147,21651
train,5870,29,29696,191,191,29887
train,5871,30,30720,202,202,30922
train,5872,16,16384,100,100,16484
train,5873,11,11264,65,65,11329
train,5874,27,27648,177,177,27825
train,5875,17,17408,113,113,17521
train,5876,32,32768,220,220,32988
train,5877,43,44032,301,301,44333
train,5878,23,23552,159,159,23711
train,5879,33,33792,231,231,34023
train,5880,11,11264,63,63,11327
train,5881,34,34816,242,242,35058
train,5882,9,9216,51,51,9267
train,5883,17,17408,105,105,17513
train,5884,22,22528,142,142,22670
train,5885,21,21504,135,135,21639
train,5886,22,22528,148,148,22676
train,5887,21,21504,151,151,21655
train,5888,39,39936,271,271,40207
train,5889,24,24576,168,168,24744
train,5890,14,14336,88,88,14424
train,5891,36,36864,258,258,37122
train,5892,16,16384,106,106,16490
train,5893,10,10240,62,62,10302
train,5894,11,11264,65,65,11329
train,5895,32,32768,224,224,32992
train,5896,18,18432,114,114,18546
train,5897,33,33792,245,245,34037
train,5898,20,20480,144,144,20624
train,5899,26,26624,174,174,26798
train,5900,23,23552,155,155,23707
train,5901,22,22528,142,142,22670
train,5902,10,10240,58,58,10298
train,5903,26,26624,188,188,26812
train,5904,17,17408,107,107,17515
train,5905,32,32768,218,218,32986
train,5906,27,27648,183,183,27831
train,5907,17,17408,113,113,17521
train,5908,9,9216,51,51,9267
train,5909,17,17408,111,111,17519
train,5910,13,13312,79,79,13391
train,5911,27,27648,193,193,27841
train,5912,9,9216,51,51,9267
train,5913,36,36864,258,258,37122
train,5914,25,25600,171,171,25771
train,5915,13,13312,79,79,13391
train,5916,15,15360,87,87,15447
train,5917,26,26624,176,176,26800
train,5918,12,12288,72,72,12360
train,5919,12,12288,72,72,12360
train,5920,13,13312,79,79,13391
train,5921,32,32768,218,218,32986
train,5922,31,31744,205,205,31949
train,5923,6,6144,30,30,6174
train,5924,6,6144,30,30,6174
train,5925,36,36864,240,240,37104
train,5926,21,21504,135,135,21639
train,5927,3,3072,9,9,3081
train,5928,25,25600,167,167,25767
train,5929,24,24576,176,176,24752
train,5930,33,33792,231,231,34023
train,5931,11,11264,65,65,11329
train,5932,20,20480,136,136,20616
train,5933,8,8192,44,44,8236
train,5934,18,18432,114,114,18546
train,5935,23,23552,149,149,23701
train,5936,19,19456,123,123,19579
train,5937,9,9216,51,51,9267
train,5938,24,24576,158,158,24734
train,5939,23,23552,151,151,23703
train,5940,31,31744,243,243,31987
train,5941,25,25600,169,169,25769
train,5942,23,23552,155,155,23707
train,5943,19,19456,127,127,19583
train,5944,32,32768,212,212,32980
train,5945,7,7168,37,37,7205
train,5946,15,15360,95,95,15455
train,5947,29,29696,201,201,29897
train,5948,14,14336,86,86,14422
train,5949,23,23552,149,149,23701
train,5950,10,10240,58,58,10298
train,5951,24,24576,178,178,24754
train,5952,16,16384,100,100,16484
train,5953,22,22528,148,148,22676
train,5954,28,28672,194,194,28866
train,5955,31,31744,213,213,31957
train,5956,40,40960,268,268,41228
train,5957,22,22528,148,148,22676
train,5958,19,19456,121,121,19577
train,5959,27,27648,183,183,27831
train,5960,14,14336,90,90,14426
train,5961,22,22528,142,142,22670
train,5962,26,26624,188,188,26812
train,5963,42,43008,320,320,43328
train,5964,13,13312,85,85,13397
train,5965,20,20480,128,128,20608
train,5966,16,16384,100,100,16484
train,5967,31,31744,217,217,31961
train,5968,16,16384,112,112,16496
train,5969,23,23552,155,155,23707
train,5970,42,43008,302,302,43310
train,5971,22,22528,158,158,22686
train,5972,9,9216,51,51,9267
train,5973,28,28672,184,184,28856
train,5974,21,21504,143,143,21647
train,5975,19,19456,121,121,19577
train,5976,19,19456,125,125,19581
train,5977,22,22528,142,142,22670
train,5978,23,23552,151,151,23703
train,5979,39,39936,275,275,40211
train,5980,20,20480,128,128,20608
train,5981,35,35840,243,243,36083
train,5982,29,29696,205,205,29901
train,5983,10,10240,60,60,10300
train,5984,22,22528,158,158,22686
train,5985,26,26624,176,176,26800
train,5986,20,20480,128,128,20608
train,5987,32,32768,212,212,32980
train,5988,20,20480,146,146,20626
train,5989,28,28672,196,196,28868
train,5990,24,24576,168,168,24744
train,5991,24,24576,156,156,24732
train,5992,7,7168,37,37,7205
train,5993,15,15360,93,93,15453
train,5994,34,34816,230,230,35046
train,5995,18,18432,114,114,18546
train,5996,18,18432,118,118,18550
train,5997,10,10240,58,58,10298
train,5998,33,33792,225,225,34017
train,5999,28,28672,202,202,28874
train,6000,35,35840,241,241,36081
train,6001,16,16384,100,100,16484
train,6002,29,29696,215,215,29911
train,6003,24,24576,156,156,24732
train,6004,19,19456,127,127,19583
train,6005,35,35840,257,257,36097
train,6006,26,26624,176,176,26800
train,6007,19,19456,121,121,19577
train,6008,15,15360,99,99,15459
train,6009,28,28672,200,200,28872
train,6010,31,31744,239,239,31983
train,6011,33,33792,229,229,34021
train,6012,23,23552,161,161,23713
train,6013,8,8192,44,44,8236
train,6014,48,49152,354,354,49506
train,6015,22,22528,154,154,22682
train,6016,22,22528,142,142,22670
train,6017,25,25600,167,167,25767
train,6018,22,22528,148,148,22676
train,6019,24,24576,162,162,24738
train,6020,29,29696,187,187,29883
train,6021,14,14336,86,86,14422
train,6022,21,21504,135,135,21639
train,6023,12,12288,72,72,12360
train,6024,20,20480,136,136,20616
train,6025,21,21504,135,135,21639
train,6026,29,29696,213,213,29909
train,6027,10,10240,58,58,10298
train,6028,17,17408,117,117,17525
train,6029,22,22528,148,148,22676
train,6030,4,4096,16,16,4112
train,6031,19,19456,119,119,19575
train,6032,11,11264,65,65,11329
train,6033,25,25600,165,165,25765
train,6034,14,14336,88,88,14424
train,6035,29,29696,197,197,29893
train,6036,20,20480,128,128,20608
train,6037,45,46080,309,309,46389
train,6038,8,8192,44,44,8236
train,6039,15,15360,93,93,15453
train,6040,33,33792,231,231,34023
train,6041,11,11264,65,65,11329
train,6042,24,24576,174,174,24750
train,6043,14,14336,90,90,14426
train,6044,19,19456,143,143,19599
train,6045,38,38912,266,266,39178
train,6046,37,37888,281,281,38169
train,6047,17,17408,107,107,17515
train,6048,31,31744,205,205,31949
train,6049,24,24576,156,156,24732
train,6050,25,25600,173,173,25773
train,6051,14,14336,86,86,14422
train,6052,11,11264,65,65,11329
train,6053,25,25600,163,163,25763
train,6054,20,20480,140,140,20620
train,6055,12,12288,72,72,12360
train,6056,33,33792,229,229,34021
train,6057,9,9216,51,51,9267
train,6058,23,23552,157,157,23709
train,6059,7,7168,37,37,7205
train,6060,22,22528,148,148,22676
train,6061,15,15360,97,97,15457
train,6062,29,29696,199,199,29895
train,6063,28,28672,200,200,28872
train,6064,23,23552,147,147,23699
train,6065,18,18432,122,122,18554
train,6066,29,29696,203,203,29899
train,6067,12,12288,72,72,12360
train,6068,19,19456,121,121,19577
train,6069,27,27648,177,177,27825
train,6070,11,11264,63,63,11327
train,6071,12,12288,72,72,12360
train,6072,29,29696,197,197,29893
train,6073,19,19456,131,131,19587
train,6074,30,30720,216,216,30936
train,6075,19,19456,125,125,19581
train,6076,41,41984,309,309,42293
train,6077,5,5120,23,23,5143
train,6078,8,8192,46,46,8238
train,6079,19,19456,121,121,19577
train,6080,15,15360,93,93,15453
train,6081,13,13312,79,79,13391
train,6082,21,21504,145,145,21649
train,6083,20,20480,128,128,20608
train,6084,15,15360,93,93,15453
train,6085,6,6144,30,30,6174
train,6086,23,23552,155,155,23707
train,6087,29,29696,195,195,29891
train,6088,22,22528,146,146,22674
train,6089,9,9216,51,51,9267
train,6090,10,10240,58,58,10298
train,6091,21,21504,149,149,21653
train,6092,12,12288,72,72,12360
train,6093,19,19456,119,119,19575
train,6094,16,16384,104,104,16488
train,6095,26,26624,180,180,26804
train,6096,18,18432,114,114,18546
train,6097,24,24576,156,156,24732
train,6098,29,29696,197,197,29893
train,6099,13,13312,79,79,13391
train,6100,6,6144,30,30,6174
train,6101,16,16384,104,104,16488
train,6102,22,22528,150,150,22678
train,6103,10,10240,58,58,10298
train,6104,11,11264,65,65,11329
train,6105,22,22528,148,148,22676
train,6106,25,25600,175,175,25775
train,6107,15,15360,93,93,15453
train,6108,11,11264,65,65,11329
train,6109,35,35840,249,249,36089
train,6110,25,25600,165,165,25765
train,6111,6,6144,30,30,6174
train,6112,30,30720,204,204,30924
train,6113,11,11264,65,65,11329
train,6114,17,17408,107,107,17515
train,6115,20,20480,134,134,20614
train,6116,22,22528,146,146,22674
train,6117,23,23552,147,147,23699
train,6118,31,31744,221,221,31965
train,6119,30,30720,214,214,30934
train,6120,22,22528,142,142,22670
train,6121,5,5120,23,23,5143
train,6122,19,19456,121,121,19577
train,6123,23,23552,149,149,23701
train,6124,36,36864,240,240,37104
train,6125,31,31744,217,217,31961
train,6126,17,17408,107,107,17515
train,6127,12,12288,72,72,12360
train,6128,25,25600,163,163,25763
train,6129,12,12288,74,74,12362
train,6130,17,17408,107,107,17515
train,6131,21,21504,141,141,21645
train,6132,8,8192,44,44,8236
train,6133,21,21504,149,149,21653
train,6134,10,10240,60,60,10300
train,6135,15,15360,99,99,15459
train,6136,20,20480,128,128,20608
train,6137,28,28672,190,190,28862
train,6138,20,20480,140,140,20620
train,6139,22,22528,140,140,22668
train,6140,19,19456,121,121,19577
train,6141,14,14336,94,94,14430
train,6142,15,15360,93,93,15453
train,6143,25,25600,163,163,25763
train,6144,16,16384,106,106,16490
train,6145,15,15360,93,93,15453
train,6146,20,20480,134,134,20614
train,6147,27,27648,189,189,27837
train,6148,25,25600,177,177,25777
train,6149,12,12288,74,74,12362
train,6150,35,35840,241,241,36081
train,6151,8,8192,44,44,8236
train,6152,19,19456,127,127,19583
train,6153,19,19456,121,121,19577
train,6154,17,17408,109,109,17517
train,6155,36,36864,262,262,37126
train,6156,27,27648,177,177,27825
train,6157,24,24576,172,172,24748
train,6158,31,31744,219,219,31963
train,6159,27,27648,191,191,27839
train,6160,41,41984,281,281,42265
train,6161,19,19456,123,123,19579
train,6162,36,36864,246,246,37110
train,6163,18,18432,114,114,18546
train,6164,25,25600,169,169,25769
train,6165,33,33792,225,225,34017
train,6166,8,8192,44,44,8236
train,6167,5,5120,23,23,5143
train,6168,10,10240,58,58,10298
train,6169,24,24576,162,162,24738
train,6170,25,25600,169,169,25769
train,6171,16,16384,100,100,16484
train,6172,28,28672,190,190,28862
train,6173,10,10240,56,56,10296
train,6174,16,16384,102,102,16486
train,6175,24,24576,154,154,24730
train,6176,19,19456,121,121,19577
train,6177,8,8192,44,44,8236
train,6178,27,27648,177,177,27825
train,6179,18,18432,114,114,18546
train,6180,14,14336,86,86,14422
train,6181,30,30720,208,208,30928
train,6182,13,13312,81,81,13393
train,6183,14,14336,84,84,14420
train,6184,22,22528,152,152,22680
train,6185,33,33792,243,243,34035
train,6186,34,34816,292,292,35108
train,6187,19,19456,121,121,19577
train,6188,3,3072,9,9,3081
train,6189,17,17408,107,107,17515
train,6190,16,16384,116,116,16500
train,6191,30,30720,208,208,30928
train,6192,18,18432,114,114,18546
train,6193,9,9216,51,51,9267
train,6194,17,17408,117,117,17525
train,6195,18,18432,114,114,18546
train,6196,5,5120,23,23,5143
train,6197,12,12288,70,70,12358
train,6198,35,35840,267,267,36107
train,6199,26,26624,184,184,26808
train,6200,30,30720,230,230,30950
train,6201,22,22528,144,144,22672
train,6202,27,27648,181,181,27829
train,6203,36,36864,292,292,37156
train,6204,20,20480,138,138,20618
train,6205,20,20480,130,130,20610
train,6206,31,31744,219,219,31963
train,6207,23,23552,159,159,23711
train,6208,30,30720,204,204,30924
train,6209,21,21504,135,135,21639
train,6210,19,19456,121,121,19577
train,6211,21,21504,133,133,21637
train,6212,24,24576,168,168,24744
train,6213,12,12288,74,74,12362
train,6214,13,13312,77,77,13389
train,6215,25,25600,175,175,25775
train,6216,35,35840,273,273,36113
train,6217,25,25600,163,163,25763
train,6218,26,26624,190,190,26814
train,6219,28,28672,188,188,28860
train,6220,23,23552,155,155,23707
train,6221,26,26624,182,182,26806
train,6222,20,20480,128,128,20608
train,6223,17,17408,107,107,17515
train,6224,26,26624,184,184,26808
train,6225,29,29696,191,191,29887
train,6226,29,29696,203,203,29899
train,6227,25,25600,169,169,25769
train,6228,19,19456,121,121,19577
train,6229,19,19456,131,131,19587
train,6230,30,30720,218,218,30938
train,6231,10,10240,58,58,10298
train,6232,6,6144,30,30,6174
train,6233,10,10240,58,58,10298
train,6234,10,10240,58,58,10298
train,6235,35,35840,233,233,36073
train,6236,29,29696,195,195,29891
train,6237,6,6144,30,30,6174
train,6238,17,17408,107,107,17515
train,6239,29,29696,201,201,29897
train,6240,22,22528,146,146,22674
train,6241,31,31744,243,243,31987
train,6242,24,24576,162,162,24738
train,6243,14,14336,86,86,14422
train,6244,11,11264,65,65,11329
train,6245,18,18432,114,114,18546
train,6246,10,10240,58,58,10298
train,6247,25,25600,163,163,25763
train,6248,34,34816,232,232,35048
train,6249,30,30720,198,198,30918
train,6250,31,31744,205,205,31949
train,6251,6,6144,30,30,6174
train,6252,31,31744,211,211,31955
train,6253,6,6144,30,30,6174
train,6254,16,16384,100,100,16484
train,6255,19,19456,123,123,19579
train,6256,5,5120,23,23,5143
train,6257,11,11264,65,65,11329
train,6258,23,23552,149,149,23701
train,6259,21,21504,135,135,21639
train,6260,7,7168,37,37,7205
train,6261,28,28672,196,196,28868
train,6262,22,22528,150,150,22678
train,6263,35,35840,245,245,36085
train,6264,29,29696,213,213,29909
train,6265,5,5120,23,23,5143
train,6266,14,14336,86,86,14422
train,6267,21,21504,139,139,21643
train,6268,44,45056,304,304,45360
train,6269,21,21504,133,133,21637
train,6270,27,27648,183,183,27831
train,6271,20,20480,128,128,20608
train,6272,21,21504,139,139,21643
train,6273,22,22528,148,148,22676
train,6274,10,10240,62,62,10302
train,6275,30,30720,210,210,30930
train,6276,12,12288,72,72,12360
train,6277,17,17408,115,115,17523
train,6278,12,12288,72,72,12360
train,6279,12,12288,72,72,12360
train,6280,28,28672,190,190,28862
train,6281,16,16384,100,100,16484
train,6282,39,39936,293,293,40229
train,6283,25,25600,179,179,25779
train,6284,24,24576,154,154,24730
train,6285,6,6144,30,30,6174
train,6286,41,41984,275,275,42259
train,6287,33,33792,229,229,34021
train,6288,40,40960,294,294,41254
train,6289,36,36864,270,270,37134
train,6290,29,29696,191,191,29887
train,6291,32,32768,216,216,32984
train,6292,6,6144,30,30,6174
train,6293,29,29696,203,203,29899
train,6294,21,21504,141,141,21645
train,6295,26,26624,180,180,26804
train,6296,23,23552,149,149,23701
train,6297,11,11264,65,65,11329
train,6298,16,16384,100,100,16484
train,6299,26,26624,180,180,26804
train,6300,28,28672,184,184,28856
train,6301,8,8192,44,44,8236
train,6302,21,21504,141,141,21645
train,6303,22,22528,140,140,22668
train,6304,25,25600,169,169,25769
train,6305,12,12288,72,72,12360
train,6306,23,23552,161,161,23713
train,6307,24,24576,166,166,24742
train,6308,16,16384,100,100,16484
train,6309,24,24576,158,158,24734
train,6310,39,39936,277,277,40213
train,6311,33,33792,225,225,34017
train,6312,24,24576,156,156,24732
train,6313,7,7168,37,37,7205
train,6314,24,24576,158,158,24734
train,6315,33,33792,235,235,34027
train,6316,22,22528,140,140,22668
train,6317,27,27648,193,193,27841
train,6318,12,12288,72,72,12360
train,6319,13,13312,79,79,13391
train,6320,10,10240,58,58,10298
train,6321,29,29696,213,213,29909
train,6322,34,34816,244,244,35060
train,6323,12,12288,72,72,12360
train,6324,19,19456,131,131,19587
train,6325,24,24576,162,162,24738
train,6326,16,16384,100,100,16484
train,6327,21,21504,135,135,21639
train,6328,10,10240,58,58,10298
train,6329,11,11264,63,63,11327
train,6330,20,20480,140,140,20620
train,6331,42,43008,302,302,43310
train,6332,35,35840,251,251,36091
train,6333,30,30720,198,198,30918
train,6334,31,31744,209,209,31953
train,6335,11,11264,65,65,11329
train,6336,13,13312,79,79,13391
train,6337,21,21504,143,143,21647
train,6338,16,16384,100,100,16484
train,6339,19,19456,115,115,19571
train,6340,37,37888,273,273,38161
train,6341,21,21504,163,163,21667
train,6342,24,24576,160,160,24736
train,6343,12,12288,72,72,12360
train,6344,13,13312,79,79,13391
train,6345,20,20480,128,128,20608
train,6346,18,18432,114,114,18546
train,6347,19,19456,127,127,19583
train,6348,8,8192,44,44,8236
train,6349,30,30720,198,198,30918
train,6350,38,38912,260,260,39172
train,6351,29,29696,195,195,29891
train,6352,22,22528,154,154,22682
train,6353,16,16384,100,100,16484
train,6354,24,24576,156,156,24732
train,6355,33,33792,251,251,34043
train,6356,26,26624,182,182,26806
train,6357,22,22528,142,142,22670
train,6358,28,28672,190,190,28862
train,6359,13,13312,83,83,13395
train,6360,26,26624,192,192,26816
train,6361,37,37888,251,251,38139
train,6362,20,20480,134,134,20614
train,6363,3,3072,9,9,3081
train,6364,10,10240,58,58,10298
train,6365,29,29696,197,197,29893
train,6366,14,14336,86,86,14422
train,6367,10,10240,58,58,10298
train,6368,8,8192,44,44,8236
train,6369,34,34816,246,246,35062
train,6370,8,8192,44,44,8236
train,6371,21,21504,135,135,21639
train,6372,33,33792,235,235,34027
train,6373,18,18432,114,114,18546
train,6374,23,23552,149,149,23701
train,6375,23,23552,161,161,23713
train,6376,22,22528,148,148,22676
train,6377,11,11264,65,65,11329
train,6378,19,19456,121,121,19577
train,6379,14,14336,86,86,14422
train,6380,32,32768,230,230,32998
train,6381,13,13312,79,79,13391
train,6382,20,20480,128,128,20608
train,6383,20,20480,134,134,20614
train,6384,6,6144,30,30,6174
train,6385,18,18432,120,120,18552
train,6386,23,23552,149,149,23701
train,6387,35,35840,249,249,36089
train,6388,33,33792,241,241,34033
train,6389,15,15360,93,93,15453
train,6390,29,29696,197,197,29893
train,6391,29,29696,207,207,29903
train,6392,14,14336,84,84,14420
train,6393,42,43008,328,328,43336
train,6394,7,7168,37,37,7205
train,6395,27,27648,187,187,27835
train,6396,12,12288,72,72,12360
train,6397,24,24576,174,174,24750
train,6398,16,16384,100,100,16484
train,6399,11,11264,65,65,11329
train,6400,39,39936,279,279,40215
train,6401,26,26624,176,176,26800
train,6402,9,9216,53,53,9269
train,6403,9,9216,51,51,9267
train,6404,13,13312,79,79,13391
train,6405,10,10240,58,58,10298
train,6406,7,7168,37,37,7205
train,6407,11,11264,65,65,11329
train,6408,7,7168,37,37,7205
train,6409,24,24576,166,166,24742
train,6410,36,36864,252,252,37116
train,6411,13,13312,89,89,13401
train,6412,29,29696,211,211,29907
train,6413,23,23552,155,155,23707
train,6414,18,18432,118,118,18550
train,6415,27,27648,193,193,27841
train,6416,30,30720,216,216,30936
train,6417,23,23552,155,155,23707
train,6418,16,16384,102,102,16486
train,6419,16,16384,106,106,16490
train,6420,21,21504,143,143,21647
train,6421,17,17408,107,107,17515
train,6422,18,18432,114,114,18546
train,6423,8,8192,44,44,8236
train,6424,14,14336,86,86,14422
train,6425,17,17408,107,107,17515
train,6426,22,22528,158,158,22686
train,6427,31,31744,223,223,31967
train,6428,18,18432,122,122,18554
train,6429,7,7168,37,37,7205
train,6430,19,19456,127,127,19583
train,6431,18,18432,114,114,18546
train,6432,6,6144,30,30,6174
train,6433,30,30720,228,228,30948
train,6434,13,13312,79,79,13391
train,6435,20,20480,130,130,20610
train,6436,25,25600,179,179,25779
train,6437,18,18432,130,130,18562
train,6438,36,36864,280,280,37144
train,6439,35,35840,273,273,36113
train,6440,29,29696,195,195,29891
train,6441,23,23552,149,149,23701
train,6442,14,14336,94,94,14430
train,6443,37,37888,279,279,38167
train,6444,12,12288,72,72,12360
train,6445,9,9216,51,51,9267
train,6446,5,5120,23,23,5143
train,6447,8,8192,44,44,8236
train,6448,24,24576,156,156,24732
train,6449,26,26624,176,176,26800
train,6450,24,24576,156,156,24732
train,6451,10,10240,58,58,10298
train,6452,27,27648,185,185,27833
train,6453,15,15360,99,99,15459
train,6454,5,5120,23,23,5143
train,6455,14,14336,86,86,14422
train,6456,22,22528,148,148,22676
train,6457,13,13312,79,79,13391
train,6458,31,31744,219,219,31963
train,6459,22,22528,142,142,22670
train,6460,15,15360,93,93,15453
train,6461,12,12288,72,72,12360
train,6462,24,24576,156,156,24732
train,6463,6,6144,30,30,6174
train,6464,16,16384,102,102,16486
train,6465,12,12288,72,72,12360
train,6466,14,14336,84,84,14420
train,6467,41,41984,305,305,42289
train,6468,11,11264,65,65,11329
train,6469,24,24576,156,156,24732
train,6470,29,29696,213,213,29909
train,6471,24,24576,160,160,24736
train,6472,12,12288,72,72,12360
train,6473,9,9216,51,51,9267
train,6474,9,9216,51,51,9267
train,6475,43,44032,315,315,44347
train,6476,13,13312,79,79,13391
train,6477,29,29696,191,191,29887
train,6478,24,24576,162,162,24738
train,6479,24,24576,166,166,24742
train,6480,11,11264,65,65,11329
train,6481,33,33792,239,239,34031
train,6482,22,22528,146,146,22674
train,6483,10,10240,58,58,10298
train,6484,43,44032,315,315,44347
train,6485,22,22528,146,146,22674
train,6486,23,23552,155,155,23707
train,6487,38,38912,266,266,39178
train,6488,16,16384,100,100,16484
train,6489,4,4096,16,16,4112
train,6490,22,22528,142,142,22670
train,6491,36,36864,250,250,37114
train,6492,26,26624,182,182,26806
train,6493,42,43008,292,292,43300
train,6494,18,18432,114,114,18546
train,6495,21,21504,141,141,21645
train,6496,33,33792,233,233,34025
train,6497,24,24576,160,160,24736
train,6498,16,16384,106,106,16490
train,6499,45,46080,319,319,46399
train,6500,21,21504,139,139,21643
train,6501,29,29696,211,211,29907
train,6502,4,4096,16,16,4112
train,6503,24,24576,156,156,24732
train,6504,26,26624,182,182,26806
train,6505,21,21504,141,141,21645
train,6506,27,27648,189,189,27837
train,6507,10,10240,60,60,10300
train,6508,10,10240,56,56,10296
train,6509,25,25600,167,167,25767
train,6510,16,16384,100,100,16484
train,6511,21,21504,137,137,21641
train,6512,18,18432,114,114,18546
train,6513,22,22528,142,142,22670
train,6514,28,28672,184,184,28856
train,6515,7,7168,37,37,7205
train,6516,22,22528,152,152,22680
train,6517,23,23552,149,149,23701
train,6518,7,7168,37,37,7205
train,6519,5,5120,23,23,5143
train,6520,9,9216,51,51,9267
train,6521,4,4096,16,16,4112
train,6522,19,19456,135,135,19591
train,6523,19,19456,125,125,19581
train,6524,18,18432,112,112,18544
train,6525,16,16384,100,100,16484
train,6526,7,7168,37,37,7205
train,6527,17,17408,103,103,17511
train,6528,3,3072,9,9,3081
train,6529,16,16384,100,100,16484
train,6530,18,18432,114,114,18546
train,6531,26,26624,170,170,26794
train,6532,19,19456,121,121,19577
train,6533,16,16384,104,104,16488
train,6534,30,30720,210,210,30930
train,6535,19,19456,121,121,19577
train,6536,19,19456,121,121,19577
train,6537,29,29696,191,191,29887
train,6538,39,39936,285,285,40221
train,6539,7,7168,37,37,7205
train,6540,22,22528,160,160,22688
train,6541,22,22528,148,148,22676
train,6542,9,9216,51,51,9267
train,6543,20,20480,128,128,20608
train,6544,28,28672,204,204,28876
train,6545,35,35840,249,249,36089
train,6546,13,13312,79,79,13391
train,6547,24,24576,160,160,24736
train,6548,31,31744,229,229,31973
train,6549,14,14336,86,86,14422
train,6550,12,12288,72,72,12360
train,6551,11,11264,65,65,11329
train,6552,4,4096,16,16,4112
train,6553,22,22528,146,146,22674
train,6554,22,22528,142,142,22670
train,6555,11,11264,75,75,11339
train,6556,17,17408,107,107,17515
train,6557,14,14336,86,86,14422
train,6558,14,14336,86,86,14422
train,6559,33,33792,237,237,34029
train,6560,11,11264,65,65,11329
train,6561,9,9216,51,51,9267
train,6562,6,6144,30,30,6174
train,6563,4,4096,16,16,4112
train,6564,7,7168,37,37,7205
train,6565,6,6144,30,30,6174
train,6566,36,36864,256,256,37120
train,6567,31,31744,213,213,31957
train,6568,28,28672,184,184,28856
train,6569,18,18432,114,114,18546
train,6570,43,44032,323,323,44355
train,6571,13,13312,79,79,13391
train,6572,19,19456,119,119,19575
train,6573,24,24576,176,176,24752
train,6574,28,28672,210,210,28882
train,6575,27,27648,201,201,27849
train,6576,12,12288,72,72,12360
train,6577,12,12288,72,72,12360
train,6578,15,15360,91,91,15451
train,6579,23,23552,155,155,23707
train,6580,13,13312,79,79,13391
train,6581,40,40960,284,284,41244
train,6582,6,6144,30,30,6174
train,6583,13,13312,83,83,13395
train,6584,15,15360,93,93,15453
train,6585,26,26624,182,182,26806
train,6586,22,22528,148,148,22676
train,6587,31,31744,217,217,31961
train,6588,28,28672,190,190,28862
train,6589,14,14336,86,86,14422
train,6590,13,13312,79,79,13391
train,6591,15,15360,93,93,15453
train,6592,23,23552,151,151,23703
train,6593,11,11264,65,65,11329
train,6594,12,12288,70,70,12358
train,6595,25,25600,167,167,25767
train,6596,39,39936,283,283,40219
train,6597,8,8192,46,46,8238
train,6598,18,18432,114,114,18546
train,6599,27,27648,181,181,27829
train,6600,14,14336,86,86,14422
train,6601,8,8192,44,44,8236
train,6602,11,11264,65,65,11329
train,6603,20,20480,128,128,20608
train,6604,24,24576,168,168,24744
train,6605,5,5120,23,23,5143
train,6606,11,11264,67,67,11331
train,6607,29,29696,213,213,29909
train,6608,16,16384,100,100,16484
train,6609,15,15360,89,89,15449
train,6610,18,18432,120,120,18552
train,6611,17,17408,107,107,17515
train,6612,22,22528,142,142,22670
train,6613,23,23552,161,161,23713
train,6614,3,3072,9,9,3081
train,6615,17,17408,107,107,17515
train,6616,15,15360,93,93,15453
train,6617,18,18432,114,114,18546
train,6618,36,36864,246,246,37110
train,6619,27,27648,177,177,27825
train,6620,20,20480,128,128,20608
train,6621,21,21504,135,135,21639
train,6622,23,23552,155,155,23707
train,6623,26,26624,196,196,26820
train,6624,8,8192,44,44,8236
train,6625,19,19456,121,121,19577
train,6626,17,17408,107,107,17515
train,6627,37,37888,259,259,38147
train,6628,18,18432,118,118,18550
train,6629,5,5120,23,23,5143
train,6630,27,27648,187,187,27835
train,6631,14,14336,86,86,14422
train,6632,23,23552,159,159,23711
train,6633,14,14336,86,86,14422
train,6634,14,14336,102,102,14438
train,6635,24,24576,156,156,24732
train,6636,22,22528,146,146,22674
train,6637,19,19456,121,121,19577
train,6638,4,4096,16,16,4112
train,6639,15,15360,93,93,15453
train,6640,6,6144,30,30,6174
train,6641,17,17408,107,107,17515
train,6642,39,39936,289,289,40225
train,6643,10,10240,58,58,10298
train,6644,22,22528,148,148,22676
train,6645,9,9216,51,51,9267
train,6646,36,36864,256,256,37120
train,6647,33,33792,227,227,34019
train,6648,32,32768,226,226,32994
train,6649,21,21504,145,145,21649
train,6650,24,24576,156,156,24732
train,6651,11,11264,71,71,11335
train,6652,27,27648,185,185,27833
train,6653,23,23552,165,165,23717
train,6654,12,12288,72,72,12360
train,6655,22,22528,158,158,22686
train,6656,27,27648,189,189,27837
train,6657,22,22528,148,148,22676
train,6658,14,14336,86,86,14422
train,6659,23,23552,153,153,23705
train,6660,27,27648,177,177,27825
train,6661,10,10240,56,56,10296
train,6662,11,11264,65,65,11329
train,6663,29,29696,197,197,29893
train,6664,21,21504,139,139,21643
train,6665,10,10240,60,60,10300
train,6666,12,12288,72,72,12360
train,6667,7,7168,37,37,7205
train,6668,30,30720,214,214,30934
train,6669,29,29696,191,191,29887
train,6670,26,26624,176,176,26800
train,6671,29,29696,197,197,29893
train,6672,17,17408,105,105,17513
train,6673,37,37888,259,259,38147
train,6674,13,13312,79,79,13391
train,6675,12,12288,72,72,12360
train,6676,7,7168,37,37,7205
train,6677,17,17408,105,105,17513
train,6678,24,24576,156,156,24732
train,6679,21,21504,139,139,21643
train,6680,26,26624,176,176,26800
train,6681,20,20480,128,128,20608
train,6682,22,22528,142,142,22670
train,6683,45,46080,357,357,46437
train,6684,27,27648,177,177,27825
train,6685,20,20480,134,134,20614
train,6686,14,14336,86,86,14422
train,6687,4,4096,16,16,4112
train,6688,13,13312,85,85,13397
train,6689,12,12288,72,72,12360
train,6690,16,16384,104,104,16488
train,6691,28,28672,200,200,28872
train,6692,26,26624,170,170,26794
train,6693,15,15360,93,93,15453
train,6694,18,18432,118,118,18550
train,6695,41,41984,299,299,42283
train,6696,31,31744,233,233,31977
train,6697,31,31744,223,223,31967
train,6698,30,30720,214,214,30934
train,6699,12,12288,72,72,12360
train,6700,25,25600,161,161,25761
train,6701,5,5120,23,23,5143
train,6702,25,25600,169,169,25769
train,6703,13,13312,77,77,13389
train,6704,22,22528,156,156,22684
train,6705,4,4096,16,16,4112
train,6706,14,14336,96,96,14432
train,6707,21,21504,145,145,21649
train,6708,11,11264,65,65,11329
train,6709,17,17408,113,113,17521
train,6710,24,24576,162,162,24738
train,6711,31,31744,211,211,31955
train,6712,39,39936,291,291,40227
train,6713,31,31744,221,221,31965
train,6714,24,24576,168,168,24744
train,6715,23,23552,157,157,23709
train,6716,18,18432,114,114,18546
train,6717,31,31744,209,209,31953
train,6718,8,8192,44,44,8236
train,6719,20,20480,128,128,20608
train,6720,9,9216,51,51,9267
train,6721,14,14336,86,86,14422
train,6722,32,32768,214,214,32982
train,6723,9,9216,51,51,9267
train,6724,17,17408,107,107,17515
train,6725,16,16384,100,100,16484
train,6726,25,25600,167,167,25767
train,6727,32,32768,218,218,32986
train,6728,14,14336,86,86,14422
train,6729,13,13312,79,79,13391
train,6730,5,5120,23,23,5143
train,6731,5,5120,23,23,5143
train,6732,29,29696,219,219,29915
train,6733,20,20480,128,128,20608
train,6734,26,26624,186,186,26810
train,6735,33,33792,249,249,34041
train,6736,22,22528,148,148,22676
train,6737,13,13312,79,79,13391
train,6738,13,13312,79,79,13391
train,6739,14,14336,82,82,14418
train,6740,35,35840,251,251,36091
train,6741,31,31744,221,221,31965
train,6742,13,13312,85,85,13397
train,6743,24,24576,166,166,24742
train,6744,15,15360,93,93,15453
train,6745,14,14336,86,86,14422
train,6746,25,25600,171,171,25771
train,6747,8,8192,44,44,8236
train,6748,5,5120,23,23,5143
train,6749,16,16384,100,100,16484
train,6750,30,30720,220,220,30940
train,6751,20,20480,128,128,20608
train,6752,28,28672,190,190,28862
train,6753,30,30720,198,198,30918
train,6754,25,25600,169,169,25769
train,6755,4,4096,16,16,4112
train,6756,18,18432,114,114,18546
train,6757,25,25600,161,161,25761
train,6758,19,19456,129,129,19585
train,6759,20,20480,140,140,20620
train,6760,17,17408,107,107,17515
train,6761,9,9216,51,51,9267
train,6762,39,39936,261,261,40197
train,6763,22,22528,142,142,22670
train,6764,33,33792,235,235,34027
train,6765,37,37888,263,263,38151
train,6766,32,32768,224,224,32992
train,6767,20,20480,128,128,20608
train,6768,28,28672,204,204,28876
train,6769,6,6144,30,30,6174
train,6770,9,9216,51,51,9267
train,6771,6,6144,30,30,6174
train,6772,11,11264,65,65,11329
train,6773,8,8192,44,44,8236
train,6774,4,4096,16,16,4112
train,6775,30,30720,204,204,30924
train,6776,5,5120,23,23,5143
train,6777,13,13312,79,79,13391
train,6778,26,26624,174,174,26798
train,6779,28,28672,188,188,28860
train,6780,28,28672,194,194,28866
train,6781,25,25600,163,163,25763
train,6782,37,37888,257,257,38145
train,6783,31,31744,205,205,31949
train,6784,38,38912,264,264,39176
train,6785,31,31744,211,211,31955
train,6786,12,12288,72,72,12360
train,6787,13,13312,79,79,13391
train,6788,29,29696,201,201,29897
train,6789,16,16384,106,106,16490
train,6790,8,8192,44,44,8236
train,6791,36,36864,250,250,37114
train,6792,24,24576,160,160,24736
train,6793,31,31744,217,217,31961
train,6794,20,20480,130,130,20610
train,6795,21,21504,135,135,21639
train,6796,10,10240,58,58,10298
train,6797,18,18432,114,114,18546
train,6798,8,8192,44,44,8236
train,6799,22,22528,148,148,22676
train,6800,4,4096,16,16,4112
train,6801,12,12288,72,72,12360
train,6802,12,12288,72,72,12360
train,6803,17,17408,107,107,17515
train,6804,19,19456,141,141,19597
train,6805,9,9216,53,53,9269
train,6806,33,33792,247,247,34039
train,6807,13,13312,79,79,13391
train,6808,17,17408,105,105,17513
train,6809,9,9216,51,51,9267
train,6810,20,20480,134,134,20614
train,6811,26,26624,170,170,26794
train,6812,19,19456,133,133,19589
train,6813,22,22528,160,160,22688
train,6814,8,8192,44,44,8236
train,6815,36,36864,262,262,37126
train,6816,20,20480,130,130,20610
train,6817,31,31744,211,211,31955
train,6818,21,21504,135,135,21639
train,6819,18,18432,114,114,18546
train,6820,29,29696,213,213,29909
train,6821,23,23552,149,149,23701
train,6822,9,9216,51,51,9267
train,6823,19,19456,121,121,19577
train,6824,11,11264,65,65,11329
train,6825,30,30720,214,214,30934
train,6826,45,46080,321,321,46401
train,6827,23,23552,157,157,23709
train,6828,8,8192,44,44,8236
train,6829,33,33792,225,225,34017
train,6830,27,27648,191,191,27839
train,6831,11,11264,65,65,11329
train,6832,21,21504,151,151,21655
train,6833,38,38912,266,266,39178
train,6834,40,40960,298,298,41258
train,6835,19,19456,121,121,19577
train,6836,23,23552,161,161,23713
train,6837,14,14336,96,96,14432
train,6838,20,20480,134,134,20614
train,6839,18,18432,118,118,18550
train,6840,7,7168,37,37,7205
train,6841,12,12288,70,70,12358
train,6842,21,21504,151,151,21655
train,6843,8,8192,44,44,8236
train,6844,20,20480,128,128,20608
train,6845,29,29696,191,191,29887
train,6846,24,24576,156,156,24732
train,6847,33,33792,229,229,34021
train,6848,15,15360,93,93,15453
train,6849,27,27648,177,177,27825
train,6850,36,36864,256,256,37120
train,6851,28,28672,216,216,28888
train,6852,22,22528,142,142,22670
train,6853,17,17408,113,113,17521
train,6854,14,14336,92,92,14428
train,6855,24,24576,156,156,24732
train,6856,18,18432,114,114,18546
train,6857,23,23552,149,149,23701
train,6858,18,18432,114,114,18546
train,6859,18,18432,114,114,18546
train,6860,26,26624,170,170,26794
train,6861,20,20480,140,140,20620
train,6862,22,22528,144,144,22672
train,6863,16,16384,100,100,16484
train,6864,32,32768,224,224,32992
train,6865,38,38912,260,260,39172
train,6866,26,26624,182,182,26806
train,6867,29,29696,205,205,29901
train,6868,42,43008,298,298,43306
train,6869,18,18432,130,130,18562
train,6870,20,20480,142,142,20622
train,6871,16,16384,100,100,16484
train,6872,22,22528,148,148,22676
train,6873,19,19456,121,121,19577
train,6874,15,15360,93,93,15453
train,6875,20,20480,138,138,20618
train,6876,34,34816,250,250,35066
train,6877,21,21504,135,135,21639
train,6878,24,24576,160,160,24736
train,6879,7,7168,37,37,7205
train,6880,16,16384,100,100,16484
train,6881,34,34816,250,250,35066
train,6882,12,12288,72,72,12360
train,6883,16,16384,106,106,16490
train,6884,20,20480,138,138,20618
train,6885,20,20480,134,134,20614
train,6886,25,25600,179,179,25779
train,6887,27,27648,187,187,27835
train,6888,31,31744,207,207,31951
train,6889,38,38912,258,258,39170
train,6890,16,16384,110,110,16494
train,6891,31,31744,211,211,31955
train,6892,14,14336,86,86,14422
train,6893,18,18432,114,114,18546
train,6894,22,22528,142,142,22670
train,6895,10,10240,58,58,10298
train,6896,20,20480,134,134,20614
train,6897,25,25600,169,169,25769
train,6898,30,30720,224,224,30944
train,6899,27,27648,177,177,27825
train,6900,19,19456,123,123,19579
train,6901,8,8192,46,46,8238
train,6902,13,13312,79,79,13391
train,6903,19,19456,127,127,19583
train,6904,28,28672,186,186,28858
train,6905,14,14336,86,86,14422
train,6906,8,8192,44,44,8236
train,6907,25,25600,163,163,25763
train,6908,15,15360,93,93,15453
train,6909,15,15360,93,93,15453
train,6910,11,11264,65,65,11329
train,6911,19,19456,125,125,19581
train,6912,22,22528,142,142,22670
train,6913,15,15360,93,93,15453
train,6914,17,17408,107,107,17515
train,6915,29,29696,197,197,29893
train,6916,23,23552,149,149,23701
train,6917,10,10240,60,60,10300
train,6918,18,18432,110,110,18542
train,6919,29,29696,193,193,29889
validation,0,23,23552,149,149,23701
validation,1,35,35840,239,239,36079
validation,2,27,27648,197,197,27845
validation,3,30,30720,202,202,30922
validation,4,24,24576,172,172,24748
validation,5,21,21504,141,141,21645
validation,6,17,17408,107,107,17515
validation,7,20,20480,134,134,20614
validation,8,18,18432,126,126,18558
validation,9,28,28672,192,192,28864
validation,10,24,24576,164,164,24740
validation,11,14,14336,86,86,14422
validation,12,23,23552,149,149,23701
validation,13,45,46080,325,325,46405
validation,14,24,24576,156,156,24732
validation,15,16,16384,104,104,16488
validation,16,11,11264,65,65,11329
validation,17,10,10240,58,58,10298
validation,18,22,22528,148,148,22676
validation,19,11,11264,65,65,11329
validation,20,29,29696,209,209,29905
validation,21,29,29696,189,189,29885
validation,22,10,10240,58,58,10298
validation,23,7,7168,37,37,7205
validation,24,26,26624,178,178,26802
validation,25,41,41984,299,299,42283
validation,26,13,13312,79,79,13391
validation,27,14,14336,86,86,14422
validation,28,40,40960,274,274,41234
validation,29,17,17408,111,111,17519
validation,30,16,16384,100,100,16484
validation,31,48,49152,346,346,49498
validation,32,17,17408,117,117,17525
validation,33,34,34816,230,230,35046
validation,34,18,18432,120,120,18552
validation,35,33,33792,237,237,34029
validation,36,26,26624,170,170,26794
validation,37,20,20480,138,138,20618
validation,38,18,18432,118,118,18550
validation,39,26,26624,182,182,26806
validation,40,35,35840,233,233,36073
validation,41,13,13312,79,79,13391
validation,42,32,32768,218,218,32986
validation,43,10,10240,68,68,10308
validation,44,25,25600,189,189,25789
validation,45,31,31744,217,217,31961
validation,46,18,18432,114,114,18546
validation,47,13,13312,79,79,13391
validation,48,6,6144,30,30,6174
validation,49,12,12288,72,72,12360
validation,50,23,23552,151,151,23703
validation,51,31,31744,217,217,31961
validation,52,19,19456,121,121,19577
validation,53,9,9216,49,49,9265
validation,54,19,19456,121,121,19577
validation,55,22,22528,148,148,22676
validation,56,18,18432,124,124,18556
validation,57,15,15360,91,91,15451
validation,58,14,14336,86,86,14422
validation,59,18,18432,120,120,18552
validation,60,5,5120,23,23,5143
validation,61,14,14336,86,86,14422
validation,62,13,13312,79,79,13391
validation,63,20,20480,128,128,20608
validation,64,11,11264,65,65,11329
validation,65,22,22528,154,154,22682
validation,66,30,30720,204,204,30924
validation,67,6,6144,30,30,6174
validation,68,11,11264,65,65,11329
validation,69,29,29696,205,205,29901
validation,70,17,17408,107,107,17515
validation,71,28,28672,184,184,28856
validation,72,18,18432,114,114,18546
validation,73,21,21504,157,157,21661
validation,74,26,26624,180,180,26804
validation,75,14,14336,92,92,14428
validation,76,29,29696,197,197,29893
validation,77,23,23552,167,167,23719
validation,78,16,16384,104,104,16488
validation,79,28,28672,184,184,28856
validation,80,39,39936,277,277,40213
validation,81,15,15360,93,93,15453
validation,82,20,20480,128,128,20608
validation,83,29,29696,227,227,29923
validation,84,33,33792,225,225,34017
validation,85,22,22528,148,148,22676
validation,86,14,14336,86,86,14422
validation,87,19,19456,129,129,19585
validation,88,15,15360,93,93,15453
validation,89,31,31744,215,215,31959
validation,90,10,10240,58,58,10298
validation,91,27,27648,177,177,27825
validation,92,23,23552,161,161,23713
validation,93,18,18432,114,114,18546
validation,94,25,25600,165,165,25765
validation,95,32,32768,218,218,32986
validation,96,41,41984,301,301,42285
validation,97,26,26624,186,186,26810
validation,98,20,20480,128,128,20608
validation,99,18,18432,114,114,18546
validation,100,38,38912,258,258,39170
validation,101,17,17408,107,107,17515
validation,102,18,18432,124,124,18556
validation,103,40,40960,282,282,41242
validation,104,19,19456,121,121,19577
validation,105,16,16384,100,100,16484
validation,106,27,27648,177,177,27825
validation,107,39,39936,275,275,40211
validation,108,12,12288,72,72,12360
validation,109,21,21504,135,135,21639
validation,110,27,27648,183,183,27831
validation,111,30,30720,214,214,30934
validation,112,26,26624,186,186,26810
validation,113,23,23552,155,155,23707
validation,114,30,30720,210,210,30930
validation,115,6,6144,30,30,6174
validation,116,32,32768,240,240,33008
validation,117,28,28672,190,190,28862
validation,118,19,19456,127,127,19583
validation,119,18,18432,114,114,18546
validation,120,22,22528,158,158,22686
validation,121,25,25600,199,199,25799
validation,122,28,28672,184,184,28856
validation,123,10,10240,58,58,10298
validation,124,27,27648,195,195,27843
validation,125,10,10240,58,58,10298
validation,126,21,21504,135,135,21639
validation,127,24,24576,162,162,24738
validation,128,42,43008,288,288,43296
validation,129,28,28672,216,216,28888
validation,130,28,28672,202,202,28874
validation,131,26,26624,180,180,26804
validation,132,37,37888,269,269,38157
validation,133,36,36864,272,272,37136
validation,134,26,26624,176,176,26800
validation,135,25,25600,175,175,25775
validation,136,21,21504,135,135,21639
validation,137,37,37888,269,269,38157
validation,138,24,24576,164,164,24740
validation,139,14,14336,84,84,14420
validation,140,32,32768,222,222,32990
validation,141,38,38912,276,276,39188
validation,142,27,27648,199,199,27847
validation,143,19,19456,121,121,19577
validation,144,18,18432,114,114,18546
validation,145,35,35840,245,245,36085
validation,146,32,32768,222,222,32990
validation,147,22,22528,148,148,22676
validation,148,30,30720,202,202,30922
validation,149,17,17408,107,107,17515
validation,150,38,38912,266,266,39178
validation,151,22,22528,160,160,22688
validation,152,9,9216,51,51,9267
validation,153,11,11264,65,65,11329
validation,154,21,21504,135,135,21639
validation,155,7,7168,37,37,7205
validation,156,10,10240,58,58,10298
validation,157,25,25600,163,163,25763
validation,158,25,25600,163,163,25763
validation,159,11,11264,65,65,11329
validation,160,14,14336,86,86,14422
validation,161,18,18432,112,112,18544
validation,162,20,20480,132,132,20612
validation,163,26,26624,192,192,26816
validation,164,9,9216,51,51,9267
validation,165,18,18432,114,114,18546
validation,166,26,26624,182,182,26806
validation,167,27,27648,177,177,27825
validation,168,10,10240,58,58,10298
validation,169,9,9216,51,51,9267
validation,170,15,15360,95,95,15455
validation,171,20,20480,126,126,20606
validation,172,22,22528,148,148,22676
validation,173,21,21504,135,135,21639
validation,174,21,21504,141,141,21645
validation,175,40,40960,284,284,41244
validation,176,9,9216,51,51,9267
validation,177,22,22528,140,140,22668
validation,178,30,30720,202,202,30922
validation,179,20,20480,138,138,20618
validation,180,20,20480,144,144,20624
validation,181,32,32768,218,218,32986
validation,182,19,19456,121,121,19577
validation,183,17,17408,111,111,17519
validation,184,23,23552,155,155,23707
validation,185,9,9216,51,51,9267
validation,186,22,22528,142,142,22670
validation,187,27,27648,205,205,27853
validation,188,19,19456,127,127,19583
validation,189,14,14336,86,86,14422
validation,190,29,29696,209,209,29905
validation,191,24,24576,162,162,24738
validation,192,29,29696,203,203,29899
validation,193,11,11264,77,77,11341
validation,194,15,15360,93,93,15453
validation,195,9,9216,51,51,9267
validation,196,12,12288,72,72,12360
validation,197,19,19456,121,121,19577
validation,198,36,36864,266,266,37130
validation,199,16,16384,100,100,16484
validation,200,30,30720,216,216,30936
validation,201,29,29696,209,209,29905
validation,202,7,7168,35,35,7203
validation,203,9,9216,51,51,9267
validation,204,25,25600,163,163,25763
validation,205,14,14336,82,82,14418
validation,206,15,15360,95,95,15455
validation,207,29,29696,195,195,29891
validation,208,39,39936,293,293,40229
validation,209,3,3072,9,9,3081
validation,210,19,19456,121,121,19577
validation,211,10,10240,58,58,10298
validation,212,13,13312,79,79,13391
validation,213,26,26624,176,176,26800
validation,214,21,21504,145,145,21649
validation,215,10,10240,58,58,10298
validation,216,30,30720,214,214,30934
validation,217,34,34816,244,244,35060
validation,218,25,25600,175,175,25775
validation,219,24,24576,158,158,24734
validation,220,20,20480,128,128,20608
validation,221,17,17408,107,107,17515
validation,222,17,17408,117,117,17525
validation,223,35,35840,245,245,36085
validation,224,38,38912,278,278,39190
validation,225,23,23552,149,149,23701
validation,226,23,23552,155,155,23707
validation,227,20,20480,128,128,20608
validation,228,36,36864,240,240,37104
validation,229,17,17408,107,107,17515
validation,230,22,22528,140,140,22668
validation,231,12,12288,72,72,12360
validation,232,6,6144,30,30,6174
validation,233,23,23552,149,149,23701
validation,234,9,9216,51,51,9267
validation,235,22,22528,148,148,22676
validation,236,26,26624,170,170,26794
validation,237,21,21504,135,135,21639
validation,238,13,13312,79,79,13391
validation,239,20,20480,128,128,20608
validation,240,14,14336,86,86,14422
validation,241,14,14336,86,86,14422
validation,242,13,13312,79,79,13391
validation,243,7,7168,37,37,7205
validation,244,9,9216,51,51,9267
validation,245,19,19456,129,129,19585
validation,246,8,8192,44,44,8236
validation,247,16,16384,102,102,16486
validation,248,17,17408,107,107,17515
validation,249,42,43008,298,298,43306
validation,250,17,17408,113,113,17521
validation,251,34,34816,232,232,35048
validation,252,22,22528,144,144,22672
validation,253,35,35840,245,245,36085
validation,254,21,21504,149,149,21653
validation,255,12,12288,72,72,12360
validation,256,13,13312,79,79,13391
validation,257,37,37888,277,277,38165
validation,258,14,14336,90,90,14426
validation,259,23,23552,155,155,23707
validation,260,31,31744,219,219,31963
validation,261,18,18432,120,120,18552
validation,262,24,24576,166,166,24742
validation,263,18,18432,114,114,18546
validation,264,17,17408,107,107,17515
validation,265,8,8192,44,44,8236
validation,266,30,30720,216,216,30936
validation,267,18,18432,120,120,18552
validation,268,22,22528,142,142,22670
validation,269,23,23552,159,159,23711
validation,270,21,21504,147,147,21651
validation,271,11,11264,65,65,11329
validation,272,18,18432,114,114,18546
validation,273,17,17408,115,115,17523
validation,274,7,7168,37,37,7205
validation,275,8,8192,44,44,8236
validation,276,26,26624,176,176,26800
validation,277,25,25600,179,179,25779
validation,278,39,39936,279,279,40215
validation,279,19,19456,131,131,19587
validation,280,16,16384,100,100,16484
validation,281,34,34816,232,232,35048
validation,282,26,26624,170,170,26794
validation,283,9,9216,51,51,9267
validation,284,17,17408,107,107,17515
validation,285,36,36864,252,252,37116
validation,286,12,12288,72,72,12360
validation,287,17,17408,107,107,17515
validation,288,25,25600,161,161,25761
validation,289,25,25600,163,163,25763
validation,290,21,21504,139,139,21643
validation,291,18,18432,114,114,18546
validation,292,8,8192,44,44,8236
validation,293,12,12288,72,72,12360
validation,294,24,24576,166,166,24742
validation,295,31,31744,213,213,31957
validation,296,26,26624,184,184,26808
validation,297,10,10240,58,58,10298
validation,298,16,16384,100,100,16484
validation,299,18,18432,120,120,18552
validation,300,12,12288,72,72,12360
validation,301,22,22528,148,148,22676
validation,302,11,11264,65,65,11329
validation,303,29,29696,203,203,29899
validation,304,28,28672,184,184,28856
validation,305,7,7168,37,37,7205
validation,306,16,16384,100,100,16484
validation,307,20,20480,128,128,20608
validation,308,34,34816,226,226,35042
validation,309,13,13312,79,79,13391
validation,310,12,12288,72,72,12360
validation,311,23,23552,161,161,23713
validation,312,22,22528,148,148,22676
validation,313,17,17408,107,107,17515
validation,314,19,19456,127,127,19583
validation,315,18,18432,120,120,18552
validation,316,14,14336,90,90,14426
validation,317,22,22528,150,150,22678
validation,318,22,22528,138,138,22666
validation,319,23,23552,161,161,23713
validation,320,33,33792,231,231,34023
validation,321,14,14336,86,86,14422
validation,322,9,9216,49,49,9265
validation,323,19,19456,121,121,19577
validation,324,16,16384,100,100,16484
validation,325,24,24576,176,176,24752
validation,326,31,31744,223,223,31967
validation,327,14,14336,86,86,14422
validation,328,14,14336,86,86,14422
validation,329,13,13312,79,79,13391
validation,330,17,17408,107,107,17515
validation,331,22,22528,146,146,22674
validation,332,21,21504,133,133,21637
validation,333,16,16384,106,106,16490
validation,334,23,23552,165,165,23717
validation,335,26,26624,170,170,26794
validation,336,27,27648,189,189,27837
validation,337,15,15360,95,95,15455
validation,338,36,36864,256,256,37120
validation,339,34,34816,244,244,35060
validation,340,7,7168,37,37,7205
validation,341,21,21504,147,147,21651
validation,342,25,25600,169,169,25769
validation,343,26,26624,182,182,26806
validation,344,11,11264,65,65,11329
validation,345,21,21504,141,141,21645
validation,346,10,10240,58,58,10298
validation,347,13,13312,81,81,13393
validation,348,8,8192,42,42,8234
validation,349,15,15360,101,101,15461
validation,350,23,23552,151,151,23703
validation,351,20,20480,128,128,20608
validation,352,21,21504,147,147,21651
validation,353,14,14336,86,86,14422
validation,354,13,13312,79,79,13391
validation,355,2,2048,4,4,2052
validation,356,6,6144,30,30,6174
validation,357,32,32768,230,230,32998
validation,358,15,15360,93,93,15453
validation,359,32,32768,212,212,32980
validation,360,21,21504,141,141,21645
validation,361,8,8192,44,44,8236
validation,362,37,37888,253,253,38141
validation,363,21,21504,141,141,21645
validation,364,17,17408,107,107,17515
validation,365,36,36864,276,276,37140
validation,366,8,8192,44,44,8236
validation,367,44,45056,338,338,45394
validation,368,9,9216,51,51,9267
validation,369,27,27648,177,177,27825
validation,370,15,15360,99,99,15459
validation,371,25,25600,169,169,25769
validation,372,26,26624,180,180,26804
validation,373,27,27648,189,189,27837
validation,374,22,22528,140,140,22668
validation,375,36,36864,246,246,37110
validation,376,23,23552,155,155,23707
validation,377,25,25600,179,179,25779
validation,378,5,5120,23,23,5143
validation,379,19,19456,127,127,19583
validation,380,33,33792,225,225,34017
validation,381,24,24576,162,162,24738
validation,382,41,41984,283,283,42267
validation,383,19,19456,127,127,19583
validation,384,18,18432,114,114,18546
validation,385,34,34816,264,264,35080
validation,386,14,14336,92,92,14428
validation,387,14,14336,86,86,14422
validation,388,6,6144,30,30,6174
validation,389,20,20480,128,128,20608
validation,390,12,12288,70,70,12358
validation,391,20,20480,140,140,20620
validation,392,6,6144,30,30,6174
validation,393,30,30720,210,210,30930
validation,394,26,26624,170,170,26794
validation,395,27,27648,193,193,27841
validation,396,20,20480,128,128,20608
validation,397,13,13312,79,79,13391
validation,398,23,23552,155,155,23707
validation,399,7,7168,37,37,7205
validation,400,6,6144,30,30,6174
validation,401,34,34816,238,238,35054
validation,402,26,26624,176,176,26800
validation,403,25,25600,171,171,25771
validation,404,25,25600,175,175,25775
validation,405,20,20480,128,128,20608
validation,406,13,13312,79,79,13391
validation,407,17,17408,107,107,17515
validation,408,24,24576,172,172,24748
validation,409,6,6144,30,30,6174
validation,410,18,18432,114,114,18546
validation,411,31,31744,209,209,31953
validation,412,22,22528,142,142,22670
validation,413,7,7168,37,37,7205
validation,414,13,13312,79,79,13391
validation,415,34,34816,234,234,35050
validation,416,29,29696,213,213,29909
validation,417,11,11264,65,65,11329
validation,418,26,26624,170,170,26794
validation,419,14,14336,90,90,14426
validation,420,33,33792,231,231,34023
validation,421,24,24576,162,162,24738
validation,422,30,30720,226,226,30946
validation,423,27,27648,197,197,27845
validation,424,24,24576,162,162,24738
validation,425,11,11264,65,65,11329
validation,426,27,27648,187,187,27835
validation,427,24,24576,162,162,24738
validation,428,48,49152,336,336,49488
validation,429,17,17408,107,107,17515
validation,430,27,27648,189,189,27837
validation,431,20,20480,128,128,20608
validation,432,9,9216,51,51,9267
validation,433,18,18432,120,120,18552
validation,434,14,14336,86,86,14422
validation,435,18,18432,126,126,18558
validation,436,14,14336,86,86,14422
validation,437,23,23552,155,155,23707
validation,438,15,15360,93,93,15453
validation,439,18,18432,114,114,18546
validation,440,11,11264,65,65,11329
validation,441,20,20480,134,134,20614
validation,442,8,8192,44,44,8236
validation,443,22,22528,142,142,22670
validation,444,36,36864,246,246,37110
validation,445,34,34816,244,244,35060
validation,446,16,16384,106,106,16490
validation,447,13,13312,79,79,13391
validation,448,13,13312,79,79,13391
validation,449,7,7168,37,37,7205
validation,450,31,31744,225,225,31969
validation,451,28,28672,200,200,28872
validation,452,29,29696,207,207,29903
validation,453,28,28672,212,212,28884
validation,454,18,18432,116,116,18548
validation,455,14,14336,86,86,14422
validation,456,23,23552,147,147,23699
validation,457,10,10240,58,58,10298
validation,458,22,22528,148,148,22676
validation,459,30,30720,220,220,30940
validation,460,14,14336,92,92,14428
validation,461,15,15360,93,93,15453
validation,462,31,31744,227,227,31971
validation,463,21,21504,141,141,21645
validation,464,16,16384,100,100,16484
validation,465,20,20480,138,138,20618
validation,466,22,22528,142,142,22670
validation,467,12,12288,72,72,12360
validation,468,9,9216,51,51,9267
validation,469,29,29696,209,209,29905
validation,470,32,32768,216,216,32984
validation,471,26,26624,176,176,26800
validation,472,10,10240,58,58,10298
validation,473,21,21504,141,141,21645
validation,474,28,28672,184,184,28856
validation,475,21,21504,141,141,21645
validation,476,28,28672,188,188,28860
validation,477,32,32768,222,222,32990
validation,478,25,25600,163,163,25763
validation,479,18,18432,130,130,18562
validation,480,23,23552,169,169,23721
validation,481,24,24576,168,168,24744
validation,482,7,7168,37,37,7205
validation,483,24,24576,162,162,24738
validation,484,38,38912,260,260,39172
validation,485,23,23552,149,149,23701
validation,486,9,9216,51,51,9267
validation,487,29,29696,203,203,29899
validation,488,11,11264,65,65,11329
validation,489,20,20480,134,134,20614
validation,490,17,17408,107,107,17515
validation,491,8,8192,44,44,8236
validation,492,24,24576,156,156,24732
validation,493,18,18432,114,114,18546
validation,494,20,20480,134,134,20614
validation,495,15,15360,93,93,15453
validation,496,31,31744,217,217,31961
validation,497,15,15360,93,93,15453
validation,498,33,33792,225,225,34017
validation,499,34,34816,232,232,35048
validation,500,21,21504,139,139,21643
validation,501,25,25600,169,169,25769
validation,502,10,10240,58,58,10298
validation,503,19,19456,127,127,19583
validation,504,25,25600,169,169,25769
validation,505,23,23552,149,149,23701
validation,506,10,10240,58,58,10298
validation,507,24,24576,156,156,24732
validation,508,20,20480,128,128,20608
validation,509,33,33792,247,247,34039
validation,510,21,21504,135,135,21639
validation,511,22,22528,148,148,22676
validation,512,21,21504,135,135,21639
validation,513,13,13312,81,81,13393
validation,514,25,25600,163,163,25763
validation,515,9,9216,51,51,9267
validation,516,15,15360,93,93,15453
validation,517,15,15360,93,93,15453
validation,518,19,19456,121,121,19577
validation,519,45,46080,327,327,46407
validation,520,33,33792,223,223,34015
validation,521,11,11264,65,65,11329
validation,522,28,28672,196,196,28868
validation,523,30,30720,210,210,30930
validation,524,27,27648,189,189,27837
validation,525,21,21504,135,135,21639
validation,526,24,24576,154,154,24730
validation,527,8,8192,44,44,8236
validation,528,20,20480,128,128,20608
validation,529,19,19456,121,121,19577
validation,530,26,26624,176,176,26800
validation,531,23,23552,149,149,23701
validation,532,39,39936,275,275,40211
validation,533,34,34816,238,238,35054
validation,534,20,20480,136,136,20616
validation,535,26,26624,182,182,26806
validation,536,25,25600,163,163,25763
validation,537,29,29696,197,197,29893
validation,538,15,15360,93,93,15453
validation,539,18,18432,114,114,18546
validation,540,22,22528,148,148,22676
validation,541,18,18432,114,114,18546
validation,542,15,15360,93,93,15453
validation,543,13,13312,79,79,13391
validation,544,17,17408,107,107,17515
validation,545,18,18432,114,114,18546
validation,546,22,22528,148,148,22676
validation,547,13,13312,79,79,13391
validation,548,7,7168,37,37,7205
validation,549,30,30720,226,226,30946
validation,550,14,14336,96,96,14432
validation,551,28,28672,212,212,28884
validation,552,19,19456,121,121,19577
validation,553,28,28672,192,192,28864
validation,554,23,23552,163,163,23715
validation,555,30,30720,216,216,30936
validation,556,37,37888,257,257,38145
validation,557,33,33792,239,239,34031
validation,558,21,21504,141,141,21645
validation,559,16,16384,106,106,16490
validation,560,25,25600,179,179,25779
validation,561,19,19456,121,121,19577
validation,562,29,29696,203,203,29899
validation,563,19,19456,127,127,19583
validation,564,2,2048,4,4,2052
validation,565,10,10240,58,58,10298
validation,566,14,14336,86,86,14422
validation,567,13,13312,79,79,13391
validation,568,22,22528,142,142,22670
validation,569,32,32768,222,222,32990
validation,570,15,15360,93,93,15453
validation,571,17,17408,113,113,17521
validation,572,13,13312,79,79,13391
validation,573,29,29696,197,197,29893
validation,574,18,18432,114,114,18546
validation,575,24,24576,162,162,24738
validation,576,25,25600,175,175,25775
validation,577,5,5120,23,23,5143
validation,578,25,25600,177,177,25777
validation,579,18,18432,114,114,18546
validation,580,25,25600,167,167,25767
validation,581,6,6144,30,30,6174
validation,582,39,39936,295,295,40231
validation,583,21,21504,135,135,21639
validation,584,28,28672,196,196,28868
validation,585,13,13312,79,79,13391
validation,586,23,23552,149,149,23701
validation,587,40,40960,290,290,41250
validation,588,14,14336,86,86,14422
validation,589,6,6144,30,30,6174
validation,590,22,22528,142,142,22670
validation,591,18,18432,122,122,18554
validation,592,21,21504,133,133,21637
validation,593,13,13312,79,79,13391
validation,594,18,18432,120,120,18552
validation,595,10,10240,58,58,10298
validation,596,9,9216,51,51,9267
validation,597,13,13312,79,79,13391
validation,598,20,20480,128,128,20608
validation,599,5,5120,23,23,5143
validation,600,23,23552,169,169,23721
validation,601,28,28672,208,208,28880
validation,602,10,10240,58,58,10298
validation,603,24,24576,156,156,24732
validation,604,26,26624,174,174,26798
validation,605,21,21504,135,135,21639
validation,606,14,14336,86,86,14422
validation,607,22,22528,158,158,22686
validation,608,27,27648,183,183,27831
validation,609,27,27648,207,207,27855
validation,610,24,24576,162,162,24738
validation,611,25,25600,185,185,25785
validation,612,30,30720,208,208,30928
validation,613,15,15360,93,93,15453
validation,614,11,11264,65,65,11329
validation,615,30,30720,222,222,30942
validation,616,21,21504,135,135,21639
validation,617,28,28672,206,206,28878
validation,618,13,13312,83,83,13395
validation,619,11,11264,65,65,11329
validation,620,22,22528,142,142,22670
validation,621,10,10240,58,58,10298
validation,622,18,18432,126,126,18558
validation,623,25,25600,163,163,25763
validation,624,24,24576,156,156,24732
validation,625,12,12288,72,72,12360
validation,626,42,43008,294,294,43302
validation,627,29,29696,189,189,29885
validation,628,10,10240,58,58,10298
validation,629,27,27648,189,189,27837
validation,630,10,10240,58,58,10298
validation,631,28,28672,198,198,28870
validation,632,27,27648,201,201,27849
validation,633,17,17408,107,107,17515
validation,634,18,18432,114,114,18546
validation,635,8,8192,44,44,8236
validation,636,9,9216,51,51,9267
validation,637,21,21504,141,141,21645
validation,638,23,23552,167,167,23719
validation,639,33,33792,225,225,34017
validation,640,31,31744,217,217,31961
validation,641,23,23552,155,155,23707
validation,642,26,26624,178,178,26802
validation,643,10,10240,56,56,10296
validation,644,30,30720,210,210,30930
validation,645,18,18432,114,114,18546
validation,646,35,35840,243,243,36083
validation,647,18,18432,114,114,18546
validation,648,8,8192,44,44,8236
validation,649,34,34816,232,232,35048
validation,650,30,30720,210,210,30930
validation,651,28,28672,192,192,28864
validation,652,37,37888,273,273,38161
validation,653,7,7168,37,37,7205
validation,654,23,23552,153,153,23705
validation,655,26,26624,180,180,26804
validation,656,20,20480,132,132,20612
validation,657,41,41984,305,305,42289
validation,658,16,16384,100,100,16484
validation,659,39,39936,261,261,40197
validation,660,29,29696,203,203,29899
validation,661,44,45056,332,332,45388
validation,662,25,25600,169,169,25769
validation,663,26,26624,178,178,26802
validation,664,30,30720,204,204,30924
validation,665,31,31744,205,205,31949
validation,666,18,18432,112,112,18544
validation,667,13,13312,79,79,13391
validation,668,24,24576,162,162,24738
validation,669,33,33792,219,219,34011
validation,670,17,17408,107,107,17515
validation,671,21,21504,135,135,21639
validation,672,7,7168,37,37,7205
validation,673,7,7168,37,37,7205
validation,674,20,20480,136,136,20616
validation,675,33,33792,227,227,34019
validation,676,23,23552,153,153,23705
validation,677,38,38912,270,270,39182
validation,678,23,23552,161,161,23713
validation,679,15,15360,93,93,15453
validation,680,11,11264,65,65,11329
validation,681,25,25600,165,165,25765
validation,682,34,34816,238,238,35054
validation,683,28,28672,196,196,28868
validation,684,29,29696,203,203,29899
validation,685,29,29696,201,201,29897
validation,686,23,23552,149,149,23701
validation,687,13,13312,79,79,13391
validation,688,11,11264,65,65,11329
validation,689,10,10240,58,58,10298
validation,690,18,18432,114,114,18546
validation,691,16,16384,100,100,16484
validation,692,15,15360,93,93,15453
validation,693,22,22528,154,154,22682
validation,694,9,9216,51,51,9267
validation,695,28,28672,190,190,28862
validation,696,27,27648,181,181,27829
validation,697,23,23552,153,153,23705
validation,698,26,26624,172,172,26796
validation,699,14,14336,86,86,14422
validation,700,4,4096,16,16,4112
validation,701,32,32768,220,220,32988
validation,702,16,16384,100,100,16484
validation,703,23,23552,149,149,23701
validation,704,17,17408,107,107,17515
validation,705,10,10240,58,58,10298
validation,706,19,19456,121,121,19577
validation,707,25,25600,169,169,25769
validation,708,23,23552,149,149,23701
validation,709,15,15360,93,93,15453
validation,710,10,10240,58,58,10298
validation,711,15,15360,93,93,15453
validation,712,22,22528,148,148,22676
validation,713,26,26624,182,182,26806
validation,714,11,11264,67,67,11331
validation,715,20,20480,134,134,20614
validation,716,18,18432,120,120,18552
validation,717,26,26624,172,172,26796
validation,718,22,22528,142,142,22670
validation,719,40,40960,274,274,41234
validation,720,19,19456,121,121,19577
validation,721,17,17408,113,113,17521
validation,722,23,23552,149,149,23701
validation,723,12,12288,72,72,12360
validation,724,20,20480,128,128,20608
validation,725,12,12288,72,72,12360
validation,726,42,43008,294,294,43302
validation,727,23,23552,163,163,23715
validation,728,9,9216,51,51,9267
validation,729,26,26624,176,176,26800
validation,730,20,20480,132,132,20612
validation,731,21,21504,139,139,21643
validation,732,21,21504,135,135,21639
validation,733,34,34816,238,238,35054
validation,734,4,4096,16,16,4112
validation,735,26,26624,182,182,26806
validation,736,6,6144,30,30,6174
validation,737,15,15360,101,101,15461
validation,738,17,17408,111,111,17519
validation,739,15,15360,93,93,15453
validation,740,16,16384,106,106,16490
validation,741,35,35840,251,251,36091
validation,742,23,23552,155,155,23707
validation,743,7,7168,35,35,7203
validation,744,37,37888,265,265,38153
validation,745,39,39936,281,281,40217
validation,746,36,36864,246,246,37110
validation,747,24,24576,156,156,24732
validation,748,28,28672,194,194,28866
validation,749,31,31744,211,211,31955
validation,750,21,21504,135,135,21639
validation,751,24,24576,164,164,24740
validation,752,9,9216,51,51,9267
validation,753,27,27648,197,197,27845
validation,754,22,22528,154,154,22682
validation,755,38,38912,254,254,39166
validation,756,18,18432,114,114,18546
validation,757,13,13312,85,85,13397
validation,758,20,20480,136,136,20616
validation,759,13,13312,79,79,13391
validation,760,18,18432,114,114,18546
validation,761,23,23552,155,155,23707
validation,762,11,11264,65,65,11329
validation,763,30,30720,204,204,30924
validation,764,25,25600,165,165,25765
validation,765,8,8192,42,42,8234
validation,766,34,34816,242,242,35058
validation,767,38,38912,270,270,39182
validation,768,15,15360,93,93,15453
validation,769,11,11264,63,63,11327
validation,770,30,30720,218,218,30938
validation,771,27,27648,177,177,27825
validation,772,14,14336,84,84,14420
validation,773,16,16384,106,106,16490
validation,774,31,31744,229,229,31973
validation,775,12,12288,72,72,12360
validation,776,20,20480,128,128,20608
validation,777,10,10240,58,58,10298
validation,778,21,21504,145,145,21649
validation,779,14,14336,86,86,14422
validation,780,22,22528,142,142,22670
validation,781,17,17408,107,107,17515
validation,782,23,23552,149,149,23701
validation,783,38,38912,298,298,39210
validation,784,19,19456,121,121,19577
validation,785,28,28672,190,190,28862
validation,786,20,20480,134,134,20614
validation,787,5,5120,23,23,5143
validation,788,25,25600,175,175,25775
validation,789,8,8192,44,44,8236
validation,790,14,14336,86,86,14422
validation,791,28,28672,190,190,28862
validation,792,41,41984,309,309,42293
validation,793,19,19456,121,121,19577
validation,794,8,8192,42,42,8234
validation,795,24,24576,166,166,24742
validation,796,19,19456,127,127,19583
validation,797,21,21504,141,141,21645
validation,798,14,14336,86,86,14422
validation,799,16,16384,106,106,16490
validation,800,35,35840,245,245,36085
validation,801,11,11264,65,65,11329
validation,802,34,34816,238,238,35054
validation,803,15,15360,93,93,15453
validation,804,9,9216,51,51,9267
validation,805,11,11264,65,65,11329
validation,806,34,34816,268,268,35084
validation,807,10,10240,58,58,10298
validation,808,15,15360,93,93,15453
validation,809,24,24576,156,156,24732
validation,810,29,29696,191,191,29887
validation,811,23,23552,157,157,23709
validation,812,20,20480,130,130,20610
validation,813,27,27648,183,183,27831
validation,814,15,15360,93,93,15453
validation,815,23,23552,149,149,23701
validation,816,14,14336,86,86,14422
validation,817,14,14336,86,86,14422
validation,818,24,24576,166,166,24742
validation,819,16,16384,98,98,16482
validation,820,24,24576,162,162,24738
validation,821,10,10240,58,58,10298
validation,822,22,22528,140,140,22668
validation,823,14,14336,86,86,14422
validation,824,16,16384,100,100,16484
validation,825,9,9216,51,51,9267
validation,826,34,34816,256,256,35072
validation,827,18,18432,114,114,18546
validation,828,15,15360,95,95,15455
validation,829,29,29696,197,197,29893
validation,830,35,35840,263,263,36103
validation,831,29,29696,197,197,29893
validation,832,22,22528,152,152,22680
validation,833,33,33792,233,233,34025
validation,834,16,16384,100,100,16484
validation,835,17,17408,107,107,17515
validation,836,31,31744,205,205,31949
validation,837,33,33792,241,241,34033
validation,838,10,10240,58,58,10298
validation,839,6,6144,30,30,6174
validation,840,10,10240,64,64,10304
validation,841,9,9216,51,51,9267
validation,842,22,22528,148,148,22676
validation,843,14,14336,90,90,14426
validation,844,28,28672,190,190,28862
validation,845,13,13312,79,79,13391
validation,846,28,28672,208,208,28880
validation,847,33,33792,237,237,34029
validation,848,21,21504,135,135,21639
validation,849,23,23552,155,155,23707
validation,850,30,30720,202,202,30922
validation,851,10,10240,58,58,10298
validation,852,8,8192,44,44,8236
validation,853,17,17408,105,105,17513
validation,854,7,7168,37,37,7205
validation,855,12,12288,72,72,12360
validation,856,23,23552,155,155,23707
validation,857,14,14336,88,88,14424
validation,858,17,17408,107,107,17515
validation,859,20,20480,128,128,20608
validation,860,22,22528,150,150,22678
validation,861,8,8192,44,44,8236
validation,862,28,28672,196,196,28868
validation,863,10,10240,58,58,10298
validation,864,33,33792,233,233,34025
validation,865,39,39936,267,267,40203
validation,866,15,15360,93,93,15453
validation,867,19,19456,121,121,19577
validation,868,24,24576,156,156,24732
validation,869,37,37888,273,273,38161
validation,870,38,38912,292,292,39204
validation,871,26,26624,170,170,26794
test,0,14,14336,90,90,14426
test,1,13,13312,79,79,13391
test,2,29,29696,223,223,29919
test,3,24,24576,162,162,24738
test,4,22,22528,148,148,22676
test,5,25,25600,189,189,25789
test,6,27,27648,189,189,27837
test,7,8,8192,44,44,8236
test,8,11,11264,65,65,11329
test,9,22,22528,154,154,22682
test,10,15,15360,93,93,15453
test,11,21,21504,141,141,21645
test,12,5,5120,23,23,5143
test,13,23,23552,149,149,23701
test,14,32,32768,218,218,32986
test,15,36,36864,258,258,37122
test,16,11,11264,65,65,11329
test,17,5,5120,23,23,5143
test,18,32,32768,238,238,33006
test,19,26,26624,172,172,26796
test,20,22,22528,158,158,22686
test,21,16,16384,100,100,16484
test,22,14,14336,84,84,14420
test,23,14,14336,86,86,14422
test,24,23,23552,159,159,23711
test,25,22,22528,142,142,22670
test,26,21,21504,137,137,21641
test,27,9,9216,51,51,9267
test,28,7,7168,37,37,7205
test,29,14,14336,86,86,14422
test,30,15,15360,99,99,15459
test,31,15,15360,93,93,15453
test,32,10,10240,58,58,10298
test,33,23,23552,155,155,23707
test,34,18,18432,112,112,18544
test,35,22,22528,148,148,22676
test,36,10,10240,58,58,10298
test,37,15,15360,93,93,15453
test,38,35,35840,239,239,36079
test,39,13,13312,79,79,13391
test,40,26,26624,188,188,26812
test,41,8,8192,44,44,8236
test,42,34,34816,250,250,35066
test,43,26,26624,180,180,26804
test,44,26,26624,178,178,26802
test,45,23,23552,173,173,23725
test,46,32,32768,212,212,32980
test,47,17,17408,107,107,17515
test,48,22,22528,142,142,22670
test,49,28,28672,194,194,28866
test,50,14,14336,86,86,14422
test,51,20,20480,128,128,20608
test,52,33,33792,239,239,34031
test,53,23,23552,149,149,23701
test,54,25,25600,179,179,25779
test,55,24,24576,158,158,24734
test,56,21,21504,151,151,21655
test,57,11,11264,65,65,11329
test,58,29,29696,195,195,29891
test,59,9,9216,51,51,9267
test,60,18,18432,114,114,18546
test,61,24,24576,156,156,24732
test,62,24,24576,162,162,24738
test,63,16,16384,100,100,16484
test,64,29,29696,195,195,29891
test,65,34,34816,250,250,35066
test,66,19,19456,121,121,19577
test,67,23,23552,155,155,23707
test,68,17,17408,107,107,17515
test,69,11,11264,65,65,11329
test,70,36,36864,246,246,37110
test,71,28,28672,190,190,28862
test,72,11,11264,65,65,11329
test,73,13,13312,79,79,13391
test,74,14,14336,90,90,14426
test,75,21,21504,147,147,21651
test,76,23,23552,161,161,23713
test,77,18,18432,120,120,18552
test,78,8,8192,44,44,8236
test,79,7,7168,37,37,7205
test,80,23,23552,161,161,23713
test,81,29,29696,197,197,29893
test,82,21,21504,145,145,21649
test,83,31,31744,221,221,31965
test,84,7,7168,37,37,7205
test,85,28,28672,190,190,28862
test,86,30,30720,198,198,30918
test,87,22,22528,142,142,22670
test,88,12,12288,72,72,12360
test,89,25,25600,163,163,25763
test,90,34,34816,226,226,35042
test,91,23,23552,161,161,23713
test,92,35,35840,245,245,36085
test,93,14,14336,86,86,14422
test,94,13,13312,89,89,13401
test,95,16,16384,100,100,16484
test,96,29,29696,201,201,29897
test,97,31,31744,223,223,31967
test,98,34,34816,232,232,35048
test,99,16,16384,100,100,16484
test,100,25,25600,163,163,25763
test,101,21,21504,147,147,21651
test,102,32,32768,230,230,32998
test,103,17,17408,123,123,17531
test,104,25,25600,163,163,25763
test,105,28,28672,194,194,28866
test,106,32,32768,222,222,32990
test,107,10,10240,58,58,10298
test,108,22,22528,142,142,22670
test,109,19,19456,127,127,19583
test,110,30,30720,200,200,30920
test,111,31,31744,227,227,31971
test,112,21,21504,141,141,21645
test,113,46,47104,316,316,47420
test,114,18,18432,114,114,18546
test,115,12,12288,72,72,12360
test,116,7,7168,37,37,7205
test,117,10,10240,58,58,10298
test,118,27,27648,187,187,27835
test,119,14,14336,86,86,14422
test,120,24,24576,162,162,24738
test,121,19,19456,131,131,19587
test,122,9,9216,51,51,9267
test,123,27,27648,195,195,27843
test,124,14,14336,86,86,14422
test,125,43,44032,297,297,44329
test,126,26,26624,180,180,26804
test,127,17,17408,115,115,17523
test,128,16,16384,98,98,16482
test,129,17,17408,107,107,17515
test,130,9,9216,51,51,9267
test,131,14,14336,86,86,14422
test,132,10,10240,56,56,10296
test,133,17,17408,107,107,17515
test,134,33,33792,235,235,34027
test,135,25,25600,163,163,25763
test,136,10,10240,58,58,10298
test,137,30,30720,198,198,30918
test,138,32,32768,212,212,32980
test,139,21,21504,135,135,21639
test,140,11,11264,65,65,11329
test,141,33,33792,229,229,34021
test,142,16,16384,100,100,16484
test,143,18,18432,124,124,18556
test,144,17,17408,107,107,17515
test,145,8,8192,44,44,8236
test,146,18,18432,118,118,18550
test,147,22,22528,156,156,22684
test,148,37,37888,253,253,38141
test,149,22,22528,148,148,22676
test,150,20,20480,132,132,20612
test,151,32,32768,234,234,33002
test,152,18,18432,120,120,18552
test,153,20,20480,132,132,20612
test,154,12,12288,72,72,12360
test,155,19,19456,131,131,19587
test,156,20,20480,138,138,20618
test,157,15,15360,93,93,15453
test,158,28,28672,196,196,28868
test,159,31,31744,211,211,31955
test,160,11,11264,65,65,11329
test,161,32,32768,236,236,33004
test,162,28,28672,184,184,28856
test,163,16,16384,100,100,16484
test,164,23,23552,151,151,23703
test,165,46,47104,350,350,47454
test,166,17,17408,107,107,17515
test,167,5,5120,23,23,5143
test,168,15,15360,97,97,15457
test,169,9,9216,51,51,9267
test,170,13,13312,83,83,13395
test,171,13,13312,79,79,13391
test,172,39,39936,299,299,40235
test,173,21,21504,147,147,21651
test,174,20,20480,128,128,20608
test,175,28,28672,198,198,28870
test,176,13,13312,79,79,13391
test,177,37,37888,275,275,38163
test,178,22,22528,164,164,22692
test,179,22,22528,158,158,22686
test,180,23,23552,159,159,23711
test,181,37,37888,249,249,38137
test,182,22,22528,142,142,22670
test,183,25,25600,189,189,25789
test,184,25,25600,169,169,25769
test,185,36,36864,264,264,37128
test,186,19,19456,127,127,19583
test,187,24,24576,174,174,24750
test,188,12,12288,72,72,12360
test,189,17,17408,105,105,17513
test,190,27,27648,187,187,27835
test,191,43,44032,311,311,44343
test,192,28,28672,190,190,28862
test,193,10,10240,58,58,10298
test,194,40,40960,278,278,41238
test,195,13,13312,79,79,13391
test,196,10,10240,58,58,10298
test,197,26,26624,182,182,26806
test,198,12,12288,72,72,12360
test,199,29,29696,227,227,29923
test,200,24,24576,156,156,24732
test,201,12,12288,72,72,12360
test,202,10,10240,58,58,10298
test,203,11,11264,65,65,11329
test,204,28,28672,202,202,28874
test,205,26,26624,182,182,26806
test,206,13,13312,81,81,13393
test,207,31,31744,223,223,31967
test,208,17,17408,107,107,17515
test,209,10,10240,58,58,10298
test,210,5,5120,23,23,5143
test,211,28,28672,190,190,28862
test,212,34,34816,242,242,35058
test,213,19,19456,121,121,19577
test,214,30,30720,210,210,30930
test,215,9,9216,51,51,9267
test,216,35,35840,249,249,36089
test,217,7,7168,37,37,7205
test,218,32,32768,224,224,32992
test,219,6,6144,30,30,6174
test,220,19,19456,121,121,19577
test,221,18,18432,114,114,18546
test,222,10,10240,58,58,10298
test,223,38,38912,260,260,39172
test,224,5,5120,23,23,5143
test,225,29,29696,209,209,29905
test,226,10,10240,58,58,10298
test,227,23,23552,149,149,23701
test,228,19,19456,119,119,19575
test,229,16,16384,100,100,16484
test,230,26,26624,188,188,26812
test,231,13,13312,79,79,13391
test,232,13,13312,85,85,13397
test,233,28,28672,184,184,28856
test,234,12,12288,72,72,12360
test,235,14,14336,86,86,14422
test,236,29,29696,197,197,29893
test,237,13,13312,79,79,13391
test,238,8,8192,44,44,8236
test,239,21,21504,141,141,21645
test,240,20,20480,126,126,20606
test,241,30,30720,216,216,30936
test,242,13,13312,79,79,13391
test,243,31,31744,209,209,31953
test,244,9,9216,51,51,9267
test,245,18,18432,120,120,18552
test,246,20,20480,136,136,20616
test,247,27,27648,173,173,27821
test,248,21,21504,135,135,21639
test,249,4,4096,16,16,4112
test,250,17,17408,113,113,17521
test,251,15,15360,97,97,15457
test,252,29,29696,209,209,29905
test,253,30,30720,212,212,30932
test,254,20,20480,128,128,20608
test,255,7,7168,37,37,7205
test,256,7,7168,37,37,7205
test,257,20,20480,134,134,20614
test,258,28,28672,200,200,28872
test,259,28,28672,204,204,28876
test,260,20,20480,138,138,20618
test,261,27,27648,175,175,27823
test,262,28,28672,190,190,28862
test,263,11,11264,65,65,11329
test,264,24,24576,166,166,24742
test,265,37,37888,271,271,38159
test,266,24,24576,162,162,24738
test,267,24,24576,162,162,24738
test,268,13,13312,79,79,13391
test,269,22,22528,142,142,22670
test,270,20,20480,134,134,20614
test,271,23,23552,161,161,23713
test,272,38,38912,272,272,39184
test,273,23,23552,149,149,23701
test,274,21,21504,135,135,21639
test,275,17,17408,107,107,17515
test,276,24,24576,166,166,24742
test,277,9,9216,51,51,9267
test,278,15,15360,93,93,15453
test,279,32,32768,238,238,33006
test,280,15,15360,93,93,15453
test,281,30,30720,216,216,30936
test,282,18,18432,114,114,18546
test,283,33,33792,231,231,34023
test,284,9,9216,51,51,9267
test,285,28,28672,200,200,28872
test,286,33,33792,233,233,34025
test,287,15,15360,105,105,15465
test,288,11,11264,65,65,11329
test,289,16,16384,110,110,16494
test,290,11,11264,61,61,11325
test,291,15,15360,93,93,15453
test,292,18,18432,114,114,18546
test,293,7,7168,37,37,7205
test,294,40,40960,268,268,41228
test,295,25,25600,163,163,25763
test,296,33,33792,223,223,34015
test,297,33,33792,219,219,34011
test,298,35,35840,251,251,36091
test,299,17,17408,113,113,17521
test,300,26,26624,170,170,26794
test,301,49,50176,361,361,50537
test,302,28,28672,194,194,28866
test,303,11,11264,65,65,11329
test,304,24,24576,156,156,24732
test,305,28,28672,190,190,28862
test,306,24,24576,166,166,24742
test,307,21,21504,133,133,21637
test,308,21,21504,141,141,21645
test,309,13,13312,81,81,13393
test,310,10,10240,58,58,10298
test,311,14,14336,98,98,14434
test,312,25,25600,175,175,25775
test,313,16,16384,100,100,16484
test,314,20,20480,128,128,20608
test,315,23,23552,149,149,23701
test,316,23,23552,149,149,23701
test,317,30,30720,204,204,30924
test,318,27,27648,183,183,27831
test,319,18,18432,114,114,18546
test,320,20,20480,132,132,20612
test,321,12,12288,72,72,12360
test,322,26,26624,178,178,26802
test,323,15,15360,93,93,15453
test,324,25,25600,179,179,25779
test,325,26,26624,176,176,26800
test,326,24,24576,162,162,24738
test,327,8,8192,44,44,8236
test,328,26,26624,170,170,26794
test,329,18,18432,132,132,18564
test,330,23,23552,165,165,23717
test,331,15,15360,101,101,15461
test,332,9,9216,51,51,9267
test,333,6,6144,30,30,6174
test,334,16,16384,100,100,16484
test,335,20,20480,126,126,20606
test,336,14,14336,86,86,14422
test,337,16,16384,100,100,16484
test,338,35,35840,249,249,36089
test,339,38,38912,264,264,39176
test,340,18,18432,118,118,18550
test,341,14,14336,90,90,14426
test,342,31,31744,215,215,31959
test,343,42,43008,334,334,43342
test,344,28,28672,190,190,28862
test,345,16,16384,100,100,16484
test,346,30,30720,204,204,30924
test,347,15,15360,93,93,15453
test,348,22,22528,144,144,22672
test,349,30,30720,204,204,30924
test,350,22,22528,150,150,22678
test,351,32,32768,212,212,32980
test,352,34,34816,232,232,35048
test,353,27,27648,187,187,27835
test,354,16,16384,100,100,16484
test,355,15,15360,99,99,15459
test,356,23,23552,151,151,23703
test,357,33,33792,245,245,34037
test,358,23,23552,149,149,23701
test,359,18,18432,114,114,18546
test,360,35,35840,241,241,36081
test,361,19,19456,121,121,19577
test,362,26,26624,174,174,26798
test,363,20,20480,142,142,20622
test,364,10,10240,58,58,10298
test,365,14,14336,92,92,14428
test,366,33,33792,237,237,34029
test,367,8,8192,44,44,8236
test,368,18,18432,114,114,18546
test,369,20,20480,140,140,20620
test,370,31,31744,239,239,31983
test,371,17,17408,107,107,17515
test,372,19,19456,121,121,19577
test,373,21,21504,139,139,21643
test,374,28,28672,184,184,28856
test,375,30,30720,202,202,30922
test,376,23,23552,147,147,23699
test,377,25,25600,167,167,25767
test,378,25,25600,169,169,25769
test,379,11,11264,65,65,11329
test,380,18,18432,120,120,18552
test,381,20,20480,128,128,20608
test,382,18,18432,114,114,18546
test,383,8,8192,44,44,8236
test,384,10,10240,58,58,10298
test,385,21,21504,135,135,21639
test,386,21,21504,141,141,21645
test,387,29,29696,201,201,29897
test,388,16,16384,100,100,16484
test,389,16,16384,98,98,16482
test,390,29,29696,203,203,29899
test,391,23,23552,179,179,23731
test,392,10,10240,56,56,10296
test,393,24,24576,180,180,24756
test,394,18,18432,122,122,18554
test,395,23,23552,149,149,23701
test,396,13,13312,79,79,13391
test,397,18,18432,120,120,18552
test,398,36,36864,264,264,37128
test,399,9,9216,49,49,9265
test,400,25,25600,177,177,25777
test,401,19,19456,121,121,19577
test,402,18,18432,118,118,18550
test,403,4,4096,16,16,4112
test,404,19,19456,127,127,19583
test,405,34,34816,226,226,35042
test,406,27,27648,179,179,27827
test,407,5,5120,23,23,5143
test,408,26,26624,170,170,26794
test,409,13,13312,79,79,13391
test,410,22,22528,142,142,22670
test,411,12,12288,72,72,12360
test,412,20,20480,128,128,20608
test,413,25,25600,163,163,25763
test,414,9,9216,51,51,9267
test,415,12,12288,72,72,12360
test,416,34,34816,240,240,35056
test,417,22,22528,150,150,22678
test,418,19,19456,119,119,19575
test,419,10,10240,58,58,10298
test,420,22,22528,156,156,22684
test,421,14,14336,90,90,14426
test,422,33,33792,219,219,34011
test,423,16,16384,102,102,16486
test,424,30,30720,216,216,30936
test,425,19,19456,119,119,19575
test,426,17,17408,109,109,17517
test,427,6,6144,30,30,6174
test,428,23,23552,155,155,23707
test,429,34,34816,238,238,35054
test,430,17,17408,107,107,17515
test,431,9,9216,49,49,9265
test,432,22,22528,152,152,22680
test,433,9,9216,51,51,9267
test,434,29,29696,221,221,29917
test,435,7,7168,37,37,7205
test,436,15,15360,93,93,15453
test,437,9,9216,51,51,9267
test,438,29,29696,191,191,29887
test,439,31,31744,217,217,31961
test,440,7,7168,37,37,7205
test,441,18,18432,124,124,18556
test,442,30,30720,204,204,30924
test,443,14,14336,86,86,14422
test,444,18,18432,120,120,18552
test,445,13,13312,79,79,13391
test,446,18,18432,114,114,18546
test,447,33,33792,231,231,34023
test,448,8,8192,44,44,8236
test,449,24,24576,184,184,24760
test,450,17,17408,107,107,17515
test,451,9,9216,51,51,9267
test,452,42,43008,326,326,43334
test,453,39,39936,267,267,40203
test,454,19,19456,129,129,19585
test,455,21,21504,135,135,21639
test,456,22,22528,148,148,22676
test,457,16,16384,100,100,16484
test,458,15,15360,95,95,15455
test,459,31,31744,217,217,31961
test,460,11,11264,65,65,11329
test,461,18,18432,114,114,18546
test,462,24,24576,156,156,24732
test,463,23,23552,155,155,23707
test,464,9,9216,51,51,9267
test,465,13,13312,79,79,13391
test,466,22,22528,142,142,22670
test,467,7,7168,37,37,7205
test,468,18,18432,114,114,18546
test,469,19,19456,121,121,19577
test,470,20,20480,128,128,20608
test,471,40,40960,274,274,41234
test,472,28,28672,202,202,28874
test,473,26,26624,182,182,26806
test,474,21,21504,135,135,21639
test,475,33,33792,237,237,34029
test,476,8,8192,44,44,8236
test,477,30,30720,222,222,30942
test,478,25,25600,175,175,25775
test,479,17,17408,109,109,17517
test,480,12,12288,72,72,12360
test,481,34,34816,250,250,35066
test,482,24,24576,156,156,24732
test,483,41,41984,289,289,42273
test,484,19,19456,121,121,19577
test,485,21,21504,145,145,21649
test,486,21,21504,135,135,21639
test,487,9,9216,51,51,9267
test,488,16,16384,98,98,16482
test,489,25,25600,169,169,25769
test,490,18,18432,114,114,18546
test,491,13,13312,79,79,13391
test,492,13,13312,79,79,13391
test,493,37,37888,271,271,38159
test,494,9,9216,51,51,9267
test,495,40,40960,292,292,41252
test,496,12,12288,72,72,12360
test,497,17,17408,107,107,17515
test,498,23,23552,149,149,23701
test,499,27,27648,177,177,27825
test,500,16,16384,100,100,16484
test,501,33,33792,237,237,34029
test,502,28,28672,184,184,28856
test,503,14,14336,86,86,14422
test,504,12,12288,72,72,12360
test,505,17,17408,107,107,17515
test,506,31,31744,235,235,31979
test,507,7,7168,37,37,7205
test,508,23,23552,155,155,23707
test,509,27,27648,183,183,27831
test,510,29,29696,223,223,29919
test,511,11,11264,65,65,11329
test,512,13,13312,79,79,13391
test,513,21,21504,139,139,21643
test,514,30,30720,212,212,30932
test,515,9,9216,51,51,9267
test,516,31,31744,233,233,31977
test,517,16,16384,100,100,16484
test,518,30,30720,202,202,30922
test,519,13,13312,77,77,13389
test,520,11,11264,65,65,11329
test,521,28,28672,200,200,28872
test,522,15,15360,99,99,15459
test,523,14,14336,86,86,14422
test,524,22,22528,148,148,22676
test,525,10,10240,58,58,10298
test,526,26,26624,172,172,26796
test,527,14,14336,86,86,14422
test,528,16,16384,106,106,16490
test,529,17,17408,105,105,17513
test,530,26,26624,188,188,26812
test,531,25,25600,173,173,25773
test,532,36,36864,270,270,37134
test,533,11,11264,65,65,11329
test,534,43,44032,323,323,44355
test,535,18,18432,114,114,18546
test,536,26,26624,172,172,26796
test,537,8,8192,44,44,8236
test,538,23,23552,149,149,23701
test,539,15,15360,93,93,15453
test,540,36,36864,258,258,37122
test,541,23,23552,153,153,23705
test,542,15,15360,93,93,15453
test,543,17,17408,107,107,17515
test,544,23,23552,149,149,23701
test,545,30,30720,206,206,30926
test,546,35,35840,245,245,36085
test,547,22,22528,142,142,22670
test,548,11,11264,71,71,11335
test,549,35,35840,271,271,36111
test,550,34,34816,238,238,35054
test,551,8,8192,44,44,8236
test,552,12,12288,72,72,12360
test,553,23,23552,159,159,23711
test,554,20,20480,138,138,20618
test,555,26,26624,176,176,26800
test,556,26,26624,168,168,26792
test,557,35,35840,233,233,36073
test,558,27,27648,191,191,27839
test,559,16,16384,106,106,16490
test,560,16,16384,100,100,16484
test,561,14,14336,86,86,14422
test,562,34,34816,232,232,35048
test,563,10,10240,58,58,10298
test,564,5,5120,23,23,5143
test,565,14,14336,92,92,14428
test,566,7,7168,37,37,7205
test,567,7,7168,37,37,7205
test,568,28,28672,182,182,28854
test,569,18,18432,118,118,18550
test,570,10,10240,58,58,10298
test,571,12,12288,72,72,12360
test,572,7,7168,37,37,7205
test,573,14,14336,86,86,14422
test,574,19,19456,127,127,19583
test,575,22,22528,148,148,22676
test,576,23,23552,155,155,23707
test,577,7,7168,37,37,7205
test,578,7,7168,37,37,7205
test,579,23,23552,149,149,23701
test,580,8,8192,44,44,8236
test,581,25,25600,167,167,25767
test,582,17,17408,107,107,17515
test,583,29,29696,193,193,29889
test,584,6,6144,30,30,6174
test,585,17,17408,113,113,17521
test,586,6,6144,30,30,6174
test,587,37,37888,267,267,38155
test,588,23,23552,155,155,23707
test,589,24,24576,162,162,24738
test,590,17,17408,107,107,17515
test,591,39,39936,303,303,40239
test,592,43,44032,315,315,44347
test,593,28,28672,196,196,28868
test,594,17,17408,105,105,17513
test,595,24,24576,162,162,24738
test,596,20,20480,132,132,20612
test,597,10,10240,64,64,10304
test,598,10,10240,58,58,10298
test,599,7,7168,37,37,7205
test,600,31,31744,221,221,31965
test,601,28,28672,184,184,28856
test,602,9,9216,51,51,9267
test,603,31,31744,213,213,31957
test,604,9,9216,51,51,9267
test,605,10,10240,58,58,10298
test,606,18,18432,120,120,18552
test,607,22,22528,142,142,22670
test,608,22,22528,148,148,22676
test,609,26,26624,170,170,26794
test,610,14,14336,86,86,14422
test,611,11,11264,65,65,11329
test,612,10,10240,58,58,10298
test,613,22,22528,152,152,22680
test,614,41,41984,325,325,42309
test,615,7,7168,37,37,7205
test,616,31,31744,217,217,31961
test,617,11,11264,69,69,11333
test,618,9,9216,51,51,9267
test,619,8,8192,44,44,8236
test,620,14,14336,86,86,14422
test,621,9,9216,51,51,9267
test,622,24,24576,156,156,24732
test,623,22,22528,156,156,22684
test,624,22,22528,148,148,22676
test,625,29,29696,191,191,29887
test,626,13,13312,79,79,13391
test,627,15,15360,93,93,15453
test,628,23,23552,149,149,23701
test,629,15,15360,93,93,15453
test,630,28,28672,192,192,28864
test,631,26,26624,170,170,26794
test,632,15,15360,93,93,15453
test,633,30,30720,204,204,30924
test,634,22,22528,154,154,22682
test,635,24,24576,170,170,24746
test,636,30,30720,204,204,30924
test,637,6,6144,30,30,6174
test,638,10,10240,58,58,10298
test,639,24,24576,166,166,24742
test,640,12,12288,72,72,12360
test,641,34,34816,242,242,35058
test,642,13,13312,79,79,13391
test,643,12,12288,72,72,12360
test,644,18,18432,114,114,18546
test,645,11,11264,65,65,11329
test,646,15,15360,101,101,15461
test,647,12,12288,72,72,12360
test,648,39,39936,267,267,40203
test,649,12,12288,72,72,12360
test,650,21,21504,133,133,21637
test,651,17,17408,117,117,17525
test,652,27,27648,191,191,27839
test,653,14,14336,86,86,14422
test,654,19,19456,121,121,19577
test,655,38,38912,266,266,39178
test,656,36,36864,252,252,37116
test,657,12,12288,72,72,12360
test,658,18,18432,118,118,18550
test,659,14,14336,82,82,14418
test,660,14,14336,86,86,14422
test,661,25,25600,175,175,25775
test,662,27,27648,177,177,27825
test,663,43,44032,323,323,44355
test,664,17,17408,113,113,17521
test,665,33,33792,231,231,34023
test,666,28,28672,190,190,28862
test,667,26,26624,176,176,26800
test,668,28,28672,194,194,28866
test,669,17,17408,107,107,17515
test,670,10,10240,60,60,10300
test,671,24,24576,162,162,24738
test,672,21,21504,137,137,21641
test,673,9,9216,51,51,9267
test,674,20,20480,128,128,20608
test,675,20,20480,128,128,20608
test,676,25,25600,169,169,25769
test,677,15,15360,93,93,15453
test,678,24,24576,156,156,24732
test,679,29,29696,199,199,29895
test,680,22,22528,142,142,22670
test,681,18,18432,122,122,18554
test,682,28,28672,190,190,28862
test,683,5,5120,23,23,5143
test,684,14,14336,86,86,14422
test,685,11,11264,75,75,11339
test,686,25,25600,169,169,25769
test,687,47,48128,373,373,48501
test,688,22,22528,142,142,22670
test,689,13,13312,79,79,13391
test,690,33,33792,231,231,34023
test,691,25,25600,167,167,25767
test,692,22,22528,142,142,22670
test,693,29,29696,219,219,29915
test,694,21,21504,141,141,21645
test,695,29,29696,197,197,29893
test,696,13,13312,79,79,13391
test,697,14,14336,86,86,14422
test,698,18,18432,120,120,18552
test,699,30,30720,198,198,30918
test,700,13,13312,79,79,13391
test,701,21,21504,135,135,21639
test,702,10,10240,58,58,10298
test,703,20,20480,140,140,20620
test,704,13,13312,79,79,13391
test,705,24,24576,172,172,24748
test,706,45,46080,337,337,46417
test,707,8,8192,44,44,8236
test,708,11,11264,65,65,11329
test,709,21,21504,141,141,21645
test,710,43,44032,317,317,44349
test,711,27,27648,181,181,27829
test,712,11,11264,65,65,11329
test,713,9,9216,51,51,9267
test,714,33,33792,225,225,34017
test,715,24,24576,162,162,24738
test,716,18,18432,114,114,18546
test,717,5,5120,23,23,5143
test,718,20,20480,134,134,20614
test,719,16,16384,102,102,16486
test,720,17,17408,107,107,17515
test,721,21,21504,141,141,21645
test,722,12,12288,72,72,12360
test,723,9,9216,51,51,9267
test,724,17,17408,113,113,17521
test,725,30,30720,216,216,30936
test,726,36,36864,240,240,37104
test,727,22,22528,142,142,22670
test,728,15,15360,93,93,15453
test,729,18,18432,120,120,18552
test,730,16,16384,100,100,16484
test,731,10,10240,58,58,10298
test,732,21,21504,135,135,21639
test,733,16,16384,100,100,16484
test,734,18,18432,114,114,18546
test,735,7,7168,37,37,7205
test,736,16,16384,100,100,16484
test,737,8,8192,44,44,8236
test,738,16,16384,100,100,16484
test,739,23,23552,165,165,23717
test,740,9,9216,51,51,9267
test,741,19,19456,123,123,19579
test,742,31,31744,221,221,31965
test,743,21,21504,141,141,21645
test,744,26,26624,208,208,26832
test,745,19,19456,121,121,19577
test,746,34,34816,230,230,35046
test,747,16,16384,98,98,16482
test,748,21,21504,141,141,21645
test,749,13,13312,79,79,13391
test,750,25,25600,169,169,25769
test,751,40,40960,276,276,41236
test,752,40,40960,300,300,41260
test,753,7,7168,37,37,7205
test,754,15,15360,93,93,15453
test,755,36,36864,270,270,37134
test,756,13,13312,79,79,13391
test,757,31,31744,223,223,31967
test,758,25,25600,179,179,25779
test,759,18,18432,114,114,18546
test,760,29,29696,197,197,29893
test,761,29,29696,217,217,29913
test,762,25,25600,173,173,25773
test,763,28,28672,190,190,28862
test,764,21,21504,135,135,21639
test,765,39,39936,265,265,40201
test,766,10,10240,58,58,10298
test,767,18,18432,114,114,18546
test,768,22,22528,142,142,22670
test,769,11,11264,65,65,11329
test,770,22,22528,142,142,22670
test,771,5,5120,23,23,5143
test,772,22,22528,142,142,22670
test,773,11,11264,65,65,11329
test,774,30,30720,210,210,30930
test,775,12,12288,70,70,12358
test,776,15,15360,93,93,15453
test,777,32,32768,230,230,32998
test,778,10,10240,56,56,10296
test,779,30,30720,196,196,30916
test,780,11,11264,65,65,11329
test,781,30,30720,198,198,30918
test,782,17,17408,107,107,17515
test,783,25,25600,169,169,25769
test,784,13,13312,81,81,13393
test,785,39,39936,293,293,40229
test,786,12,12288,72,72,12360
test,787,21,21504,135,135,21639
test,788,18,18432,112,112,18544
test,789,22,22528,154,154,22682
test,790,15,15360,93,93,15453
test,791,15,15360,93,93,15453
test,792,12,12288,72,72,12360
test,793,23,23552,159,159,23711
test,794,18,18432,114,114,18546
test,795,13,13312,79,79,13391
test,796,20,20480,134,134,20614
test,797,7,7168,37,37,7205
test,798,9,9216,51,51,9267
test,799,13,13312,79,79,13391
test,800,33,33792,235,235,34027
test,801,24,24576,156,156,24732
test,802,35,35840,249,249,36089
test,803,16,16384,100,100,16484
test,804,10,10240,58,58,10298
test,805,8,8192,44,44,8236
test,806,18,18432,124,124,18556
test,807,8,8192,44,44,8236
test,808,15,15360,93,93,15453
test,809,17,17408,107,107,17515
test,810,20,20480,128,128,20608
test,811,29,29696,199,199,29895
test,812,26,26624,182,182,26806
test,813,18,18432,114,114,18546
test,814,22,22528,142,142,22670
test,815,4,4096,16,16,4112
test,816,19,19456,121,121,19577
test,817,27,27648,177,177,27825
test,818,18,18432,114,114,18546
test,819,9,9216,51,51,9267
test,820,5,5120,23,23,5143
test,821,19,19456,121,121,19577
test,822,12,12288,72,72,12360
test,823,13,13312,79,79,13391
test,824,21,21504,135,135,21639
test,825,22,22528,148,148,22676
test,826,19,19456,143,143,19599
test,827,26,26624,178,178,26802
test,828,20,20480,128,128,20608
test,829,19,19456,121,121,19577
test,830,10,10240,58,58,10298
test,831,26,26624,170,170,26794
test,832,17,17408,107,107,17515
test,833,12,12288,72,72,12360
test,834,43,44032,307,307,44339
test,835,21,21504,141,141,21645
test,836,29,29696,189,189,29885
test,837,15,15360,103,103,15463
test,838,9,9216,51,51,9267
test,839,13,13312,79,79,13391
test,840,16,16384,98,98,16482
test,841,25,25600,169,169,25769
test,842,29,29696,207,207,29903
test,843,37,37888,269,269,38157
test,844,18,18432,124,124,18556
test,845,32,32768,222,222,32990
test,846,13,13312,79,79,13391
test,847,12,12288,72,72,12360
test,848,20,20480,128,128,20608
test,849,17,17408,107,107,17515
test,850,35,35840,239,239,36079
test,851,38,38912,268,268,39180
test,852,20,20480,138,138,20618
test,853,7,7168,37,37,7205
test,854,22,22528,144,144,22672
test,855,34,34816,238,238,35054
test,856,32,32768,234,234,33002
test,857,21,21504,141,141,21645
test,858,14,14336,86,86,14422
test,859,17,17408,107,107,17515
test,860,21,21504,139,139,21643
test,861,20,20480,130,130,20610
test,862,38,38912,264,264,39176
test,863,26,26624,170,170,26794
test,864,28,28672,200,200,28872
test,865,23,23552,153,153,23705
test,866,30,30720,198,198,30918
test,867,48,49152,332,332,49484
test,868,14,14336,94,94,14430
test,869,21,21504,135,135,21639
test,870,8,8192,44,44,8236
test,871,29,29696,201,201,29897
test,872,6,6144,30,30,6174
test,873,17,17408,113,113,17521
test,874,31,31744,229,229,31973
test,875,22,22528,148,148,22676
test,876,16,16384,100,100,16484
test,877,38,38912,260,260,39172
test,878,33,33792,241,241,34033
test,879,22,22528,148,148,22676
test,880,33,33792,217,217,34009
test,881,5,5120,23,23,5143
test,882,30,30720,240,240,30960
test,883,26,26624,192,192,26816
test,884,9,9216,51,51,9267
test,885,28,28672,184,184,28856
test,886,9,9216,51,51,9267
test,887,11,11264,65,65,11329
test,888,21,21504,135,135,21639
test,889,24,24576,162,162,24738
test,890,15,15360,99,99,15459
test,891,29,29696,197,197,29893
test,892,28,28672,182,182,28854
test,893,31,31744,213,213,31957
test,894,25,25600,161,161,25761
test,895,5,5120,23,23,5143
test,896,26,26624,170,170,26794
test,897,28,28672,196,196,28868
test,898,18,18432,114,114,18546
test,899,12,12288,72,72,12360
test,900,13,13312,81,81,13393
test,901,26,26624,182,182,26806
test,902,31,31744,227,227,31971
test,903,36,36864,246,246,37110
test,904,15,15360,93,93,15453
test,905,23,23552,153,153,23705
test,906,18,18432,112,112,18544
test,907,15,15360,93,93,15453
test,908,14,14336,84,84,14420
test,909,14,14336,88,88,14424
test,910,21,21504,155,155,21659
test,911,34,34816,252,252,35068
test,912,8,8192,44,44,8236
test,913,17,17408,107,107,17515
test,914,19,19456,121,121,19577
test,915,24,24576,168,168,24744
test,916,26,26624,170,170,26794
test,917,29,29696,193,193,29889
test,918,15,15360,105,105,15465
test,919,16,16384,100,100,16484
test,920,13,13312,87,87,13399
test,921,25,25600,165,165,25765
test,922,33,33792,237,237,34029
test,923,11,11264,65,65,11329
test,924,32,32768,222,222,32990
test,925,37,37888,261,261,38149
test,926,36,36864,240,240,37104
test,927,35,35840,237,237,36077
test,928,9,9216,51,51,9267
test,929,17,17408,113,113,17521
test,930,38,38912,282,282,39194
test,931,18,18432,114,114,18546
test,932,17,17408,107,107,17515
test,933,8,8192,44,44,8236
test,934,45,46080,325,325,46405
test,935,15,15360,93,93,15453
test,936,14,14336,84,84,14420
test,937,10,10240,58,58,10298
test,938,14,14336,92,92,14428
test,939,40,40960,296,296,41256
test,940,28,28672,190,190,28862
test,941,36,36864,246,246,37110
test,942,29,29696,209,209,29905
test,943,19,19456,121,121,19577
test,944,24,24576,156,156,24732
test,945,22,22528,140,140,22668
test,946,44,45056,330,330,45386
test,947,33,33792,257,257,34049
test,948,35,35840,251,251,36091
test,949,16,16384,100,100,16484
test,950,30,30720,212,212,30932
test,951,23,23552,161,161,23713
test,952,21,21504,133,133,21637
test,953,18,18432,114,114,18546
test,954,10,10240,58,58,10298
test,955,31,31744,207,207,31951
test,956,17,17408,107,107,17515
test,957,24,24576,168,168,24744
test,958,25,25600,169,169,25769
test,959,32,32768,226,226,32994
test,960,14,14336,86,86,14422
test,961,9,9216,51,51,9267
test,962,18,18432,120,120,18552
test,963,19,19456,135,135,19591
test,964,15,15360,93,93,15453
test,965,12,12288,70,70,12358
test,966,29,29696,197,197,29893
test,967,21,21504,141,141,21645
test,968,25,25600,163,163,25763
test,969,8,8192,44,44,8236
test,970,8,8192,44,44,8236
test,971,36,36864,252,252,37116
test,972,29,29696,209,209,29905
test,973,19,19456,121,121,19577
test,974,9,9216,51,51,9267
test,975,11,11264,65,65,11329
test,976,7,7168,37,37,7205
test,977,21,21504,135,135,21639
test,978,17,17408,113,113,17521
test,979,18,18432,112,112,18544
test,980,28,28672,184,184,28856
test,981,33,33792,251,251,34043
test,982,21,21504,147,147,21651
test,983,7,7168,37,37,7205
test,984,14,14336,86,86,14422
test,985,11,11264,65,65,11329
test,986,12,12288,72,72,12360
test,987,28,28672,190,190,28862
test,988,10,10240,58,58,10298
test,989,22,22528,152,152,22680
test,990,33,33792,225,225,34017
test,991,16,16384,100,100,16484
test,992,25,25600,169,169,25769
test,993,42,43008,306,306,43314
test,994,13,13312,79,79,13391
test,995,35,35840,233,233,36073
test,996,17,17408,113,113,17521
test,997,11,11264,65,65,11329
test,998,20,20480,134,134,20614
test,999,27,27648,181,181,27829
test,1000,13,13312,79,79,13391
test,1001,19,19456,127,127,19583
test,1002,10,10240,58,58,10298
test,1003,9,9216,51,51,9267
test,1004,31,31744,211,211,31955
test,1005,32,32768,242,242,33010
test,1006,25,25600,161,161,25761
test,1007,13,13312,91,91,13403
test,1008,23,23552,151,151,23703
test,1009,30,30720,210,210,30930
test,1010,7,7168,37,37,7205
test,1011,21,21504,141,141,21645
test,1012,7,7168,37,37,7205
test,1013,9,9216,51,51,9267
test,1014,12,12288,72,72,12360
test,1015,12,12288,72,72,12360
test,1016,25,25600,169,169,25769
test,1017,10,10240,58,58,10298
test,1018,8,8192,44,44,8236
test,1019,39,39936,269,269,40205
test,1020,33,33792,233,233,34025
test,1021,27,27648,189,189,27837
test,1022,22,22528,142,142,22670
test,1023,4,4096,16,16,4112
test,1024,19,19456,127,127,19583
test,1025,10,10240,58,58,10298
test,1026,19,19456,121,121,19577
test,1027,13,13312,79,79,13391
test,1028,12,12288,70,70,12358
test,1029,13,13312,79,79,13391
test,1030,17,17408,113,113,17521
test,1031,37,37888,265,265,38153
test,1032,25,25600,165,165,25765
test,1033,17,17408,119,119,17527
test,1034,20,20480,134,134,20614
test,1035,16,16384,100,100,16484
test,1036,24,24576,156,156,24732
test,1037,27,27648,185,185,27833
test,1038,22,22528,150,150,22678
test,1039,17,17408,107,107,17515
test,1040,19,19456,121,121,19577
test,1041,8,8192,44,44,8236
test,1042,25,25600,163,163,25763
test,1043,29,29696,203,203,29899
test,1044,16,16384,106,106,16490
test,1045,21,21504,143,143,21647
test,1046,23,23552,149,149,23701
test,1047,16,16384,100,100,16484
test,1048,8,8192,44,44,8236
test,1049,34,34816,262,262,35078
test,1050,13,13312,79,79,13391
test,1051,24,24576,156,156,24732
test,1052,35,35840,243,243,36083
test,1053,42,43008,306,306,43314
test,1054,25,25600,177,177,25777
test,1055,10,10240,58,58,10298
test,1056,11,11264,65,65,11329
test,1057,6,6144,30,30,6174
test,1058,7,7168,37,37,7205
test,1059,3,3072,9,9,3081
test,1060,30,30720,210,210,30930
test,1061,23,23552,155,155,23707
test,1062,13,13312,79,79,13391
test,1063,22,22528,148,148,22676
test,1064,19,19456,131,131,19587
test,1065,24,24576,156,156,24732
test,1066,15,15360,97,97,15457
test,1067,26,26624,182,182,26806
test,1068,23,23552,153,153,23705
test,1069,25,25600,161,161,25761
test,1070,17,17408,109,109,17517
test,1071,31,31744,229,229,31973
test,1072,25,25600,173,173,25773
test,1073,39,39936,279,279,40215
test,1074,24,24576,162,162,24738
test,1075,10,10240,60,60,10300
test,1076,17,17408,107,107,17515
test,1077,14,14336,90,90,14426
test,1078,18,18432,114,114,18546
test,1079,27,27648,179,179,27827
test,1080,14,14336,86,86,14422
test,1081,19,19456,125,125,19581
test,1082,4,4096,16,16,4112
test,1083,9,9216,57,57,9273
test,1084,27,27648,177,177,27825
test,1085,5,5120,23,23,5143
test,1086,22,22528,142,142,22670
test,1087,35,35840,239,239,36079
test,1088,21,21504,147,147,21651
test,1089,22,22528,142,142,22670
test,1090,20,20480,128,128,20608
test,1091,9,9216,51,51,9267
test,1092,20,20480,128,128,20608
test,1093,6,6144,30,30,6174
test,1094,18,18432,114,114,18546
test,1095,10,10240,58,58,10298
test,1096,20,20480,130,130,20610
test,1097,18,18432,120,120,18552
test,1098,41,41984,313,313,42297
test,1099,13,13312,79,79,13391
test,1100,14,14336,86,86,14422
test,1101,21,21504,145,145,21649
test,1102,24,24576,158,158,24734
test,1103,32,32768,216,216,32984
test,1104,18,18432,120,120,18552
test,1105,11,11264,65,65,11329
test,1106,24,24576,168,168,24744
test,1107,31,31744,211,211,31955
test,1108,24,24576,166,166,24742
test,1109,11,11264,65,65,11329
test,1110,20,20480,128,128,20608
test,1111,31,31744,205,205,31949
test,1112,20,20480,134,134,20614
test,1113,33,33792,231,231,34023
test,1114,23,23552,161,161,23713
test,1115,8,8192,44,44,8236
test,1116,22,22528,150,150,22678
test,1117,21,21504,135,135,21639
test,1118,9,9216,51,51,9267
test,1119,27,27648,185,185,27833
test,1120,7,7168,37,37,7205
test,1121,14,14336,98,98,14434
test,1122,27,27648,191,191,27839
test,1123,27,27648,197,197,27845
test,1124,30,30720,204,204,30924
test,1125,25,25600,163,163,25763
test,1126,11,11264,65,65,11329
test,1127,16,16384,100,100,16484
test,1128,10,10240,58,58,10298
test,1129,19,19456,127,127,19583
test,1130,23,23552,163,163,23715
test,1131,14,14336,86,86,14422
test,1132,21,21504,135,135,21639
test,1133,4,4096,16,16,4112
test,1134,15,15360,93,93,15453
test,1135,26,26624,168,168,26792
test,1136,37,37888,261,261,38149
test,1137,13,13312,77,77,13389
test,1138,24,24576,168,168,24744
test,1139,35,35840,239,239,36079
test,1140,10,10240,58,58,10298
test,1141,22,22528,142,142,22670
test,1142,22,22528,150,150,22678
test,1143,27,27648,183,183,27831
test,1144,46,47104,344,344,47448
test,1145,46,47104,328,328,47432
test,1146,16,16384,106,106,16490
test,1147,42,43008,300,300,43308
test,1148,16,16384,114,114,16498
test,1149,10,10240,58,58,10298
test,1150,25,25600,163,163,25763
test,1151,21,21504,135,135,21639
test,1152,19,19456,119,119,19575
test,1153,13,13312,79,79,13391
test,1154,30,30720,206,206,30926
test,1155,23,23552,155,155,23707
test,1156,6,6144,30,30,6174
test,1157,11,11264,65,65,11329
test,1158,33,33792,223,223,34015
test,1159,34,34816,244,244,35060
test,1160,12,12288,72,72,12360
test,1161,20,20480,128,128,20608
test,1162,22,22528,142,142,22670
test,1163,8,8192,44,44,8236
test,1164,31,31744,211,211,31955
test,1165,26,26624,182,182,26806
test,1166,25,25600,179,179,25779
test,1167,32,32768,218,218,32986
test,1168,12,12288,76,76,12364
test,1169,24,24576,174,174,24750
test,1170,36,36864,254,254,37118
test,1171,32,32768,224,224,32992
test,1172,33,33792,225,225,34017
test,1173,24,24576,158,158,24734
test,1174,13,13312,77,77,13389
test,1175,16,16384,100,100,16484
test,1176,27,27648,183,183,27831
test,1177,30,30720,204,204,30924
test,1178,23,23552,153,153,23705
test,1179,13,13312,79,79,13391
test,1180,9,9216,51,51,9267
test,1181,22,22528,142,142,22670
test,1182,17,17408,107,107,17515
test,1183,22,22528,142,142,22670
test,1184,15,15360,93,93,15453
test,1185,24,24576,162,162,24738
test,1186,14,14336,84,84,14420
test,1187,17,17408,113,113,17521
test,1188,23,23552,161,161,23713
test,1189,22,22528,148,148,22676
test,1190,24,24576,172,172,24748
test,1191,7,7168,37,37,7205
test,1192,13,13312,77,77,13389
test,1193,22,22528,148,148,22676
test,1194,15,15360,93,93,15453
test,1195,22,22528,140,140,22668
test,1196,28,28672,184,184,28856
test,1197,10,10240,58,58,10298
test,1198,13,13312,79,79,13391
test,1199,20,20480,136,136,20616
test,1200,16,16384,100,100,16484
test,1201,16,16384,100,100,16484
test,1202,15,15360,93,93,15453
test,1203,26,26624,190,190,26814
test,1204,43,44032,313,313,44345
test,1205,13,13312,79,79,13391
test,1206,28,28672,204,204,28876
test,1207,18,18432,124,124,18556
test,1208,32,32768,212,212,32980
test,1209,36,36864,256,256,37120
test,1210,22,22528,148,148,22676
test,1211,28,28672,190,190,28862
test,1212,7,7168,37,37,7205
test,1213,42,43008,282,282,43290
test,1214,28,28672,184,184,28856
test,1215,25,25600,175,175,25775
test,1216,28,28672,184,184,28856
test,1217,7,7168,37,37,7205
test,1218,36,36864,256,256,37120
test,1219,17,17408,107,107,17515
test,1220,14,14336,86,86,14422
test,1221,9,9216,51,51,9267
test,1222,37,37888,303,303,38191
test,1223,9,9216,51,51,9267
test,1224,21,21504,135,135,21639
test,1225,24,24576,166,166,24742
test,1226,31,31744,221,221,31965
test,1227,41,41984,303,303,42287
test,1228,27,27648,199,199,27847
test,1229,7,7168,37,37,7205
test,1230,20,20480,124,124,20604
test,1231,24,24576,162,162,24738
test,1232,16,16384,100,100,16484
test,1233,27,27648,187,187,27835
test,1234,13,13312,79,79,13391
test,1235,13,13312,79,79,13391
test,1236,25,25600,173,173,25773
test,1237,26,26624,194,194,26818
test,1238,12,12288,72,72,12360
test,1239,22,22528,160,160,22688
test,1240,12,12288,74,74,12362
test,1241,19,19456,121,121,19577
test,1242,25,25600,173,173,25773
test,1243,36,36864,246,246,37110
test,1244,26,26624,176,176,26800
test,1245,39,39936,277,277,40213
test,1246,22,22528,142,142,22670
test,1247,14,14336,86,86,14422
test,1248,33,33792,245,245,34037
test,1249,18,18432,122,122,18554
test,1250,18,18432,116,116,18548
test,1251,22,22528,150,150,22678
test,1252,12,12288,72,72,12360
test,1253,25,25600,169,169,25769
test,1254,31,31744,223,223,31967
test,1255,18,18432,120,120,18552
test,1256,24,24576,158,158,24734
test,1257,8,8192,44,44,8236
test,1258,30,30720,214,214,30934
test,1259,17,17408,107,107,17515
test,1260,15,15360,93,93,15453
test,1261,9,9216,51,51,9267
test,1262,16,16384,98,98,16482
test,1263,32,32768,214,214,32982
test,1264,28,28672,208,208,28880
test,1265,28,28672,200,200,28872
test,1266,28,28672,196,196,28868
test,1267,16,16384,100,100,16484
test,1268,15,15360,99,99,15459
test,1269,27,27648,199,199,27847
test,1270,13,13312,79,79,13391
test,1271,14,14336,86,86,14422
test,1272,10,10240,60,60,10300
test,1273,22,22528,148,148,22676
test,1274,24,24576,168,168,24744
test,1275,28,28672,190,190,28862
test,1276,28,28672,184,184,28856
test,1277,30,30720,208,208,30928
test,1278,7,7168,37,37,7205
test,1279,15,15360,93,93,15453
test,1280,23,23552,151,151,23703
test,1281,13,13312,73,73,13385
test,1282,13,13312,85,85,13397
test,1283,17,17408,107,107,17515
test,1284,10,10240,58,58,10298
test,1285,31,31744,223,223,31967
test,1286,14,14336,92,92,14428
test,1287,32,32768,228,228,32996
test,1288,29,29696,213,213,29909
test,1289,7,7168,37,37,7205
test,1290,32,32768,232,232,33000
test,1291,20,20480,128,128,20608
test,1292,24,24576,162,162,24738
test,1293,21,21504,135,135,21639
test,1294,3,3072,9,9,3081
test,1295,19,19456,127,127,19583
test,1296,11,11264,65,65,11329
test,1297,31,31744,211,211,31955
test,1298,17,17408,107,107,17515
test,1299,37,37888,287,287,38175
test,1300,23,23552,153,153,23705
test,1301,21,21504,131,131,21635
test,1302,21,21504,135,135,21639
test,1303,17,17408,113,113,17521
test,1304,9,9216,51,51,9267
test,1305,26,26624,182,182,26806
test,1306,22,22528,148,148,22676
test,1307,18,18432,114,114,18546
test,1308,8,8192,44,44,8236
test,1309,12,12288,72,72,12360
test,1310,9,9216,51,51,9267
test,1311,31,31744,215,215,31959
test,1312,18,18432,120,120,18552
test,1313,12,12288,72,72,12360
test,1314,23,23552,155,155,23707
test,1315,29,29696,191,191,29887
test,1316,33,33792,231,231,34023
test,1317,24,24576,168,168,24744
test,1318,12,12288,72,72,12360
test,1319,25,25600,163,163,25763
test,1320,26,26624,176,176,26800
test,1321,17,17408,107,107,17515
test,1322,16,16384,100,100,16484
test,1323,33,33792,239,239,34031
test,1324,16,16384,100,100,16484
test,1325,7,7168,37,37,7205
test,1326,37,37888,289,289,38177
test,1327,5,5120,23,23,5143
test,1328,17,17408,107,107,17515
test,1329,18,18432,114,114,18546
test,1330,18,18432,124,124,18556
test,1331,9,9216,51,51,9267
test,1332,11,11264,65,65,11329
test,1333,36,36864,248,248,37112
test,1334,18,18432,114,114,18546
test,1335,25,25600,163,163,25763
test,1336,41,41984,287,287,42271
test,1337,10,10240,58,58,10298
test,1338,21,21504,141,141,21645
test,1339,18,18432,120,120,18552
test,1340,16,16384,100,100,16484
test,1341,20,20480,156,156,20636
test,1342,9,9216,51,51,9267
test,1343,22,22528,156,156,22684
test,1344,13,13312,79,79,13391
test,1345,22,22528,142,142,22670
test,1346,37,37888,269,269,38157
test,1347,23,23552,149,149,23701
test,1348,26,26624,176,176,26800
test,1349,28,28672,194,194,28866
test,1350,17,17408,107,107,17515
test,1351,29,29696,197,197,29893
test,1352,19,19456,125,125,19581
test,1353,20,20480,128,128,20608
test,1354,16,16384,100,100,16484
test,1355,8,8192,44,44,8236
test,1356,16,16384,100,100,16484
test,1357,21,21504,141,141,21645
test,1358,28,28672,184,184,28856
test,1359,39,39936,291,291,40227
test,1360,18,18432,120,120,18552
test,1361,18,18432,114,114,18546
test,1362,5,5120,23,23,5143
test,1363,31,31744,205,205,31949
test,1364,9,9216,51,51,9267
test,1365,24,24576,162,162,24738
test,1366,12,12288,72,72,12360
test,1367,21,21504,139,139,21643
test,1368,21,21504,141,141,21645
test,1369,14,14336,86,86,14422
test,1370,20,20480,134,134,20614
test,1371,26,26624,178,178,26802
test,1372,25,25600,163,163,25763
test,1373,18,18432,124,124,18556
test,1374,24,24576,162,162,24738
test,1375,10,10240,58,58,10298
test,1376,11,11264,65,65,11329
test,1377,36,36864,278,278,37142
test,1378,27,27648,197,197,27845
test,1379,28,28672,184,184,28856
test,1380,17,17408,117,117,17525
test,1381,20,20480,132,132,20612
test,1382,31,31744,217,217,31961
test,1383,30,30720,204,204,30924
test,1384,15,15360,93,93,15453
test,1385,18,18432,114,114,18546
test,1386,21,21504,135,135,21639
test,1387,24,24576,162,162,24738
test,1388,15,15360,99,99,15459
test,1389,6,6144,30,30,6174
test,1390,19,19456,129,129,19585
test,1391,8,8192,44,44,8236
test,1392,15,15360,99,99,15459
test,1393,45,46080,323,323,46403
test,1394,32,32768,220,220,32988
test,1395,14,14336,86,86,14422
test,1396,11,11264,65,65,11329
test,1397,14,14336,86,86,14422
test,1398,21,21504,135,135,21639
test,1399,14,14336,84,84,14420
test,1400,13,13312,79,79,13391
test,1401,15,15360,93,93,15453
test,1402,23,23552,151,151,23703
test,1403,31,31744,205,205,31949
test,1404,29,29696,197,197,29893
test,1405,26,26624,188,188,26812
test,1406,24,24576,168,168,24744
test,1407,9,9216,51,51,9267
test,1408,20,20480,142,142,20622
test,1409,27,27648,187,187,27835
test,1410,15,15360,107,107,15467
test,1411,18,18432,120,120,18552
test,1412,26,26624,182,182,26806
test,1413,6,6144,30,30,6174
test,1414,16,16384,100,100,16484
test,1415,7,7168,37,37,7205
test,1416,24,24576,156,156,24732
test,1417,25,25600,169,169,25769
test,1418,26,26624,176,176,26800
test,1419,18,18432,118,118,18550
test,1420,12,12288,74,74,12362
test,1421,36,36864,276,276,37140
test,1422,11,11264,63,63,11327
test,1423,22,22528,148,148,22676
test,1424,24,24576,162,162,24738
test,1425,16,16384,100,100,16484
test,1426,19,19456,125,125,19581
test,1427,29,29696,197,197,29893
test,1428,10,10240,58,58,10298
test,1429,22,22528,142,142,22670
test,1430,23,23552,155,155,23707
test,1431,11,11264,65,65,11329
test,1432,37,37888,275,275,38163
test,1433,19,19456,121,121,19577
test,1434,43,44032,311,311,44343
test,1435,21,21504,135,135,21639
test,1436,31,31744,211,211,31955
test,1437,27,27648,203,203,27851
test,1438,29,29696,195,195,29891
test,1439,24,24576,156,156,24732
test,1440,33,33792,235,235,34027
test,1441,17,17408,107,107,17515
test,1442,13,13312,85,85,13397
test,1443,9,9216,51,51,9267
test,1444,24,24576,154,154,24730
test,1445,50,51200,372,372,51572
test,1446,45,46080,315,315,46395
test,1447,21,21504,135,135,21639
test,1448,15,15360,93,93,15453
test,1449,30,30720,206,206,30926
test,1450,25,25600,169,169,25769
test,1451,36,36864,246,246,37110
test,1452,35,35840,245,245,36085
test,1453,32,32768,224,224,32992
test,1454,25,25600,179,179,25779
test,1455,16,16384,102,102,16486
test,1456,27,27648,189,189,27837
test,1457,7,7168,37,37,7205
test,1458,22,22528,148,148,22676
test,1459,7,7168,37,37,7205
test,1460,29,29696,211,211,29907
test,1461,12,12288,72,72,12360
test,1462,22,22528,160,160,22688
test,1463,18,18432,120,120,18552
test,1464,14,14336,92,92,14428
test,1465,30,30720,214,214,30934
test,1466,41,41984,303,303,42287
test,1467,23,23552,161,161,23713
test,1468,29,29696,191,191,29887
test,1469,37,37888,251,251,38139
test,1470,15,15360,93,93,15453
test,1471,17,17408,107,107,17515
test,1472,9,9216,51,51,9267
test,1473,26,26624,178,178,26802
test,1474,16,16384,100,100,16484
test,1475,12,12288,74,74,12362
test,1476,20,20480,128,128,20608
test,1477,24,24576,162,162,24738
test,1478,12,12288,72,72,12360
test,1479,23,23552,149,149,23701
test,1480,21,21504,141,141,21645
test,1481,15,15360,93,93,15453
test,1482,31,31744,205,205,31949
test,1483,18,18432,114,114,18546
test,1484,23,23552,149,149,23701
test,1485,14,14336,86,86,14422
test,1486,10,10240,58,58,10298
test,1487,20,20480,136,136,20616
test,1488,31,31744,223,223,31967
test,1489,17,17408,113,113,17521
test,1490,15,15360,93,93,15453
test,1491,27,27648,183,183,27831
test,1492,34,34816,236,236,35052
test,1493,25,25600,175,175,25775
test,1494,26,26624,176,176,26800
test,1495,8,8192,44,44,8236
test,1496,10,10240,58,58,10298
test,1497,7,7168,37,37,7205
test,1498,20,20480,138,138,20618
test,1499,9,9216,51,51,9267
test,1500,9,9216,51,51,9267
test,1501,44,45056,330,330,45386
test,1502,22,22528,144,144,22672
test,1503,25,25600,163,163,25763
test,1504,45,46080,323,323,46403
test,1505,15,15360,93,93,15453
test,1506,6,6144,30,30,6174
test,1507,36,36864,246,246,37110
test,1508,19,19456,143,143,19599
test,1509,25,25600,175,175,25775
test,1510,19,19456,127,127,19583
test,1511,24,24576,162,162,24738
test,1512,11,11264,65,65,11329
test,1513,16,16384,100,100,16484
test,1514,10,10240,58,58,10298
test,1515,24,24576,162,162,24738
test,1516,17,17408,113,113,17521
test,1517,17,17408,107,107,17515
test,1518,43,44032,323,323,44355
test,1519,26,26624,188,188,26812
test,1520,35,35840,257,257,36097
test,1521,31,31744,229,229,31973
test,1522,29,29696,207,207,29903
test,1523,9,9216,51,51,9267
test,1524,28,28672,196,196,28868
test,1525,7,7168,37,37,7205
test,1526,29,29696,201,201,29897
test,1527,16,16384,100,100,16484
test,1528,26,26624,176,176,26800
test,1529,15,15360,93,93,15453
test,1530,28,28672,190,190,28862
test,1531,9,9216,51,51,9267
test,1532,45,46080,309,309,46389
test,1533,23,23552,155,155,23707
test,1534,16,16384,100,100,16484
test,1535,20,20480,136,136,20616
test,1536,17,17408,107,107,17515
test,1537,16,16384,100,100,16484
test,1538,18,18432,120,120,18552
test,1539,27,27648,177,177,27825
test,1540,11,11264,65,65,11329
test,1541,21,21504,149,149,21653
test,1542,19,19456,131,131,19587
test,1543,18,18432,114,114,18546
test,1544,16,16384,114,114,16498
test,1545,9,9216,51,51,9267
test,1546,16,16384,98,98,16482
test,1547,14,14336,86,86,14422
test,1548,30,30720,210,210,30930
test,1549,21,21504,141,141,21645
test,1550,10,10240,56,56,10296
test,1551,25,25600,163,163,25763
test,1552,22,22528,148,148,22676
test,1553,24,24576,174,174,24750
test,1554,13,13312,79,79,13391
test,1555,36,36864,260,260,37124
test,1556,10,10240,58,58,10298
test,1557,13,13312,75,75,13387
test,1558,42,43008,316,316,43324
test,1559,20,20480,128,128,20608
test,1560,7,7168,37,37,7205
test,1561,19,19456,121,121,19577
test,1562,11,11264,65,65,11329
test,1563,39,39936,295,295,40231
test,1564,10,10240,58,58,10298
test,1565,18,18432,120,120,18552
test,1566,17,17408,113,113,17521
test,1567,13,13312,79,79,13391
test,1568,12,12288,72,72,12360
test,1569,11,11264,65,65,11329
test,1570,16,16384,100,100,16484
test,1571,10,10240,58,58,10298
test,1572,21,21504,133,133,21637
test,1573,29,29696,191,191,29887
test,1574,31,31744,225,225,31969
test,1575,11,11264,65,65,11329
test,1576,31,31744,211,211,31955
test,1577,11,11264,65,65,11329
test,1578,15,15360,99,99,15459
test,1579,30,30720,196,196,30916
test,1580,7,7168,37,37,7205
test,1581,23,23552,149,149,23701
test,1582,20,20480,128,128,20608
test,1583,21,21504,135,135,21639
test,1584,26,26624,176,176,26800
test,1585,8,8192,44,44,8236
test,1586,19,19456,135,135,19591
test,1587,17,17408,107,107,17515
test,1588,19,19456,121,121,19577
test,1589,21,21504,147,147,21651
test,1590,22,22528,142,142,22670
test,1591,14,14336,86,86,14422
test,1592,29,29696,193,193,29889
test,1593,13,13312,79,79,13391
test,1594,25,25600,179,179,25779
test,1595,27,27648,179,179,27827
test,1596,13,13312,79,79,13391
test,1597,8,8192,44,44,8236
test,1598,37,37888,257,257,38145
test,1599,30,30720,204,204,30924
test,1600,17,17408,107,107,17515
test,1601,18,18432,114,114,18546
test,1602,14,14336,86,86,14422
test,1603,6,6144,30,30,6174
test,1604,7,7168,37,37,7205
test,1605,17,17408,107,107,17515
test,1606,10,10240,58,58,10298
test,1607,16,16384,100,100,16484
test,1608,13,13312,79,79,13391
test,1609,15,15360,93,93,15453
test,1610,20,20480,128,128,20608
test,1611,11,11264,65,65,11329
test,1612,23,23552,161,161,23713
test,1613,20,20480,128,128,20608
test,1614,17,17408,109,109,17517
test,1615,19,19456,121,121,19577
test,1616,26,26624,176,176,26800
test,1617,15,15360,93,93,15453
test,1618,31,31744,223,223,31967
test,1619,26,26624,178,178,26802
test,1620,20,20480,132,132,20612
test,1621,7,7168,37,37,7205
test,1622,25,25600,169,169,25769
test,1623,33,33792,225,225,34017
test,1624,10,10240,58,58,10298
test,1625,22,22528,142,142,22670
test,1626,23,23552,153,153,23705
test,1627,19,19456,139,139,19595
test,1628,27,27648,195,195,27843
test,1629,35,35840,257,257,36097
test,1630,22,22528,150,150,22678
test,1631,21,21504,141,141,21645
test,1632,28,28672,202,202,28874
test,1633,15,15360,93,93,15453
test,1634,39,39936,261,261,40197
test,1635,21,21504,141,141,21645
test,1636,44,45056,330,330,45386
test,1637,12,12288,72,72,12360
test,1638,25,25600,183,183,25783
test,1639,12,12288,72,72,12360
test,1640,25,25600,179,179,25779
test,1641,9,9216,51,51,9267
test,1642,37,37888,287,287,38175
test,1643,17,17408,107,107,17515
test,1644,25,25600,181,181,25781
test,1645,18,18432,114,114,18546
test,1646,14,14336,86,86,14422
test,1647,30,30720,208,208,30928
test,1648,25,25600,163,163,25763
test,1649,20,20480,134,134,20614
test,1650,33,33792,219,219,34011
test,1651,24,24576,156,156,24732
test,1652,24,24576,162,162,24738
test,1653,23,23552,159,159,23711
test,1654,12,12288,80,80,12368
test,1655,32,32768,230,230,32998
test,1656,34,34816,238,238,35054
test,1657,7,7168,37,37,7205
test,1658,10,10240,58,58,10298
test,1659,34,34816,232,232,35048
test,1660,24,24576,172,172,24748
test,1661,31,31744,233,233,31977
test,1662,23,23552,149,149,23701
test,1663,14,14336,84,84,14420
test,1664,19,19456,131,131,19587
test,1665,18,18432,114,114,18546
test,1666,17,17408,117,117,17525
test,1667,35,35840,251,251,36091
test,1668,36,36864,262,262,37126
test,1669,18,18432,112,112,18544
test,1670,20,20480,142,142,20622
test,1671,16,16384,100,100,16484
test,1672,31,31744,215,215,31959
test,1673,24,24576,166,166,24742
test,1674,30,30720,204,204,30924
test,1675,20,20480,128,128,20608
test,1676,22,22528,156,156,22684
test,1677,36,36864,252,252,37116
test,1678,9,9216,51,51,9267
test,1679,22,22528,174,174,22702
test,1680,3,3072,9,9,3081
test,1681,19,19456,121,121,19577
test,1682,40,40960,278,278,41238
test,1683,30,30720,204,204,30924
test,1684,17,17408,105,105,17513
test,1685,13,13312,79,79,13391
test,1686,32,32768,218,218,32986
test,1687,33,33792,243,243,34035
test,1688,13,13312,85,85,13397
test,1689,29,29696,197,197,29893
test,1690,17,17408,107,107,17515
test,1691,7,7168,37,37,7205
test,1692,28,28672,192,192,28864
test,1693,32,32768,238,238,33006
test,1694,19,19456,127,127,19583
test,1695,10,10240,58,58,10298
test,1696,35,35840,245,245,36085
test,1697,24,24576,154,154,24730
test,1698,13,13312,77,77,13389
test,1699,16,16384,100,100,16484
test,1700,20,20480,134,134,20614
test,1701,24,24576,164,164,24740
test,1702,23,23552,151,151,23703
test,1703,11,11264,65,65,11329
test,1704,25,25600,163,163,25763
test,1705,24,24576,164,164,24740
test,1706,24,24576,184,184,24760
test,1707,22,22528,148,148,22676
test,1708,20,20480,128,128,20608
test,1709,32,32768,230,230,32998
test,1710,7,7168,37,37,7205
test,1711,27,27648,187,187,27835
test,1712,21,21504,135,135,21639
test,1713,13,13312,79,79,13391
test,1714,24,24576,162,162,24738
test,1715,20,20480,134,134,20614
test,1716,30,30720,212,212,30932
test,1717,21,21504,135,135,21639
test,1718,8,8192,44,44,8236
test,1719,17,17408,107,107,17515
test,1720,27,27648,209,209,27857
test,1721,8,8192,44,44,8236
test,1722,24,24576,160,160,24736
test,1723,20,20480,128,128,20608
test,1724,6,6144,30,30,6174
test,1725,30,30720,200,200,30920
test,1726,10,10240,58,58,10298
test,1727,6,6144,30,30,6174
test,1728,35,35840,243,243,36083
test,1729,26,26624,176,176,26800
test,1730,17,17408,107,107,17515
test,1731,17,17408,107,107,17515
test,1732,21,21504,141,141,21645
test,1733,3,3072,9,9,3081
test,1734,14,14336,86,86,14422
test,1735,22,22528,142,142,22670
test,1736,12,12288,74,74,12362
test,1737,29,29696,207,207,29903
test,1738,18,18432,114,114,18546
test,1739,25,25600,163,163,25763
test,1740,39,39936,289,289,40225
test,1741,24,24576,156,156,24732
test,1742,32,32768,214,214,32982
test,1743,13,13312,79,79,13391
test,1744,28,28672,196,196,28868
test,1745,22,22528,148,148,22676
test,1746,50,51200,344,344,51544
test,1747,31,31744,209,209,31953
test,1748,24,24576,162,162,24738
test,1749,33,33792,219,219,34011
test,1750,22,22528,142,142,22670
test,1751,3,3072,9,9,3081
test,1752,33,33792,239,239,34031
test,1753,30,30720,222,222,30942
test,1754,7,7168,37,37,7205
test,1755,23,23552,149,149,23701
test,1756,7,7168,37,37,7205
test,1757,11,11264,65,65,11329
test,1758,13,13312,79,79,13391
test,1759,22,22528,142,142,22670
test,1760,6,6144,30,30,6174
test,1761,33,33792,235,235,34027
test,1762,18,18432,112,112,18544
test,1763,12,12288,72,72,12360
test,1764,16,16384,100,100,16484
test,1765,22,22528,154,154,22682
test,1766,20,20480,128,128,20608
test,1767,18,18432,114,114,18546
test,1768,31,31744,211,211,31955
test,1769,33,33792,245,245,34037
test,1770,19,19456,121,121,19577
test,1771,13,13312,79,79,13391
test,1772,25,25600,169,169,25769
test,1773,17,17408,107,107,17515
test,1774,26,26624,176,176,26800
test,1775,35,35840,245,245,36085
test,1776,8,8192,44,44,8236
test,1777,31,31744,215,215,31959
test,1778,20,20480,136,136,20616
test,1779,24,24576,168,168,24744
test,1780,27,27648,189,189,27837
test,1781,15,15360,93,93,15453
test,1782,18,18432,120,120,18552
test,1783,8,8192,44,44,8236
test,1784,15,15360,93,93,15453
test,1785,15,15360,93,93,15453
test,1786,19,19456,121,121,19577
test,1787,31,31744,237,237,31981
test,1788,22,22528,142,142,22670
test,1789,33,33792,231,231,34023
test,1790,36,36864,240,240,37104
test,1791,35,35840,243,243,36083
test,1792,15,15360,93,93,15453
test,1793,33,33792,219,219,34011
test,1794,8,8192,44,44,8236
test,1795,33,33792,263,263,34055
test,1796,32,32768,232,232,33000
test,1797,34,34816,232,232,35048
test,1798,25,25600,169,169,25769
test,1799,13,13312,79,79,13391
test,1800,9,9216,51,51,9267
test,1801,18,18432,114,114,18546
test,1802,7,7168,39,39,7207
test,1803,29,29696,203,203,29899
test,1804,23,23552,191,191,23743
test,1805,13,13312,83,83,13395
test,1806,29,29696,199,199,29895
test,1807,24,24576,172,172,24748
test,1808,6,6144,30,30,6174
test,1809,8,8192,44,44,8236
test,1810,19,19456,121,121,19577
test,1811,32,32768,220,220,32988
test,1812,36,36864,252,252,37116
test,1813,26,26624,186,186,26810
test,1814,14,14336,86,86,14422
test,1815,31,31744,217,217,31961
test,1816,36,36864,258,258,37122
test,1817,17,17408,119,119,17527
test,1818,31,31744,205,205,31949
test,1819,4,4096,16,16,4112
test,1820,27,27648,183,183,27831
