split,index,nodes,total_values_for_nodes,edges,total_values_for_edges,total_values_for_graph
train,0,550,563200,10824,2078208,2641408
train,1,596,610304,11208,2151936,2762240
train,2,493,504832,9427,1809984,2314816
train,3,510,522240,8508,1633536,2155776
train,4,610,624640,11686,2243712,2868352
train,5,371,379904,5339,1025088,1404992
train,6,477,488448,8468,1625856,2114304
train,7,544,557056,9074,1742208,2299264
train,8,579,592896,10119,1942848,2535744
train,9,448,458752,7785,1494720,1953472
train,10,663,678912,12666,2431872,3110784
train,11,460,471040,7354,1411968,1883008
train,12,452,462848,7680,1474560,1937408
train,13,584,598016,10499,2015808,2613824
train,14,581,594944,11658,2238336,2833280
train,15,444,454656,7110,1365120,1819776
train,16,433,443392,7168,1376256,1819648
train,17,706,722944,14481,2780352,3503296
train,18,520,532480,9069,1741248,2273728
train,19,439,449536,7475,1435200,1884736
train,20,496,507904,9218,1769856,2277760
train,21,474,485376,8714,1673088,2158464
train,22,517,529408,9513,1826496,2355904
train,23,547,560128,10374,1991808,2551936
train,24,529,541696,9470,1818240,2359936
train,25,503,515072,9813,1884096,2399168
train,26,480,491520,8936,1715712,2207232
train,27,603,617472,11838,2272896,2890368
train,28,532,544768,8694,1669248,2214016
train,29,583,596992,11517,2211264,2808256
train,30,491,502784,9351,1795392,2298176
train,31,414,423936,6307,1210944,1634880
train,32,550,563200,10429,2002368,2565568
train,33,483,494592,7772,1492224,1986816
train,34,763,781312,13947,2677824,3459136
train,35,551,564224,10119,1942848,2507072
train,36,422,432128,6907,1326144,1758272
train,37,549,562176,9549,1833408,2395584
train,38,484,495616,7713,1480896,1976512
train,39,578,591872,10254,1968768,2560640
train,40,542,555008,10496,2015232,2570240
train,41,580,593920,10859,2084928,2678848
train,42,388,397312,5839,1121088,1518400
train,43,527,539648,9714,1865088,2404736
train,44,513,525312,8700,1670400,2195712
train,45,493,504832,8397,1612224,2117056
train,46,827,846848,15090,2897280,3744128
train,47,566,579584,9878,1896576,2476160
train,48,468,479232,8495,1631040,2110272
train,49,566,579584,10035,1926720,2506304
train,50,560,573440,10112,1941504,2514944
train,51,468,479232,7883,1513536,1992768
train,52,559,572416,10022,1924224,2496640
train,53,494,505856,8891,1707072,2212928
train,54,447,457728,6666,1279872,1737600
train,55,616,630784,11410,2190720,2821504
train,56,513,525312,8614,1653888,2179200
train,57,636,651264,12268,2355456,3006720
train,58,515,527360,9103,1747776,2275136
train,59,523,535552,8705,1671360,2206912
train,60,454,464896,7995,1535040,1999936
train,61,550,563200,10255,1968960,2532160
train,62,507,519168,8833,1695936,2215104
train,63,601,615424,13366,2566272,3181696
train,64,565,578560,9868,1894656,2473216
train,65,563,576512,9624,1847808,2424320
train,66,525,537600,10529,2021568,2559168
train,67,692,708608,14314,2748288,3456896
train,68,512,524288,9011,1730112,2254400
train,69,480,491520,8576,1646592,2138112
train,70,429,439296,7138,1370496,1809792
train,71,485,496640,8424,1617408,2114048
train,72,566,579584,10788,2071296,2650880
train,73,545,558080,9987,1917504,2475584
train,74,424,434176,6897,1324224,1758400
train,75,437,447488,7064,1356288,1803776
train,76,534,546816,9962,1912704,2459520
train,77,542,555008,9220,1770240,2325248
train,78,495,506880,9155,1757760,2264640
train,79,474,485376,8714,1673088,2158464
train,80,650,665600,12839,2465088,3130688
train,81,486,497664,7662,1471104,1968768
train,82,449,459776,7819,1501248,1961024
train,83,621,635904,12406,2381952,3017856
train,84,610,624640,12259,2353728,2978368
train,85,514,526336,9066,1740672,2267008
train,86,546,559104,9613,1845696,2404800
train,87,488,499712,9237,1773504,2273216
train,88,526,538624,9882,1897344,2435968
train,89,521,533504,9062,1739904,2273408
train,90,610,624640,13319,2557248,3181888
train,91,477,488448,8825,1694400,2182848
train,92,548,561152,11284,2166528,2727680
train,93,490,501760,8776,1684992,2186752
train,94,404,413696,6331,1215552,1629248
train,95,471,482304,8332,1599744,2082048
train,96,474,485376,7496,1439232,1924608
train,97,554,567296,9741,1870272,2437568
train,98,421,431104,6825,1310400,1741504
train,99,515,527360,8360,1605120,2132480
train,100,484,495616,8372,1607424,2103040
train,101,453,463872,7904,1517568,1981440
train,102,673,689152,13312,2555904,3245056
train,103,575,588800,12365,2374080,2962880
train,104,521,533504,9359,1796928,2330432
train,105,610,624640,11470,2202240,2826880
train,106,461,472064,7854,1507968,1980032
train,107,550,563200,9926,1905792,2468992
train,108,513,525312,9599,1843008,2368320
train,109,650,665600,12811,2459712,3125312
train,110,671,687104,13602,2611584,3298688
train,111,433,443392,7272,1396224,1839616
train,112,571,584704,10854,2083968,2668672
train,113,639,654336,12037,2311104,2965440
train,114,494,505856,9465,1817280,2323136
train,115,524,536576,8702,1670784,2207360
train,116,454,464896,7576,1454592,1919488
train,117,569,582656,10541,2023872,2606528
train,118,516,528384,8749,1679808,2208192
train,119,555,568320,9365,1798080,2366400
train,120,497,508928,8742,1678464,2187392
train,121,535,547840,9315,1788480,2336320
train,122,564,577536,10799,2073408,2650944
train,123,467,478208,7563,1452096,1930304
train,124,492,503808,7890,1514880,2018688
train,125,595,609280,11586,2224512,2833792
train,126,460,471040,8071,1549632,2020672
train,127,515,527360,8871,1703232,2230592
train,128,554,567296,10261,1970112,2537408
train,129,412,421888,6322,1213824,1635712
train,130,577,590848,9764,1874688,2465536
train,131,584,598016,10578,2030976,2628992
train,132,478,489472,8862,1701504,2190976
train,133,473,484352,8133,1561536,2045888
train,134,532,544768,9255,1776960,2321728
train,135,607,621568,11298,2169216,2790784
train,136,574,587776,10864,2085888,2673664
train,137,602,616448,10958,2103936,2720384
train,138,725,742400,14885,2857920,3600320
train,139,518,530432,9277,1781184,2311616
train,140,576,589824,10932,2098944,2688768
train,141,602,616448,12273,2356416,2972864
train,142,427,437248,7072,1357824,1795072
train,143,577,590848,10579,2031168,2622016
train,144,441,451584,6277,1205184,1656768
train,145,502,514048,8740,1678080,2192128
train,146,507,519168,8653,1661376,2180544
train,147,619,633856,12698,2438016,3071872
train,148,532,544768,9055,1738560,2283328
train,149,491,502784,9351,1795392,2298176
train,150,833,852992,17341,3329472,4182464
train,151,595,609280,10927,2097984,2707264
train,152,546,559104,9776,1876992,2436096
train,153,709,726016,14387,2762304,3488320
train,154,528,540672,10779,2069568,2610240
train,155,472,483328,8063,1548096,2031424
train,156,740,757760,14661,2814912,3572672
train,157,545,558080,9774,1876608,2434688
train,158,491,502784,8798,1689216,2192000
train,159,644,659456,11914,2287488,2946944
train,160,496,507904,8653,1661376,2169280
train,161,529,541696,9430,1810560,2352256
train,162,481,492544,8739,1677888,2170432
train,163,611,625664,11603,2227776,2853440
train,164,448,458752,7785,1494720,1953472
train,165,532,544768,10877,2088384,2633152
train,166,542,555008,9129,1752768,2307776
train,167,814,833536,17181,3298752,4132288
train,168,510,522240,10088,1936896,2459136
train,169,550,563200,9436,1811712,2374912
train,170,614,628736,11139,2138688,2767424
train,171,604,618496,11504,2208768,2827264
train,172,506,518144,9654,1853568,2371712
train,173,537,549888,9032,1734144,2284032
train,174,555,568320,10003,1920576,2488896
train,175,575,588800,10648,2044416,2633216
train,176,525,537600,9243,1774656,2312256
train,177,485,496640,8093,1553856,2050496
train,178,534,546816,9396,1804032,2350848
train,179,502,514048,9247,1775424,2289472
train,180,433,443392,6999,1343808,1787200
train,181,507,519168,8889,1706688,2225856
train,182,564,577536,10962,2104704,2682240
train,183,462,473088,7738,1485696,1958784
train,184,453,463872,7959,1528128,1992000
train,185,627,642048,11860,2277120,2919168
train,186,572,585728,12377,2376384,2962112
train,187,520,532480,8351,1603392,2135872
train,188,655,670720,12888,2474496,3145216
train,189,526,538624,8938,1716096,2254720
train,190,398,407552,6144,1179648,1587200
train,191,470,481280,7856,1508352,1989632
train,192,585,599040,12668,2432256,3031296
train,193,454,464896,7652,1469184,1934080
train,194,475,486400,7412,1423104,1909504
train,195,435,445440,7063,1356096,1801536
train,196,577,590848,10415,1999680,2590528
train,197,505,517120,8108,1556736,2073856
train,198,558,571392,10209,1960128,2531520
train,199,461,472064,8019,1539648,2011712
train,200,462,473088,7467,1433664,1906752
train,201,625,640000,11948,2294016,2934016
train,202,467,478208,7819,1501248,1979456
train,203,525,537600,9592,1841664,2379264
train,204,568,581632,9936,1907712,2489344
train,205,530,542720,8611,1653312,2196032
train,206,490,501760,8378,1608576,2110336
train,207,584,598016,10421,2000832,2598848
train,208,531,543744,10737,2061504,2605248
train,209,499,510976,8440,1620480,2131456
train,210,563,576512,10905,2093760,2670272
train,211,664,679936,13188,2532096,3212032
train,212,492,503808,8635,1657920,2161728
train,213,527,539648,9788,1879296,2418944
train,214,566,579584,11151,2140992,2720576
train,215,451,461824,7653,1469376,1931200
train,216,466,477184,8142,1563264,2040448
train,217,514,526336,8959,1720128,2246464
train,218,457,467968,7606,1460352,1928320
train,219,579,592896,10657,2046144,2639040
train,220,532,544768,10143,1947456,2492224
train,221,541,553984,10166,1951872,2505856
train,222,483,494592,7928,1522176,2016768
train,223,488,499712,8032,1542144,2041856
train,224,620,634880,11543,2216256,2851136
train,225,513,525312,9927,1905984,2431296
train,226,498,509952,8953,1718976,2228928
train,227,497,508928,8842,1697664,2206592
train,228,511,523264,9112,1749504,2272768
train,229,450,460800,6615,1270080,1730880
train,230,546,559104,9694,1861248,2420352
train,231,522,534528,8759,1681728,2216256
train,232,451,461824,7650,1468800,1930624
train,233,662,677888,12741,2446272,3124160
train,234,516,528384,9058,1739136,2267520
train,235,487,498688,8252,1584384,2083072
train,236,541,553984,10813,2076096,2630080
train,237,483,494592,8022,1540224,2034816
train,238,537,549888,9126,1752192,2302080
train,239,528,540672,9193,1765056,2305728
train,240,495,506880,9009,1729728,2236608
train,241,588,602112,11395,2187840,2789952
train,242,454,464896,7995,1535040,1999936
train,243,742,759808,15435,2963520,3723328
train,244,526,538624,9738,1869696,2408320
train,245,581,594944,10558,2027136,2622080
train,246,679,695296,14197,2725824,3421120
train,247,732,749568,15602,2995584,3745152
train,248,586,600064,12544,2408448,3008512
train,249,451,461824,6896,1324032,1785856
train,250,471,482304,8547,1641024,2123328
train,251,512,524288,9247,1775424,2299712
train,252,623,637952,13462,2584704,3222656
train,253,408,417792,5867,1126464,1544256
train,254,559,572416,10292,1976064,2548480
train,255,488,499712,8576,1646592,2146304
train,256,567,580608,9858,1892736,2473344
train,257,463,474112,7893,1515456,1989568
train,258,519,531456,9009,1729728,2261184
train,259,367,375808,5224,1003008,1378816
train,260,513,525312,9076,1742592,2267904
train,261,564,577536,9550,1833600,2411136
train,262,397,406528,6089,1169088,1575616
train,263,613,627712,11743,2254656,2882368
train,264,529,541696,8371,1607232,2148928
train,265,536,548864,9739,1869888,2418752
train,266,540,552960,9997,1919424,2472384
train,267,542,555008,9733,1868736,2423744
train,268,505,517120,9612,1845504,2362624
train,269,657,672768,13009,2497728,3170496
train,270,607,621568,11652,2237184,2858752
train,271,402,411648,5838,1120896,1532544
train,272,569,582656,10507,2017344,2600000
train,273,472,483328,7984,1532928,2016256
train,274,499,510976,8717,1673664,2184640
train,275,533,545792,10853,2083776,2629568
train,276,494,505856,8937,1715904,2221760
train,277,487,498688,8696,1669632,2168320
train,278,523,535552,9790,1879680,2415232
train,279,629,644096,11954,2295168,2939264
train,280,516,528384,9091,1745472,2273856
train,281,500,512000,8491,1630272,2142272
train,282,497,508928,9308,1787136,2296064
train,283,422,432128,6520,1251840,1683968
train,284,540,552960,9147,1756224,2309184
train,285,427,437248,6635,1273920,1711168
train,286,468,479232,7681,1474752,1953984
train,287,483,494592,8991,1726272,2220864
train,288,506,518144,9740,1870080,2388224
train,289,519,531456,10076,1934592,2466048
train,290,491,502784,8674,1665408,2168192
train,291,490,501760,8448,1622016,2123776
train,292,524,536576,10650,2044800,2581376
train,293,459,470016,7694,1477248,1947264
train,294,721,738304,15635,3001920,3740224
train,295,499,510976,7864,1509888,2020864
train,296,465,476160,7770,1491840,1968000
train,297,521,533504,9848,1890816,2424320
train,298,414,423936,6648,1276416,1700352
train,299,440,450560,7509,1441728,1892288
train,300,531,543744,10678,2050176,2593920
train,301,543,556032,9925,1905600,2461632
train,302,514,526336,9146,1756032,2282368
train,303,441,451584,6599,1267008,1718592
train,304,495,506880,8305,1594560,2101440
train,305,507,519168,8164,1567488,2086656
train,306,500,512000,8882,1705344,2217344
train,307,587,601088,10756,2065152,2666240
train,308,461,472064,7375,1416000,1888064
train,309,566,579584,10030,1925760,2505344
train,310,437,447488,7407,1422144,1869632
train,311,467,478208,7370,1415040,1893248
train,312,451,461824,7889,1514688,1976512
train,313,498,509952,8931,1714752,2224704
train,314,606,620544,11810,2267520,2888064
train,315,480,491520,8083,1551936,2043456
train,316,516,528384,9536,1830912,2359296
train,317,611,625664,11840,2273280,2898944
train,318,512,524288,9193,1765056,2289344
train,319,528,540672,9486,1821312,2361984
train,320,560,573440,10463,2008896,2582336
train,321,397,406528,6113,1173696,1580224
train,322,525,537600,8571,1645632,2183232
train,323,466,477184,8231,1580352,2057536
train,324,537,549888,9300,1785600,2335488
train,325,509,521216,8707,1671744,2192960
train,326,586,600064,10799,2073408,2673472
train,327,493,504832,8394,1611648,2116480
train,328,538,550912,9551,1833792,2384704
train,329,492,503808,8978,1723776,2227584
train,330,629,644096,12282,2358144,3002240
train,331,680,696320,13286,2550912,3247232
train,332,621,635904,11398,2188416,2824320
train,333,643,658432,12391,2379072,3037504
train,334,576,589824,10585,2032320,2622144
train,335,554,567296,9568,1837056,2404352
train,336,500,512000,9483,1820736,2332736
train,337,520,532480,9707,1863744,2396224
train,338,522,534528,9136,1754112,2288640
train,339,561,574464,10241,1966272,2540736
train,340,661,676864,13279,2549568,3226432
train,341,478,489472,8002,1536384,2025856
train,342,484,495616,8826,1694592,2190208
train,343,521,533504,9622,1847424,2380928
train,344,522,534528,9307,1786944,2321472
train,345,625,640000,11450,2198400,2838400
train,346,422,432128,6881,1321152,1753280
train,347,576,589824,12326,2366592,2956416
train,348,625,640000,11988,2301696,2941696
train,349,454,464896,7443,1429056,1893952
train,350,537,549888,9137,1754304,2304192
train,351,494,505856,9199,1766208,2272064
train,352,858,878592,17810,3419520,4298112
train,353,483,494592,7899,1516608,2011200
train,354,425,435200,7006,1345152,1780352
train,355,674,690176,13855,2660160,3350336
train,356,535,547840,9572,1837824,2385664
train,357,412,421888,6584,1264128,1686016
train,358,534,546816,9314,1788288,2335104
train,359,559,572416,9951,1910592,2483008
train,360,530,542720,8682,1666944,2209664
train,361,484,495616,8635,1657920,2153536
train,362,531,543744,9177,1761984,2305728
train,363,638,653312,12754,2448768,3102080
train,364,738,755712,15422,2961024,3716736
train,365,556,569344,9628,1848576,2417920
train,366,411,420864,6385,1225920,1646784
train,367,548,561152,10662,2047104,2608256
train,368,462,473088,7654,1469568,1942656
train,369,458,468992,8053,1546176,2015168
train,370,794,813056,17572,3373824,4186880
train,371,495,506880,9504,1824768,2331648
train,372,660,675840,12974,2491008,3166848
train,373,471,482304,8043,1544256,2026560
train,374,529,541696,10334,1984128,2525824
train,375,432,442368,6392,1227264,1669632
train,376,465,476160,8387,1610304,2086464
train,377,620,634880,12078,2318976,2953856
train,378,561,574464,9913,1903296,2477760
train,379,559,572416,9873,1895616,2468032
train,380,581,594944,10029,1925568,2520512
train,381,473,484352,8592,1649664,2134016
train,382,629,644096,11662,2239104,2883200
train,383,540,552960,10536,2022912,2575872
train,384,519,531456,9839,1889088,2420544
train,385,655,670720,13110,2517120,3187840
train,386,590,604160,12068,2317056,2921216
train,387,590,604160,10582,2031744,2635904
train,388,515,527360,9173,1761216,2288576
train,389,573,586752,10332,1983744,2570496
train,390,546,559104,11189,2148288,2707392
train,391,447,457728,7695,1477440,1935168
train,392,502,514048,9331,1791552,2305600
train,393,605,619520,12430,2386560,3006080
train,394,576,589824,11558,2219136,2808960
train,395,405,414720,6337,1216704,1631424
train,396,497,508928,9311,1787712,2296640
train,397,533,545792,10578,2030976,2576768
train,398,451,461824,7372,1415424,1877248
train,399,627,642048,12161,2334912,2976960
train,400,483,494592,7787,1495104,1989696
train,401,558,571392,10699,2054208,2625600
train,402,488,499712,9237,1773504,2273216
train,403,476,487424,7546,1448832,1936256
train,404,367,375808,5224,1003008,1378816
train,405,407,416768,6425,1233600,1650368
train,406,452,462848,7349,1411008,1873856
train,407,563,576512,10849,2083008,2659520
train,408,470,481280,8236,1581312,2062592
train,409,526,538624,9353,1795776,2334400
train,410,540,552960,9800,1881600,2434560
train,411,590,604160,10793,2072256,2676416
train,412,581,594944,10549,2025408,2620352
train,413,499,510976,9353,1795776,2306752
train,414,558,571392,9694,1861248,2432640
train,415,521,533504,9651,1852992,2386496
train,416,530,542720,9628,1848576,2391296
train,417,559,572416,10356,1988352,2560768
train,418,559,572416,9657,1854144,2426560
train,419,500,512000,8352,1603584,2115584
train,420,796,815104,15583,2991936,3807040
train,421,444,454656,7538,1447296,1901952
train,422,425,435200,7006,1345152,1780352
train,423,649,664576,12877,2472384,3136960
train,424,506,518144,9168,1760256,2278400
train,425,500,512000,8390,1610880,2122880
train,426,423,433152,6361,1221312,1654464
train,427,545,558080,9343,1793856,2351936
train,428,489,500736,8157,1566144,2066880
train,429,516,528384,10163,1951296,2479680
train,430,447,457728,7165,1375680,1833408
train,431,569,582656,9975,1915200,2497856
train,432,477,488448,8590,1649280,2137728
train,433,522,534528,10006,1921152,2455680
train,434,516,528384,8682,1666944,2195328
train,435,524,536576,9576,1838592,2375168
train,436,512,524288,8786,1686912,2211200
train,437,574,587776,11608,2228736,2816512
train,438,566,579584,9678,1858176,2437760
train,439,546,559104,10799,2073408,2632512
train,440,522,534528,8739,1677888,2212416
train,441,549,562176,11009,2113728,2675904
train,442,471,482304,7577,1454784,1937088
train,443,558,571392,10038,1927296,2498688
train,444,507,519168,8816,1692672,2211840
train,445,443,453632,7530,1445760,1899392
train,446,542,555008,9051,1737792,2292800
train,447,505,517120,9769,1875648,2392768
train,448,553,566272,10742,2062464,2628736
train,449,575,588800,11147,2140224,2729024
train,450,544,557056,9794,1880448,2437504
train,451,683,699392,13381,2569152,3268544
train,452,523,535552,9308,1787136,2322688
train,453,534,546816,9191,1764672,2311488
train,454,556,569344,10917,2096064,2665408
train,455,516,528384,8763,1682496,2210880
train,456,492,503808,8759,1681728,2185536
train,457,460,471040,7505,1440960,1912000
train,458,432,442368,7239,1389888,1832256
train,459,478,489472,7715,1481280,1970752
train,460,559,572416,10082,1935744,2508160
train,461,572,585728,10010,1921920,2507648
train,462,518,530432,8470,1626240,2156672
train,463,468,479232,8117,1558464,2037696
train,464,516,528384,8987,1725504,2253888
train,465,503,515072,8782,1686144,2201216
train,466,556,569344,10018,1923456,2492800
train,467,460,471040,7703,1478976,1950016
train,468,516,528384,9452,1814784,2343168
train,469,453,463872,7150,1372800,1836672
train,470,498,509952,8875,1704000,2213952
train,471,499,510976,8994,1726848,2237824
train,472,515,527360,8674,1665408,2192768
train,473,450,460800,7854,1507968,1968768
train,474,455,465920,7169,1376448,1842368
train,475,465,476160,8387,1610304,2086464
train,476,589,603136,11823,2270016,2873152
train,477,591,605184,11788,2263296,2868480
train,478,510,522240,9241,1774272,2296512
train,479,565,578560,10199,1958208,2536768
train,480,540,552960,9306,1786752,2339712
train,481,560,573440,10106,1940352,2513792
train,482,513,525312,7895,1515840,2041152
train,483,639,654336,12683,2435136,3089472
train,484,430,440320,7172,1377024,1817344
train,485,584,598016,10513,2018496,2616512
train,486,498,509952,9177,1761984,2271936
train,487,539,551936,10432,2002944,2554880
train,488,513,525312,8953,1718976,2244288
train,489,429,439296,7138,1370496,1809792
train,490,452,462848,6914,1327488,1790336
train,491,397,406528,6113,1173696,1580224
train,492,645,660480,12400,2380800,3041280
train,493,511,523264,8546,1640832,2164096
train,494,523,535552,8957,1719744,2255296
train,495,566,579584,10308,1979136,2558720
train,496,615,629760,11856,2276352,2906112
train,497,422,432128,6668,1280256,1712384
train,498,531,543744,10804,2074368,2618112
train,499,647,662528,13188,2532096,3194624
validation,0,606,620544,11364,2181888,2802432
validation,1,443,453632,7436,1427712,1881344
validation,2,448,458752,7785,1494720,1953472
validation,3,517,529408,8697,1669824,2199232
validation,4,462,473088,7895,1515840,1988928
validation,5,473,484352,7451,1430592,1914944
validation,6,456,466944,6652,1277184,1744128
validation,7,598,612352,11876,2280192,2892544
validation,8,472,483328,8266,1587072,2070400
validation,9,472,483328,8212,1576704,2060032
validation,10,487,498688,7935,1523520,2022208
validation,11,587,601088,11378,2184576,2785664
validation,12,460,471040,7984,1532928,2003968
validation,13,466,477184,8423,1617216,2094400
validation,14,367,375808,4378,840576,1216384
validation,15,525,537600,8878,1704576,2242176
validation,16,519,531456,8647,1660224,2191680
validation,17,454,464896,7995,1535040,1999936
validation,18,448,458752,7785,1494720,1953472
validation,19,509,521216,8825,1694400,2215616
validation,20,486,497664,8188,1572096,2069760
validation,21,515,527360,9770,1875840,2403200
validation,22,436,446464,6906,1325952,1772416
validation,23,500,512000,8051,1545792,2057792
validation,24,496,507904,9037,1735104,2243008
validation,25,482,493568,7867,1510464,2004032
validation,26,610,624640,11663,2239296,2863936
validation,27,614,628736,11982,2300544,2929280
validation,28,643,658432,12525,2404800,3063232
validation,29,518,530432,8732,1676544,2206976
validation,30,508,520192,8377,1608384,2128576
validation,31,572,585728,11022,2116224,2701952
validation,32,510,522240,9720,1866240,2388480
validation,33,513,525312,9349,1795008,2320320
validation,34,507,519168,9970,1914240,2433408
validation,35,573,586752,10165,1951680,2538432
validation,36,446,456704,7715,1481280,1937984
validation,37,476,487424,7854,1507968,1995392
validation,38,510,522240,10088,1936896,2459136
validation,39,685,701440,14624,2807808,3509248
validation,40,542,555008,9680,1858560,2413568
validation,41,568,581632,10019,1923648,2505280
validation,42,465,476160,7971,1530432,2006592
validation,43,471,482304,7862,1509504,1991808
validation,44,497,508928,9581,1839552,2348480
validation,45,475,486400,8751,1680192,2166592
validation,46,466,477184,7263,1394496,1871680
validation,47,519,531456,8927,1713984,2245440
validation,48,425,435200,7006,1345152,1780352
validation,49,508,520192,10009,1921728,2441920
validation,50,625,640000,11902,2285184,2925184
validation,51,588,602112,11321,2173632,2775744
validation,52,648,663552,12562,2411904,3075456
validation,53,398,407552,5983,1148736,1556288
validation,54,478,489472,8522,1636224,2125696
validation,55,530,542720,9650,1852800,2395520
validation,56,450,460800,7230,1388160,1848960
validation,57,520,532480,9769,1875648,2408128
validation,58,579,592896,12447,2389824,2982720
validation,59,500,512000,7980,1532160,2044160
validation,60,529,541696,9639,1850688,2392384
validation,61,481,492544,8913,1711296,2203840
validation,62,615,629760,11291,2167872,2797632
validation,63,526,538624,9348,1794816,2333440
validation,64,622,636928,12309,2363328,3000256
validation,65,566,579584,10284,1974528,2554112
validation,66,545,558080,9714,1865088,2423168
validation,67,477,488448,7785,1494720,1983168
validation,68,603,617472,11134,2137728,2755200
validation,69,549,562176,10343,1985856,2548032
validation,70,647,662528,13178,2530176,3192704
validation,71,405,414720,6362,1221504,1636224
validation,72,432,442368,7239,1389888,1832256
validation,73,518,530432,8637,1658304,2188736
validation,74,497,508928,9581,1839552,2348480
validation,75,619,633856,11595,2226240,2860096
validation,76,550,563200,9507,1825344,2388544
validation,77,474,485376,8308,1595136,2080512
validation,78,566,579584,11131,2137152,2716736
validation,79,501,513024,8664,1663488,2176512
validation,80,505,517120,9514,1826688,2343808
validation,81,507,519168,8539,1639488,2158656
validation,82,554,567296,9984,1916928,2484224
validation,83,555,568320,11775,2260800,2829120
validation,84,505,517120,9891,1899072,2416192
validation,85,521,533504,10093,1937856,2471360
validation,86,571,584704,9985,1917120,2501824
validation,87,546,559104,10911,2094912,2654016
validation,88,482,493568,9011,1730112,2223680
validation,89,473,484352,7507,1441344,1925696
validation,90,634,649216,12739,2445888,3095104
validation,91,511,523264,8501,1632192,2155456
validation,92,503,515072,8846,1698432,2213504
validation,93,495,506880,9045,1736640,2243520
validation,94,649,664576,12935,2483520,3148096
validation,95,512,524288,9739,1869888,2394176
validation,96,555,568320,9784,1878528,2446848
validation,97,420,430080,6718,1289856,1719936
validation,98,485,496640,8137,1562304,2058944
validation,99,485,496640,9033,1734336,2230976
validation,100,582,595968,11077,2126784,2722752
validation,101,467,478208,7191,1380672,1858880
validation,102,483,494592,8737,1677504,2172096
validation,103,519,531456,10447,2005824,2537280
validation,104,499,510976,8337,1600704,2111680
validation,105,451,461824,7262,1394304,1856128
validation,106,506,518144,9931,1906752,2424896
validation,107,577,590848,10731,2060352,2651200
validation,108,539,551936,9833,1887936,2439872
validation,109,402,411648,6221,1194432,1606080
validation,110,430,440320,7172,1377024,1817344
validation,111,450,460800,7854,1507968,1968768
validation,112,529,541696,8984,1724928,2266624
validation,113,463,474112,8315,1596480,2070592
validation,114,598,612352,11492,2206464,2818816
validation,115,551,564224,9993,1918656,2482880
validation,116,509,521216,9234,1772928,2294144
validation,117,515,527360,8609,1652928,2180288
validation,118,370,378880,5310,1019520,1398400
validation,119,544,557056,10022,1924224,2481280
validation,120,499,510976,9475,1819200,2330176
validation,121,593,607232,10913,2095296,2702528
validation,122,469,480256,7460,1432320,1912576
validation,123,422,432128,6198,1190016,1622144
validation,124,565,578560,10237,1965504,2544064
validation,125,494,505856,9034,1734528,2240384
validation,126,641,656384,12717,2441664,3098048
validation,127,535,547840,8759,1681728,2229568
validation,128,472,483328,8527,1637184,2120512
validation,129,522,534528,9086,1744512,2279040
validation,130,451,461824,7889,1514688,1976512
validation,131,563,576512,10667,2048064,2624576
validation,132,469,480256,8130,1560960,2041216
validation,133,551,564224,9765,1874880,2439104
validation,134,492,503808,9004,1728768,2232576
validation,135,602,616448,10970,2106240,2722688
validation,136,508,520192,9759,1873728,2393920
validation,137,464,475136,8129,1560768,2035904
validation,138,588,602112,11217,2153664,2755776
validation,139,605,619520,11603,2227776,2847296
validation,140,570,583680,10532,2022144,2605824
validation,141,424,434176,6365,1222080,1656256
validation,142,559,572416,10088,1936896,2509312
validation,143,417,427008,6745,1295040,1722048
validation,144,568,581632,10031,1925952,2507584
validation,145,429,439296,6515,1250880,1690176
validation,146,609,623616,12000,2304000,2927616
validation,147,552,565248,11059,2123328,2688576
validation,148,501,513024,9164,1759488,2272512
validation,149,482,493568,8661,1662912,2156480
validation,150,492,503808,8927,1713984,2217792
validation,151,481,492544,8974,1723008,2215552
validation,152,541,553984,8710,1672320,2226304
validation,153,536,548864,9440,1812480,2361344
validation,154,531,543744,9306,1786752,2330496
validation,155,413,422912,6616,1270272,1693184
validation,156,448,458752,7068,1357056,1815808
validation,157,552,565248,9625,1848000,2413248
validation,158,601,615424,12863,2469696,3085120
validation,159,397,406528,6113,1173696,1580224
validation,160,466,477184,8366,1606272,2083456
validation,161,478,489472,8689,1668288,2157760
validation,162,527,539648,10195,1957440,2497088
validation,163,492,503808,8768,1683456,2187264
validation,164,533,545792,9917,1904064,2449856
test,0,531,543744,9236,1773312,2317056
test,1,525,537600,9813,1884096,2421696
test,2,628,643072,12449,2390208,3033280
test,3,419,429056,6546,1256832,1685888
test,4,563,576512,10489,2013888,2590400
test,5,570,583680,10254,1968768,2552448
test,6,460,471040,7305,1402560,1873600
test,7,504,516096,9821,1885632,2401728
test,8,553,566272,10300,1977600,2543872
test,9,463,474112,7846,1506432,1980544
test,10,513,525312,8136,1562112,2087424
test,11,577,590848,11590,2225280,2816128
test,12,627,642048,12161,2334912,2976960
test,13,468,479232,7058,1355136,1834368
test,14,527,539648,9144,1755648,2295296
test,15,602,616448,10817,2076864,2693312
test,16,553,566272,11143,2139456,2705728
test,17,504,516096,8333,1599936,2116032
test,18,529,541696,9778,1877376,2419072
test,19,548,561152,11613,2229696,2790848
test,20,519,531456,8186,1571712,2103168
test,21,461,472064,8243,1582656,2054720
test,22,608,622592,11466,2201472,2824064
test,23,578,591872,11411,2190912,2782784
test,24,535,547840,9147,1756224,2304064
test,25,575,588800,12539,2407488,2996288
test,26,551,564224,9948,1910016,2474240
test,27,662,677888,13141,2523072,3200960
test,28,493,504832,8531,1637952,2142784
test,29,517,529408,8673,1665216,2194624
test,30,463,474112,7901,1516992,1991104
test,31,538,550912,9269,1779648,2330560
test,32,1226,1255424,30664,5887488,7142912
test,33,482,493568,9011,1730112,2223680
test,34,383,392192,5312,1019904,1412096
test,35,451,461824,7397,1420224,1882048
test,36,567,580608,10647,2044224,2624832
test,37,500,512000,8975,1723200,2235200
test,38,488,499712,9237,1773504,2273216
test,39,436,446464,7373,1415616,1862080
test,40,421,431104,6875,1320000,1751104
test,41,534,546816,10460,2008320,2555136
test,42,521,533504,9649,1852608,2386112
test,43,633,648192,11588,2224896,2873088
test,44,515,527360,9570,1837440,2364800
test,45,517,529408,8814,1692288,2221696
test,46,611,625664,11468,2201856,2827520
test,47,367,375808,5181,994752,1370560
test,48,583,596992,10640,2042880,2639872
test,49,484,495616,8353,1603776,2099392
test,50,435,445440,7313,1404096,1849536
test,51,485,496640,8948,1718016,2214656
test,52,522,534528,9974,1915008,2449536
test,53,572,585728,10942,2100864,2686592
test,54,432,442368,7186,1379712,1822080
test,55,574,587776,9339,1793088,2380864
test,56,519,531456,9087,1744704,2276160
test,57,578,591872,10401,1996992,2588864
test,58,548,561152,9871,1895232,2456384
test,59,514,526336,8941,1716672,2243008
test,60,519,531456,8784,1686528,2217984
test,61,661,676864,12964,2489088,3165952
test,62,608,622592,11538,2215296,2837888
test,63,585,599040,11159,2142528,2741568
test,64,587,601088,10643,2043456,2644544
test,65,514,526336,8847,1698624,2224960
test,66,525,537600,10690,2052480,2590080
test,67,421,431104,6875,1320000,1751104
test,68,417,427008,5931,1138752,1565760
test,69,528,540672,9114,1749888,2290560
test,70,521,533504,10528,2021376,2554880
test,71,619,633856,11892,2283264,2917120
test,72,491,502784,8886,1706112,2208896
test,73,464,475136,7691,1476672,1951808
test,74,447,457728,7750,1488000,1945728
test,75,695,711680,15074,2894208,3605888
test,76,476,487424,7905,1517760,2005184
test,77,518,530432,8729,1675968,2206400
test,78,465,476160,8330,1599360,2075520
test,79,405,414720,5893,1131456,1546176
test,80,528,540672,8967,1721664,2262336
test,81,522,534528,9023,1732416,2266944
test,82,548,561152,10768,2067456,2628608
test,83,527,539648,9946,1909632,2449280
test,84,493,504832,8498,1631616,2136448
test,85,654,669696,12495,2399040,3068736
test,86,479,490496,8626,1656192,2146688
test,87,483,494592,8697,1669824,2164416
test,88,623,637952,12793,2456256,3094208
test,89,530,542720,9851,1891392,2434112
test,90,490,501760,8796,1688832,2190592
test,91,500,512000,8498,1631616,2143616
test,92,473,484352,8678,1666176,2150528
test,93,580,593920,10584,2032128,2626048
test,94,467,478208,8459,1624128,2102336
test,95,643,658432,11683,2243136,2901568
test,96,592,606208,10462,2008704,2614912
test,97,418,428032,6777,1301184,1729216
test,98,426,436224,6124,1175808,1612032
test,99,646,661504,12817,2460864,3122368
test,100,521,533504,9427,1809984,2343488
test,101,525,537600,10203,1958976,2496576
test,102,477,488448,8568,1645056,2133504
test,103,593,607232,11164,2143488,2750720
test,104,428,438272,7105,1364160,1802432
test,105,503,515072,8358,1604736,2119808
test,106,520,532480,10106,1940352,2472832
test,107,424,434176,6434,1235328,1669504
test,108,624,638976,11668,2240256,2879232
test,109,427,437248,7072,1357824,1795072
test,110,539,551936,11099,2131008,2682944
test,111,485,496640,8238,1581696,2078336
test,112,597,611328,10767,2067264,2678592
test,113,520,532480,8803,1690176,2222656
test,114,481,492544,8974,1723008,2215552
test,115,492,503808,8921,1712832,2216640
test,116,460,471040,8207,1575744,2046784
test,117,390,399360,5900,1132800,1532160
test,118,481,492544,8771,1684032,2176576
test,119,519,531456,8694,1669248,2200704
test,120,502,514048,8690,1668480,2182528
test,121,556,569344,10733,2060736,2630080
test,122,529,541696,9964,1913088,2454784
test,123,433,443392,7272,1396224,1839616
test,124,578,591872,10310,1979520,2571392
test,125,547,560128,9444,1813248,2373376
test,126,487,498688,9199,1766208,2264896
test,127,597,611328,11403,2189376,2800704
test,128,549,562176,9689,1860288,2422464
test,129,598,612352,10854,2083968,2696320
test,130,471,482304,8028,1541376,2023680
test,131,537,549888,10240,1966080,2515968
test,132,478,489472,8129,1560768,2050240
test,133,531,543744,9132,1753344,2297088
test,134,633,648192,12175,2337600,2985792
test,135,484,495616,8172,1569024,2064640
test,136,507,519168,9160,1758720,2277888
test,137,576,589824,10568,2029056,2618880
test,138,520,532480,8679,1666368,2198848
test,139,502,514048,8564,1644288,2158336
test,140,486,497664,7663,1471296,1968960
test,141,421,431104,6749,1295808,1726912
test,142,498,509952,9619,1846848,2356800
test,143,514,526336,10247,1967424,2493760
test,144,401,410624,6141,1179072,1589696
test,145,516,528384,9275,1780800,2309184
test,146,437,447488,7055,1354560,1802048
test,147,591,605184,12732,2444544,3049728
test,148,624,638976,12659,2430528,3069504
test,149,414,423936,6648,1276416,1700352
test,150,506,518144,8985,1725120,2243264
test,151,572,585728,10225,1963200,2548928
test,152,468,479232,8324,1598208,2077440
test,153,530,542720,8612,1653504,2196224
test,154,570,583680,9460,1816320,2400000
test,155,468,479232,7576,1454592,1933824
test,156,580,593920,10077,1934784,2528704
test,157,537,549888,9193,1765056,2314944
test,158,499,510976,9658,1854336,2365312
test,159,623,637952,12578,2414976,3052928
test,160,538,550912,9145,1755840,2306752
test,161,445,455680,7681,1474752,1930432
test,162,548,561152,9662,1855104,2416256
test,163,534,546816,8811,1691712,2238528
test,164,420,430080,6842,1313664,1743744
test,165,496,507904,8814,1692288,2200192
test,166,420,430080,6842,1313664,1743744
test,167,525,537600,8908,1710336,2247936
test,168,520,532480,9259,1777728,2310208
test,169,399,408576,6175,1185600,1594176
test,170,529,541696,9763,1874496,2416192
test,171,585,599040,10723,2058816,2657856
test,172,561,574464,10755,2064960,2639424
test,173,546,559104,9591,1841472,2400576
test,174,588,602112,12354,2371968,2974080
test,175,669,685056,14376,2760192,3445248
test,176,446,456704,7497,1439424,1896128
test,177,431,441344,7205,1383360,1824704
test,178,551,564224,10377,1992384,2556608
test,179,548,561152,9491,1822272,2383424
test,180,524,536576,9790,1879680,2416256
test,181,478,489472,8341,1601472,2090944
test,182,478,489472,7406,1421952,1911424
test,183,535,547840,8666,1663872,2211712
test,184,497,508928,8407,1614144,2123072
test,185,541,553984,11352,2179584,2733568
test,186,658,673792,14078,2702976,3376768
test,187,442,452608,7578,1454976,1907584
test,188,544,557056,10211,1960512,2517568
test,189,505,517120,8913,1711296,2228416
test,190,515,527360,9391,1803072,2330432
test,191,473,484352,7627,1464384,1948736
test,192,525,537600,9825,1886400,2424000
test,193,523,535552,9283,1782336,2317888
test,194,633,648192,12556,2410752,3058944
test,195,518,530432,9630,1848960,2379392
test,196,505,517120,8886,1706112,2223232
test,197,633,648192,12430,2386560,3034752
test,198,557,570368,10382,1993344,2563712
test,199,412,421888,6584,1264128,1686016
test,200,614,628736,11605,2228160,2856896
test,201,497,508928,8134,1561728,2070656
test,202,474,485376,7607,1460544,1945920
test,203,487,498688,8889,1706688,2205376
test,204,480,491520,8936,1715712,2207232
test,205,533,545792,9739,1869888,2415680
test,206,490,501760,7830,1503360,2005120
test,207,534,546816,9522,1828224,2375040
test,208,431,441344,7205,1383360,1824704
test,209,550,563200,10918,2096256,2659456
test,210,564,577536,10510,2017920,2595456
test,211,393,402432,5991,1150272,1552704
test,212,546,559104,9854,1891968,2451072
test,213,563,576512,9837,1888704,2465216
test,214,519,531456,8859,1700928,2232384
test,215,447,457728,7750,1488000,1945728
test,216,573,586752,10420,2000640,2587392
test,217,397,406528,5881,1129152,1535680
test,218,570,583680,10656,2045952,2629632
test,219,515,527360,8526,1636992,2164352
test,220,482,493568,9011,1730112,2223680
test,221,449,459776,7654,1469568,1929344
test,222,280,286720,3041,583872,870592
test,223,520,532480,9914,1903488,2435968
test,224,538,550912,10118,1942656,2493568
test,225,529,541696,10199,1958208,2499904
test,226,451,461824,7509,1441728,1903552
test,227,547,560128,10177,1953984,2514112
test,228,564,577536,10327,1982784,2560320
test,229,517,529408,9852,1891584,2420992
test,230,505,517120,9769,1875648,2392768
test,231,652,667648,13091,2513472,3181120
test,232,394,403456,6021,1156032,1559488
test,233,453,463872,7959,1528128,1992000
test,234,437,447488,7407,1422144,1869632
test,235,455,465920,7562,1451904,1917824
test,236,548,561152,11253,2160576,2721728
test,237,586,600064,10341,1985472,2585536
test,238,612,626688,11643,2235456,2862144
test,239,606,620544,11629,2232768,2853312
test,240,484,495616,7645,1467840,1963456
test,241,543,556032,9487,1821504,2377536
test,242,609,623616,12572,2413824,3037440
test,243,562,575488,10913,2095296,2670784
test,244,442,452608,7578,1454976,1907584
test,245,903,924672,18853,3619776,4544448
test,246,471,482304,8604,1651968,2134272
test,247,606,620544,11218,2153856,2774400
test,248,439,449536,6948,1334016,1783552
test,249,477,488448,8825,1694400,2182848
test,250,595,609280,11034,2118528,2727808
test,251,1062,1087488,26006,4993152,6080640
test,252,486,497664,8165,1567680,2065344
test,253,530,542720,9302,1785984,2328704
test,254,481,492544,7980,1532160,2024704
test,255,583,596992,10644,2043648,2640640
test,256,982,1005568,22493,4318656,5324224
test,257,481,492544,8370,1607040,2099584
test,258,493,504832,8206,1575552,2080384
test,259,613,627712,11353,2179776,2807488
test,260,530,542720,9919,1904448,2447168
test,261,555,568320,10235,1965120,2533440
test,262,439,449536,6729,1291968,1741504
test,263,563,576512,12294,2360448,2936960
test,264,611,625664,10956,2103552,2729216
test,265,447,457728,7381,1417152,1874880
test,266,526,538624,10261,1970112,2508736
test,267,439,449536,7169,1376448,1825984
test,268,593,607232,10772,2068224,2675456
test,269,473,484352,8537,1639104,2123456
test,270,462,473088,7872,1511424,1984512
test,271,522,534528,8599,1651008,2185536
test,272,538,550912,9830,1887360,2438272
test,273,566,579584,10884,2089728,2669312
test,274,495,506880,8496,1631232,2138112
test,275,577,590848,10717,2057664,2648512
test,276,508,520192,9230,1772160,2292352
test,277,483,494592,9048,1737216,2231808
test,278,465,476160,7488,1437696,1913856
test,279,578,591872,12238,2349696,2941568
test,280,574,587776,10992,2110464,2698240
test,281,505,517120,8832,1695744,2212864
test,282,511,523264,9346,1794432,2317696
test,283,472,483328,8526,1636992,2120320
test,284,480,491520,7815,1500480,1992000
test,285,446,456704,7230,1388160,1844864
test,286,623,637952,11744,2254848,2892800
test,287,419,429056,6379,1224768,1653824
test,288,609,623616,11503,2208576,2832192
test,289,469,480256,8532,1638144,2118400
test,290,569,582656,10789,2071488,2654144
test,291,518,530432,9321,1789632,2320064
test,292,512,524288,8917,1712064,2236352
test,293,463,474112,7969,1530048,2004160
test,294,605,619520,11304,2170368,2789888
test,295,619,633856,12158,2334336,2968192
test,296,676,692224,13284,2550528,3242752
test,297,466,477184,8423,1617216,2094400
test,298,442,452608,6605,1268160,1720768
test,299,537,549888,9367,1798464,2348352
test,300,554,567296,11560,2219520,2786816
test,301,484,495616,9086,1744512,2240128
test,302,504,516096,8647,1660224,2176320
test,303,448,458752,7785,1494720,1953472
test,304,664,679936,13188,2532096,3212032
test,305,558,571392,11642,2235264,2806656
test,306,610,624640,10994,2110848,2735488
test,307,582,595968,10779,2069568,2665536
test,308,544,557056,9868,1894656,2451712
test,309,488,499712,8732,1676544,2176256
test,310,451,461824,6913,1327296,1789120
test,311,579,592896,10222,1962624,2555520
test,312,552,565248,9567,1836864,2402112
test,313,566,579584,10443,2005056,2584640
test,314,513,525312,8844,1698048,2223360
test,315,583,596992,11296,2168832,2765824
test,316,745,762880,15569,2989248,3752128
test,317,442,452608,7578,1454976,1907584
test,318,520,532480,9317,1788864,2321344
test,319,583,596992,11055,2122560,2719552
test,320,452,462848,6818,1309056,1771904
test,321,577,590848,10249,1967808,2558656
test,322,504,516096,8234,1580928,2097024
test,323,484,495616,9086,1744512,2240128
test,324,515,527360,9211,1768512,2295872
test,325,415,424960,6680,1282560,1707520
test,326,469,480256,8417,1616064,2096320
test,327,455,465920,8030,1541760,2007680
test,328,601,615424,11231,2156352,2771776
test,329,456,466944,8065,1548480,2015424
test,330,443,453632,7142,1371264,1824896
test,331,565,578560,10369,1990848,2569408
test,332,573,586752,10285,1974720,2561472
test,333,489,500736,8018,1539456,2040192
test,334,540,552960,11042,2120064,2673024
