split,index,nodes,total_values_for_nodes,edges,total_values_for_edges,total_values_for_graph
train,0,186,190464,3824,734208,924672
train,1,183,187392,3702,710784,898176
train,2,190,194560,3990,766080,960640
train,3,146,149504,2356,452352,601856
train,4,90,92160,896,172032,264192
train,5,152,155648,2554,490368,646016
train,6,74,75776,606,116352,192128
train,7,210,215040,4874,935808,1150848
train,8,114,116736,1437,275904,392640
train,9,142,145408,2229,427968,573376
train,10,132,135168,1926,369792,504960
train,11,77,78848,656,125952,204800
train,12,172,176128,3270,627840,803968
train,13,141,144384,2198,422016,566400
train,14,158,161792,2759,529728,691520
train,15,100,102400,1106,212352,314752
train,16,172,176128,3270,627840,803968
train,17,131,134144,1897,364224,498368
train,18,178,182272,3502,672384,854656
train,19,70,71680,542,104064,175744
train,20,118,120832,1539,295488,416320
train,21,93,95232,956,183552,278784
train,22,120,122880,1592,305664,428544
train,23,106,108544,1242,238464,347008
train,24,189,193536,3948,758016,951552
train,25,156,159744,2690,516480,676224
train,26,137,140288,2075,398400,538688
train,27,192,196608,4075,782400,979008
train,28,121,123904,1618,310656,434560
train,29,84,86016,780,149760,235776
train,30,94,96256,977,187584,283840
train,31,149,152576,2454,471168,623744
train,32,212,217088,4967,953664,1170752
train,33,245,250880,6634,1273728,1524608
train,34,194,198656,4160,798720,997376
train,35,146,149504,2356,452352,601856
train,36,141,144384,2198,422016,566400
train,37,147,150528,2389,458688,609216
train,38,98,100352,1062,203904,304256
train,39,182,186368,3661,702912,889280
train,40,185,189440,3783,726336,915776
train,41,156,159744,2690,516480,676224
train,42,96,98304,1019,195648,293952
train,43,141,144384,2198,422016,566400
train,44,118,120832,1539,295488,416320
train,45,151,154624,2520,483840,638464
train,46,170,174080,3194,613248,787328
train,47,188,192512,3907,750144,942656
train,48,121,123904,1618,310656,434560
train,49,127,130048,1783,342336,472384
train,50,174,178176,3346,642432,820608
train,51,118,120832,1539,295488,416320
train,52,144,147456,2292,440064,587520
train,53,190,194560,3990,766080,960640
train,54,64,65536,453,86976,152512
train,55,107,109568,1266,243072,352640
train,56,104,106496,1196,229632,336128
train,57,183,187392,3702,710784,898176
train,58,227,232448,5695,1093440,1325888
train,59,202,206848,4510,865920,1072768
train,60,123,125952,1672,321024,446976
train,61,118,120832,1539,295488,416320
train,62,206,210944,4690,900480,1111424
train,63,188,192512,3907,750144,942656
train,64,163,166912,2937,563904,730816
train,65,140,143360,2167,416064,559424
train,66,64,65536,453,86976,152512
train,67,72,73728,573,110016,183744
train,68,137,140288,2075,398400,538688
train,69,202,206848,4510,865920,1072768
train,70,142,145408,2229,427968,573376
train,71,121,123904,1618,310656,434560
train,72,67,68608,497,95424,164032
train,73,145,148480,2324,446208,594688
train,74,105,107520,1219,234048,341568
train,75,60,61440,398,76416,137856
train,76,193,197632,4117,790464,988096
train,77,152,155648,2554,490368,646016
train,78,204,208896,4600,883200,1092096
train,79,131,134144,1897,364224,498368
train,80,214,219136,5062,971904,1191040
train,81,167,171008,3083,591936,762944
train,82,134,137216,1985,381120,518336
train,83,209,214016,4828,926976,1140992
train,84,192,196608,4075,782400,979008
train,85,75,76800,622,119424,196224
train,86,172,176128,3270,627840,803968
train,87,118,120832,1539,295488,416320
train,88,174,178176,3346,642432,820608
train,89,213,218112,5014,962688,1180800
train,90,172,176128,3270,627840,803968
train,91,157,160768,2725,523200,683968
train,92,247,252928,6743,1294656,1547584
train,93,126,129024,1755,336960,465984
train,94,99,101376,1084,208128,309504
train,95,206,210944,4690,900480,1111424
train,96,185,189440,3783,726336,915776
train,97,101,103424,1128,216576,320000
train,98,179,183296,3541,679872,863168
train,99,88,90112,856,164352,254464
train,100,172,176128,3270,627840,803968
train,101,128,131072,1811,347712,478784
train,102,139,142336,2136,410112,552448
train,103,136,139264,2045,392640,531904
train,104,213,218112,5014,962688,1180800
train,105,180,184320,3581,687552,871872
train,106,94,96256,977,187584,283840
train,107,125,128000,1727,331584,459584
train,108,130,133120,1868,358656,491776
train,109,120,122880,1592,305664,428544
train,110,119,121856,1565,300480,422336
train,111,104,106496,1196,229632,336128
train,112,192,196608,4075,782400,979008
train,113,187,191488,3865,742080,933568
train,114,102,104448,1150,220800,325248
train,115,232,237568,5949,1142208,1379776
train,116,194,198656,4160,798720,997376
train,117,176,180224,3424,657408,837632
train,118,98,100352,1062,203904,304256
train,119,179,183296,3541,679872,863168
train,120,186,190464,3824,734208,924672
train,121,126,129024,1755,336960,465984
train,122,114,116736,1437,275904,392640
train,123,154,157696,2621,503232,660928
train,124,159,162816,2794,536448,699264
train,125,101,103424,1128,216576,320000
train,126,77,78848,656,125952,204800
train,127,110,112640,1338,256896,369536
train,128,132,135168,1926,369792,504960
train,129,204,208896,4600,883200,1092096
train,130,121,123904,1618,310656,434560
train,131,188,192512,3907,750144,942656
train,132,128,131072,1811,347712,478784
train,133,142,145408,2229,427968,573376
train,134,92,94208,936,179712,273920
train,135,88,90112,856,164352,254464
train,136,106,108544,1242,238464,347008
train,137,169,173056,3157,606144,779200
train,138,214,219136,5062,971904,1191040
train,139,190,194560,3990,766080,960640
train,140,166,169984,3046,584832,754816
train,141,115,117760,1462,280704,398464
train,142,120,122880,1592,305664,428544
train,143,124,126976,1700,326400,453376
train,144,165,168960,3009,577728,746688
train,145,146,149504,2356,452352,601856
train,146,66,67584,482,92544,160128
train,147,106,108544,1242,238464,347008
train,148,152,155648,2554,490368,646016
train,149,115,117760,1462,280704,398464
train,150,155,158720,2656,509952,668672
train,151,69,70656,527,101184,171840
train,152,136,139264,2045,392640,531904
train,153,185,189440,3783,726336,915776
train,154,144,147456,2292,440064,587520
train,155,135,138240,2015,386880,525120
train,156,153,156672,2587,496704,653376
train,157,221,226304,5398,1036416,1262720
train,158,154,157696,2621,503232,660928
train,159,147,150528,2389,458688,609216
train,160,80,81920,708,135936,217856
train,161,108,110592,1289,247488,358080
train,162,110,112640,1338,256896,369536
train,163,91,93184,916,175872,269056
train,164,218,223232,5253,1008576,1231808
train,165,190,194560,3990,766080,960640
train,166,193,197632,4117,790464,988096
train,167,95,97280,998,191616,288896
train,168,79,80896,690,132480,213376
train,169,55,56320,335,64320,120640
train,170,89,91136,876,168192,259328
train,171,180,184320,3581,687552,871872
train,172,100,102400,1106,212352,314752
train,173,187,191488,3865,742080,933568
train,174,158,161792,2759,529728,691520
train,175,158,161792,2759,529728,691520
train,176,142,145408,2229,427968,573376
train,177,177,181248,3463,664896,846144
train,178,190,194560,3990,766080,960640
train,179,142,145408,2229,427968,573376
train,180,174,178176,3346,642432,820608
train,181,58,59392,372,71424,130816
train,182,76,77824,639,122688,200512
train,183,147,150528,2389,458688,609216
train,184,134,137216,1985,381120,518336
train,185,175,179200,3385,649920,829120
train,186,125,128000,1727,331584,459584
train,187,159,162816,2794,536448,699264
train,188,152,155648,2554,490368,646016
train,189,137,140288,2075,398400,538688
train,190,224,229376,5546,1064832,1294208
train,191,157,160768,2725,523200,683968
train,192,141,144384,2198,422016,566400
train,193,212,217088,4967,953664,1170752
train,194,110,112640,1338,256896,369536
train,195,137,140288,2075,398400,538688
train,196,171,175104,3232,620544,795648
train,197,65,66560,467,89664,156224
train,198,127,130048,1783,342336,472384
train,199,138,141312,2105,404160,545472
train,200,161,164864,2865,550080,714944
train,201,166,169984,3046,584832,754816
train,202,192,196608,4075,782400,979008
train,203,173,177152,3308,635136,812288
train,204,135,138240,2015,386880,525120
train,205,160,163840,2830,543360,707200
train,206,143,146432,2260,433920,580352
train,207,264,270336,7703,1478976,1749312
train,208,154,157696,2621,503232,660928
train,209,168,172032,3120,599040,771072
train,210,160,163840,2830,543360,707200
train,211,155,158720,2656,509952,668672
train,212,103,105472,1173,225216,330688
train,213,165,168960,3009,577728,746688
train,214,113,115712,1412,271104,386816
train,215,187,191488,3865,742080,933568
train,216,147,150528,2389,458688,609216
train,217,130,133120,1868,358656,491776
train,218,117,119808,1513,290496,410304
train,219,59,60416,385,73920,134336
train,220,144,147456,2292,440064,587520
train,221,144,147456,2292,440064,587520
train,222,149,152576,2454,471168,623744
train,223,62,63488,425,81600,145088
train,224,135,138240,2015,386880,525120
train,225,159,162816,2794,536448,699264
train,226,127,130048,1783,342336,472384
train,227,162,165888,2901,556992,722880
train,228,144,147456,2292,440064,587520
train,229,92,94208,936,179712,273920
train,230,84,86016,780,149760,235776
train,231,232,237568,5949,1142208,1379776
train,232,164,167936,2973,570816,738752
train,233,163,166912,2937,563904,730816
train,234,103,105472,1173,225216,330688
train,235,107,109568,1266,243072,352640
train,236,147,150528,2389,458688,609216
train,237,131,134144,1897,364224,498368
train,238,185,189440,3783,726336,915776
train,239,236,241664,6156,1181952,1423616
train,240,159,162816,2794,536448,699264
train,241,299,306176,9881,1897152,2203328
train,242,142,145408,2229,427968,573376
train,243,147,150528,2389,458688,609216
train,244,144,147456,2292,440064,587520
train,245,122,124928,1645,315840,440768
train,246,171,175104,3232,620544,795648
train,247,74,75776,606,116352,192128
train,248,182,186368,3661,702912,889280
train,249,98,100352,1062,203904,304256
train,250,132,135168,1926,369792,504960
train,251,182,186368,3661,702912,889280
train,252,81,82944,725,139200,222144
train,253,151,154624,2520,483840,638464
train,254,130,133120,1868,358656,491776
train,255,128,131072,1811,347712,478784
train,256,130,133120,1868,358656,491776
train,257,152,155648,2554,490368,646016
train,258,137,140288,2075,398400,538688
train,259,154,157696,2621,503232,660928
train,260,69,70656,527,101184,171840
train,261,115,117760,1462,280704,398464
train,262,154,157696,2621,503232,660928
train,263,148,151552,2421,464832,616384
train,264,142,145408,2229,427968,573376
train,265,88,90112,856,164352,254464
train,266,201,205824,4465,857280,1063104
train,267,113,115712,1412,271104,386816
train,268,200,204800,4421,848832,1053632
train,269,160,163840,2830,543360,707200
train,270,181,185344,3621,695232,880576
train,271,135,138240,2015,386880,525120
train,272,185,189440,3783,726336,915776
train,273,160,163840,2830,543360,707200
train,274,92,94208,936,179712,273920
train,275,155,158720,2656,509952,668672
train,276,107,109568,1266,243072,352640
train,277,117,119808,1513,290496,410304
train,278,136,139264,2045,392640,531904
train,279,278,284672,8542,1640064,1924736
train,280,157,160768,2725,523200,683968
train,281,135,138240,2015,386880,525120
train,282,118,120832,1539,295488,416320
train,283,150,153600,2487,477504,631104
train,284,112,114688,1387,266304,380992
train,285,184,188416,3742,718464,906880
train,286,198,202752,4333,831936,1034688
train,287,193,197632,4117,790464,988096
train,288,157,160768,2725,523200,683968
train,289,56,57344,347,66624,123968
train,290,216,221184,5157,990144,1211328
train,291,118,120832,1539,295488,416320
train,292,154,157696,2621,503232,660928
train,293,157,160768,2725,523200,683968
train,294,181,185344,3621,695232,880576
train,295,168,172032,3120,599040,771072
train,296,166,169984,3046,584832,754816
train,297,160,163840,2830,543360,707200
train,298,108,110592,1289,247488,358080
train,299,150,153600,2487,477504,631104
train,300,86,88064,818,157056,245120
train,301,83,84992,762,146304,231296
train,302,166,169984,3046,584832,754816
train,303,84,86016,780,149760,235776
train,304,117,119808,1513,290496,410304
train,305,157,160768,2725,523200,683968
train,306,223,228352,5496,1055232,1283584
train,307,194,198656,4160,798720,997376
train,308,146,149504,2356,452352,601856
train,309,78,79872,673,129216,209088
train,310,136,139264,2045,392640,531904
train,311,144,147456,2292,440064,587520
train,312,172,176128,3270,627840,803968
train,313,162,165888,2901,556992,722880
train,314,190,194560,3990,766080,960640
train,315,111,113664,1362,261504,375168
train,316,163,166912,2937,563904,730816
train,317,126,129024,1755,336960,465984
train,318,174,178176,3346,642432,820608
train,319,140,143360,2167,416064,559424
train,320,87,89088,837,160704,249792
train,321,214,219136,5062,971904,1191040
train,322,190,194560,3990,766080,960640
train,323,161,164864,2865,550080,714944
train,324,104,106496,1196,229632,336128
train,325,155,158720,2656,509952,668672
train,326,91,93184,916,175872,269056
train,327,80,81920,708,135936,217856
train,328,179,183296,3541,679872,863168
train,329,109,111616,1313,252096,363712
train,330,109,111616,1313,252096,363712
train,331,73,74752,589,113088,187840
train,332,163,166912,2937,563904,730816
train,333,153,156672,2587,496704,653376
train,334,106,108544,1242,238464,347008
train,335,97,99328,1040,199680,299008
train,336,119,121856,1565,300480,422336
train,337,58,59392,372,71424,130816
train,338,172,176128,3270,627840,803968
train,339,300,307200,9947,1909824,2217024
train,340,117,119808,1513,290496,410304
train,341,205,209920,4645,891840,1101760
train,342,139,142336,2136,410112,552448
train,343,82,83968,744,142848,226816
train,344,141,144384,2198,422016,566400
train,345,243,248832,6526,1252992,1501824
train,346,179,183296,3541,679872,863168
train,347,145,148480,2324,446208,594688
train,348,90,92160,896,172032,264192
train,349,171,175104,3232,620544,795648
train,350,181,185344,3621,695232,880576
train,351,150,153600,2487,477504,631104
train,352,132,135168,1926,369792,504960
train,353,148,151552,2421,464832,616384
train,354,181,185344,3621,695232,880576
train,355,114,116736,1437,275904,392640
train,356,269,275456,7998,1535616,1811072
train,357,121,123904,1618,310656,434560
train,358,120,122880,1592,305664,428544
train,359,180,184320,3581,687552,871872
train,360,107,109568,1266,243072,352640
train,361,120,122880,1592,305664,428544
train,362,114,116736,1437,275904,392640
train,363,127,130048,1783,342336,472384
train,364,85,87040,799,153408,240448
train,365,188,192512,3907,750144,942656
train,366,133,136192,1955,375360,511552
train,367,204,208896,4600,883200,1092096
train,368,129,132096,1840,353280,485376
train,369,119,121856,1565,300480,422336
train,370,115,117760,1462,280704,398464
train,371,156,159744,2690,516480,676224
train,372,121,123904,1618,310656,434560
train,373,179,183296,3541,679872,863168
train,374,124,126976,1700,326400,453376
train,375,171,175104,3232,620544,795648
train,376,158,161792,2759,529728,691520
train,377,231,236544,5898,1132416,1368960
train,378,100,102400,1106,212352,314752
train,379,150,153600,2487,477504,631104
train,380,123,125952,1672,321024,446976
train,381,205,209920,4645,891840,1101760
train,382,181,185344,3621,695232,880576
train,383,109,111616,1313,252096,363712
train,384,89,91136,876,168192,259328
train,385,92,94208,936,179712,273920
train,386,80,81920,708,135936,217856
train,387,188,192512,3907,750144,942656
train,388,223,228352,5496,1055232,1283584
train,389,81,82944,725,139200,222144
train,390,139,142336,2136,410112,552448
train,391,128,131072,1811,347712,478784
train,392,116,118784,1488,285696,404480
train,393,37,37888,152,29184,67072
train,394,99,101376,1084,208128,309504
train,395,95,97280,998,191616,288896
train,396,141,144384,2198,422016,566400
train,397,132,135168,1926,369792,504960
train,398,63,64512,439,84288,148800
train,399,236,241664,6156,1181952,1423616
train,400,161,164864,2865,550080,714944
train,401,108,110592,1289,247488,358080
train,402,106,108544,1242,238464,347008
train,403,150,153600,2487,477504,631104
train,404,111,113664,1362,261504,375168
train,405,152,155648,2554,490368,646016
train,406,132,135168,1926,369792,504960
train,407,141,144384,2198,422016,566400
train,408,153,156672,2587,496704,653376
train,409,167,171008,3083,591936,762944
train,410,149,152576,2454,471168,623744
train,411,163,166912,2937,563904,730816
train,412,120,122880,1592,305664,428544
train,413,65,66560,467,89664,156224
train,414,159,162816,2794,536448,699264
train,415,194,198656,4160,798720,997376
train,416,111,113664,1362,261504,375168
train,417,74,75776,606,116352,192128
train,418,173,177152,3308,635136,812288
train,419,196,200704,4246,815232,1015936
train,420,93,95232,956,183552,278784
train,421,193,197632,4117,790464,988096
train,422,143,146432,2260,433920,580352
train,423,131,134144,1897,364224,498368
train,424,114,116736,1437,275904,392640
train,425,139,142336,2136,410112,552448
train,426,273,279552,8237,1581504,1861056
train,427,170,174080,3194,613248,787328
train,428,93,95232,956,183552,278784
train,429,159,162816,2794,536448,699264
train,430,168,172032,3120,599040,771072
train,431,94,96256,977,187584,283840
train,432,58,59392,372,71424,130816
train,433,168,172032,3120,599040,771072
train,434,106,108544,1242,238464,347008
train,435,262,268288,7587,1456704,1724992
train,436,65,66560,467,89664,156224
train,437,75,76800,622,119424,196224
train,438,151,154624,2520,483840,638464
train,439,132,135168,1926,369792,504960
train,440,197,201728,4289,823488,1025216
train,441,183,187392,3702,710784,898176
train,442,136,139264,2045,392640,531904
train,443,83,84992,762,146304,231296
train,444,217,222208,5205,999360,1221568
train,445,133,136192,1955,375360,511552
train,446,189,193536,3948,758016,951552
train,447,156,159744,2690,516480,676224
train,448,99,101376,1084,208128,309504
train,449,182,186368,3661,702912,889280
train,450,91,93184,916,175872,269056
train,451,185,189440,3783,726336,915776
train,452,115,117760,1462,280704,398464
train,453,163,166912,2937,563904,730816
train,454,148,151552,2421,464832,616384
train,455,70,71680,542,104064,175744
train,456,137,140288,2075,398400,538688
train,457,122,124928,1645,315840,440768
train,458,167,171008,3083,591936,762944
train,459,56,57344,347,66624,123968
train,460,165,168960,3009,577728,746688
train,461,117,119808,1513,290496,410304
train,462,147,150528,2389,458688,609216
train,463,172,176128,3270,627840,803968
train,464,82,83968,744,142848,226816
train,465,118,120832,1539,295488,416320
train,466,160,163840,2830,543360,707200
train,467,215,220160,5109,980928,1201088
train,468,174,178176,3346,642432,820608
train,469,204,208896,4600,883200,1092096
train,470,58,59392,372,71424,130816
train,471,103,105472,1173,225216,330688
train,472,147,150528,2389,458688,609216
train,473,108,110592,1289,247488,358080
train,474,136,139264,2045,392640,531904
train,475,182,186368,3661,702912,889280
train,476,166,169984,3046,584832,754816
train,477,117,119808,1513,290496,410304
train,478,118,120832,1539,295488,416320
train,479,72,73728,573,110016,183744
train,480,104,106496,1196,229632,336128
train,481,148,151552,2421,464832,616384
train,482,143,146432,2260,433920,580352
train,483,67,68608,497,95424,164032
train,484,118,120832,1539,295488,416320
train,485,213,218112,5014,962688,1180800
train,486,119,121856,1565,300480,422336
train,487,171,175104,3232,620544,795648
train,488,201,205824,4465,857280,1063104
train,489,183,187392,3702,710784,898176
train,490,92,94208,936,179712,273920
train,491,151,154624,2520,483840,638464
train,492,204,208896,4600,883200,1092096
train,493,137,140288,2075,398400,538688
train,494,175,179200,3385,649920,829120
train,495,191,195584,4032,774144,969728
train,496,201,205824,4465,857280,1063104
train,497,82,83968,744,142848,226816
train,498,128,131072,1811,347712,478784
train,499,188,192512,3907,750144,942656
train,500,156,159744,2690,516480,676224
train,501,112,114688,1387,266304,380992
train,502,127,130048,1783,342336,472384
train,503,205,209920,4645,891840,1101760
train,504,220,225280,5349,1027008,1252288
train,505,182,186368,3661,702912,889280
train,506,145,148480,2324,446208,594688
train,507,173,177152,3308,635136,812288
train,508,181,185344,3621,695232,880576
train,509,91,93184,916,175872,269056
train,510,73,74752,589,113088,187840
train,511,92,94208,936,179712,273920
train,512,189,193536,3948,758016,951552
train,513,159,162816,2794,536448,699264
train,514,79,80896,690,132480,213376
train,515,190,194560,3990,766080,960640
train,516,99,101376,1084,208128,309504
train,517,135,138240,2015,386880,525120
train,518,106,108544,1242,238464,347008
train,519,178,182272,3502,672384,854656
train,520,46,47104,234,44928,92032
train,521,139,142336,2136,410112,552448
train,522,157,160768,2725,523200,683968
train,523,196,200704,4246,815232,1015936
train,524,87,89088,837,160704,249792
train,525,199,203776,4377,840384,1044160
train,526,103,105472,1173,225216,330688
train,527,192,196608,4075,782400,979008
train,528,57,58368,359,68928,127296
train,529,117,119808,1513,290496,410304
train,530,135,138240,2015,386880,525120
train,531,110,112640,1338,256896,369536
train,532,184,188416,3742,718464,906880
train,533,151,154624,2520,483840,638464
train,534,172,176128,3270,627840,803968
train,535,175,179200,3385,649920,829120
train,536,173,177152,3308,635136,812288
train,537,91,93184,916,175872,269056
train,538,114,116736,1437,275904,392640
train,539,156,159744,2690,516480,676224
train,540,189,193536,3948,758016,951552
train,541,143,146432,2260,433920,580352
train,542,164,167936,2973,570816,738752
train,543,60,61440,398,76416,137856
train,544,247,252928,6743,1294656,1547584
train,545,174,178176,3346,642432,820608
train,546,304,311296,10214,1961088,2272384
train,547,122,124928,1645,315840,440768
train,548,103,105472,1173,225216,330688
train,549,97,99328,1040,199680,299008
train,550,125,128000,1727,331584,459584
train,551,155,158720,2656,509952,668672
train,552,141,144384,2198,422016,566400
train,553,182,186368,3661,702912,889280
train,554,58,59392,372,71424,130816
train,555,61,62464,412,79104,141568
train,556,196,200704,4246,815232,1015936
train,557,184,188416,3742,718464,906880
train,558,136,139264,2045,392640,531904
train,559,131,134144,1897,364224,498368
train,560,236,241664,6156,1181952,1423616
train,561,84,86016,780,149760,235776
train,562,151,154624,2520,483840,638464
train,563,168,172032,3120,599040,771072
train,564,121,123904,1618,310656,434560
train,565,171,175104,3232,620544,795648
train,566,145,148480,2324,446208,594688
train,567,211,216064,4921,944832,1160896
train,568,95,97280,998,191616,288896
train,569,117,119808,1513,290496,410304
train,570,180,184320,3581,687552,871872
train,571,70,71680,542,104064,175744
train,572,108,110592,1289,247488,358080
train,573,176,180224,3424,657408,837632
train,574,176,180224,3424,657408,837632
train,575,205,209920,4645,891840,1101760
train,576,178,182272,3502,672384,854656
train,577,147,150528,2389,458688,609216
train,578,245,250880,6634,1273728,1524608
train,579,187,191488,3865,742080,933568
train,580,115,117760,1462,280704,398464
train,581,149,152576,2454,471168,623744
train,582,181,185344,3621,695232,880576
train,583,192,196608,4075,782400,979008
train,584,114,116736,1437,275904,392640
train,585,126,129024,1755,336960,465984
train,586,192,196608,4075,782400,979008
train,587,65,66560,467,89664,156224
train,588,112,114688,1387,266304,380992
train,589,53,54272,311,59712,113984
train,590,163,166912,2937,563904,730816
train,591,70,71680,542,104064,175744
train,592,99,101376,1084,208128,309504
train,593,143,146432,2260,433920,580352
train,594,150,153600,2487,477504,631104
train,595,115,117760,1462,280704,398464
train,596,102,104448,1150,220800,325248
train,597,161,164864,2865,550080,714944
train,598,165,168960,3009,577728,746688
train,599,156,159744,2690,516480,676224
train,600,123,125952,1672,321024,446976
train,601,140,143360,2167,416064,559424
train,602,111,113664,1362,261504,375168
train,603,222,227328,5447,1045824,1273152
train,604,92,94208,936,179712,273920
train,605,134,137216,1985,381120,518336
train,606,79,80896,690,132480,213376
train,607,198,202752,4333,831936,1034688
train,608,137,140288,2075,398400,538688
train,609,63,64512,439,84288,148800
train,610,57,58368,359,68928,127296
train,611,207,211968,4736,909312,1121280
train,612,166,169984,3046,584832,754816
train,613,92,94208,936,179712,273920
train,614,149,152576,2454,471168,623744
train,615,141,144384,2198,422016,566400
train,616,132,135168,1926,369792,504960
train,617,112,114688,1387,266304,380992
train,618,207,211968,4736,909312,1121280
train,619,95,97280,998,191616,288896
train,620,169,173056,3157,606144,779200
train,621,112,114688,1387,266304,380992
train,622,77,78848,656,125952,204800
train,623,102,104448,1150,220800,325248
train,624,168,172032,3120,599040,771072
train,625,219,224256,5301,1017792,1242048
train,626,137,140288,2075,398400,538688
train,627,79,80896,690,132480,213376
train,628,105,107520,1219,234048,341568
train,629,215,220160,5109,980928,1201088
train,630,126,129024,1755,336960,465984
train,631,122,124928,1645,315840,440768
train,632,149,152576,2454,471168,623744
train,633,142,145408,2229,427968,573376
train,634,120,122880,1592,305664,428544
train,635,114,116736,1437,275904,392640
train,636,172,176128,3270,627840,803968
train,637,84,86016,780,149760,235776
train,638,154,157696,2621,503232,660928
train,639,68,69632,511,98112,167744
train,640,140,143360,2167,416064,559424
train,641,162,165888,2901,556992,722880
train,642,90,92160,896,172032,264192
train,643,164,167936,2973,570816,738752
train,644,115,117760,1462,280704,398464
train,645,166,169984,3046,584832,754816
train,646,115,117760,1462,280704,398464
train,647,87,89088,837,160704,249792
train,648,149,152576,2454,471168,623744
train,649,119,121856,1565,300480,422336
train,650,103,105472,1173,225216,330688
train,651,78,79872,673,129216,209088
train,652,119,121856,1565,300480,422336
train,653,141,144384,2198,422016,566400
train,654,97,99328,1040,199680,299008
train,655,172,176128,3270,627840,803968
train,656,95,97280,998,191616,288896
train,657,223,228352,5496,1055232,1283584
train,658,177,181248,3463,664896,846144
train,659,129,132096,1840,353280,485376
train,660,188,192512,3907,750144,942656
train,661,88,90112,856,164352,254464
train,662,137,140288,2075,398400,538688
train,663,126,129024,1755,336960,465984
train,664,127,130048,1783,342336,472384
train,665,120,122880,1592,305664,428544
train,666,133,136192,1955,375360,511552
train,667,110,112640,1338,256896,369536
train,668,145,148480,2324,446208,594688
train,669,71,72704,558,107136,179840
train,670,67,68608,497,95424,164032
train,671,133,136192,1955,375360,511552
train,672,95,97280,998,191616,288896
train,673,159,162816,2794,536448,699264
train,674,149,152576,2454,471168,623744
train,675,130,133120,1868,358656,491776
train,676,89,91136,876,168192,259328
train,677,203,207872,4555,874560,1082432
train,678,167,171008,3083,591936,762944
train,679,168,172032,3120,599040,771072
train,680,152,155648,2554,490368,646016
train,681,123,125952,1672,321024,446976
train,682,92,94208,936,179712,273920
train,683,100,102400,1106,212352,314752
train,684,181,185344,3621,695232,880576
train,685,96,98304,1019,195648,293952
train,686,141,144384,2198,422016,566400
train,687,246,251904,6688,1284096,1536000
train,688,148,151552,2421,464832,616384
train,689,161,164864,2865,550080,714944
train,690,125,128000,1727,331584,459584
train,691,146,149504,2356,452352,601856
train,692,177,181248,3463,664896,846144
train,693,120,122880,1592,305664,428544
train,694,53,54272,311,59712,113984
train,695,147,150528,2389,458688,609216
train,696,95,97280,998,191616,288896
train,697,154,157696,2621,503232,660928
train,698,176,180224,3424,657408,837632
train,699,209,214016,4828,926976,1140992
train,700,225,230400,5595,1074240,1304640
train,701,151,154624,2520,483840,638464
train,702,83,84992,762,146304,231296
train,703,112,114688,1387,266304,380992
train,704,150,153600,2487,477504,631104
train,705,111,113664,1362,261504,375168
train,706,109,111616,1313,252096,363712
train,707,151,154624,2520,483840,638464
train,708,95,97280,998,191616,288896
train,709,164,167936,2973,570816,738752
train,710,174,178176,3346,642432,820608
train,711,123,125952,1672,321024,446976
train,712,124,126976,1700,326400,453376
train,713,116,118784,1488,285696,404480
train,714,169,173056,3157,606144,779200
train,715,141,144384,2198,422016,566400
train,716,95,97280,998,191616,288896
train,717,144,147456,2292,440064,587520
train,718,163,166912,2937,563904,730816
train,719,205,209920,4645,891840,1101760
train,720,114,116736,1437,275904,392640
train,721,168,172032,3120,599040,771072
train,722,135,138240,2015,386880,525120
train,723,95,97280,998,191616,288896
train,724,175,179200,3385,649920,829120
train,725,108,110592,1289,247488,358080
train,726,118,120832,1539,295488,416320
train,727,142,145408,2229,427968,573376
train,728,115,117760,1462,280704,398464
train,729,143,146432,2260,433920,580352
train,730,104,106496,1196,229632,336128
train,731,107,109568,1266,243072,352640
train,732,136,139264,2045,392640,531904
train,733,186,190464,3824,734208,924672
train,734,193,197632,4117,790464,988096
train,735,246,251904,6688,1284096,1536000
train,736,148,151552,2421,464832,616384
train,737,76,77824,639,122688,200512
train,738,172,176128,3270,627840,803968
train,739,109,111616,1313,252096,363712
train,740,143,146432,2260,433920,580352
train,741,101,103424,1128,216576,320000
train,742,222,227328,5447,1045824,1273152
train,743,186,190464,3824,734208,924672
train,744,94,96256,977,187584,283840
train,745,112,114688,1387,266304,380992
train,746,147,150528,2389,458688,609216
train,747,87,89088,837,160704,249792
train,748,98,100352,1062,203904,304256
train,749,132,135168,1926,369792,504960
train,750,145,148480,2324,446208,594688
train,751,175,179200,3385,649920,829120
train,752,96,98304,1019,195648,293952
train,753,138,141312,2105,404160,545472
train,754,116,118784,1488,285696,404480
train,755,126,129024,1755,336960,465984
train,756,133,136192,1955,375360,511552
train,757,157,160768,2725,523200,683968
train,758,149,152576,2454,471168,623744
train,759,129,132096,1840,353280,485376
train,760,145,148480,2324,446208,594688
train,761,190,194560,3990,766080,960640
train,762,56,57344,347,66624,123968
train,763,82,83968,744,142848,226816
train,764,52,53248,299,57408,110656
train,765,136,139264,2045,392640,531904
train,766,161,164864,2865,550080,714944
train,767,201,205824,4465,857280,1063104
train,768,194,198656,4160,798720,997376
train,769,96,98304,1019,195648,293952
train,770,89,91136,876,168192,259328
train,771,125,128000,1727,331584,459584
train,772,182,186368,3661,702912,889280
train,773,167,171008,3083,591936,762944
train,774,157,160768,2725,523200,683968
train,775,189,193536,3948,758016,951552
train,776,120,122880,1592,305664,428544
train,777,107,109568,1266,243072,352640
train,778,94,96256,977,187584,283840
train,779,97,99328,1040,199680,299008
train,780,147,150528,2389,458688,609216
train,781,85,87040,799,153408,240448
train,782,128,131072,1811,347712,478784
train,783,125,128000,1727,331584,459584
train,784,104,106496,1196,229632,336128
train,785,65,66560,467,89664,156224
train,786,142,145408,2229,427968,573376
train,787,171,175104,3232,620544,795648
train,788,60,61440,398,76416,137856
train,789,165,168960,3009,577728,746688
train,790,192,196608,4075,782400,979008
train,791,132,135168,1926,369792,504960
train,792,64,65536,453,86976,152512
train,793,192,196608,4075,782400,979008
train,794,151,154624,2520,483840,638464
train,795,94,96256,977,187584,283840
train,796,133,136192,1955,375360,511552
train,797,106,108544,1242,238464,347008
train,798,89,91136,876,168192,259328
train,799,182,186368,3661,702912,889280
train,800,128,131072,1811,347712,478784
train,801,161,164864,2865,550080,714944
train,802,105,107520,1219,234048,341568
train,803,156,159744,2690,516480,676224
train,804,192,196608,4075,782400,979008
train,805,161,164864,2865,550080,714944
train,806,143,146432,2260,433920,580352
train,807,199,203776,4377,840384,1044160
train,808,158,161792,2759,529728,691520
train,809,62,63488,425,81600,145088
train,810,121,123904,1618,310656,434560
train,811,201,205824,4465,857280,1063104
train,812,83,84992,762,146304,231296
train,813,51,52224,288,55296,107520
train,814,206,210944,4690,900480,1111424
train,815,167,171008,3083,591936,762944
train,816,184,188416,3742,718464,906880
train,817,205,209920,4645,891840,1101760
train,818,66,67584,482,92544,160128
train,819,230,235520,5847,1122624,1358144
train,820,186,190464,3824,734208,924672
train,821,147,150528,2389,458688,609216
train,822,127,130048,1783,342336,472384
train,823,159,162816,2794,536448,699264
train,824,164,167936,2973,570816,738752
train,825,170,174080,3194,613248,787328
train,826,106,108544,1242,238464,347008
train,827,190,194560,3990,766080,960640
train,828,181,185344,3621,695232,880576
train,829,117,119808,1513,290496,410304
train,830,187,191488,3865,742080,933568
train,831,75,76800,622,119424,196224
train,832,164,167936,2973,570816,738752
train,833,185,189440,3783,726336,915776
train,834,160,163840,2830,543360,707200
train,835,170,174080,3194,613248,787328
train,836,177,181248,3463,664896,846144
train,837,117,119808,1513,290496,410304
train,838,84,86016,780,149760,235776
train,839,189,193536,3948,758016,951552
train,840,67,68608,497,95424,164032
train,841,152,155648,2554,490368,646016
train,842,87,89088,837,160704,249792
train,843,103,105472,1173,225216,330688
train,844,91,93184,916,175872,269056
train,845,132,135168,1926,369792,504960
train,846,172,176128,3270,627840,803968
train,847,137,140288,2075,398400,538688
train,848,147,150528,2389,458688,609216
train,849,188,192512,3907,750144,942656
train,850,140,143360,2167,416064,559424
train,851,133,136192,1955,375360,511552
train,852,89,91136,876,168192,259328
train,853,123,125952,1672,321024,446976
train,854,130,133120,1868,358656,491776
train,855,108,110592,1289,247488,358080
train,856,175,179200,3385,649920,829120
train,857,63,64512,439,84288,148800
train,858,114,116736,1437,275904,392640
train,859,203,207872,4555,874560,1082432
train,860,221,226304,5398,1036416,1262720
train,861,100,102400,1106,212352,314752
train,862,124,126976,1700,326400,453376
train,863,227,232448,5695,1093440,1325888
train,864,170,174080,3194,613248,787328
train,865,141,144384,2198,422016,566400
train,866,70,71680,542,104064,175744
train,867,98,100352,1062,203904,304256
train,868,81,82944,725,139200,222144
train,869,160,163840,2830,543360,707200
train,870,114,116736,1437,275904,392640
train,871,106,108544,1242,238464,347008
train,872,106,108544,1242,238464,347008
train,873,106,108544,1242,238464,347008
train,874,152,155648,2554,490368,646016
train,875,83,84992,762,146304,231296
train,876,181,185344,3621,695232,880576
train,877,199,203776,4377,840384,1044160
train,878,142,145408,2229,427968,573376
train,879,150,153600,2487,477504,631104
train,880,141,144384,2198,422016,566400
train,881,86,88064,818,157056,245120
train,882,132,135168,1926,369792,504960
train,883,159,162816,2794,536448,699264
train,884,143,146432,2260,433920,580352
train,885,108,110592,1289,247488,358080
train,886,213,218112,5014,962688,1180800
train,887,112,114688,1387,266304,380992
train,888,104,106496,1196,229632,336128
train,889,109,111616,1313,252096,363712
train,890,165,168960,3009,577728,746688
train,891,72,73728,573,110016,183744
train,892,149,152576,2454,471168,623744
train,893,167,171008,3083,591936,762944
train,894,176,180224,3424,657408,837632
train,895,200,204800,4421,848832,1053632
train,896,72,73728,573,110016,183744
train,897,180,184320,3581,687552,871872
train,898,180,184320,3581,687552,871872
train,899,108,110592,1289,247488,358080
train,900,162,165888,2901,556992,722880
train,901,110,112640,1338,256896,369536
train,902,125,128000,1727,331584,459584
train,903,115,117760,1462,280704,398464
train,904,43,44032,205,39360,83392
train,905,81,82944,725,139200,222144
train,906,208,212992,4782,918144,1131136
train,907,175,179200,3385,649920,829120
train,908,204,208896,4600,883200,1092096
train,909,133,136192,1955,375360,511552
train,910,219,224256,5301,1017792,1242048
train,911,134,137216,1985,381120,518336
train,912,69,70656,527,101184,171840
train,913,128,131072,1811,347712,478784
train,914,122,124928,1645,315840,440768
train,915,125,128000,1727,331584,459584
train,916,141,144384,2198,422016,566400
train,917,111,113664,1362,261504,375168
train,918,97,99328,1040,199680,299008
train,919,156,159744,2690,516480,676224
train,920,150,153600,2487,477504,631104
train,921,136,139264,2045,392640,531904
train,922,90,92160,896,172032,264192
train,923,143,146432,2260,433920,580352
train,924,181,185344,3621,695232,880576
train,925,188,192512,3907,750144,942656
train,926,126,129024,1755,336960,465984
train,927,105,107520,1219,234048,341568
train,928,80,81920,708,135936,217856
train,929,112,114688,1387,266304,380992
train,930,48,49152,255,48960,98112
train,931,139,142336,2136,410112,552448
train,932,217,222208,5205,999360,1221568
train,933,137,140288,2075,398400,538688
train,934,142,145408,2229,427968,573376
train,935,75,76800,622,119424,196224
train,936,155,158720,2656,509952,668672
train,937,127,130048,1783,342336,472384
train,938,129,132096,1840,353280,485376
train,939,161,164864,2865,550080,714944
train,940,111,113664,1362,261504,375168
train,941,214,219136,5062,971904,1191040
train,942,165,168960,3009,577728,746688
train,943,154,157696,2621,503232,660928
train,944,90,92160,896,172032,264192
train,945,131,134144,1897,364224,498368
train,946,134,137216,1985,381120,518336
train,947,91,93184,916,175872,269056
train,948,136,139264,2045,392640,531904
train,949,73,74752,589,113088,187840
train,950,196,200704,4246,815232,1015936
train,951,180,184320,3581,687552,871872
train,952,161,164864,2865,550080,714944
train,953,156,159744,2690,516480,676224
train,954,182,186368,3661,702912,889280
train,955,128,131072,1811,347712,478784
train,956,80,81920,708,135936,217856
train,957,116,118784,1488,285696,404480
train,958,166,169984,3046,584832,754816
train,959,66,67584,482,92544,160128
train,960,127,130048,1783,342336,472384
train,961,94,96256,977,187584,283840
train,962,128,131072,1811,347712,478784
train,963,160,163840,2830,543360,707200
train,964,107,109568,1266,243072,352640
train,965,106,108544,1242,238464,347008
train,966,248,253952,6798,1305216,1559168
train,967,159,162816,2794,536448,699264
train,968,174,178176,3346,642432,820608
train,969,105,107520,1219,234048,341568
train,970,181,185344,3621,695232,880576
train,971,183,187392,3702,710784,898176
train,972,85,87040,799,153408,240448
train,973,204,208896,4600,883200,1092096
train,974,128,131072,1811,347712,478784
train,975,196,200704,4246,815232,1015936
train,976,119,121856,1565,300480,422336
train,977,158,161792,2759,529728,691520
train,978,119,121856,1565,300480,422336
train,979,183,187392,3702,710784,898176
train,980,235,240640,6104,1171968,1412608
train,981,145,148480,2324,446208,594688
train,982,66,67584,482,92544,160128
train,983,81,82944,725,139200,222144
train,984,146,149504,2356,452352,601856
train,985,207,211968,4736,909312,1121280
train,986,92,94208,936,179712,273920
train,987,163,166912,2937,563904,730816
train,988,184,188416,3742,718464,906880
train,989,112,114688,1387,266304,380992
train,990,96,98304,1019,195648,293952
train,991,140,143360,2167,416064,559424
train,992,118,120832,1539,295488,416320
train,993,68,69632,511,98112,167744
train,994,153,156672,2587,496704,653376
train,995,147,150528,2389,458688,609216
train,996,168,172032,3120,599040,771072
train,997,111,113664,1362,261504,375168
train,998,174,178176,3346,642432,820608
train,999,128,131072,1811,347712,478784
train,1000,76,77824,639,122688,200512
train,1001,87,89088,837,160704,249792
train,1002,123,125952,1672,321024,446976
train,1003,149,152576,2454,471168,623744
train,1004,115,117760,1462,280704,398464
train,1005,150,153600,2487,477504,631104
train,1006,107,109568,1266,243072,352640
train,1007,179,183296,3541,679872,863168
train,1008,161,164864,2865,550080,714944
train,1009,116,118784,1488,285696,404480
train,1010,129,132096,1840,353280,485376
train,1011,101,103424,1128,216576,320000
train,1012,126,129024,1755,336960,465984
train,1013,117,119808,1513,290496,410304
train,1014,138,141312,2105,404160,545472
train,1015,106,108544,1242,238464,347008
train,1016,108,110592,1289,247488,358080
train,1017,114,116736,1437,275904,392640
train,1018,172,176128,3270,627840,803968
train,1019,151,154624,2520,483840,638464
train,1020,137,140288,2075,398400,538688
train,1021,161,164864,2865,550080,714944
train,1022,147,150528,2389,458688,609216
train,1023,188,192512,3907,750144,942656
train,1024,123,125952,1672,321024,446976
train,1025,122,124928,1645,315840,440768
train,1026,170,174080,3194,613248,787328
train,1027,141,144384,2198,422016,566400
train,1028,82,83968,744,142848,226816
train,1029,118,120832,1539,295488,416320
train,1030,66,67584,482,92544,160128
train,1031,125,128000,1727,331584,459584
train,1032,199,203776,4377,840384,1044160
train,1033,166,169984,3046,584832,754816
train,1034,183,187392,3702,710784,898176
train,1035,135,138240,2015,386880,525120
train,1036,117,119808,1513,290496,410304
train,1037,139,142336,2136,410112,552448
train,1038,113,115712,1412,271104,386816
train,1039,147,150528,2389,458688,609216
train,1040,157,160768,2725,523200,683968
train,1041,118,120832,1539,295488,416320
train,1042,78,79872,673,129216,209088
train,1043,109,111616,1313,252096,363712
train,1044,113,115712,1412,271104,386816
train,1045,80,81920,708,135936,217856
train,1046,123,125952,1672,321024,446976
train,1047,95,97280,998,191616,288896
train,1048,118,120832,1539,295488,416320
train,1049,153,156672,2587,496704,653376
train,1050,124,126976,1700,326400,453376
train,1051,184,188416,3742,718464,906880
train,1052,122,124928,1645,315840,440768
train,1053,145,148480,2324,446208,594688
train,1054,150,153600,2487,477504,631104
train,1055,129,132096,1840,353280,485376
train,1056,92,94208,936,179712,273920
train,1057,138,141312,2105,404160,545472
train,1058,78,79872,673,129216,209088
train,1059,105,107520,1219,234048,341568
train,1060,84,86016,780,149760,235776
train,1061,164,167936,2973,570816,738752
train,1062,127,130048,1783,342336,472384
train,1063,162,165888,2901,556992,722880
train,1064,171,175104,3232,620544,795648
train,1065,73,74752,589,113088,187840
train,1066,146,149504,2356,452352,601856
train,1067,122,124928,1645,315840,440768
train,1068,152,155648,2554,490368,646016
train,1069,121,123904,1618,310656,434560
train,1070,160,163840,2830,543360,707200
train,1071,126,129024,1755,336960,465984
train,1072,128,131072,1811,347712,478784
train,1073,112,114688,1387,266304,380992
train,1074,80,81920,708,135936,217856
train,1075,118,120832,1539,295488,416320
train,1076,171,175104,3232,620544,795648
train,1077,165,168960,3009,577728,746688
train,1078,102,104448,1150,220800,325248
train,1079,190,194560,3990,766080,960640
train,1080,151,154624,2520,483840,638464
train,1081,155,158720,2656,509952,668672
train,1082,122,124928,1645,315840,440768
train,1083,92,94208,936,179712,273920
train,1084,117,119808,1513,290496,410304
train,1085,96,98304,1019,195648,293952
train,1086,98,100352,1062,203904,304256
train,1087,59,60416,385,73920,134336
train,1088,62,63488,425,81600,145088
train,1089,135,138240,2015,386880,525120
train,1090,180,184320,3581,687552,871872
train,1091,120,122880,1592,305664,428544
train,1092,131,134144,1897,364224,498368
train,1093,227,232448,5695,1093440,1325888
train,1094,131,134144,1897,364224,498368
train,1095,84,86016,780,149760,235776
train,1096,159,162816,2794,536448,699264
train,1097,201,205824,4465,857280,1063104
train,1098,189,193536,3948,758016,951552
train,1099,160,163840,2830,543360,707200
train,1100,192,196608,4075,782400,979008
train,1101,93,95232,956,183552,278784
train,1102,139,142336,2136,410112,552448
train,1103,205,209920,4645,891840,1101760
train,1104,100,102400,1106,212352,314752
train,1105,59,60416,385,73920,134336
train,1106,148,151552,2421,464832,616384
train,1107,177,181248,3463,664896,846144
train,1108,60,61440,398,76416,137856
train,1109,207,211968,4736,909312,1121280
train,1110,149,152576,2454,471168,623744
train,1111,104,106496,1196,229632,336128
train,1112,177,181248,3463,664896,846144
train,1113,125,128000,1727,331584,459584
train,1114,149,152576,2454,471168,623744
train,1115,149,152576,2454,471168,623744
train,1116,78,79872,673,129216,209088
train,1117,211,216064,4921,944832,1160896
train,1118,130,133120,1868,358656,491776
train,1119,128,131072,1811,347712,478784
train,1120,129,132096,1840,353280,485376
train,1121,89,91136,876,168192,259328
train,1122,144,147456,2292,440064,587520
train,1123,88,90112,856,164352,254464
train,1124,55,56320,335,64320,120640
train,1125,135,138240,2015,386880,525120
train,1126,211,216064,4921,944832,1160896
train,1127,240,245760,6366,1222272,1468032
train,1128,61,62464,412,79104,141568
train,1129,81,82944,725,139200,222144
train,1130,147,150528,2389,458688,609216
train,1131,139,142336,2136,410112,552448
train,1132,121,123904,1618,310656,434560
train,1133,211,216064,4921,944832,1160896
train,1134,72,73728,573,110016,183744
train,1135,63,64512,439,84288,148800
train,1136,137,140288,2075,398400,538688
train,1137,145,148480,2324,446208,594688
train,1138,173,177152,3308,635136,812288
train,1139,75,76800,622,119424,196224
train,1140,200,204800,4421,848832,1053632
train,1141,88,90112,856,164352,254464
train,1142,84,86016,780,149760,235776
train,1143,191,195584,4032,774144,969728
train,1144,154,157696,2621,503232,660928
train,1145,149,152576,2454,471168,623744
train,1146,102,104448,1150,220800,325248
train,1147,137,140288,2075,398400,538688
train,1148,126,129024,1755,336960,465984
train,1149,164,167936,2973,570816,738752
train,1150,170,174080,3194,613248,787328
train,1151,145,148480,2324,446208,594688
train,1152,147,150528,2389,458688,609216
train,1153,124,126976,1700,326400,453376
train,1154,110,112640,1338,256896,369536
train,1155,205,209920,4645,891840,1101760
train,1156,138,141312,2105,404160,545472
train,1157,161,164864,2865,550080,714944
train,1158,157,160768,2725,523200,683968
train,1159,106,108544,1242,238464,347008
train,1160,73,74752,589,113088,187840
train,1161,181,185344,3621,695232,880576
train,1162,174,178176,3346,642432,820608
train,1163,142,145408,2229,427968,573376
train,1164,224,229376,5546,1064832,1294208
train,1165,101,103424,1128,216576,320000
train,1166,131,134144,1897,364224,498368
train,1167,95,97280,998,191616,288896
train,1168,66,67584,482,92544,160128
train,1169,109,111616,1313,252096,363712
train,1170,143,146432,2260,433920,580352
train,1171,123,125952,1672,321024,446976
train,1172,99,101376,1084,208128,309504
train,1173,231,236544,5898,1132416,1368960
train,1174,82,83968,744,142848,226816
train,1175,181,185344,3621,695232,880576
train,1176,140,143360,2167,416064,559424
train,1177,161,164864,2865,550080,714944
train,1178,89,91136,876,168192,259328
train,1179,175,179200,3385,649920,829120
train,1180,64,65536,453,86976,152512
train,1181,37,37888,152,29184,67072
train,1182,101,103424,1128,216576,320000
train,1183,262,268288,7587,1456704,1724992
train,1184,113,115712,1412,271104,386816
train,1185,147,150528,2389,458688,609216
train,1186,153,156672,2587,496704,653376
train,1187,178,182272,3502,672384,854656
train,1188,222,227328,5447,1045824,1273152
train,1189,119,121856,1565,300480,422336
train,1190,185,189440,3783,726336,915776
train,1191,159,162816,2794,536448,699264
train,1192,91,93184,916,175872,269056
train,1193,170,174080,3194,613248,787328
train,1194,153,156672,2588,496896,653568
train,1195,112,114688,1387,266304,380992
train,1196,104,106496,1196,229632,336128
train,1197,139,142336,2136,410112,552448
train,1198,118,120832,1539,295488,416320
train,1199,162,165888,2901,556992,722880
train,1200,99,101376,1084,208128,309504
train,1201,161,164864,2865,550080,714944
train,1202,122,124928,1645,315840,440768
train,1203,183,187392,3702,710784,898176
train,1204,157,160768,2725,523200,683968
train,1205,48,49152,255,48960,98112
train,1206,105,107520,1219,234048,341568
train,1207,102,104448,1150,220800,325248
train,1208,149,152576,2454,471168,623744
train,1209,164,167936,2973,570816,738752
train,1210,138,141312,2105,404160,545472
train,1211,103,105472,1173,225216,330688
train,1212,147,150528,2389,458688,609216
train,1213,238,243712,6261,1202112,1445824
train,1214,175,179200,3385,649920,829120
train,1215,94,96256,977,187584,283840
train,1216,111,113664,1362,261504,375168
train,1217,142,145408,2229,427968,573376
train,1218,163,166912,2937,563904,730816
train,1219,94,96256,977,187584,283840
train,1220,145,148480,2324,446208,594688
train,1221,231,236544,5898,1132416,1368960
train,1222,113,115712,1412,271104,386816
train,1223,131,134144,1897,364224,498368
train,1224,133,136192,1955,375360,511552
train,1225,49,50176,266,51072,101248
train,1226,146,149504,2356,452352,601856
train,1227,161,164864,2865,550080,714944
train,1228,229,234496,5796,1112832,1347328
train,1229,82,83968,744,142848,226816
train,1230,154,157696,2621,503232,660928
train,1231,72,73728,573,110016,183744
train,1232,165,168960,3009,577728,746688
train,1233,187,191488,3865,742080,933568
train,1234,145,148480,2324,446208,594688
train,1235,166,169984,3046,584832,754816
train,1236,65,66560,467,89664,156224
train,1237,136,139264,2045,392640,531904
train,1238,116,118784,1488,285696,404480
train,1239,109,111616,1313,252096,363712
train,1240,134,137216,1985,381120,518336
train,1241,142,145408,2229,427968,573376
train,1242,123,125952,1672,321024,446976
train,1243,85,87040,799,153408,240448
train,1244,106,108544,1242,238464,347008
train,1245,160,163840,2830,543360,707200
train,1246,112,114688,1387,266304,380992
train,1247,141,144384,2198,422016,566400
train,1248,45,46080,224,43008,89088
train,1249,136,139264,2045,392640,531904
train,1250,126,129024,1755,336960,465984
train,1251,56,57344,347,66624,123968
train,1252,240,245760,6366,1222272,1468032
train,1253,146,149504,2356,452352,601856
train,1254,79,80896,690,132480,213376
train,1255,146,149504,2356,452352,601856
train,1256,44,45056,214,41088,86144
train,1257,99,101376,1084,208128,309504
train,1258,97,99328,1040,199680,299008
train,1259,148,151552,2421,464832,616384
train,1260,133,136192,1955,375360,511552
train,1261,164,167936,2973,570816,738752
train,1262,150,153600,2487,477504,631104
train,1263,171,175104,3232,620544,795648
train,1264,129,132096,1840,353280,485376
train,1265,151,154624,2520,483840,638464
train,1266,111,113664,1362,261504,375168
train,1267,135,138240,2015,386880,525120
train,1268,171,175104,3232,620544,795648
train,1269,149,152576,2454,471168,623744
train,1270,80,81920,708,135936,217856
train,1271,125,128000,1727,331584,459584
train,1272,102,104448,1150,220800,325248
train,1273,139,142336,2136,410112,552448
train,1274,81,82944,725,139200,222144
train,1275,128,131072,1811,347712,478784
train,1276,85,87040,799,153408,240448
train,1277,133,136192,1955,375360,511552
train,1278,170,174080,3194,613248,787328
train,1279,127,130048,1783,342336,472384
train,1280,203,207872,4555,874560,1082432
train,1281,140,143360,2167,416064,559424
train,1282,115,117760,1462,280704,398464
train,1283,133,136192,1955,375360,511552
train,1284,98,100352,1062,203904,304256
train,1285,107,109568,1266,243072,352640
train,1286,190,194560,3990,766080,960640
train,1287,153,156672,2587,496704,653376
train,1288,66,67584,482,92544,160128
train,1289,115,117760,1462,280704,398464
train,1290,198,202752,4333,831936,1034688
train,1291,174,178176,3346,642432,820608
train,1292,52,53248,299,57408,110656
train,1293,139,142336,2136,410112,552448
train,1294,99,101376,1084,208128,309504
train,1295,112,114688,1387,266304,380992
train,1296,99,101376,1084,208128,309504
train,1297,115,117760,1462,280704,398464
train,1298,98,100352,1062,203904,304256
train,1299,142,145408,2229,427968,573376
train,1300,129,132096,1840,353280,485376
train,1301,110,112640,1338,256896,369536
train,1302,151,154624,2520,483840,638464
train,1303,130,133120,1868,358656,491776
train,1304,103,105472,1173,225216,330688
train,1305,173,177152,3308,635136,812288
train,1306,137,140288,2075,398400,538688
train,1307,81,82944,725,139200,222144
train,1308,74,75776,606,116352,192128
train,1309,126,129024,1755,336960,465984
train,1310,101,103424,1128,216576,320000
train,1311,203,207872,4555,874560,1082432
train,1312,216,221184,5157,990144,1211328
train,1313,122,124928,1645,315840,440768
train,1314,178,182272,3502,672384,854656
train,1315,188,192512,3907,750144,942656
train,1316,100,102400,1106,212352,314752
train,1317,225,230400,5595,1074240,1304640
train,1318,160,163840,2830,543360,707200
train,1319,234,239616,6052,1161984,1401600
train,1320,102,104448,1150,220800,325248
train,1321,161,164864,2865,550080,714944
train,1322,124,126976,1700,326400,453376
train,1323,101,103424,1128,216576,320000
train,1324,180,184320,3581,687552,871872
train,1325,100,102400,1106,212352,314752
train,1326,169,173056,3157,606144,779200
train,1327,145,148480,2324,446208,594688
train,1328,200,204800,4421,848832,1053632
train,1329,164,167936,2973,570816,738752
train,1330,166,169984,3046,584832,754816
train,1331,65,66560,467,89664,156224
train,1332,119,121856,1565,300480,422336
train,1333,235,240640,6104,1171968,1412608
train,1334,137,140288,2075,398400,538688
train,1335,122,124928,1645,315840,440768
train,1336,134,137216,1985,381120,518336
train,1337,162,165888,2901,556992,722880
train,1338,105,107520,1219,234048,341568
train,1339,172,176128,3270,627840,803968
train,1340,204,208896,4600,883200,1092096
train,1341,167,171008,3083,591936,762944
train,1342,111,113664,1362,261504,375168
train,1343,39,39936,168,32256,72192
train,1344,161,164864,2865,550080,714944
train,1345,131,134144,1897,364224,498368
train,1346,56,57344,347,66624,123968
train,1347,138,141312,2105,404160,545472
train,1348,135,138240,2015,386880,525120
train,1349,81,82944,725,139200,222144
train,1350,194,198656,4160,798720,997376
train,1351,108,110592,1289,247488,358080
train,1352,194,198656,4160,798720,997376
train,1353,45,46080,224,43008,89088
train,1354,148,151552,2421,464832,616384
train,1355,105,107520,1219,234048,341568
train,1356,198,202752,4333,831936,1034688
train,1357,168,172032,3120,599040,771072
train,1358,87,89088,837,160704,249792
train,1359,69,70656,527,101184,171840
train,1360,144,147456,2292,440064,587520
train,1361,162,165888,2901,556992,722880
train,1362,87,89088,837,160704,249792
train,1363,64,65536,453,86976,152512
train,1364,251,257024,6963,1336896,1593920
train,1365,146,149504,2356,452352,601856
train,1366,120,122880,1592,305664,428544
train,1367,109,111616,1313,252096,363712
train,1368,133,136192,1955,375360,511552
train,1369,56,57344,347,66624,123968
train,1370,130,133120,1868,358656,491776
train,1371,130,133120,1868,358656,491776
train,1372,236,241664,6156,1181952,1423616
train,1373,231,236544,5898,1132416,1368960
train,1374,105,107520,1219,234048,341568
train,1375,118,120832,1539,295488,416320
train,1376,176,180224,3424,657408,837632
train,1377,189,193536,3948,758016,951552
train,1378,154,157696,2621,503232,660928
train,1379,135,138240,2015,386880,525120
train,1380,146,149504,2356,452352,601856
train,1381,155,158720,2656,509952,668672
train,1382,102,104448,1150,220800,325248
train,1383,184,188416,3742,718464,906880
train,1384,115,117760,1462,280704,398464
train,1385,115,117760,1462,280704,398464
train,1386,108,110592,1289,247488,358080
train,1387,36,36864,144,27648,64512
train,1388,98,100352,1062,203904,304256
train,1389,169,173056,3157,606144,779200
train,1390,149,152576,2454,471168,623744
train,1391,187,191488,3865,742080,933568
train,1392,188,192512,3907,750144,942656
train,1393,63,64512,439,84288,148800
train,1394,142,145408,2229,427968,573376
train,1395,201,205824,4465,857280,1063104
train,1396,100,102400,1106,212352,314752
train,1397,180,184320,3581,687552,871872
train,1398,61,62464,412,79104,141568
train,1399,84,86016,780,149760,235776
train,1400,241,246784,6419,1232448,1479232
train,1401,77,78848,656,125952,204800
train,1402,204,208896,4600,883200,1092096
train,1403,202,206848,4510,865920,1072768
train,1404,61,62464,412,79104,141568
train,1405,175,179200,3385,649920,829120
train,1406,117,119808,1513,290496,410304
train,1407,195,199680,4203,806976,1006656
train,1408,161,164864,2865,550080,714944
train,1409,176,180224,3424,657408,837632
train,1410,155,158720,2656,509952,668672
train,1411,119,121856,1565,300480,422336
train,1412,87,89088,837,160704,249792
train,1413,106,108544,1242,238464,347008
train,1414,132,135168,1926,369792,504960
train,1415,162,165888,2901,556992,722880
train,1416,248,253952,6798,1305216,1559168
train,1417,136,139264,2045,392640,531904
train,1418,196,200704,4246,815232,1015936
train,1419,158,161792,2759,529728,691520
train,1420,172,176128,3270,627840,803968
train,1421,152,155648,2554,490368,646016
train,1422,223,228352,5496,1055232,1283584
train,1423,104,106496,1196,229632,336128
train,1424,158,161792,2759,529728,691520
train,1425,152,155648,2554,490368,646016
train,1426,183,187392,3702,710784,898176
train,1427,151,154624,2520,483840,638464
train,1428,106,108544,1242,238464,347008
train,1429,94,96256,977,187584,283840
train,1430,178,182272,3502,672384,854656
train,1431,131,134144,1897,364224,498368
train,1432,150,153600,2487,477504,631104
train,1433,190,194560,3990,766080,960640
train,1434,173,177152,3308,635136,812288
train,1435,119,121856,1565,300480,422336
train,1436,190,194560,3990,766080,960640
train,1437,209,214016,4828,926976,1140992
train,1438,174,178176,3346,642432,820608
train,1439,185,189440,3783,726336,915776
train,1440,100,102400,1106,212352,314752
train,1441,136,139264,2045,392640,531904
train,1442,195,199680,4203,806976,1006656
train,1443,166,169984,3046,584832,754816
train,1444,157,160768,2725,523200,683968
train,1445,56,57344,347,66624,123968
train,1446,179,183296,3541,679872,863168
train,1447,132,135168,1926,369792,504960
train,1448,104,106496,1196,229632,336128
train,1449,197,201728,4289,823488,1025216
train,1450,195,199680,4203,806976,1006656
train,1451,148,151552,2421,464832,616384
train,1452,172,176128,3270,627840,803968
train,1453,160,163840,2830,543360,707200
train,1454,136,139264,2045,392640,531904
train,1455,200,204800,4421,848832,1053632
train,1456,172,176128,3270,627840,803968
train,1457,217,222208,5205,999360,1221568
train,1458,142,145408,2229,427968,573376
train,1459,148,151552,2421,464832,616384
train,1460,206,210944,4690,900480,1111424
train,1461,134,137216,1985,381120,518336
train,1462,183,187392,3702,710784,898176
train,1463,110,112640,1338,256896,369536
train,1464,87,89088,837,160704,249792
train,1465,126,129024,1755,336960,465984
train,1466,229,234496,5796,1112832,1347328
train,1467,154,157696,2621,503232,660928
train,1468,161,164864,2865,550080,714944
train,1469,185,189440,3783,726336,915776
train,1470,87,89088,837,160704,249792
train,1471,52,53248,299,57408,110656
train,1472,174,178176,3346,642432,820608
train,1473,221,226304,5398,1036416,1262720
train,1474,174,178176,3346,642432,820608
train,1475,158,161792,2759,529728,691520
train,1476,177,181248,3463,664896,846144
train,1477,119,121856,1565,300480,422336
train,1478,102,104448,1150,220800,325248
train,1479,156,159744,2690,516480,676224
train,1480,108,110592,1289,247488,358080
train,1481,174,178176,3346,642432,820608
train,1482,203,207872,4555,874560,1082432
train,1483,165,168960,3009,577728,746688
train,1484,132,135168,1926,369792,504960
train,1485,145,148480,2324,446208,594688
train,1486,102,104448,1150,220800,325248
train,1487,123,125952,1672,321024,446976
train,1488,224,229376,5546,1064832,1294208
train,1489,126,129024,1755,336960,465984
train,1490,110,112640,1338,256896,369536
train,1491,140,143360,2167,416064,559424
train,1492,180,184320,3581,687552,871872
train,1493,92,94208,936,179712,273920
train,1494,136,139264,2045,392640,531904
train,1495,56,57344,347,66624,123968
train,1496,143,146432,2260,433920,580352
train,1497,208,212992,4782,918144,1131136
train,1498,194,198656,4160,798720,997376
train,1499,216,221184,5157,990144,1211328
train,1500,136,139264,2045,392640,531904
train,1501,141,144384,2198,422016,566400
train,1502,169,173056,3157,606144,779200
train,1503,194,198656,4160,798720,997376
train,1504,73,74752,589,113088,187840
train,1505,72,73728,573,110016,183744
train,1506,197,201728,4289,823488,1025216
train,1507,175,179200,3385,649920,829120
train,1508,167,171008,3083,591936,762944
train,1509,199,203776,4377,840384,1044160
train,1510,250,256000,6908,1326336,1582336
train,1511,154,157696,2621,503232,660928
train,1512,196,200704,4246,815232,1015936
train,1513,216,221184,5157,990144,1211328
train,1514,121,123904,1618,310656,434560
train,1515,149,152576,2454,471168,623744
train,1516,126,129024,1755,336960,465984
train,1517,203,207872,4555,874560,1082432
train,1518,71,72704,558,107136,179840
train,1519,49,50176,266,51072,101248
train,1520,125,128000,1727,331584,459584
train,1521,153,156672,2587,496704,653376
train,1522,167,171008,3083,591936,762944
train,1523,119,121856,1565,300480,422336
train,1524,143,146432,2260,433920,580352
train,1525,117,119808,1513,290496,410304
train,1526,67,68608,497,95424,164032
train,1527,161,164864,2865,550080,714944
train,1528,134,137216,1985,381120,518336
train,1529,146,149504,2356,452352,601856
train,1530,231,236544,5898,1132416,1368960
train,1531,168,172032,3120,599040,771072
train,1532,170,174080,3194,613248,787328
train,1533,127,130048,1783,342336,472384
train,1534,163,166912,2937,563904,730816
train,1535,162,165888,2901,556992,722880
train,1536,136,139264,2045,392640,531904
train,1537,171,175104,3232,620544,795648
train,1538,216,221184,5157,990144,1211328
train,1539,133,136192,1955,375360,511552
train,1540,120,122880,1592,305664,428544
train,1541,69,70656,527,101184,171840
train,1542,148,151552,2421,464832,616384
train,1543,81,82944,725,139200,222144
train,1544,182,186368,3661,702912,889280
train,1545,122,124928,1645,315840,440768
train,1546,187,191488,3865,742080,933568
train,1547,155,158720,2656,509952,668672
train,1548,189,193536,3948,758016,951552
train,1549,151,154624,2520,483840,638464
train,1550,213,218112,5014,962688,1180800
train,1551,211,216064,4921,944832,1160896
train,1552,213,218112,5014,962688,1180800
train,1553,129,132096,1840,353280,485376
train,1554,85,87040,799,153408,240448
train,1555,209,214016,4828,926976,1140992
train,1556,160,163840,2830,543360,707200
train,1557,216,221184,5157,990144,1211328
train,1558,141,144384,2198,422016,566400
train,1559,135,138240,2015,386880,525120
train,1560,166,169984,3046,584832,754816
train,1561,163,166912,2937,563904,730816
train,1562,161,164864,2865,550080,714944
train,1563,128,131072,1811,347712,478784
train,1564,80,81920,708,135936,217856
train,1565,178,182272,3502,672384,854656
train,1566,52,53248,299,57408,110656
train,1567,163,166912,2937,563904,730816
train,1568,144,147456,2292,440064,587520
train,1569,181,185344,3621,695232,880576
train,1570,182,186368,3661,702912,889280
train,1571,161,164864,2865,550080,714944
train,1572,131,134144,1897,364224,498368
train,1573,130,133120,1868,358656,491776
train,1574,118,120832,1539,295488,416320
train,1575,93,95232,956,183552,278784
train,1576,130,133120,1868,358656,491776
train,1577,177,181248,3463,664896,846144
train,1578,122,124928,1645,315840,440768
train,1579,69,70656,527,101184,171840
train,1580,95,97280,998,191616,288896
train,1581,182,186368,3661,702912,889280
train,1582,111,113664,1362,261504,375168
train,1583,116,118784,1488,285696,404480
train,1584,53,54272,311,59712,113984
train,1585,140,143360,2167,416064,559424
train,1586,101,103424,1128,216576,320000
train,1587,98,100352,1062,203904,304256
train,1588,197,201728,4289,823488,1025216
train,1589,94,96256,977,187584,283840
train,1590,191,195584,4032,774144,969728
train,1591,161,164864,2865,550080,714944
train,1592,168,172032,3120,599040,771072
train,1593,132,135168,1926,369792,504960
train,1594,133,136192,1955,375360,511552
train,1595,110,112640,1338,256896,369536
train,1596,95,97280,998,191616,288896
train,1597,92,94208,936,179712,273920
train,1598,111,113664,1362,261504,375168
train,1599,129,132096,1840,353280,485376
train,1600,160,163840,2830,543360,707200
train,1601,148,151552,2421,464832,616384
train,1602,83,84992,762,146304,231296
train,1603,188,192512,3907,750144,942656
train,1604,159,162816,2794,536448,699264
train,1605,147,150528,2389,458688,609216
train,1606,196,200704,4246,815232,1015936
train,1607,196,200704,4246,815232,1015936
train,1608,167,171008,3083,591936,762944
train,1609,130,133120,1868,358656,491776
train,1610,141,144384,2198,422016,566400
train,1611,119,121856,1565,300480,422336
train,1612,68,69632,511,98112,167744
train,1613,98,100352,1062,203904,304256
train,1614,215,220160,5109,980928,1201088
train,1615,139,142336,2136,410112,552448
train,1616,70,71680,542,104064,175744
train,1617,233,238592,6000,1152000,1390592
train,1618,234,239616,6052,1161984,1401600
train,1619,135,138240,2015,386880,525120
train,1620,139,142336,2136,410112,552448
train,1621,186,190464,3824,734208,924672
train,1622,151,154624,2520,483840,638464
train,1623,121,123904,1618,310656,434560
train,1624,166,169984,3046,584832,754816
train,1625,139,142336,2136,410112,552448
train,1626,171,175104,3232,620544,795648
train,1627,143,146432,2260,433920,580352
train,1628,105,107520,1219,234048,341568
train,1629,132,135168,1926,369792,504960
train,1630,198,202752,4333,831936,1034688
train,1631,72,73728,573,110016,183744
train,1632,125,128000,1727,331584,459584
train,1633,107,109568,1266,243072,352640
train,1634,203,207872,4555,874560,1082432
train,1635,52,53248,299,57408,110656
train,1636,112,114688,1387,266304,380992
train,1637,202,206848,4510,865920,1072768
train,1638,166,169984,3046,584832,754816
train,1639,146,149504,2356,452352,601856
train,1640,151,154624,2520,483840,638464
train,1641,141,144384,2198,422016,566400
train,1642,83,84992,762,146304,231296
train,1643,181,185344,3621,695232,880576
train,1644,128,131072,1811,347712,478784
train,1645,132,135168,1926,369792,504960
train,1646,201,205824,4465,857280,1063104
train,1647,66,67584,482,92544,160128
train,1648,179,183296,3541,679872,863168
train,1649,186,190464,3824,734208,924672
train,1650,98,100352,1062,203904,304256
train,1651,174,178176,3346,642432,820608
train,1652,101,103424,1128,216576,320000
train,1653,135,138240,2015,386880,525120
train,1654,212,217088,4967,953664,1170752
train,1655,136,139264,2045,392640,531904
train,1656,127,130048,1783,342336,472384
train,1657,170,174080,3194,613248,787328
train,1658,143,146432,2260,433920,580352
train,1659,100,102400,1106,212352,314752
train,1660,187,191488,3865,742080,933568
train,1661,68,69632,511,98112,167744
train,1662,104,106496,1196,229632,336128
train,1663,190,194560,3990,766080,960640
train,1664,146,149504,2356,452352,601856
train,1665,177,181248,3463,664896,846144
train,1666,178,182272,3502,672384,854656
train,1667,171,175104,3232,620544,795648
train,1668,112,114688,1387,266304,380992
train,1669,211,216064,4921,944832,1160896
train,1670,68,69632,511,98112,167744
train,1671,123,125952,1672,321024,446976
train,1672,138,141312,2105,404160,545472
train,1673,123,125952,1672,321024,446976
train,1674,118,120832,1539,295488,416320
train,1675,140,143360,2167,416064,559424
train,1676,159,162816,2794,536448,699264
train,1677,208,212992,4782,918144,1131136
train,1678,182,186368,3661,702912,889280
train,1679,40,40960,177,33984,74944
train,1680,60,61440,398,76416,137856
train,1681,48,49152,255,48960,98112
train,1682,137,140288,2075,398400,538688
train,1683,181,185344,3621,695232,880576
train,1684,143,146432,2260,433920,580352
train,1685,159,162816,2794,536448,699264
train,1686,233,238592,6000,1152000,1390592
train,1687,148,151552,2421,464832,616384
train,1688,146,149504,2356,452352,601856
train,1689,153,156672,2587,496704,653376
train,1690,139,142336,2136,410112,552448
train,1691,207,211968,4736,909312,1121280
train,1692,131,134144,1897,364224,498368
train,1693,169,173056,3157,606144,779200
train,1694,125,128000,1727,331584,459584
train,1695,49,50176,266,51072,101248
train,1696,42,43008,195,37440,80448
train,1697,110,112640,1338,256896,369536
train,1698,257,263168,7300,1401600,1664768
train,1699,172,176128,3270,627840,803968
train,1700,123,125952,1672,321024,446976
train,1701,176,180224,3424,657408,837632
train,1702,138,141312,2105,404160,545472
train,1703,174,178176,3346,642432,820608
train,1704,161,164864,2865,550080,714944
train,1705,164,167936,2973,570816,738752
train,1706,58,59392,372,71424,130816
train,1707,118,120832,1539,295488,416320
train,1708,67,68608,497,95424,164032
train,1709,157,160768,2725,523200,683968
train,1710,184,188416,3742,718464,906880
train,1711,117,119808,1513,290496,410304
train,1712,82,83968,744,142848,226816
train,1713,199,203776,4377,840384,1044160
train,1714,202,206848,4510,865920,1072768
train,1715,77,78848,656,125952,204800
train,1716,194,198656,4160,798720,997376
train,1717,115,117760,1462,280704,398464
train,1718,86,88064,818,157056,245120
train,1719,173,177152,3308,635136,812288
train,1720,202,206848,4510,865920,1072768
train,1721,152,155648,2554,490368,646016
train,1722,144,147456,2292,440064,587520
train,1723,198,202752,4333,831936,1034688
train,1724,156,159744,2690,516480,676224
train,1725,185,189440,3783,726336,915776
train,1726,163,166912,2937,563904,730816
train,1727,166,169984,3046,584832,754816
train,1728,122,124928,1645,315840,440768
train,1729,99,101376,1084,208128,309504
train,1730,127,130048,1783,342336,472384
train,1731,59,60416,385,73920,134336
train,1732,168,172032,3120,599040,771072
train,1733,178,182272,3502,672384,854656
train,1734,126,129024,1755,336960,465984
train,1735,78,79872,673,129216,209088
train,1736,153,156672,2587,496704,653376
train,1737,220,225280,5349,1027008,1252288
train,1738,173,177152,3308,635136,812288
train,1739,88,90112,856,164352,254464
train,1740,149,152576,2454,471168,623744
train,1741,180,184320,3581,687552,871872
train,1742,132,135168,1926,369792,504960
train,1743,179,183296,3541,679872,863168
train,1744,104,106496,1196,229632,336128
train,1745,132,135168,1926,369792,504960
train,1746,85,87040,799,153408,240448
train,1747,154,157696,2621,503232,660928
train,1748,181,185344,3621,695232,880576
train,1749,108,110592,1289,247488,358080
train,1750,197,201728,4289,823488,1025216
train,1751,110,112640,1338,256896,369536
train,1752,31,31744,107,20544,52288
train,1753,121,123904,1618,310656,434560
train,1754,153,156672,2587,496704,653376
train,1755,76,77824,639,122688,200512
train,1756,78,79872,673,129216,209088
train,1757,152,155648,2554,490368,646016
train,1758,114,116736,1437,275904,392640
train,1759,99,101376,1084,208128,309504
train,1760,177,181248,3463,664896,846144
train,1761,109,111616,1313,252096,363712
train,1762,83,84992,762,146304,231296
train,1763,114,116736,1437,275904,392640
train,1764,154,157696,2621,503232,660928
train,1765,80,81920,708,135936,217856
train,1766,159,162816,2794,536448,699264
train,1767,128,131072,1811,347712,478784
train,1768,195,199680,4203,806976,1006656
train,1769,128,131072,1811,347712,478784
train,1770,159,162816,2794,536448,699264
train,1771,177,181248,3463,664896,846144
train,1772,233,238592,6000,1152000,1390592
train,1773,227,232448,5695,1093440,1325888
train,1774,132,135168,1926,369792,504960
train,1775,94,96256,977,187584,283840
train,1776,156,159744,2690,516480,676224
train,1777,206,210944,4690,900480,1111424
train,1778,109,111616,1313,252096,363712
train,1779,197,201728,4289,823488,1025216
train,1780,87,89088,837,160704,249792
train,1781,148,151552,2421,464832,616384
train,1782,201,205824,4465,857280,1063104
train,1783,188,192512,3907,750144,942656
train,1784,94,96256,977,187584,283840
train,1785,179,183296,3541,679872,863168
train,1786,238,243712,6261,1202112,1445824
train,1787,101,103424,1128,216576,320000
train,1788,148,151552,2421,464832,616384
train,1789,192,196608,4075,782400,979008
train,1790,127,130048,1783,342336,472384
train,1791,130,133120,1868,358656,491776
train,1792,176,180224,3424,657408,837632
train,1793,135,138240,2015,386880,525120
train,1794,130,133120,1868,358656,491776
train,1795,107,109568,1266,243072,352640
train,1796,82,83968,744,142848,226816
train,1797,74,75776,606,116352,192128
train,1798,128,131072,1811,347712,478784
train,1799,189,193536,3948,758016,951552
train,1800,140,143360,2167,416064,559424
train,1801,175,179200,3385,649920,829120
train,1802,212,217088,4967,953664,1170752
train,1803,187,191488,3865,742080,933568
train,1804,199,203776,4377,840384,1044160
train,1805,125,128000,1727,331584,459584
train,1806,99,101376,1084,208128,309504
train,1807,143,146432,2260,433920,580352
train,1808,232,237568,5949,1142208,1379776
train,1809,56,57344,347,66624,123968
train,1810,159,162816,2794,536448,699264
train,1811,113,115712,1412,271104,386816
train,1812,183,187392,3702,710784,898176
train,1813,110,112640,1338,256896,369536
train,1814,84,86016,780,149760,235776
train,1815,115,117760,1462,280704,398464
train,1816,124,126976,1700,326400,453376
train,1817,96,98304,1019,195648,293952
train,1818,56,57344,347,66624,123968
train,1819,112,114688,1387,266304,380992
train,1820,64,65536,453,86976,152512
train,1821,189,193536,3948,758016,951552
train,1822,60,61440,398,76416,137856
train,1823,134,137216,1985,381120,518336
train,1824,168,172032,3120,599040,771072
train,1825,150,153600,2487,477504,631104
train,1826,175,179200,3385,649920,829120
train,1827,146,149504,2356,452352,601856
train,1828,76,77824,639,122688,200512
train,1829,170,174080,3194,613248,787328
train,1830,188,192512,3907,750144,942656
train,1831,151,154624,2520,483840,638464
train,1832,177,181248,3463,664896,846144
train,1833,113,115712,1412,271104,386816
train,1834,93,95232,956,183552,278784
train,1835,169,173056,3157,606144,779200
train,1836,183,187392,3702,710784,898176
train,1837,180,184320,3581,687552,871872
train,1838,190,194560,3990,766080,960640
train,1839,179,183296,3541,679872,863168
train,1840,91,93184,916,175872,269056
train,1841,128,131072,1811,347712,478784
train,1842,166,169984,3046,584832,754816
train,1843,188,192512,3907,750144,942656
train,1844,113,115712,1412,271104,386816
train,1845,132,135168,1926,369792,504960
train,1846,136,139264,2045,392640,531904
train,1847,137,140288,2075,398400,538688
train,1848,220,225280,5349,1027008,1252288
train,1849,199,203776,4377,840384,1044160
train,1850,117,119808,1513,290496,410304
train,1851,142,145408,2229,427968,573376
train,1852,132,135168,1926,369792,504960
train,1853,136,139264,2045,392640,531904
train,1854,142,145408,2229,427968,573376
train,1855,129,132096,1840,353280,485376
train,1856,171,175104,3232,620544,795648
train,1857,72,73728,573,110016,183744
train,1858,170,174080,3194,613248,787328
train,1859,145,148480,2324,446208,594688
train,1860,102,104448,1150,220800,325248
train,1861,166,169984,3046,584832,754816
train,1862,169,173056,3157,606144,779200
train,1863,154,157696,2621,503232,660928
train,1864,187,191488,3865,742080,933568
train,1865,128,131072,1811,347712,478784
train,1866,115,117760,1462,280704,398464
train,1867,196,200704,4246,815232,1015936
train,1868,114,116736,1437,275904,392640
train,1869,181,185344,3621,695232,880576
train,1870,54,55296,323,62016,117312
train,1871,125,128000,1727,331584,459584
train,1872,193,197632,4117,790464,988096
train,1873,173,177152,3308,635136,812288
train,1874,169,173056,3157,606144,779200
train,1875,191,195584,4032,774144,969728
train,1876,135,138240,2015,386880,525120
train,1877,127,130048,1783,342336,472384
train,1878,98,100352,1062,203904,304256
train,1879,37,37888,152,29184,67072
train,1880,152,155648,2554,490368,646016
train,1881,98,100352,1062,203904,304256
train,1882,97,99328,1040,199680,299008
train,1883,117,119808,1513,290496,410304
train,1884,99,101376,1084,208128,309504
train,1885,76,77824,639,122688,200512
train,1886,100,102400,1106,212352,314752
train,1887,109,111616,1313,252096,363712
train,1888,229,234496,5796,1112832,1347328
train,1889,63,64512,439,84288,148800
train,1890,163,166912,2937,563904,730816
train,1891,108,110592,1289,247488,358080
train,1892,150,153600,2487,477504,631104
train,1893,141,144384,2198,422016,566400
train,1894,116,118784,1488,285696,404480
train,1895,101,103424,1128,216576,320000
train,1896,103,105472,1173,225216,330688
train,1897,208,212992,4782,918144,1131136
train,1898,148,151552,2421,464832,616384
train,1899,165,168960,3009,577728,746688
train,1900,211,216064,4921,944832,1160896
train,1901,155,158720,2656,509952,668672
train,1902,150,153600,2487,477504,631104
train,1903,137,140288,2075,398400,538688
train,1904,153,156672,2587,496704,653376
train,1905,123,125952,1672,321024,446976
train,1906,196,200704,4246,815232,1015936
train,1907,194,198656,4160,798720,997376
train,1908,176,180224,3424,657408,837632
train,1909,162,165888,2901,556992,722880
train,1910,191,195584,4032,774144,969728
train,1911,117,119808,1513,290496,410304
train,1912,164,167936,2973,570816,738752
train,1913,202,206848,4510,865920,1072768
train,1914,222,227328,5447,1045824,1273152
train,1915,225,230400,5595,1074240,1304640
train,1916,211,216064,4921,944832,1160896
train,1917,181,185344,3621,695232,880576
train,1918,117,119808,1513,290496,410304
train,1919,70,71680,542,104064,175744
train,1920,128,131072,1811,347712,478784
train,1921,144,147456,2292,440064,587520
train,1922,99,101376,1084,208128,309504
train,1923,199,203776,4377,840384,1044160
train,1924,110,112640,1338,256896,369536
train,1925,116,118784,1488,285696,404480
train,1926,176,180224,3424,657408,837632
train,1927,216,221184,5157,990144,1211328
train,1928,139,142336,2136,410112,552448
train,1929,168,172032,3120,599040,771072
train,1930,129,132096,1840,353280,485376
train,1931,111,113664,1362,261504,375168
train,1932,222,227328,5447,1045824,1273152
train,1933,130,133120,1868,358656,491776
train,1934,175,179200,3385,649920,829120
train,1935,73,74752,589,113088,187840
train,1936,158,161792,2759,529728,691520
train,1937,125,128000,1727,331584,459584
train,1938,118,120832,1539,295488,416320
train,1939,98,100352,1062,203904,304256
train,1940,178,182272,3502,672384,854656
train,1941,100,102400,1106,212352,314752
train,1942,193,197632,4117,790464,988096
train,1943,227,232448,5695,1093440,1325888
train,1944,55,56320,335,64320,120640
train,1945,136,139264,2045,392640,531904
train,1946,48,49152,255,48960,98112
train,1947,71,72704,558,107136,179840
train,1948,198,202752,4333,831936,1034688
train,1949,173,177152,3308,635136,812288
train,1950,189,193536,3948,758016,951552
train,1951,71,72704,558,107136,179840
train,1952,141,144384,2198,422016,566400
train,1953,165,168960,3009,577728,746688
train,1954,208,212992,4782,918144,1131136
train,1955,50,51200,277,53184,104384
train,1956,186,190464,3824,734208,924672
train,1957,67,68608,497,95424,164032
train,1958,171,175104,3232,620544,795648
train,1959,146,149504,2356,452352,601856
train,1960,117,119808,1513,290496,410304
train,1961,191,195584,4032,774144,969728
train,1962,115,117760,1462,280704,398464
train,1963,128,131072,1811,347712,478784
train,1964,126,129024,1755,336960,465984
train,1965,110,112640,1338,256896,369536
train,1966,209,214016,4828,926976,1140992
train,1967,315,322560,10966,2105472,2428032
train,1968,79,80896,690,132480,213376
train,1969,115,117760,1462,280704,398464
train,1970,113,115712,1412,271104,386816
train,1971,108,110592,1289,247488,358080
train,1972,141,144384,2198,422016,566400
train,1973,62,63488,425,81600,145088
train,1974,66,67584,482,92544,160128
train,1975,88,90112,856,164352,254464
train,1976,122,124928,1645,315840,440768
train,1977,71,72704,558,107136,179840
train,1978,179,183296,3541,679872,863168
train,1979,191,195584,4032,774144,969728
train,1980,200,204800,4421,848832,1053632
train,1981,162,165888,2901,556992,722880
train,1982,204,208896,4600,883200,1092096
train,1983,90,92160,896,172032,264192
train,1984,162,165888,2901,556992,722880
train,1985,231,236544,5898,1132416,1368960
train,1986,139,142336,2136,410112,552448
train,1987,124,126976,1700,326400,453376
train,1988,102,104448,1150,220800,325248
train,1989,85,87040,799,153408,240448
train,1990,114,116736,1437,275904,392640
train,1991,78,79872,673,129216,209088
train,1992,201,205824,4465,857280,1063104
train,1993,107,109568,1266,243072,352640
train,1994,154,157696,2621,503232,660928
train,1995,127,130048,1783,342336,472384
train,1996,133,136192,1955,375360,511552
train,1997,101,103424,1128,216576,320000
train,1998,135,138240,2015,386880,525120
train,1999,197,201728,4289,823488,1025216
train,2000,111,113664,1362,261504,375168
train,2001,110,112640,1338,256896,369536
train,2002,215,220160,5109,980928,1201088
train,2003,125,128000,1727,331584,459584
train,2004,200,204800,4421,848832,1053632
train,2005,133,136192,1955,375360,511552
train,2006,149,152576,2454,471168,623744
train,2007,105,107520,1219,234048,341568
train,2008,79,80896,690,132480,213376
train,2009,176,180224,3424,657408,837632
train,2010,173,177152,3308,635136,812288
train,2011,170,174080,3194,613248,787328
train,2012,95,97280,998,191616,288896
train,2013,191,195584,4032,774144,969728
train,2014,119,121856,1565,300480,422336
train,2015,90,92160,896,172032,264192
train,2016,156,159744,2690,516480,676224
train,2017,53,54272,311,59712,113984
train,2018,50,51200,277,53184,104384
train,2019,138,141312,2105,404160,545472
train,2020,193,197632,4117,790464,988096
train,2021,198,202752,4333,831936,1034688
train,2022,114,116736,1437,275904,392640
train,2023,193,197632,4117,790464,988096
train,2024,123,125952,1672,321024,446976
train,2025,161,164864,2865,550080,714944
train,2026,180,184320,3581,687552,871872
train,2027,105,107520,1219,234048,341568
train,2028,190,194560,3990,766080,960640
train,2029,232,237568,5949,1142208,1379776
train,2030,176,180224,3424,657408,837632
train,2031,188,192512,3907,750144,942656
train,2032,33,33792,121,23232,57024
train,2033,68,69632,511,98112,167744
train,2034,268,274432,7938,1524096,1798528
train,2035,121,123904,1618,310656,434560
train,2036,225,230400,5595,1074240,1304640
train,2037,130,133120,1868,358656,491776
train,2038,155,158720,2656,509952,668672
train,2039,151,154624,2520,483840,638464
train,2040,95,97280,998,191616,288896
train,2041,124,126976,1700,326400,453376
train,2042,142,145408,2229,427968,573376
train,2043,117,119808,1513,290496,410304
train,2044,129,132096,1840,353280,485376
train,2045,68,69632,511,98112,167744
train,2046,110,112640,1338,256896,369536
train,2047,227,232448,5695,1093440,1325888
train,2048,127,130048,1783,342336,472384
train,2049,166,169984,3046,584832,754816
train,2050,121,123904,1618,310656,434560
train,2051,176,180224,3424,657408,837632
train,2052,134,137216,1985,381120,518336
train,2053,173,177152,3308,635136,812288
train,2054,195,199680,4203,806976,1006656
train,2055,57,58368,359,68928,127296
train,2056,189,193536,3948,758016,951552
train,2057,110,112640,1338,256896,369536
train,2058,99,101376,1084,208128,309504
train,2059,137,140288,2075,398400,538688
train,2060,210,215040,4874,935808,1150848
train,2061,124,126976,1700,326400,453376
train,2062,146,149504,2356,452352,601856
train,2063,129,132096,1840,353280,485376
train,2064,136,139264,2045,392640,531904
train,2065,79,80896,690,132480,213376
train,2066,102,104448,1150,220800,325248
train,2067,111,113664,1362,261504,375168
train,2068,190,194560,3990,766080,960640
train,2069,166,169984,3046,584832,754816
train,2070,150,153600,2487,477504,631104
train,2071,210,215040,4874,935808,1150848
train,2072,134,137216,1985,381120,518336
train,2073,142,145408,2229,427968,573376
train,2074,140,143360,2167,416064,559424
train,2075,64,65536,453,86976,152512
train,2076,85,87040,799,153408,240448
train,2077,180,184320,3581,687552,871872
train,2078,211,216064,4921,944832,1160896
train,2079,101,103424,1128,216576,320000
train,2080,90,92160,896,172032,264192
train,2081,258,264192,7357,1412544,1676736
train,2082,161,164864,2865,550080,714944
train,2083,91,93184,916,175872,269056
train,2084,182,186368,3661,702912,889280
train,2085,194,198656,4160,798720,997376
train,2086,90,92160,896,172032,264192
train,2087,105,107520,1219,234048,341568
train,2088,152,155648,2554,490368,646016
train,2089,195,199680,4203,806976,1006656
train,2090,128,131072,1811,347712,478784
train,2091,220,225280,5349,1027008,1252288
train,2092,91,93184,916,175872,269056
train,2093,113,115712,1412,271104,386816
train,2094,161,164864,2865,550080,714944
train,2095,171,175104,3232,620544,795648
train,2096,158,161792,2759,529728,691520
train,2097,180,184320,3581,687552,871872
train,2098,155,158720,2656,509952,668672
train,2099,165,168960,3009,577728,746688
train,2100,137,140288,2075,398400,538688
train,2101,71,72704,558,107136,179840
train,2102,99,101376,1084,208128,309504
train,2103,87,89088,837,160704,249792
train,2104,172,176128,3270,627840,803968
train,2105,144,147456,2292,440064,587520
train,2106,171,175104,3232,620544,795648
train,2107,112,114688,1387,266304,380992
train,2108,127,130048,1783,342336,472384
train,2109,165,168960,3009,577728,746688
train,2110,91,93184,916,175872,269056
train,2111,96,98304,1019,195648,293952
train,2112,149,152576,2454,471168,623744
train,2113,115,117760,1462,280704,398464
train,2114,131,134144,1897,364224,498368
train,2115,131,134144,1897,364224,498368
train,2116,115,117760,1462,280704,398464
train,2117,177,181248,3463,664896,846144
train,2118,156,159744,2690,516480,676224
train,2119,169,173056,3157,606144,779200
train,2120,187,191488,3865,742080,933568
train,2121,157,160768,2725,523200,683968
train,2122,140,143360,2167,416064,559424
train,2123,55,56320,335,64320,120640
train,2124,104,106496,1196,229632,336128
train,2125,165,168960,3009,577728,746688
train,2126,183,187392,3702,710784,898176
train,2127,62,63488,425,81600,145088
train,2128,82,83968,744,142848,226816
train,2129,121,123904,1618,310656,434560
train,2130,103,105472,1173,225216,330688
train,2131,79,80896,690,132480,213376
train,2132,170,174080,3194,613248,787328
train,2133,155,158720,2656,509952,668672
train,2134,77,78848,656,125952,204800
train,2135,162,165888,2901,556992,722880
train,2136,95,97280,998,191616,288896
train,2137,176,180224,3424,657408,837632
train,2138,173,177152,3308,635136,812288
train,2139,122,124928,1645,315840,440768
train,2140,173,177152,3308,635136,812288
train,2141,84,86016,780,149760,235776
train,2142,66,67584,482,92544,160128
train,2143,166,169984,3046,584832,754816
train,2144,157,160768,2725,523200,683968
train,2145,168,172032,3120,599040,771072
train,2146,184,188416,3742,718464,906880
train,2147,89,91136,876,168192,259328
train,2148,89,91136,876,168192,259328
train,2149,180,184320,3581,687552,871872
train,2150,124,126976,1700,326400,453376
train,2151,58,59392,372,71424,130816
train,2152,72,73728,573,110016,183744
train,2153,105,107520,1219,234048,341568
train,2154,143,146432,2260,433920,580352
train,2155,257,263168,7300,1401600,1664768
train,2156,82,83968,744,142848,226816
train,2157,89,91136,876,168192,259328
train,2158,186,190464,3824,734208,924672
train,2159,139,142336,2136,410112,552448
train,2160,97,99328,1040,199680,299008
train,2161,143,146432,2260,433920,580352
train,2162,159,162816,2794,536448,699264
train,2163,113,115712,1412,271104,386816
train,2164,112,114688,1387,266304,380992
train,2165,66,67584,482,92544,160128
train,2166,67,68608,497,95424,164032
train,2167,133,136192,1955,375360,511552
train,2168,113,115712,1412,271104,386816
train,2169,165,168960,3009,577728,746688
train,2170,101,103424,1128,216576,320000
train,2171,149,152576,2454,471168,623744
train,2172,97,99328,1040,199680,299008
train,2173,112,114688,1387,266304,380992
train,2174,92,94208,936,179712,273920
train,2175,145,148480,2324,446208,594688
train,2176,131,134144,1897,364224,498368
train,2177,277,283648,8480,1628160,1911808
train,2178,163,166912,2937,563904,730816
train,2179,145,148480,2324,446208,594688
train,2180,138,141312,2105,404160,545472
train,2181,133,136192,1955,375360,511552
train,2182,146,149504,2356,452352,601856
train,2183,151,154624,2520,483840,638464
train,2184,137,140288,2075,398400,538688
train,2185,82,83968,744,142848,226816
train,2186,167,171008,3083,591936,762944
train,2187,148,151552,2421,464832,616384
train,2188,79,80896,690,132480,213376
train,2189,193,197632,4117,790464,988096
train,2190,102,104448,1150,220800,325248
train,2191,142,145408,2229,427968,573376
train,2192,118,120832,1539,295488,416320
train,2193,178,182272,3502,672384,854656
train,2194,178,182272,3502,672384,854656
train,2195,215,220160,5109,980928,1201088
train,2196,153,156672,2587,496704,653376
train,2197,86,88064,818,157056,245120
train,2198,104,106496,1196,229632,336128
train,2199,137,140288,2075,398400,538688
train,2200,131,134144,1897,364224,498368
train,2201,198,202752,4333,831936,1034688
train,2202,151,154624,2520,483840,638464
train,2203,203,207872,4555,874560,1082432
train,2204,155,158720,2656,509952,668672
train,2205,149,152576,2454,471168,623744
train,2206,132,135168,1926,369792,504960
train,2207,73,74752,589,113088,187840
train,2208,150,153600,2487,477504,631104
train,2209,219,224256,5301,1017792,1242048
train,2210,118,120832,1539,295488,416320
train,2211,157,160768,2725,523200,683968
train,2212,113,115712,1412,271104,386816
train,2213,141,144384,2198,422016,566400
train,2214,144,147456,2292,440064,587520
train,2215,120,122880,1592,305664,428544
train,2216,227,232448,5695,1093440,1325888
train,2217,121,123904,1618,310656,434560
train,2218,176,180224,3424,657408,837632
train,2219,180,184320,3581,687552,871872
train,2220,184,188416,3742,718464,906880
train,2221,199,203776,4377,840384,1044160
train,2222,53,54272,311,59712,113984
train,2223,143,146432,2260,433920,580352
train,2224,197,201728,4289,823488,1025216
train,2225,174,178176,3346,642432,820608
train,2226,154,157696,2621,503232,660928
train,2227,61,62464,412,79104,141568
train,2228,154,157696,2621,503232,660928
train,2229,136,139264,2045,392640,531904
train,2230,167,171008,3083,591936,762944
train,2231,119,121856,1565,300480,422336
train,2232,52,53248,299,57408,110656
train,2233,160,163840,2830,543360,707200
train,2234,187,191488,3865,742080,933568
train,2235,69,70656,527,101184,171840
train,2236,203,207872,4555,874560,1082432
train,2237,80,81920,708,135936,217856
train,2238,115,117760,1462,280704,398464
train,2239,106,108544,1242,238464,347008
train,2240,127,130048,1783,342336,472384
train,2241,103,105472,1173,225216,330688
train,2242,128,131072,1811,347712,478784
train,2243,145,148480,2324,446208,594688
train,2244,117,119808,1513,290496,410304
train,2245,187,191488,3865,742080,933568
train,2246,126,129024,1755,336960,465984
train,2247,143,146432,2260,433920,580352
train,2248,183,187392,3702,710784,898176
train,2249,118,120832,1539,295488,416320
train,2250,238,243712,6261,1202112,1445824
train,2251,61,62464,412,79104,141568
train,2252,105,107520,1219,234048,341568
train,2253,103,105472,1173,225216,330688
train,2254,191,195584,4032,774144,969728
train,2255,192,196608,4075,782400,979008
train,2256,149,152576,2454,471168,623744
train,2257,200,204800,4421,848832,1053632
train,2258,141,144384,2198,422016,566400
train,2259,183,187392,3702,710784,898176
train,2260,118,120832,1539,295488,416320
train,2261,185,189440,3783,726336,915776
train,2262,202,206848,4510,865920,1072768
train,2263,90,92160,896,172032,264192
train,2264,135,138240,2015,386880,525120
train,2265,137,140288,2075,398400,538688
train,2266,263,269312,7645,1467840,1737152
train,2267,139,142336,2136,410112,552448
train,2268,88,90112,856,164352,254464
train,2269,88,90112,856,164352,254464
train,2270,138,141312,2105,404160,545472
train,2271,144,147456,2292,440064,587520
train,2272,129,132096,1840,353280,485376
train,2273,51,52224,288,55296,107520
train,2274,174,178176,3346,642432,820608
train,2275,166,169984,3046,584832,754816
train,2276,182,186368,3661,702912,889280
train,2277,164,167936,2973,570816,738752
train,2278,236,241664,6156,1181952,1423616
train,2279,145,148480,2324,446208,594688
train,2280,164,167936,2973,570816,738752
train,2281,207,211968,4736,909312,1121280
train,2282,159,162816,2794,536448,699264
train,2283,196,200704,4246,815232,1015936
train,2284,100,102400,1106,212352,314752
train,2285,246,251904,6688,1284096,1536000
train,2286,124,126976,1700,326400,453376
train,2287,159,162816,2794,536448,699264
train,2288,125,128000,1727,331584,459584
train,2289,98,100352,1062,203904,304256
train,2290,36,36864,144,27648,64512
train,2291,182,186368,3661,702912,889280
train,2292,67,68608,497,95424,164032
train,2293,130,133120,1868,358656,491776
train,2294,172,176128,3270,627840,803968
train,2295,72,73728,573,110016,183744
train,2296,153,156672,2587,496704,653376
train,2297,112,114688,1387,266304,380992
train,2298,142,145408,2229,427968,573376
train,2299,138,141312,2105,404160,545472
train,2300,125,128000,1727,331584,459584
train,2301,134,137216,1985,381120,518336
train,2302,99,101376,1084,208128,309504
train,2303,139,142336,2136,410112,552448
train,2304,200,204800,4421,848832,1053632
train,2305,145,148480,2324,446208,594688
train,2306,229,234496,5796,1112832,1347328
train,2307,75,76800,622,119424,196224
train,2308,116,118784,1488,285696,404480
train,2309,145,148480,2324,446208,594688
train,2310,175,179200,3385,649920,829120
train,2311,123,125952,1672,321024,446976
train,2312,161,164864,2865,550080,714944
train,2313,152,155648,2554,490368,646016
train,2314,166,169984,3046,584832,754816
train,2315,180,184320,3581,687552,871872
train,2316,143,146432,2260,433920,580352
train,2317,129,132096,1840,353280,485376
train,2318,114,116736,1437,275904,392640
train,2319,135,138240,2015,386880,525120
train,2320,97,99328,1040,199680,299008
train,2321,164,167936,2973,570816,738752
train,2322,172,176128,3270,627840,803968
train,2323,124,126976,1700,326400,453376
train,2324,141,144384,2198,422016,566400
train,2325,123,125952,1672,321024,446976
train,2326,167,171008,3083,591936,762944
train,2327,181,185344,3621,695232,880576
train,2328,115,117760,1462,280704,398464
train,2329,137,140288,2075,398400,538688
train,2330,76,77824,639,122688,200512
train,2331,89,91136,876,168192,259328
train,2332,159,162816,2794,536448,699264
train,2333,122,124928,1645,315840,440768
train,2334,151,154624,2520,483840,638464
train,2335,129,132096,1840,353280,485376
train,2336,203,207872,4555,874560,1082432
train,2337,183,187392,3702,710784,898176
train,2338,217,222208,5205,999360,1221568
train,2339,119,121856,1565,300480,422336
train,2340,143,146432,2260,433920,580352
train,2341,196,200704,4246,815232,1015936
train,2342,147,150528,2389,458688,609216
train,2343,166,169984,3046,584832,754816
train,2344,100,102400,1106,212352,314752
train,2345,126,129024,1755,336960,465984
train,2346,139,142336,2136,410112,552448
train,2347,170,174080,3194,613248,787328
train,2348,87,89088,837,160704,249792
train,2349,104,106496,1196,229632,336128
train,2350,148,151552,2421,464832,616384
train,2351,178,182272,3502,672384,854656
train,2352,202,206848,4510,865920,1072768
train,2353,69,70656,527,101184,171840
train,2354,128,131072,1811,347712,478784
train,2355,79,80896,690,132480,213376
train,2356,106,108544,1242,238464,347008
train,2357,183,187392,3702,710784,898176
train,2358,119,121856,1565,300480,422336
train,2359,127,130048,1783,342336,472384
train,2360,95,97280,998,191616,288896
train,2361,204,208896,4600,883200,1092096
train,2362,159,162816,2794,536448,699264
train,2363,94,96256,977,187584,283840
train,2364,197,201728,4289,823488,1025216
train,2365,101,103424,1128,216576,320000
train,2366,202,206848,4510,865920,1072768
train,2367,199,203776,4377,840384,1044160
train,2368,137,140288,2075,398400,538688
train,2369,169,173056,3157,606144,779200
train,2370,170,174080,3194,613248,787328
train,2371,146,149504,2356,452352,601856
train,2372,95,97280,998,191616,288896
train,2373,187,191488,3865,742080,933568
train,2374,185,189440,3783,726336,915776
train,2375,199,203776,4377,840384,1044160
train,2376,122,124928,1645,315840,440768
train,2377,123,125952,1672,321024,446976
train,2378,81,82944,725,139200,222144
train,2379,132,135168,1926,369792,504960
train,2380,165,168960,3009,577728,746688
train,2381,132,135168,1926,369792,504960
train,2382,74,75776,606,116352,192128
train,2383,198,202752,4333,831936,1034688
train,2384,92,94208,936,179712,273920
train,2385,188,192512,3907,750144,942656
train,2386,134,137216,1985,381120,518336
train,2387,57,58368,359,68928,127296
train,2388,77,78848,656,125952,204800
train,2389,116,118784,1488,285696,404480
train,2390,169,173056,3157,606144,779200
train,2391,39,39936,168,32256,72192
train,2392,86,88064,818,157056,245120
train,2393,141,144384,2198,422016,566400
train,2394,126,129024,1755,336960,465984
train,2395,106,108544,1242,238464,347008
train,2396,97,99328,1040,199680,299008
train,2397,135,138240,2015,386880,525120
train,2398,117,119808,1513,290496,410304
train,2399,133,136192,1955,375360,511552
train,2400,119,121856,1565,300480,422336
train,2401,117,119808,1513,290496,410304
train,2402,154,157696,2621,503232,660928
train,2403,152,155648,2554,490368,646016
train,2404,172,176128,3270,627840,803968
train,2405,124,126976,1700,326400,453376
train,2406,63,64512,439,84288,148800
train,2407,149,152576,2454,471168,623744
train,2408,92,94208,936,179712,273920
train,2409,160,163840,2830,543360,707200
train,2410,84,86016,780,149760,235776
train,2411,125,128000,1727,331584,459584
train,2412,138,141312,2105,404160,545472
train,2413,164,167936,2973,570816,738752
train,2414,148,151552,2421,464832,616384
train,2415,182,186368,3661,702912,889280
train,2416,136,139264,2045,392640,531904
train,2417,129,132096,1840,353280,485376
train,2418,181,185344,3621,695232,880576
train,2419,154,157696,2621,503232,660928
train,2420,188,192512,3907,750144,942656
train,2421,132,135168,1926,369792,504960
train,2422,146,149504,2356,452352,601856
train,2423,257,263168,7300,1401600,1664768
train,2424,202,206848,4510,865920,1072768
train,2425,111,113664,1362,261504,375168
train,2426,181,185344,3621,695232,880576
train,2427,149,152576,2454,471168,623744
train,2428,133,136192,1955,375360,511552
train,2429,32,32768,114,21888,54656
train,2430,150,153600,2487,477504,631104
train,2431,92,94208,936,179712,273920
train,2432,145,148480,2324,446208,594688
train,2433,199,203776,4377,840384,1044160
train,2434,192,196608,4075,782400,979008
train,2435,95,97280,998,191616,288896
train,2436,176,180224,3424,657408,837632
train,2437,129,132096,1840,353280,485376
train,2438,120,122880,1592,305664,428544
train,2439,91,93184,916,175872,269056
train,2440,159,162816,2794,536448,699264
train,2441,132,135168,1926,369792,504960
train,2442,116,118784,1488,285696,404480
train,2443,155,158720,2656,509952,668672
train,2444,134,137216,1985,381120,518336
train,2445,62,63488,425,81600,145088
train,2446,96,98304,1019,195648,293952
train,2447,101,103424,1128,216576,320000
train,2448,106,108544,1242,238464,347008
train,2449,195,199680,4203,806976,1006656
train,2450,124,126976,1700,326400,453376
train,2451,129,132096,1840,353280,485376
train,2452,123,125952,1672,321024,446976
train,2453,206,210944,4690,900480,1111424
train,2454,160,163840,2830,543360,707200
train,2455,133,136192,1955,375360,511552
train,2456,135,138240,2015,386880,525120
train,2457,174,178176,3346,642432,820608
train,2458,98,100352,1062,203904,304256
train,2459,149,152576,2454,471168,623744
train,2460,95,97280,998,191616,288896
train,2461,130,133120,1868,358656,491776
train,2462,141,144384,2198,422016,566400
train,2463,192,196608,4075,782400,979008
train,2464,151,154624,2520,483840,638464
train,2465,97,99328,1040,199680,299008
train,2466,202,206848,4510,865920,1072768
train,2467,138,141312,2105,404160,545472
train,2468,67,68608,497,95424,164032
train,2469,166,169984,3046,584832,754816
train,2470,100,102400,1106,212352,314752
train,2471,95,97280,998,191616,288896
train,2472,87,89088,837,160704,249792
train,2473,50,51200,277,53184,104384
train,2474,159,162816,2794,536448,699264
train,2475,111,113664,1362,261504,375168
train,2476,209,214016,4828,926976,1140992
train,2477,158,161792,2759,529728,691520
train,2478,128,131072,1811,347712,478784
train,2479,99,101376,1084,208128,309504
train,2480,179,183296,3541,679872,863168
train,2481,139,142336,2136,410112,552448
train,2482,144,147456,2292,440064,587520
train,2483,116,118784,1488,285696,404480
train,2484,165,168960,3009,577728,746688
train,2485,80,81920,708,135936,217856
train,2486,56,57344,347,66624,123968
train,2487,110,112640,1338,256896,369536
train,2488,129,132096,1840,353280,485376
train,2489,168,172032,3120,599040,771072
train,2490,108,110592,1289,247488,358080
train,2491,193,197632,4117,790464,988096
train,2492,101,103424,1128,216576,320000
train,2493,45,46080,224,43008,89088
train,2494,92,94208,936,179712,273920
train,2495,130,133120,1868,358656,491776
train,2496,162,165888,2901,556992,722880
train,2497,65,66560,467,89664,156224
train,2498,147,150528,2389,458688,609216
train,2499,161,164864,2865,550080,714944
train,2500,187,191488,3865,742080,933568
train,2501,87,89088,837,160704,249792
train,2502,148,151552,2421,464832,616384
train,2503,117,119808,1513,290496,410304
train,2504,163,166912,2937,563904,730816
train,2505,139,142336,2136,410112,552448
train,2506,145,148480,2324,446208,594688
train,2507,128,131072,1811,347712,478784
train,2508,139,142336,2136,410112,552448
train,2509,69,70656,527,101184,171840
train,2510,113,115712,1412,271104,386816
train,2511,187,191488,3865,742080,933568
train,2512,126,129024,1755,336960,465984
train,2513,85,87040,799,153408,240448
train,2514,253,259072,7075,1358400,1617472
train,2515,155,158720,2656,509952,668672
train,2516,179,183296,3541,679872,863168
train,2517,253,259072,7075,1358400,1617472
train,2518,156,159744,2690,516480,676224
train,2519,72,73728,573,110016,183744
train,2520,72,73728,573,110016,183744
train,2521,157,160768,2725,523200,683968
train,2522,189,193536,3948,758016,951552
train,2523,110,112640,1338,256896,369536
train,2524,113,115712,1412,271104,386816
train,2525,196,200704,4246,815232,1015936
train,2526,60,61440,398,76416,137856
train,2527,170,174080,3194,613248,787328
train,2528,82,83968,744,142848,226816
train,2529,116,118784,1488,285696,404480
train,2530,140,143360,2167,416064,559424
train,2531,115,117760,1462,280704,398464
train,2532,141,144384,2198,422016,566400
train,2533,78,79872,673,129216,209088
train,2534,130,133120,1868,358656,491776
train,2535,52,53248,299,57408,110656
train,2536,60,61440,398,76416,137856
train,2537,109,111616,1313,252096,363712
train,2538,140,143360,2167,416064,559424
train,2539,62,63488,425,81600,145088
train,2540,46,47104,234,44928,92032
train,2541,142,145408,2229,427968,573376
train,2542,118,120832,1539,295488,416320
train,2543,157,160768,2725,523200,683968
train,2544,147,150528,2389,458688,609216
train,2545,122,124928,1645,315840,440768
train,2546,173,177152,3308,635136,812288
train,2547,141,144384,2198,422016,566400
train,2548,154,157696,2621,503232,660928
train,2549,69,70656,527,101184,171840
train,2550,155,158720,2656,509952,668672
train,2551,161,164864,2865,550080,714944
train,2552,79,80896,690,132480,213376
train,2553,182,186368,3661,702912,889280
train,2554,108,110592,1289,247488,358080
train,2555,196,200704,4246,815232,1015936
train,2556,151,154624,2520,483840,638464
train,2557,85,87040,799,153408,240448
train,2558,169,173056,3157,606144,779200
train,2559,92,94208,936,179712,273920
train,2560,91,93184,916,175872,269056
train,2561,159,162816,2794,536448,699264
train,2562,144,147456,2292,440064,587520
train,2563,130,133120,1868,358656,491776
train,2564,48,49152,255,48960,98112
train,2565,99,101376,1084,208128,309504
train,2566,63,64512,439,84288,148800
train,2567,154,157696,2621,503232,660928
train,2568,132,135168,1926,369792,504960
train,2569,122,124928,1645,315840,440768
train,2570,191,195584,4032,774144,969728
train,2571,197,201728,4289,823488,1025216
train,2572,133,136192,1955,375360,511552
train,2573,180,184320,3581,687552,871872
train,2574,132,135168,1926,369792,504960
train,2575,219,224256,5301,1017792,1242048
train,2576,163,166912,2937,563904,730816
train,2577,111,113664,1362,261504,375168
train,2578,88,90112,856,164352,254464
train,2579,134,137216,1985,381120,518336
train,2580,106,108544,1242,238464,347008
train,2581,123,125952,1672,321024,446976
train,2582,117,119808,1513,290496,410304
train,2583,172,176128,3270,627840,803968
train,2584,153,156672,2587,496704,653376
train,2585,157,160768,2725,523200,683968
train,2586,158,161792,2759,529728,691520
train,2587,185,189440,3783,726336,915776
train,2588,199,203776,4377,840384,1044160
train,2589,83,84992,762,146304,231296
train,2590,104,106496,1196,229632,336128
train,2591,131,134144,1897,364224,498368
train,2592,187,191488,3865,742080,933568
train,2593,142,145408,2229,427968,573376
train,2594,221,226304,5398,1036416,1262720
train,2595,170,174080,3194,613248,787328
train,2596,204,208896,4600,883200,1092096
train,2597,232,237568,5949,1142208,1379776
train,2598,140,143360,2167,416064,559424
train,2599,163,166912,2937,563904,730816
train,2600,122,124928,1645,315840,440768
train,2601,126,129024,1755,336960,465984
train,2602,134,137216,1985,381120,518336
train,2603,75,76800,622,119424,196224
train,2604,192,196608,4075,782400,979008
train,2605,179,183296,3541,679872,863168
train,2606,163,166912,2937,563904,730816
train,2607,108,110592,1289,247488,358080
train,2608,68,69632,511,98112,167744
train,2609,145,148480,2324,446208,594688
train,2610,107,109568,1266,243072,352640
train,2611,104,106496,1196,229632,336128
train,2612,183,187392,3702,710784,898176
train,2613,136,139264,2045,392640,531904
train,2614,178,182272,3502,672384,854656
train,2615,144,147456,2292,440064,587520
train,2616,215,220160,5109,980928,1201088
train,2617,62,63488,425,81600,145088
train,2618,95,97280,998,191616,288896
train,2619,151,154624,2520,483840,638464
train,2620,160,163840,2830,543360,707200
train,2621,150,153600,2487,477504,631104
train,2622,118,120832,1539,295488,416320
train,2623,183,187392,3702,710784,898176
train,2624,134,137216,1985,381120,518336
train,2625,202,206848,4510,865920,1072768
train,2626,173,177152,3308,635136,812288
train,2627,124,126976,1700,326400,453376
train,2628,213,218112,5014,962688,1180800
train,2629,231,236544,5898,1132416,1368960
train,2630,162,165888,2901,556992,722880
train,2631,168,172032,3120,599040,771072
train,2632,169,173056,3157,606144,779200
train,2633,101,103424,1128,216576,320000
train,2634,107,109568,1266,243072,352640
train,2635,142,145408,2229,427968,573376
train,2636,116,118784,1488,285696,404480
train,2637,173,177152,3308,635136,812288
train,2638,244,249856,6580,1263360,1513216
train,2639,78,79872,673,129216,209088
train,2640,162,165888,2901,556992,722880
train,2641,204,208896,4600,883200,1092096
train,2642,55,56320,335,64320,120640
train,2643,138,141312,2105,404160,545472
train,2644,158,161792,2759,529728,691520
train,2645,197,201728,4289,823488,1025216
train,2646,72,73728,573,110016,183744
train,2647,103,105472,1173,225216,330688
train,2648,110,112640,1338,256896,369536
train,2649,188,192512,3907,750144,942656
train,2650,112,114688,1387,266304,380992
train,2651,120,122880,1592,305664,428544
train,2652,122,124928,1645,315840,440768
train,2653,112,114688,1387,266304,380992
train,2654,178,182272,3502,672384,854656
train,2655,138,141312,2105,404160,545472
train,2656,170,174080,3194,613248,787328
train,2657,113,115712,1412,271104,386816
train,2658,95,97280,998,191616,288896
train,2659,54,55296,323,62016,117312
train,2660,110,112640,1338,256896,369536
train,2661,178,182272,3502,672384,854656
train,2662,116,118784,1488,285696,404480
train,2663,165,168960,3009,577728,746688
train,2664,171,175104,3232,620544,795648
train,2665,90,92160,896,172032,264192
train,2666,100,102400,1106,212352,314752
train,2667,164,167936,2973,570816,738752
train,2668,137,140288,2075,398400,538688
train,2669,123,125952,1672,321024,446976
train,2670,151,154624,2520,483840,638464
train,2671,144,147456,2292,440064,587520
train,2672,114,116736,1437,275904,392640
train,2673,101,103424,1128,216576,320000
train,2674,135,138240,2015,386880,525120
train,2675,92,94208,936,179712,273920
train,2676,133,136192,1955,375360,511552
train,2677,88,90112,856,164352,254464
train,2678,165,168960,3009,577728,746688
train,2679,122,124928,1645,315840,440768
train,2680,95,97280,998,191616,288896
train,2681,129,132096,1840,353280,485376
train,2682,160,163840,2830,543360,707200
train,2683,146,149504,2356,452352,601856
train,2684,163,166912,2937,563904,730816
validation,0,97,99328,1040,199680,299008
validation,1,78,79872,673,129216,209088
validation,2,86,88064,818,157056,245120
validation,3,96,98304,1019,195648,293952
validation,4,155,158720,2656,509952,668672
validation,5,209,214016,4828,926976,1140992
validation,6,253,259072,7075,1358400,1617472
validation,7,193,197632,4117,790464,988096
validation,8,164,167936,2973,570816,738752
validation,9,158,161792,2759,529728,691520
validation,10,177,181248,3463,664896,846144
validation,11,131,134144,1897,364224,498368
validation,12,81,82944,725,139200,222144
validation,13,129,132096,1840,353280,485376
validation,14,208,212992,4782,918144,1131136
validation,15,211,216064,4921,944832,1160896
validation,16,150,153600,2487,477504,631104
validation,17,164,167936,2973,570816,738752
validation,18,199,203776,4377,840384,1044160
validation,19,170,174080,3194,613248,787328
validation,20,113,115712,1412,271104,386816
validation,21,149,152576,2454,471168,623744
validation,22,204,208896,4600,883200,1092096
validation,23,144,147456,2292,440064,587520
validation,24,120,122880,1592,305664,428544
validation,25,173,177152,3308,635136,812288
validation,26,101,103424,1128,216576,320000
validation,27,49,50176,266,51072,101248
validation,28,121,123904,1618,310656,434560
validation,29,122,124928,1645,315840,440768
validation,30,192,196608,4075,782400,979008
validation,31,144,147456,2292,440064,587520
validation,32,147,150528,2389,458688,609216
validation,33,170,174080,3194,613248,787328
validation,34,190,194560,3990,766080,960640
validation,35,56,57344,347,66624,123968
validation,36,106,108544,1242,238464,347008
validation,37,114,116736,1437,275904,392640
validation,38,138,141312,2105,404160,545472
validation,39,171,175104,3232,620544,795648
validation,40,155,158720,2656,509952,668672
validation,41,160,163840,2830,543360,707200
validation,42,167,171008,3083,591936,762944
validation,43,78,79872,673,129216,209088
validation,44,102,104448,1150,220800,325248
validation,45,162,165888,2901,556992,722880
validation,46,182,186368,3661,702912,889280
validation,47,121,123904,1618,310656,434560
validation,48,191,195584,4032,774144,969728
validation,49,106,108544,1242,238464,347008
validation,50,143,146432,2260,433920,580352
validation,51,141,144384,2198,422016,566400
validation,52,133,136192,1955,375360,511552
validation,53,89,91136,876,168192,259328
validation,54,149,152576,2454,471168,623744
validation,55,142,145408,2229,427968,573376
validation,56,154,157696,2621,503232,660928
validation,57,124,126976,1700,326400,453376
validation,58,87,89088,837,160704,249792
validation,59,102,104448,1150,220800,325248
validation,60,150,153600,2487,477504,631104
validation,61,174,178176,3346,642432,820608
validation,62,198,202752,4333,831936,1034688
validation,63,177,181248,3463,664896,846144
validation,64,257,263168,7300,1401600,1664768
validation,65,199,203776,4377,840384,1044160
validation,66,106,108544,1242,238464,347008
validation,67,107,109568,1266,243072,352640
validation,68,141,144384,2198,422016,566400
validation,69,103,105472,1173,225216,330688
validation,70,115,117760,1462,280704,398464
validation,71,69,70656,527,101184,171840
validation,72,199,203776,4377,840384,1044160
validation,73,145,148480,2324,446208,594688
validation,74,114,116736,1437,275904,392640
validation,75,212,217088,4967,953664,1170752
validation,76,94,96256,977,187584,283840
validation,77,112,114688,1387,266304,380992
validation,78,191,195584,4032,774144,969728
validation,79,108,110592,1289,247488,358080
validation,80,37,37888,152,29184,67072
validation,81,206,210944,4690,900480,1111424
validation,82,179,183296,3541,679872,863168
validation,83,168,172032,3120,599040,771072
validation,84,126,129024,1755,336960,465984
validation,85,133,136192,1955,375360,511552
validation,86,203,207872,4555,874560,1082432
validation,87,105,107520,1219,234048,341568
validation,88,154,157696,2621,503232,660928
validation,89,119,121856,1565,300480,422336
validation,90,57,58368,359,68928,127296
validation,91,157,160768,2725,523200,683968
validation,92,91,93184,916,175872,269056
validation,93,131,134144,1897,364224,498368
validation,94,138,141312,2105,404160,545472
validation,95,123,125952,1672,321024,446976
validation,96,66,67584,482,92544,160128
validation,97,87,89088,837,160704,249792
validation,98,77,78848,656,125952,204800
validation,99,200,204800,4421,848832,1053632
validation,100,151,154624,2520,483840,638464
validation,101,128,131072,1811,347712,478784
validation,102,143,146432,2260,433920,580352
validation,103,52,53248,299,57408,110656
validation,104,144,147456,2292,440064,587520
validation,105,187,191488,3865,742080,933568
validation,106,112,114688,1387,266304,380992
validation,107,68,69632,511,98112,167744
validation,108,230,235520,5847,1122624,1358144
validation,109,134,137216,1985,381120,518336
validation,110,154,157696,2621,503232,660928
validation,111,136,139264,2045,392640,531904
validation,112,105,107520,1219,234048,341568
validation,113,62,63488,425,81600,145088
validation,114,173,177152,3308,635136,812288
validation,115,114,116736,1437,275904,392640
validation,116,152,155648,2554,490368,646016
validation,117,98,100352,1062,203904,304256
validation,118,120,122880,1592,305664,428544
validation,119,151,154624,2520,483840,638464
validation,120,145,148480,2324,446208,594688
validation,121,133,136192,1955,375360,511552
validation,122,181,185344,3621,695232,880576
validation,123,58,59392,372,71424,130816
validation,124,190,194560,3990,766080,960640
validation,125,148,151552,2421,464832,616384
validation,126,99,101376,1084,208128,309504
validation,127,191,195584,4032,774144,969728
validation,128,171,175104,3232,620544,795648
validation,129,142,145408,2229,427968,573376
validation,130,141,144384,2198,422016,566400
validation,131,131,134144,1897,364224,498368
validation,132,156,159744,2690,516480,676224
validation,133,163,166912,2937,563904,730816
validation,134,123,125952,1672,321024,446976
validation,135,183,187392,3702,710784,898176
validation,136,81,82944,725,139200,222144
validation,137,149,152576,2454,471168,623744
validation,138,73,74752,589,113088,187840
validation,139,144,147456,2292,440064,587520
validation,140,137,140288,2075,398400,538688
validation,141,148,151552,2421,464832,616384
validation,142,123,125952,1672,321024,446976
validation,143,200,204800,4421,848832,1053632
validation,144,94,96256,977,187584,283840
validation,145,122,124928,1645,315840,440768
validation,146,168,172032,3120,599040,771072
validation,147,207,211968,4736,909312,1121280
validation,148,94,96256,977,187584,283840
validation,149,124,126976,1700,326400,453376
validation,150,114,116736,1437,275904,392640
validation,151,125,128000,1727,331584,459584
validation,152,150,153600,2487,477504,631104
validation,153,173,177152,3308,635136,812288
validation,154,63,64512,439,84288,148800
validation,155,119,121856,1565,300480,422336
validation,156,164,167936,2973,570816,738752
validation,157,160,163840,2830,543360,707200
validation,158,159,162816,2794,536448,699264
validation,159,132,135168,1926,369792,504960
validation,160,115,117760,1462,280704,398464
validation,161,95,97280,998,191616,288896
validation,162,128,131072,1811,347712,478784
validation,163,89,91136,876,168192,259328
validation,164,172,176128,3270,627840,803968
validation,165,235,240640,6104,1171968,1412608
validation,166,97,99328,1040,199680,299008
validation,167,141,144384,2198,422016,566400
validation,168,190,194560,3990,766080,960640
validation,169,84,86016,780,149760,235776
validation,170,172,176128,3270,627840,803968
validation,171,69,70656,527,101184,171840
validation,172,159,162816,2794,536448,699264
validation,173,141,144384,2198,422016,566400
validation,174,196,200704,4246,815232,1015936
validation,175,175,179200,3385,649920,829120
validation,176,149,152576,2454,471168,623744
validation,177,42,43008,195,37440,80448
validation,178,49,50176,266,51072,101248
validation,179,173,177152,3308,635136,812288
validation,180,218,223232,5253,1008576,1231808
validation,181,136,139264,2045,392640,531904
validation,182,178,182272,3502,672384,854656
validation,183,152,155648,2554,490368,646016
validation,184,98,100352,1062,203904,304256
validation,185,100,102400,1106,212352,314752
validation,186,146,149504,2356,452352,601856
validation,187,145,148480,2324,446208,594688
validation,188,116,118784,1488,285696,404480
validation,189,147,150528,2389,458688,609216
validation,190,124,126976,1700,326400,453376
validation,191,138,141312,2105,404160,545472
validation,192,158,161792,2759,529728,691520
validation,193,177,181248,3463,664896,846144
validation,194,102,104448,1150,220800,325248
validation,195,167,171008,3083,591936,762944
validation,196,143,146432,2260,433920,580352
validation,197,112,114688,1387,266304,380992
validation,198,121,123904,1618,310656,434560
validation,199,204,208896,4600,883200,1092096
validation,200,117,119808,1513,290496,410304
validation,201,210,215040,4874,935808,1150848
validation,202,69,70656,527,101184,171840
validation,203,64,65536,453,86976,152512
validation,204,189,193536,3948,758016,951552
validation,205,130,133120,1868,358656,491776
validation,206,200,204800,4421,848832,1053632
validation,207,176,180224,3424,657408,837632
validation,208,135,138240,2015,386880,525120
validation,209,98,100352,1062,203904,304256
validation,210,139,142336,2136,410112,552448
validation,211,123,125952,1672,321024,446976
validation,212,156,159744,2690,516480,676224
validation,213,119,121856,1565,300480,422336
validation,214,133,136192,1955,375360,511552
validation,215,102,104448,1150,220800,325248
validation,216,154,157696,2621,503232,660928
validation,217,185,189440,3783,726336,915776
validation,218,166,169984,3046,584832,754816
validation,219,181,185344,3621,695232,880576
validation,220,107,109568,1266,243072,352640
validation,221,154,157696,2621,503232,660928
validation,222,164,167936,2973,570816,738752
validation,223,137,140288,2075,398400,538688
validation,224,193,197632,4117,790464,988096
validation,225,99,101376,1084,208128,309504
validation,226,40,40960,177,33984,74944
validation,227,112,114688,1387,266304,380992
validation,228,135,138240,2015,386880,525120
validation,229,164,167936,2973,570816,738752
validation,230,138,141312,2105,404160,545472
validation,231,118,120832,1539,295488,416320
validation,232,90,92160,896,172032,264192
validation,233,116,118784,1488,285696,404480
validation,234,68,69632,511,98112,167744
validation,235,192,196608,4075,782400,979008
validation,236,129,132096,1840,353280,485376
validation,237,176,180224,3424,657408,837632
validation,238,118,120832,1539,295488,416320
validation,239,169,173056,3157,606144,779200
validation,240,128,131072,1811,347712,478784
validation,241,139,142336,2136,410112,552448
validation,242,66,67584,482,92544,160128
validation,243,108,110592,1289,247488,358080
validation,244,187,191488,3865,742080,933568
validation,245,67,68608,497,95424,164032
validation,246,94,96256,977,187584,283840
validation,247,100,102400,1106,212352,314752
validation,248,176,180224,3424,657408,837632
validation,249,131,134144,1897,364224,498368
validation,250,221,226304,5398,1036416,1262720
validation,251,135,138240,2015,386880,525120
validation,252,139,142336,2136,410112,552448
validation,253,194,198656,4160,798720,997376
validation,254,136,139264,2045,392640,531904
validation,255,202,206848,4510,865920,1072768
validation,256,217,222208,5205,999360,1221568
validation,257,207,211968,4736,909312,1121280
validation,258,205,209920,4645,891840,1101760
validation,259,72,73728,573,110016,183744
validation,260,141,144384,2198,422016,566400
validation,261,134,137216,1985,381120,518336
validation,262,156,159744,2690,516480,676224
validation,263,179,183296,3541,679872,863168
validation,264,121,123904,1618,310656,434560
validation,265,87,89088,837,160704,249792
validation,266,210,215040,4874,935808,1150848
validation,267,173,177152,3308,635136,812288
validation,268,74,75776,606,116352,192128
validation,269,160,163840,2830,543360,707200
validation,270,166,169984,3046,584832,754816
validation,271,98,100352,1062,203904,304256
validation,272,72,73728,573,110016,183744
validation,273,139,142336,2136,410112,552448
validation,274,66,67584,482,92544,160128
validation,275,102,104448,1150,220800,325248
validation,276,87,89088,837,160704,249792
validation,277,46,47104,234,44928,92032
validation,278,185,189440,3783,726336,915776
validation,279,139,142336,2136,410112,552448
validation,280,73,74752,589,113088,187840
validation,281,56,57344,347,66624,123968
validation,282,143,146432,2260,433920,580352
validation,283,170,174080,3194,613248,787328
validation,284,160,163840,2830,543360,707200
validation,285,146,149504,2356,452352,601856
validation,286,182,186368,3661,702912,889280
validation,287,72,73728,573,110016,183744
validation,288,108,110592,1289,247488,358080
validation,289,147,150528,2389,458688,609216
validation,290,120,122880,1592,305664,428544
validation,291,101,103424,1128,216576,320000
validation,292,44,45056,214,41088,86144
validation,293,162,165888,2901,556992,722880
validation,294,152,155648,2554,490368,646016
validation,295,199,203776,4377,840384,1044160
validation,296,190,194560,3990,766080,960640
validation,297,161,164864,2865,550080,714944
validation,298,144,147456,2292,440064,587520
validation,299,156,159744,2690,516480,676224
validation,300,172,176128,3270,627840,803968
validation,301,134,137216,1985,381120,518336
validation,302,151,154624,2520,483840,638464
validation,303,195,199680,4203,806976,1006656
validation,304,107,109568,1266,243072,352640
validation,305,88,90112,856,164352,254464
validation,306,111,113664,1362,261504,375168
validation,307,146,149504,2356,452352,601856
validation,308,125,128000,1727,331584,459584
validation,309,74,75776,606,116352,192128
validation,310,178,182272,3502,672384,854656
validation,311,128,131072,1811,347712,478784
validation,312,98,100352,1062,203904,304256
validation,313,134,137216,1985,381120,518336
validation,314,166,169984,3046,584832,754816
validation,315,140,143360,2167,416064,559424
validation,316,87,89088,837,160704,249792
validation,317,99,101376,1084,208128,309504
validation,318,133,136192,1955,375360,511552
validation,319,236,241664,6156,1181952,1423616
validation,320,104,106496,1196,229632,336128
validation,321,78,79872,673,129216,209088
validation,322,163,166912,2937,563904,730816
validation,323,132,135168,1926,369792,504960
validation,324,119,121856,1565,300480,422336
validation,325,263,269312,7645,1467840,1737152
validation,326,85,87040,799,153408,240448
validation,327,150,153600,2487,477504,631104
validation,328,163,166912,2937,563904,730816
validation,329,169,173056,3157,606144,779200
validation,330,119,121856,1565,300480,422336
validation,331,183,187392,3702,710784,898176
validation,332,224,229376,5546,1064832,1294208
validation,333,130,133120,1868,358656,491776
validation,334,154,157696,2621,503232,660928
validation,335,73,74752,589,113088,187840
validation,336,180,184320,3581,687552,871872
validation,337,105,107520,1219,234048,341568
validation,338,162,165888,2901,556992,722880
validation,339,168,172032,3120,599040,771072
validation,340,189,193536,3948,758016,951552
validation,341,133,136192,1955,375360,511552
validation,342,114,116736,1437,275904,392640
validation,343,118,120832,1539,295488,416320
validation,344,178,182272,3502,672384,854656
validation,345,174,178176,3346,642432,820608
validation,346,161,164864,2865,550080,714944
validation,347,126,129024,1755,336960,465984
validation,348,132,135168,1926,369792,504960
validation,349,188,192512,3907,750144,942656
validation,350,77,78848,656,125952,204800
validation,351,136,139264,2045,392640,531904
validation,352,128,131072,1811,347712,478784
validation,353,173,177152,3308,635136,812288
validation,354,134,137216,1985,381120,518336
validation,355,164,167936,2973,570816,738752
validation,356,84,86016,780,149760,235776
validation,357,93,95232,956,183552,278784
validation,358,136,139264,2045,392640,531904
validation,359,157,160768,2725,523200,683968
validation,360,113,115712,1412,271104,386816
validation,361,184,188416,3742,718464,906880
validation,362,181,185344,3621,695232,880576
validation,363,127,130048,1783,342336,472384
validation,364,131,134144,1897,364224,498368
validation,365,181,185344,3621,695232,880576
validation,366,146,149504,2356,452352,601856
validation,367,102,104448,1150,220800,325248
validation,368,185,189440,3783,726336,915776
validation,369,130,133120,1868,358656,491776
validation,370,141,144384,2198,422016,566400
validation,371,49,50176,266,51072,101248
validation,372,134,137216,1985,381120,518336
validation,373,209,214016,4828,926976,1140992
validation,374,193,197632,4117,790464,988096
validation,375,142,145408,2229,427968,573376
validation,376,176,180224,3424,657408,837632
validation,377,121,123904,1618,310656,434560
validation,378,162,165888,2901,556992,722880
validation,379,109,111616,1313,252096,363712
validation,380,230,235520,5847,1122624,1358144
validation,381,183,187392,3702,710784,898176
validation,382,193,197632,4117,790464,988096
validation,383,274,280576,8298,1593216,1873792
validation,384,192,196608,4075,782400,979008
validation,385,156,159744,2690,516480,676224
validation,386,129,132096,1840,353280,485376
validation,387,146,149504,2356,452352,601856
validation,388,129,132096,1840,353280,485376
validation,389,72,73728,573,110016,183744
validation,390,123,125952,1672,321024,446976
validation,391,117,119808,1513,290496,410304
validation,392,189,193536,3948,758016,951552
validation,393,150,153600,2487,477504,631104
validation,394,253,259072,7075,1358400,1617472
validation,395,173,177152,3308,635136,812288
validation,396,93,95232,956,183552,278784
validation,397,137,140288,2075,398400,538688
validation,398,123,125952,1672,321024,446976
validation,399,169,173056,3157,606144,779200
validation,400,157,160768,2725,523200,683968
validation,401,103,105472,1173,225216,330688
validation,402,162,165888,2901,556992,722880
validation,403,62,63488,425,81600,145088
validation,404,108,110592,1289,247488,358080
validation,405,181,185344,3621,695232,880576
validation,406,135,138240,2015,386880,525120
validation,407,96,98304,1019,195648,293952
validation,408,99,101376,1084,208128,309504
validation,409,172,176128,3270,627840,803968
validation,410,99,101376,1084,208128,309504
validation,411,230,235520,5847,1122624,1358144
validation,412,125,128000,1727,331584,459584
validation,413,153,156672,2587,496704,653376
validation,414,141,144384,2198,422016,566400
validation,415,114,116736,1437,275904,392640
validation,416,136,139264,2045,392640,531904
validation,417,102,104448,1150,220800,325248
validation,418,78,79872,673,129216,209088
validation,419,195,199680,4203,806976,1006656
validation,420,223,228352,5496,1055232,1283584
validation,421,61,62464,412,79104,141568
validation,422,225,230400,5595,1074240,1304640
validation,423,168,172032,3120,599040,771072
validation,424,95,97280,998,191616,288896
validation,425,81,82944,725,139200,222144
validation,426,167,171008,3083,591936,762944
validation,427,95,97280,998,191616,288896
validation,428,169,173056,3157,606144,779200
validation,429,78,79872,673,129216,209088
validation,430,96,98304,1019,195648,293952
validation,431,120,122880,1592,305664,428544
validation,432,159,162816,2794,536448,699264
validation,433,118,120832,1539,295488,416320
validation,434,181,185344,3621,695232,880576
validation,435,194,198656,4160,798720,997376
validation,436,242,247808,6473,1242816,1490624
validation,437,67,68608,497,95424,164032
validation,438,126,129024,1755,336960,465984
validation,439,83,84992,762,146304,231296
validation,440,105,107520,1219,234048,341568
validation,441,47,48128,245,47040,95168
validation,442,170,174080,3194,613248,787328
validation,443,168,172032,3120,599040,771072
validation,444,85,87040,799,153408,240448
validation,445,103,105472,1173,225216,330688
validation,446,158,161792,2759,529728,691520
validation,447,67,68608,497,95424,164032
validation,448,156,159744,2690,516480,676224
validation,449,161,164864,2865,550080,714944
validation,450,108,110592,1289,247488,358080
validation,451,113,115712,1412,271104,386816
validation,452,86,88064,818,157056,245120
validation,453,119,121856,1565,300480,422336
validation,454,116,118784,1488,285696,404480
validation,455,165,168960,3009,577728,746688
validation,456,75,76800,622,119424,196224
validation,457,163,166912,2937,563904,730816
validation,458,105,107520,1219,234048,341568
validation,459,137,140288,2075,398400,538688
validation,460,120,122880,1592,305664,428544
validation,461,84,86016,780,149760,235776
validation,462,132,135168,1926,369792,504960
validation,463,112,114688,1387,266304,380992
validation,464,153,156672,2587,496704,653376
validation,465,183,187392,3702,710784,898176
validation,466,173,177152,3308,635136,812288
validation,467,153,156672,2587,496704,653376
validation,468,76,77824,639,122688,200512
validation,469,185,189440,3783,726336,915776
validation,470,97,99328,1040,199680,299008
validation,471,112,114688,1387,266304,380992
validation,472,172,176128,3270,627840,803968
validation,473,153,156672,2587,496704,653376
validation,474,145,148480,2324,446208,594688
validation,475,152,155648,2554,490368,646016
validation,476,218,223232,5253,1008576,1231808
validation,477,80,81920,708,135936,217856
validation,478,139,142336,2136,410112,552448
validation,479,169,173056,3157,606144,779200
validation,480,165,168960,3009,577728,746688
validation,481,159,162816,2794,536448,699264
validation,482,185,189440,3783,726336,915776
validation,483,131,134144,1897,364224,498368
validation,484,72,73728,573,110016,183744
validation,485,129,132096,1840,353280,485376
validation,486,127,130048,1783,342336,472384
validation,487,141,144384,2198,422016,566400
validation,488,178,182272,3502,672384,854656
validation,489,107,109568,1266,243072,352640
validation,490,101,103424,1128,216576,320000
validation,491,223,228352,5496,1055232,1283584
validation,492,152,155648,2554,490368,646016
validation,493,169,173056,3157,606144,779200
validation,494,131,134144,1897,364224,498368
validation,495,152,155648,2554,490368,646016
validation,496,143,146432,2260,433920,580352
validation,497,169,173056,3157,606144,779200
validation,498,104,106496,1196,229632,336128
validation,499,211,216064,4921,944832,1160896
validation,500,161,164864,2865,550080,714944
validation,501,201,205824,4465,857280,1063104
validation,502,143,146432,2260,433920,580352
validation,503,159,162816,2794,536448,699264
validation,504,175,179200,3385,649920,829120
validation,505,95,97280,998,191616,288896
validation,506,130,133120,1868,358656,491776
validation,507,140,143360,2167,416064,559424
validation,508,149,152576,2454,471168,623744
validation,509,158,161792,2759,529728,691520
validation,510,211,216064,4921,944832,1160896
validation,511,98,100352,1062,203904,304256
validation,512,111,113664,1362,261504,375168
validation,513,145,148480,2324,446208,594688
validation,514,112,114688,1387,266304,380992
validation,515,191,195584,4032,774144,969728
validation,516,176,180224,3424,657408,837632
validation,517,145,148480,2324,446208,594688
validation,518,149,152576,2454,471168,623744
validation,519,80,81920,708,135936,217856
validation,520,115,117760,1462,280704,398464
validation,521,130,133120,1868,358656,491776
validation,522,86,88064,818,157056,245120
validation,523,199,203776,4377,840384,1044160
validation,524,103,105472,1173,225216,330688
validation,525,155,158720,2656,509952,668672
validation,526,100,102400,1106,212352,314752
validation,527,215,220160,5109,980928,1201088
validation,528,82,83968,744,142848,226816
validation,529,115,117760,1462,280704,398464
validation,530,115,117760,1462,280704,398464
validation,531,141,144384,2198,422016,566400
validation,532,166,169984,3046,584832,754816
validation,533,205,209920,4645,891840,1101760
validation,534,151,154624,2520,483840,638464
validation,535,133,136192,1955,375360,511552
validation,536,152,155648,2554,490368,646016
validation,537,170,174080,3194,613248,787328
validation,538,165,168960,3009,577728,746688
validation,539,182,186368,3661,702912,889280
validation,540,148,151552,2421,464832,616384
validation,541,139,142336,2136,410112,552448
validation,542,164,167936,2973,570816,738752
validation,543,127,130048,1783,342336,472384
validation,544,145,148480,2324,446208,594688
validation,545,162,165888,2901,556992,722880
validation,546,115,117760,1462,280704,398464
validation,547,155,158720,2656,509952,668672
validation,548,134,137216,1985,381120,518336
validation,549,211,216064,4921,944832,1160896
validation,550,156,159744,2690,516480,676224
validation,551,198,202752,4333,831936,1034688
validation,552,91,93184,916,175872,269056
validation,553,214,219136,5062,971904,1191040
validation,554,129,132096,1840,353280,485376
validation,555,127,130048,1783,342336,472384
validation,556,68,69632,511,98112,167744
validation,557,123,125952,1672,321024,446976
validation,558,81,82944,725,139200,222144
validation,559,175,179200,3385,649920,829120
validation,560,161,164864,2865,550080,714944
validation,561,140,143360,2167,416064,559424
validation,562,77,78848,656,125952,204800
validation,563,191,195584,4032,774144,969728
validation,564,221,226304,5398,1036416,1262720
validation,565,158,161792,2759,529728,691520
validation,566,163,166912,2937,563904,730816
validation,567,242,247808,6473,1242816,1490624
validation,568,150,153600,2487,477504,631104
validation,569,137,140288,2075,398400,538688
validation,570,245,250880,6634,1273728,1524608
validation,571,78,79872,673,129216,209088
validation,572,227,232448,5695,1093440,1325888
validation,573,132,135168,1926,369792,504960
validation,574,174,178176,3346,642432,820608
validation,575,33,33792,121,23232,57024
validation,576,120,122880,1592,305664,428544
validation,577,182,186368,3661,702912,889280
validation,578,140,143360,2167,416064,559424
validation,579,103,105472,1173,225216,330688
validation,580,93,95232,956,183552,278784
validation,581,206,210944,4690,900480,1111424
validation,582,149,152576,2454,471168,623744
validation,583,79,80896,690,132480,213376
validation,584,128,131072,1811,347712,478784
validation,585,142,145408,2229,427968,573376
validation,586,148,151552,2421,464832,616384
validation,587,142,145408,2229,427968,573376
validation,588,148,151552,2421,464832,616384
validation,589,121,123904,1618,310656,434560
validation,590,149,152576,2454,471168,623744
validation,591,125,128000,1727,331584,459584
validation,592,95,97280,998,191616,288896
validation,593,138,141312,2105,404160,545472
validation,594,185,189440,3783,726336,915776
validation,595,94,96256,977,187584,283840
validation,596,178,182272,3502,672384,854656
validation,597,143,146432,2260,433920,580352
validation,598,59,60416,385,73920,134336
validation,599,61,62464,412,79104,141568
validation,600,72,73728,573,110016,183744
validation,601,112,114688,1387,266304,380992
validation,602,66,67584,482,92544,160128
validation,603,213,218112,5014,962688,1180800
validation,604,148,151552,2421,464832,616384
validation,605,105,107520,1219,234048,341568
validation,606,126,129024,1755,336960,465984
validation,607,136,139264,2045,392640,531904
validation,608,161,164864,2865,550080,714944
validation,609,108,110592,1289,247488,358080
validation,610,212,217088,4967,953664,1170752
validation,611,155,158720,2656,509952,668672
validation,612,182,186368,3661,702912,889280
validation,613,80,81920,708,135936,217856
validation,614,140,143360,2167,416064,559424
validation,615,129,132096,1840,353280,485376
validation,616,142,145408,2229,427968,573376
validation,617,69,70656,527,101184,171840
validation,618,113,115712,1412,271104,386816
validation,619,94,96256,977,187584,283840
validation,620,208,212992,4782,918144,1131136
validation,621,157,160768,2725,523200,683968
validation,622,147,150528,2389,458688,609216
validation,623,56,57344,347,66624,123968
validation,624,145,148480,2324,446208,594688
validation,625,207,211968,4736,909312,1121280
validation,626,73,74752,589,113088,187840
validation,627,159,162816,2794,536448,699264
validation,628,117,119808,1513,290496,410304
validation,629,190,194560,3990,766080,960640
validation,630,136,139264,2045,392640,531904
validation,631,147,150528,2389,458688,609216
validation,632,132,135168,1926,369792,504960
validation,633,229,234496,5796,1112832,1347328
validation,634,207,211968,4736,909312,1121280
validation,635,128,131072,1811,347712,478784
validation,636,58,59392,372,71424,130816
validation,637,230,235520,5847,1122624,1358144
validation,638,191,195584,4032,774144,969728
validation,639,275,281600,8358,1604736,1886336
validation,640,66,67584,482,92544,160128
validation,641,162,165888,2901,556992,722880
validation,642,207,211968,4736,909312,1121280
validation,643,93,95232,956,183552,278784
validation,644,127,130048,1783,342336,472384
validation,645,81,82944,725,139200,222144
validation,646,138,141312,2105,404160,545472
validation,647,158,161792,2759,529728,691520
validation,648,124,126976,1700,326400,453376
validation,649,222,227328,5447,1045824,1273152
validation,650,159,162816,2794,536448,699264
validation,651,202,206848,4510,865920,1072768
validation,652,59,60416,385,73920,134336
validation,653,176,180224,3424,657408,837632
validation,654,159,162816,2794,536448,699264
validation,655,157,160768,2725,523200,683968
validation,656,135,138240,2015,386880,525120
validation,657,177,181248,3463,664896,846144
validation,658,123,125952,1672,321024,446976
validation,659,201,205824,4465,857280,1063104
validation,660,177,181248,3463,664896,846144
validation,661,157,160768,2725,523200,683968
validation,662,175,179200,3385,649920,829120
validation,663,91,93184,916,175872,269056
validation,664,103,105472,1173,225216,330688
validation,665,88,90112,856,164352,254464
validation,666,103,105472,1173,225216,330688
validation,667,177,181248,3463,664896,846144
validation,668,109,111616,1313,252096,363712
validation,669,130,133120,1868,358656,491776
validation,670,121,123904,1618,310656,434560
validation,671,160,163840,2830,543360,707200
test,0,115,117760,1462,280704,398464
test,1,159,162816,2794,536448,699264
test,2,124,126976,1700,326400,453376
test,3,144,147456,2292,440064,587520
test,4,133,136192,1955,375360,511552
test,5,219,224256,5301,1017792,1242048
test,6,218,223232,5253,1008576,1231808
test,7,168,172032,3120,599040,771072
test,8,226,231424,5645,1083840,1315264
test,9,212,217088,4967,953664,1170752
test,10,116,118784,1488,285696,404480
test,11,168,172032,3120,599040,771072
test,12,125,128000,1727,331584,459584
test,13,94,96256,977,187584,283840
test,14,61,62464,412,79104,141568
test,15,129,132096,1840,353280,485376
test,16,121,123904,1618,310656,434560
test,17,94,96256,977,187584,283840
test,18,146,149504,2356,452352,601856
test,19,186,190464,3824,734208,924672
test,20,131,134144,1897,364224,498368
test,21,111,113664,1362,261504,375168
test,22,164,167936,2973,570816,738752
test,23,263,269312,7645,1467840,1737152
test,24,179,183296,3541,679872,863168
test,25,179,183296,3541,679872,863168
test,26,209,214016,4828,926976,1140992
test,27,139,142336,2136,410112,552448
test,28,79,80896,690,132480,213376
test,29,42,43008,195,37440,80448
test,30,179,183296,3541,679872,863168
test,31,65,66560,467,89664,156224
test,32,113,115712,1412,271104,386816
test,33,159,162816,2794,536448,699264
test,34,101,103424,1128,216576,320000
test,35,154,157696,2621,503232,660928
test,36,70,71680,542,104064,175744
test,37,87,89088,837,160704,249792
test,38,98,100352,1062,203904,304256
test,39,145,148480,2324,446208,594688
test,40,177,181248,3463,664896,846144
test,41,91,93184,916,175872,269056
test,42,177,181248,3463,664896,846144
test,43,110,112640,1338,256896,369536
test,44,62,63488,425,81600,145088
test,45,135,138240,2015,386880,525120
test,46,147,150528,2389,458688,609216
test,47,199,203776,4377,840384,1044160
test,48,177,181248,3463,664896,846144
test,49,128,131072,1811,347712,478784
test,50,130,133120,1868,358656,491776
test,51,116,118784,1488,285696,404480
test,52,133,136192,1955,375360,511552
test,53,116,118784,1488,285696,404480
test,54,152,155648,2554,490368,646016
test,55,102,104448,1150,220800,325248
test,56,148,151552,2421,464832,616384
test,57,180,184320,3581,687552,871872
test,58,122,124928,1645,315840,440768
test,59,126,129024,1755,336960,465984
test,60,170,174080,3194,613248,787328
test,61,137,140288,2075,398400,538688
test,62,129,132096,1840,353280,485376
test,63,136,139264,2045,392640,531904
test,64,216,221184,5157,990144,1211328
test,65,216,221184,5157,990144,1211328
test,66,145,148480,2324,446208,594688
test,67,84,86016,780,149760,235776
test,68,197,201728,4289,823488,1025216
test,69,129,132096,1840,353280,485376
test,70,116,118784,1488,285696,404480
test,71,120,122880,1592,305664,428544
test,72,176,180224,3424,657408,837632
test,73,68,69632,511,98112,167744
test,74,179,183296,3541,679872,863168
test,75,177,181248,3463,664896,846144
test,76,166,169984,3046,584832,754816
test,77,151,154624,2520,483840,638464
test,78,174,178176,3346,642432,820608
test,79,119,121856,1565,300480,422336
test,80,74,75776,606,116352,192128
test,81,73,74752,589,113088,187840
test,82,166,169984,3046,584832,754816
test,83,160,163840,2830,543360,707200
test,84,180,184320,3581,687552,871872
test,85,116,118784,1488,285696,404480
test,86,102,104448,1150,220800,325248
test,87,144,147456,2292,440064,587520
test,88,215,220160,5109,980928,1201088
test,89,82,83968,744,142848,226816
test,90,158,161792,2759,529728,691520
test,91,189,193536,3948,758016,951552
test,92,183,187392,3702,710784,898176
test,93,128,131072,1811,347712,478784
test,94,159,162816,2794,536448,699264
test,95,246,251904,6688,1284096,1536000
test,96,83,84992,762,146304,231296
test,97,92,94208,936,179712,273920
test,98,193,197632,4117,790464,988096
test,99,149,152576,2454,471168,623744
test,100,174,178176,3346,642432,820608
test,101,118,120832,1539,295488,416320
test,102,163,166912,2937,563904,730816
test,103,119,121856,1565,300480,422336
test,104,48,49152,255,48960,98112
test,105,172,176128,3270,627840,803968
test,106,158,161792,2759,529728,691520
test,107,126,129024,1755,336960,465984
test,108,143,146432,2260,433920,580352
test,109,213,218112,5014,962688,1180800
test,110,135,138240,2015,386880,525120
test,111,176,180224,3424,657408,837632
test,112,194,198656,4160,798720,997376
test,113,193,197632,4117,790464,988096
test,114,199,203776,4377,840384,1044160
test,115,162,165888,2901,556992,722880
test,116,175,179200,3385,649920,829120
test,117,121,123904,1618,310656,434560
test,118,295,302080,9618,1846656,2148736
test,119,127,130048,1783,342336,472384
test,120,146,149504,2356,452352,601856
test,121,140,143360,2167,416064,559424
test,122,157,160768,2725,523200,683968
test,123,225,230400,5595,1074240,1304640
test,124,86,88064,818,157056,245120
test,125,214,219136,5062,971904,1191040
test,126,47,48128,245,47040,95168
test,127,126,129024,1755,336960,465984
test,128,142,145408,2229,427968,573376
test,129,185,189440,3783,726336,915776
test,130,117,119808,1513,290496,410304
test,131,61,62464,412,79104,141568
test,132,103,105472,1173,225216,330688
test,133,86,88064,818,157056,245120
test,134,191,195584,4032,774144,969728
test,135,111,113664,1362,261504,375168
test,136,181,185344,3621,695232,880576
test,137,184,188416,3742,718464,906880
test,138,165,168960,3009,577728,746688
test,139,143,146432,2260,433920,580352
test,140,169,173056,3157,606144,779200
test,141,75,76800,622,119424,196224
test,142,98,100352,1062,203904,304256
test,143,65,66560,467,89664,156224
test,144,147,150528,2389,458688,609216
test,145,111,113664,1362,261504,375168
test,146,157,160768,2725,523200,683968
test,147,94,96256,977,187584,283840
test,148,127,130048,1783,342336,472384
test,149,151,154624,2520,483840,638464
test,150,61,62464,412,79104,141568
test,151,148,151552,2421,464832,616384
test,152,135,138240,2015,386880,525120
test,153,196,200704,4246,815232,1015936
test,154,177,181248,3463,664896,846144
test,155,232,237568,5949,1142208,1379776
test,156,175,179200,3385,649920,829120
test,157,145,148480,2324,446208,594688
test,158,117,119808,1513,290496,410304
test,159,121,123904,1618,310656,434560
test,160,179,183296,3541,679872,863168
test,161,193,197632,4117,790464,988096
test,162,171,175104,3232,620544,795648
test,163,143,146432,2260,433920,580352
test,164,165,168960,3009,577728,746688
test,165,94,96256,977,187584,283840
test,166,91,93184,916,175872,269056
test,167,61,62464,412,79104,141568
test,168,160,163840,2830,543360,707200
test,169,131,134144,1897,364224,498368
test,170,151,154624,2520,483840,638464
test,171,87,89088,837,160704,249792
test,172,117,119808,1513,290496,410304
test,173,181,185344,3621,695232,880576
test,174,142,145408,2229,427968,573376
test,175,84,86016,780,149760,235776
test,176,131,134144,1897,364224,498368
test,177,139,142336,2136,410112,552448
test,178,100,102400,1106,212352,314752
test,179,103,105472,1173,225216,330688
test,180,202,206848,4510,865920,1072768
test,181,149,152576,2454,471168,623744
test,182,44,45056,214,41088,86144
test,183,114,116736,1437,275904,392640
test,184,145,148480,2324,446208,594688
test,185,156,159744,2690,516480,676224
test,186,150,153600,2487,477504,631104
test,187,94,96256,977,187584,283840
test,188,178,182272,3502,672384,854656
test,189,134,137216,1985,381120,518336
test,190,96,98304,1019,195648,293952
test,191,146,149504,2356,452352,601856
test,192,168,172032,3120,599040,771072
test,193,141,144384,2198,422016,566400
test,194,113,115712,1412,271104,386816
test,195,144,147456,2292,440064,587520
test,196,71,72704,558,107136,179840
test,197,125,128000,1727,331584,459584
test,198,142,145408,2229,427968,573376
test,199,164,167936,2973,570816,738752
test,200,195,199680,4203,806976,1006656
test,201,116,118784,1488,285696,404480
test,202,143,146432,2260,433920,580352
test,203,200,204800,4421,848832,1053632
test,204,119,121856,1565,300480,422336
test,205,175,179200,3385,649920,829120
test,206,135,138240,2015,386880,525120
test,207,80,81920,708,135936,217856
test,208,162,165888,2901,556992,722880
test,209,97,99328,1040,199680,299008
test,210,136,139264,2045,392640,531904
test,211,158,161792,2759,529728,691520
test,212,127,130048,1783,342336,472384
test,213,160,163840,2830,543360,707200
test,214,151,154624,2520,483840,638464
test,215,157,160768,2725,523200,683968
test,216,126,129024,1755,336960,465984
test,217,230,235520,5847,1122624,1358144
test,218,154,157696,2621,503232,660928
test,219,199,203776,4377,840384,1044160
test,220,126,129024,1755,336960,465984
test,221,189,193536,3948,758016,951552
test,222,65,66560,467,89664,156224
test,223,184,188416,3742,718464,906880
test,224,136,139264,2045,392640,531904
test,225,119,121856,1565,300480,422336
test,226,91,93184,916,175872,269056
test,227,218,223232,5253,1008576,1231808
test,228,175,179200,3385,649920,829120
test,229,104,106496,1196,229632,336128
test,230,112,114688,1387,266304,380992
test,231,176,180224,3424,657408,837632
test,232,161,164864,2865,550080,714944
test,233,132,135168,1926,369792,504960
test,234,100,102400,1106,212352,314752
test,235,89,91136,876,168192,259328
test,236,159,162816,2794,536448,699264
test,237,107,109568,1266,243072,352640
test,238,154,157696,2621,503232,660928
test,239,194,198656,4160,798720,997376
test,240,126,129024,1755,336960,465984
test,241,148,151552,2421,464832,616384
test,242,89,91136,876,168192,259328
test,243,156,159744,2690,516480,676224
test,244,134,137216,1985,381120,518336
test,245,118,120832,1539,295488,416320
test,246,237,242688,6208,1191936,1434624
test,247,133,136192,1955,375360,511552
test,248,174,178176,3346,642432,820608
test,249,105,107520,1219,234048,341568
test,250,140,143360,2167,416064,559424
test,251,94,96256,977,187584,283840
test,252,126,129024,1755,336960,465984
test,253,165,168960,3009,577728,746688
test,254,135,138240,2015,386880,525120
test,255,102,104448,1150,220800,325248
test,256,125,128000,1727,331584,459584
test,257,154,157696,2621,503232,660928
test,258,218,223232,5253,1008576,1231808
test,259,165,168960,3009,577728,746688
test,260,116,118784,1488,285696,404480
test,261,179,183296,3541,679872,863168
test,262,160,163840,2830,543360,707200
test,263,144,147456,2292,440064,587520
test,264,106,108544,1242,238464,347008
test,265,148,151552,2421,464832,616384
test,266,202,206848,4510,865920,1072768
test,267,146,149504,2356,452352,601856
test,268,151,154624,2520,483840,638464
test,269,128,131072,1811,347712,478784
test,270,100,102400,1106,212352,314752
test,271,170,174080,3194,613248,787328
test,272,271,277504,8117,1558464,1835968
test,273,93,95232,956,183552,278784
test,274,123,125952,1672,321024,446976
test,275,112,114688,1387,266304,380992
test,276,91,93184,916,175872,269056
test,277,102,104448,1150,220800,325248
test,278,146,149504,2356,452352,601856
test,279,79,80896,690,132480,213376
test,280,120,122880,1592,305664,428544
test,281,144,147456,2292,440064,587520
test,282,68,69632,511,98112,167744
test,283,107,109568,1266,243072,352640
test,284,154,157696,2621,503232,660928
test,285,127,130048,1783,342336,472384
test,286,118,120832,1539,295488,416320
test,287,189,193536,3948,758016,951552
test,288,128,131072,1811,347712,478784
test,289,144,147456,2292,440064,587520
test,290,200,204800,4421,848832,1053632
test,291,88,90112,856,164352,254464
test,292,157,160768,2725,523200,683968
test,293,185,189440,3783,726336,915776
test,294,216,221184,5157,990144,1211328
test,295,165,168960,3009,577728,746688
test,296,86,88064,818,157056,245120
test,297,190,194560,3990,766080,960640
test,298,163,166912,2937,563904,730816
test,299,211,216064,4921,944832,1160896
test,300,186,190464,3824,734208,924672
test,301,61,62464,412,79104,141568
test,302,141,144384,2198,422016,566400
test,303,255,261120,7187,1379904,1641024
test,304,204,208896,4600,883200,1092096
test,305,204,208896,4600,883200,1092096
test,306,151,154624,2520,483840,638464
test,307,162,165888,2901,556992,722880
test,308,101,103424,1128,216576,320000
test,309,133,136192,1955,375360,511552
test,310,71,72704,558,107136,179840
test,311,69,70656,527,101184,171840
test,312,112,114688,1387,266304,380992
test,313,66,67584,482,92544,160128
test,314,133,136192,1955,375360,511552
test,315,99,101376,1084,208128,309504
test,316,205,209920,4645,891840,1101760
test,317,86,88064,818,157056,245120
test,318,142,145408,2229,427968,573376
test,319,42,43008,195,37440,80448
test,320,139,142336,2136,410112,552448
test,321,162,165888,2901,556992,722880
test,322,214,219136,5062,971904,1191040
test,323,140,143360,2167,416064,559424
test,324,129,132096,1840,353280,485376
test,325,73,74752,589,113088,187840
test,326,166,169984,3046,584832,754816
test,327,155,158720,2656,509952,668672
test,328,90,92160,896,172032,264192
test,329,205,209920,4645,891840,1101760
test,330,112,114688,1387,266304,380992
test,331,122,124928,1645,315840,440768
test,332,90,92160,896,172032,264192
test,333,166,169984,3046,584832,754816
test,334,95,97280,998,191616,288896
test,335,219,224256,5301,1017792,1242048
test,336,74,75776,606,116352,192128
test,337,122,124928,1645,315840,440768
test,338,148,151552,2421,464832,616384
test,339,48,49152,255,48960,98112
test,340,49,50176,266,51072,101248
test,341,99,101376,1084,208128,309504
test,342,109,111616,1313,252096,363712
test,343,187,191488,3865,742080,933568
test,344,153,156672,2587,496704,653376
test,345,126,129024,1755,336960,465984
test,346,166,169984,3046,584832,754816
test,347,184,188416,3742,718464,906880
test,348,157,160768,2725,523200,683968
test,349,121,123904,1618,310656,434560
test,350,130,133120,1868,358656,491776
test,351,104,106496,1196,229632,336128
test,352,167,171008,3083,591936,762944
test,353,149,152576,2454,471168,623744
test,354,82,83968,744,142848,226816
test,355,300,307200,9947,1909824,2217024
test,356,131,134144,1897,364224,498368
test,357,114,116736,1437,275904,392640
test,358,138,141312,2105,404160,545472
test,359,173,177152,3308,635136,812288
test,360,149,152576,2454,471168,623744
test,361,167,171008,3083,591936,762944
test,362,60,61440,398,76416,137856
test,363,122,124928,1645,315840,440768
test,364,45,46080,224,43008,89088
test,365,96,98304,1019,195648,293952
test,366,78,79872,673,129216,209088
test,367,120,122880,1592,305664,428544
test,368,156,159744,2690,516480,676224
test,369,78,79872,673,129216,209088
test,370,182,186368,3661,702912,889280
test,371,143,146432,2260,433920,580352
test,372,74,75776,606,116352,192128
test,373,138,141312,2105,404160,545472
test,374,176,180224,3424,657408,837632
test,375,259,265216,7414,1423488,1688704
test,376,138,141312,2105,404160,545472
test,377,149,152576,2454,471168,623744
test,378,126,129024,1755,336960,465984
test,379,77,78848,656,125952,204800
test,380,88,90112,856,164352,254464
test,381,180,184320,3581,687552,871872
test,382,158,161792,2759,529728,691520
test,383,66,67584,482,92544,160128
test,384,89,91136,876,168192,259328
test,385,116,118784,1488,285696,404480
test,386,117,119808,1513,290496,410304
test,387,164,167936,2973,570816,738752
test,388,136,139264,2045,392640,531904
test,389,96,98304,1019,195648,293952
test,390,140,143360,2167,416064,559424
test,391,57,58368,359,68928,127296
test,392,180,184320,3581,687552,871872
test,393,181,185344,3621,695232,880576
test,394,196,200704,4246,815232,1015936
test,395,134,137216,1985,381120,518336
test,396,183,187392,3702,710784,898176
test,397,96,98304,1019,195648,293952
test,398,164,167936,2973,570816,738752
test,399,105,107520,1219,234048,341568
test,400,209,214016,4828,926976,1140992
test,401,93,95232,956,183552,278784
test,402,143,146432,2260,433920,580352
test,403,226,231424,5645,1083840,1315264
test,404,129,132096,1840,353280,485376
test,405,128,131072,1811,347712,478784
test,406,113,115712,1412,271104,386816
test,407,175,179200,3385,649920,829120
test,408,196,200704,4246,815232,1015936
test,409,195,199680,4203,806976,1006656
test,410,155,158720,2656,509952,668672
test,411,147,150528,2389,458688,609216
test,412,76,77824,639,122688,200512
test,413,200,204800,4421,848832,1053632
test,414,115,117760,1462,280704,398464
test,415,175,179200,3385,649920,829120
test,416,233,238592,6000,1152000,1390592
test,417,211,216064,4921,944832,1160896
test,418,191,195584,4032,774144,969728
test,419,105,107520,1219,234048,341568
test,420,117,119808,1513,290496,410304
test,421,90,92160,896,172032,264192
test,422,126,129024,1755,336960,465984
test,423,100,102400,1106,212352,314752
test,424,165,168960,3009,577728,746688
test,425,81,82944,725,139200,222144
test,426,112,114688,1387,266304,380992
test,427,101,103424,1128,216576,320000
test,428,122,124928,1645,315840,440768
test,429,95,97280,998,191616,288896
test,430,131,134144,1897,364224,498368
test,431,96,98304,1019,195648,293952
test,432,171,175104,3232,620544,795648
test,433,173,177152,3308,635136,812288
test,434,141,144384,2198,422016,566400
test,435,119,121856,1565,300480,422336
test,436,147,150528,2389,458688,609216
test,437,186,190464,3824,734208,924672
test,438,169,173056,3157,606144,779200
test,439,150,153600,2487,477504,631104
test,440,239,244736,6313,1212096,1456832
test,441,174,178176,3346,642432,820608
test,442,129,132096,1840,353280,485376
test,443,144,147456,2292,440064,587520
test,444,67,68608,497,95424,164032
test,445,168,172032,3120,599040,771072
test,446,188,192512,3907,750144,942656
test,447,126,129024,1755,336960,465984
test,448,173,177152,3308,635136,812288
test,449,148,151552,2421,464832,616384
test,450,196,200704,4246,815232,1015936
test,451,191,195584,4032,774144,969728
test,452,192,196608,4075,782400,979008
test,453,173,177152,3308,635136,812288
test,454,125,128000,1727,331584,459584
test,455,131,134144,1897,364224,498368
test,456,191,195584,4032,774144,969728
test,457,204,208896,4600,883200,1092096
test,458,173,177152,3308,635136,812288
test,459,118,120832,1539,295488,416320
test,460,164,167936,2973,570816,738752
test,461,167,171008,3083,591936,762944
test,462,131,134144,1897,364224,498368
test,463,130,133120,1868,358656,491776
test,464,76,77824,639,122688,200512
test,465,183,187392,3702,710784,898176
test,466,82,83968,744,142848,226816
test,467,192,196608,4075,782400,979008
test,468,167,171008,3083,591936,762944
test,469,132,135168,1926,369792,504960
test,470,128,131072,1811,347712,478784
test,471,137,140288,2075,398400,538688
test,472,88,90112,856,164352,254464
test,473,185,189440,3783,726336,915776
test,474,136,139264,2045,392640,531904
test,475,264,270336,7703,1478976,1749312
test,476,83,84992,762,146304,231296
test,477,178,182272,3502,672384,854656
test,478,75,76800,622,119424,196224
test,479,96,98304,1019,195648,293952
test,480,171,175104,3232,620544,795648
test,481,202,206848,4510,865920,1072768
test,482,144,147456,2292,440064,587520
test,483,71,72704,558,107136,179840
test,484,179,183296,3541,679872,863168
test,485,82,83968,744,142848,226816
test,486,86,88064,818,157056,245120
test,487,149,152576,2454,471168,623744
test,488,190,194560,3990,766080,960640
test,489,174,178176,3346,642432,820608
test,490,121,123904,1618,310656,434560
test,491,175,179200,3385,649920,829120
test,492,143,146432,2260,433920,580352
test,493,137,140288,2075,398400,538688
test,494,73,74752,589,113088,187840
test,495,107,109568,1266,243072,352640
test,496,141,144384,2198,422016,566400
test,497,220,225280,5349,1027008,1252288
test,498,152,155648,2554,490368,646016
test,499,167,171008,3083,591936,762944
test,500,75,76800,622,119424,196224
test,501,118,120832,1539,295488,416320
test,502,116,118784,1488,285696,404480
test,503,105,107520,1219,234048,341568
test,504,103,105472,1173,225216,330688
test,505,172,176128,3270,627840,803968
test,506,116,118784,1488,285696,404480
test,507,164,167936,2973,570816,738752
test,508,198,202752,4333,831936,1034688
test,509,263,269312,7645,1467840,1737152
test,510,121,123904,1618,310656,434560
test,511,105,107520,1219,234048,341568
test,512,122,124928,1645,315840,440768
test,513,160,163840,2830,543360,707200
test,514,79,80896,690,132480,213376
test,515,142,145408,2229,427968,573376
test,516,115,117760,1462,280704,398464
test,517,113,115712,1412,271104,386816
test,518,178,182272,3502,672384,854656
test,519,143,146432,2260,433920,580352
test,520,80,81920,708,135936,217856
test,521,87,89088,837,160704,249792
test,522,83,84992,762,146304,231296
test,523,167,171008,3083,591936,762944
test,524,244,249856,6580,1263360,1513216
test,525,112,114688,1387,266304,380992
test,526,227,232448,5695,1093440,1325888
test,527,168,172032,3120,599040,771072
test,528,50,51200,277,53184,104384
test,529,41,41984,186,35712,77696
test,530,212,217088,4967,953664,1170752
test,531,129,132096,1840,353280,485376
test,532,79,80896,690,132480,213376
test,533,110,112640,1338,256896,369536
test,534,187,191488,3865,742080,933568
test,535,244,249856,6580,1263360,1513216
test,536,83,84992,762,146304,231296
test,537,100,102400,1106,212352,314752
test,538,160,163840,2830,543360,707200
test,539,138,141312,2105,404160,545472
test,540,143,146432,2260,433920,580352
test,541,91,93184,916,175872,269056
test,542,126,129024,1755,336960,465984
test,543,145,148480,2324,446208,594688
test,544,82,83968,744,142848,226816
test,545,173,177152,3308,635136,812288
test,546,135,138240,2015,386880,525120
test,547,152,155648,2554,490368,646016
test,548,204,208896,4600,883200,1092096
test,549,92,94208,936,179712,273920
test,550,123,125952,1672,321024,446976
test,551,150,153600,2487,477504,631104
test,552,109,111616,1313,252096,363712
test,553,92,94208,936,179712,273920
test,554,113,115712,1412,271104,386816
test,555,80,81920,708,135936,217856
test,556,116,118784,1488,285696,404480
test,557,205,209920,4645,891840,1101760
test,558,211,216064,4921,944832,1160896
test,559,137,140288,2075,398400,538688
test,560,192,196608,4075,782400,979008
test,561,120,122880,1592,305664,428544
test,562,89,91136,876,168192,259328
test,563,222,227328,5447,1045824,1273152
test,564,134,137216,1985,381120,518336
test,565,154,157696,2621,503232,660928
test,566,228,233472,5746,1103232,1336704
test,567,197,201728,4289,823488,1025216
test,568,158,161792,2759,529728,691520
test,569,112,114688,1387,266304,380992
test,570,120,122880,1592,305664,428544
test,571,123,125952,1672,321024,446976
test,572,129,132096,1840,353280,485376
test,573,142,145408,2229,427968,573376
test,574,77,78848,656,125952,204800
test,575,104,106496,1196,229632,336128
test,576,192,196608,4075,782400,979008
test,577,76,77824,639,122688,200512
test,578,126,129024,1755,336960,465984
test,579,99,101376,1084,208128,309504
test,580,171,175104,3232,620544,795648
test,581,87,89088,837,160704,249792
test,582,156,159744,2690,516480,676224
test,583,117,119808,1513,290496,410304
test,584,269,275456,7998,1535616,1811072
test,585,215,220160,5109,980928,1201088
test,586,139,142336,2136,410112,552448
test,587,99,101376,1084,208128,309504
test,588,53,54272,311,59712,113984
test,589,176,180224,3424,657408,837632
test,590,159,162816,2794,536448,699264
test,591,125,128000,1727,331584,459584
test,592,159,162816,2794,536448,699264
test,593,162,165888,2901,556992,722880
test,594,159,162816,2794,536448,699264
test,595,129,132096,1840,353280,485376
test,596,252,258048,7019,1347648,1605696
test,597,150,153600,2487,477504,631104
test,598,68,69632,511,98112,167744
test,599,120,122880,1592,305664,428544
test,600,77,78848,656,125952,204800
test,601,140,143360,2167,416064,559424
test,602,105,107520,1219,234048,341568
test,603,107,109568,1266,243072,352640
test,604,161,164864,2865,550080,714944
test,605,209,214016,4828,926976,1140992
test,606,207,211968,4736,909312,1121280
test,607,170,174080,3194,613248,787328
test,608,144,147456,2292,440064,587520
test,609,79,80896,690,132480,213376
test,610,147,150528,2389,458688,609216
test,611,162,165888,2901,556992,722880
test,612,182,186368,3661,702912,889280
test,613,230,235520,5847,1122624,1358144
test,614,210,215040,4874,935808,1150848
test,615,181,185344,3621,695232,880576
test,616,82,83968,744,142848,226816
test,617,85,87040,799,153408,240448
test,618,141,144384,2198,422016,566400
test,619,141,144384,2198,422016,566400
test,620,112,114688,1387,266304,380992
test,621,158,161792,2759,529728,691520
test,622,205,209920,4645,891840,1101760
test,623,194,198656,4160,798720,997376
test,624,61,62464,412,79104,141568
test,625,163,166912,2937,563904,730816
test,626,160,163840,2830,543360,707200
test,627,97,99328,1040,199680,299008
test,628,127,130048,1783,342336,472384
test,629,126,129024,1755,336960,465984
test,630,180,184320,3581,687552,871872
test,631,189,193536,3948,758016,951552
test,632,104,106496,1196,229632,336128
test,633,190,194560,3990,766080,960640
test,634,143,146432,2260,433920,580352
test,635,142,145408,2229,427968,573376
test,636,181,185344,3621,695232,880576
test,637,171,175104,3232,620544,795648
test,638,163,166912,2937,563904,730816
test,639,125,128000,1727,331584,459584
test,640,141,144384,2198,422016,566400
test,641,204,208896,4600,883200,1092096
test,642,73,74752,589,113088,187840
test,643,130,133120,1868,358656,491776
test,644,176,180224,3424,657408,837632
test,645,157,160768,2725,523200,683968
test,646,238,243712,6261,1202112,1445824
test,647,66,67584,482,92544,160128
test,648,165,168960,3009,577728,746688
test,649,56,57344,347,66624,123968
test,650,85,87040,799,153408,240448
test,651,202,206848,4510,865920,1072768
test,652,142,145408,2229,427968,573376
test,653,111,113664,1362,261504,375168
test,654,113,115712,1412,271104,386816
test,655,190,194560,3990,766080,960640
test,656,175,179200,3385,649920,829120
test,657,181,185344,3621,695232,880576
test,658,164,167936,2973,570816,738752
test,659,113,115712,1412,271104,386816
test,660,165,168960,3009,577728,746688
test,661,161,164864,2865,550080,714944
test,662,156,159744,2690,516480,676224
test,663,163,166912,2937,563904,730816
test,664,133,136192,1955,375360,511552
test,665,143,146432,2260,433920,580352
test,666,180,184320,3581,687552,871872
test,667,125,128000,1727,331584,459584
test,668,232,237568,5949,1142208,1379776
test,669,110,112640,1338,256896,369536
test,670,158,161792,2759,529728,691520
test,671,152,155648,2554,490368,646016
test,672,195,199680,4203,806976,1006656
test,673,156,159744,2690,516480,676224
test,674,152,155648,2554,490368,646016
test,675,118,120832,1539,295488,416320
test,676,132,135168,1926,369792,504960
test,677,107,109568,1266,243072,352640
test,678,183,187392,3702,710784,898176
test,679,103,105472,1173,225216,330688
test,680,83,84992,762,146304,231296
test,681,134,137216,1985,381120,518336
test,682,174,178176,3346,642432,820608
test,683,169,173056,3157,606144,779200
test,684,144,147456,2292,440064,587520
test,685,233,238592,6000,1152000,1390592
test,686,124,126976,1700,326400,453376
test,687,130,133120,1868,358656,491776
test,688,95,97280,998,191616,288896
test,689,110,112640,1338,256896,369536
test,690,192,196608,4075,782400,979008
test,691,118,120832,1539,295488,416320
test,692,182,186368,3661,702912,889280
test,693,156,159744,2690,516480,676224
test,694,106,108544,1242,238464,347008
test,695,181,185344,3621,695232,880576
test,696,181,185344,3621,695232,880576
test,697,142,145408,2229,427968,573376
test,698,202,206848,4510,865920,1072768
test,699,157,160768,2725,523200,683968
test,700,173,177152,3308,635136,812288
test,701,124,126976,1700,326400,453376
test,702,142,145408,2229,427968,573376
test,703,141,144384,2198,422016,566400
test,704,198,202752,4333,831936,1034688
test,705,147,150528,2389,458688,609216
test,706,163,166912,2937,563904,730816
test,707,82,83968,744,142848,226816
test,708,94,96256,977,187584,283840
test,709,129,132096,1840,353280,485376
test,710,110,112640,1338,256896,369536
test,711,83,84992,762,146304,231296
test,712,195,199680,4203,806976,1006656
test,713,58,59392,372,71424,130816
test,714,177,181248,3463,664896,846144
test,715,66,67584,482,92544,160128
test,716,132,135168,1926,369792,504960
test,717,63,64512,439,84288,148800
test,718,90,92160,896,172032,264192
test,719,58,59392,372,71424,130816
test,720,101,103424,1128,216576,320000
test,721,138,141312,2105,404160,545472
test,722,78,79872,673,129216,209088
test,723,140,143360,2167,416064,559424
test,724,180,184320,3581,687552,871872
test,725,145,148480,2324,446208,594688
test,726,172,176128,3270,627840,803968
test,727,166,169984,3046,584832,754816
test,728,84,86016,780,149760,235776
test,729,163,166912,2937,563904,730816
test,730,203,207872,4555,874560,1082432
test,731,140,143360,2167,416064,559424
test,732,188,192512,3907,750144,942656
test,733,127,130048,1783,342336,472384
test,734,118,120832,1539,295488,416320
test,735,70,71680,542,104064,175744
test,736,60,61440,398,76416,137856
test,737,151,154624,2520,483840,638464
test,738,78,79872,673,129216,209088
test,739,201,205824,4465,857280,1063104
test,740,70,71680,542,104064,175744
test,741,213,218112,5014,962688,1180800
test,742,201,205824,4465,857280,1063104
test,743,113,115712,1412,271104,386816
test,744,72,73728,573,110016,183744
test,745,151,154624,2520,483840,638464
test,746,87,89088,837,160704,249792
test,747,101,103424,1128,216576,320000
test,748,137,140288,2075,398400,538688
test,749,97,99328,1040,199680,299008
test,750,290,296960,9295,1784640,2081600
test,751,178,182272,3502,672384,854656
test,752,143,146432,2260,433920,580352
test,753,134,137216,1985,381120,518336
test,754,96,98304,1019,195648,293952
test,755,237,242688,6208,1191936,1434624
test,756,126,129024,1755,336960,465984
test,757,146,149504,2356,452352,601856
test,758,109,111616,1313,252096,363712
test,759,86,88064,818,157056,245120
test,760,142,145408,2229,427968,573376
test,761,99,101376,1084,208128,309504
test,762,135,138240,2015,386880,525120
test,763,154,157696,2621,503232,660928
test,764,191,195584,4032,774144,969728
test,765,129,132096,1840,353280,485376
test,766,108,110592,1289,247488,358080
test,767,60,61440,398,76416,137856
test,768,68,69632,511,98112,167744
test,769,124,126976,1700,326400,453376
test,770,119,121856,1565,300480,422336
test,771,115,117760,1462,280704,398464
test,772,178,182272,3502,672384,854656
test,773,184,188416,3742,718464,906880
test,774,133,136192,1955,375360,511552
test,775,70,71680,542,104064,175744
test,776,88,90112,856,164352,254464
test,777,140,143360,2167,416064,559424
test,778,123,125952,1672,321024,446976
test,779,61,62464,412,79104,141568
test,780,169,173056,3157,606144,779200
test,781,230,235520,5847,1122624,1358144
test,782,157,160768,2725,523200,683968
test,783,61,62464,412,79104,141568
test,784,171,175104,3232,620544,795648
test,785,173,177152,3308,635136,812288
test,786,111,113664,1362,261504,375168
test,787,118,120832,1539,295488,416320
test,788,181,185344,3621,695232,880576
test,789,136,139264,2045,392640,531904
test,790,115,117760,1462,280704,398464
test,791,72,73728,573,110016,183744
test,792,135,138240,2015,386880,525120
test,793,143,146432,2260,433920,580352
test,794,189,193536,3948,758016,951552
test,795,52,53248,299,57408,110656
test,796,112,114688,1387,266304,380992
test,797,91,93184,916,175872,269056
test,798,132,135168,1926,369792,504960
test,799,105,107520,1219,234048,341568
test,800,96,98304,1019,195648,293952
test,801,274,280576,8298,1593216,1873792
test,802,144,147456,2292,440064,587520
test,803,125,128000,1727,331584,459584
test,804,98,100352,1062,203904,304256
test,805,117,119808,1513,290496,410304
test,806,195,199680,4203,806976,1006656
test,807,186,190464,3824,734208,924672
test,808,177,181248,3463,664896,846144
test,809,138,141312,2105,404160,545472
test,810,114,116736,1437,275904,392640
test,811,38,38912,160,30720,69632
test,812,77,78848,656,125952,204800
test,813,175,179200,3385,649920,829120
test,814,194,198656,4160,798720,997376
test,815,51,52224,288,55296,107520
test,816,150,153600,2487,477504,631104
test,817,68,69632,511,98112,167744
test,818,117,119808,1513,290496,410304
test,819,219,224256,5301,1017792,1242048
test,820,201,205824,4465,857280,1063104
test,821,84,86016,780,149760,235776
test,822,220,225280,5349,1027008,1252288
test,823,121,123904,1618,310656,434560
test,824,234,239616,6052,1161984,1401600
test,825,165,168960,3009,577728,746688
test,826,172,176128,3270,627840,803968
test,827,179,183296,3541,679872,863168
test,828,186,190464,3824,734208,924672
test,829,82,83968,744,142848,226816
test,830,133,136192,1955,375360,511552
test,831,142,145408,2229,427968,573376
test,832,114,116736,1437,275904,392640
test,833,77,78848,656,125952,204800
test,834,57,58368,359,68928,127296
test,835,91,93184,916,175872,269056
test,836,182,186368,3661,702912,889280
test,837,217,222208,5205,999360,1221568
test,838,163,166912,2937,563904,730816
test,839,124,126976,1700,326400,453376
test,840,98,100352,1062,203904,304256
test,841,156,159744,2690,516480,676224
test,842,96,98304,1019,195648,293952
test,843,140,143360,2167,416064,559424
test,844,75,76800,622,119424,196224
test,845,62,63488,425,81600,145088
test,846,176,180224,3424,657408,837632
test,847,145,148480,2324,446208,594688
test,848,165,168960,3009,577728,746688
test,849,161,164864,2865,550080,714944
test,850,157,160768,2725,523200,683968
test,851,136,139264,2045,392640,531904
test,852,110,112640,1338,256896,369536
test,853,118,120832,1539,295488,416320
test,854,113,115712,1412,271104,386816
test,855,183,187392,3702,710784,898176
test,856,133,136192,1955,375360,511552
test,857,113,115712,1412,271104,386816
test,858,182,186368,3661,702912,889280
test,859,130,133120,1868,358656,491776
test,860,91,93184,916,175872,269056
test,861,156,159744,2690,516480,676224
test,862,176,180224,3424,657408,837632
test,863,253,259072,7075,1358400,1617472
test,864,77,78848,656,125952,204800
test,865,152,155648,2554,490368,646016
test,866,176,180224,3424,657408,837632
test,867,189,193536,3948,758016,951552
test,868,76,77824,639,122688,200512
test,869,165,168960,3009,577728,746688
test,870,104,106496,1196,229632,336128
test,871,84,86016,780,149760,235776
test,872,126,129024,1755,336960,465984
test,873,146,149504,2356,452352,601856
test,874,131,134144,1897,364224,498368
test,875,54,55296,323,62016,117312
test,876,203,207872,4555,874560,1082432
test,877,83,84992,762,146304,231296
test,878,137,140288,2075,398400,538688
test,879,111,113664,1362,261504,375168
test,880,190,194560,3990,766080,960640
test,881,151,154624,2520,483840,638464
test,882,90,92160,896,172032,264192
test,883,172,176128,3270,627840,803968
test,884,128,131072,1811,347712,478784
test,885,166,169984,3046,584832,754816
test,886,120,122880,1592,305664,428544
test,887,175,179200,3385,649920,829120
test,888,60,61440,398,76416,137856
test,889,170,174080,3194,613248,787328
test,890,78,79872,673,129216,209088
test,891,144,147456,2292,440064,587520
test,892,167,171008,3083,591936,762944
test,893,147,150528,2389,458688,609216
test,894,173,177152,3308,635136,812288
test,895,82,83968,744,142848,226816
test,896,110,112640,1338,256896,369536
test,897,160,163840,2830,543360,707200
test,898,80,81920,708,135936,217856
test,899,207,211968,4736,909312,1121280
test,900,244,249856,6580,1263360,1513216
test,901,129,132096,1840,353280,485376
test,902,143,146432,2260,433920,580352
test,903,151,154624,2520,483840,638464
test,904,93,95232,956,183552,278784
test,905,179,183296,3541,679872,863168
test,906,107,109568,1266,243072,352640
test,907,91,93184,916,175872,269056
test,908,105,107520,1219,234048,341568
test,909,57,58368,359,68928,127296
test,910,145,148480,2324,446208,594688
test,911,110,112640,1338,256896,369536
test,912,127,130048,1783,342336,472384
test,913,130,133120,1868,358656,491776
test,914,141,144384,2198,422016,566400
test,915,153,156672,2587,496704,653376
test,916,153,156672,2587,496704,653376
test,917,63,64512,439,84288,148800
test,918,180,184320,3581,687552,871872
test,919,131,134144,1897,364224,498368
test,920,143,146432,2260,433920,580352
test,921,105,107520,1219,234048,341568
test,922,162,165888,2901,556992,722880
test,923,102,104448,1150,220800,325248
test,924,154,157696,2621,503232,660928
test,925,65,66560,467,89664,156224
test,926,152,155648,2554,490368,646016
test,927,174,178176,3346,642432,820608
test,928,151,154624,2520,483840,638464
test,929,81,82944,725,139200,222144
test,930,150,153600,2487,477504,631104
test,931,99,101376,1084,208128,309504
test,932,124,126976,1700,326400,453376
test,933,182,186368,3661,702912,889280
test,934,122,124928,1645,315840,440768
test,935,113,115712,1412,271104,386816
test,936,128,131072,1811,347712,478784
test,937,236,241664,6156,1181952,1423616
test,938,163,166912,2937,563904,730816
test,939,100,102400,1106,212352,314752
test,940,137,140288,2075,398400,538688
test,941,163,166912,2937,563904,730816
test,942,55,56320,335,64320,120640
test,943,161,164864,2865,550080,714944
test,944,165,168960,3009,577728,746688
test,945,147,150528,2389,458688,609216
test,946,94,96256,977,187584,283840
test,947,135,138240,2015,386880,525120
test,948,145,148480,2324,446208,594688
test,949,130,133120,1868,358656,491776
test,950,115,117760,1462,280704,398464
test,951,142,145408,2229,427968,573376
test,952,231,236544,5898,1132416,1368960
test,953,137,140288,2075,398400,538688
test,954,144,147456,2292,440064,587520
test,955,218,223232,5253,1008576,1231808
test,956,103,105472,1173,225216,330688
test,957,168,172032,3120,599040,771072
test,958,121,123904,1618,310656,434560
test,959,96,98304,1019,195648,293952
test,960,168,172032,3120,599040,771072
test,961,93,95232,956,183552,278784
test,962,119,121856,1565,300480,422336
test,963,112,114688,1387,266304,380992
test,964,126,129024,1755,336960,465984
test,965,107,109568,1266,243072,352640
test,966,97,99328,1040,199680,299008
test,967,197,201728,4289,823488,1025216
test,968,186,190464,3824,734208,924672
test,969,113,115712,1412,271104,386816
test,970,105,107520,1219,234048,341568
test,971,147,150528,2389,458688,609216
test,972,125,128000,1727,331584,459584
test,973,91,93184,916,175872,269056
test,974,115,117760,1462,280704,398464
test,975,238,243712,6261,1202112,1445824
test,976,124,126976,1700,326400,453376
test,977,102,104448,1150,220800,325248
test,978,199,203776,4377,840384,1044160
test,979,205,209920,4645,891840,1101760
test,980,123,125952,1672,321024,446976
test,981,143,146432,2260,433920,580352
test,982,171,175104,3232,620544,795648
test,983,142,145408,2229,427968,573376
test,984,170,174080,3194,613248,787328
test,985,50,51200,277,53184,104384
test,986,84,86016,780,149760,235776
test,987,149,152576,2454,471168,623744
test,988,176,180224,3424,657408,837632
test,989,216,221184,5157,990144,1211328
test,990,110,112640,1338,256896,369536
test,991,67,68608,497,95424,164032
test,992,128,131072,1811,347712,478784
test,993,182,186368,3661,702912,889280
test,994,141,144384,2198,422016,566400
test,995,78,79872,673,129216,209088
test,996,230,235520,5847,1122624,1358144
test,997,153,156672,2587,496704,653376
test,998,118,120832,1539,295488,416320
test,999,197,201728,4289,823488,1025216
test,1000,145,148480,2324,446208,594688
test,1001,131,134144,1897,364224,498368
test,1002,107,109568,1266,243072,352640
test,1003,120,122880,1592,305664,428544
test,1004,167,171008,3083,591936,762944
test,1005,112,114688,1387,266304,380992
test,1006,99,101376,1084,208128,309504
test,1007,192,196608,4075,782400,979008
test,1008,125,128000,1727,331584,459584
test,1009,177,181248,3463,664896,846144
test,1010,118,120832,1539,295488,416320
test,1011,161,164864,2865,550080,714944
test,1012,169,173056,3157,606144,779200
test,1013,138,141312,2105,404160,545472
test,1014,144,147456,2292,440064,587520
test,1015,114,116736,1437,275904,392640
test,1016,108,110592,1289,247488,358080
test,1017,184,188416,3742,718464,906880
test,1018,96,98304,1019,195648,293952
test,1019,150,153600,2487,477504,631104
test,1020,176,180224,3424,657408,837632
test,1021,138,141312,2105,404160,545472
test,1022,69,70656,527,101184,171840
test,1023,88,90112,856,164352,254464
test,1024,148,151552,2421,464832,616384
test,1025,162,165888,2901,556992,722880
test,1026,48,49152,255,48960,98112
test,1027,126,129024,1755,336960,465984
test,1028,171,175104,3232,620544,795648
test,1029,104,106496,1196,229632,336128
test,1030,102,104448,1150,220800,325248
test,1031,59,60416,385,73920,134336
test,1032,151,154624,2520,483840,638464
test,1033,145,148480,2324,446208,594688
test,1034,154,157696,2621,503232,660928
test,1035,124,126976,1700,326400,453376
test,1036,66,67584,482,92544,160128
test,1037,130,133120,1868,358656,491776
test,1038,125,128000,1727,331584,459584
test,1039,48,49152,255,48960,98112
test,1040,54,55296,323,62016,117312
test,1041,190,194560,3990,766080,960640
test,1042,115,117760,1462,280704,398464
test,1043,117,119808,1513,290496,410304
test,1044,167,171008,3083,591936,762944
test,1045,199,203776,4377,840384,1044160
test,1046,210,215040,4874,935808,1150848
test,1047,199,203776,4377,840384,1044160
test,1048,143,146432,2260,433920,580352
test,1049,177,181248,3463,664896,846144
test,1050,131,134144,1897,364224,498368
test,1051,129,132096,1840,353280,485376
test,1052,102,104448,1150,220800,325248
test,1053,135,138240,2015,386880,525120
test,1054,194,198656,4160,798720,997376
test,1055,185,189440,3783,726336,915776
test,1056,138,141312,2105,404160,545472
test,1057,210,215040,4874,935808,1150848
test,1058,67,68608,497,95424,164032
test,1059,78,79872,673,129216,209088
test,1060,96,98304,1019,195648,293952
test,1061,246,251904,6688,1284096,1536000
test,1062,136,139264,2045,392640,531904
test,1063,240,245760,6366,1222272,1468032
test,1064,109,111616,1313,252096,363712
test,1065,195,199680,4203,806976,1006656
test,1066,129,132096,1840,353280,485376
test,1067,101,103424,1128,216576,320000
test,1068,106,108544,1242,238464,347008
test,1069,163,166912,2937,563904,730816
test,1070,159,162816,2794,536448,699264
test,1071,124,126976,1700,326400,453376
test,1072,156,159744,2690,516480,676224
test,1073,120,122880,1592,305664,428544
test,1074,172,176128,3270,627840,803968
test,1075,233,238592,6000,1152000,1390592
test,1076,135,138240,2015,386880,525120
test,1077,198,202752,4333,831936,1034688
test,1078,176,180224,3424,657408,837632
test,1079,275,281600,8358,1604736,1886336
test,1080,226,231424,5645,1083840,1315264
test,1081,151,154624,2520,483840,638464
test,1082,105,107520,1219,234048,341568
test,1083,184,188416,3742,718464,906880
test,1084,171,175104,3232,620544,795648
test,1085,163,166912,2937,563904,730816
test,1086,138,141312,2105,404160,545472
test,1087,185,189440,3783,726336,915776
test,1088,153,156672,2587,496704,653376
test,1089,153,156672,2587,496704,653376
test,1090,50,51200,277,53184,104384
test,1091,166,169984,3046,584832,754816
test,1092,114,116736,1437,275904,392640
test,1093,57,58368,359,68928,127296
test,1094,147,150528,2389,458688,609216
test,1095,175,179200,3385,649920,829120
test,1096,194,198656,4160,798720,997376
test,1097,198,202752,4333,831936,1034688
test,1098,183,187392,3702,710784,898176
test,1099,250,256000,6908,1326336,1582336
test,1100,159,162816,2794,536448,699264
test,1101,182,186368,3661,702912,889280
test,1102,80,81920,708,135936,217856
test,1103,72,73728,573,110016,183744
test,1104,152,155648,2554,490368,646016
test,1105,221,226304,5398,1036416,1262720
test,1106,153,156672,2587,496704,653376
test,1107,226,231424,5645,1083840,1315264
test,1108,130,133120,1868,358656,491776
test,1109,131,134144,1897,364224,498368
test,1110,191,195584,4032,774144,969728
test,1111,128,131072,1811,347712,478784
test,1112,121,123904,1618,310656,434560
test,1113,102,104448,1150,220800,325248
test,1114,201,205824,4465,857280,1063104
test,1115,119,121856,1565,300480,422336
test,1116,162,165888,2901,556992,722880
test,1117,90,92160,896,172032,264192
test,1118,164,167936,2973,570816,738752
test,1119,122,124928,1645,315840,440768
test,1120,146,149504,2356,452352,601856
test,1121,130,133120,1868,358656,491776
test,1122,132,135168,1926,369792,504960
test,1123,69,70656,527,101184,171840
test,1124,139,142336,2136,410112,552448
test,1125,238,243712,6261,1202112,1445824
test,1126,123,125952,1672,321024,446976
test,1127,179,183296,3541,679872,863168
test,1128,112,114688,1387,266304,380992
test,1129,156,159744,2690,516480,676224
test,1130,141,144384,2198,422016,566400
test,1131,164,167936,2973,570816,738752
test,1132,172,176128,3270,627840,803968
test,1133,116,118784,1488,285696,404480
test,1134,169,173056,3157,606144,779200
test,1135,194,198656,4160,798720,997376
test,1136,161,164864,2865,550080,714944
test,1137,165,168960,3009,577728,746688
test,1138,174,178176,3346,642432,820608
test,1139,118,120832,1539,295488,416320
test,1140,142,145408,2229,427968,573376
test,1141,93,95232,956,183552,278784
test,1142,145,148480,2324,446208,594688
test,1143,187,191488,3865,742080,933568
test,1144,212,217088,4967,953664,1170752
test,1145,144,147456,2292,440064,587520
test,1146,212,217088,4967,953664,1170752
test,1147,96,98304,1019,195648,293952
test,1148,215,220160,5109,980928,1201088
test,1149,212,217088,4967,953664,1170752
test,1150,188,192512,3907,750144,942656
test,1151,56,57344,347,66624,123968
test,1152,50,51200,277,53184,104384
test,1153,68,69632,511,98112,167744
test,1154,161,164864,2865,550080,714944
test,1155,185,189440,3783,726336,915776
test,1156,178,182272,3502,672384,854656
test,1157,71,72704,558,107136,179840
test,1158,143,146432,2260,433920,580352
test,1159,200,204800,4421,848832,1053632
test,1160,183,187392,3702,710784,898176
test,1161,170,174080,3194,613248,787328
test,1162,53,54272,311,59712,113984
test,1163,69,70656,527,101184,171840
test,1164,102,104448,1150,220800,325248
test,1165,119,121856,1565,300480,422336
test,1166,104,106496,1196,229632,336128
test,1167,153,156672,2587,496704,653376
test,1168,96,98304,1019,195648,293952
test,1169,90,92160,896,172032,264192
test,1170,221,226304,5398,1036416,1262720
test,1171,133,136192,1955,375360,511552
test,1172,113,115712,1412,271104,386816
test,1173,169,173056,3157,606144,779200
test,1174,157,160768,2725,523200,683968
test,1175,106,108544,1242,238464,347008
test,1176,167,171008,3083,591936,762944
test,1177,79,80896,690,132480,213376
test,1178,128,131072,1811,347712,478784
test,1179,161,164864,2865,550080,714944
test,1180,120,122880,1592,305664,428544
test,1181,186,190464,3824,734208,924672
test,1182,119,121856,1565,300480,422336
test,1183,114,116736,1437,275904,392640
test,1184,101,103424,1128,216576,320000
test,1185,159,162816,2794,536448,699264
test,1186,168,172032,3120,599040,771072
test,1187,140,143360,2167,416064,559424
test,1188,113,115712,1412,271104,386816
test,1189,65,66560,467,89664,156224
test,1190,117,119808,1513,290496,410304
test,1191,184,188416,3742,718464,906880
test,1192,156,159744,2690,516480,676224
test,1193,137,140288,2075,398400,538688
test,1194,163,166912,2937,563904,730816
test,1195,172,176128,3270,627840,803968
test,1196,163,166912,2937,563904,730816
test,1197,161,164864,2865,550080,714944
test,1198,107,109568,1266,243072,352640
test,1199,135,138240,2015,386880,525120
test,1200,176,180224,3424,657408,837632
test,1201,120,122880,1592,305664,428544
test,1202,56,57344,347,66624,123968
test,1203,156,159744,2690,516480,676224
test,1204,130,133120,1868,358656,491776
test,1205,112,114688,1387,266304,380992
test,1206,202,206848,4510,865920,1072768
test,1207,147,150528,2389,458688,609216
test,1208,181,185344,3621,695232,880576
test,1209,223,228352,5496,1055232,1283584
test,1210,89,91136,876,168192,259328
test,1211,103,105472,1173,225216,330688
test,1212,252,258048,7019,1347648,1605696
test,1213,42,43008,195,37440,80448
test,1214,206,210944,4690,900480,1111424
test,1215,168,172032,3120,599040,771072
test,1216,114,116736,1437,275904,392640
test,1217,122,124928,1645,315840,440768
test,1218,139,142336,2136,410112,552448
test,1219,187,191488,3865,742080,933568
test,1220,199,203776,4377,840384,1044160
test,1221,179,183296,3541,679872,863168
test,1222,127,130048,1783,342336,472384
test,1223,83,84992,762,146304,231296
test,1224,199,203776,4377,840384,1044160
test,1225,177,181248,3463,664896,846144
test,1226,167,171008,3083,591936,762944
test,1227,139,142336,2136,410112,552448
test,1228,181,185344,3621,695232,880576
test,1229,186,190464,3824,734208,924672
test,1230,256,262144,7243,1390656,1652800
test,1231,147,150528,2389,458688,609216
test,1232,58,59392,372,71424,130816
test,1233,157,160768,2725,523200,683968
test,1234,187,191488,3865,742080,933568
test,1235,33,33792,121,23232,57024
test,1236,91,93184,916,175872,269056
test,1237,52,53248,299,57408,110656
test,1238,95,97280,998,191616,288896
test,1239,172,176128,3270,627840,803968
test,1240,188,192512,3907,750144,942656
test,1241,180,184320,3581,687552,871872
test,1242,179,183296,3542,680064,863360
test,1243,154,157696,2621,503232,660928
test,1244,66,67584,482,92544,160128
test,1245,64,65536,453,86976,152512
test,1246,121,123904,1618,310656,434560
test,1247,143,146432,2260,433920,580352
test,1248,83,84992,762,146304,231296
test,1249,182,186368,3661,702912,889280
test,1250,146,149504,2356,452352,601856
test,1251,172,176128,3270,627840,803968
test,1252,114,116736,1437,275904,392640
test,1253,153,156672,2587,496704,653376
test,1254,162,165888,2901,556992,722880
test,1255,140,143360,2167,416064,559424
test,1256,162,165888,2901,556992,722880
test,1257,104,106496,1196,229632,336128
test,1258,146,149504,2356,452352,601856
test,1259,180,184320,3581,687552,871872
test,1260,68,69632,511,98112,167744
test,1261,111,113664,1362,261504,375168
test,1262,160,163840,2830,543360,707200
test,1263,191,195584,4032,774144,969728
test,1264,110,112640,1338,256896,369536
test,1265,129,132096,1840,353280,485376
test,1266,135,138240,2015,386880,525120
test,1267,148,151552,2421,464832,616384
test,1268,236,241664,6156,1181952,1423616
test,1269,171,175104,3232,620544,795648
test,1270,174,178176,3346,642432,820608
test,1271,110,112640,1338,256896,369536
test,1272,50,51200,277,53184,104384
test,1273,132,135168,1926,369792,504960
test,1274,128,131072,1811,347712,478784
test,1275,160,163840,2830,543360,707200
test,1276,187,191488,3865,742080,933568
test,1277,217,222208,5205,999360,1221568
test,1278,184,188416,3742,718464,906880
test,1279,184,188416,3742,718464,906880
test,1280,119,121856,1565,300480,422336
test,1281,130,133120,1868,358656,491776
test,1282,193,197632,4117,790464,988096
test,1283,130,133120,1868,358656,491776
test,1284,156,159744,2690,516480,676224
test,1285,96,98304,1019,195648,293952
test,1286,242,247808,6473,1242816,1490624
test,1287,66,67584,482,92544,160128
test,1288,46,47104,234,44928,92032
test,1289,136,139264,2045,392640,531904
test,1290,160,163840,2830,543360,707200
test,1291,122,124928,1645,315840,440768
test,1292,90,92160,896,172032,264192
test,1293,195,199680,4203,806976,1006656
test,1294,52,53248,299,57408,110656
test,1295,118,120832,1539,295488,416320
test,1296,167,171008,3083,591936,762944
test,1297,218,223232,5253,1008576,1231808
test,1298,131,134144,1897,364224,498368
test,1299,140,143360,2167,416064,559424
test,1300,92,94208,936,179712,273920
test,1301,90,92160,896,172032,264192
test,1302,120,122880,1592,305664,428544
test,1303,58,59392,372,71424,130816
test,1304,232,237568,5949,1142208,1379776
test,1305,136,139264,2045,392640,531904
test,1306,166,169984,3046,584832,754816
test,1307,45,46080,224,43008,89088
test,1308,178,182272,3502,672384,854656
test,1309,189,193536,3948,758016,951552
test,1310,64,65536,453,86976,152512
test,1311,145,148480,2324,446208,594688
test,1312,115,117760,1462,280704,398464
test,1313,120,122880,1592,305664,428544
test,1314,107,109568,1266,243072,352640
test,1315,165,168960,3009,577728,746688
test,1316,191,195584,4032,774144,969728
test,1317,159,162816,2794,536448,699264
test,1318,106,108544,1242,238464,347008
test,1319,50,51200,277,53184,104384
test,1320,66,67584,482,92544,160128
test,1321,172,176128,3270,627840,803968
test,1322,76,77824,639,122688,200512
test,1323,175,179200,3385,649920,829120
test,1324,128,131072,1811,347712,478784
test,1325,168,172032,3120,599040,771072
test,1326,126,129024,1755,336960,465984
test,1327,98,100352,1062,203904,304256
test,1328,216,221184,5157,990144,1211328
test,1329,98,100352,1062,203904,304256
test,1330,256,262144,7243,1390656,1652800
test,1331,161,164864,2865,550080,714944
test,1332,111,113664,1362,261504,375168
test,1333,167,171008,3083,591936,762944
test,1334,212,217088,4967,953664,1170752
test,1335,135,138240,2015,386880,525120
test,1336,165,168960,3009,577728,746688
test,1337,115,117760,1462,280704,398464
test,1338,146,149504,2356,452352,601856
test,1339,167,171008,3083,591936,762944
test,1340,82,83968,744,142848,226816
test,1341,137,140288,2075,398400,538688
test,1342,132,135168,1926,369792,504960
test,1343,198,202752,4333,831936,1034688
test,1344,135,138240,2015,386880,525120
test,1345,147,150528,2389,458688,609216
test,1346,153,156672,2587,496704,653376
test,1347,72,73728,573,110016,183744
test,1348,110,112640,1338,256896,369536
test,1349,78,79872,673,129216,209088
test,1350,177,181248,3463,664896,846144
test,1351,134,137216,1985,381120,518336
test,1352,76,77824,639,122688,200512
test,1353,100,102400,1106,212352,314752
test,1354,109,111616,1313,252096,363712
test,1355,211,216064,4921,944832,1160896
test,1356,135,138240,2015,386880,525120
test,1357,56,57344,347,66624,123968
test,1358,134,137216,1985,381120,518336
test,1359,123,125952,1672,321024,446976
test,1360,148,151552,2421,464832,616384
test,1361,107,109568,1266,243072,352640
test,1362,132,135168,1926,369792,504960
test,1363,103,105472,1173,225216,330688
test,1364,241,246784,6419,1232448,1479232
test,1365,175,179200,3385,649920,829120
test,1366,166,169984,3046,584832,754816
test,1367,193,197632,4117,790464,988096
test,1368,119,121856,1565,300480,422336
test,1369,133,136192,1955,375360,511552
test,1370,125,128000,1727,331584,459584
test,1371,118,120832,1539,295488,416320
test,1372,127,130048,1783,342336,472384
test,1373,116,118784,1488,285696,404480
test,1374,183,187392,3702,710784,898176
test,1375,137,140288,2075,398400,538688
test,1376,40,40960,177,33984,74944
test,1377,245,250880,6634,1273728,1524608
test,1378,142,145408,2229,427968,573376
test,1379,41,41984,186,35712,77696
test,1380,137,140288,2075,398400,538688
test,1381,85,87040,799,153408,240448
test,1382,129,132096,1840,353280,485376
test,1383,69,70656,527,101184,171840
test,1384,121,123904,1618,310656,434560
test,1385,108,110592,1289,247488,358080
test,1386,186,190464,3824,734208,924672
test,1387,99,101376,1084,208128,309504
test,1388,143,146432,2260,433920,580352
test,1389,111,113664,1362,261504,375168
test,1390,128,131072,1811,347712,478784
test,1391,211,216064,4921,944832,1160896
test,1392,161,164864,2865,550080,714944
test,1393,175,179200,3385,649920,829120
test,1394,58,59392,372,71424,130816
test,1395,197,201728,4289,823488,1025216
test,1396,125,128000,1727,331584,459584
test,1397,180,184320,3581,687552,871872
test,1398,85,87040,799,153408,240448
test,1399,168,172032,3120,599040,771072
test,1400,120,122880,1592,305664,428544
test,1401,109,111616,1313,252096,363712
test,1402,104,106496,1196,229632,336128
test,1403,157,160768,2725,523200,683968
test,1404,41,41984,186,35712,77696
test,1405,122,124928,1645,315840,440768
test,1406,114,116736,1437,275904,392640
test,1407,193,197632,4117,790464,988096
test,1408,171,175104,3232,620544,795648
test,1409,83,84992,762,146304,231296
test,1410,184,188416,3742,718464,906880
test,1411,142,145408,2229,427968,573376
test,1412,146,149504,2356,452352,601856
test,1413,158,161792,2759,529728,691520
test,1414,124,126976,1700,326400,453376
test,1415,208,212992,4782,918144,1131136
test,1416,108,110592,1289,247488,358080
test,1417,172,176128,3270,627840,803968
test,1418,256,262144,7243,1390656,1652800
test,1419,142,145408,2229,427968,573376
test,1420,163,166912,2937,563904,730816
test,1421,125,128000,1727,331584,459584
test,1422,122,124928,1645,315840,440768
test,1423,280,286720,8665,1663680,1950400
test,1424,99,101376,1084,208128,309504
test,1425,229,234496,5796,1112832,1347328
test,1426,174,178176,3346,642432,820608
test,1427,183,187392,3702,710784,898176
test,1428,158,161792,2759,529728,691520
test,1429,150,153600,2487,477504,631104
test,1430,199,203776,4377,840384,1044160
test,1431,149,152576,2454,471168,623744
test,1432,117,119808,1513,290496,410304
test,1433,187,191488,3865,742080,933568
test,1434,66,67584,482,92544,160128
test,1435,165,168960,3009,577728,746688
test,1436,173,177152,3308,635136,812288
test,1437,158,161792,2759,529728,691520
test,1438,133,136192,1955,375360,511552
test,1439,53,54272,311,59712,113984
test,1440,158,161792,2759,529728,691520
test,1441,94,96256,977,187584,283840
test,1442,143,146432,2260,433920,580352
test,1443,81,82944,725,139200,222144
test,1444,221,226304,5398,1036416,1262720
test,1445,93,95232,956,183552,278784
test,1446,80,81920,708,135936,217856
test,1447,178,182272,3502,672384,854656
test,1448,114,116736,1437,275904,392640
test,1449,102,104448,1150,220800,325248
test,1450,157,160768,2725,523200,683968
test,1451,83,84992,762,146304,231296
test,1452,127,130048,1783,342336,472384
test,1453,72,73728,573,110016,183744
test,1454,184,188416,3742,718464,906880
test,1455,220,225280,5349,1027008,1252288
test,1456,134,137216,1985,381120,518336
test,1457,128,131072,1811,347712,478784
test,1458,70,71680,542,104064,175744
test,1459,95,97280,998,191616,288896
test,1460,174,178176,3346,642432,820608
test,1461,78,79872,673,129216,209088
test,1462,146,149504,2356,452352,601856
test,1463,183,187392,3702,710784,898176
test,1464,105,107520,1219,234048,341568
test,1465,162,165888,2901,556992,722880
test,1466,72,73728,573,110016,183744
test,1467,183,187392,3702,710784,898176
test,1468,208,212992,4782,918144,1131136
test,1469,136,139264,2045,392640,531904
test,1470,149,152576,2454,471168,623744
test,1471,191,195584,4032,774144,969728
test,1472,139,142336,2136,410112,552448
test,1473,136,139264,2045,392640,531904
test,1474,182,186368,3661,702912,889280
test,1475,95,97280,998,191616,288896
test,1476,84,86016,780,149760,235776
test,1477,131,134144,1897,364224,498368
test,1478,174,178176,3346,642432,820608
test,1479,131,134144,1897,364224,498368
test,1480,170,174080,3194,613248,787328
test,1481,128,131072,1811,347712,478784
test,1482,124,126976,1700,326400,453376
test,1483,194,198656,4160,798720,997376
test,1484,100,102400,1106,212352,314752
test,1485,98,100352,1062,203904,304256
test,1486,135,138240,2015,386880,525120
test,1487,196,200704,4246,815232,1015936
test,1488,152,155648,2554,490368,646016
test,1489,145,148480,2324,446208,594688
test,1490,77,78848,656,125952,204800
test,1491,60,61440,398,76416,137856
test,1492,68,69632,511,98112,167744
test,1493,103,105472,1173,225216,330688
test,1494,158,161792,2759,529728,691520
test,1495,207,211968,4736,909312,1121280
test,1496,254,260096,7131,1369152,1629248
test,1497,149,152576,2454,471168,623744
test,1498,190,194560,3990,766080,960640
test,1499,202,206848,4510,865920,1072768
test,1500,104,106496,1196,229632,336128
test,1501,172,176128,3270,627840,803968
test,1502,66,67584,482,92544,160128
test,1503,144,147456,2292,440064,587520
test,1504,139,142336,2136,410112,552448
test,1505,145,148480,2324,446208,594688
test,1506,75,76800,622,119424,196224
test,1507,166,169984,3046,584832,754816
test,1508,120,122880,1592,305664,428544
test,1509,161,164864,2865,550080,714944
test,1510,46,47104,234,44928,92032
test,1511,169,173056,3157,606144,779200
test,1512,63,64512,439,84288,148800
test,1513,87,89088,837,160704,249792
test,1514,103,105472,1173,225216,330688
test,1515,133,136192,1955,375360,511552
test,1516,154,157696,2621,503232,660928
test,1517,141,144384,2198,422016,566400
test,1518,72,73728,573,110016,183744
test,1519,116,118784,1488,285696,404480
test,1520,156,159744,2690,516480,676224
test,1521,132,135168,1926,369792,504960
test,1522,161,164864,2865,550080,714944
test,1523,168,172032,3120,599040,771072
test,1524,58,59392,372,71424,130816
test,1525,98,100352,1062,203904,304256
test,1526,157,160768,2725,523200,683968
test,1527,136,139264,2045,392640,531904
test,1528,176,180224,3424,657408,837632
test,1529,121,123904,1618,310656,434560
test,1530,186,190464,3824,734208,924672
test,1531,169,173056,3157,606144,779200
test,1532,155,158720,2656,509952,668672
test,1533,105,107520,1219,234048,341568
test,1534,138,141312,2105,404160,545472
test,1535,179,183296,3541,679872,863168
test,1536,105,107520,1219,234048,341568
test,1537,147,150528,2389,458688,609216
test,1538,203,207872,4555,874560,1082432
test,1539,147,150528,2389,458688,609216
test,1540,194,198656,4160,798720,997376
test,1541,206,210944,4690,900480,1111424
test,1542,149,152576,2454,471168,623744
test,1543,153,156672,2587,496704,653376
test,1544,115,117760,1462,280704,398464
test,1545,138,141312,2105,404160,545472
test,1546,176,180224,3424,657408,837632
test,1547,132,135168,1926,369792,504960
test,1548,93,95232,956,183552,278784
test,1549,135,138240,2015,386880,525120
test,1550,69,70656,527,101184,171840
test,1551,180,184320,3581,687552,871872
test,1552,124,126976,1700,326400,453376
test,1553,167,171008,3083,591936,762944
test,1554,111,113664,1362,261504,375168
test,1555,146,149504,2356,452352,601856
test,1556,211,216064,4921,944832,1160896
test,1557,147,150528,2389,458688,609216
test,1558,202,206848,4510,865920,1072768
test,1559,90,92160,896,172032,264192
test,1560,208,212992,4782,918144,1131136
test,1561,69,70656,527,101184,171840
test,1562,151,154624,2520,483840,638464
test,1563,173,177152,3308,635136,812288
test,1564,151,154624,2520,483840,638464
test,1565,148,151552,2421,464832,616384
test,1566,154,157696,2621,503232,660928
test,1567,124,126976,1700,326400,453376
test,1568,150,153600,2487,477504,631104
test,1569,69,70656,527,101184,171840
test,1570,103,105472,1173,225216,330688
test,1571,139,142336,2136,410112,552448
test,1572,147,150528,2389,458688,609216
test,1573,101,103424,1128,216576,320000
test,1574,129,132096,1840,353280,485376
test,1575,68,69632,511,98112,167744
test,1576,107,109568,1266,243072,352640
test,1577,157,160768,2725,523200,683968
test,1578,163,166912,2937,563904,730816
test,1579,160,163840,2830,543360,707200
test,1580,206,210944,4690,900480,1111424
test,1581,100,102400,1106,212352,314752
test,1582,167,171008,3083,591936,762944
test,1583,219,224256,5301,1017792,1242048
test,1584,102,104448,1150,220800,325248
test,1585,111,113664,1362,261504,375168
test,1586,59,60416,385,73920,134336
test,1587,116,118784,1488,285696,404480
test,1588,119,121856,1565,300480,422336
test,1589,170,174080,3194,613248,787328
test,1590,122,124928,1645,315840,440768
test,1591,180,184320,3581,687552,871872
test,1592,91,93184,916,175872,269056
test,1593,65,66560,467,89664,156224
test,1594,194,198656,4160,798720,997376
test,1595,185,189440,3783,726336,915776
test,1596,93,95232,956,183552,278784
test,1597,199,203776,4377,840384,1044160
test,1598,86,88064,818,157056,245120
test,1599,139,142336,2136,410112,552448
test,1600,138,141312,2105,404160,545472
test,1601,108,110592,1289,247488,358080
test,1602,161,164864,2865,550080,714944
test,1603,171,175104,3232,620544,795648
test,1604,132,135168,1926,369792,504960
test,1605,120,122880,1592,305664,428544
test,1606,181,185344,3621,695232,880576
test,1607,201,205824,4465,857280,1063104
test,1608,209,214016,4828,926976,1140992
test,1609,154,157696,2621,503232,660928
test,1610,122,124928,1645,315840,440768
test,1611,103,105472,1173,225216,330688
test,1612,102,104448,1150,220800,325248
test,1613,88,90112,856,164352,254464
test,1614,173,177152,3308,635136,812288
test,1615,85,87040,799,153408,240448
test,1616,140,143360,2167,416064,559424
test,1617,109,111616,1313,252096,363712
test,1618,75,76800,622,119424,196224
test,1619,157,160768,2725,523200,683968
test,1620,159,162816,2794,536448,699264
test,1621,131,134144,1897,364224,498368
test,1622,142,145408,2229,427968,573376
test,1623,137,140288,2075,398400,538688
test,1624,94,96256,977,187584,283840
test,1625,162,165888,2901,556992,722880
test,1626,82,83968,744,142848,226816
test,1627,161,164864,2865,550080,714944
test,1628,146,149504,2356,452352,601856
test,1629,212,217088,4967,953664,1170752
test,1630,82,83968,744,142848,226816
test,1631,117,119808,1513,290496,410304
test,1632,185,189440,3783,726336,915776
test,1633,81,82944,725,139200,222144
test,1634,165,168960,3009,577728,746688
test,1635,156,159744,2690,516480,676224
test,1636,135,138240,2015,386880,525120
test,1637,135,138240,2015,386880,525120
test,1638,148,151552,2421,464832,616384
test,1639,119,121856,1565,300480,422336
test,1640,191,195584,4032,774144,969728
test,1641,195,199680,4203,806976,1006656
test,1642,175,179200,3385,649920,829120
test,1643,82,83968,744,142848,226816
test,1644,179,183296,3541,679872,863168
test,1645,176,180224,3424,657408,837632
test,1646,119,121856,1565,300480,422336
test,1647,190,194560,3990,766080,960640
test,1648,145,148480,2324,446208,594688
test,1649,76,77824,639,122688,200512
test,1650,123,125952,1672,321024,446976
test,1651,97,99328,1040,199680,299008
test,1652,97,99328,1040,199680,299008
test,1653,147,150528,2389,458688,609216
test,1654,52,53248,299,57408,110656
test,1655,115,117760,1462,280704,398464
test,1656,69,70656,527,101184,171840
test,1657,130,133120,1868,358656,491776
test,1658,119,121856,1565,300480,422336
test,1659,42,43008,195,37440,80448
test,1660,266,272384,7820,1501440,1773824
test,1661,153,156672,2587,496704,653376
test,1662,122,124928,1645,315840,440768
test,1663,192,196608,4075,782400,979008
test,1664,86,88064,818,157056,245120
test,1665,83,84992,762,146304,231296
test,1666,265,271360,7761,1490112,1761472
test,1667,105,107520,1219,234048,341568
test,1668,163,166912,2937,563904,730816
test,1669,124,126976,1700,326400,453376
test,1670,170,174080,3194,613248,787328
test,1671,80,81920,708,135936,217856
test,1672,155,158720,2656,509952,668672
test,1673,102,104448,1150,220800,325248
test,1674,219,224256,5301,1017792,1242048
test,1675,122,124928,1645,315840,440768
test,1676,108,110592,1289,247488,358080
test,1677,144,147456,2292,440064,587520
test,1678,197,201728,4289,823488,1025216
test,1679,144,147456,2292,440064,587520
test,1680,112,114688,1387,266304,380992
test,1681,65,66560,467,89664,156224
test,1682,99,101376,1084,208128,309504
test,1683,124,126976,1700,326400,453376
test,1684,87,89088,837,160704,249792
test,1685,125,128000,1727,331584,459584
test,1686,148,151552,2421,464832,616384
test,1687,142,145408,2229,427968,573376
test,1688,145,148480,2324,446208,594688
test,1689,103,105472,1173,225216,330688
test,1690,98,100352,1062,203904,304256
test,1691,132,135168,1926,369792,504960
test,1692,131,134144,1897,364224,498368
test,1693,219,224256,5301,1017792,1242048
test,1694,147,150528,2389,458688,609216
test,1695,162,165888,2901,556992,722880
test,1696,97,99328,1040,199680,299008
test,1697,225,230400,5595,1074240,1304640
test,1698,177,181248,3463,664896,846144
test,1699,76,77824,639,122688,200512
test,1700,164,167936,2973,570816,738752
test,1701,153,156672,2587,496704,653376
test,1702,222,227328,5447,1045824,1273152
test,1703,158,161792,2759,529728,691520
test,1704,130,133120,1868,358656,491776
test,1705,100,102400,1106,212352,314752
test,1706,182,186368,3661,702912,889280
test,1707,164,167936,2973,570816,738752
test,1708,191,195584,4032,774144,969728
test,1709,214,219136,5062,971904,1191040
test,1710,186,190464,3824,734208,924672
test,1711,127,130048,1783,342336,472384
test,1712,135,138240,2015,386880,525120
test,1713,146,149504,2356,452352,601856
test,1714,164,167936,2973,570816,738752
test,1715,87,89088,837,160704,249792
test,1716,155,158720,2656,509952,668672
test,1717,145,148480,2324,446208,594688
test,1718,56,57344,347,66624,123968
test,1719,102,104448,1150,220800,325248
test,1720,110,112640,1338,256896,369536
test,1721,170,174080,3194,613248,787328
test,1722,156,159744,2690,516480,676224
test,1723,156,159744,2690,516480,676224
test,1724,209,214016,4828,926976,1140992
test,1725,69,70656,527,101184,171840
test,1726,128,131072,1811,347712,478784
test,1727,125,128000,1727,331584,459584
test,1728,218,223232,5253,1008576,1231808
test,1729,206,210944,4690,900480,1111424
test,1730,132,135168,1926,369792,504960
test,1731,83,84992,762,146304,231296
test,1732,115,117760,1462,280704,398464
test,1733,124,126976,1700,326400,453376
test,1734,114,116736,1437,275904,392640
test,1735,101,103424,1128,216576,320000
test,1736,37,37888,152,29184,67072
test,1737,260,266240,7471,1434432,1700672
test,1738,96,98304,1019,195648,293952
test,1739,135,138240,2015,386880,525120
test,1740,83,84992,762,146304,231296
test,1741,181,185344,3621,695232,880576
test,1742,172,176128,3270,627840,803968
test,1743,103,105472,1173,225216,330688
test,1744,174,178176,3346,642432,820608
test,1745,122,124928,1645,315840,440768
test,1746,131,134144,1897,364224,498368
test,1747,138,141312,2105,404160,545472
test,1748,159,162816,2794,536448,699264
test,1749,132,135168,1926,369792,504960
test,1750,163,166912,2937,563904,730816
test,1751,152,155648,2554,490368,646016
test,1752,130,133120,1868,358656,491776
test,1753,159,162816,2794,536448,699264
test,1754,67,68608,497,95424,164032
test,1755,96,98304,1019,195648,293952
test,1756,142,145408,2229,427968,573376
test,1757,98,100352,1062,203904,304256
test,1758,155,158720,2656,509952,668672
test,1759,90,92160,896,172032,264192
test,1760,129,132096,1840,353280,485376
test,1761,184,188416,3742,718464,906880
test,1762,116,118784,1488,285696,404480
test,1763,72,73728,573,110016,183744
test,1764,148,151552,2421,464832,616384
test,1765,117,119808,1513,290496,410304
test,1766,181,185344,3621,695232,880576
test,1767,124,126976,1700,326400,453376
test,1768,94,96256,977,187584,283840
test,1769,88,90112,856,164352,254464
test,1770,101,103424,1128,216576,320000
test,1771,135,138240,2015,386880,525120
test,1772,97,99328,1040,199680,299008
test,1773,180,184320,3581,687552,871872
test,1774,67,68608,497,95424,164032
test,1775,253,259072,7075,1358400,1617472
test,1776,134,137216,1985,381120,518336
test,1777,196,200704,4246,815232,1015936
test,1778,215,220160,5109,980928,1201088
test,1779,61,62464,412,79104,141568
test,1780,213,218112,5014,962688,1180800
test,1781,164,167936,2973,570816,738752
test,1782,99,101376,1084,208128,309504
test,1783,179,183296,3541,679872,863168
test,1784,166,169984,3046,584832,754816
test,1785,78,79872,673,129216,209088
test,1786,166,169984,3046,584832,754816
test,1787,146,149504,2356,452352,601856
test,1788,183,187392,3702,710784,898176
test,1789,158,161792,2759,529728,691520
test,1790,61,62464,412,79104,141568
test,1791,70,71680,542,104064,175744
test,1792,222,227328,5447,1045824,1273152
test,1793,175,179200,3385,649920,829120
test,1794,81,82944,725,139200,222144
test,1795,203,207872,4555,874560,1082432
test,1796,150,153600,2487,477504,631104
test,1797,89,91136,876,168192,259328
test,1798,49,50176,266,51072,101248
test,1799,196,200704,4246,815232,1015936
test,1800,130,133120,1868,358656,491776
test,1801,126,129024,1755,336960,465984
test,1802,116,118784,1488,285696,404480
test,1803,232,237568,5949,1142208,1379776
test,1804,136,139264,2045,392640,531904
test,1805,152,155648,2554,490368,646016
test,1806,158,161792,2759,529728,691520
test,1807,199,203776,4377,840384,1044160
test,1808,162,165888,2901,556992,722880
test,1809,59,60416,385,73920,134336
test,1810,181,185344,3621,695232,880576
test,1811,177,181248,3463,664896,846144
test,1812,167,171008,3083,591936,762944
test,1813,101,103424,1128,216576,320000
test,1814,106,108544,1242,238464,347008
test,1815,194,198656,4160,798720,997376
test,1816,105,107520,1219,234048,341568
test,1817,166,169984,3046,584832,754816
test,1818,213,218112,5014,962688,1180800
test,1819,144,147456,2292,440064,587520
test,1820,89,91136,876,168192,259328
test,1821,237,242688,6208,1191936,1434624
test,1822,100,102400,1106,212352,314752
test,1823,161,164864,2865,550080,714944
test,1824,127,130048,1783,342336,472384
test,1825,64,65536,453,86976,152512
test,1826,135,138240,2015,386880,525120
test,1827,80,81920,708,135936,217856
test,1828,118,120832,1539,295488,416320
test,1829,79,80896,690,132480,213376
test,1830,108,110592,1289,247488,358080
test,1831,243,248832,6526,1252992,1501824
test,1832,177,181248,3463,664896,846144
test,1833,190,194560,3990,766080,960640
test,1834,72,73728,573,110016,183744
test,1835,134,137216,1985,381120,518336
test,1836,162,165888,2901,556992,722880
test,1837,99,101376,1084,208128,309504
test,1838,149,152576,2454,471168,623744
test,1839,198,202752,4333,831936,1034688
test,1840,174,178176,3346,642432,820608
test,1841,132,135168,1926,369792,504960
test,1842,179,183296,3541,679872,863168
test,1843,204,208896,4600,883200,1092096
test,1844,98,100352,1062,203904,304256
test,1845,125,128000,1727,331584,459584
test,1846,108,110592,1289,247488,358080
test,1847,156,159744,2690,516480,676224
test,1848,145,148480,2324,446208,594688
test,1849,171,175104,3232,620544,795648
test,1850,144,147456,2292,440064,587520
test,1851,206,210944,4690,900480,1111424
test,1852,215,220160,5109,980928,1201088
test,1853,63,64512,439,84288,148800
test,1854,148,151552,2421,464832,616384
test,1855,99,101376,1084,208128,309504
test,1856,149,152576,2454,471168,623744
test,1857,266,272384,7820,1501440,1773824
test,1858,221,226304,5398,1036416,1262720
test,1859,167,171008,3083,591936,762944
test,1860,93,95232,956,183552,278784
test,1861,154,157696,2621,503232,660928
test,1862,161,164864,2865,550080,714944
test,1863,174,178176,3346,642432,820608
test,1864,69,70656,527,101184,171840
test,1865,123,125952,1672,321024,446976
test,1866,152,155648,2554,490368,646016
test,1867,176,180224,3424,657408,837632
test,1868,192,196608,4075,782400,979008
test,1869,108,110592,1289,247488,358080
test,1870,194,198656,4160,798720,997376
test,1871,146,149504,2356,452352,601856
test,1872,99,101376,1084,208128,309504
test,1873,146,149504,2356,452352,601856
test,1874,151,154624,2520,483840,638464
test,1875,156,159744,2690,516480,676224
test,1876,92,94208,936,179712,273920
test,1877,142,145408,2229,427968,573376
test,1878,130,133120,1868,358656,491776
test,1879,165,168960,3009,577728,746688
test,1880,98,100352,1062,203904,304256
test,1881,87,89088,837,160704,249792
test,1882,85,87040,799,153408,240448
test,1883,119,121856,1565,300480,422336
test,1884,129,132096,1840,353280,485376
test,1885,143,146432,2260,433920,580352
test,1886,252,258048,7019,1347648,1605696
test,1887,240,245760,6366,1222272,1468032
test,1888,186,190464,3824,734208,924672
test,1889,154,157696,2621,503232,660928
test,1890,143,146432,2260,433920,580352
test,1891,99,101376,1084,208128,309504
test,1892,111,113664,1362,261504,375168
test,1893,223,228352,5496,1055232,1283584
test,1894,146,149504,2356,452352,601856
test,1895,138,141312,2105,404160,545472
test,1896,97,99328,1040,199680,299008
test,1897,79,80896,690,132480,213376
test,1898,133,136192,1955,375360,511552
test,1899,193,197632,4117,790464,988096
test,1900,124,126976,1700,326400,453376
test,1901,202,206848,4510,865920,1072768
test,1902,182,186368,3661,702912,889280
test,1903,204,208896,4600,883200,1092096
test,1904,125,128000,1727,331584,459584
test,1905,79,80896,690,132480,213376
test,1906,145,148480,2324,446208,594688
test,1907,168,172032,3120,599040,771072
test,1908,166,169984,3046,584832,754816
test,1909,121,123904,1618,310656,434560
test,1910,176,180224,3424,657408,837632
test,1911,70,71680,542,104064,175744
test,1912,210,215040,4874,935808,1150848
test,1913,129,132096,1840,353280,485376
test,1914,127,130048,1783,342336,472384
test,1915,152,155648,2554,490368,646016
test,1916,153,156672,2587,496704,653376
test,1917,150,153600,2487,477504,631104
test,1918,116,118784,1488,285696,404480
test,1919,267,273408,7879,1512768,1786176
test,1920,136,139264,2045,392640,531904
test,1921,153,156672,2587,496704,653376
test,1922,175,179200,3385,649920,829120
test,1923,183,187392,3702,710784,898176
test,1924,196,200704,4246,815232,1015936
test,1925,164,167936,2973,570816,738752
test,1926,138,141312,2105,404160,545472
test,1927,155,158720,2656,509952,668672
test,1928,83,84992,762,146304,231296
test,1929,112,114688,1387,266304,380992
test,1930,67,68608,497,95424,164032
test,1931,63,64512,439,84288,148800
test,1932,148,151552,2421,464832,616384
test,1933,122,124928,1645,315840,440768
test,1934,63,64512,439,84288,148800
test,1935,199,203776,4377,840384,1044160
test,1936,128,131072,1811,347712,478784
test,1937,112,114688,1387,266304,380992
test,1938,117,119808,1513,290496,410304
test,1939,183,187392,3702,710784,898176
test,1940,132,135168,1926,369792,504960
test,1941,158,161792,2759,529728,691520
test,1942,87,89088,837,160704,249792
test,1943,162,165888,2901,556992,722880
test,1944,146,149504,2356,452352,601856
test,1945,165,168960,3009,577728,746688
test,1946,129,132096,1840,353280,485376
test,1947,203,207872,4555,874560,1082432
test,1948,160,163840,2830,543360,707200
test,1949,86,88064,818,157056,245120
test,1950,190,194560,3990,766080,960640
test,1951,84,86016,780,149760,235776
test,1952,153,156672,2587,496704,653376
test,1953,103,105472,1173,225216,330688
test,1954,127,130048,1783,342336,472384
test,1955,200,204800,4421,848832,1053632
test,1956,192,196608,4075,782400,979008
test,1957,111,113664,1362,261504,375168
test,1958,229,234496,5796,1112832,1347328
test,1959,143,146432,2260,433920,580352
test,1960,129,132096,1840,353280,485376
test,1961,152,155648,2554,490368,646016
test,1962,74,75776,606,116352,192128
test,1963,81,82944,725,139200,222144
test,1964,158,161792,2759,529728,691520
test,1965,275,281600,8358,1604736,1886336
test,1966,126,129024,1755,336960,465984
test,1967,125,128000,1727,331584,459584
test,1968,142,145408,2229,427968,573376
test,1969,127,130048,1783,342336,472384
test,1970,110,112640,1338,256896,369536
test,1971,82,83968,744,142848,226816
test,1972,131,134144,1897,364224,498368
test,1973,130,133120,1868,358656,491776
test,1974,77,78848,656,125952,204800
test,1975,100,102400,1106,212352,314752
test,1976,76,77824,639,122688,200512
test,1977,60,61440,398,76416,137856
test,1978,165,168960,3009,577728,746688
test,1979,43,44032,205,39360,83392
test,1980,146,149504,2356,452352,601856
test,1981,83,84992,762,146304,231296
test,1982,88,90112,856,164352,254464
test,1983,80,81920,708,135936,217856
test,1984,159,162816,2794,536448,699264
test,1985,166,169984,3046,584832,754816
test,1986,133,136192,1955,375360,511552
test,1987,253,259072,7075,1358400,1617472
test,1988,216,221184,5157,990144,1211328
test,1989,63,64512,439,84288,148800
test,1990,135,138240,2015,386880,525120
test,1991,184,188416,3742,718464,906880
test,1992,126,129024,1755,336960,465984
test,1993,114,116736,1437,275904,392640
test,1994,139,142336,2136,410112,552448
test,1995,119,121856,1565,300480,422336
test,1996,169,173056,3157,606144,779200
test,1997,116,118784,1488,285696,404480
test,1998,166,169984,3046,584832,754816
test,1999,143,146432,2260,433920,580352
test,2000,153,156672,2587,496704,653376
test,2001,147,150528,2389,458688,609216
test,2002,151,154624,2520,483840,638464
test,2003,140,143360,2167,416064,559424
test,2004,102,104448,1150,220800,325248
test,2005,156,159744,2690,516480,676224
test,2006,121,123904,1618,310656,434560
test,2007,49,50176,266,51072,101248
test,2008,78,79872,673,129216,209088
test,2009,133,136192,1955,375360,511552
test,2010,168,172032,3120,599040,771072
test,2011,99,101376,1084,208128,309504
test,2012,126,129024,1755,336960,465984
test,2013,137,140288,2075,398400,538688
test,2014,181,185344,3621,695232,880576
test,2015,110,112640,1338,256896,369536
test,2016,132,135168,1926,369792,504960
test,2017,219,224256,5301,1017792,1242048
test,2018,64,65536,453,86976,152512
test,2019,155,158720,2656,509952,668672
test,2020,153,156672,2587,496704,653376
test,2021,135,138240,2015,386880,525120
test,2022,86,88064,818,157056,245120
test,2023,197,201728,4289,823488,1025216
test,2024,90,92160,896,172032,264192
test,2025,96,98304,1019,195648,293952
test,2026,114,116736,1437,275904,392640
test,2027,159,162816,2794,536448,699264
test,2028,122,124928,1645,315840,440768
test,2029,115,117760,1462,280704,398464
test,2030,112,114688,1387,266304,380992
test,2031,146,149504,2356,452352,601856
test,2032,132,135168,1926,369792,504960
test,2033,90,92160,896,172032,264192
test,2034,93,95232,956,183552,278784
test,2035,160,163840,2830,543360,707200
test,2036,55,56320,335,64320,120640
test,2037,158,161792,2759,529728,691520
test,2038,180,184320,3581,687552,871872
test,2039,169,173056,3157,606144,779200
test,2040,86,88064,818,157056,245120
test,2041,157,160768,2725,523200,683968
test,2042,125,128000,1727,331584,459584
test,2043,72,73728,573,110016,183744
test,2044,184,188416,3742,718464,906880
test,2045,190,194560,3990,766080,960640
test,2046,128,131072,1811,347712,478784
test,2047,145,148480,2324,446208,594688
test,2048,113,115712,1412,271104,386816
test,2049,104,106496,1196,229632,336128
test,2050,163,166912,2937,563904,730816
test,2051,108,110592,1289,247488,358080
test,2052,174,178176,3346,642432,820608
test,2053,148,151552,2421,464832,616384
test,2054,156,159744,2690,516480,676224
test,2055,103,105472,1173,225216,330688
test,2056,132,135168,1926,369792,504960
test,2057,116,118784,1488,285696,404480
test,2058,160,163840,2830,543360,707200
test,2059,118,120832,1539,295488,416320
test,2060,183,187392,3702,710784,898176
test,2061,152,155648,2554,490368,646016
test,2062,135,138240,2015,386880,525120
test,2063,124,126976,1700,326400,453376
test,2064,213,218112,5014,962688,1180800
test,2065,137,140288,2075,398400,538688
test,2066,114,116736,1437,275904,392640
test,2067,132,135168,1926,369792,504960
test,2068,210,215040,4874,935808,1150848
test,2069,144,147456,2292,440064,587520
test,2070,194,198656,4160,798720,997376
test,2071,122,124928,1645,315840,440768
test,2072,80,81920,708,135936,217856
test,2073,109,111616,1313,252096,363712
test,2074,113,115712,1412,271104,386816
test,2075,138,141312,2105,404160,545472
test,2076,167,171008,3083,591936,762944
test,2077,57,58368,359,68928,127296
test,2078,103,105472,1173,225216,330688
test,2079,101,103424,1128,216576,320000
test,2080,122,124928,1645,315840,440768
test,2081,112,114688,1387,266304,380992
test,2082,130,133120,1868,358656,491776
test,2083,78,79872,673,129216,209088
test,2084,169,173056,3157,606144,779200
test,2085,115,117760,1462,280704,398464
test,2086,111,113664,1362,261504,375168
test,2087,153,156672,2587,496704,653376
test,2088,99,101376,1084,208128,309504
test,2089,193,197632,4117,790464,988096
test,2090,61,62464,412,79104,141568
test,2091,146,149504,2356,452352,601856
test,2092,108,110592,1289,247488,358080
test,2093,86,88064,818,157056,245120
test,2094,94,96256,977,187584,283840
test,2095,130,133120,1868,358656,491776
test,2096,197,201728,4289,823488,1025216
test,2097,196,200704,4246,815232,1015936
test,2098,192,196608,4075,782400,979008
test,2099,132,135168,1926,369792,504960
test,2100,88,90112,856,164352,254464
test,2101,241,246784,6419,1232448,1479232
test,2102,194,198656,4160,798720,997376
test,2103,206,210944,4690,900480,1111424
test,2104,173,177152,3308,635136,812288
test,2105,58,59392,372,71424,130816
test,2106,134,137216,1985,381120,518336
test,2107,181,185344,3621,695232,880576
test,2108,256,262144,7243,1390656,1652800
test,2109,161,164864,2865,550080,714944
test,2110,186,190464,3824,734208,924672
test,2111,149,152576,2454,471168,623744
test,2112,151,154624,2520,483840,638464
test,2113,110,112640,1338,256896,369536
test,2114,214,219136,5062,971904,1191040
test,2115,206,210944,4690,900480,1111424
test,2116,56,57344,347,66624,123968
test,2117,142,145408,2229,427968,573376
test,2118,103,105472,1173,225216,330688
test,2119,111,113664,1362,261504,375168
test,2120,62,63488,425,81600,145088
test,2121,222,227328,5447,1045824,1273152
test,2122,143,146432,2260,433920,580352
test,2123,99,101376,1084,208128,309504
test,2124,109,111616,1313,252096,363712
test,2125,166,169984,3046,584832,754816
test,2126,162,165888,2901,556992,722880
test,2127,63,64512,439,84288,148800
test,2128,131,134144,1897,364224,498368
test,2129,139,142336,2136,410112,552448
test,2130,169,173056,3157,606144,779200
test,2131,165,168960,3009,577728,746688
test,2132,162,165888,2901,556992,722880
test,2133,78,79872,673,129216,209088
test,2134,172,176128,3270,627840,803968
test,2135,115,117760,1462,280704,398464
test,2136,84,86016,780,149760,235776
test,2137,155,158720,2656,509952,668672
test,2138,88,90112,856,164352,254464
test,2139,187,191488,3865,742080,933568
test,2140,112,114688,1387,266304,380992
test,2141,135,138240,2015,386880,525120
test,2142,136,139264,2045,392640,531904
test,2143,226,231424,5645,1083840,1315264
test,2144,219,224256,5301,1017792,1242048
test,2145,178,182272,3502,672384,854656
test,2146,105,107520,1219,234048,341568
test,2147,171,175104,3232,620544,795648
test,2148,185,189440,3783,726336,915776
test,2149,130,133120,1868,358656,491776
test,2150,126,129024,1755,336960,465984
test,2151,190,194560,3990,766080,960640
test,2152,124,126976,1700,326400,453376
test,2153,133,136192,1955,375360,511552
test,2154,102,104448,1150,220800,325248
test,2155,234,239616,6052,1161984,1401600
test,2156,169,173056,3157,606144,779200
test,2157,214,219136,5062,971904,1191040
test,2158,61,62464,412,79104,141568
test,2159,132,135168,1926,369792,504960
test,2160,116,118784,1488,285696,404480
test,2161,172,176128,3270,627840,803968
test,2162,200,204800,4421,848832,1053632
test,2163,167,171008,3083,591936,762944
test,2164,126,129024,1755,336960,465984
test,2165,104,106496,1196,229632,336128
test,2166,196,200704,4246,815232,1015936
test,2167,165,168960,3009,577728,746688
test,2168,205,209920,4645,891840,1101760
test,2169,154,157696,2621,503232,660928
test,2170,138,141312,2105,404160,545472
test,2171,148,151552,2421,464832,616384
test,2172,146,149504,2356,452352,601856
test,2173,176,180224,3424,657408,837632
test,2174,131,134144,1897,364224,498368
test,2175,230,235520,5847,1122624,1358144
test,2176,151,154624,2520,483840,638464
test,2177,71,72704,558,107136,179840
test,2178,191,195584,4032,774144,969728
test,2179,171,175104,3232,620544,795648
test,2180,85,87040,799,153408,240448
test,2181,150,153600,2487,477504,631104
test,2182,116,118784,1488,285696,404480
test,2183,190,194560,3990,766080,960640
test,2184,180,184320,3581,687552,871872
test,2185,163,166912,2937,563904,730816
test,2186,262,268288,7587,1456704,1724992
test,2187,117,119808,1513,290496,410304
test,2188,177,181248,3463,664896,846144
test,2189,126,129024,1755,336960,465984
test,2190,117,119808,1513,290496,410304
test,2191,84,86016,780,149760,235776
test,2192,94,96256,977,187584,283840
test,2193,128,131072,1811,347712,478784
test,2194,82,83968,744,142848,226816
test,2195,170,174080,3194,613248,787328
test,2196,135,138240,2015,386880,525120
test,2197,114,116736,1437,275904,392640
test,2198,233,238592,6000,1152000,1390592
test,2199,96,98304,1019,195648,293952
test,2200,108,110592,1289,247488,358080
test,2201,105,107520,1219,234048,341568
test,2202,68,69632,511,98112,167744
test,2203,60,61440,398,76416,137856
test,2204,126,129024,1755,336960,465984
test,2205,154,157696,2621,503232,660928
test,2206,108,110592,1289,247488,358080
test,2207,90,92160,896,172032,264192
test,2208,199,203776,4377,840384,1044160
test,2209,107,109568,1266,243072,352640
test,2210,145,148480,2324,446208,594688
test,2211,133,136192,1955,375360,511552
test,2212,149,152576,2454,471168,623744
test,2213,128,131072,1811,347712,478784
test,2214,105,107520,1219,234048,341568
test,2215,64,65536,453,86976,152512
test,2216,105,107520,1219,234048,341568
test,2217,67,68608,497,95424,164032
test,2218,156,159744,2690,516480,676224
test,2219,172,176128,3270,627840,803968
test,2220,190,194560,3990,766080,960640
test,2221,202,206848,4510,865920,1072768
test,2222,140,143360,2167,416064,559424
test,2223,125,128000,1727,331584,459584
test,2224,163,166912,2937,563904,730816
test,2225,34,34816,128,24576,59392
test,2226,125,128000,1727,331584,459584
test,2227,238,243712,6261,1202112,1445824
test,2228,117,119808,1513,290496,410304
test,2229,136,139264,2045,392640,531904
test,2230,163,166912,2937,563904,730816
test,2231,62,63488,425,81600,145088
test,2232,111,113664,1362,261504,375168
test,2233,155,158720,2656,509952,668672
test,2234,156,159744,2690,516480,676224
test,2235,118,120832,1539,295488,416320
test,2236,146,149504,2356,452352,601856
test,2237,185,189440,3783,726336,915776
test,2238,152,155648,2554,490368,646016
test,2239,141,144384,2198,422016,566400
test,2240,73,74752,589,113088,187840
test,2241,111,113664,1362,261504,375168
test,2242,155,158720,2656,509952,668672
test,2243,157,160768,2725,523200,683968
test,2244,90,92160,896,172032,264192
test,2245,91,93184,916,175872,269056
test,2246,201,205824,4465,857280,1063104
test,2247,195,199680,4203,806976,1006656
test,2248,163,166912,2937,563904,730816
test,2249,141,144384,2198,422016,566400
test,2250,181,185344,3621,695232,880576
test,2251,60,61440,398,76416,137856
test,2252,151,154624,2520,483840,638464
test,2253,154,157696,2621,503232,660928
test,2254,93,95232,956,183552,278784
test,2255,195,199680,4203,806976,1006656
test,2256,124,126976,1700,326400,453376
test,2257,105,107520,1219,234048,341568
test,2258,179,183296,3541,679872,863168
test,2259,67,68608,497,95424,164032
test,2260,156,159744,2690,516480,676224
test,2261,114,116736,1437,275904,392640
test,2262,133,136192,1955,375360,511552
test,2263,217,222208,5205,999360,1221568
test,2264,154,157696,2621,503232,660928
test,2265,72,73728,573,110016,183744
test,2266,217,222208,5205,999360,1221568
test,2267,110,112640,1338,256896,369536
test,2268,147,150528,2389,458688,609216
test,2269,85,87040,799,153408,240448
test,2270,224,229376,5546,1064832,1294208
test,2271,171,175104,3232,620544,795648
test,2272,168,172032,3120,599040,771072
test,2273,113,115712,1412,271104,386816
test,2274,167,171008,3083,591936,762944
test,2275,138,141312,2105,404160,545472
test,2276,227,232448,5695,1093440,1325888
test,2277,178,182272,3502,672384,854656
test,2278,159,162816,2794,536448,699264
test,2279,93,95232,956,183552,278784
test,2280,225,230400,5595,1074240,1304640
test,2281,142,145408,2229,427968,573376
test,2282,215,220160,5109,980928,1201088
test,2283,186,190464,3824,734208,924672
test,2284,137,140288,2075,398400,538688
test,2285,139,142336,2136,410112,552448
test,2286,98,100352,1062,203904,304256
test,2287,191,195584,4032,774144,969728
test,2288,117,119808,1513,290496,410304
test,2289,91,93184,916,175872,269056
test,2290,144,147456,2292,440064,587520
test,2291,143,146432,2260,433920,580352
test,2292,137,140288,2075,398400,538688
test,2293,194,198656,4160,798720,997376
test,2294,181,185344,3621,695232,880576
test,2295,121,123904,1618,310656,434560
test,2296,157,160768,2725,523200,683968
test,2297,144,147456,2292,440064,587520
test,2298,153,156672,2587,496704,653376
test,2299,130,133120,1868,358656,491776
test,2300,146,149504,2357,452544,602048
test,2301,72,73728,573,110016,183744
test,2302,182,186368,3661,702912,889280
test,2303,73,74752,589,113088,187840
test,2304,186,190464,3824,734208,924672
test,2305,148,151552,2421,464832,616384
test,2306,204,208896,4600,883200,1092096
test,2307,101,103424,1128,216576,320000
test,2308,74,75776,606,116352,192128
test,2309,193,197632,4117,790464,988096
test,2310,307,314368,10417,2000064,2314432
test,2311,205,209920,4645,891840,1101760
test,2312,152,155648,2554,490368,646016
test,2313,173,177152,3308,635136,812288
test,2314,105,107520,1219,234048,341568
test,2315,159,162816,2794,536448,699264
test,2316,126,129024,1755,336960,465984
test,2317,150,153600,2487,477504,631104
test,2318,188,192512,3907,750144,942656
test,2319,84,86016,780,149760,235776
test,2320,182,186368,3661,702912,889280
test,2321,213,218112,5014,962688,1180800
test,2322,127,130048,1783,342336,472384
test,2323,175,179200,3385,649920,829120
test,2324,60,61440,398,76416,137856
test,2325,188,192512,3907,750144,942656
test,2326,133,136192,1955,375360,511552
test,2327,104,106496,1196,229632,336128
test,2328,164,167936,2973,570816,738752
test,2329,124,126976,1700,326400,453376
test,2330,141,144384,2198,422016,566400
test,2331,148,151552,2421,464832,616384
test,2332,86,88064,818,157056,245120
test,2333,172,176128,3270,627840,803968
test,2334,140,143360,2167,416064,559424
test,2335,94,96256,977,187584,283840
test,2336,156,159744,2690,516480,676224
test,2337,85,87040,799,153408,240448
test,2338,208,212992,4782,918144,1131136
test,2339,130,133120,1868,358656,491776
test,2340,73,74752,589,113088,187840
test,2341,176,180224,3424,657408,837632
test,2342,128,131072,1811,347712,478784
test,2343,100,102400,1106,212352,314752
test,2344,103,105472,1173,225216,330688
test,2345,145,148480,2324,446208,594688
test,2346,136,139264,2045,392640,531904
test,2347,173,177152,3308,635136,812288
test,2348,116,118784,1488,285696,404480
test,2349,119,121856,1565,300480,422336
test,2350,196,200704,4246,815232,1015936
test,2351,105,107520,1219,234048,341568
test,2352,148,151552,2421,464832,616384
test,2353,150,153600,2487,477504,631104
test,2354,122,124928,1645,315840,440768
test,2355,145,148480,2324,446208,594688
test,2356,145,148480,2324,446208,594688
test,2357,204,208896,4600,883200,1092096
test,2358,95,97280,998,191616,288896
test,2359,106,108544,1242,238464,347008
test,2360,196,200704,4246,815232,1015936
test,2361,167,171008,3083,591936,762944
test,2362,173,177152,3308,635136,812288
test,2363,266,272384,7820,1501440,1773824
test,2364,128,131072,1811,347712,478784
test,2365,94,96256,977,187584,283840
test,2366,165,168960,3009,577728,746688
test,2367,156,159744,2690,516480,676224
test,2368,212,217088,4967,953664,1170752
test,2369,118,120832,1539,295488,416320
test,2370,129,132096,1840,353280,485376
test,2371,54,55296,323,62016,117312
test,2372,147,150528,2389,458688,609216
test,2373,53,54272,311,59712,113984
test,2374,101,103424,1128,216576,320000
test,2375,107,109568,1266,243072,352640
test,2376,148,151552,2421,464832,616384
test,2377,66,67584,482,92544,160128
test,2378,201,205824,4465,857280,1063104
test,2379,101,103424,1128,216576,320000
test,2380,130,133120,1868,358656,491776
test,2381,137,140288,2075,398400,538688
test,2382,223,228352,5496,1055232,1283584
test,2383,167,171008,3083,591936,762944
test,2384,147,150528,2389,458688,609216
test,2385,88,90112,856,164352,254464
test,2386,139,142336,2136,410112,552448
test,2387,157,160768,2725,523200,683968
test,2388,165,168960,3009,577728,746688
test,2389,120,122880,1592,305664,428544
test,2390,231,236544,5898,1132416,1368960
test,2391,190,194560,3990,766080,960640
test,2392,121,123904,1618,310656,434560
test,2393,105,107520,1219,234048,341568
test,2394,114,116736,1437,275904,392640
test,2395,148,151552,2421,464832,616384
test,2396,114,116736,1437,275904,392640
test,2397,221,226304,5398,1036416,1262720
test,2398,180,184320,3581,687552,871872
test,2399,174,178176,3346,642432,820608
test,2400,137,140288,2075,398400,538688
test,2401,172,176128,3270,627840,803968
test,2402,193,197632,4117,790464,988096
test,2403,173,177152,3308,635136,812288
test,2404,120,122880,1592,305664,428544
test,2405,177,181248,3463,664896,846144
test,2406,111,113664,1362,261504,375168
test,2407,152,155648,2554,490368,646016
test,2408,215,220160,5109,980928,1201088
test,2409,179,183296,3541,679872,863168
test,2410,129,132096,1840,353280,485376
test,2411,110,112640,1338,256896,369536
test,2412,171,175104,3232,620544,795648
test,2413,194,198656,4160,798720,997376
test,2414,198,202752,4333,831936,1034688
test,2415,231,236544,5898,1132416,1368960
test,2416,125,128000,1727,331584,459584
test,2417,200,204800,4421,848832,1053632
test,2418,238,243712,6261,1202112,1445824
test,2419,136,139264,2045,392640,531904
test,2420,143,146432,2260,433920,580352
test,2421,99,101376,1084,208128,309504
test,2422,164,167936,2973,570816,738752
test,2423,93,95232,956,183552,278784
test,2424,130,133120,1868,358656,491776
test,2425,170,174080,3194,613248,787328
test,2426,173,177152,3308,635136,812288
test,2427,198,202752,4333,831936,1034688
test,2428,173,177152,3308,635136,812288
test,2429,204,208896,4600,883200,1092096
test,2430,286,292864,9040,1735680,2028544
test,2431,152,155648,2554,490368,646016
test,2432,266,272384,7820,1501440,1773824
test,2433,130,133120,1868,358656,491776
test,2434,113,115712,1412,271104,386816
test,2435,198,202752,4333,831936,1034688
test,2436,118,120832,1539,295488,416320
test,2437,81,82944,725,139200,222144
test,2438,175,179200,3385,649920,829120
test,2439,71,72704,558,107136,179840
test,2440,194,198656,4160,798720,997376
test,2441,189,193536,3948,758016,951552
test,2442,196,200704,4246,815232,1015936
test,2443,205,209920,4645,891840,1101760
test,2444,126,129024,1755,336960,465984
test,2445,60,61440,398,76416,137856
test,2446,168,172032,3120,599040,771072
test,2447,235,240640,6104,1171968,1412608
test,2448,142,145408,2229,427968,573376
test,2449,118,120832,1539,295488,416320
test,2450,87,89088,837,160704,249792
test,2451,205,209920,4645,891840,1101760
test,2452,84,86016,780,149760,235776
test,2453,60,61440,398,76416,137856
test,2454,167,171008,3083,591936,762944
test,2455,128,131072,1811,347712,478784
test,2456,118,120832,1539,295488,416320
test,2457,86,88064,818,157056,245120
test,2458,155,158720,2656,509952,668672
test,2459,186,190464,3824,734208,924672
test,2460,121,123904,1618,310656,434560
test,2461,164,167936,2973,570816,738752
test,2462,179,183296,3541,679872,863168
test,2463,178,182272,3502,672384,854656
test,2464,185,189440,3783,726336,915776
test,2465,148,151552,2421,464832,616384
test,2466,141,144384,2198,422016,566400
test,2467,152,155648,2554,490368,646016
test,2468,50,51200,277,53184,104384
test,2469,310,317440,10621,2039232,2356672
test,2470,176,180224,3424,657408,837632
test,2471,138,141312,2105,404160,545472
test,2472,79,80896,690,132480,213376
test,2473,89,91136,876,168192,259328
test,2474,133,136192,1955,375360,511552
test,2475,158,161792,2759,529728,691520
test,2476,148,151552,2421,464832,616384
test,2477,97,99328,1040,199680,299008
test,2478,136,139264,2045,392640,531904
test,2479,86,88064,818,157056,245120
test,2480,137,140288,2075,398400,538688
test,2481,81,82944,725,139200,222144
test,2482,112,114688,1387,266304,380992
test,2483,117,119808,1513,290496,410304
test,2484,157,160768,2725,523200,683968
test,2485,158,161792,2759,529728,691520
test,2486,166,169984,3046,584832,754816
test,2487,189,193536,3948,758016,951552
test,2488,164,167936,2973,570816,738752
test,2489,98,100352,1062,203904,304256
test,2490,126,129024,1755,336960,465984
test,2491,183,187392,3702,710784,898176
test,2492,60,61440,398,76416,137856
test,2493,129,132096,1840,353280,485376
test,2494,167,171008,3083,591936,762944
test,2495,194,198656,4160,798720,997376
test,2496,200,204800,4421,848832,1053632
test,2497,172,176128,3270,627840,803968
test,2498,105,107520,1219,234048,341568
test,2499,160,163840,2830,543360,707200
test,2500,112,114688,1387,266304,380992
test,2501,61,62464,412,79104,141568
test,2502,138,141312,2105,404160,545472
test,2503,170,174080,3194,613248,787328
test,2504,92,94208,936,179712,273920
test,2505,124,126976,1700,326400,453376
test,2506,84,86016,780,149760,235776
test,2507,149,152576,2454,471168,623744
test,2508,179,183296,3541,679872,863168
test,2509,42,43008,195,37440,80448
test,2510,139,142336,2136,410112,552448
test,2511,194,198656,4160,798720,997376
test,2512,166,169984,3046,584832,754816
test,2513,187,191488,3865,742080,933568
test,2514,91,93184,916,175872,269056
test,2515,218,223232,5253,1008576,1231808
test,2516,58,59392,372,71424,130816
test,2517,193,197632,4117,790464,988096
test,2518,138,141312,2105,404160,545472
test,2519,75,76800,622,119424,196224
test,2520,98,100352,1062,203904,304256
test,2521,203,207872,4555,874560,1082432
test,2522,98,100352,1062,203904,304256
test,2523,129,132096,1840,353280,485376
test,2524,205,209920,4645,891840,1101760
test,2525,149,152576,2454,471168,623744
test,2526,146,149504,2356,452352,601856
test,2527,89,91136,876,168192,259328
test,2528,241,246784,6419,1232448,1479232
test,2529,72,73728,573,110016,183744
test,2530,139,142336,2136,410112,552448
test,2531,51,52224,288,55296,107520
test,2532,124,126976,1700,326400,453376
test,2533,123,125952,1672,321024,446976
test,2534,144,147456,2292,440064,587520
test,2535,140,143360,2167,416064,559424
test,2536,87,89088,837,160704,249792
test,2537,128,131072,1811,347712,478784
test,2538,185,189440,3783,726336,915776
test,2539,106,108544,1242,238464,347008
test,2540,107,109568,1266,243072,352640
test,2541,169,173056,3157,606144,779200
test,2542,197,201728,4289,823488,1025216
test,2543,161,164864,2865,550080,714944
test,2544,173,177152,3308,635136,812288
test,2545,221,226304,5398,1036416,1262720
test,2546,161,164864,2865,550080,714944
test,2547,81,82944,725,139200,222144
test,2548,119,121856,1565,300480,422336
test,2549,159,162816,2794,536448,699264
test,2550,189,193536,3948,758016,951552
test,2551,75,76800,622,119424,196224
test,2552,142,145408,2229,427968,573376
test,2553,112,114688,1387,266304,380992
test,2554,95,97280,998,191616,288896
test,2555,204,208896,4600,883200,1092096
test,2556,148,151552,2421,464832,616384
test,2557,174,178176,3346,642432,820608
test,2558,113,115712,1412,271104,386816
test,2559,101,103424,1128,216576,320000
test,2560,158,161792,2759,529728,691520
test,2561,122,124928,1645,315840,440768
test,2562,148,151552,2421,464832,616384
test,2563,108,110592,1289,247488,358080
test,2564,85,87040,799,153408,240448
test,2565,101,103424,1128,216576,320000
test,2566,119,121856,1565,300480,422336
test,2567,163,166912,2937,563904,730816
test,2568,133,136192,1955,375360,511552
test,2569,136,139264,2045,392640,531904
test,2570,137,140288,2075,398400,538688
test,2571,97,99328,1040,199680,299008
test,2572,48,49152,255,48960,98112
test,2573,178,182272,3502,672384,854656
test,2574,195,199680,4203,806976,1006656
test,2575,78,79872,673,129216,209088
test,2576,169,173056,3157,606144,779200
test,2577,49,50176,266,51072,101248
test,2578,120,122880,1592,305664,428544
test,2579,109,111616,1313,252096,363712
test,2580,178,182272,3502,672384,854656
test,2581,122,124928,1645,315840,440768
test,2582,128,131072,1811,347712,478784
test,2583,88,90112,856,164352,254464
test,2584,128,131072,1811,347712,478784
test,2585,253,259072,7075,1358400,1617472
test,2586,122,124928,1645,315840,440768
test,2587,115,117760,1462,280704,398464
test,2588,99,101376,1084,208128,309504
test,2589,234,239616,6052,1161984,1401600
test,2590,146,149504,2356,452352,601856
test,2591,94,96256,977,187584,283840
test,2592,180,184320,3581,687552,871872
test,2593,201,205824,4465,857280,1063104
test,2594,165,168960,3009,577728,746688
test,2595,111,113664,1362,261504,375168
test,2596,154,157696,2621,503232,660928
test,2597,59,60416,385,73920,134336
test,2598,141,144384,2198,422016,566400
test,2599,139,142336,2136,410112,552448
test,2600,165,168960,3009,577728,746688
test,2601,168,172032,3120,599040,771072
test,2602,79,80896,690,132480,213376
test,2603,58,59392,372,71424,130816
test,2604,197,201728,4289,823488,1025216
test,2605,41,41984,186,35712,77696
test,2606,136,139264,2045,392640,531904
test,2607,94,96256,977,187584,283840
test,2608,265,271360,7761,1490112,1761472
test,2609,173,177152,3308,635136,812288
test,2610,76,77824,639,122688,200512
test,2611,149,152576,2454,471168,623744
test,2612,143,146432,2260,433920,580352
test,2613,95,97280,998,191616,288896
test,2614,197,201728,4289,823488,1025216
test,2615,127,130048,1783,342336,472384
test,2616,117,119808,1513,290496,410304
test,2617,226,231424,5645,1083840,1315264
test,2618,154,157696,2621,503232,660928
test,2619,188,192512,3907,750144,942656
test,2620,46,47104,234,44928,92032
test,2621,56,57344,347,66624,123968
test,2622,201,205824,4465,857280,1063104
test,2623,154,157696,2621,503232,660928
test,2624,186,190464,3824,734208,924672
test,2625,142,145408,2229,427968,573376
test,2626,179,183296,3541,679872,863168
test,2627,114,116736,1437,275904,392640
test,2628,81,82944,725,139200,222144
test,2629,161,164864,2865,550080,714944
test,2630,62,63488,425,81600,145088
test,2631,106,108544,1242,238464,347008
test,2632,156,159744,2690,516480,676224
test,2633,161,164864,2865,550080,714944
test,2634,183,187392,3702,710784,898176
test,2635,116,118784,1488,285696,404480
test,2636,178,182272,3502,672384,854656
test,2637,80,81920,708,135936,217856
test,2638,56,57344,347,66624,123968
test,2639,196,200704,4246,815232,1015936
test,2640,186,190464,3824,734208,924672
test,2641,205,209920,4645,891840,1101760
test,2642,87,89088,837,160704,249792
test,2643,200,204800,4421,848832,1053632
test,2644,155,158720,2656,509952,668672
test,2645,145,148480,2324,446208,594688
test,2646,141,144384,2198,422016,566400
test,2647,117,119808,1513,290496,410304
test,2648,191,195584,4032,774144,969728
test,2649,71,72704,558,107136,179840
test,2650,162,165888,2901,556992,722880
test,2651,157,160768,2725,523200,683968
test,2652,77,78848,656,125952,204800
test,2653,177,181248,3463,664896,846144
test,2654,104,106496,1196,229632,336128
test,2655,249,254976,6853,1315776,1570752
test,2656,166,169984,3046,584832,754816
test,2657,136,139264,2045,392640,531904
test,2658,165,168960,3009,577728,746688
test,2659,92,94208,936,179712,273920
test,2660,234,239616,6052,1161984,1401600
test,2661,193,197632,4117,790464,988096
test,2662,144,147456,2292,440064,587520
test,2663,77,78848,656,125952,204800
test,2664,144,147456,2292,440064,587520
test,2665,153,156672,2587,496704,653376
test,2666,92,94208,936,179712,273920
test,2667,140,143360,2167,416064,559424
test,2668,100,102400,1106,212352,314752
test,2669,181,185344,3621,695232,880576
test,2670,152,155648,2554,490368,646016
test,2671,145,148480,2324,446208,594688
test,2672,121,123904,1618,310656,434560
test,2673,322,329728,11459,2200128,2529856
test,2674,100,102400,1106,212352,314752
test,2675,62,63488,425,81600,145088
test,2676,106,108544,1242,238464,347008
test,2677,118,120832,1539,295488,416320
test,2678,209,214016,4828,926976,1140992
test,2679,180,184320,3581,687552,871872
test,2680,156,159744,2690,516480,676224
test,2681,103,105472,1173,225216,330688
test,2682,171,175104,3232,620544,795648
test,2683,184,188416,3742,718464,906880
test,2684,115,117760,1462,280704,398464
test,2685,180,184320,3581,687552,871872
test,2686,102,104448,1150,220800,325248
test,2687,130,133120,1868,358656,491776
test,2688,119,121856,1565,300480,422336
test,2689,171,175104,3232,620544,795648
test,2690,48,49152,255,48960,98112
test,2691,168,172032,3120,599040,771072
test,2692,200,204800,4421,848832,1053632
test,2693,107,109568,1266,243072,352640
test,2694,170,174080,3194,613248,787328
test,2695,164,167936,2973,570816,738752
test,2696,181,185344,3621,695232,880576
test,2697,154,157696,2621,503232,660928
test,2698,151,154624,2520,483840,638464
test,2699,191,195584,4032,774144,969728
test,2700,162,165888,2901,556992,722880
test,2701,188,192512,3907,750144,942656
test,2702,221,226304,5398,1036416,1262720
test,2703,155,158720,2656,509952,668672
test,2704,189,193536,3948,758016,951552
test,2705,120,122880,1592,305664,428544
test,2706,63,64512,439,84288,148800
test,2707,147,150528,2389,458688,609216
test,2708,166,169984,3046,584832,754816
test,2709,118,120832,1539,295488,416320
test,2710,125,128000,1727,331584,459584
test,2711,119,121856,1565,300480,422336
test,2712,46,47104,234,44928,92032
test,2713,157,160768,2725,523200,683968
test,2714,114,116736,1437,275904,392640
test,2715,167,171008,3083,591936,762944
test,2716,135,138240,2015,386880,525120
test,2717,150,153600,2487,477504,631104
test,2718,190,194560,3990,766080,960640
test,2719,123,125952,1672,321024,446976
test,2720,150,153600,2487,477504,631104
test,2721,342,350208,12927,2481984,2832192
test,2722,265,271360,7761,1490112,1761472
test,2723,168,172032,3120,599040,771072
test,2724,173,177152,3308,635136,812288
test,2725,83,84992,762,146304,231296
test,2726,102,104448,1150,220800,325248
test,2727,159,162816,2794,536448,699264
test,2728,211,216064,4921,944832,1160896
test,2729,172,176128,3270,627840,803968
test,2730,171,175104,3232,620544,795648
test,2731,120,122880,1592,305664,428544
test,2732,50,51200,277,53184,104384
test,2733,42,43008,195,37440,80448
test,2734,217,222208,5205,999360,1221568
test,2735,140,143360,2167,416064,559424
test,2736,158,161792,2759,529728,691520
test,2737,132,135168,1926,369792,504960
test,2738,93,95232,956,183552,278784
test,2739,137,140288,2075,398400,538688
test,2740,172,176128,3270,627840,803968
test,2741,136,139264,2045,392640,531904
test,2742,175,179200,3385,649920,829120
test,2743,147,150528,2389,458688,609216
test,2744,143,146432,2260,433920,580352
test,2745,132,135168,1926,369792,504960
test,2746,169,173056,3157,606144,779200
test,2747,158,161792,2759,529728,691520
test,2748,152,155648,2554,490368,646016
test,2749,58,59392,372,71424,130816
test,2750,127,130048,1783,342336,472384
test,2751,188,192512,3907,750144,942656
test,2752,193,197632,4117,790464,988096
test,2753,100,102400,1106,212352,314752
test,2754,71,72704,558,107136,179840
test,2755,109,111616,1313,252096,363712
test,2756,83,84992,762,146304,231296
test,2757,58,59392,372,71424,130816
test,2758,217,222208,5205,999360,1221568
test,2759,166,169984,3046,584832,754816
test,2760,155,158720,2656,509952,668672
test,2761,49,50176,266,51072,101248
test,2762,107,109568,1266,243072,352640
test,2763,190,194560,3990,766080,960640
test,2764,74,75776,606,116352,192128
test,2765,225,230400,5595,1074240,1304640
test,2766,194,198656,4160,798720,997376
test,2767,152,155648,2554,490368,646016
test,2768,168,172032,3120,599040,771072
test,2769,230,235520,5847,1122624,1358144
test,2770,91,93184,916,175872,269056
test,2771,129,132096,1840,353280,485376
test,2772,92,94208,936,179712,273920
test,2773,111,113664,1362,261504,375168
test,2774,119,121856,1565,300480,422336
test,2775,116,118784,1488,285696,404480
test,2776,217,222208,5205,999360,1221568
test,2777,149,152576,2454,471168,623744
test,2778,115,117760,1462,280704,398464
test,2779,249,254976,6853,1315776,1570752
test,2780,178,182272,3502,672384,854656
test,2781,141,144384,2198,422016,566400
test,2782,79,80896,690,132480,213376
test,2783,234,239616,6052,1161984,1401600
test,2784,107,109568,1266,243072,352640
test,2785,72,73728,573,110016,183744
test,2786,125,128000,1727,331584,459584
test,2787,120,122880,1592,305664,428544
test,2788,113,115712,1412,271104,386816
test,2789,107,109568,1266,243072,352640
test,2790,145,148480,2324,446208,594688
test,2791,92,94208,936,179712,273920
test,2792,150,153600,2487,477504,631104
test,2793,65,66560,467,89664,156224
test,2794,175,179200,3385,649920,829120
test,2795,158,161792,2759,529728,691520
test,2796,46,47104,234,44928,92032
test,2797,149,152576,2454,471168,623744
test,2798,146,149504,2356,452352,601856
test,2799,208,212992,4782,918144,1131136
test,2800,151,154624,2520,483840,638464
test,2801,167,171008,3083,591936,762944
test,2802,69,70656,527,101184,171840
test,2803,70,71680,542,104064,175744
test,2804,111,113664,1362,261504,375168
test,2805,126,129024,1755,336960,465984
test,2806,169,173056,3157,606144,779200
test,2807,89,91136,876,168192,259328
test,2808,103,105472,1173,225216,330688
test,2809,104,106496,1196,229632,336128
test,2810,136,139264,2045,392640,531904
test,2811,63,64512,439,84288,148800
test,2812,123,125952,1672,321024,446976
test,2813,109,111616,1313,252096,363712
test,2814,113,115712,1412,271104,386816
test,2815,72,73728,573,110016,183744
test,2816,88,90112,856,164352,254464
test,2817,151,154624,2520,483840,638464
test,2818,47,48128,245,47040,95168
test,2819,216,221184,5157,990144,1211328
test,2820,205,209920,4645,891840,1101760
test,2821,157,160768,2725,523200,683968
test,2822,206,210944,4690,900480,1111424
test,2823,74,75776,606,116352,192128
test,2824,112,114688,1387,266304,380992
test,2825,93,95232,956,183552,278784
test,2826,143,146432,2260,433920,580352
test,2827,178,182272,3502,672384,854656
test,2828,156,159744,2690,516480,676224
test,2829,127,130048,1783,342336,472384
test,2830,167,171008,3083,591936,762944
test,2831,120,122880,1592,305664,428544
test,2832,85,87040,799,153408,240448
test,2833,87,89088,837,160704,249792
test,2834,143,146432,2260,433920,580352
test,2835,147,150528,2389,458688,609216
test,2836,117,119808,1513,290496,410304
test,2837,200,204800,4421,848832,1053632
test,2838,63,64512,439,84288,148800
test,2839,111,113664,1362,261504,375168
test,2840,162,165888,2901,556992,722880
test,2841,183,187392,3702,710784,898176
test,2842,111,113664,1362,261504,375168
test,2843,104,106496,1196,229632,336128
test,2844,236,241664,6156,1181952,1423616
test,2845,153,156672,2587,496704,653376
test,2846,155,158720,2656,509952,668672
test,2847,228,233472,5746,1103232,1336704
test,2848,129,132096,1840,353280,485376
test,2849,50,51200,277,53184,104384
test,2850,125,128000,1727,331584,459584
test,2851,141,144384,2198,422016,566400
test,2852,183,187392,3702,710784,898176
test,2853,92,94208,936,179712,273920
test,2854,165,168960,3009,577728,746688
test,2855,146,149504,2356,452352,601856
test,2856,89,91136,876,168192,259328
test,2857,133,136192,1955,375360,511552
test,2858,162,165888,2901,556992,722880
test,2859,113,115712,1412,271104,386816
test,2860,158,161792,2759,529728,691520
test,2861,165,168960,3009,577728,746688
test,2862,217,222208,5205,999360,1221568
test,2863,183,187392,3702,710784,898176
test,2864,154,157696,2621,503232,660928
test,2865,53,54272,311,59712,113984
test,2866,201,205824,4465,857280,1063104
test,2867,138,141312,2105,404160,545472
test,2868,63,64512,439,84288,148800
test,2869,134,137216,1985,381120,518336
test,2870,157,160768,2725,523200,683968
test,2871,81,82944,725,139200,222144
test,2872,136,139264,2045,392640,531904
test,2873,158,161792,2759,529728,691520
test,2874,67,68608,497,95424,164032
test,2875,130,133120,1868,358656,491776
test,2876,156,159744,2690,516480,676224
test,2877,139,142336,2136,410112,552448
test,2878,200,204800,4421,848832,1053632
test,2879,128,131072,1811,347712,478784
test,2880,131,134144,1897,364224,498368
test,2881,153,156672,2587,496704,653376
test,2882,220,225280,5349,1027008,1252288
test,2883,107,109568,1266,243072,352640
test,2884,190,194560,3990,766080,960640
test,2885,161,164864,2865,550080,714944
test,2886,129,132096,1840,353280,485376
test,2887,153,156672,2587,496704,653376
test,2888,167,171008,3083,591936,762944
test,2889,250,256000,6908,1326336,1582336
test,2890,134,137216,1985,381120,518336
test,2891,61,62464,412,79104,141568
test,2892,109,111616,1313,252096,363712
test,2893,165,168960,3009,577728,746688
test,2894,112,114688,1387,266304,380992
test,2895,167,171008,3083,591936,762944
test,2896,158,161792,2759,529728,691520
test,2897,111,113664,1362,261504,375168
test,2898,120,122880,1592,305664,428544
test,2899,187,191488,3865,742080,933568
test,2900,186,190464,3824,734208,924672
test,2901,66,67584,482,92544,160128
test,2902,160,163840,2830,543360,707200
test,2903,126,129024,1755,336960,465984
test,2904,161,164864,2865,550080,714944
test,2905,161,164864,2865,550080,714944
test,2906,177,181248,3463,664896,846144
test,2907,144,147456,2292,440064,587520
test,2908,50,51200,277,53184,104384
test,2909,104,106496,1196,229632,336128
test,2910,173,177152,3308,635136,812288
test,2911,127,130048,1783,342336,472384
test,2912,52,53248,299,57408,110656
test,2913,232,237568,5949,1142208,1379776
test,2914,206,210944,4690,900480,1111424
test,2915,180,184320,3581,687552,871872
test,2916,184,188416,3742,718464,906880
test,2917,185,189440,3783,726336,915776
test,2918,88,90112,856,164352,254464
test,2919,196,200704,4246,815232,1015936
test,2920,73,74752,589,113088,187840
test,2921,146,149504,2356,452352,601856
test,2922,121,123904,1618,310656,434560
test,2923,209,214016,4828,926976,1140992
test,2924,166,169984,3046,584832,754816
test,2925,84,86016,780,149760,235776
test,2926,186,190464,3824,734208,924672
test,2927,151,154624,2520,483840,638464
test,2928,137,140288,2075,398400,538688
test,2929,142,145408,2229,427968,573376
test,2930,147,150528,2389,458688,609216
test,2931,173,177152,3308,635136,812288
test,2932,146,149504,2356,452352,601856
test,2933,135,138240,2015,386880,525120
test,2934,135,138240,2015,386880,525120
test,2935,190,194560,3990,766080,960640
test,2936,179,183296,3541,679872,863168
test,2937,171,175104,3232,620544,795648
test,2938,168,172032,3120,599040,771072
test,2939,120,122880,1592,305664,428544
test,2940,92,94208,936,179712,273920
test,2941,115,117760,1462,280704,398464
test,2942,160,163840,2830,543360,707200
test,2943,93,95232,956,183552,278784
test,2944,155,158720,2656,509952,668672
test,2945,183,187392,3702,710784,898176
test,2946,133,136192,1955,375360,511552
test,2947,69,70656,527,101184,171840
test,2948,224,229376,5546,1064832,1294208
test,2949,59,60416,385,73920,134336
test,2950,120,122880,1592,305664,428544
test,2951,167,171008,3083,591936,762944
test,2952,230,235520,5847,1122624,1358144
test,2953,187,191488,3865,742080,933568
test,2954,84,86016,780,149760,235776
test,2955,175,179200,3385,649920,829120
test,2956,158,161792,2759,529728,691520
test,2957,130,133120,1868,358656,491776
test,2958,152,155648,2554,490368,646016
test,2959,96,98304,1019,195648,293952
test,2960,159,162816,2794,536448,699264
test,2961,114,116736,1437,275904,392640
test,2962,167,171008,3083,591936,762944
test,2963,108,110592,1289,247488,358080
test,2964,97,99328,1040,199680,299008
test,2965,185,189440,3783,726336,915776
test,2966,110,112640,1338,256896,369536
test,2967,196,200704,4246,815232,1015936
test,2968,175,179200,3385,649920,829120
test,2969,159,162816,2794,536448,699264
test,2970,90,92160,896,172032,264192
test,2971,174,178176,3346,642432,820608
test,2972,136,139264,2045,392640,531904
test,2973,190,194560,3990,766080,960640
test,2974,82,83968,744,142848,226816
test,2975,64,65536,453,86976,152512
test,2976,147,150528,2389,458688,609216
test,2977,111,113664,1362,261504,375168
test,2978,74,75776,606,116352,192128
test,2979,58,59392,372,71424,130816
test,2980,157,160768,2725,523200,683968
test,2981,183,187392,3702,710784,898176
test,2982,81,82944,725,139200,222144
test,2983,168,172032,3120,599040,771072
test,2984,85,87040,799,153408,240448
test,2985,112,114688,1387,266304,380992
test,2986,119,121856,1565,300480,422336
test,2987,190,194560,3990,766080,960640
test,2988,282,288768,8789,1687488,1976256
test,2989,135,138240,2015,386880,525120
test,2990,171,175104,3232,620544,795648
test,2991,62,63488,425,81600,145088
test,2992,139,142336,2136,410112,552448
test,2993,104,106496,1196,229632,336128
test,2994,144,147456,2292,440064,587520
test,2995,273,279552,8237,1581504,1861056
test,2996,151,154624,2520,483840,638464
test,2997,184,188416,3742,718464,906880
test,2998,100,102400,1106,212352,314752
test,2999,151,154624,2520,483840,638464
test,3000,146,149504,2356,452352,601856
test,3001,131,134144,1897,364224,498368
test,3002,175,179200,3385,649920,829120
test,3003,177,181248,3463,664896,846144
test,3004,176,180224,3424,657408,837632
test,3005,94,96256,977,187584,283840
test,3006,91,93184,916,175872,269056
test,3007,56,57344,347,66624,123968
test,3008,179,183296,3541,679872,863168
test,3009,75,76800,622,119424,196224
test,3010,55,56320,335,64320,120640
test,3011,132,135168,1926,369792,504960
test,3012,149,152576,2454,471168,623744
test,3013,147,150528,2389,458688,609216
test,3014,105,107520,1219,234048,341568
test,3015,155,158720,2656,509952,668672
test,3016,137,140288,2075,398400,538688
test,3017,146,149504,2356,452352,601856
test,3018,115,117760,1462,280704,398464
test,3019,152,155648,2554,490368,646016
test,3020,220,225280,5349,1027008,1252288
test,3021,162,165888,2901,556992,722880
test,3022,199,203776,4377,840384,1044160
test,3023,150,153600,2487,477504,631104
test,3024,140,143360,2167,416064,559424
test,3025,119,121856,1565,300480,422336
test,3026,157,160768,2725,523200,683968
test,3027,130,133120,1868,358656,491776
test,3028,115,117760,1462,280704,398464
test,3029,191,195584,4032,774144,969728
test,3030,162,165888,2901,556992,722880
test,3031,103,105472,1173,225216,330688
test,3032,97,99328,1040,199680,299008
test,3033,102,104448,1150,220800,325248
test,3034,86,88064,818,157056,245120
test,3035,201,205824,4465,857280,1063104
test,3036,172,176128,3270,627840,803968
test,3037,184,188416,3742,718464,906880
test,3038,118,120832,1539,295488,416320
test,3039,126,129024,1755,336960,465984
test,3040,137,140288,2075,398400,538688
test,3041,119,121856,1565,300480,422336
test,3042,126,129024,1755,336960,465984
test,3043,112,114688,1387,266304,380992
test,3044,175,179200,3385,649920,829120
test,3045,182,186368,3661,702912,889280
test,3046,167,171008,3083,591936,762944
test,3047,138,141312,2105,404160,545472
test,3048,188,192512,3907,750144,942656
test,3049,213,218112,5014,962688,1180800
test,3050,137,140288,2075,398400,538688
test,3051,163,166912,2937,563904,730816
test,3052,129,132096,1840,353280,485376
test,3053,50,51200,277,53184,104384
test,3054,122,124928,1645,315840,440768
test,3055,240,245760,6366,1222272,1468032
test,3056,118,120832,1539,295488,416320
test,3057,188,192512,3907,750144,942656
test,3058,120,122880,1592,305664,428544
test,3059,50,51200,277,53184,104384
test,3060,221,226304,5398,1036416,1262720
test,3061,124,126976,1700,326400,453376
test,3062,91,93184,916,175872,269056
test,3063,166,169984,3046,584832,754816
test,3064,120,122880,1592,305664,428544
test,3065,113,115712,1412,271104,386816
test,3066,229,234496,5796,1112832,1347328
test,3067,102,104448,1150,220800,325248
test,3068,189,193536,3948,758016,951552
test,3069,53,54272,311,59712,113984
test,3070,197,201728,4289,823488,1025216
test,3071,91,93184,916,175872,269056
test,3072,140,143360,2167,416064,559424
test,3073,129,132096,1840,353280,485376
test,3074,181,185344,3621,695232,880576
test,3075,180,184320,3581,687552,871872
test,3076,126,129024,1755,336960,465984
test,3077,101,103424,1128,216576,320000
test,3078,203,207872,4555,874560,1082432
test,3079,168,172032,3120,599040,771072
test,3080,198,202752,4333,831936,1034688
test,3081,154,157696,2621,503232,660928
test,3082,125,128000,1727,331584,459584
test,3083,203,207872,4555,874560,1082432
test,3084,149,152576,2454,471168,623744
test,3085,187,191488,3865,742080,933568
test,3086,138,141312,2105,404160,545472
test,3087,191,195584,4032,774144,969728
test,3088,268,274432,7938,1524096,1798528
test,3089,152,155648,2554,490368,646016
test,3090,136,139264,2045,392640,531904
test,3091,218,223232,5253,1008576,1231808
test,3092,151,154624,2520,483840,638464
test,3093,131,134144,1897,364224,498368
test,3094,167,171008,3083,591936,762944
test,3095,156,159744,2690,516480,676224
test,3096,128,131072,1811,347712,478784
test,3097,185,189440,3783,726336,915776
test,3098,93,95232,956,183552,278784
test,3099,191,195584,4032,774144,969728
test,3100,175,179200,3385,649920,829120
test,3101,152,155648,2554,490368,646016
test,3102,188,192512,3907,750144,942656
test,3103,128,131072,1811,347712,478784
test,3104,112,114688,1387,266304,380992
test,3105,154,157696,2621,503232,660928
test,3106,141,144384,2198,422016,566400
test,3107,175,179200,3385,649920,829120
test,3108,113,115712,1412,271104,386816
test,3109,77,78848,656,125952,204800
test,3110,158,161792,2759,529728,691520
test,3111,106,108544,1242,238464,347008
test,3112,146,149504,2356,452352,601856
test,3113,85,87040,799,153408,240448
test,3114,121,123904,1618,310656,434560
test,3115,116,118784,1488,285696,404480
test,3116,171,175104,3232,620544,795648
test,3117,149,152576,2454,471168,623744
test,3118,125,128000,1727,331584,459584
test,3119,48,49152,255,48960,98112
test,3120,35,35840,136,26112,61952
test,3121,92,94208,936,179712,273920
test,3122,154,157696,2621,503232,660928
test,3123,104,106496,1196,229632,336128
test,3124,179,183296,3541,679872,863168
test,3125,48,49152,255,48960,98112
test,3126,130,133120,1868,358656,491776
test,3127,183,187392,3702,710784,898176
test,3128,85,87040,799,153408,240448
test,3129,154,157696,2621,503232,660928
test,3130,144,147456,2292,440064,587520
test,3131,169,173056,3157,606144,779200
test,3132,83,84992,762,146304,231296
test,3133,229,234496,5796,1112832,1347328
test,3134,154,157696,2621,503232,660928
test,3135,92,94208,936,179712,273920
test,3136,144,147456,2292,440064,587520
test,3137,176,180224,3424,657408,837632
test,3138,180,184320,3581,687552,871872
test,3139,149,152576,2454,471168,623744
test,3140,145,148480,2324,446208,594688
test,3141,53,54272,311,59712,113984
test,3142,161,164864,2865,550080,714944
test,3143,81,82944,726,139392,222336
test,3144,185,189440,3783,726336,915776
test,3145,169,173056,3157,606144,779200
test,3146,110,112640,1338,256896,369536
test,3147,165,168960,3009,577728,746688
test,3148,53,54272,311,59712,113984
test,3149,199,203776,4377,840384,1044160
test,3150,201,205824,4465,857280,1063104
test,3151,147,150528,2389,458688,609216
test,3152,123,125952,1672,321024,446976
test,3153,168,172032,3120,599040,771072
test,3154,191,195584,4032,774144,969728
test,3155,86,88064,818,157056,245120
test,3156,175,179200,3385,649920,829120
test,3157,175,179200,3385,649920,829120
test,3158,107,109568,1266,243072,352640
test,3159,59,60416,385,73920,134336
test,3160,235,240640,6104,1171968,1412608
test,3161,149,152576,2454,471168,623744
test,3162,89,91136,876,168192,259328
test,3163,148,151552,2421,464832,616384
test,3164,235,240640,6104,1171968,1412608
test,3165,164,167936,2973,570816,738752
test,3166,165,168960,3009,577728,746688
test,3167,145,148480,2324,446208,594688
test,3168,139,142336,2136,410112,552448
test,3169,83,84992,762,146304,231296
test,3170,88,90112,856,164352,254464
test,3171,152,155648,2554,490368,646016
test,3172,108,110592,1289,247488,358080
test,3173,77,78848,656,125952,204800
test,3174,66,67584,482,92544,160128
test,3175,207,211968,4736,909312,1121280
test,3176,144,147456,2292,440064,587520
test,3177,182,186368,3661,702912,889280
test,3178,143,146432,2260,433920,580352
test,3179,211,216064,4921,944832,1160896
test,3180,133,136192,1955,375360,511552
test,3181,148,151552,2421,464832,616384
test,3182,157,160768,2725,523200,683968
test,3183,151,154624,2520,483840,638464
test,3184,104,106496,1196,229632,336128
test,3185,51,52224,288,55296,107520
test,3186,173,177152,3308,635136,812288
test,3187,135,138240,2015,386880,525120
test,3188,158,161792,2759,529728,691520
test,3189,91,93184,916,175872,269056
test,3190,75,76800,622,119424,196224
test,3191,190,194560,3990,766080,960640
test,3192,87,89088,837,160704,249792
test,3193,220,225280,5349,1027008,1252288
test,3194,98,100352,1062,203904,304256
test,3195,52,53248,299,57408,110656
test,3196,133,136192,1955,375360,511552
test,3197,86,88064,818,157056,245120
test,3198,147,150528,2389,458688,609216
test,3199,178,182272,3502,672384,854656
test,3200,174,178176,3346,642432,820608
test,3201,95,97280,998,191616,288896
test,3202,144,147456,2292,440064,587520
test,3203,160,163840,2830,543360,707200
test,3204,107,109568,1266,243072,352640
test,3205,84,86016,780,149760,235776
test,3206,86,88064,818,157056,245120
test,3207,133,136192,1955,375360,511552
test,3208,134,137216,1985,381120,518336
test,3209,171,175104,3232,620544,795648
test,3210,121,123904,1618,310656,434560
test,3211,105,107520,1219,234048,341568
test,3212,158,161792,2759,529728,691520
test,3213,140,143360,2167,416064,559424
test,3214,156,159744,2690,516480,676224
test,3215,72,73728,573,110016,183744
test,3216,94,96256,977,187584,283840
test,3217,195,199680,4203,806976,1006656
test,3218,176,180224,3424,657408,837632
test,3219,146,149504,2356,452352,601856
test,3220,182,186368,3661,702912,889280
test,3221,141,144384,2198,422016,566400
test,3222,191,195584,4032,774144,969728
test,3223,127,130048,1783,342336,472384
test,3224,172,176128,3270,627840,803968
test,3225,77,78848,656,125952,204800
test,3226,124,126976,1700,326400,453376
test,3227,225,230400,5595,1074240,1304640
test,3228,67,68608,497,95424,164032
test,3229,219,224256,5301,1017792,1242048
test,3230,113,115712,1412,271104,386816
test,3231,156,159744,2690,516480,676224
test,3232,149,152576,2454,471168,623744
test,3233,153,156672,2587,496704,653376
test,3234,174,178176,3346,642432,820608
test,3235,134,137216,1985,381120,518336
test,3236,67,68608,497,95424,164032
test,3237,153,156672,2587,496704,653376
test,3238,86,88064,818,157056,245120
test,3239,247,252928,6743,1294656,1547584
test,3240,44,45056,214,41088,86144
test,3241,169,173056,3157,606144,779200
test,3242,63,64512,439,84288,148800
test,3243,123,125952,1672,321024,446976
test,3244,123,125952,1672,321024,446976
test,3245,92,94208,936,179712,273920
test,3246,166,169984,3046,584832,754816
test,3247,140,143360,2167,416064,559424
test,3248,209,214016,4828,926976,1140992
test,3249,117,119808,1513,290496,410304
test,3250,142,145408,2229,427968,573376
test,3251,172,176128,3270,627840,803968
test,3252,98,100352,1062,203904,304256
test,3253,128,131072,1811,347712,478784
test,3254,160,163840,2830,543360,707200
test,3255,158,161792,2759,529728,691520
test,3256,80,81920,708,135936,217856
test,3257,159,162816,2794,536448,699264
test,3258,54,55296,323,62016,117312
test,3259,130,133120,1868,358656,491776
test,3260,159,162816,2794,536448,699264
test,3261,150,153600,2487,477504,631104
test,3262,65,66560,467,89664,156224
test,3263,196,200704,4246,815232,1015936
test,3264,118,120832,1539,295488,416320
test,3265,236,241664,6156,1181952,1423616
test,3266,138,141312,2105,404160,545472
test,3267,74,75776,606,116352,192128
test,3268,138,141312,2105,404160,545472
test,3269,129,132096,1840,353280,485376
test,3270,191,195584,4032,774144,969728
test,3271,121,123904,1618,310656,434560
test,3272,100,102400,1106,212352,314752
test,3273,122,124928,1645,315840,440768
test,3274,211,216064,4921,944832,1160896
test,3275,197,201728,4289,823488,1025216
test,3276,143,146432,2260,433920,580352
test,3277,138,141312,2105,404160,545472
test,3278,101,103424,1128,216576,320000
test,3279,91,93184,916,175872,269056
test,3280,186,190464,3824,734208,924672
test,3281,197,201728,4289,823488,1025216
test,3282,116,118784,1488,285696,404480
test,3283,116,118784,1488,285696,404480
test,3284,226,231424,5645,1083840,1315264
test,3285,168,172032,3120,599040,771072
test,3286,151,154624,2520,483840,638464
test,3287,207,211968,4736,909312,1121280
test,3288,173,177152,3308,635136,812288
test,3289,86,88064,818,157056,245120
test,3290,173,177152,3308,635136,812288
test,3291,196,200704,4246,815232,1015936
test,3292,123,125952,1672,321024,446976
test,3293,113,115712,1412,271104,386816
test,3294,167,171008,3083,591936,762944
test,3295,177,181248,3463,664896,846144
test,3296,65,66560,467,89664,156224
test,3297,109,111616,1313,252096,363712
test,3298,191,195584,4032,774144,969728
test,3299,143,146432,2260,433920,580352
test,3300,188,192512,3907,750144,942656
test,3301,57,58368,359,68928,127296
test,3302,161,164864,2865,550080,714944
test,3303,187,191488,3865,742080,933568
test,3304,158,161792,2759,529728,691520
test,3305,77,78848,656,125952,204800
test,3306,88,90112,856,164352,254464
test,3307,140,143360,2167,416064,559424
test,3308,154,157696,2621,503232,660928
test,3309,189,193536,3948,758016,951552
test,3310,201,205824,4465,857280,1063104
test,3311,127,130048,1783,342336,472384
test,3312,186,190464,3824,734208,924672
test,3313,153,156672,2587,496704,653376
test,3314,143,146432,2260,433920,580352
test,3315,93,95232,956,183552,278784
test,3316,116,118784,1488,285696,404480
test,3317,176,180224,3424,657408,837632
test,3318,105,107520,1219,234048,341568
test,3319,91,93184,916,175872,269056
test,3320,115,117760,1462,280704,398464
test,3321,147,150528,2389,458688,609216
test,3322,88,90112,856,164352,254464
test,3323,97,99328,1040,199680,299008
test,3324,105,107520,1219,234048,341568
test,3325,139,142336,2136,410112,552448
test,3326,165,168960,3009,577728,746688
test,3327,138,141312,2105,404160,545472
test,3328,53,54272,311,59712,113984
test,3329,79,80896,690,132480,213376
test,3330,151,154624,2520,483840,638464
test,3331,180,184320,3581,687552,871872
test,3332,108,110592,1289,247488,358080
test,3333,129,132096,1840,353280,485376
test,3334,143,146432,2260,433920,580352
test,3335,112,114688,1387,266304,380992
test,3336,63,64512,439,84288,148800
test,3337,142,145408,2229,427968,573376
test,3338,220,225280,5349,1027008,1252288
test,3339,136,139264,2045,392640,531904
test,3340,96,98304,1019,195648,293952
test,3341,86,88064,818,157056,245120
test,3342,165,168960,3009,577728,746688
test,3343,144,147456,2292,440064,587520
test,3344,198,202752,4333,831936,1034688
test,3345,79,80896,690,132480,213376
test,3346,70,71680,542,104064,175744
test,3347,81,82944,725,139200,222144
test,3348,153,156672,2587,496704,653376
test,3349,74,75776,606,116352,192128
test,3350,112,114688,1387,266304,380992
test,3351,143,146432,2260,433920,580352
test,3352,152,155648,2554,490368,646016
test,3353,233,238592,6000,1152000,1390592
test,3354,109,111616,1313,252096,363712
test,3355,131,134144,1897,364224,498368
test,3356,99,101376,1084,208128,309504
test,3357,96,98304,1019,195648,293952
test,3358,70,71680,542,104064,175744
test,3359,130,133120,1868,358656,491776
test,3360,113,115712,1412,271104,386816
test,3361,54,55296,323,62016,117312
test,3362,62,63488,425,81600,145088
test,3363,171,175104,3232,620544,795648
test,3364,174,178176,3346,642432,820608
test,3365,111,113664,1362,261504,375168
test,3366,127,130048,1783,342336,472384
test,3367,104,106496,1196,229632,336128
test,3368,59,60416,385,73920,134336
test,3369,143,146432,2260,433920,580352
test,3370,165,168960,3009,577728,746688
test,3371,112,114688,1387,266304,380992
test,3372,160,163840,2830,543360,707200
test,3373,130,133120,1868,358656,491776
test,3374,78,79872,673,129216,209088
test,3375,137,140288,2075,398400,538688
test,3376,213,218112,5014,962688,1180800
test,3377,194,198656,4160,798720,997376
test,3378,168,172032,3120,599040,771072
test,3379,133,136192,1955,375360,511552
test,3380,111,113664,1362,261504,375168
test,3381,152,155648,2554,490368,646016
test,3382,129,132096,1840,353280,485376
test,3383,212,217088,4967,953664,1170752
test,3384,135,138240,2015,386880,525120
test,3385,103,105472,1173,225216,330688
test,3386,163,166912,2937,563904,730816
test,3387,100,102400,1106,212352,314752
test,3388,128,131072,1811,347712,478784
test,3389,166,169984,3046,584832,754816
test,3390,191,195584,4032,774144,969728
test,3391,83,84992,762,146304,231296
test,3392,102,104448,1150,220800,325248
test,3393,162,165888,2901,556992,722880
test,3394,177,181248,3463,664896,846144
test,3395,118,120832,1539,295488,416320
test,3396,97,99328,1040,199680,299008
test,3397,121,123904,1618,310656,434560
test,3398,147,150528,2389,458688,609216
test,3399,95,97280,998,191616,288896
test,3400,64,65536,453,86976,152512
test,3401,215,220160,5109,980928,1201088
test,3402,125,128000,1727,331584,459584
test,3403,105,107520,1219,234048,341568
test,3404,43,44032,205,39360,83392
test,3405,171,175104,3232,620544,795648
test,3406,208,212992,4782,918144,1131136
test,3407,129,132096,1840,353280,485376
test,3408,122,124928,1645,315840,440768
test,3409,177,181248,3463,664896,846144
test,3410,127,130048,1783,342336,472384
test,3411,129,132096,1840,353280,485376
test,3412,156,159744,2690,516480,676224
test,3413,239,244736,6313,1212096,1456832
test,3414,149,152576,2454,471168,623744
test,3415,100,102400,1106,212352,314752
test,3416,90,92160,896,172032,264192
test,3417,125,128000,1727,331584,459584
test,3418,207,211968,4736,909312,1121280
test,3419,157,160768,2725,523200,683968
test,3420,165,168960,3009,577728,746688
test,3421,203,207872,4555,874560,1082432
test,3422,85,87040,799,153408,240448
test,3423,283,289792,8852,1699584,1989376
test,3424,106,108544,1242,238464,347008
test,3425,132,135168,1926,369792,504960
test,3426,187,191488,3865,742080,933568
test,3427,88,90112,856,164352,254464
test,3428,188,192512,3907,750144,942656
test,3429,136,139264,2045,392640,531904
test,3430,172,176128,3270,627840,803968
test,3431,75,76800,622,119424,196224
test,3432,108,110592,1289,247488,358080
test,3433,47,48128,245,47040,95168
test,3434,154,157696,2621,503232,660928
test,3435,144,147456,2292,440064,587520
test,3436,193,197632,4117,790464,988096
test,3437,153,156672,2587,496704,653376
test,3438,104,106496,1196,229632,336128
test,3439,182,186368,3661,702912,889280
test,3440,283,289792,8852,1699584,1989376
test,3441,112,114688,1387,266304,380992
test,3442,156,159744,2690,516480,676224
test,3443,205,209920,4645,891840,1101760
test,3444,110,112640,1338,256896,369536
test,3445,218,223232,5253,1008576,1231808
test,3446,166,169984,3046,584832,754816
test,3447,119,121856,1565,300480,422336
test,3448,139,142336,2136,410112,552448
test,3449,104,106496,1196,229632,336128
test,3450,179,183296,3541,679872,863168
test,3451,169,173056,3157,606144,779200
test,3452,103,105472,1173,225216,330688
test,3453,193,197632,4117,790464,988096
test,3454,66,67584,482,92544,160128
test,3455,132,135168,1926,369792,504960
test,3456,180,184320,3581,687552,871872
test,3457,119,121856,1565,300480,422336
test,3458,236,241664,6156,1181952,1423616
test,3459,177,181248,3463,664896,846144
test,3460,74,75776,606,116352,192128
test,3461,139,142336,2136,410112,552448
test,3462,168,172032,3120,599040,771072
test,3463,128,131072,1811,347712,478784
test,3464,287,293888,9104,1747968,2041856
test,3465,133,136192,1955,375360,511552
test,3466,166,169984,3046,584832,754816
test,3467,185,189440,3783,726336,915776
test,3468,113,115712,1412,271104,386816
test,3469,121,123904,1618,310656,434560
test,3470,112,114688,1387,266304,380992
test,3471,162,165888,2901,556992,722880
test,3472,154,157696,2621,503232,660928
test,3473,174,178176,3346,642432,820608
test,3474,114,116736,1437,275904,392640
test,3475,192,196608,4075,782400,979008
test,3476,138,141312,2105,404160,545472
test,3477,146,149504,2356,452352,601856
test,3478,75,76800,622,119424,196224
test,3479,52,53248,299,57408,110656
test,3480,162,165888,2901,556992,722880
test,3481,142,145408,2229,427968,573376
test,3482,131,134144,1897,364224,498368
test,3483,149,152576,2454,471168,623744
test,3484,135,138240,2015,386880,525120
test,3485,84,86016,780,149760,235776
test,3486,149,152576,2454,471168,623744
test,3487,133,136192,1955,375360,511552
test,3488,233,238592,6000,1152000,1390592
test,3489,75,76800,622,119424,196224
test,3490,183,187392,3702,710784,898176
test,3491,134,137216,1985,381120,518336
test,3492,172,176128,3270,627840,803968
test,3493,128,131072,1811,347712,478784
test,3494,321,328704,11388,2186496,2515200
test,3495,133,136192,1955,375360,511552
test,3496,92,94208,936,179712,273920
test,3497,175,179200,3385,649920,829120
test,3498,221,226304,5398,1036416,1262720
test,3499,189,193536,3948,758016,951552
test,3500,147,150528,2389,458688,609216
test,3501,137,140288,2075,398400,538688
test,3502,97,99328,1040,199680,299008
test,3503,116,118784,1488,285696,404480
test,3504,227,232448,5695,1093440,1325888
test,3505,176,180224,3424,657408,837632
test,3506,79,80896,690,132480,213376
test,3507,166,169984,3046,584832,754816
test,3508,196,200704,4246,815232,1015936
test,3509,162,165888,2901,556992,722880
test,3510,134,137216,1985,381120,518336
test,3511,136,139264,2045,392640,531904
test,3512,165,168960,3009,577728,746688
test,3513,151,154624,2520,483840,638464
test,3514,107,109568,1266,243072,352640
test,3515,97,99328,1040,199680,299008
test,3516,187,191488,3865,742080,933568
test,3517,84,86016,780,149760,235776
test,3518,55,56320,335,64320,120640
test,3519,165,168960,3009,577728,746688
test,3520,61,62464,412,79104,141568
test,3521,170,174080,3194,613248,787328
test,3522,280,286720,8665,1663680,1950400
test,3523,113,115712,1412,271104,386816
test,3524,132,135168,1926,369792,504960
test,3525,100,102400,1106,212352,314752
test,3526,143,146432,2260,433920,580352
test,3527,139,142336,2136,410112,552448
test,3528,221,226304,5398,1036416,1262720
test,3529,127,130048,1783,342336,472384
test,3530,154,157696,2621,503232,660928
test,3531,118,120832,1539,295488,416320
test,3532,137,140288,2075,398400,538688
test,3533,57,58368,359,68928,127296
test,3534,210,215040,4874,935808,1150848
test,3535,123,125952,1672,321024,446976
test,3536,175,179200,3385,649920,829120
test,3537,134,137216,1985,381120,518336
test,3538,172,176128,3270,627840,803968
test,3539,158,161792,2759,529728,691520
test,3540,161,164864,2865,550080,714944
test,3541,52,53248,299,57408,110656
test,3542,85,87040,799,153408,240448
test,3543,100,102400,1106,212352,314752
test,3544,159,162816,2794,536448,699264
test,3545,150,153600,2487,477504,631104
test,3546,169,173056,3157,606144,779200
test,3547,138,141312,2105,404160,545472
test,3548,114,116736,1437,275904,392640
test,3549,54,55296,323,62016,117312
test,3550,48,49152,255,48960,98112
test,3551,115,117760,1462,280704,398464
test,3552,194,198656,4160,798720,997376
test,3553,181,185344,3621,695232,880576
test,3554,122,124928,1645,315840,440768
test,3555,193,197632,4117,790464,988096
test,3556,172,176128,3270,627840,803968
test,3557,115,117760,1462,280704,398464
test,3558,178,182272,3502,672384,854656
test,3559,114,116736,1437,275904,392640
test,3560,29,29696,93,17856,47552
test,3561,150,153600,2487,477504,631104
test,3562,111,113664,1362,261504,375168
test,3563,112,114688,1387,266304,380992
test,3564,146,149504,2356,452352,601856
test,3565,283,289792,8852,1699584,1989376
test,3566,119,121856,1565,300480,422336
test,3567,103,105472,1173,225216,330688
test,3568,72,73728,573,110016,183744
test,3569,163,166912,2937,563904,730816
test,3570,134,137216,1985,381120,518336
test,3571,160,163840,2830,543360,707200
test,3572,171,175104,3232,620544,795648
test,3573,186,190464,3824,734208,924672
test,3574,184,188416,3742,718464,906880
test,3575,87,89088,837,160704,249792
test,3576,142,145408,2229,427968,573376
test,3577,211,216064,4921,944832,1160896
test,3578,183,187392,3702,710784,898176
test,3579,92,94208,936,179712,273920
test,3580,121,123904,1618,310656,434560
test,3581,210,215040,4874,935808,1150848
test,3582,186,190464,3824,734208,924672
test,3583,144,147456,2292,440064,587520
test,3584,107,109568,1266,243072,352640
test,3585,159,162816,2794,536448,699264
test,3586,102,104448,1150,220800,325248
test,3587,189,193536,3948,758016,951552
test,3588,100,102400,1106,212352,314752
test,3589,155,158720,2656,509952,668672
test,3590,106,108544,1242,238464,347008
test,3591,222,227328,5447,1045824,1273152
test,3592,196,200704,4246,815232,1015936
test,3593,155,158720,2656,509952,668672
test,3594,147,150528,2389,458688,609216
test,3595,158,161792,2759,529728,691520
test,3596,108,110592,1289,247488,358080
test,3597,153,156672,2587,496704,653376
test,3598,110,112640,1338,256896,369536
test,3599,245,250880,6634,1273728,1524608
test,3600,120,122880,1592,305664,428544
test,3601,279,285696,8603,1651776,1937472
test,3602,149,152576,2454,471168,623744
test,3603,135,138240,2015,386880,525120
test,3604,193,197632,4117,790464,988096
test,3605,102,104448,1150,220800,325248
test,3606,128,131072,1811,347712,478784
test,3607,165,168960,3009,577728,746688
test,3608,172,176128,3270,627840,803968
test,3609,211,216064,4921,944832,1160896
test,3610,209,214016,4828,926976,1140992
test,3611,96,98304,1019,195648,293952
test,3612,194,198656,4160,798720,997376
test,3613,184,188416,3742,718464,906880
test,3614,146,149504,2356,452352,601856
test,3615,143,146432,2260,433920,580352
test,3616,98,100352,1062,203904,304256
test,3617,153,156672,2587,496704,653376
test,3618,86,88064,818,157056,245120
test,3619,135,138240,2015,386880,525120
test,3620,67,68608,497,95424,164032
test,3621,177,181248,3463,664896,846144
test,3622,114,116736,1437,275904,392640
test,3623,137,140288,2075,398400,538688
test,3624,197,201728,4289,823488,1025216
test,3625,52,53248,299,57408,110656
test,3626,100,102400,1106,212352,314752
test,3627,139,142336,2136,410112,552448
test,3628,88,90112,856,164352,254464
test,3629,94,96256,977,187584,283840
test,3630,194,198656,4160,798720,997376
test,3631,186,190464,3824,734208,924672
test,3632,156,159744,2690,516480,676224
test,3633,138,141312,2105,404160,545472
test,3634,136,139264,2045,392640,531904
test,3635,153,156672,2587,496704,653376
test,3636,121,123904,1618,310656,434560
test,3637,101,103424,1128,216576,320000
test,3638,220,225280,5349,1027008,1252288
test,3639,213,218112,5014,962688,1180800
test,3640,93,95232,956,183552,278784
test,3641,129,132096,1840,353280,485376
test,3642,109,111616,1313,252096,363712
test,3643,232,237568,5949,1142208,1379776
test,3644,136,139264,2045,392640,531904
test,3645,127,130048,1783,342336,472384
test,3646,100,102400,1106,212352,314752
test,3647,144,147456,2292,440064,587520
test,3648,168,172032,3120,599040,771072
test,3649,199,203776,4377,840384,1044160
test,3650,173,177152,3308,635136,812288
test,3651,143,146432,2260,433920,580352
test,3652,60,61440,398,76416,137856
test,3653,178,182272,3502,672384,854656
test,3654,202,206848,4510,865920,1072768
test,3655,127,130048,1783,342336,472384
test,3656,206,210944,4690,900480,1111424
test,3657,98,100352,1062,203904,304256
test,3658,106,108544,1242,238464,347008
test,3659,133,136192,1955,375360,511552
test,3660,72,73728,573,110016,183744
test,3661,115,117760,1462,280704,398464
test,3662,119,121856,1565,300480,422336
test,3663,145,148480,2324,446208,594688
test,3664,100,102400,1106,212352,314752
test,3665,172,176128,3270,627840,803968
test,3666,141,144384,2198,422016,566400
test,3667,206,210944,4690,900480,1111424
test,3668,82,83968,744,142848,226816
test,3669,145,148480,2324,446208,594688
test,3670,187,191488,3865,742080,933568
test,3671,44,45056,214,41088,86144
test,3672,114,116736,1437,275904,392640
test,3673,209,214016,4828,926976,1140992
test,3674,189,193536,3948,758016,951552
test,3675,202,206848,4510,865920,1072768
test,3676,104,106496,1196,229632,336128
test,3677,111,113664,1362,261504,375168
test,3678,111,113664,1362,261504,375168
test,3679,212,217088,4967,953664,1170752
test,3680,182,186368,3661,702912,889280
test,3681,123,125952,1672,321024,446976
test,3682,192,196608,4075,782400,979008
test,3683,140,143360,2167,416064,559424
test,3684,167,171008,3083,591936,762944
test,3685,147,150528,2389,458688,609216
test,3686,92,94208,936,179712,273920
test,3687,157,160768,2725,523200,683968
test,3688,49,50176,266,51072,101248
test,3689,168,172032,3120,599040,771072
test,3690,143,146432,2260,433920,580352
test,3691,109,111616,1313,252096,363712
test,3692,130,133120,1868,358656,491776
test,3693,142,145408,2229,427968,573376
test,3694,188,192512,3907,750144,942656
test,3695,70,71680,542,104064,175744
test,3696,88,90112,856,164352,254464
test,3697,259,265216,7414,1423488,1688704
test,3698,57,58368,359,68928,127296
test,3699,121,123904,1618,310656,434560
test,3700,155,158720,2656,509952,668672
test,3701,125,128000,1727,331584,459584
test,3702,186,190464,3824,734208,924672
test,3703,100,102400,1106,212352,314752
test,3704,57,58368,359,68928,127296
test,3705,150,153600,2487,477504,631104
test,3706,182,186368,3661,702912,889280
test,3707,106,108544,1242,238464,347008
test,3708,150,153600,2487,477504,631104
test,3709,115,117760,1462,280704,398464
test,3710,116,118784,1488,285696,404480
test,3711,190,194560,3990,766080,960640
test,3712,137,140288,2075,398400,538688
test,3713,80,81920,708,135936,217856
test,3714,115,117760,1462,280704,398464
test,3715,231,236544,5898,1132416,1368960
test,3716,110,112640,1338,256896,369536
test,3717,148,151552,2421,464832,616384
test,3718,129,132096,1840,353280,485376
test,3719,208,212992,4782,918144,1131136
test,3720,171,175104,3232,620544,795648
test,3721,117,119808,1513,290496,410304
test,3722,197,201728,4289,823488,1025216
test,3723,78,79872,673,129216,209088
test,3724,115,117760,1462,280704,398464
test,3725,106,108544,1242,238464,347008
test,3726,77,78848,656,125952,204800
test,3727,114,116736,1437,275904,392640
test,3728,121,123904,1618,310656,434560
test,3729,220,225280,5349,1027008,1252288
test,3730,76,77824,639,122688,200512
test,3731,158,161792,2759,529728,691520
test,3732,159,162816,2794,536448,699264
test,3733,237,242688,6208,1191936,1434624
test,3734,118,120832,1539,295488,416320
test,3735,121,123904,1618,310656,434560
test,3736,199,203776,4377,840384,1044160
test,3737,142,145408,2229,427968,573376
test,3738,67,68608,497,95424,164032
test,3739,162,165888,2901,556992,722880
test,3740,159,162816,2794,536448,699264
test,3741,158,161792,2759,529728,691520
test,3742,160,163840,2830,543360,707200
test,3743,83,84992,762,146304,231296
test,3744,66,67584,482,92544,160128
test,3745,159,162816,2794,536448,699264
test,3746,66,67584,482,92544,160128
test,3747,97,99328,1040,199680,299008
test,3748,191,195584,4032,774144,969728
test,3749,109,111616,1313,252096,363712
test,3750,163,166912,2937,563904,730816
test,3751,108,110592,1289,247488,358080
test,3752,209,214016,4828,926976,1140992
test,3753,121,123904,1618,310656,434560
test,3754,174,178176,3346,642432,820608
test,3755,186,190464,3824,734208,924672
test,3756,151,154624,2520,483840,638464
test,3757,163,166912,2937,563904,730816
test,3758,144,147456,2292,440064,587520
test,3759,139,142336,2136,410112,552448
test,3760,136,139264,2045,392640,531904
test,3761,95,97280,998,191616,288896
test,3762,127,130048,1783,342336,472384
test,3763,125,128000,1727,331584,459584
test,3764,73,74752,589,113088,187840
test,3765,102,104448,1150,220800,325248
test,3766,217,222208,5205,999360,1221568
test,3767,159,162816,2794,536448,699264
test,3768,40,40960,177,33984,74944
test,3769,201,205824,4465,857280,1063104
test,3770,116,118784,1488,285696,404480
test,3771,141,144384,2198,422016,566400
test,3772,93,95232,956,183552,278784
test,3773,118,120832,1539,295488,416320
test,3774,151,154624,2520,483840,638464
test,3775,128,131072,1811,347712,478784
test,3776,139,142336,2136,410112,552448
test,3777,91,93184,916,175872,269056
test,3778,101,103424,1128,216576,320000
test,3779,100,102400,1106,212352,314752
test,3780,163,166912,2937,563904,730816
test,3781,62,63488,425,81600,145088
test,3782,96,98304,1019,195648,293952
test,3783,166,169984,3046,584832,754816
test,3784,135,138240,2015,386880,525120
test,3785,100,102400,1106,212352,314752
test,3786,155,158720,2656,509952,668672
test,3787,201,205824,4465,857280,1063104
test,3788,96,98304,1019,195648,293952
test,3789,138,141312,2105,404160,545472
test,3790,71,72704,558,107136,179840
test,3791,222,227328,5447,1045824,1273152
test,3792,83,84992,762,146304,231296
test,3793,110,112640,1338,256896,369536
test,3794,77,78848,656,125952,204800
test,3795,133,136192,1955,375360,511552
test,3796,49,50176,266,51072,101248
test,3797,117,119808,1513,290496,410304
test,3798,54,55296,323,62016,117312
test,3799,191,195584,4032,774144,969728
test,3800,164,167936,2973,570816,738752
test,3801,119,121856,1565,300480,422336
test,3802,70,71680,542,104064,175744
test,3803,146,149504,2356,452352,601856
test,3804,161,164864,2865,550080,714944
test,3805,231,236544,5898,1132416,1368960
test,3806,96,98304,1019,195648,293952
test,3807,229,234496,5796,1112832,1347328
test,3808,191,195584,4032,774144,969728
test,3809,111,113664,1362,261504,375168
test,3810,113,115712,1412,271104,386816
test,3811,185,189440,3783,726336,915776
test,3812,146,149504,2356,452352,601856
test,3813,50,51200,277,53184,104384
test,3814,127,130048,1783,342336,472384
test,3815,94,96256,977,187584,283840
test,3816,185,189440,3783,726336,915776
test,3817,100,102400,1106,212352,314752
test,3818,166,169984,3046,584832,754816
test,3819,125,128000,1727,331584,459584
test,3820,177,181248,3463,664896,846144
test,3821,90,92160,896,172032,264192
test,3822,161,164864,2865,550080,714944
test,3823,237,242688,6208,1191936,1434624
test,3824,117,119808,1513,290496,410304
test,3825,128,131072,1811,347712,478784
test,3826,120,122880,1592,305664,428544
test,3827,186,190464,3824,734208,924672
test,3828,86,88064,818,157056,245120
test,3829,129,132096,1840,353280,485376
test,3830,167,171008,3083,591936,762944
test,3831,193,197632,4117,790464,988096
test,3832,110,112640,1338,256896,369536
test,3833,183,187392,3702,710784,898176
test,3834,128,131072,1811,347712,478784
test,3835,158,161792,2759,529728,691520
test,3836,168,172032,3120,599040,771072
test,3837,112,114688,1387,266304,380992
test,3838,55,56320,335,64320,120640
test,3839,182,186368,3661,702912,889280
test,3840,224,229376,5546,1064832,1294208
test,3841,150,153600,2487,477504,631104
test,3842,127,130048,1783,342336,472384
test,3843,90,92160,896,172032,264192
test,3844,112,114688,1387,266304,380992
test,3845,115,117760,1462,280704,398464
test,3846,148,151552,2421,464832,616384
test,3847,177,181248,3463,664896,846144
test,3848,135,138240,2015,386880,525120
test,3849,107,109568,1266,243072,352640
test,3850,127,130048,1783,342336,472384
test,3851,161,164864,2865,550080,714944
test,3852,65,66560,467,89664,156224
test,3853,208,212992,4782,918144,1131136
test,3854,70,71680,542,104064,175744
test,3855,71,72704,558,107136,179840
test,3856,195,199680,4203,806976,1006656
test,3857,152,155648,2554,490368,646016
test,3858,64,65536,453,86976,152512
test,3859,177,181248,3463,664896,846144
test,3860,88,90112,856,164352,254464
test,3861,163,166912,2937,563904,730816
test,3862,94,96256,977,187584,283840
test,3863,133,136192,1955,375360,511552
test,3864,202,206848,4510,865920,1072768
test,3865,117,119808,1513,290496,410304
test,3866,49,50176,266,51072,101248
test,3867,146,149504,2356,452352,601856
test,3868,135,138240,2015,386880,525120
test,3869,175,179200,3385,649920,829120
test,3870,173,177152,3308,635136,812288
test,3871,189,193536,3948,758016,951552
test,3872,114,116736,1437,275904,392640
test,3873,121,123904,1618,310656,434560
test,3874,200,204800,4421,848832,1053632
test,3875,72,73728,573,110016,183744
test,3876,87,89088,837,160704,249792
test,3877,132,135168,1926,369792,504960
test,3878,66,67584,482,92544,160128
test,3879,180,184320,3581,687552,871872
test,3880,198,202752,4333,831936,1034688
test,3881,144,147456,2292,440064,587520
test,3882,180,184320,3581,687552,871872
test,3883,189,193536,3948,758016,951552
test,3884,117,119808,1513,290496,410304
test,3885,208,212992,4782,918144,1131136
test,3886,177,181248,3463,664896,846144
test,3887,151,154624,2520,483840,638464
test,3888,58,59392,372,71424,130816
test,3889,193,197632,4117,790464,988096
test,3890,76,77824,639,122688,200512
test,3891,158,161792,2759,529728,691520
test,3892,96,98304,1019,195648,293952
test,3893,141,144384,2198,422016,566400
test,3894,217,222208,5205,999360,1221568
test,3895,114,116736,1437,275904,392640
test,3896,66,67584,482,92544,160128
test,3897,114,116736,1437,275904,392640
test,3898,85,87040,799,153408,240448
test,3899,117,119808,1513,290496,410304
test,3900,94,96256,977,187584,283840
test,3901,126,129024,1755,336960,465984
test,3902,111,113664,1362,261504,375168
test,3903,198,202752,4333,831936,1034688
test,3904,224,229376,5546,1064832,1294208
test,3905,110,112640,1338,256896,369536
test,3906,127,130048,1783,342336,472384
test,3907,152,155648,2554,490368,646016
test,3908,167,171008,3083,591936,762944
test,3909,204,208896,4600,883200,1092096
test,3910,314,321536,10897,2092224,2413760
test,3911,163,166912,2937,563904,730816
test,3912,155,158720,2656,509952,668672
test,3913,125,128000,1727,331584,459584
test,3914,145,148480,2324,446208,594688
test,3915,138,141312,2105,404160,545472
test,3916,185,189440,3783,726336,915776
test,3917,62,63488,425,81600,145088
test,3918,155,158720,2656,509952,668672
test,3919,146,149504,2356,452352,601856
test,3920,158,161792,2759,529728,691520
test,3921,175,179200,3385,649920,829120
test,3922,170,174080,3194,613248,787328
test,3923,138,141312,2105,404160,545472
test,3924,182,186368,3661,702912,889280
test,3925,107,109568,1266,243072,352640
test,3926,149,152576,2454,471168,623744
test,3927,125,128000,1727,331584,459584
test,3928,132,135168,1926,369792,504960
test,3929,158,161792,2759,529728,691520
test,3930,121,123904,1618,310656,434560
test,3931,213,218112,5014,962688,1180800
test,3932,173,177152,3308,635136,812288
test,3933,158,161792,2759,529728,691520
test,3934,59,60416,385,73920,134336
test,3935,138,141312,2105,404160,545472
test,3936,162,165888,2901,556992,722880
test,3937,138,141312,2105,404160,545472
test,3938,146,149504,2356,452352,601856
test,3939,139,142336,2136,410112,552448
test,3940,92,94208,936,179712,273920
test,3941,95,97280,998,191616,288896
test,3942,140,143360,2167,416064,559424
test,3943,174,178176,3346,642432,820608
test,3944,136,139264,2045,392640,531904
test,3945,140,143360,2167,416064,559424
test,3946,40,40960,177,33984,74944
test,3947,129,132096,1840,353280,485376
test,3948,158,161792,2759,529728,691520
test,3949,114,116736,1437,275904,392640
test,3950,136,139264,2045,392640,531904
test,3951,188,192512,3907,750144,942656
test,3952,120,122880,1592,305664,428544
test,3953,104,106496,1196,229632,336128
test,3954,90,92160,896,172032,264192
test,3955,80,81920,708,135936,217856
test,3956,168,172032,3120,599040,771072
test,3957,224,229376,5546,1064832,1294208
test,3958,93,95232,956,183552,278784
test,3959,133,136192,1955,375360,511552
test,3960,184,188416,3742,718464,906880
test,3961,220,225280,5349,1027008,1252288
test,3962,90,92160,896,172032,264192
test,3963,148,151552,2421,464832,616384
test,3964,161,164864,2865,550080,714944
test,3965,59,60416,385,73920,134336
test,3966,97,99328,1040,199680,299008
test,3967,183,187392,3702,710784,898176
test,3968,124,126976,1700,326400,453376
test,3969,98,100352,1062,203904,304256
test,3970,208,212992,4782,918144,1131136
test,3971,144,147456,2292,440064,587520
test,3972,222,227328,5447,1045824,1273152
test,3973,244,249856,6580,1263360,1513216
test,3974,134,137216,1985,381120,518336
test,3975,96,98304,1019,195648,293952
test,3976,150,153600,2487,477504,631104
test,3977,180,184320,3581,687552,871872
test,3978,126,129024,1755,336960,465984
test,3979,128,131072,1811,347712,478784
test,3980,235,240640,6104,1171968,1412608
test,3981,117,119808,1513,290496,410304
test,3982,150,153600,2487,477504,631104
test,3983,132,135168,1926,369792,504960
test,3984,75,76800,622,119424,196224
test,3985,169,173056,3157,606144,779200
test,3986,232,237568,5949,1142208,1379776
test,3987,128,131072,1811,347712,478784
test,3988,156,159744,2690,516480,676224
test,3989,192,196608,4075,782400,979008
test,3990,112,114688,1387,266304,380992
test,3991,173,177152,3308,635136,812288
test,3992,251,257024,6963,1336896,1593920
test,3993,161,164864,2865,550080,714944
test,3994,111,113664,1362,261504,375168
test,3995,190,194560,3990,766080,960640
test,3996,132,135168,1926,369792,504960
test,3997,91,93184,916,175872,269056
test,3998,132,135168,1926,369792,504960
test,3999,178,182272,3502,672384,854656
test,4000,120,122880,1592,305664,428544
test,4001,188,192512,3907,750144,942656
test,4002,155,158720,2656,509952,668672
test,4003,202,206848,4510,865920,1072768
test,4004,172,176128,3270,627840,803968
test,4005,181,185344,3621,695232,880576
test,4006,90,92160,896,172032,264192
test,4007,188,192512,3907,750144,942656
test,4008,272,278528,8177,1569984,1848512
test,4009,163,166912,2937,563904,730816
test,4010,164,167936,2973,570816,738752
test,4011,179,183296,3541,679872,863168
test,4012,163,166912,2937,563904,730816
test,4013,94,96256,977,187584,283840
test,4014,167,171008,3083,591936,762944
test,4015,166,169984,3046,584832,754816
test,4016,126,129024,1755,336960,465984
test,4017,140,143360,2167,416064,559424
test,4018,140,143360,2167,416064,559424
test,4019,66,67584,482,92544,160128
test,4020,185,189440,3783,726336,915776
test,4021,155,158720,2656,509952,668672
test,4022,123,125952,1672,321024,446976
test,4023,144,147456,2292,440064,587520
test,4024,189,193536,3948,758016,951552
test,4025,108,110592,1289,247488,358080
test,4026,194,198656,4160,798720,997376
test,4027,70,71680,542,104064,175744
test,4028,94,96256,977,187584,283840
test,4029,144,147456,2292,440064,587520
test,4030,177,181248,3463,664896,846144
test,4031,125,128000,1727,331584,459584
test,4032,108,110592,1289,247488,358080
test,4033,218,223232,5253,1008576,1231808
test,4034,71,72704,558,107136,179840
test,4035,122,124928,1645,315840,440768
test,4036,110,112640,1338,256896,369536
test,4037,90,92160,896,172032,264192
test,4038,123,125952,1672,321024,446976
test,4039,160,163840,2830,543360,707200
test,4040,151,154624,2520,483840,638464
test,4041,172,176128,3270,627840,803968
test,4042,76,77824,639,122688,200512
