split,index,nodes,total_values_for_nodes,edges,total_values_for_edges,total_values_for_graph
train,0,22,22528,137,26304,48832
train,1,158,161792,7036,1350912,1512704
train,2,13,13312,48,9216,22528
train,3,59,60416,981,188352,248768
train,4,45,46080,571,109632,155712
train,5,33,33792,307,58944,92736
train,6,278,284672,21782,4182144,4466816
train,7,24,24576,163,31296,55872
train,8,40,40960,451,86592,127552
train,9,178,182272,8930,1714560,1896832
train,10,37,37888,386,74112,112000
train,11,26,26624,191,36672,63296
train,12,38,38912,407,78144,117056
train,13,120,122880,4059,779328,902208
train,14,107,109568,3227,619584,729152
train,15,30,30720,254,48768,79488
train,16,50,51200,705,135360,186560
train,17,68,69632,1303,250176,319808
train,18,159,162816,7125,1368000,1530816
train,19,298,305152,25029,4805568,5110720
train,20,97,99328,2652,509184,608512
train,21,142,145408,5683,1091136,1236544
train,22,148,151552,6174,1185408,1336960
train,23,28,28672,221,42432,71104
train,24,28,28672,221,42432,71104
train,25,20,20480,113,21696,42176
train,26,58,59392,948,182016,241408
train,27,22,22528,137,26304,48832
train,28,47,48128,623,119616,167744
train,29,35,35840,345,66240,102080
train,30,39,39936,429,82368,122304
train,31,193,197632,10499,2015808,2213440
train,32,24,24576,163,31296,55872
train,33,35,35840,345,66240,102080
train,34,105,107520,3108,596736,704256
train,35,54,55296,822,157824,213120
train,36,25,25600,176,33792,59392
train,37,22,22528,137,26304,48832
train,38,47,48128,623,119616,167744
train,39,224,229376,14142,2715264,2944640
train,40,24,24576,163,31296,55872
train,41,28,28672,221,42432,71104
train,42,38,38912,407,78144,117056
train,43,40,40960,451,86592,127552
train,44,27,27648,206,39552,67200
train,45,437,447488,48457,9303744,9751232
train,46,70,71680,1381,265152,336832
train,47,60,61440,1015,194880,256320
train,48,38,38912,407,78144,117056
train,49,23,23552,149,28608,52160
train,50,261,267264,19200,3686400,3953664
train,51,65,66560,1191,228672,295232
train,52,97,99328,2652,509184,608512
train,53,103,105472,2990,574080,679552
train,54,53,54272,792,152064,206336
train,55,172,176128,8338,1600896,1777024
train,56,48,49152,650,124800,173952
train,57,52,53248,762,146304,199552
train,58,31,31744,271,52032,83776
train,59,80,81920,1804,346368,428288
train,60,22,22528,137,26304,48832
train,61,62,63488,1084,208128,271616
train,62,88,90112,2183,419136,509248
train,63,13,13312,48,9216,22528
train,64,51,52224,733,140736,192960
train,65,106,108544,3167,608064,716608
train,66,26,26624,191,36672,63296
train,67,70,71680,1381,265152,336832
train,68,85,87040,2037,391104,478144
train,69,44,45056,546,104832,149888
train,70,49,50176,677,129984,180160
train,71,23,23552,149,28608,52160
train,72,74,75776,1544,296448,372224
train,73,64,65536,1155,221760,287296
train,74,42,43008,497,95424,138432
train,75,20,20480,113,21696,42176
train,76,162,165888,7397,1420224,1586112
train,77,22,22528,137,26304,48832
train,78,45,46080,571,109632,155712
train,79,23,23552,149,28608,52160
train,80,86,88064,2085,400320,488384
train,81,34,34816,326,62592,97408
train,82,71,72704,1421,272832,345536
train,83,60,61440,1015,194880,256320
train,84,51,52224,733,140736,192960
train,85,33,33792,307,58944,92736
train,86,27,27648,206,39552,67200
train,87,170,174080,8145,1563840,1737920
train,88,62,63488,1084,208128,271616
train,89,22,22528,137,26304,48832
train,90,22,22528,137,26304,48832
train,91,11,11264,34,6528,17792
train,92,38,38912,407,78144,117056
train,93,120,122880,4059,779328,902208
train,94,26,26624,191,36672,63296
train,95,12,12288,41,7872,20160
train,96,74,75776,1544,296448,372224
train,97,224,229376,14142,2715264,2944640
train,98,25,25600,176,33792,59392
train,99,24,24576,163,31296,55872
train,100,74,75776,1544,296448,372224
train,101,37,37888,386,74112,112000
train,102,140,143360,5524,1060608,1203968
train,103,52,53248,762,146304,199552
train,104,45,46080,571,109632,155712
train,105,140,143360,5524,1060608,1203968
train,106,36,36864,365,70080,106944
train,107,38,38912,407,78144,117056
train,108,10,10240,28,5376,15616
train,109,26,26624,191,36672,63296
train,110,27,27648,206,39552,67200
train,111,23,23552,149,28608,52160
train,112,73,74752,1502,288384,363136
train,113,23,23552,149,28608,52160
train,114,57,58368,916,175872,234240
train,115,21,21504,125,24000,45504
train,116,84,86016,1989,381888,467904
train,117,128,131072,4618,886656,1017728
train,118,46,47104,597,114624,161728
train,119,51,52224,733,140736,192960
train,120,253,259072,18041,3463872,3722944
train,121,71,72704,1421,272832,345536
train,122,26,26624,191,36672,63296
train,123,22,22528,137,26304,48832
train,124,54,55296,822,157824,213120
train,125,89,91136,2233,428736,519872
train,126,29,29696,237,45504,75200
train,127,65,66560,1191,228672,295232
train,128,117,119808,3858,740736,860544
train,129,21,21504,125,24000,45504
train,130,78,79872,1715,329280,409152
train,131,36,36864,365,70080,106944
train,132,38,38912,407,78144,117056
train,133,43,44032,521,100032,144064
train,134,31,31744,271,52032,83776
train,135,56,57344,884,169728,227072
train,136,150,153600,6342,1217664,1371264
train,137,53,54272,792,152064,206336
train,138,122,124928,4195,805440,930368
train,139,80,81920,1804,346368,428288
train,140,108,110592,3288,631296,741888
train,141,25,25600,176,33792,59392
train,142,48,49152,650,124800,173952
train,143,107,109568,3227,619584,729152
train,144,25,25600,176,33792,59392
train,145,75,76800,1586,304512,381312
train,146,85,87040,2037,391104,478144
train,147,151,154624,6426,1233792,1388416
train,148,16,16384,72,13824,30208
train,149,73,74752,1502,288384,363136
train,150,129,132096,4690,900480,1032576
train,151,110,112640,3411,654912,767552
train,152,21,21504,125,24000,45504
train,153,21,21504,125,24000,45504
train,154,36,36864,365,70080,106944
train,155,59,60416,981,188352,248768
train,156,26,26624,191,36672,63296
train,157,54,55296,822,157824,213120
train,158,77,78848,1671,320832,399680
train,159,106,108544,3167,608064,716608
train,160,37,37888,386,74112,112000
train,161,17,17408,82,15744,33152
train,162,44,45056,546,104832,149888
train,163,30,30720,254,48768,79488
train,164,44,45056,546,104832,149888
train,165,280,286720,22097,4242624,4529344
train,166,35,35840,345,66240,102080
train,167,167,171008,7861,1509312,1680320
train,168,124,126976,4334,832128,959104
train,169,25,25600,176,33792,59392
train,170,33,33792,307,58944,92736
train,171,101,103424,2875,552000,655424
train,172,45,46080,571,109632,155712
train,173,14,14336,55,10560,24896
train,174,29,29696,237,45504,75200
train,175,20,20480,113,21696,42176
train,176,107,109568,3227,619584,729152
train,177,149,152576,6257,1201344,1353920
train,178,39,39936,429,82368,122304
train,179,68,69632,1303,250176,319808
train,180,227,232448,14523,2788416,3020864
train,181,73,74752,1502,288384,363136
train,182,167,171008,7861,1509312,1680320
train,183,210,215040,12429,2386368,2601408
train,184,31,31744,271,52032,83776
train,185,74,75776,1544,296448,372224
train,186,103,105472,2990,574080,679552
train,187,25,25600,176,33792,59392
train,188,158,161792,7036,1350912,1512704
train,189,133,136192,4986,957312,1093504
train,190,30,30720,254,48768,79488
train,191,181,185344,9234,1772928,1958272
train,192,208,212992,12194,2341248,2554240
train,193,23,23552,149,28608,52160
train,194,272,278528,20852,4003584,4282112
train,195,61,62464,1049,201408,263872
train,196,79,80896,1759,337728,418624
train,197,45,46080,571,109632,155712
train,198,123,125952,4264,818688,944640
train,199,85,87040,2037,391104,478144
train,200,57,58368,916,175872,234240
train,201,187,191488,9856,1892352,2083840
train,202,58,59392,948,182016,241408
train,203,85,87040,2037,391104,478144
train,204,34,34816,326,62592,97408
train,205,132,135168,4911,942912,1078080
train,206,36,36864,365,70080,106944
train,207,50,51200,705,135360,186560
train,208,85,87040,2037,391104,478144
train,209,40,40960,451,86592,127552
train,210,21,21504,125,24000,45504
train,211,28,28672,221,42432,71104
train,212,42,43008,497,95424,138432
train,213,22,22528,137,26304,48832
train,214,175,179200,8632,1657344,1836544
train,215,46,47104,597,114624,161728
train,216,19,19456,102,19584,39040
train,217,43,44032,521,100032,144064
train,218,77,78848,1671,320832,399680
train,219,75,76800,1586,304512,381312
train,220,31,31744,271,52032,83776
train,221,48,49152,650,124800,173952
train,222,64,65536,1155,221760,287296
train,223,69,70656,1342,257664,328320
train,224,82,83968,1895,363840,447808
train,225,45,46080,571,109632,155712
train,226,28,28672,221,42432,71104
train,227,17,17408,82,15744,33152
train,228,34,34816,326,62592,97408
train,229,26,26624,191,36672,63296
train,230,60,61440,1015,194880,256320
train,231,29,29696,237,45504,75200
train,232,23,23552,149,28608,52160
train,233,103,105472,2990,574080,679552
train,234,61,62464,1049,201408,263872
train,235,168,172032,7955,1527360,1699392
train,236,53,54272,792,152064,206336
train,237,84,86016,1989,381888,467904
train,238,15,15360,64,12288,27648
train,239,41,41984,474,91008,132992
train,240,27,27648,206,39552,67200
train,241,33,33792,307,58944,92736
train,242,24,24576,163,31296,55872
train,243,344,352256,33352,6403584,6755840
train,244,69,70656,1342,257664,328320
train,245,241,246784,16370,3143040,3389824
train,246,51,52224,733,140736,192960
train,247,90,92160,2283,438336,530496
train,248,90,92160,2283,438336,530496
train,249,44,45056,546,104832,149888
train,250,62,63488,1084,208128,271616
train,251,17,17408,82,15744,33152
train,252,71,72704,1421,272832,345536
train,253,25,25600,176,33792,59392
train,254,195,199680,10717,2057664,2257344
train,255,200,204800,11274,2164608,2369408
train,256,20,20480,113,21696,42176
train,257,61,62464,1049,201408,263872
train,258,24,24576,163,31296,55872
train,259,52,53248,762,146304,199552
train,260,12,12288,41,7872,20160
train,261,22,22528,137,26304,48832
train,262,129,132096,4690,900480,1032576
train,263,21,21504,125,24000,45504
train,264,69,70656,1342,257664,328320
train,265,136,139264,5213,1000896,1140160
train,266,68,69632,1303,250176,319808
train,267,31,31744,271,52032,83776
train,268,122,124928,4195,805440,930368
train,269,60,61440,1015,194880,256320
train,270,157,160768,6947,1333824,1494592
train,271,32,32768,289,55488,88256
train,272,38,38912,407,78144,117056
train,273,40,40960,451,86592,127552
train,274,72,73728,1461,280512,354240
train,275,51,52224,733,140736,192960
train,276,22,22528,137,26304,48832
train,277,166,169984,7767,1491264,1661248
train,278,23,23552,149,28608,52160
train,279,80,81920,1804,346368,428288
train,280,25,25600,176,33792,59392
train,281,38,38912,407,78144,117056
train,282,159,162816,7125,1368000,1530816
train,283,43,44032,521,100032,144064
train,284,64,65536,1155,221760,287296
train,285,49,50176,677,129984,180160
train,286,88,90112,2183,419136,509248
train,287,63,64512,1119,214848,279360
train,288,32,32768,289,55488,88256
train,289,76,77824,1628,312576,390400
train,290,52,53248,762,146304,199552
train,291,155,158720,6771,1300032,1458752
train,292,29,29696,237,45504,75200
train,293,59,60416,981,188352,248768
train,294,163,166912,7488,1437696,1604608
train,295,24,24576,163,31296,55872
train,296,61,62464,1049,201408,263872
train,297,88,90112,2183,419136,509248
train,298,51,52224,733,140736,192960
train,299,10,10240,28,5376,15616
train,300,31,31744,271,52032,83776
train,301,30,30720,254,48768,79488
train,302,151,154624,6426,1233792,1388416
train,303,18,18432,92,17664,36096
train,304,13,13312,48,9216,22528
train,305,46,47104,597,114624,161728
train,306,27,27648,206,39552,67200
train,307,85,87040,2037,391104,478144
train,308,21,21504,125,24000,45504
train,309,86,88064,2085,400320,488384
train,310,62,63488,1084,208128,271616
train,311,173,177152,8435,1619520,1796672
train,312,88,90112,2183,419136,509248
train,313,66,67584,1228,235776,303360
train,314,35,35840,345,66240,102080
train,315,11,11264,34,6528,17792
train,316,25,25600,176,33792,59392
train,317,55,56320,853,163776,220096
train,318,45,46080,571,109632,155712
train,319,79,80896,1759,337728,418624
train,320,23,23552,149,28608,52160
train,321,27,27648,206,39552,67200
train,322,65,66560,1191,228672,295232
train,323,38,38912,407,78144,117056
train,324,128,131072,4618,886656,1017728
train,325,409,418816,47147,9052224,9471040
train,326,19,19456,102,19584,39040
train,327,163,166912,7488,1437696,1604608
train,328,141,144384,5604,1075968,1220352
train,329,231,236544,15040,2887680,3124224
train,330,104,106496,3049,585408,691904
train,331,60,61440,1015,194880,256320
train,332,19,19456,102,19584,39040
train,333,20,20480,113,21696,42176
train,334,45,46080,571,109632,155712
train,335,16,16384,72,13824,30208
train,336,77,78848,1671,320832,399680
train,337,324,331776,29587,5680704,6012480
train,338,144,147456,5844,1122048,1269504
train,339,25,25600,176,33792,59392
train,340,14,14336,55,10560,24896
train,341,59,60416,981,188352,248768
train,342,93,95232,2438,468096,563328
train,343,35,35840,345,66240,102080
train,344,91,93184,2334,448128,541312
train,345,78,79872,1715,329280,409152
train,346,45,46080,571,109632,155712
train,347,84,86016,1989,381888,467904
train,348,24,24576,163,31296,55872
train,349,100,102400,2819,541248,643648
train,350,50,51200,705,135360,186560
train,351,115,117760,3728,715776,833536
train,352,64,65536,1155,221760,287296
train,353,13,13312,48,9216,22528
train,354,66,67584,1228,235776,303360
train,355,66,67584,1228,235776,303360
train,356,15,15360,64,12288,27648
train,357,37,37888,386,74112,112000
train,358,31,31744,271,52032,83776
train,359,62,63488,1084,208128,271616
train,360,77,78848,1671,320832,399680
train,361,35,35840,345,66240,102080
train,362,136,139264,5213,1000896,1140160
train,363,23,23552,149,28608,52160
train,364,12,12288,41,7872,20160
train,365,81,82944,1849,355008,437952
train,366,305,312320,26219,5034048,5346368
train,367,72,73728,1461,280512,354240
train,368,17,17408,82,15744,33152
train,369,13,13312,48,9216,22528
train,370,22,22528,137,26304,48832
train,371,164,167936,7581,1455552,1623488
train,372,41,41984,474,91008,132992
train,373,77,78848,1671,320832,399680
train,374,14,14336,55,10560,24896
train,375,145,148480,5926,1137792,1286272
train,376,33,33792,307,58944,92736
train,377,19,19456,102,19584,39040
train,378,15,15360,64,12288,27648
train,379,22,22528,137,26304,48832
train,380,16,16384,72,13824,30208
train,381,58,59392,948,182016,241408
train,382,31,31744,271,52032,83776
train,383,103,105472,2990,574080,679552
train,384,88,90112,2183,419136,509248
train,385,20,20480,113,21696,42176
train,386,55,56320,853,163776,220096
train,387,39,39936,429,82368,122304
train,388,38,38912,407,78144,117056
train,389,38,38912,407,78144,117056
train,390,7,7168,14,2688,9856
train,391,28,28672,221,42432,71104
train,392,108,110592,3288,631296,741888
train,393,109,111616,3349,643008,754624
train,394,71,72704,1421,272832,345536
train,395,23,23552,149,28608,52160
train,396,56,57344,884,169728,227072
train,397,83,84992,1942,372864,457856
train,398,10,10240,28,5376,15616
train,399,78,79872,1715,329280,409152
train,400,35,35840,345,66240,102080
train,401,12,12288,41,7872,20160
train,402,62,63488,1084,208128,271616
train,403,24,24576,163,31296,55872
train,404,23,23552,149,28608,52160
train,405,99,101376,2763,530496,631872
train,406,137,140288,5290,1015680,1155968
train,407,265,271360,19793,3800256,4071616
train,408,228,233472,14651,2812992,3046464
train,409,74,75776,1544,296448,372224
train,410,77,78848,1671,320832,399680
train,411,52,53248,762,146304,199552
train,412,85,87040,2037,391104,478144
train,413,40,40960,451,86592,127552
train,414,40,40960,451,86592,127552
train,415,108,110592,3288,631296,741888
train,416,132,135168,4911,942912,1078080
train,417,19,19456,102,19584,39040
train,418,22,22528,137,26304,48832
train,419,25,25600,176,33792,59392
train,420,26,26624,191,36672,63296
train,421,114,116736,3663,703296,820032
train,422,27,27648,206,39552,67200
train,423,69,70656,1342,257664,328320
train,424,313,320512,27612,5301504,5622016
train,425,81,82944,1849,355008,437952
train,426,199,203776,11161,2142912,2346688
train,427,75,76800,1586,304512,381312
train,428,93,95232,2438,468096,563328
train,429,39,39936,429,82368,122304
train,430,11,11264,34,6528,17792
train,431,56,57344,884,169728,227072
train,432,22,22528,137,26304,48832
train,433,177,181248,8830,1695360,1876608
train,434,49,50176,677,129984,180160
train,435,126,129024,4475,859200,988224
train,436,57,58368,916,175872,234240
train,437,66,67584,1228,235776,303360
train,438,40,40960,451,86592,127552
train,439,62,63488,1084,208128,271616
train,440,50,51200,705,135360,186560
train,441,27,27648,206,39552,67200
train,442,65,66560,1191,228672,295232
train,443,76,77824,1628,312576,390400
train,444,33,33792,307,58944,92736
train,445,67,68608,1265,242880,311488
train,446,49,50176,677,129984,180160
train,447,48,49152,650,124800,173952
train,448,21,21504,125,24000,45504
train,449,107,109568,3227,619584,729152
train,450,81,82944,1849,355008,437952
train,451,21,21504,125,24000,45504
train,452,22,22528,137,26304,48832
train,453,63,64512,1119,214848,279360
train,454,81,82944,1849,355008,437952
train,455,100,102400,2819,541248,643648
train,456,106,108544,3167,608064,716608
train,457,81,82944,1849,355008,437952
train,458,18,18432,92,17664,36096
train,459,59,60416,981,188352,248768
train,460,80,81920,1804,346368,428288
train,461,37,37888,386,74112,112000
train,462,46,47104,597,114624,161728
train,463,11,11264,34,6528,17792
train,464,24,24576,163,31296,55872
train,465,50,51200,705,135360,186560
train,466,29,29696,237,45504,75200
train,467,12,12288,41,7872,20160
train,468,65,66560,1191,228672,295232
train,469,269,275456,20395,3915840,4191296
train,470,68,69632,1303,250176,319808
train,471,21,21504,125,24000,45504
train,472,226,231424,14396,2764032,2995456
train,473,112,114688,3536,678912,793600
train,474,41,41984,474,91008,132992
train,475,122,124928,4195,805440,930368
train,476,156,159744,6859,1316928,1476672
train,477,30,30720,254,48768,79488
train,478,34,34816,326,62592,97408
train,479,31,31744,271,52032,83776
train,480,188,192512,9962,1912704,2105216
train,481,149,152576,6258,1201536,1354112
train,482,27,27648,206,39552,67200
train,483,89,91136,2233,428736,519872
train,484,67,68608,1265,242880,311488
train,485,123,125952,4264,818688,944640
train,486,81,82944,1849,355008,437952
train,487,45,46080,571,109632,155712
train,488,38,38912,407,78144,117056
train,489,16,16384,72,13824,30208
train,490,225,230400,14268,2739456,2969856
train,491,34,34816,326,62592,97408
train,492,37,37888,386,74112,112000
train,493,91,93184,2334,448128,541312
train,494,44,45056,546,104832,149888
train,495,61,62464,1049,201408,263872
train,496,70,71680,1381,265152,336832
train,497,17,17408,82,15744,33152
train,498,92,94208,2386,458112,552320
train,499,68,69632,1303,250176,319808
train,500,365,373760,37549,7209408,7583168
train,501,80,81920,1804,346368,428288
train,502,39,39936,429,82368,122304
train,503,69,70656,1342,257664,328320
train,504,12,12288,41,7872,20160
train,505,150,153600,6342,1217664,1371264
train,506,81,82944,1849,355008,437952
train,507,36,36864,365,70080,106944
train,508,23,23552,149,28608,52160
train,509,43,44032,521,100032,144064
train,510,55,56320,853,163776,220096
train,511,47,48128,623,119616,167744
train,512,73,74752,1502,288384,363136
train,513,101,103424,2875,552000,655424
train,514,18,18432,92,17664,36096
train,515,24,24576,163,31296,55872
train,516,33,33792,307,58944,92736
train,517,24,24576,163,31296,55872
train,518,44,45056,546,104832,149888
train,519,27,27648,206,39552,67200
train,520,53,54272,792,152064,206336
train,521,34,34816,326,62592,97408
train,522,83,84992,1942,372864,457856
train,523,140,143360,5524,1060608,1203968
train,524,64,65536,1155,221760,287296
train,525,24,24576,163,31296,55872
train,526,22,22528,137,26304,48832
train,527,43,44032,521,100032,144064
train,528,76,77824,1628,312576,390400
train,529,18,18432,92,17664,36096
train,530,44,45056,546,104832,149888
train,531,41,41984,474,91008,132992
train,532,25,25600,176,33792,59392
train,533,12,12288,41,7872,20160
train,534,51,52224,733,140736,192960
train,535,287,293888,23215,4457280,4751168
train,536,96,98304,2598,498816,597120
train,537,67,68608,1265,242880,311488
train,538,46,47104,597,114624,161728
train,539,45,46080,571,109632,155712
train,540,80,81920,1804,346368,428288
train,541,51,52224,733,140736,192960
train,542,303,310272,25876,4968192,5278464
train,543,97,99328,2652,509184,608512
train,544,178,182272,8930,1714560,1896832
train,545,27,27648,206,39552,67200
train,546,45,46080,571,109632,155712
train,547,42,43008,497,95424,138432
train,548,71,72704,1421,272832,345536
train,549,229,234496,14780,2837760,3072256
train,550,31,31744,271,52032,83776
train,551,271,277504,20699,3974208,4251712
train,552,48,49152,650,124800,173952
train,553,126,129024,4475,859200,988224
train,554,64,65536,1155,221760,287296
train,555,113,115712,3599,691008,806720
train,556,76,77824,1628,312576,390400
train,557,119,121856,3991,766272,888128
train,558,51,52224,733,140736,192960
train,559,325,332800,29770,5715840,6048640
train,560,34,34816,326,62592,97408
train,561,36,36864,365,70080,106944
train,562,183,187392,9439,1812288,1999680
train,563,57,58368,916,175872,234240
train,564,48,49152,650,124800,173952
train,565,72,73728,1461,280512,354240
train,566,51,52224,733,140736,192960
train,567,128,131072,4618,886656,1017728
train,568,46,47104,597,114624,161728
train,569,75,76800,1586,304512,381312
train,570,21,21504,125,24000,45504
train,571,21,21504,125,24000,45504
train,572,40,40960,451,86592,127552
train,573,13,13312,48,9216,22528
train,574,65,66560,1191,228672,295232
train,575,35,35840,345,66240,102080
train,576,11,11264,34,6528,17792
train,577,27,27648,206,39552,67200
train,578,33,33792,307,58944,92736
train,579,47,48128,623,119616,167744
train,580,38,38912,407,78144,117056
train,581,31,31744,271,52032,83776
train,582,65,66560,1191,228672,295232
train,583,19,19456,102,19584,39040
train,584,15,15360,64,12288,27648
train,585,70,71680,1381,265152,336832
train,586,31,31744,271,52032,83776
train,587,24,24576,163,31296,55872
train,588,58,59392,948,182016,241408
train,589,129,132096,4690,900480,1032576
train,590,49,50176,677,129984,180160
train,591,48,49152,650,124800,173952
train,592,80,81920,1804,346368,428288
train,593,110,112640,3411,654912,767552
train,594,19,19456,102,19584,39040
train,595,13,13312,48,9216,22528
train,596,59,60416,981,188352,248768
train,597,60,61440,1015,194880,256320
train,598,25,25600,176,33792,59392
train,599,65,66560,1191,228672,295232
train,600,37,37888,386,74112,112000
train,601,18,18432,92,17664,36096
train,602,9,9216,23,4416,13632
train,603,147,150528,6091,1169472,1320000
train,604,190,194560,10175,1953600,2148160
train,605,90,92160,2283,438336,530496
train,606,30,30720,254,48768,79488
train,607,63,64512,1119,214848,279360
train,608,20,20480,113,21696,42176
train,609,106,108544,3167,608064,716608
train,610,27,27648,206,39552,67200
train,611,24,24576,163,31296,55872
train,612,46,47104,597,114624,161728
train,613,38,38912,407,78144,117056
train,614,19,19456,102,19584,39040
train,615,65,66560,1191,228672,295232
train,616,74,75776,1544,296448,372224
train,617,79,80896,1759,337728,418624
train,618,22,22528,137,26304,48832
train,619,51,52224,733,140736,192960
train,620,23,23552,149,28608,52160
train,621,25,25600,176,33792,59392
train,622,49,50176,677,129984,180160
train,623,45,46080,571,109632,155712
train,624,69,70656,1342,257664,328320
train,625,62,63488,1084,208128,271616
train,626,53,54272,792,152064,206336
train,627,23,23552,149,28608,52160
train,628,45,46080,571,109632,155712
train,629,54,55296,822,157824,213120
train,630,46,47104,597,114624,161728
train,631,42,43008,497,95424,138432
train,632,53,54272,792,152064,206336
train,633,39,39936,429,82368,122304
train,634,24,24576,163,31296,55872
train,635,81,82944,1849,355008,437952
train,636,30,30720,254,48768,79488
train,637,96,98304,2598,498816,597120
train,638,84,86016,1989,381888,467904
train,639,26,26624,191,36672,63296
train,640,116,118784,3793,728256,847040
train,641,22,22528,137,26304,48832
train,642,23,23552,149,28608,52160
train,643,25,25600,176,33792,59392
train,644,28,28672,221,42432,71104
train,645,13,13312,48,9216,22528
train,646,258,264192,18761,3602112,3866304
train,647,53,54272,792,152064,206336
train,648,18,18432,92,17664,36096
train,649,52,53248,762,146304,199552
train,650,30,30720,254,48768,79488
train,651,37,37888,386,74112,112000
train,652,23,23552,149,28608,52160
train,653,63,64512,1119,214848,279360
train,654,36,36864,365,70080,106944
train,655,25,25600,176,33792,59392
train,656,20,20480,113,21696,42176
train,657,17,17408,82,15744,33152
train,658,47,48128,623,119616,167744
train,659,73,74752,1502,288384,363136
train,660,28,28672,221,42432,71104
train,661,51,52224,733,140736,192960
train,662,45,46080,571,109632,155712
train,663,24,24576,163,31296,55872
train,664,76,77824,1628,312576,390400
train,665,194,198656,10608,2036736,2235392
train,666,132,135168,4911,942912,1078080
train,667,29,29696,237,45504,75200
train,668,23,23552,149,28608,52160
train,669,69,70656,1342,257664,328320
train,670,27,27648,206,39552,67200
train,671,58,59392,948,182016,241408
train,672,81,82944,1849,355008,437952
train,673,79,80896,1759,337728,418624
train,674,14,14336,55,10560,24896
train,675,55,56320,853,163776,220096
train,676,264,270336,19643,3771456,4041792
train,677,60,61440,1015,194880,256320
train,678,20,20480,113,21696,42176
train,679,25,25600,176,33792,59392
train,680,46,47104,597,114624,161728
train,681,22,22528,137,26304,48832
train,682,46,47104,597,114624,161728
train,683,24,24576,163,31296,55872
train,684,64,65536,1155,221760,287296
train,685,16,16384,72,13824,30208
train,686,30,30720,254,48768,79488
train,687,44,45056,546,104832,149888
train,688,17,17408,82,15744,33152
train,689,227,232448,14523,2788416,3020864
train,690,33,33792,307,58944,92736
train,691,47,48128,623,119616,167744
train,692,49,50176,677,129984,180160
train,693,124,126976,4334,832128,959104
train,694,25,25600,176,33792,59392
train,695,110,112640,3411,654912,767552
train,696,116,118784,3793,728256,847040
train,697,48,49152,650,124800,173952
train,698,20,20480,113,21696,42176
train,699,75,76800,1586,304512,381312
train,700,16,16384,72,13824,30208
train,701,39,39936,429,82368,122304
train,702,35,35840,345,66240,102080
train,703,50,51200,705,135360,186560
train,704,39,39936,429,82368,122304
train,705,204,208896,11729,2251968,2460864
train,706,20,20480,113,21696,42176
train,707,170,174080,8145,1563840,1737920
train,708,81,82944,1849,355008,437952
train,709,12,12288,41,7872,20160
train,710,353,361472,35120,6743040,7104512
train,711,30,30720,254,48768,79488
train,712,291,297984,23867,4582464,4880448
train,713,23,23552,149,28608,52160
train,714,49,50176,677,129984,180160
train,715,62,63488,1084,208128,271616
train,716,13,13312,48,9216,22528
train,717,59,60416,981,188352,248768
train,718,69,70656,1342,257664,328320
train,719,81,82944,1849,355008,437952
train,720,50,51200,705,135360,186560
train,721,27,27648,206,39552,67200
train,722,25,25600,176,33792,59392
train,723,42,43008,497,95424,138432
train,724,41,41984,474,91008,132992
train,725,36,36864,365,70080,106944
train,726,23,23552,149,28608,52160
train,727,141,144384,5604,1075968,1220352
train,728,36,36864,365,70080,106944
train,729,22,22528,137,26304,48832
train,730,62,63488,1084,208128,271616
train,731,64,65536,1155,221760,287296
train,732,226,231424,14396,2764032,2995456
train,733,29,29696,237,45504,75200
train,734,58,59392,948,182016,241408
train,735,23,23552,149,28608,52160
train,736,174,178176,8533,1638336,1816512
train,737,71,72704,1421,272832,345536
train,738,59,60416,981,188352,248768
train,739,128,131072,4618,886656,1017728
train,740,66,67584,1228,235776,303360
train,741,37,37888,386,74112,112000
train,742,60,61440,1015,194880,256320
train,743,78,79872,1715,329280,409152
train,744,54,55296,822,157824,213120
train,745,117,119808,3858,740736,860544
train,746,51,52224,733,140736,192960
train,747,195,199680,10717,2057664,2257344
train,748,31,31744,271,52032,83776
train,749,69,70656,1342,257664,328320
train,750,64,65536,1155,221760,287296
train,751,50,51200,705,135360,186560
train,752,199,203776,11161,2142912,2346688
train,753,42,43008,497,95424,138432
train,754,54,55296,822,157824,213120
train,755,15,15360,64,12288,27648
train,756,32,32768,289,55488,88256
train,757,74,75776,1544,296448,372224
train,758,58,59392,948,182016,241408
train,759,108,110592,3288,631296,741888
train,760,51,52224,733,140736,192960
train,761,142,145408,5683,1091136,1236544
train,762,77,78848,1671,320832,399680
train,763,39,39936,429,82368,122304
train,764,33,33792,307,58944,92736
train,765,19,19456,102,19584,39040
train,766,329,336896,30507,5857344,6194240
train,767,28,28672,221,42432,71104
train,768,51,52224,733,140736,192960
train,769,116,118784,3793,728256,847040
train,770,70,71680,1381,265152,336832
train,771,47,48128,623,119616,167744
train,772,243,248832,16643,3195456,3444288
train,773,150,153600,6342,1217664,1371264
train,774,68,69632,1303,250176,319808
train,775,68,69632,1303,250176,319808
train,776,89,91136,2233,428736,519872
train,777,20,20480,113,21696,42176
train,778,8,8192,18,3456,11648
train,779,11,11264,34,6528,17792
train,780,70,71680,1381,265152,336832
train,781,56,57344,884,169728,227072
train,782,66,67584,1228,235776,303360
train,783,67,68608,1265,242880,311488
train,784,22,22528,137,26304,48832
train,785,28,28672,221,42432,71104
train,786,75,76800,1586,304512,381312
train,787,79,80896,1759,337728,418624
train,788,45,46080,571,109632,155712
train,789,76,77824,1628,312576,390400
train,790,50,51200,705,135360,186560
train,791,141,144384,5604,1075968,1220352
train,792,50,51200,705,135360,186560
train,793,50,51200,705,135360,186560
train,794,120,122880,4059,779328,902208
train,795,58,59392,948,182016,241408
train,796,82,83968,1895,363840,447808
train,797,58,59392,948,182016,241408
train,798,141,144384,5604,1075968,1220352
train,799,47,48128,623,119616,167744
train,800,38,38912,407,78144,117056
train,801,29,29696,237,45504,75200
train,802,58,59392,948,182016,241408
train,803,72,73728,1461,280512,354240
train,804,40,40960,451,86592,127552
train,805,27,27648,206,39552,67200
train,806,23,23552,149,28608,52160
train,807,37,37888,386,74112,112000
train,808,55,56320,853,163776,220096
train,809,33,33792,307,58944,92736
train,810,48,49152,650,124800,173952
train,811,26,26624,191,36672,63296
train,812,10,10240,28,5376,15616
train,813,93,95232,2438,468096,563328
train,814,25,25600,176,33792,59392
train,815,203,207872,11615,2230080,2437952
train,816,45,46080,571,109632,155712
train,817,55,56320,853,163776,220096
train,818,11,11264,34,6528,17792
train,819,42,43008,497,95424,138432
train,820,23,23552,149,28608,52160
train,821,106,108544,3167,608064,716608
train,822,15,15360,64,12288,27648
train,823,50,51200,705,135360,186560
train,824,22,22528,137,26304,48832
train,825,169,173056,8050,1545600,1718656
train,826,19,19456,102,19584,39040
train,827,51,52224,733,140736,192960
train,828,26,26624,191,36672,63296
train,829,24,24576,163,31296,55872
train,830,27,27648,206,39552,67200
train,831,26,26624,191,36672,63296
train,832,41,41984,474,91008,132992
train,833,82,83968,1895,363840,447808
train,834,148,151552,6174,1185408,1336960
train,835,78,79872,1715,329280,409152
train,836,27,27648,206,39552,67200
train,837,32,32768,289,55488,88256
train,838,20,20480,113,21696,42176
train,839,75,76800,1586,304512,381312
train,840,325,332800,29770,5715840,6048640
train,841,90,92160,2283,438336,530496
train,842,51,52224,733,140736,192960
train,843,19,19456,102,19584,39040
train,844,24,24576,163,31296,55872
train,845,321,328704,29041,5575872,5904576
train,846,24,24576,163,31296,55872
train,847,353,361472,35120,6743040,7104512
train,848,40,40960,451,86592,127552
train,849,114,116736,3663,703296,820032
train,850,50,51200,705,135360,186560
train,851,21,21504,125,24000,45504
train,852,29,29696,237,45504,75200
train,853,126,129024,4475,859200,988224
train,854,42,43008,497,95424,138432
train,855,15,15360,64,12288,27648
train,856,48,49152,650,124800,173952
train,857,282,288768,22413,4303296,4592064
train,858,150,153600,6342,1217664,1371264
train,859,29,29696,237,45504,75200
train,860,52,53248,762,146304,199552
train,861,45,46080,571,109632,155712
train,862,28,28672,221,42432,71104
train,863,20,20480,113,21696,42176
train,864,65,66560,1191,228672,295232
train,865,79,80896,1759,337728,418624
train,866,13,13312,48,9216,22528
train,867,35,35840,345,66240,102080
train,868,42,43008,497,95424,138432
train,869,41,41984,474,91008,132992
train,870,63,64512,1119,214848,279360
train,871,123,125952,4264,818688,944640
train,872,20,20480,113,21696,42176
train,873,26,26624,191,36672,63296
train,874,28,28672,221,42432,71104
train,875,28,28672,221,42432,71104
train,876,39,39936,429,82368,122304
train,877,24,24576,163,31296,55872
train,878,38,38912,407,78144,117056
train,879,188,192512,9962,1912704,2105216
train,880,11,11264,34,6528,17792
train,881,127,130048,4546,872832,1002880
train,882,23,23552,149,28608,52160
train,883,22,22528,137,26304,48832
train,884,70,71680,1381,265152,336832
train,885,33,33792,307,58944,92736
train,886,77,78848,1671,320832,399680
train,887,22,22528,137,26304,48832
train,888,85,87040,2037,391104,478144
train,889,48,49152,650,124800,173952
train,890,27,27648,206,39552,67200
train,891,54,55296,822,157824,213120
train,892,49,50176,677,129984,180160
train,893,126,129024,4475,859200,988224
train,894,91,93184,2334,448128,541312
train,895,121,123904,4127,792384,916288
train,896,128,131072,4618,886656,1017728
train,897,35,35840,345,66240,102080
train,898,39,39936,429,82368,122304
train,899,62,63488,1084,208128,271616
train,900,132,135168,4911,942912,1078080
train,901,41,41984,474,91008,132992
train,902,131,134144,4837,928704,1062848
train,903,65,66560,1191,228672,295232
train,904,145,148480,5926,1137792,1286272
train,905,299,306176,25197,4837824,5144000
train,906,81,82944,1849,355008,437952
train,907,191,195584,10282,1974144,2169728
train,908,52,53248,762,146304,199552
train,909,43,44032,521,100032,144064
train,910,138,141312,5368,1030656,1171968
train,911,46,47104,597,114624,161728
train,912,36,36864,365,70080,106944
train,913,28,28672,221,42432,71104
train,914,68,69632,1303,250176,319808
train,915,52,53248,762,146304,199552
train,916,61,62464,1049,201408,263872
train,917,49,50176,677,129984,180160
train,918,161,164864,7306,1402752,1567616
train,919,155,158720,6771,1300032,1458752
train,920,13,13312,48,9216,22528
train,921,30,30720,254,48768,79488
train,922,82,83968,1895,363840,447808
train,923,61,62464,1049,201408,263872
train,924,218,223232,13394,2571648,2794880
train,925,64,65536,1155,221760,287296
train,926,46,47104,597,114624,161728
train,927,23,23552,149,28608,52160
train,928,268,274432,20243,3886656,4161088
train,929,50,51200,705,135360,186560
train,930,26,26624,191,36672,63296
train,931,49,50176,677,129984,180160
train,932,135,138240,5137,986304,1124544
train,933,59,60416,981,188352,248768
train,934,72,73728,1461,280512,354240
train,935,69,70656,1342,257664,328320
train,936,68,69632,1303,250176,319808
train,937,11,11264,34,6528,17792
train,938,23,23552,149,28608,52160
train,939,39,39936,429,82368,122304
train,940,21,21504,125,24000,45504
train,941,24,24576,163,31296,55872
train,942,79,80896,1759,337728,418624
train,943,28,28672,221,42432,71104
train,944,186,190464,9751,1872192,2062656
train,945,100,102400,2819,541248,643648
train,946,28,28672,221,42432,71104
train,947,15,15360,64,12288,27648
train,948,112,114688,3536,678912,793600
train,949,69,70656,1342,257664,328320
train,950,53,54272,792,152064,206336
train,951,46,47104,597,114624,161728
train,952,14,14336,55,10560,24896
train,953,54,55296,822,157824,213120
train,954,25,25600,176,33792,59392
train,955,20,20480,113,21696,42176
train,956,39,39936,429,82368,122304
train,957,18,18432,92,17664,36096
train,958,79,80896,1759,337728,418624
train,959,23,23552,149,28608,52160
train,960,74,75776,1544,296448,372224
train,961,63,64512,1119,214848,279360
train,962,23,23552,149,28608,52160
train,963,28,28672,221,42432,71104
train,964,97,99328,2652,509184,608512
train,965,73,74752,1502,288384,363136
train,966,61,62464,1049,201408,263872
train,967,17,17408,82,15744,33152
train,968,25,25600,176,33792,59392
train,969,26,26624,191,36672,63296
train,970,156,159744,6859,1316928,1476672
train,971,17,17408,82,15744,33152
train,972,27,27648,206,39552,67200
train,973,63,64512,1119,214848,279360
train,974,21,21504,125,24000,45504
train,975,56,57344,884,169728,227072
train,976,60,61440,1015,194880,256320
train,977,11,11264,34,6528,17792
train,978,74,75776,1544,296448,372224
train,979,42,43008,497,95424,138432
train,980,17,17408,82,15744,33152
train,981,38,38912,407,78144,117056
train,982,22,22528,137,26304,48832
train,983,17,17408,82,15744,33152
train,984,23,23552,149,28608,52160
train,985,146,149504,6008,1153536,1303040
train,986,49,50176,677,129984,180160
train,987,163,166912,7488,1437696,1604608
train,988,98,100352,2707,519744,620096
train,989,145,148480,5926,1137792,1286272
train,990,25,25600,176,33792,59392
train,991,40,40960,451,86592,127552
train,992,52,53248,762,146304,199552
train,993,52,53248,762,146304,199552
train,994,114,116736,3663,703296,820032
train,995,22,22528,137,26304,48832
train,996,28,28672,221,42432,71104
train,997,13,13312,48,9216,22528
train,998,22,22528,137,26304,48832
train,999,23,23552,149,28608,52160
train,1000,44,45056,546,104832,149888
train,1001,82,83968,1895,363840,447808
train,1002,74,75776,1544,296448,372224
train,1003,122,124928,4195,805440,930368
train,1004,82,83968,1895,363840,447808
train,1005,55,56320,853,163776,220096
train,1006,109,111616,3349,643008,754624
train,1007,53,54272,792,152064,206336
train,1008,16,16384,72,13824,30208
train,1009,79,80896,1759,337728,418624
train,1010,41,41984,474,91008,132992
train,1011,205,209920,11845,2274240,2484160
train,1012,277,283648,21626,4152192,4435840
train,1013,71,72704,1421,272832,345536
train,1014,69,70656,1342,257664,328320
train,1015,23,23552,149,28608,52160
train,1016,41,41984,474,91008,132992
train,1017,91,93184,2334,448128,541312
train,1018,13,13312,48,9216,22528
train,1019,28,28672,221,42432,71104
train,1020,109,111616,3349,643008,754624
train,1021,308,315392,26737,5133504,5448896
train,1022,15,15360,64,12288,27648
train,1023,190,194560,10175,1953600,2148160
train,1024,10,10240,28,5376,15616
train,1025,25,25600,176,33792,59392
train,1026,81,82944,1849,355008,437952
train,1027,51,52224,733,140736,192960
train,1028,48,49152,650,124800,173952
train,1029,66,67584,1228,235776,303360
train,1030,39,39936,429,82368,122304
train,1031,23,23552,149,28608,52160
train,1032,104,106496,3049,585408,691904
train,1033,23,23552,149,28608,52160
train,1034,59,60416,981,188352,248768
train,1035,35,35840,345,66240,102080
train,1036,74,75776,1544,296448,372224
train,1037,27,27648,206,39552,67200
train,1038,129,132096,4690,900480,1032576
train,1039,66,67584,1228,235776,303360
train,1040,16,16384,72,13824,30208
train,1041,19,19456,102,19584,39040
train,1042,54,55296,822,157824,213120
train,1043,26,26624,191,36672,63296
train,1044,60,61440,1015,194880,256320
train,1045,90,92160,2283,438336,530496
train,1046,27,27648,206,39552,67200
train,1047,76,77824,1628,312576,390400
train,1048,67,68608,1265,242880,311488
train,1049,25,25600,176,33792,59392
train,1050,76,77824,1628,312576,390400
train,1051,115,117760,3728,715776,833536
train,1052,68,69632,1303,250176,319808
train,1053,64,65536,1155,221760,287296
train,1054,31,31744,271,52032,83776
train,1055,51,52224,733,140736,192960
train,1056,69,70656,1342,257664,328320
train,1057,59,60416,981,188352,248768
train,1058,80,81920,1804,346368,428288
train,1059,24,24576,163,31296,55872
train,1060,24,24576,163,31296,55872
train,1061,61,62464,1049,201408,263872
train,1062,46,47104,597,114624,161728
train,1063,85,87040,2037,391104,478144
train,1064,145,148480,5926,1137792,1286272
train,1065,23,23552,149,28608,52160
train,1066,23,23552,149,28608,52160
train,1067,270,276480,20546,3944832,4221312
train,1068,99,101376,2763,530496,631872
train,1069,44,45056,546,104832,149888
train,1070,30,30720,254,48768,79488
train,1071,23,23552,149,28608,52160
train,1072,123,125952,4264,818688,944640
train,1073,51,52224,733,140736,192960
train,1074,87,89088,2133,409536,498624
train,1075,149,152576,6257,1201344,1353920
train,1076,11,11264,34,6528,17792
train,1077,31,31744,271,52032,83776
train,1078,19,19456,102,19584,39040
train,1079,11,11264,34,6528,17792
train,1080,21,21504,125,24000,45504
train,1081,18,18432,92,17664,36096
train,1082,44,45056,546,104832,149888
train,1083,58,59392,948,182016,241408
train,1084,210,215040,12429,2386368,2601408
train,1085,39,39936,429,82368,122304
train,1086,159,162816,7125,1368000,1530816
train,1087,36,36864,365,70080,106944
train,1088,23,23552,149,28608,52160
train,1089,144,147456,5845,1122240,1269696
train,1090,43,44032,521,100032,144064
train,1091,21,21504,125,24000,45504
train,1092,75,76800,1586,304512,381312
train,1093,23,23552,149,28608,52160
train,1094,46,47104,597,114624,161728
train,1095,132,135168,4911,942912,1078080
train,1096,17,17408,82,15744,33152
train,1097,39,39936,429,82368,122304
train,1098,21,21504,125,24000,45504
train,1099,22,22528,137,26304,48832
train,1100,26,26624,191,36672,63296
train,1101,34,34816,326,62592,97408
train,1102,20,20480,113,21696,42176
train,1103,15,15360,64,12288,27648
train,1104,82,83968,1895,363840,447808
train,1105,25,25600,176,33792,59392
train,1106,105,107520,3108,596736,704256
train,1107,38,38912,407,78144,117056
train,1108,84,86016,1989,381888,467904
train,1109,44,45056,546,104832,149888
train,1110,20,20480,113,21696,42176
train,1111,24,24576,163,31296,55872
train,1112,62,63488,1084,208128,271616
train,1113,41,41984,474,91008,132992
train,1114,20,20480,113,21696,42176
train,1115,134,137216,5061,971712,1108928
train,1116,363,371712,37138,7130496,7502208
train,1117,17,17408,82,15744,33152
train,1118,68,69632,1303,250176,319808
train,1119,58,59392,948,182016,241408
train,1120,51,52224,733,140736,192960
train,1121,37,37888,386,74112,112000
train,1122,130,133120,4763,914496,1047616
train,1123,29,29696,237,45504,75200
train,1124,267,273408,20092,3857664,4131072
train,1125,46,47104,597,114624,161728
train,1126,22,22528,137,26304,48832
train,1127,38,38912,407,78144,117056
train,1128,76,77824,1628,312576,390400
train,1129,81,82944,1849,355008,437952
train,1130,151,154624,6426,1233792,1388416
train,1131,22,22528,137,26304,48832
train,1132,32,32768,289,55488,88256
train,1133,14,14336,55,10560,24896
train,1134,47,48128,623,119616,167744
train,1135,25,25600,176,33792,59392
train,1136,66,67584,1228,235776,303360
train,1137,22,22528,137,26304,48832
train,1138,24,24576,163,31296,55872
train,1139,17,17408,82,15744,33152
train,1140,25,25600,176,33792,59392
train,1141,30,30720,254,48768,79488
train,1142,253,259072,18041,3463872,3722944
train,1143,9,9216,23,4416,13632
train,1144,153,156672,6598,1266816,1423488
train,1145,99,101376,2763,530496,631872
train,1146,115,117760,3728,715776,833536
train,1147,73,74752,1502,288384,363136
train,1148,53,54272,792,152064,206336
train,1149,39,39936,429,82368,122304
train,1150,20,20480,113,21696,42176
train,1151,74,75776,1544,296448,372224
train,1152,62,63488,1084,208128,271616
train,1153,153,156672,6598,1266816,1423488
train,1154,73,74752,1502,288384,363136
train,1155,74,75776,1544,296448,372224
train,1156,54,55296,822,157824,213120
train,1157,19,19456,102,19584,39040
train,1158,49,50176,677,129984,180160
train,1159,71,72704,1421,272832,345536
train,1160,60,61440,1015,194880,256320
train,1161,23,23552,149,28608,52160
train,1162,170,174080,8145,1563840,1737920
train,1163,24,24576,163,31296,55872
train,1164,51,52224,733,140736,192960
train,1165,70,71680,1381,265152,336832
train,1166,66,67584,1228,235776,303360
train,1167,22,22528,137,26304,48832
train,1168,24,24576,163,31296,55872
train,1169,27,27648,206,39552,67200
train,1170,34,34816,326,62592,97408
train,1171,96,98304,2598,498816,597120
train,1172,58,59392,948,182016,241408
train,1173,96,98304,2598,498816,597120
train,1174,34,34816,326,62592,97408
train,1175,67,68608,1265,242880,311488
train,1176,31,31744,271,52032,83776
train,1177,54,55296,822,157824,213120
train,1178,74,75776,1544,296448,372224
train,1179,26,26624,191,36672,63296
train,1180,350,358400,34526,6628992,6987392
train,1181,19,19456,102,19584,39040
train,1182,43,44032,521,100032,144064
train,1183,21,21504,125,24000,45504
train,1184,173,177152,8435,1619520,1796672
train,1185,51,52224,733,140736,192960
train,1186,55,56320,853,163776,220096
train,1187,19,19456,102,19584,39040
train,1188,25,25600,176,33792,59392
train,1189,175,179200,8632,1657344,1836544
train,1190,177,181248,8830,1695360,1876608
train,1191,87,89088,2133,409536,498624
train,1192,12,12288,41,7872,20160
train,1193,70,71680,1381,265152,336832
train,1194,54,55296,822,157824,213120
train,1195,11,11264,34,6528,17792
train,1196,115,117760,3728,715776,833536
train,1197,18,18432,92,17664,36096
train,1198,21,21504,125,24000,45504
train,1199,73,74752,1502,288384,363136
train,1200,39,39936,429,82368,122304
train,1201,45,46080,571,109632,155712
train,1202,60,61440,1015,194880,256320
train,1203,81,82944,1849,355008,437952
train,1204,57,58368,916,175872,234240
train,1205,198,202752,11050,2121600,2324352
train,1206,279,285696,21939,4212288,4497984
train,1207,38,38912,407,78144,117056
train,1208,249,254976,17475,3355200,3610176
train,1209,59,60416,981,188352,248768
train,1210,75,76800,1586,304512,381312
train,1211,29,29696,237,45504,75200
train,1212,48,49152,650,124800,173952
train,1213,71,72704,1421,272832,345536
train,1214,91,93184,2334,448128,541312
train,1215,12,12288,41,7872,20160
train,1216,165,168960,7673,1473216,1642176
train,1217,23,23552,149,28608,52160
train,1218,14,14336,55,10560,24896
train,1219,14,14336,55,10560,24896
train,1220,68,69632,1303,250176,319808
train,1221,64,65536,1155,221760,287296
train,1222,124,126976,4334,832128,959104
train,1223,141,144384,5604,1075968,1220352
train,1224,142,145408,5683,1091136,1236544
train,1225,24,24576,163,31296,55872
train,1226,39,39936,429,82368,122304
train,1227,140,143360,5524,1060608,1203968
train,1228,75,76800,1586,304512,381312
train,1229,159,162816,7125,1368000,1530816
train,1230,29,29696,237,45504,75200
train,1231,146,149504,6008,1153536,1303040
train,1232,127,130048,4546,872832,1002880
train,1233,13,13312,48,9216,22528
train,1234,25,25600,176,33792,59392
train,1235,60,61440,1015,194880,256320
train,1236,74,75776,1544,296448,372224
train,1237,15,15360,64,12288,27648
train,1238,73,74752,1502,288384,363136
train,1239,24,24576,163,31296,55872
train,1240,174,178176,8533,1638336,1816512
train,1241,67,68608,1265,242880,311488
train,1242,34,34816,326,62592,97408
train,1243,59,60416,981,188352,248768
train,1244,48,49152,650,124800,173952
train,1245,152,155648,6512,1250304,1405952
train,1246,67,68608,1265,242880,311488
train,1247,60,61440,1015,194880,256320
train,1248,368,376832,38168,7328256,7705088
train,1249,91,93184,2334,448128,541312
train,1250,93,95232,2438,468096,563328
train,1251,25,25600,176,33792,59392
train,1252,58,59392,948,182016,241408
train,1253,88,90112,2183,419136,509248
train,1254,24,24576,163,31296,55872
train,1255,32,32768,289,55488,88256
train,1256,94,96256,2491,478272,574528
train,1257,21,21504,125,24000,45504
train,1258,40,40960,451,86592,127552
train,1259,105,107520,3108,596736,704256
train,1260,22,22528,137,26304,48832
train,1261,41,41984,474,91008,132992
train,1262,128,131072,4618,886656,1017728
train,1263,30,30720,254,48768,79488
train,1264,24,24576,163,31296,55872
train,1265,80,81920,1804,346368,428288
train,1266,39,39936,429,82368,122304
train,1267,26,26624,191,36672,63296
train,1268,35,35840,345,66240,102080
train,1269,25,25600,176,33792,59392
train,1270,51,52224,733,140736,192960
train,1271,115,117760,3728,715776,833536
train,1272,39,39936,429,82368,122304
train,1273,89,91136,2233,428736,519872
train,1274,61,62464,1049,201408,263872
train,1275,68,69632,1303,250176,319808
train,1276,20,20480,113,21696,42176
train,1277,126,129024,4475,859200,988224
train,1278,166,169984,7767,1491264,1661248
train,1279,35,35840,345,66240,102080
train,1280,78,79872,1715,329280,409152
train,1281,24,24576,163,31296,55872
train,1282,17,17408,82,15744,33152
train,1283,69,70656,1342,257664,328320
train,1284,29,29696,237,45504,75200
train,1285,120,122880,4059,779328,902208
train,1286,37,37888,386,74112,112000
train,1287,65,66560,1191,228672,295232
train,1288,211,216064,12548,2409216,2625280
train,1289,149,152576,6257,1201344,1353920
train,1290,34,34816,326,62592,97408
train,1291,30,30720,254,48768,79488
train,1292,25,25600,176,33792,59392
train,1293,51,52224,733,140736,192960
train,1294,38,38912,407,78144,117056
train,1295,26,26624,191,36672,63296
train,1296,84,86016,1989,381888,467904
train,1297,25,25600,176,33792,59392
train,1298,26,26624,191,36672,63296
train,1299,13,13312,48,9216,22528
train,1300,31,31744,271,52032,83776
train,1301,93,95232,2438,468096,563328
train,1302,26,26624,191,36672,63296
train,1303,15,15360,64,12288,27648
train,1304,23,23552,149,28608,52160
train,1305,229,234496,14780,2837760,3072256
train,1306,43,44032,521,100032,144064
train,1307,167,171008,7861,1509312,1680320
train,1308,40,40960,451,86592,127552
train,1309,24,24576,163,31296,55872
train,1310,26,26624,191,36672,63296
train,1311,23,23552,149,28608,52160
train,1312,389,398336,42649,8188608,8586944
train,1313,118,120832,3925,753600,874432
train,1314,21,21504,125,24000,45504
train,1315,45,46080,571,109632,155712
train,1316,47,48128,623,119616,167744
train,1317,20,20480,113,21696,42176
train,1318,76,77824,1628,312576,390400
train,1319,80,81920,1804,346368,428288
train,1320,135,138240,5137,986304,1124544
train,1321,40,40960,451,86592,127552
train,1322,26,26624,191,36672,63296
train,1323,14,14336,55,10560,24896
train,1324,71,72704,1421,272832,345536
train,1325,36,36864,365,70080,106944
train,1326,73,74752,1502,288384,363136
train,1327,70,71680,1381,265152,336832
train,1328,26,26624,191,36672,63296
train,1329,225,230400,14268,2739456,2969856
train,1330,134,137216,5061,971712,1108928
train,1331,37,37888,386,74112,112000
train,1332,155,158720,6771,1300032,1458752
train,1333,11,11264,34,6528,17792
train,1334,107,109568,3227,619584,729152
train,1335,74,75776,1544,296448,372224
train,1336,11,11264,34,6528,17792
train,1337,82,83968,1895,363840,447808
train,1338,31,31744,271,52032,83776
train,1339,51,52224,733,140736,192960
train,1340,51,52224,733,140736,192960
train,1341,54,55296,822,157824,213120
train,1342,98,100352,2707,519744,620096
train,1343,21,21504,125,24000,45504
train,1344,53,54272,792,152064,206336
train,1345,42,43008,497,95424,138432
train,1346,41,41984,474,91008,132992
train,1347,58,59392,948,182016,241408
train,1348,27,27648,206,39552,67200
train,1349,183,187392,9439,1812288,1999680
train,1350,105,107520,3108,596736,704256
train,1351,187,191488,9856,1892352,2083840
train,1352,51,52224,733,140736,192960
train,1353,32,32768,289,55488,88256
train,1354,22,22528,137,26304,48832
train,1355,56,57344,884,169728,227072
train,1356,31,31744,271,52032,83776
train,1357,116,118784,3793,728256,847040
train,1358,35,35840,345,66240,102080
train,1359,109,111616,3349,643008,754624
train,1360,30,30720,254,48768,79488
train,1361,85,87040,2037,391104,478144
train,1362,52,53248,762,146304,199552
train,1363,59,60416,981,188352,248768
train,1364,125,128000,4404,845568,973568
train,1365,30,30720,254,48768,79488
train,1366,79,80896,1759,337728,418624
train,1367,46,47104,597,114624,161728
train,1368,188,192512,9962,1912704,2105216
train,1369,33,33792,307,58944,92736
train,1370,29,29696,237,45504,75200
train,1371,263,269312,19495,3743040,4012352
train,1372,162,165888,7397,1420224,1586112
train,1373,43,44032,521,100032,144064
train,1374,26,26624,191,36672,63296
train,1375,79,80896,1759,337728,418624
train,1376,72,73728,1461,280512,354240
train,1377,70,71680,1381,265152,336832
train,1378,57,58368,916,175872,234240
train,1379,35,35840,345,66240,102080
train,1380,48,49152,650,124800,173952
train,1381,22,22528,137,26304,48832
train,1382,29,29696,237,45504,75200
train,1383,60,61440,1015,194880,256320
train,1384,11,11264,34,6528,17792
train,1385,235,240640,15565,2988480,3229120
train,1386,66,67584,1228,235776,303360
train,1387,54,55296,822,157824,213120
train,1388,24,24576,163,31296,55872
train,1389,160,163840,7215,1385280,1549120
train,1390,21,21504,125,24000,45504
train,1391,75,76800,1586,304512,381312
train,1392,70,71680,1381,265152,336832
train,1393,84,86016,1989,381888,467904
train,1394,45,46080,571,109632,155712
train,1395,302,309248,25705,4935360,5244608
train,1396,22,22528,137,26304,48832
train,1397,168,172032,7955,1527360,1699392
train,1398,18,18432,92,17664,36096
train,1399,113,115712,3599,691008,806720
train,1400,57,58368,916,175872,234240
train,1401,28,28672,221,42432,71104
train,1402,160,163840,7215,1385280,1549120
train,1403,24,24576,163,31296,55872
train,1404,14,14336,55,10560,24896
train,1405,87,89088,2133,409536,498624
train,1406,52,53248,762,146304,199552
train,1407,32,32768,289,55488,88256
train,1408,31,31744,271,52032,83776
train,1409,146,149504,6008,1153536,1303040
train,1410,34,34816,326,62592,97408
train,1411,69,70656,1342,257664,328320
train,1412,161,164864,7306,1402752,1567616
train,1413,28,28672,221,42432,71104
train,1414,386,395264,41994,8062848,8458112
train,1415,54,55296,822,157824,213120
train,1416,117,119808,3858,740736,860544
train,1417,389,398336,42649,8188608,8586944
train,1418,24,24576,163,31296,55872
train,1419,62,63488,1084,208128,271616
train,1420,31,31744,271,52032,83776
train,1421,29,29696,237,45504,75200
train,1422,88,90112,2183,419136,509248
train,1423,43,44032,521,100032,144064
train,1424,30,30720,254,48768,79488
train,1425,71,72704,1421,272832,345536
train,1426,124,126976,4334,832128,959104
train,1427,41,41984,474,91008,132992
train,1428,119,121856,3991,766272,888128
train,1429,33,33792,307,58944,92736
train,1430,24,24576,163,31296,55872
train,1431,53,54272,792,152064,206336
train,1432,75,76800,1586,304512,381312
train,1433,69,70656,1342,257664,328320
train,1434,39,39936,429,82368,122304
train,1435,74,75776,1544,296448,372224
train,1436,85,87040,2037,391104,478144
train,1437,41,41984,474,91008,132992
train,1438,22,22528,137,26304,48832
train,1439,44,45056,546,104832,149888
train,1440,342,350208,32966,6329472,6679680
train,1441,55,56320,853,163776,220096
train,1442,166,169984,7767,1491264,1661248
train,1443,15,15360,64,12288,27648
train,1444,37,37888,386,74112,112000
train,1445,22,22528,137,26304,48832
train,1446,69,70656,1342,257664,328320
train,1447,68,69632,1303,250176,319808
train,1448,26,26624,191,36672,63296
train,1449,210,215040,12429,2386368,2601408
train,1450,90,92160,2283,438336,530496
train,1451,90,92160,2283,438336,530496
train,1452,71,72704,1421,272832,345536
train,1453,43,44032,521,100032,144064
train,1454,26,26624,191,36672,63296
train,1455,61,62464,1049,201408,263872
train,1456,59,60416,981,188352,248768
train,1457,22,22528,137,26304,48832
train,1458,106,108544,3167,608064,716608
train,1459,36,36864,365,70080,106944
train,1460,33,33792,307,58944,92736
train,1461,86,88064,2085,400320,488384
train,1462,37,37888,386,74112,112000
train,1463,44,45056,546,104832,149888
train,1464,80,81920,1804,346368,428288
train,1465,21,21504,125,24000,45504
train,1466,45,46080,571,109632,155712
train,1467,33,33792,307,58944,92736
train,1468,151,154624,6426,1233792,1388416
train,1469,59,60416,981,188352,248768
train,1470,47,48128,623,119616,167744
train,1471,46,47104,597,114624,161728
train,1472,76,77824,1628,312576,390400
train,1473,117,119808,3858,740736,860544
train,1474,40,40960,451,86592,127552
train,1475,261,267264,19200,3686400,3953664
train,1476,27,27648,206,39552,67200
train,1477,90,92160,2283,438336,530496
train,1478,27,27648,206,39552,67200
train,1479,157,160768,6947,1333824,1494592
train,1480,36,36864,365,70080,106944
train,1481,19,19456,102,19584,39040
train,1482,116,118784,3793,728256,847040
train,1483,10,10240,28,5376,15616
train,1484,268,274432,20243,3886656,4161088
train,1485,137,140288,5290,1015680,1155968
train,1486,8,8192,18,3456,11648
train,1487,15,15360,64,12288,27648
train,1488,34,34816,326,62592,97408
train,1489,56,57344,884,169728,227072
train,1490,39,39936,429,82368,122304
train,1491,36,36864,365,70080,106944
train,1492,81,82944,1849,355008,437952
train,1493,45,46080,571,109632,155712
train,1494,47,48128,623,119616,167744
train,1495,54,55296,822,157824,213120
train,1496,32,32768,289,55488,88256
train,1497,252,258048,17898,3436416,3694464
train,1498,61,62464,1049,201408,263872
train,1499,28,28672,221,42432,71104
train,1500,71,72704,1421,272832,345536
train,1501,18,18432,92,17664,36096
train,1502,32,32768,289,55488,88256
train,1503,43,44032,521,100032,144064
train,1504,108,110592,3288,631296,741888
train,1505,46,47104,597,114624,161728
train,1506,65,66560,1191,228672,295232
train,1507,163,166912,7488,1437696,1604608
train,1508,25,25600,176,33792,59392
train,1509,65,66560,1191,228672,295232
train,1510,315,322560,27966,5369472,5692032
train,1511,144,147456,5844,1122048,1269504
train,1512,72,73728,1461,280512,354240
train,1513,56,57344,884,169728,227072
train,1514,23,23552,149,28608,52160
train,1515,65,66560,1191,228672,295232
train,1516,40,40960,451,86592,127552
train,1517,66,67584,1228,235776,303360
train,1518,248,253952,17335,3328320,3582272
train,1519,314,321536,27789,5335488,5657024
train,1520,23,23552,149,28608,52160
train,1521,123,125952,4264,818688,944640
train,1522,254,260096,18184,3491328,3751424
train,1523,31,31744,271,52032,83776
train,1524,104,106496,3049,585408,691904
train,1525,143,146432,5764,1106688,1253120
train,1526,25,25600,176,33792,59392
train,1527,29,29696,237,45504,75200
train,1528,68,69632,1303,250176,319808
train,1529,71,72704,1421,272832,345536
train,1530,101,103424,2875,552000,655424
train,1531,178,182272,8930,1714560,1896832
train,1532,83,84992,1942,372864,457856
train,1533,32,32768,289,55488,88256
train,1534,71,72704,1421,272832,345536
train,1535,36,36864,365,70080,106944
train,1536,40,40960,451,86592,127552
train,1537,144,147456,5844,1122048,1269504
train,1538,20,20480,113,21696,42176
train,1539,97,99328,2652,509184,608512
train,1540,20,20480,113,21696,42176
train,1541,26,26624,191,36672,63296
train,1542,12,12288,41,7872,20160
train,1543,27,27648,206,39552,67200
train,1544,134,137216,5061,971712,1108928
train,1545,97,99328,2652,509184,608512
train,1546,24,24576,163,31296,55872
train,1547,74,75776,1544,296448,372224
train,1548,28,28672,221,42432,71104
train,1549,76,77824,1628,312576,390400
train,1550,13,13312,48,9216,22528
train,1551,72,73728,1461,280512,354240
train,1552,34,34816,326,62592,97408
train,1553,36,36864,365,70080,106944
train,1554,71,72704,1421,272832,345536
train,1555,239,244736,16099,3091008,3335744
train,1556,33,33792,307,58944,92736
train,1557,43,44032,521,100032,144064
train,1558,38,38912,407,78144,117056
train,1559,66,67584,1228,235776,303360
train,1560,61,62464,1049,201408,263872
train,1561,71,72704,1421,272832,345536
train,1562,22,22528,137,26304,48832
train,1563,243,248832,16643,3195456,3444288
train,1564,11,11264,34,6528,17792
train,1565,70,71680,1381,265152,336832
train,1566,170,174080,8145,1563840,1737920
train,1567,105,107520,3108,596736,704256
train,1568,17,17408,82,15744,33152
train,1569,50,51200,705,135360,186560
train,1570,28,28672,221,42432,71104
train,1571,14,14336,55,10560,24896
train,1572,113,115712,3599,691008,806720
train,1573,23,23552,149,28608,52160
train,1574,82,83968,1895,363840,447808
train,1575,98,100352,2707,519744,620096
train,1576,39,39936,429,82368,122304
train,1577,178,182272,8930,1714560,1896832
train,1578,156,159744,6859,1316928,1476672
train,1579,74,75776,1544,296448,372224
train,1580,69,70656,1342,257664,328320
train,1581,131,134144,4837,928704,1062848
train,1582,14,14336,55,10560,24896
train,1583,78,79872,1715,329280,409152
train,1584,38,38912,407,78144,117056
train,1585,42,43008,497,95424,138432
train,1586,64,65536,1155,221760,287296
train,1587,119,121856,3991,766272,888128
train,1588,76,77824,1628,312576,390400
train,1589,53,54272,792,152064,206336
train,1590,30,30720,254,48768,79488
train,1591,158,161792,7036,1350912,1512704
train,1592,75,76800,1586,304512,381312
train,1593,101,103424,2875,552000,655424
train,1594,12,12288,41,7872,20160
train,1595,108,110592,3288,631296,741888
train,1596,40,40960,451,86592,127552
train,1597,36,36864,365,70080,106944
train,1598,47,48128,623,119616,167744
train,1599,90,92160,2283,438336,530496
train,1600,75,76800,1586,304512,381312
train,1601,183,187392,9439,1812288,1999680
train,1602,103,105472,2990,574080,679552
train,1603,64,65536,1155,221760,287296
train,1604,21,21504,125,24000,45504
train,1605,55,56320,853,163776,220096
train,1606,172,176128,8338,1600896,1777024
train,1607,26,26624,191,36672,63296
train,1608,25,25600,176,33792,59392
train,1609,60,61440,1015,194880,256320
train,1610,48,49152,650,124800,173952
train,1611,158,161792,7036,1350912,1512704
train,1612,53,54272,792,152064,206336
train,1613,32,32768,289,55488,88256
train,1614,68,69632,1303,250176,319808
train,1615,37,37888,386,74112,112000
train,1616,28,28672,221,42432,71104
train,1617,16,16384,72,13824,30208
train,1618,20,20480,113,21696,42176
train,1619,22,22528,137,26304,48832
train,1620,75,76800,1586,304512,381312
train,1621,168,172032,7955,1527360,1699392
train,1622,25,25600,176,33792,59392
train,1623,181,185344,9234,1772928,1958272
train,1624,16,16384,72,13824,30208
train,1625,54,55296,822,157824,213120
train,1626,47,48128,623,119616,167744
train,1627,24,24576,163,31296,55872
train,1628,145,148480,5926,1137792,1286272
train,1629,67,68608,1265,242880,311488
train,1630,13,13312,48,9216,22528
train,1631,95,97280,2544,488448,585728
train,1632,43,44032,521,100032,144064
train,1633,110,112640,3411,654912,767552
train,1634,40,40960,451,86592,127552
train,1635,54,55296,822,157824,213120
train,1636,34,34816,326,62592,97408
train,1637,88,90112,2183,419136,509248
train,1638,20,20480,113,21696,42176
train,1639,104,106496,3049,585408,691904
train,1640,69,70656,1342,257664,328320
train,1641,56,57344,884,169728,227072
train,1642,76,77824,1628,312576,390400
train,1643,47,48128,623,119616,167744
train,1644,70,71680,1381,265152,336832
train,1645,41,41984,474,91008,132992
train,1646,14,14336,55,10560,24896
train,1647,60,61440,1015,194880,256320
train,1648,30,30720,254,48768,79488
train,1649,69,70656,1342,257664,328320
train,1650,58,59392,948,182016,241408
train,1651,72,73728,1461,280512,354240
train,1652,25,25600,176,33792,59392
train,1653,54,55296,822,157824,213120
train,1654,55,56320,853,163776,220096
train,1655,36,36864,365,70080,106944
train,1656,298,305152,25029,4805568,5110720
train,1657,26,26624,191,36672,63296
train,1658,83,84992,1942,372864,457856
train,1659,89,91136,2233,428736,519872
train,1660,205,209920,11845,2274240,2484160
train,1661,37,37888,386,74112,112000
train,1662,78,79872,1715,329280,409152
train,1663,22,22528,137,26304,48832
train,1664,57,58368,916,175872,234240
train,1665,181,185344,9234,1772928,1958272
train,1666,22,22528,137,26304,48832
train,1667,14,14336,55,10560,24896
train,1668,86,88064,2085,400320,488384
train,1669,52,53248,762,146304,199552
train,1670,76,77824,1628,312576,390400
train,1671,27,27648,206,39552,67200
train,1672,30,30720,254,48768,79488
train,1673,30,30720,254,48768,79488
train,1674,273,279552,21006,4033152,4312704
train,1675,14,14336,55,10560,24896
train,1676,84,86016,1989,381888,467904
train,1677,91,93184,2334,448128,541312
train,1678,241,246784,16370,3143040,3389824
train,1679,34,34816,326,62592,97408
train,1680,56,57344,884,169728,227072
train,1681,239,244736,16099,3091008,3335744
train,1682,26,26624,191,36672,63296
train,1683,22,22528,137,26304,48832
train,1684,67,68608,1265,242880,311488
train,1685,33,33792,307,58944,92736
train,1686,25,25600,176,33792,59392
train,1687,43,44032,521,100032,144064
train,1688,69,70656,1342,257664,328320
train,1689,56,57344,884,169728,227072
train,1690,81,82944,1849,355008,437952
train,1691,33,33792,307,58944,92736
train,1692,63,64512,1119,214848,279360
train,1693,15,15360,64,12288,27648
train,1694,74,75776,1544,296448,372224
train,1695,22,22528,137,26304,48832
train,1696,38,38912,407,78144,117056
train,1697,60,61440,1015,194880,256320
train,1698,23,23552,149,28608,52160
train,1699,165,168960,7673,1473216,1642176
train,1700,135,138240,5137,986304,1124544
train,1701,107,109568,3227,619584,729152
train,1702,84,86016,1989,381888,467904
train,1703,13,13312,48,9216,22528
train,1704,21,21504,125,24000,45504
train,1705,15,15360,64,12288,27648
train,1706,23,23552,149,28608,52160
train,1707,179,183296,9031,1733952,1917248
train,1708,12,12288,41,7872,20160
train,1709,333,340992,31253,6000576,6341568
train,1710,46,47104,597,114624,161728
train,1711,43,44032,521,100032,144064
train,1712,44,45056,546,104832,149888
train,1713,77,78848,1671,320832,399680
train,1714,87,89088,2133,409536,498624
train,1715,78,79872,1715,329280,409152
train,1716,97,99328,2652,509184,608512
train,1717,13,13312,48,9216,22528
train,1718,115,117760,3728,715776,833536
train,1719,40,40960,451,86592,127552
train,1720,16,16384,72,13824,30208
train,1721,30,30720,254,48768,79488
train,1722,108,110592,3288,631296,741888
train,1723,40,40960,451,86592,127552
train,1724,165,168960,7673,1473216,1642176
train,1725,29,29696,237,45504,75200
train,1726,129,132096,4690,900480,1032576
train,1727,119,121856,3991,766272,888128
train,1728,48,49152,650,124800,173952
train,1729,97,99328,2652,509184,608512
train,1730,36,36864,365,70080,106944
train,1731,36,36864,365,70080,106944
train,1732,51,52224,733,140736,192960
train,1733,55,56320,853,163776,220096
train,1734,21,21504,125,24000,45504
train,1735,57,58368,916,175872,234240
train,1736,108,110592,3288,631296,741888
train,1737,164,167936,7581,1455552,1623488
train,1738,17,17408,82,15744,33152
train,1739,57,58368,916,175872,234240
train,1740,35,35840,345,66240,102080
train,1741,85,87040,2037,391104,478144
train,1742,72,73728,1461,280512,354240
train,1743,91,93184,2334,448128,541312
train,1744,183,187392,9439,1812288,1999680
train,1745,45,46080,571,109632,155712
train,1746,82,83968,1895,363840,447808
train,1747,62,63488,1084,208128,271616
train,1748,70,71680,1381,265152,336832
train,1749,50,51200,705,135360,186560
train,1750,96,98304,2598,498816,597120
train,1751,12,12288,41,7872,20160
train,1752,60,61440,1015,194880,256320
train,1753,18,18432,92,17664,36096
train,1754,83,84992,1942,372864,457856
train,1755,31,31744,271,52032,83776
train,1756,30,30720,254,48768,79488
train,1757,24,24576,163,31296,55872
train,1758,126,129024,4475,859200,988224
train,1759,28,28672,221,42432,71104
train,1760,73,74752,1502,288384,363136
train,1761,35,35840,345,66240,102080
train,1762,33,33792,307,58944,92736
train,1763,25,25600,176,33792,59392
train,1764,45,46080,571,109632,155712
train,1765,54,55296,822,157824,213120
train,1766,22,22528,137,26304,48832
train,1767,54,55296,822,157824,213120
train,1768,98,100352,2707,519744,620096
train,1769,45,46080,571,109632,155712
train,1770,155,158720,6771,1300032,1458752
train,1771,191,195584,10282,1974144,2169728
train,1772,23,23552,149,28608,52160
train,1773,53,54272,792,152064,206336
train,1774,153,156672,6598,1266816,1423488
train,1775,12,12288,41,7872,20160
train,1776,18,18432,92,17664,36096
train,1777,49,50176,677,129984,180160
train,1778,43,44032,521,100032,144064
train,1779,58,59392,948,182016,241408
train,1780,78,79872,1715,329280,409152
train,1781,300,307200,25366,4870272,5177472
train,1782,64,65536,1155,221760,287296
train,1783,65,66560,1191,228672,295232
train,1784,34,34816,326,62592,97408
train,1785,66,67584,1228,235776,303360
train,1786,44,45056,546,104832,149888
train,1787,38,38912,407,78144,117056
train,1788,25,25600,176,33792,59392
train,1789,113,115712,3599,691008,806720
train,1790,232,237568,15170,2912640,3150208
train,1791,45,46080,571,109632,155712
train,1792,97,99328,2652,509184,608512
train,1793,41,41984,474,91008,132992
train,1794,70,71680,1381,265152,336832
train,1795,121,123904,4127,792384,916288
train,1796,76,77824,1628,312576,390400
train,1797,45,46080,571,109632,155712
train,1798,119,121856,3991,766272,888128
train,1799,20,20480,113,21696,42176
train,1800,154,157696,6684,1283328,1441024
train,1801,18,18432,92,17664,36096
train,1802,81,82944,1849,355008,437952
train,1803,30,30720,254,48768,79488
train,1804,91,93184,2334,448128,541312
train,1805,96,98304,2598,498816,597120
train,1806,21,21504,125,24000,45504
train,1807,35,35840,345,66240,102080
train,1808,54,55296,822,157824,213120
train,1809,46,47104,597,114624,161728
train,1810,77,78848,1671,320832,399680
train,1811,108,110592,3288,631296,741888
train,1812,59,60416,981,188352,248768
train,1813,120,122880,4059,779328,902208
train,1814,14,14336,55,10560,24896
train,1815,16,16384,72,13824,30208
train,1816,65,66560,1191,228672,295232
train,1817,262,268288,19347,3714624,3982912
train,1818,179,183296,9031,1733952,1917248
train,1819,38,38912,407,78144,117056
train,1820,96,98304,2598,498816,597120
train,1821,53,54272,792,152064,206336
train,1822,76,77824,1628,312576,390400
train,1823,23,23552,149,28608,52160
train,1824,107,109568,3227,619584,729152
train,1825,20,20480,113,21696,42176
train,1826,16,16384,72,13824,30208
train,1827,26,26624,191,36672,63296
train,1828,46,47104,597,114624,161728
train,1829,32,32768,289,55488,88256
train,1830,84,86016,1989,381888,467904
train,1831,23,23552,149,28608,52160
train,1832,29,29696,237,45504,75200
train,1833,239,244736,16099,3091008,3335744
train,1834,125,128000,4404,845568,973568
train,1835,98,100352,2707,519744,620096
train,1836,71,72704,1421,272832,345536
train,1837,155,158720,6771,1300032,1458752
train,1838,43,44032,521,100032,144064
train,1839,88,90112,2183,419136,509248
train,1840,246,251904,17056,3274752,3526656
train,1841,21,21504,125,24000,45504
train,1842,195,199680,10717,2057664,2257344
train,1843,16,16384,72,13824,30208
train,1844,43,44032,521,100032,144064
train,1845,122,124928,4195,805440,930368
train,1846,22,22528,137,26304,48832
train,1847,50,51200,705,135360,186560
train,1848,76,77824,1628,312576,390400
train,1849,322,329728,29223,5610816,5940544
train,1850,114,116736,3663,703296,820032
train,1851,230,235520,14910,2862720,3098240
train,1852,362,370688,36934,7091328,7462016
train,1853,28,28672,221,42432,71104
train,1854,50,51200,705,135360,186560
train,1855,71,72704,1421,272832,345536
train,1856,44,45056,546,104832,149888
train,1857,38,38912,407,78144,117056
train,1858,23,23552,149,28608,52160
train,1859,25,25600,176,33792,59392
train,1860,55,56320,853,163776,220096
train,1861,23,23552,149,28608,52160
train,1862,47,48128,623,119616,167744
train,1863,14,14336,55,10560,24896
train,1864,16,16384,72,13824,30208
train,1865,51,52224,733,140736,192960
train,1866,35,35840,345,66240,102080
train,1867,15,15360,64,12288,27648
train,1868,48,49152,650,124800,173952
train,1869,329,336896,30507,5857344,6194240
train,1870,20,20480,113,21696,42176
train,1871,71,72704,1421,272832,345536
train,1872,58,59392,948,182016,241408
train,1873,45,46080,571,109632,155712
train,1874,14,14336,55,10560,24896
train,1875,226,231424,14396,2764032,2995456
train,1876,24,24576,163,31296,55872
train,1877,253,259072,18041,3463872,3722944
train,1878,154,157696,6684,1283328,1441024
train,1879,22,22528,137,26304,48832
train,1880,82,83968,1895,363840,447808
train,1881,77,78848,1671,320832,399680
train,1882,70,71680,1381,265152,336832
train,1883,109,111616,3349,643008,754624
train,1884,17,17408,82,15744,33152
train,1885,17,17408,82,15744,33152
train,1886,51,52224,733,140736,192960
train,1887,16,16384,72,13824,30208
train,1888,19,19456,102,19584,39040
train,1889,48,49152,650,124800,173952
train,1890,86,88064,2085,400320,488384
train,1891,35,35840,345,66240,102080
train,1892,82,83968,1895,363840,447808
train,1893,27,27648,206,39552,67200
train,1894,20,20480,113,21696,42176
train,1895,41,41984,474,91008,132992
train,1896,24,24576,163,31296,55872
train,1897,76,77824,1628,312576,390400
train,1898,55,56320,853,163776,220096
train,1899,117,119808,3858,740736,860544
train,1900,44,45056,546,104832,149888
train,1901,121,123904,4127,792384,916288
train,1902,89,91136,2233,428736,519872
train,1903,46,47104,597,114624,161728
train,1904,19,19456,102,19584,39040
train,1905,19,19456,102,19584,39040
train,1906,58,59392,948,182016,241408
train,1907,24,24576,163,31296,55872
train,1908,26,26624,191,36672,63296
train,1909,106,108544,3167,608064,716608
train,1910,45,46080,571,109632,155712
train,1911,70,71680,1381,265152,336832
train,1912,38,38912,407,78144,117056
train,1913,40,40960,451,86592,127552
train,1914,49,50176,677,129984,180160
train,1915,60,61440,1015,194880,256320
train,1916,72,73728,1461,280512,354240
train,1917,27,27648,206,39552,67200
train,1918,29,29696,237,45504,75200
train,1919,50,51200,705,135360,186560
train,1920,117,119808,3858,740736,860544
train,1921,110,112640,3411,654912,767552
train,1922,25,25600,176,33792,59392
train,1923,120,122880,4059,779328,902208
train,1924,163,166912,7488,1437696,1604608
train,1925,143,146432,5764,1106688,1253120
train,1926,31,31744,271,52032,83776
train,1927,258,264192,18761,3602112,3866304
train,1928,32,32768,289,55488,88256
train,1929,116,118784,3793,728256,847040
train,1930,107,109568,3227,619584,729152
train,1931,39,39936,429,82368,122304
train,1932,87,89088,2133,409536,498624
train,1933,130,133120,4763,914496,1047616
train,1934,72,73728,1461,280512,354240
train,1935,74,75776,1544,296448,372224
train,1936,27,27648,206,39552,67200
train,1937,49,50176,677,129984,180160
train,1938,83,84992,1942,372864,457856
train,1939,31,31744,271,52032,83776
train,1940,85,87040,2037,391104,478144
train,1941,155,158720,6771,1300032,1458752
train,1942,71,72704,1421,272832,345536
train,1943,15,15360,64,12288,27648
train,1944,28,28672,221,42432,71104
train,1945,47,48128,623,119616,167744
train,1946,55,56320,853,163776,220096
train,1947,21,21504,125,24000,45504
train,1948,25,25600,176,33792,59392
train,1949,51,52224,733,140736,192960
train,1950,53,54272,792,152064,206336
train,1951,79,80896,1759,337728,418624
train,1952,21,21504,125,24000,45504
train,1953,36,36864,365,70080,106944
train,1954,17,17408,82,15744,33152
train,1955,57,58368,916,175872,234240
train,1956,196,200704,10827,2078784,2279488
train,1957,131,134144,4837,928704,1062848
train,1958,183,187392,9439,1812288,1999680
train,1959,88,90112,2183,419136,509248
train,1960,24,24576,163,31296,55872
train,1961,26,26624,191,36672,63296
train,1962,106,108544,3167,608064,716608
train,1963,137,140288,5290,1015680,1155968
train,1964,54,55296,822,157824,213120
train,1965,18,18432,92,17664,36096
train,1966,34,34816,326,62592,97408
train,1967,33,33792,307,58944,92736
train,1968,83,84992,1942,372864,457856
train,1969,24,24576,163,31296,55872
train,1970,21,21504,125,24000,45504
train,1971,132,135168,4911,942912,1078080
train,1972,73,74752,1502,288384,363136
train,1973,68,69632,1303,250176,319808
train,1974,190,194560,10175,1953600,2148160
train,1975,95,97280,2544,488448,585728
train,1976,40,40960,451,86592,127552
train,1977,50,51200,705,135360,186560
train,1978,39,39936,429,82368,122304
train,1979,25,25600,176,33792,59392
train,1980,72,73728,1461,280512,354240
train,1981,40,40960,451,86592,127552
train,1982,24,24576,163,31296,55872
train,1983,30,30720,254,48768,79488
train,1984,12,12288,41,7872,20160
train,1985,76,77824,1628,312576,390400
train,1986,24,24576,163,31296,55872
train,1987,68,69632,1303,250176,319808
train,1988,20,20480,113,21696,42176
train,1989,83,84992,1942,372864,457856
train,1990,24,24576,163,31296,55872
train,1991,66,67584,1228,235776,303360
train,1992,84,86016,1989,381888,467904
train,1993,93,95232,2438,468096,563328
train,1994,48,49152,650,124800,173952
train,1995,132,135168,4911,942912,1078080
train,1996,157,160768,6947,1333824,1494592
train,1997,63,64512,1119,214848,279360
train,1998,37,37888,386,74112,112000
train,1999,82,83968,1895,363840,447808
train,2000,13,13312,48,9216,22528
train,2001,23,23552,149,28608,52160
train,2002,83,84992,1942,372864,457856
train,2003,12,12288,41,7872,20160
train,2004,116,118784,3793,728256,847040
train,2005,79,80896,1759,337728,418624
train,2006,77,78848,1671,320832,399680
train,2007,10,10240,28,5376,15616
train,2008,80,81920,1804,346368,428288
train,2009,35,35840,345,66240,102080
train,2010,62,63488,1084,208128,271616
train,2011,75,76800,1586,304512,381312
train,2012,112,114688,3536,678912,793600
train,2013,126,129024,4475,859200,988224
train,2014,48,49152,650,124800,173952
train,2015,118,120832,3925,753600,874432
train,2016,35,35840,345,66240,102080
train,2017,160,163840,7215,1385280,1549120
train,2018,53,54272,792,152064,206336
train,2019,160,163840,7215,1385280,1549120
train,2020,24,24576,163,31296,55872
train,2021,60,61440,1015,194880,256320
train,2022,26,26624,191,36672,63296
train,2023,44,45056,546,104832,149888
train,2024,51,52224,733,140736,192960
train,2025,65,66560,1191,228672,295232
train,2026,26,26624,191,36672,63296
train,2027,67,68608,1265,242880,311488
train,2028,22,22528,137,26304,48832
train,2029,82,83968,1895,363840,447808
train,2030,127,130048,4546,872832,1002880
train,2031,36,36864,365,70080,106944
train,2032,25,25600,176,33792,59392
train,2033,111,113664,3473,666816,780480
train,2034,166,169984,7767,1491264,1661248
train,2035,87,89088,2133,409536,498624
train,2036,18,18432,92,17664,36096
train,2037,227,232448,14523,2788416,3020864
train,2038,80,81920,1804,346368,428288
train,2039,29,29696,237,45504,75200
train,2040,117,119808,3858,740736,860544
train,2041,19,19456,102,19584,39040
train,2042,45,46080,571,109632,155712
train,2043,44,45056,546,104832,149888
train,2044,52,53248,762,146304,199552
train,2045,36,36864,365,70080,106944
train,2046,61,62464,1049,201408,263872
train,2047,25,25600,176,33792,59392
train,2048,75,76800,1586,304512,381312
train,2049,46,47104,597,114624,161728
train,2050,17,17408,82,15744,33152
train,2051,36,36864,365,70080,106944
train,2052,37,37888,386,74112,112000
train,2053,35,35840,345,66240,102080
train,2054,58,59392,948,182016,241408
train,2055,71,72704,1421,272832,345536
train,2056,25,25600,176,33792,59392
train,2057,127,130048,4546,872832,1002880
train,2058,11,11264,34,6528,17792
train,2059,63,64512,1119,214848,279360
train,2060,101,103424,2875,552000,655424
train,2061,36,36864,365,70080,106944
train,2062,40,40960,451,86592,127552
train,2063,41,41984,474,91008,132992
train,2064,72,73728,1461,280512,354240
train,2065,38,38912,407,78144,117056
train,2066,51,52224,733,140736,192960
train,2067,54,55296,822,157824,213120
train,2068,55,56320,853,163776,220096
train,2069,15,15360,64,12288,27648
train,2070,24,24576,163,31296,55872
train,2071,180,184320,9132,1753344,1937664
train,2072,51,52224,733,140736,192960
train,2073,215,220160,13028,2501376,2721536
train,2074,357,365568,35921,6896832,7262400
train,2075,62,63488,1084,208128,271616
train,2076,68,69632,1303,250176,319808
train,2077,77,78848,1671,320832,399680
train,2078,56,57344,884,169728,227072
train,2079,47,48128,623,119616,167744
train,2080,35,35840,345,66240,102080
train,2081,49,50176,677,129984,180160
train,2082,19,19456,102,19584,39040
train,2083,36,36864,365,70080,106944
train,2084,173,177152,8435,1619520,1796672
train,2085,74,75776,1544,296448,372224
train,2086,14,14336,55,10560,24896
train,2087,15,15360,64,12288,27648
train,2088,71,72704,1421,272832,345536
train,2089,73,74752,1502,288384,363136
train,2090,189,193536,10068,1933056,2126592
train,2091,33,33792,307,58944,92736
train,2092,35,35840,345,66240,102080
train,2093,13,13312,48,9216,22528
train,2094,115,117760,3728,715776,833536
train,2095,27,27648,206,39552,67200
train,2096,36,36864,365,70080,106944
train,2097,120,122880,4059,779328,902208
train,2098,21,21504,125,24000,45504
train,2099,17,17408,82,15744,33152
train,2100,11,11264,34,6528,17792
train,2101,25,25600,176,33792,59392
train,2102,60,61440,1015,194880,256320
train,2103,61,62464,1049,201408,263872
train,2104,60,61440,1015,194880,256320
train,2105,49,50176,677,129984,180160
train,2106,39,39936,429,82368,122304
train,2107,21,21504,125,24000,45504
train,2108,67,68608,1265,242880,311488
train,2109,87,89088,2133,409536,498624
train,2110,42,43008,497,95424,138432
train,2111,67,68608,1265,242880,311488
train,2112,46,47104,597,114624,161728
train,2113,85,87040,2037,391104,478144
train,2114,170,174080,8145,1563840,1737920
train,2115,95,97280,2544,488448,585728
train,2116,21,21504,125,24000,45504
train,2117,71,72704,1421,272832,345536
train,2118,75,76800,1586,304512,381312
train,2119,69,70656,1342,257664,328320
train,2120,56,57344,884,169728,227072
train,2121,39,39936,429,82368,122304
train,2122,53,54272,792,152064,206336
train,2123,174,178176,8533,1638336,1816512
train,2124,182,186368,9336,1792512,1978880
train,2125,61,62464,1049,201408,263872
train,2126,85,87040,2037,391104,478144
train,2127,75,76800,1586,304512,381312
train,2128,94,96256,2491,478272,574528
train,2129,18,18432,92,17664,36096
train,2130,17,17408,82,15744,33152
train,2131,67,68608,1265,242880,311488
train,2132,83,84992,1942,372864,457856
train,2133,94,96256,2491,478272,574528
train,2134,14,14336,55,10560,24896
train,2135,31,31744,271,52032,83776
train,2136,13,13312,48,9216,22528
train,2137,22,22528,137,26304,48832
train,2138,35,35840,345,66240,102080
train,2139,21,21504,125,24000,45504
train,2140,23,23552,149,28608,52160
train,2141,111,113664,3473,666816,780480
train,2142,27,27648,206,39552,67200
train,2143,49,50176,677,129984,180160
train,2144,40,40960,451,86592,127552
train,2145,23,23552,149,28608,52160
train,2146,12,12288,41,7872,20160
train,2147,87,89088,2133,409536,498624
train,2148,17,17408,82,15744,33152
train,2149,314,321536,27789,5335488,5657024
train,2150,23,23552,149,28608,52160
train,2151,141,144384,5604,1075968,1220352
train,2152,39,39936,429,82368,122304
train,2153,97,99328,2652,509184,608512
train,2154,39,39936,429,82368,122304
train,2155,147,150528,6091,1169472,1320000
train,2156,25,25600,176,33792,59392
train,2157,34,34816,326,62592,97408
train,2158,85,87040,2037,391104,478144
train,2159,29,29696,237,45504,75200
train,2160,180,184320,9132,1753344,1937664
train,2161,64,65536,1155,221760,287296
train,2162,41,41984,474,91008,132992
train,2163,82,83968,1895,363840,447808
train,2164,73,74752,1502,288384,363136
train,2165,81,82944,1849,355008,437952
train,2166,76,77824,1628,312576,390400
train,2167,33,33792,307,58944,92736
train,2168,76,77824,1628,312576,390400
train,2169,45,46080,571,109632,155712
train,2170,101,103424,2875,552000,655424
train,2171,33,33792,307,58944,92736
train,2172,55,56320,853,163776,220096
train,2173,221,226304,13766,2643072,2869376
train,2174,310,317440,27085,5200320,5517760
train,2175,90,92160,2283,438336,530496
train,2176,69,70656,1342,257664,328320
train,2177,68,69632,1303,250176,319808
train,2178,36,36864,365,70080,106944
train,2179,53,54272,792,152064,206336
train,2180,145,148480,5926,1137792,1286272
train,2181,147,150528,6091,1169472,1320000
train,2182,122,124928,4195,805440,930368
train,2183,117,119808,3858,740736,860544
train,2184,102,104448,2933,563136,667584
train,2185,28,28672,221,42432,71104
train,2186,51,52224,733,140736,192960
train,2187,15,15360,64,12288,27648
train,2188,12,12288,41,7872,20160
train,2189,17,17408,82,15744,33152
train,2190,23,23552,149,28608,52160
train,2191,321,328704,29041,5575872,5904576
train,2192,175,179200,8632,1657344,1836544
train,2193,257,263168,18616,3574272,3837440
train,2194,46,47104,597,114624,161728
train,2195,58,59392,948,182016,241408
train,2196,51,52224,733,140736,192960
train,2197,23,23552,149,28608,52160
train,2198,92,94208,2386,458112,552320
train,2199,186,190464,9751,1872192,2062656
train,2200,24,24576,163,31296,55872
train,2201,51,52224,733,140736,192960
train,2202,54,55296,822,157824,213120
train,2203,15,15360,64,12288,27648
train,2204,60,61440,1015,194880,256320
train,2205,206,210944,11960,2296320,2507264
train,2206,65,66560,1191,228672,295232
train,2207,38,38912,407,78144,117056
train,2208,163,166912,7488,1437696,1604608
train,2209,116,118784,3793,728256,847040
train,2210,331,338944,30879,5928768,6267712
train,2211,47,48128,623,119616,167744
train,2212,48,49152,650,124800,173952
train,2213,118,120832,3925,753600,874432
train,2214,50,51200,705,135360,186560
train,2215,266,272384,19942,3828864,4101248
train,2216,18,18432,92,17664,36096
train,2217,57,58368,916,175872,234240
train,2218,68,69632,1303,250176,319808
train,2219,62,63488,1084,208128,271616
train,2220,27,27648,206,39552,67200
train,2221,24,24576,163,31296,55872
train,2222,118,120832,3925,753600,874432
train,2223,28,28672,221,42432,71104
train,2224,184,188416,9542,1832064,2020480
train,2225,9,9216,23,4416,13632
train,2226,24,24576,163,31296,55872
train,2227,274,280576,21160,4062720,4343296
train,2228,28,28672,221,42432,71104
train,2229,84,86016,1989,381888,467904
train,2230,11,11264,34,6528,17792
train,2231,191,195584,10282,1974144,2169728
train,2232,34,34816,326,62592,97408
train,2233,139,142336,5446,1045632,1187968
train,2234,26,26624,191,36672,63296
train,2235,16,16384,72,13824,30208
train,2236,38,38912,407,78144,117056
train,2237,176,180224,8731,1676352,1856576
train,2238,17,17408,82,15744,33152
train,2239,29,29696,237,45504,75200
train,2240,61,62464,1049,201408,263872
train,2241,214,219136,12907,2478144,2697280
train,2242,166,169984,7767,1491264,1661248
train,2243,128,131072,4618,886656,1017728
train,2244,59,60416,981,188352,248768
train,2245,24,24576,163,31296,55872
train,2246,73,74752,1502,288384,363136
train,2247,20,20480,113,21696,42176
train,2248,176,180224,8731,1676352,1856576
train,2249,43,44032,521,100032,144064
train,2250,83,84992,1942,372864,457856
train,2251,54,55296,822,157824,213120
train,2252,89,91136,2233,428736,519872
train,2253,49,50176,677,129984,180160
train,2254,14,14336,55,10560,24896
train,2255,58,59392,948,182016,241408
train,2256,59,60416,981,188352,248768
train,2257,131,134144,4837,928704,1062848
train,2258,197,201728,10938,2100096,2301824
train,2259,63,64512,1119,214848,279360
train,2260,103,105472,2990,574080,679552
train,2261,29,29696,237,45504,75200
train,2262,31,31744,271,52032,83776
train,2263,41,41984,474,91008,132992
train,2264,86,88064,2085,400320,488384
train,2265,52,53248,762,146304,199552
train,2266,72,73728,1461,280512,354240
train,2267,24,24576,163,31296,55872
train,2268,23,23552,149,28608,52160
train,2269,22,22528,137,26304,48832
train,2270,15,15360,64,12288,27648
train,2271,19,19456,102,19584,39040
train,2272,47,48128,623,119616,167744
train,2273,135,138240,5137,986304,1124544
train,2274,103,105472,2990,574080,679552
train,2275,17,17408,82,15744,33152
train,2276,134,137216,5061,971712,1108928
train,2277,163,166912,7488,1437696,1604608
train,2278,70,71680,1381,265152,336832
train,2279,27,27648,206,39552,67200
train,2280,42,43008,497,95424,138432
train,2281,82,83968,1895,363840,447808
train,2282,66,67584,1228,235776,303360
train,2283,149,152576,6257,1201344,1353920
train,2284,14,14336,55,10560,24896
train,2285,25,25600,176,33792,59392
train,2286,79,80896,1759,337728,418624
train,2287,12,12288,41,7872,20160
train,2288,39,39936,429,82368,122304
train,2289,298,305152,25029,4805568,5110720
train,2290,60,61440,1015,194880,256320
train,2291,138,141312,5368,1030656,1171968
train,2292,39,39936,429,82368,122304
train,2293,186,190464,9751,1872192,2062656
train,2294,34,34816,326,62592,97408
train,2295,25,25600,176,33792,59392
train,2296,54,55296,822,157824,213120
train,2297,28,28672,221,42432,71104
train,2298,52,53248,762,146304,199552
train,2299,25,25600,176,33792,59392
train,2300,15,15360,64,12288,27648
train,2301,21,21504,125,24000,45504
train,2302,73,74752,1502,288384,363136
train,2303,163,166912,7488,1437696,1604608
train,2304,68,69632,1303,250176,319808
train,2305,323,330752,29404,5645568,5976320
train,2306,32,32768,289,55488,88256
train,2307,78,79872,1715,329280,409152
train,2308,30,30720,254,48768,79488
train,2309,351,359424,34723,6666816,7026240
train,2310,126,129024,4475,859200,988224
train,2311,77,78848,1671,320832,399680
train,2312,57,58368,916,175872,234240
train,2313,22,22528,137,26304,48832
train,2314,40,40960,451,86592,127552
train,2315,25,25600,176,33792,59392
train,2316,303,310272,25876,4968192,5278464
train,2317,53,54272,792,152064,206336
train,2318,156,159744,6859,1316928,1476672
train,2319,45,46080,571,109632,155712
train,2320,64,65536,1155,221760,287296
train,2321,137,140288,5290,1015680,1155968
train,2322,26,26624,191,36672,63296
train,2323,80,81920,1804,346368,428288
train,2324,53,54272,792,152064,206336
train,2325,25,25600,176,33792,59392
train,2326,22,22528,137,26304,48832
train,2327,29,29696,237,45504,75200
train,2328,22,22528,137,26304,48832
train,2329,15,15360,64,12288,27648
train,2330,26,26624,191,36672,63296
train,2331,23,23552,149,28608,52160
train,2332,24,24576,163,31296,55872
train,2333,152,155648,6512,1250304,1405952
train,2334,46,47104,597,114624,161728
train,2335,125,128000,4404,845568,973568
train,2336,180,184320,9132,1753344,1937664
train,2337,44,45056,546,104832,149888
train,2338,41,41984,474,91008,132992
train,2339,47,48128,623,119616,167744
train,2340,25,25600,176,33792,59392
train,2341,151,154624,6426,1233792,1388416
train,2342,23,23552,149,28608,52160
train,2343,22,22528,137,26304,48832
train,2344,45,46080,571,109632,155712
train,2345,141,144384,5604,1075968,1220352
train,2346,82,83968,1895,363840,447808
train,2347,13,13312,48,9216,22528
train,2348,84,86016,1989,381888,467904
train,2349,53,54272,792,152064,206336
train,2350,24,24576,163,31296,55872
train,2351,68,69632,1303,250176,319808
train,2352,371,379904,38793,7448256,7828160
train,2353,14,14336,55,10560,24896
train,2354,101,103424,2875,552000,655424
train,2355,83,84992,1942,372864,457856
train,2356,48,49152,650,124800,173952
train,2357,13,13312,48,9216,22528
train,2358,30,30720,254,48768,79488
train,2359,42,43008,497,95424,138432
train,2360,104,106496,3049,585408,691904
train,2361,108,110592,3288,631296,741888
train,2362,15,15360,64,12288,27648
train,2363,140,143360,5524,1060608,1203968
train,2364,53,54272,792,152064,206336
train,2365,14,14336,55,10560,24896
train,2366,49,50176,677,129984,180160
train,2367,72,73728,1461,280512,354240
train,2368,170,174080,8145,1563840,1737920
train,2369,23,23552,149,28608,52160
train,2370,59,60416,981,188352,248768
train,2371,11,11264,34,6528,17792
train,2372,54,55296,822,157824,213120
train,2373,154,157696,6685,1283520,1441216
train,2374,29,29696,237,45504,75200
train,2375,100,102400,2819,541248,643648
train,2376,103,105472,2990,574080,679552
train,2377,123,125952,4264,818688,944640
train,2378,31,31744,271,52032,83776
train,2379,65,66560,1191,228672,295232
train,2380,65,66560,1191,228672,295232
train,2381,228,233472,14651,2812992,3046464
train,2382,96,98304,2598,498816,597120
train,2383,152,155648,6512,1250304,1405952
train,2384,90,92160,2283,438336,530496
train,2385,99,101376,2763,530496,631872
train,2386,61,62464,1049,201408,263872
train,2387,22,22528,137,26304,48832
train,2388,248,253952,17335,3328320,3582272
train,2389,68,69632,1303,250176,319808
train,2390,34,34816,326,62592,97408
train,2391,46,47104,597,114624,161728
train,2392,144,147456,5844,1122048,1269504
train,2393,24,24576,163,31296,55872
train,2394,29,29696,237,45504,75200
train,2395,98,100352,2707,519744,620096
train,2396,86,88064,2085,400320,488384
train,2397,63,64512,1119,214848,279360
train,2398,35,35840,345,66240,102080
train,2399,11,11264,34,6528,17792
train,2400,25,25600,176,33792,59392
train,2401,101,103424,2875,552000,655424
train,2402,46,47104,597,114624,161728
train,2403,12,12288,41,7872,20160
train,2404,29,29696,237,45504,75200
train,2405,68,69632,1303,250176,319808
train,2406,23,23552,149,28608,52160
train,2407,69,70656,1342,257664,328320
train,2408,24,24576,163,31296,55872
train,2409,94,96256,2491,478272,574528
train,2410,60,61440,1015,194880,256320
train,2411,211,216064,12548,2409216,2625280
train,2412,200,204800,11274,2164608,2369408
train,2413,35,35840,345,66240,102080
train,2414,63,64512,1119,214848,279360
train,2415,164,167936,7581,1455552,1623488
train,2416,115,117760,3728,715776,833536
train,2417,157,160768,6947,1333824,1494592
train,2418,12,12288,41,7872,20160
train,2419,8,8192,23,4416,12608
train,2420,25,25600,176,33792,59392
train,2421,35,35840,345,66240,102080
train,2422,53,54272,792,152064,206336
train,2423,24,24576,163,31296,55872
train,2424,88,90112,2183,419136,509248
train,2425,31,31744,271,52032,83776
train,2426,136,139264,5213,1000896,1140160
train,2427,17,17408,82,15744,33152
train,2428,74,75776,1544,296448,372224
train,2429,121,123904,4127,792384,916288
train,2430,89,91136,2233,428736,519872
train,2431,23,23552,149,28608,52160
train,2432,66,67584,1228,235776,303360
train,2433,26,26624,191,36672,63296
train,2434,13,13312,48,9216,22528
train,2435,55,56320,853,163776,220096
train,2436,39,39936,429,82368,122304
train,2437,34,34816,326,62592,97408
train,2438,209,214016,12311,2363712,2577728
train,2439,25,25600,176,33792,59392
train,2440,66,67584,1228,235776,303360
train,2441,31,31744,271,52032,83776
train,2442,54,55296,822,157824,213120
train,2443,51,52224,733,140736,192960
train,2444,21,21504,125,24000,45504
train,2445,90,92160,2283,438336,530496
train,2446,71,72704,1421,272832,345536
train,2447,32,32768,289,55488,88256
train,2448,270,276480,20546,3944832,4221312
train,2449,37,37888,386,74112,112000
train,2450,32,32768,289,55488,88256
train,2451,347,355328,33937,6515904,6871232
train,2452,40,40960,451,86592,127552
train,2453,45,46080,571,109632,155712
train,2454,166,169984,7767,1491264,1661248
train,2455,23,23552,149,28608,52160
train,2456,44,45056,546,104832,149888
train,2457,123,125952,4264,818688,944640
train,2458,68,69632,1303,250176,319808
train,2459,145,148480,5926,1137792,1286272
train,2460,56,57344,884,169728,227072
train,2461,25,25600,176,33792,59392
train,2462,51,52224,733,140736,192960
train,2463,99,101376,2763,530496,631872
train,2464,65,66560,1191,228672,295232
train,2465,65,66560,1191,228672,295232
train,2466,47,48128,623,119616,167744
train,2467,41,41984,474,91008,132992
train,2468,42,43008,497,95424,138432
train,2469,207,211968,12077,2318784,2530752
train,2470,16,16384,72,13824,30208
train,2471,12,12288,41,7872,20160
train,2472,56,57344,884,169728,227072
train,2473,82,83968,1895,363840,447808
train,2474,40,40960,451,86592,127552
train,2475,139,142336,5446,1045632,1187968
train,2476,37,37888,386,74112,112000
train,2477,49,50176,677,129984,180160
train,2478,13,13312,48,9216,22528
train,2479,24,24576,163,31296,55872
train,2480,69,70656,1342,257664,328320
train,2481,48,49152,650,124800,173952
train,2482,41,41984,474,91008,132992
train,2483,25,25600,176,33792,59392
train,2484,13,13312,48,9216,22528
train,2485,18,18432,92,17664,36096
train,2486,236,241664,15698,3014016,3255680
train,2487,10,10240,28,5376,15616
train,2488,20,20480,113,21696,42176
train,2489,63,64512,1119,214848,279360
train,2490,128,131072,4618,886656,1017728
train,2491,74,75776,1544,296448,372224
train,2492,12,12288,41,7872,20160
train,2493,78,79872,1715,329280,409152
train,2494,42,43008,497,95424,138432
train,2495,66,67584,1228,235776,303360
train,2496,50,51200,705,135360,186560
train,2497,166,169984,7767,1491264,1661248
train,2498,74,75776,1544,296448,372224
train,2499,59,60416,981,188352,248768
train,2500,173,177152,8435,1619520,1796672
train,2501,32,32768,289,55488,88256
train,2502,46,47104,597,114624,161728
train,2503,89,91136,2233,428736,519872
train,2504,191,195584,10282,1974144,2169728
train,2505,150,153600,6342,1217664,1371264
train,2506,59,60416,981,188352,248768
train,2507,22,22528,137,26304,48832
train,2508,68,69632,1303,250176,319808
train,2509,57,58368,916,175872,234240
train,2510,43,44032,521,100032,144064
train,2511,52,53248,762,146304,199552
train,2512,118,120832,3925,753600,874432
train,2513,16,16384,72,13824,30208
train,2514,129,132096,4690,900480,1032576
train,2515,40,40960,451,86592,127552
train,2516,23,23552,149,28608,52160
train,2517,39,39936,429,82368,122304
train,2518,27,27648,206,39552,67200
train,2519,246,251904,17056,3274752,3526656
train,2520,42,43008,497,95424,138432
train,2521,24,24576,163,31296,55872
train,2522,57,58368,916,175872,234240
train,2523,10,10240,28,5376,15616
train,2524,36,36864,365,70080,106944
train,2525,47,48128,623,119616,167744
train,2526,81,82944,1849,355008,437952
train,2527,154,157696,6684,1283328,1441024
train,2528,73,74752,1502,288384,363136
train,2529,56,57344,884,169728,227072
train,2530,156,159744,6859,1316928,1476672
train,2531,105,107520,3108,596736,704256
train,2532,42,43008,497,95424,138432
train,2533,24,24576,163,31296,55872
train,2534,22,22528,137,26304,48832
train,2535,94,96256,2491,478272,574528
train,2536,83,84992,1942,372864,457856
train,2537,49,50176,677,129984,180160
train,2538,33,33792,307,58944,92736
train,2539,39,39936,429,82368,122304
train,2540,15,15360,64,12288,27648
train,2541,116,118784,3793,728256,847040
train,2542,80,81920,1804,346368,428288
train,2543,26,26624,191,36672,63296
train,2544,13,13312,48,9216,22528
train,2545,36,36864,365,70080,106944
train,2546,32,32768,289,55488,88256
train,2547,66,67584,1228,235776,303360
train,2548,49,50176,677,129984,180160
train,2549,56,57344,884,169728,227072
train,2550,21,21504,125,24000,45504
train,2551,36,36864,365,70080,106944
train,2552,24,24576,163,31296,55872
train,2553,147,150528,6091,1169472,1320000
train,2554,24,24576,163,31296,55872
train,2555,139,142336,5446,1045632,1187968
train,2556,19,19456,102,19584,39040
train,2557,106,108544,3167,608064,716608
train,2558,69,70656,1342,257664,328320
train,2559,34,34816,326,62592,97408
train,2560,236,241664,15698,3014016,3255680
train,2561,119,121856,3991,766272,888128
train,2562,22,22528,137,26304,48832
train,2563,20,20480,113,21696,42176
train,2564,27,27648,206,39552,67200
train,2565,84,86016,1989,381888,467904
train,2566,99,101376,2763,530496,631872
train,2567,78,79872,1715,329280,409152
train,2568,142,145408,5683,1091136,1236544
train,2569,83,84992,1942,372864,457856
train,2570,77,78848,1671,320832,399680
train,2571,119,121856,3991,766272,888128
train,2572,58,59392,948,182016,241408
train,2573,22,22528,137,26304,48832
train,2574,42,43008,497,95424,138432
train,2575,13,13312,48,9216,22528
train,2576,100,102400,2819,541248,643648
train,2577,213,218112,12787,2455104,2673216
train,2578,14,14336,55,10560,24896
train,2579,67,68608,1265,242880,311488
train,2580,128,131072,4618,886656,1017728
train,2581,120,122880,4059,779328,902208
train,2582,70,71680,1381,265152,336832
train,2583,108,110592,3288,631296,741888
train,2584,46,47104,597,114624,161728
train,2585,39,39936,429,82368,122304
train,2586,41,41984,474,91008,132992
train,2587,11,11264,34,6528,17792
train,2588,54,55296,822,157824,213120
train,2589,24,24576,163,31296,55872
train,2590,26,26624,191,36672,63296
train,2591,61,62464,1049,201408,263872
train,2592,29,29696,237,45504,75200
train,2593,23,23552,149,28608,52160
train,2594,43,44032,521,100032,144064
train,2595,71,72704,1421,272832,345536
train,2596,58,59392,948,182016,241408
train,2597,74,75776,1544,296448,372224
train,2598,24,24576,163,31296,55872
train,2599,37,37888,386,74112,112000
train,2600,77,78848,1671,320832,399680
train,2601,56,57344,884,169728,227072
train,2602,131,134144,4837,928704,1062848
train,2603,45,46080,571,109632,155712
train,2604,56,57344,884,169728,227072
train,2605,78,79872,1715,329280,409152
train,2606,27,27648,206,39552,67200
train,2607,63,64512,1119,214848,279360
train,2608,30,30720,254,48768,79488
train,2609,36,36864,365,70080,106944
train,2610,86,88064,2085,400320,488384
train,2611,117,119808,3858,740736,860544
train,2612,79,80896,1759,337728,418624
train,2613,27,27648,206,39552,67200
train,2614,81,82944,1849,355008,437952
train,2615,29,29696,237,45504,75200
train,2616,61,62464,1049,201408,263872
train,2617,18,18432,92,17664,36096
train,2618,99,101376,2763,530496,631872
train,2619,22,22528,137,26304,48832
train,2620,203,207872,11615,2230080,2437952
train,2621,54,55296,822,157824,213120
train,2622,53,54272,792,152064,206336
train,2623,42,43008,497,95424,138432
train,2624,73,74752,1502,288384,363136
train,2625,90,92160,2283,438336,530496
train,2626,45,46080,571,109632,155712
train,2627,228,233472,14651,2812992,3046464
train,2628,125,128000,4404,845568,973568
train,2629,39,39936,429,82368,122304
train,2630,118,120832,3925,753600,874432
train,2631,24,24576,163,31296,55872
train,2632,31,31744,271,52032,83776
train,2633,98,100352,2707,519744,620096
train,2634,41,41984,474,91008,132992
train,2635,80,81920,1804,346368,428288
train,2636,104,106496,3049,585408,691904
train,2637,61,62464,1049,201408,263872
train,2638,173,177152,8435,1619520,1796672
train,2639,89,91136,2233,428736,519872
train,2640,21,21504,125,24000,45504
train,2641,23,23552,149,28608,52160
train,2642,39,39936,429,82368,122304
train,2643,110,112640,3411,654912,767552
train,2644,39,39936,429,82368,122304
train,2645,168,172032,7955,1527360,1699392
train,2646,74,75776,1544,296448,372224
train,2647,40,40960,451,86592,127552
train,2648,19,19456,102,19584,39040
train,2649,23,23552,149,28608,52160
train,2650,33,33792,307,58944,92736
train,2651,65,66560,1191,228672,295232
train,2652,41,41984,474,91008,132992
train,2653,60,61440,1015,194880,256320
train,2654,24,24576,163,31296,55872
train,2655,134,137216,5061,971712,1108928
train,2656,181,185344,9234,1772928,1958272
train,2657,28,28672,221,42432,71104
train,2658,37,37888,386,74112,112000
train,2659,17,17408,82,15744,33152
train,2660,151,154624,6426,1233792,1388416
train,2661,126,129024,4475,859200,988224
train,2662,64,65536,1155,221760,287296
train,2663,68,69632,1303,250176,319808
train,2664,75,76800,1586,304512,381312
train,2665,59,60416,981,188352,248768
train,2666,13,13312,48,9216,22528
train,2667,70,71680,1381,265152,336832
train,2668,28,28672,221,42432,71104
train,2669,13,13312,48,9216,22528
train,2670,139,142336,5446,1045632,1187968
train,2671,268,274432,20243,3886656,4161088
train,2672,95,97280,2544,488448,585728
train,2673,33,33792,307,58944,92736
train,2674,20,20480,113,21696,42176
train,2675,105,107520,3108,596736,704256
train,2676,104,106496,3049,585408,691904
train,2677,33,33792,307,58944,92736
train,2678,88,90112,2183,419136,509248
train,2679,22,22528,137,26304,48832
train,2680,100,102400,2819,541248,643648
train,2681,39,39936,429,82368,122304
train,2682,83,84992,1942,372864,457856
train,2683,56,57344,884,169728,227072
train,2684,54,55296,822,157824,213120
train,2685,27,27648,206,39552,67200
train,2686,49,50176,677,129984,180160
train,2687,53,54272,792,152064,206336
train,2688,38,38912,407,78144,117056
train,2689,39,39936,429,82368,122304
train,2690,145,148480,5926,1137792,1286272
train,2691,82,83968,1895,363840,447808
train,2692,42,43008,497,95424,138432
train,2693,31,31744,271,52032,83776
train,2694,73,74752,1502,288384,363136
train,2695,32,32768,289,55488,88256
train,2696,226,231424,14396,2764032,2995456
train,2697,66,67584,1228,235776,303360
train,2698,25,25600,176,33792,59392
train,2699,25,25600,176,33792,59392
train,2700,42,43008,497,95424,138432
train,2701,37,37888,386,74112,112000
train,2702,233,238592,15301,2937792,3176384
train,2703,13,13312,48,9216,22528
train,2704,189,193536,10068,1933056,2126592
train,2705,42,43008,497,95424,138432
train,2706,23,23552,149,28608,52160
train,2707,17,17408,82,15744,33152
train,2708,28,28672,221,42432,71104
train,2709,25,25600,176,33792,59392
train,2710,78,79872,1715,329280,409152
train,2711,23,23552,149,28608,52160
train,2712,44,45056,546,104832,149888
train,2713,14,14336,55,10560,24896
train,2714,65,66560,1191,228672,295232
train,2715,11,11264,34,6528,17792
train,2716,153,156672,6598,1266816,1423488
train,2717,34,34816,326,62592,97408
train,2718,169,173056,8050,1545600,1718656
train,2719,81,82944,1849,355008,437952
train,2720,67,68608,1265,242880,311488
train,2721,21,21504,125,24000,45504
train,2722,62,63488,1084,208128,271616
train,2723,121,123904,4127,792384,916288
train,2724,33,33792,307,58944,92736
train,2725,173,177152,8435,1619520,1796672
train,2726,168,172032,7955,1527360,1699392
train,2727,67,68608,1265,242880,311488
train,2728,36,36864,365,70080,106944
train,2729,57,58368,916,175872,234240
train,2730,33,33792,307,58944,92736
train,2731,33,33792,307,58944,92736
train,2732,51,52224,733,140736,192960
train,2733,69,70656,1342,257664,328320
train,2734,145,148480,5926,1137792,1286272
train,2735,84,86016,1989,381888,467904
train,2736,38,38912,407,78144,117056
train,2737,27,27648,206,39552,67200
train,2738,47,48128,623,119616,167744
train,2739,78,79872,1715,329280,409152
train,2740,44,45056,546,104832,149888
train,2741,30,30720,254,48768,79488
train,2742,36,36864,365,70080,106944
train,2743,26,26624,191,36672,63296
train,2744,94,96256,2491,478272,574528
train,2745,31,31744,271,52032,83776
train,2746,14,14336,55,10560,24896
train,2747,37,37888,386,74112,112000
train,2748,69,70656,1342,257664,328320
train,2749,91,93184,2334,448128,541312
train,2750,43,44032,521,100032,144064
train,2751,439,449536,54317,10428864,10878400
train,2752,20,20480,113,21696,42176
train,2753,11,11264,34,6528,17792
train,2754,214,219136,12907,2478144,2697280
train,2755,114,116736,3663,703296,820032
train,2756,91,93184,2334,448128,541312
train,2757,135,138240,5137,986304,1124544
train,2758,308,315392,26737,5133504,5448896
train,2759,25,25600,176,33792,59392
train,2760,52,53248,762,146304,199552
train,2761,11,11264,34,6528,17792
train,2762,55,56320,853,163776,220096
train,2763,58,59392,948,182016,241408
train,2764,93,95232,2438,468096,563328
train,2765,24,24576,163,31296,55872
train,2766,33,33792,307,58944,92736
train,2767,65,66560,1191,228672,295232
train,2768,56,57344,884,169728,227072
train,2769,42,43008,497,95424,138432
train,2770,167,171008,7861,1509312,1680320
train,2771,179,183296,9031,1733952,1917248
train,2772,16,16384,72,13824,30208
train,2773,95,97280,2544,488448,585728
train,2774,145,148480,5926,1137792,1286272
train,2775,51,52224,733,140736,192960
train,2776,21,21504,125,24000,45504
train,2777,46,47104,597,114624,161728
train,2778,23,23552,149,28608,52160
train,2779,24,24576,163,31296,55872
train,2780,53,54272,792,152064,206336
train,2781,51,52224,733,140736,192960
train,2782,109,111616,3349,643008,754624
train,2783,91,93184,2334,448128,541312
train,2784,170,174080,8145,1563840,1737920
train,2785,99,101376,2763,530496,631872
train,2786,212,217088,12668,2432256,2649344
train,2787,63,64512,1119,214848,279360
train,2788,44,45056,546,104832,149888
train,2789,56,57344,884,169728,227072
train,2790,71,72704,1421,272832,345536
train,2791,87,89088,2133,409536,498624
train,2792,46,47104,597,114624,161728
train,2793,217,222208,13272,2548224,2770432
train,2794,58,59392,948,182016,241408
train,2795,37,37888,386,74112,112000
train,2796,53,54272,792,152064,206336
train,2797,62,63488,1084,208128,271616
train,2798,63,64512,1119,214848,279360
train,2799,239,244736,16099,3091008,3335744
train,2800,51,52224,733,140736,192960
train,2801,24,24576,163,31296,55872
train,2802,119,121856,3991,766272,888128
train,2803,39,39936,429,82368,122304
train,2804,142,145408,5683,1091136,1236544
train,2805,60,61440,1015,194880,256320
train,2806,85,87040,2037,391104,478144
train,2807,121,123904,4127,792384,916288
train,2808,22,22528,137,26304,48832
train,2809,33,33792,307,58944,92736
train,2810,80,81920,1804,346368,428288
train,2811,60,61440,1015,194880,256320
train,2812,62,63488,1084,208128,271616
train,2813,102,104448,2933,563136,667584
train,2814,112,114688,3536,678912,793600
train,2815,133,136192,4986,957312,1093504
train,2816,52,53248,762,146304,199552
train,2817,28,28672,221,42432,71104
train,2818,74,75776,1544,296448,372224
train,2819,75,76800,1586,304512,381312
train,2820,17,17408,82,15744,33152
train,2821,110,112640,3411,654912,767552
train,2822,136,139264,5213,1000896,1140160
train,2823,64,65536,1155,221760,287296
train,2824,14,14336,55,10560,24896
train,2825,29,29696,237,45504,75200
train,2826,17,17408,82,15744,33152
train,2827,62,63488,1084,208128,271616
train,2828,28,28672,221,42432,71104
train,2829,75,76800,1586,304512,381312
train,2830,178,182272,8930,1714560,1896832
train,2831,134,137216,5061,971712,1108928
train,2832,23,23552,149,28608,52160
train,2833,43,44032,521,100032,144064
train,2834,197,201728,10938,2100096,2301824
train,2835,30,30720,254,48768,79488
train,2836,116,118784,3793,728256,847040
train,2837,61,62464,1049,201408,263872
train,2838,67,68608,1265,242880,311488
train,2839,134,137216,5061,971712,1108928
train,2840,54,55296,822,157824,213120
train,2841,24,24576,163,31296,55872
train,2842,15,15360,64,12288,27648
train,2843,42,43008,497,95424,138432
train,2844,29,29696,237,45504,75200
train,2845,167,171008,7861,1509312,1680320
train,2846,20,20480,113,21696,42176
train,2847,19,19456,102,19584,39040
train,2848,196,200704,10827,2078784,2279488
train,2849,28,28672,221,42432,71104
train,2850,101,103424,2875,552000,655424
train,2851,32,32768,289,55488,88256
train,2852,83,84992,1942,372864,457856
train,2853,71,72704,1421,272832,345536
train,2854,41,41984,474,91008,132992
train,2855,25,25600,176,33792,59392
train,2856,22,22528,137,26304,48832
train,2857,74,75776,1544,296448,372224
train,2858,21,21504,125,24000,45504
train,2859,27,27648,206,39552,67200
train,2860,115,117760,3728,715776,833536
train,2861,66,67584,1228,235776,303360
train,2862,28,28672,221,42432,71104
train,2863,281,287744,22255,4272960,4560704
train,2864,31,31744,271,52032,83776
train,2865,39,39936,429,82368,122304
train,2866,22,22528,137,26304,48832
train,2867,54,55296,822,157824,213120
train,2868,35,35840,345,66240,102080
train,2869,15,15360,64,12288,27648
train,2870,17,17408,82,15744,33152
train,2871,188,192512,9962,1912704,2105216
train,2872,59,60416,981,188352,248768
train,2873,74,75776,1544,296448,372224
train,2874,33,33792,307,58944,92736
train,2875,70,71680,1381,265152,336832
train,2876,77,78848,1671,320832,399680
train,2877,56,57344,884,169728,227072
train,2878,79,80896,1759,337728,418624
train,2879,141,144384,5604,1075968,1220352
train,2880,79,80896,1759,337728,418624
train,2881,40,40960,451,86592,127552
train,2882,19,19456,102,19584,39040
train,2883,78,79872,1715,329280,409152
train,2884,63,64512,1119,214848,279360
train,2885,28,28672,221,42432,71104
train,2886,62,63488,1084,208128,271616
train,2887,24,24576,163,31296,55872
train,2888,55,56320,853,163776,220096
train,2889,170,174080,8145,1563840,1737920
train,2890,23,23552,149,28608,52160
train,2891,89,91136,2233,428736,519872
train,2892,30,30720,254,48768,79488
train,2893,102,104448,2933,563136,667584
train,2894,37,37888,386,74112,112000
train,2895,68,69632,1303,250176,319808
train,2896,11,11264,34,6528,17792
train,2897,28,28672,221,42432,71104
train,2898,57,58368,916,175872,234240
train,2899,14,14336,55,10560,24896
train,2900,54,55296,822,157824,213120
train,2901,66,67584,1228,235776,303360
train,2902,66,67584,1228,235776,303360
train,2903,93,95232,2438,468096,563328
train,2904,18,18432,92,17664,36096
train,2905,54,55296,822,157824,213120
train,2906,119,121856,3991,766272,888128
train,2907,50,51200,705,135360,186560
train,2908,42,43008,497,95424,138432
train,2909,46,47104,597,114624,161728
train,2910,160,163840,7215,1385280,1549120
train,2911,108,110592,3288,631296,741888
train,2912,78,79872,1715,329280,409152
train,2913,94,96256,2491,478272,574528
train,2914,73,74752,1502,288384,363136
train,2915,86,88064,2085,400320,488384
train,2916,25,25600,176,33792,59392
train,2917,47,48128,623,119616,167744
train,2918,43,44032,521,100032,144064
train,2919,37,37888,386,74112,112000
train,2920,23,23552,149,28608,52160
train,2921,24,24576,163,31296,55872
train,2922,36,36864,365,70080,106944
train,2923,57,58368,916,175872,234240
train,2924,25,25600,176,33792,59392
train,2925,430,440320,52113,10005696,10446016
train,2926,48,49152,650,124800,173952
train,2927,58,59392,948,182016,241408
train,2928,21,21504,125,24000,45504
train,2929,96,98304,2598,498816,597120
train,2930,9,9216,23,4416,13632
train,2931,214,219136,12907,2478144,2697280
train,2932,91,93184,2334,448128,541312
train,2933,15,15360,64,12288,27648
train,2934,348,356352,34132,6553344,6909696
train,2935,23,23552,149,28608,52160
train,2936,21,21504,125,24000,45504
train,2937,31,31744,271,52032,83776
train,2938,18,18432,92,17664,36096
train,2939,92,94208,2386,458112,552320
train,2940,59,60416,981,188352,248768
train,2941,14,14336,55,10560,24896
train,2942,20,20480,113,21696,42176
train,2943,14,14336,55,10560,24896
train,2944,67,68608,1265,242880,311488
train,2945,28,28672,221,42432,71104
train,2946,81,82944,1849,355008,437952
train,2947,41,41984,474,91008,132992
train,2948,96,98304,2598,498816,597120
train,2949,14,14336,55,10560,24896
train,2950,82,83968,1895,363840,447808
train,2951,97,99328,2652,509184,608512
train,2952,49,50176,677,129984,180160
train,2953,62,63488,1084,208128,271616
train,2954,25,25600,176,33792,59392
train,2955,78,79872,1715,329280,409152
train,2956,15,15360,64,12288,27648
train,2957,118,120832,3925,753600,874432
train,2958,80,81920,1804,346368,428288
train,2959,55,56320,853,163776,220096
train,2960,89,91136,2233,428736,519872
train,2961,65,66560,1191,228672,295232
train,2962,16,16384,72,13824,30208
train,2963,58,59392,948,182016,241408
train,2964,85,87040,2037,391104,478144
train,2965,45,46080,571,109632,155712
train,2966,24,24576,163,31296,55872
train,2967,52,53248,762,146304,199552
train,2968,19,19456,102,19584,39040
train,2969,28,28672,221,42432,71104
train,2970,24,24576,163,31296,55872
train,2971,38,38912,407,78144,117056
train,2972,96,98304,2598,498816,597120
train,2973,21,21504,125,24000,45504
train,2974,272,278528,20852,4003584,4282112
train,2975,28,28672,221,42432,71104
train,2976,25,25600,176,33792,59392
train,2977,46,47104,597,114624,161728
train,2978,96,98304,2598,498816,597120
train,2979,22,22528,137,26304,48832
train,2980,30,30720,254,48768,79488
train,2981,216,221184,13150,2524800,2745984
train,2982,75,76800,1586,304512,381312
train,2983,29,29696,237,45504,75200
train,2984,44,45056,546,104832,149888
train,2985,26,26624,191,36672,63296
train,2986,23,23552,149,28608,52160
train,2987,38,38912,407,78144,117056
train,2988,29,29696,237,45504,75200
train,2989,118,120832,3925,753600,874432
train,2990,69,70656,1342,257664,328320
train,2991,27,27648,206,39552,67200
train,2992,85,87040,2037,391104,478144
train,2993,18,18432,92,17664,36096
train,2994,72,73728,1461,280512,354240
train,2995,23,23552,149,28608,52160
train,2996,14,14336,55,10560,24896
train,2997,12,12288,41,7872,20160
train,2998,393,402432,43530,8357760,8760192
train,2999,176,180224,8731,1676352,1856576
train,3000,68,69632,1303,250176,319808
train,3001,216,221184,13150,2524800,2745984
train,3002,102,104448,2933,563136,667584
train,3003,24,24576,163,31296,55872
train,3004,75,76800,1586,304512,381312
train,3005,16,16384,72,13824,30208
train,3006,26,26624,191,36672,63296
train,3007,48,49152,650,124800,173952
train,3008,74,75776,1544,296448,372224
train,3009,14,14336,55,10560,24896
train,3010,173,177152,8435,1619520,1796672
train,3011,69,70656,1342,257664,328320
train,3012,42,43008,497,95424,138432
train,3013,90,92160,2283,438336,530496
train,3014,90,92160,2283,438336,530496
train,3015,39,39936,429,82368,122304
train,3016,75,76800,1586,304512,381312
train,3017,13,13312,48,9216,22528
train,3018,64,65536,1155,221760,287296
train,3019,36,36864,365,70080,106944
train,3020,42,43008,497,95424,138432
train,3021,14,14336,55,10560,24896
train,3022,283,289792,22573,4334016,4623808
train,3023,44,45056,546,104832,149888
train,3024,66,67584,1228,235776,303360
train,3025,73,74752,1502,288384,363136
train,3026,24,24576,163,31296,55872
train,3027,19,19456,102,19584,39040
train,3028,23,23552,149,28608,52160
train,3029,36,36864,365,70080,106944
train,3030,24,24576,163,31296,55872
train,3031,35,35840,345,66240,102080
train,3032,33,33792,307,58944,92736
train,3033,79,80896,1759,337728,418624
train,3034,92,94208,2386,458112,552320
train,3035,67,68608,1265,242880,311488
train,3036,45,46080,571,109632,155712
train,3037,23,23552,149,28608,52160
train,3038,22,22528,137,26304,48832
train,3039,72,73728,1461,280512,354240
train,3040,38,38912,407,78144,117056
train,3041,25,25600,176,33792,59392
train,3042,196,200704,10827,2078784,2279488
train,3043,61,62464,1049,201408,263872
train,3044,56,57344,884,169728,227072
train,3045,37,37888,386,74112,112000
train,3046,10,10240,28,5376,15616
train,3047,34,34816,326,62592,97408
train,3048,13,13312,48,9216,22528
train,3049,24,24576,163,31296,55872
train,3050,21,21504,125,24000,45504
train,3051,30,30720,254,48768,79488
train,3052,77,78848,1671,320832,399680
train,3053,34,34816,326,62592,97408
train,3054,21,21504,125,24000,45504
train,3055,28,28672,221,42432,71104
train,3056,43,44032,521,100032,144064
train,3057,23,23552,149,28608,52160
train,3058,48,49152,650,124800,173952
train,3059,39,39936,429,82368,122304
train,3060,73,74752,1502,288384,363136
train,3061,96,98304,2598,498816,597120
train,3062,79,80896,1759,337728,418624
train,3063,25,25600,176,33792,59392
train,3064,34,34816,326,62592,97408
train,3065,21,21504,125,24000,45504
train,3066,77,78848,1671,320832,399680
train,3067,24,24576,163,31296,55872
train,3068,74,75776,1544,296448,372224
train,3069,28,28672,221,42432,71104
train,3070,152,155648,6512,1250304,1405952
train,3071,45,46080,571,109632,155712
train,3072,37,37888,386,74112,112000
train,3073,199,203776,11161,2142912,2346688
train,3074,66,67584,1228,235776,303360
train,3075,72,73728,1461,280512,354240
train,3076,36,36864,365,70080,106944
train,3077,42,43008,497,95424,138432
train,3078,38,38912,407,78144,117056
train,3079,28,28672,221,42432,71104
train,3080,41,41984,474,91008,132992
train,3081,66,67584,1228,235776,303360
train,3082,10,10240,28,5376,15616
train,3083,76,77824,1628,312576,390400
train,3084,81,82944,1849,355008,437952
train,3085,144,147456,5844,1122048,1269504
train,3086,30,30720,254,48768,79488
train,3087,155,158720,6771,1300032,1458752
train,3088,26,26624,191,36672,63296
train,3089,48,49152,650,124800,173952
train,3090,18,18432,92,17664,36096
train,3091,56,57344,884,169728,227072
train,3092,60,61440,1015,194880,256320
train,3093,115,117760,3728,715776,833536
train,3094,112,114688,3536,678912,793600
train,3095,20,20480,113,21696,42176
train,3096,65,66560,1191,228672,295232
train,3097,85,87040,2037,391104,478144
train,3098,27,27648,206,39552,67200
train,3099,24,24576,163,31296,55872
train,3100,85,87040,2037,391104,478144
train,3101,66,67584,1228,235776,303360
train,3102,13,13312,48,9216,22528
train,3103,68,69632,1303,250176,319808
train,3104,86,88064,2085,400320,488384
train,3105,53,54272,792,152064,206336
train,3106,28,28672,221,42432,71104
train,3107,349,357376,34329,6591168,6948544
train,3108,61,62464,1049,201408,263872
train,3109,19,19456,102,19584,39040
train,3110,81,82944,1849,355008,437952
train,3111,60,61440,1015,194880,256320
train,3112,132,135168,4911,942912,1078080
train,3113,71,72704,1421,272832,345536
train,3114,79,80896,1759,337728,418624
train,3115,42,43008,497,95424,138432
train,3116,211,216064,12548,2409216,2625280
train,3117,54,55296,822,157824,213120
train,3118,21,21504,125,24000,45504
train,3119,116,118784,3793,728256,847040
train,3120,31,31744,271,52032,83776
train,3121,127,130048,4546,872832,1002880
train,3122,42,43008,497,95424,138432
train,3123,63,64512,1119,214848,279360
train,3124,67,68608,1265,242880,311488
train,3125,76,77824,1628,312576,390400
train,3126,22,22528,137,26304,48832
train,3127,70,71680,1381,265152,336832
train,3128,27,27648,206,39552,67200
train,3129,71,72704,1421,272832,345536
train,3130,41,41984,474,91008,132992
train,3131,17,17408,82,15744,33152
train,3132,79,80896,1759,337728,418624
train,3133,25,25600,176,33792,59392
train,3134,37,37888,386,74112,112000
train,3135,109,111616,3349,643008,754624
train,3136,67,68608,1265,242880,311488
train,3137,24,24576,163,31296,55872
train,3138,82,83968,1895,363840,447808
train,3139,48,49152,650,124800,173952
train,3140,44,45056,546,104832,149888
train,3141,42,43008,497,95424,138432
train,3142,24,24576,163,31296,55872
train,3143,55,56320,853,163776,220096
train,3144,68,69632,1303,250176,319808
train,3145,61,62464,1049,201408,263872
train,3146,60,61440,1015,194880,256320
train,3147,25,25600,176,33792,59392
train,3148,30,30720,254,48768,79488
train,3149,51,52224,733,140736,192960
train,3150,44,45056,546,104832,149888
train,3151,14,14336,55,10560,24896
train,3152,10,10240,28,5376,15616
train,3153,23,23552,149,28608,52160
train,3154,25,25600,176,33792,59392
train,3155,70,71680,1381,265152,336832
train,3156,18,18432,92,17664,36096
train,3157,49,50176,677,129984,180160
train,3158,25,25600,176,33792,59392
train,3159,151,154624,6426,1233792,1388416
train,3160,12,12288,41,7872,20160
train,3161,46,47104,597,114624,161728
train,3162,21,21504,125,24000,45504
train,3163,21,21504,125,24000,45504
train,3164,28,28672,221,42432,71104
train,3165,111,113664,3473,666816,780480
train,3166,26,26624,191,36672,63296
train,3167,43,44032,521,100032,144064
train,3168,119,121856,3991,766272,888128
train,3169,74,75776,1544,296448,372224
train,3170,13,13312,48,9216,22528
train,3171,41,41984,474,91008,132992
train,3172,122,124928,4195,805440,930368
train,3173,14,14336,55,10560,24896
train,3174,25,25600,176,33792,59392
train,3175,55,56320,853,163776,220096
train,3176,163,166912,7488,1437696,1604608
train,3177,54,55296,822,157824,213120
train,3178,56,57344,884,169728,227072
train,3179,21,21504,125,24000,45504
train,3180,23,23552,149,28608,52160
train,3181,115,117760,3728,715776,833536
train,3182,43,44032,521,100032,144064
train,3183,211,216064,12548,2409216,2625280
train,3184,11,11264,34,6528,17792
train,3185,117,119808,3858,740736,860544
train,3186,65,66560,1191,228672,295232
train,3187,24,24576,163,31296,55872
train,3188,15,15360,64,12288,27648
train,3189,111,113664,3473,666816,780480
train,3190,13,13312,48,9216,22528
train,3191,14,14336,55,10560,24896
train,3192,69,70656,1342,257664,328320
train,3193,148,151552,6174,1185408,1336960
train,3194,64,65536,1155,221760,287296
train,3195,46,47104,597,114624,161728
train,3196,396,405504,44198,8486016,8891520
train,3197,40,40960,451,86592,127552
train,3198,81,82944,1849,355008,437952
train,3199,42,43008,497,95424,138432
train,3200,23,23552,149,28608,52160
train,3201,44,45056,546,104832,149888
train,3202,105,107520,3108,596736,704256
train,3203,15,15360,64,12288,27648
train,3204,13,13312,48,9216,22528
train,3205,10,10240,28,5376,15616
train,3206,8,8192,18,3456,11648
train,3207,11,11264,34,6528,17792
train,3208,58,59392,948,182016,241408
train,3209,127,130048,4546,872832,1002880
train,3210,112,114688,3536,678912,793600
train,3211,52,53248,762,146304,199552
train,3212,25,25600,176,33792,59392
train,3213,29,29696,237,45504,75200
train,3214,77,78848,1671,320832,399680
train,3215,61,62464,1049,201408,263872
train,3216,64,65536,1155,221760,287296
train,3217,52,53248,762,146304,199552
train,3218,25,25600,176,33792,59392
train,3219,94,96256,2491,478272,574528
train,3220,35,35840,345,66240,102080
train,3221,15,15360,64,12288,27648
train,3222,13,13312,48,9216,22528
train,3223,181,185344,9234,1772928,1958272
train,3224,33,33792,307,58944,92736
train,3225,200,204800,11274,2164608,2369408
train,3226,87,89088,2133,409536,498624
train,3227,169,173056,8050,1545600,1718656
train,3228,28,28672,221,42432,71104
train,3229,25,25600,176,33792,59392
train,3230,190,194560,10175,1953600,2148160
train,3231,51,52224,733,140736,192960
train,3232,291,297984,23867,4582464,4880448
train,3233,99,101376,2763,530496,631872
train,3234,25,25600,176,33792,59392
train,3235,65,66560,1191,228672,295232
train,3236,64,65536,1155,221760,287296
train,3237,23,23552,149,28608,52160
train,3238,163,166912,7488,1437696,1604608
train,3239,94,96256,2491,478272,574528
train,3240,151,154624,6426,1233792,1388416
train,3241,56,57344,884,169728,227072
train,3242,47,48128,623,119616,167744
train,3243,72,73728,1461,280512,354240
train,3244,164,167936,7581,1455552,1623488
train,3245,177,181248,8830,1695360,1876608
train,3246,25,25600,176,33792,59392
train,3247,40,40960,451,86592,127552
train,3248,71,72704,1421,272832,345536
train,3249,27,27648,206,39552,67200
train,3250,135,138240,5137,986304,1124544
train,3251,41,41984,474,91008,132992
train,3252,20,20480,113,21696,42176
train,3253,76,77824,1628,312576,390400
train,3254,37,37888,386,74112,112000
train,3255,57,58368,916,175872,234240
train,3256,25,25600,176,33792,59392
train,3257,17,17408,82,15744,33152
train,3258,44,45056,546,104832,149888
train,3259,11,11264,34,6528,17792
train,3260,79,80896,1759,337728,418624
train,3261,151,154624,6426,1233792,1388416
train,3262,77,78848,1671,320832,399680
train,3263,82,83968,1895,363840,447808
train,3264,42,43008,497,95424,138432
train,3265,38,38912,407,78144,117056
train,3266,132,135168,4911,942912,1078080
train,3267,14,14336,55,10560,24896
train,3268,66,67584,1228,235776,303360
train,3269,89,91136,2233,428736,519872
train,3270,67,68608,1265,242880,311488
train,3271,151,154624,6426,1233792,1388416
train,3272,32,32768,289,55488,88256
train,3273,29,29696,237,45504,75200
train,3274,17,17408,82,15744,33152
train,3275,164,167936,7581,1455552,1623488
train,3276,21,21504,125,24000,45504
train,3277,38,38912,407,78144,117056
train,3278,23,23552,149,28608,52160
train,3279,88,90112,2183,419136,509248
train,3280,72,73728,1461,280512,354240
train,3281,84,86016,1989,381888,467904
train,3282,24,24576,163,31296,55872
train,3283,60,61440,1015,194880,256320
train,3284,129,132096,4690,900480,1032576
train,3285,63,64512,1119,214848,279360
train,3286,101,103424,2875,552000,655424
train,3287,44,45056,546,104832,149888
train,3288,172,176128,8338,1600896,1777024
train,3289,74,75776,1544,296448,372224
train,3290,10,10240,28,5376,15616
train,3291,59,60416,981,188352,248768
train,3292,91,93184,2334,448128,541312
train,3293,56,57344,884,169728,227072
train,3294,10,10240,28,5376,15616
train,3295,48,49152,650,124800,173952
train,3296,42,43008,497,95424,138432
train,3297,128,131072,4618,886656,1017728
train,3298,39,39936,429,82368,122304
train,3299,39,39936,429,82368,122304
train,3300,14,14336,55,10560,24896
train,3301,56,57344,884,169728,227072
train,3302,45,46080,571,109632,155712
train,3303,124,126976,4334,832128,959104
train,3304,342,350208,32966,6329472,6679680
train,3305,12,12288,41,7872,20160
train,3306,62,63488,1084,208128,271616
train,3307,87,89088,2133,409536,498624
train,3308,18,18432,92,17664,36096
train,3309,71,72704,1421,272832,345536
train,3310,32,32768,289,55488,88256
train,3311,213,218112,12787,2455104,2673216
train,3312,105,107520,3108,596736,704256
train,3313,67,68608,1265,242880,311488
train,3314,14,14336,55,10560,24896
train,3315,192,196608,10390,1994880,2191488
train,3316,21,21504,125,24000,45504
train,3317,114,116736,3663,703296,820032
train,3318,50,51200,705,135360,186560
train,3319,128,131072,4618,886656,1017728
train,3320,54,55296,822,157824,213120
train,3321,67,68608,1265,242880,311488
train,3322,12,12288,41,7872,20160
train,3323,56,57344,884,169728,227072
train,3324,24,24576,163,31296,55872
train,3325,99,101376,2763,530496,631872
train,3326,37,37888,386,74112,112000
train,3327,14,14336,55,10560,24896
train,3328,65,66560,1191,228672,295232
train,3329,106,108544,3167,608064,716608
train,3330,56,57344,884,169728,227072
train,3331,13,13312,48,9216,22528
train,3332,13,13312,48,9216,22528
train,3333,97,99328,2652,509184,608512
train,3334,162,165888,7397,1420224,1586112
train,3335,152,155648,6512,1250304,1405952
train,3336,35,35840,345,66240,102080
train,3337,228,233472,14651,2812992,3046464
train,3338,47,48128,623,119616,167744
train,3339,72,73728,1461,280512,354240
train,3340,79,80896,1759,337728,418624
train,3341,19,19456,102,19584,39040
train,3342,12,12288,41,7872,20160
train,3343,67,68608,1265,242880,311488
train,3344,14,14336,55,10560,24896
train,3345,29,29696,237,45504,75200
train,3346,34,34816,326,62592,97408
train,3347,79,80896,1759,337728,418624
train,3348,121,123904,4127,792384,916288
train,3349,25,25600,176,33792,59392
train,3350,13,13312,48,9216,22528
train,3351,137,140288,5290,1015680,1155968
train,3352,66,67584,1228,235776,303360
train,3353,24,24576,163,31296,55872
train,3354,24,24576,163,31296,55872
train,3355,40,40960,451,86592,127552
train,3356,27,27648,206,39552,67200
train,3357,140,143360,5524,1060608,1203968
train,3358,33,33792,307,58944,92736
train,3359,140,143360,5524,1060608,1203968
train,3360,167,171008,7861,1509312,1680320
train,3361,163,166912,7488,1437696,1604608
train,3362,25,25600,176,33792,59392
train,3363,280,286720,22097,4242624,4529344
train,3364,46,47104,597,114624,161728
train,3365,35,35840,345,66240,102080
train,3366,102,104448,2933,563136,667584
train,3367,16,16384,72,13824,30208
train,3368,104,106496,3049,585408,691904
train,3369,39,39936,429,82368,122304
train,3370,49,50176,677,129984,180160
train,3371,37,37888,386,74112,112000
train,3372,36,36864,365,70080,106944
train,3373,105,107520,3108,596736,704256
train,3374,61,62464,1049,201408,263872
train,3375,33,33792,307,58944,92736
train,3376,23,23552,149,28608,52160
train,3377,28,28672,221,42432,71104
train,3378,79,80896,1759,337728,418624
train,3379,384,393216,41559,7979328,8372544
train,3380,35,35840,345,66240,102080
train,3381,23,23552,149,28608,52160
train,3382,92,94208,2386,458112,552320
train,3383,57,58368,916,175872,234240
train,3384,39,39936,429,82368,122304
train,3385,14,14336,55,10560,24896
train,3386,48,49152,650,124800,173952
train,3387,74,75776,1544,296448,372224
train,3388,20,20480,113,21696,42176
train,3389,45,46080,571,109632,155712
train,3390,24,24576,163,31296,55872
train,3391,31,31744,271,52032,83776
train,3392,23,23552,149,28608,52160
train,3393,78,79872,1715,329280,409152
train,3394,47,48128,623,119616,167744
train,3395,180,184320,9132,1753344,1937664
train,3396,44,45056,546,104832,149888
train,3397,21,21504,125,24000,45504
train,3398,129,132096,4690,900480,1032576
train,3399,12,12288,41,7872,20160
train,3400,205,209920,11845,2274240,2484160
train,3401,88,90112,2183,419136,509248
train,3402,144,147456,5844,1122048,1269504
train,3403,50,51200,705,135360,186560
train,3404,46,47104,597,114624,161728
train,3405,54,55296,822,157824,213120
train,3406,170,174080,8145,1563840,1737920
train,3407,46,47104,597,114624,161728
train,3408,20,20480,113,21696,42176
train,3409,34,34816,326,62592,97408
train,3410,82,83968,1895,363840,447808
train,3411,73,74752,1502,288384,363136
train,3412,84,86016,1989,381888,467904
train,3413,47,48128,623,119616,167744
train,3414,348,356352,34132,6553344,6909696
train,3415,82,83968,1895,363840,447808
train,3416,24,24576,163,31296,55872
train,3417,82,83968,1895,363840,447808
train,3418,164,167936,7581,1455552,1623488
train,3419,42,43008,497,95424,138432
train,3420,28,28672,221,42432,71104
train,3421,137,140288,5290,1015680,1155968
train,3422,24,24576,163,31296,55872
train,3423,47,48128,623,119616,167744
train,3424,16,16384,72,13824,30208
train,3425,51,52224,733,140736,192960
train,3426,88,90112,2183,419136,509248
train,3427,92,94208,2386,458112,552320
train,3428,31,31744,271,52032,83776
train,3429,22,22528,137,26304,48832
train,3430,43,44032,521,100032,144064
train,3431,86,88064,2085,400320,488384
train,3432,144,147456,5844,1122048,1269504
train,3433,194,198656,10608,2036736,2235392
train,3434,40,40960,451,86592,127552
train,3435,138,141312,5368,1030656,1171968
train,3436,16,16384,72,13824,30208
train,3437,132,135168,4911,942912,1078080
train,3438,273,279552,21006,4033152,4312704
train,3439,80,81920,1804,346368,428288
train,3440,66,67584,1228,235776,303360
train,3441,50,51200,705,135360,186560
train,3442,73,74752,1502,288384,363136
train,3443,19,19456,102,19584,39040
train,3444,114,116736,3663,703296,820032
train,3445,64,65536,1155,221760,287296
train,3446,22,22528,137,26304,48832
train,3447,69,70656,1342,257664,328320
train,3448,127,130048,4546,872832,1002880
train,3449,152,155648,6512,1250304,1405952
train,3450,11,11264,34,6528,17792
train,3451,15,15360,64,12288,27648
train,3452,18,18432,92,17664,36096
train,3453,27,27648,206,39552,67200
train,3454,94,96256,2491,478272,574528
train,3455,14,14336,55,10560,24896
train,3456,49,50176,677,129984,180160
train,3457,44,45056,546,104832,149888
train,3458,89,91136,2233,428736,519872
train,3459,21,21504,125,24000,45504
train,3460,54,55296,822,157824,213120
train,3461,24,24576,163,31296,55872
train,3462,34,34816,326,62592,97408
train,3463,260,266240,19053,3658176,3924416
train,3464,50,51200,705,135360,186560
train,3465,13,13312,48,9216,22528
train,3466,76,77824,1628,312576,390400
train,3467,25,25600,176,33792,59392
train,3468,67,68608,1265,242880,311488
train,3469,79,80896,1759,337728,418624
train,3470,19,19456,102,19584,39040
train,3471,13,13312,48,9216,22528
train,3472,71,72704,1421,272832,345536
train,3473,354,362496,35320,6781440,7143936
train,3474,20,20480,113,21696,42176
train,3475,27,27648,206,39552,67200
train,3476,15,15360,64,12288,27648
train,3477,32,32768,289,55488,88256
train,3478,60,61440,1015,194880,256320
train,3479,68,69632,1303,250176,319808
train,3480,79,80896,1759,337728,418624
train,3481,94,96256,2491,478272,574528
train,3482,172,176128,8338,1600896,1777024
train,3483,31,31744,271,52032,83776
train,3484,63,64512,1119,214848,279360
train,3485,46,47104,597,114624,161728
train,3486,97,99328,2652,509184,608512
train,3487,138,141312,5368,1030656,1171968
train,3488,75,76800,1586,304512,381312
train,3489,29,29696,237,45504,75200
train,3490,79,80896,1759,337728,418624
train,3491,42,43008,497,95424,138432
train,3492,50,51200,705,135360,186560
train,3493,20,20480,113,21696,42176
train,3494,87,89088,2133,409536,498624
train,3495,9,9216,23,4416,13632
train,3496,214,219136,12907,2478144,2697280
train,3497,141,144384,5604,1075968,1220352
train,3498,60,61440,1015,194880,256320
train,3499,102,104448,2933,563136,667584
train,3500,13,13312,48,9216,22528
train,3501,66,67584,1228,235776,303360
train,3502,24,24576,163,31296,55872
train,3503,135,138240,5137,986304,1124544
train,3504,58,59392,948,182016,241408
train,3505,257,263168,18616,3574272,3837440
train,3506,60,61440,1015,194880,256320
train,3507,24,24576,163,31296,55872
train,3508,134,137216,5061,971712,1108928
train,3509,19,19456,102,19584,39040
train,3510,126,129024,4475,859200,988224
train,3511,270,276480,20547,3945024,4221504
train,3512,144,147456,5844,1122048,1269504
train,3513,36,36864,365,70080,106944
train,3514,18,18432,92,17664,36096
train,3515,95,97280,2544,488448,585728
train,3516,61,62464,1049,201408,263872
train,3517,68,69632,1303,250176,319808
train,3518,208,212992,12194,2341248,2554240
train,3519,30,30720,254,48768,79488
train,3520,62,63488,1084,208128,271616
train,3521,78,79872,1715,329280,409152
train,3522,25,25600,176,33792,59392
train,3523,30,30720,254,48768,79488
train,3524,149,152576,6257,1201344,1353920
train,3525,63,64512,1119,214848,279360
train,3526,14,14336,55,10560,24896
train,3527,38,38912,407,78144,117056
train,3528,38,38912,407,78144,117056
train,3529,36,36864,365,70080,106944
train,3530,68,69632,1303,250176,319808
train,3531,43,44032,521,100032,144064
train,3532,77,78848,1671,320832,399680
train,3533,14,14336,55,10560,24896
train,3534,164,167936,7581,1455552,1623488
train,3535,60,61440,1015,194880,256320
train,3536,71,72704,1421,272832,345536
train,3537,14,14336,55,10560,24896
train,3538,18,18432,92,17664,36096
train,3539,120,122880,4059,779328,902208
train,3540,38,38912,407,78144,117056
train,3541,18,18432,92,17664,36096
train,3542,21,21504,125,24000,45504
train,3543,39,39936,429,82368,122304
train,3544,35,35840,345,66240,102080
train,3545,255,261120,18327,3518784,3779904
train,3546,55,56320,853,163776,220096
train,3547,22,22528,137,26304,48832
train,3548,134,137216,5061,971712,1108928
train,3549,51,52224,733,140736,192960
train,3550,23,23552,149,28608,52160
train,3551,15,15360,64,12288,27648
train,3552,31,31744,271,52032,83776
train,3553,108,110592,3288,631296,741888
train,3554,63,64512,1119,214848,279360
train,3555,36,36864,365,70080,106944
train,3556,33,33792,307,58944,92736
train,3557,137,140288,5290,1015680,1155968
train,3558,299,306176,25197,4837824,5144000
train,3559,75,76800,1586,304512,381312
train,3560,37,37888,386,74112,112000
train,3561,151,154624,6426,1233792,1388416
train,3562,64,65536,1155,221760,287296
train,3563,25,25600,176,33792,59392
train,3564,67,68608,1265,242880,311488
train,3565,162,165888,7397,1420224,1586112
train,3566,90,92160,2283,438336,530496
train,3567,85,87040,2037,391104,478144
train,3568,11,11264,34,6528,17792
train,3569,157,160768,6947,1333824,1494592
train,3570,41,41984,474,91008,132992
train,3571,32,32768,289,55488,88256
train,3572,45,46080,571,109632,155712
train,3573,46,47104,597,114624,161728
train,3574,177,181248,8830,1695360,1876608
train,3575,109,111616,3349,643008,754624
train,3576,22,22528,137,26304,48832
train,3577,19,19456,102,19584,39040
train,3578,36,36864,365,70080,106944
train,3579,25,25600,176,33792,59392
train,3580,74,75776,1544,296448,372224
train,3581,24,24576,163,31296,55872
train,3582,50,51200,705,135360,186560
train,3583,27,27648,206,39552,67200
train,3584,115,117760,3728,715776,833536
train,3585,142,145408,5683,1091136,1236544
train,3586,81,82944,1849,355008,437952
train,3587,213,218112,12787,2455104,2673216
train,3588,161,164864,7306,1402752,1567616
train,3589,46,47104,597,114624,161728
train,3590,30,30720,254,48768,79488
train,3591,58,59392,948,182016,241408
train,3592,58,59392,948,182016,241408
train,3593,22,22528,137,26304,48832
train,3594,50,51200,705,135360,186560
train,3595,56,57344,884,169728,227072
train,3596,46,47104,597,114624,161728
train,3597,67,68608,1265,242880,311488
train,3598,51,52224,733,140736,192960
train,3599,17,17408,82,15744,33152
train,3600,103,105472,2990,574080,679552
train,3601,139,142336,5446,1045632,1187968
train,3602,27,27648,206,39552,67200
train,3603,27,27648,206,39552,67200
train,3604,68,69632,1303,250176,319808
train,3605,103,105472,2990,574080,679552
train,3606,67,68608,1265,242880,311488
train,3607,182,186368,9336,1792512,1978880
train,3608,43,44032,521,100032,144064
train,3609,73,74752,1502,288384,363136
train,3610,124,126976,4334,832128,959104
train,3611,336,344064,31819,6109248,6453312
train,3612,65,66560,1191,228672,295232
train,3613,26,26624,191,36672,63296
train,3614,195,199680,10717,2057664,2257344
train,3615,59,60416,981,188352,248768
train,3616,97,99328,2652,509184,608512
train,3617,79,80896,1759,337728,418624
train,3618,40,40960,451,86592,127552
train,3619,126,129024,4475,859200,988224
train,3620,47,48128,623,119616,167744
train,3621,80,81920,1804,346368,428288
train,3622,25,25600,176,33792,59392
train,3623,74,75776,1544,296448,372224
train,3624,67,68608,1265,242880,311488
train,3625,59,60416,981,188352,248768
train,3626,32,32768,289,55488,88256
train,3627,72,73728,1461,280512,354240
train,3628,42,43008,497,95424,138432
train,3629,70,71680,1381,265152,336832
train,3630,28,28672,221,42432,71104
train,3631,38,38912,407,78144,117056
train,3632,52,53248,762,146304,199552
train,3633,12,12288,41,7872,20160
train,3634,54,55296,822,157824,213120
train,3635,27,27648,206,39552,67200
train,3636,131,134144,4837,928704,1062848
train,3637,49,50176,677,129984,180160
train,3638,27,27648,206,39552,67200
train,3639,383,392192,41343,7937856,8330048
train,3640,17,17408,82,15744,33152
train,3641,66,67584,1228,235776,303360
train,3642,103,105472,2990,574080,679552
train,3643,23,23552,149,28608,52160
train,3644,25,25600,176,33792,59392
train,3645,48,49152,650,124800,173952
train,3646,19,19456,102,19584,39040
train,3647,15,15360,64,12288,27648
train,3648,84,86016,1989,381888,467904
train,3649,75,76800,1586,304512,381312
train,3650,20,20480,113,21696,42176
train,3651,25,25600,176,33792,59392
train,3652,39,39936,429,82368,122304
train,3653,15,15360,64,12288,27648
train,3654,105,107520,3108,596736,704256
train,3655,34,34816,326,62592,97408
train,3656,58,59392,948,182016,241408
train,3657,39,39936,429,82368,122304
train,3658,20,20480,113,21696,42176
train,3659,106,108544,3167,608064,716608
train,3660,126,129024,4475,859200,988224
train,3661,14,14336,55,10560,24896
train,3662,158,161792,7036,1350912,1512704
train,3663,19,19456,102,19584,39040
train,3664,48,49152,650,124800,173952
train,3665,22,22528,137,26304,48832
train,3666,99,101376,2763,530496,631872
train,3667,32,32768,289,55488,88256
train,3668,23,23552,149,28608,52160
train,3669,48,49152,650,124800,173952
train,3670,183,187392,9439,1812288,1999680
train,3671,108,110592,3288,631296,741888
train,3672,99,101376,2763,530496,631872
train,3673,23,23552,149,28608,52160
train,3674,152,155648,6512,1250304,1405952
train,3675,32,32768,289,55488,88256
train,3676,128,131072,4618,886656,1017728
train,3677,115,117760,3728,715776,833536
train,3678,37,37888,386,74112,112000
train,3679,22,22528,137,26304,48832
train,3680,127,130048,4546,872832,1002880
train,3681,92,94208,2386,458112,552320
train,3682,60,61440,1015,194880,256320
train,3683,61,62464,1049,201408,263872
train,3684,16,16384,72,13824,30208
train,3685,78,79872,1715,329280,409152
train,3686,115,117760,3728,715776,833536
train,3687,24,24576,163,31296,55872
train,3688,17,17408,82,15744,33152
train,3689,82,83968,1895,363840,447808
train,3690,25,25600,176,33792,59392
train,3691,70,71680,1381,265152,336832
train,3692,23,23552,149,28608,52160
train,3693,13,13312,48,9216,22528
train,3694,90,92160,2283,438336,530496
train,3695,69,70656,1342,257664,328320
train,3696,43,44032,521,100032,144064
train,3697,56,57344,884,169728,227072
train,3698,41,41984,474,91008,132992
train,3699,24,24576,163,31296,55872
train,3700,37,37888,386,74112,112000
train,3701,22,22528,137,26304,48832
train,3702,24,24576,163,31296,55872
train,3703,49,50176,677,129984,180160
train,3704,65,66560,1191,228672,295232
train,3705,111,113664,3473,666816,780480
train,3706,33,33792,307,58944,92736
train,3707,112,114688,3536,678912,793600
train,3708,16,16384,72,13824,30208
train,3709,135,138240,5137,986304,1124544
train,3710,39,39936,429,82368,122304
train,3711,50,51200,705,135360,186560
train,3712,122,124928,4195,805440,930368
train,3713,77,78848,1671,320832,399680
train,3714,27,27648,206,39552,67200
train,3715,24,24576,163,31296,55872
train,3716,27,27648,206,39552,67200
train,3717,26,26624,191,36672,63296
train,3718,14,14336,55,10560,24896
train,3719,120,122880,4059,779328,902208
train,3720,70,71680,1381,265152,336832
train,3721,35,35840,345,66240,102080
train,3722,24,24576,163,31296,55872
train,3723,51,52224,733,140736,192960
train,3724,31,31744,271,52032,83776
train,3725,46,47104,597,114624,161728
train,3726,55,56320,853,163776,220096
train,3727,37,37888,386,74112,112000
train,3728,155,158720,6771,1300032,1458752
train,3729,96,98304,2598,498816,597120
train,3730,53,54272,792,152064,206336
train,3731,32,32768,289,55488,88256
train,3732,55,56320,853,163776,220096
train,3733,48,49152,650,124800,173952
train,3734,326,333824,29953,5750976,6084800
train,3735,42,43008,497,95424,138432
train,3736,133,136192,4986,957312,1093504
train,3737,20,20480,113,21696,42176
train,3738,49,50176,677,129984,180160
train,3739,100,102400,2819,541248,643648
train,3740,133,136192,4986,957312,1093504
train,3741,12,12288,41,7872,20160
train,3742,20,20480,113,21696,42176
train,3743,50,51200,705,135360,186560
train,3744,37,37888,386,74112,112000
train,3745,118,120832,3925,753600,874432
train,3746,67,68608,1265,242880,311488
train,3747,125,128000,4404,845568,973568
train,3748,24,24576,163,31296,55872
train,3749,13,13312,48,9216,22528
train,3750,41,41984,474,91008,132992
train,3751,70,71680,1381,265152,336832
train,3752,27,27648,206,39552,67200
train,3753,65,66560,1191,228672,295232
train,3754,21,21504,125,24000,45504
train,3755,97,99328,2652,509184,608512
train,3756,33,33792,307,58944,92736
train,3757,29,29696,237,45504,75200
train,3758,27,27648,206,39552,67200
train,3759,69,70656,1342,257664,328320
train,3760,396,405504,44198,8486016,8891520
train,3761,293,300032,24196,4645632,4945664
train,3762,28,28672,221,42432,71104
train,3763,39,39936,429,82368,122304
train,3764,32,32768,289,55488,88256
train,3765,168,172032,7955,1527360,1699392
train,3766,192,196608,10390,1994880,2191488
train,3767,84,86016,1989,381888,467904
train,3768,123,125952,4264,818688,944640
train,3769,21,21504,125,24000,45504
train,3770,24,24576,163,31296,55872
train,3771,94,96256,2491,478272,574528
train,3772,21,21504,125,24000,45504
train,3773,41,41984,474,91008,132992
train,3774,28,28672,221,42432,71104
train,3775,45,46080,571,109632,155712
train,3776,70,71680,1381,265152,336832
train,3777,76,77824,1628,312576,390400
train,3778,34,34816,326,62592,97408
train,3779,43,44032,521,100032,144064
train,3780,89,91136,2233,428736,519872
train,3781,67,68608,1265,242880,311488
train,3782,49,50176,677,129984,180160
train,3783,131,134144,4837,928704,1062848
train,3784,18,18432,92,17664,36096
train,3785,39,39936,429,82368,122304
train,3786,46,47104,597,114624,161728
train,3787,149,152576,6257,1201344,1353920
train,3788,40,40960,451,86592,127552
train,3789,120,122880,4059,779328,902208
train,3790,85,87040,2037,391104,478144
train,3791,137,140288,5290,1015680,1155968
train,3792,80,81920,1804,346368,428288
train,3793,86,88064,2085,400320,488384
train,3794,184,188416,9542,1832064,2020480
train,3795,81,82944,1849,355008,437952
train,3796,42,43008,497,95424,138432
train,3797,63,64512,1119,214848,279360
train,3798,25,25600,176,33792,59392
train,3799,25,25600,176,33792,59392
train,3800,27,27648,206,39552,67200
train,3801,91,93184,2334,448128,541312
train,3802,15,15360,64,12288,27648
train,3803,16,16384,72,13824,30208
train,3804,25,25600,176,33792,59392
train,3805,47,48128,623,119616,167744
train,3806,52,53248,762,146304,199552
train,3807,67,68608,1265,242880,311488
train,3808,41,41984,474,91008,132992
train,3809,124,126976,4334,832128,959104
train,3810,102,104448,2933,563136,667584
train,3811,69,70656,1342,257664,328320
train,3812,12,12288,41,7872,20160
train,3813,48,49152,650,124800,173952
train,3814,108,110592,3288,631296,741888
train,3815,87,89088,2133,409536,498624
train,3816,133,136192,4986,957312,1093504
train,3817,41,41984,474,91008,132992
train,3818,28,28672,221,42432,71104
train,3819,40,40960,451,86592,127552
train,3820,140,143360,5524,1060608,1203968
train,3821,74,75776,1544,296448,372224
train,3822,214,219136,12907,2478144,2697280
train,3823,13,13312,48,9216,22528
train,3824,74,75776,1544,296448,372224
train,3825,18,18432,92,17664,36096
train,3826,73,74752,1502,288384,363136
train,3827,67,68608,1265,242880,311488
train,3828,46,47104,597,114624,161728
train,3829,193,197632,10499,2015808,2213440
train,3830,10,10240,28,5376,15616
train,3831,327,334848,30137,5786304,6121152
train,3832,14,14336,55,10560,24896
train,3833,52,53248,762,146304,199552
train,3834,54,55296,822,157824,213120
train,3835,46,47104,597,114624,161728
train,3836,28,28672,221,42432,71104
train,3837,106,108544,3167,608064,716608
train,3838,54,55296,822,157824,213120
train,3839,27,27648,206,39552,67200
train,3840,78,79872,1715,329280,409152
train,3841,77,78848,1671,320832,399680
train,3842,10,10240,28,5376,15616
train,3843,30,30720,254,48768,79488
train,3844,39,39936,429,82368,122304
train,3845,36,36864,365,70080,106944
train,3846,185,189440,9646,1852032,2041472
train,3847,46,47104,597,114624,161728
train,3848,44,45056,546,104832,149888
train,3849,227,232448,14523,2788416,3020864
train,3850,28,28672,221,42432,71104
train,3851,24,24576,163,31296,55872
train,3852,138,141312,5368,1030656,1171968
train,3853,42,43008,497,95424,138432
train,3854,31,31744,271,52032,83776
train,3855,11,11264,34,6528,17792
train,3856,113,115712,3599,691008,806720
train,3857,17,17408,82,15744,33152
train,3858,25,25600,176,33792,59392
train,3859,69,70656,1342,257664,328320
train,3860,14,14336,55,10560,24896
train,3861,14,14336,55,10560,24896
train,3862,21,21504,125,24000,45504
train,3863,82,83968,1895,363840,447808
train,3864,141,144384,5604,1075968,1220352
train,3865,33,33792,307,58944,92736
train,3866,47,48128,623,119616,167744
train,3867,35,35840,345,66240,102080
train,3868,35,35840,345,66240,102080
train,3869,47,48128,623,119616,167744
train,3870,27,27648,206,39552,67200
train,3871,17,17408,82,15744,33152
train,3872,48,49152,650,124800,173952
train,3873,39,39936,429,82368,122304
train,3874,258,264192,18761,3602112,3866304
train,3875,16,16384,72,13824,30208
train,3876,59,60416,981,188352,248768
train,3877,38,38912,407,78144,117056
train,3878,115,117760,3728,715776,833536
train,3879,76,77824,1628,312576,390400
train,3880,27,27648,206,39552,67200
train,3881,20,20480,113,21696,42176
train,3882,14,14336,55,10560,24896
train,3883,118,120832,3925,753600,874432
train,3884,12,12288,41,7872,20160
train,3885,336,344064,31819,6109248,6453312
train,3886,21,21504,125,24000,45504
train,3887,31,31744,271,52032,83776
train,3888,35,35840,345,66240,102080
train,3889,74,75776,1544,296448,372224
train,3890,22,22528,137,26304,48832
train,3891,35,35840,345,66240,102080
train,3892,80,81920,1804,346368,428288
train,3893,225,230400,14268,2739456,2969856
train,3894,97,99328,2652,509184,608512
train,3895,20,20480,113,21696,42176
train,3896,24,24576,163,31296,55872
train,3897,30,30720,254,48768,79488
train,3898,68,69632,1303,250176,319808
train,3899,202,206848,11500,2208000,2414848
train,3900,48,49152,650,124800,173952
train,3901,76,77824,1628,312576,390400
train,3902,58,59392,948,182016,241408
train,3903,62,63488,1084,208128,271616
train,3904,28,28672,221,42432,71104
train,3905,18,18432,92,17664,36096
train,3906,154,157696,6684,1283328,1441024
train,3907,132,135168,4911,942912,1078080
train,3908,24,24576,163,31296,55872
train,3909,75,76800,1586,304512,381312
train,3910,20,20480,113,21696,42176
train,3911,30,30720,254,48768,79488
train,3912,46,47104,597,114624,161728
train,3913,114,116736,3663,703296,820032
train,3914,76,77824,1628,312576,390400
train,3915,133,136192,4986,957312,1093504
train,3916,85,87040,2037,391104,478144
train,3917,51,52224,733,140736,192960
train,3918,147,150528,6091,1169472,1320000
train,3919,177,181248,8830,1695360,1876608
train,3920,165,168960,7673,1473216,1642176
train,3921,22,22528,137,26304,48832
train,3922,17,17408,82,15744,33152
train,3923,17,17408,82,15744,33152
train,3924,84,86016,1989,381888,467904
train,3925,46,47104,597,114624,161728
train,3926,107,109568,3227,619584,729152
train,3927,26,26624,191,36672,63296
train,3928,49,50176,677,129984,180160
train,3929,53,54272,792,152064,206336
train,3930,61,62464,1049,201408,263872
train,3931,121,123904,4127,792384,916288
train,3932,40,40960,451,86592,127552
train,3933,27,27648,206,39552,67200
train,3934,77,78848,1671,320832,399680
train,3935,215,220160,13028,2501376,2721536
train,3936,22,22528,137,26304,48832
train,3937,26,26624,191,36672,63296
train,3938,25,25600,176,33792,59392
train,3939,39,39936,429,82368,122304
train,3940,175,179200,8632,1657344,1836544
train,3941,27,27648,206,39552,67200
train,3942,337,345088,32009,6145728,6490816
train,3943,22,22528,137,26304,48832
train,3944,70,71680,1381,265152,336832
train,3945,83,84992,1942,372864,457856
train,3946,71,72704,1421,272832,345536
train,3947,11,11264,34,6528,17792
train,3948,27,27648,206,39552,67200
train,3949,15,15360,64,12288,27648
train,3950,12,12288,41,7872,20160
train,3951,49,50176,677,129984,180160
train,3952,35,35840,345,66240,102080
train,3953,63,64512,1119,214848,279360
train,3954,26,26624,191,36672,63296
train,3955,136,139264,5213,1000896,1140160
train,3956,146,149504,6008,1153536,1303040
train,3957,96,98304,2598,498816,597120
train,3958,17,17408,82,15744,33152
train,3959,76,77824,1628,312576,390400
train,3960,28,28672,221,42432,71104
train,3961,23,23552,149,28608,52160
train,3962,26,26624,191,36672,63296
train,3963,161,164864,7306,1402752,1567616
train,3964,47,48128,623,119616,167744
train,3965,19,19456,102,19584,39040
train,3966,64,65536,1155,221760,287296
train,3967,59,60416,981,188352,248768
train,3968,75,76800,1586,304512,381312
train,3969,52,53248,762,146304,199552
train,3970,94,96256,2491,478272,574528
train,3971,27,27648,206,39552,67200
train,3972,80,81920,1804,346368,428288
train,3973,79,80896,1759,337728,418624
train,3974,27,27648,206,39552,67200
train,3975,83,84992,1942,372864,457856
train,3976,93,95232,2438,468096,563328
train,3977,88,90112,2183,419136,509248
train,3978,79,80896,1759,337728,418624
train,3979,31,31744,271,52032,83776
train,3980,51,52224,733,140736,192960
train,3981,34,34816,326,62592,97408
train,3982,94,96256,2491,478272,574528
train,3983,72,73728,1461,280512,354240
train,3984,41,41984,474,91008,132992
train,3985,75,76800,1586,304512,381312
train,3986,130,133120,4763,914496,1047616
train,3987,38,38912,407,78144,117056
train,3988,24,24576,163,31296,55872
train,3989,48,49152,650,124800,173952
train,3990,185,189440,9646,1852032,2041472
train,3991,20,20480,113,21696,42176
train,3992,170,174080,8145,1563840,1737920
train,3993,125,128000,4404,845568,973568
train,3994,75,76800,1586,304512,381312
train,3995,110,112640,3411,654912,767552
train,3996,71,72704,1421,272832,345536
train,3997,25,25600,176,33792,59392
train,3998,20,20480,113,21696,42176
train,3999,53,54272,792,152064,206336
train,4000,80,81920,1804,346368,428288
train,4001,65,66560,1191,228672,295232
train,4002,22,22528,137,26304,48832
train,4003,58,59392,948,182016,241408
train,4004,60,61440,1015,194880,256320
train,4005,41,41984,474,91008,132992
train,4006,29,29696,237,45504,75200
train,4007,143,146432,5764,1106688,1253120
train,4008,32,32768,289,55488,88256
train,4009,32,32768,289,55488,88256
train,4010,59,60416,981,188352,248768
train,4011,109,111616,3349,643008,754624
train,4012,12,12288,41,7872,20160
train,4013,33,33792,307,58944,92736
train,4014,235,240640,15565,2988480,3229120
train,4015,37,37888,386,74112,112000
train,4016,97,99328,2652,509184,608512
train,4017,56,57344,884,169728,227072
train,4018,70,71680,1381,265152,336832
train,4019,23,23552,149,28608,52160
train,4020,63,64512,1119,214848,279360
train,4021,102,104448,2933,563136,667584
train,4022,60,61440,1015,194880,256320
train,4023,62,63488,1084,208128,271616
train,4024,354,362496,35320,6781440,7143936
train,4025,32,32768,289,55488,88256
train,4026,138,141312,5368,1030656,1171968
train,4027,34,34816,326,62592,97408
train,4028,163,166912,7488,1437696,1604608
train,4029,49,50176,677,129984,180160
train,4030,54,55296,822,157824,213120
train,4031,63,64512,1119,214848,279360
train,4032,28,28672,221,42432,71104
train,4033,31,31744,271,52032,83776
train,4034,42,43008,497,95424,138432
train,4035,18,18432,92,17664,36096
train,4036,224,229376,14142,2715264,2944640
train,4037,45,46080,571,109632,155712
train,4038,115,117760,3728,715776,833536
train,4039,48,49152,650,124800,173952
train,4040,21,21504,125,24000,45504
train,4041,56,57344,884,169728,227072
train,4042,82,83968,1895,363840,447808
train,4043,107,109568,3227,619584,729152
train,4044,332,339968,31066,5964672,6304640
train,4045,82,83968,1895,363840,447808
train,4046,197,201728,10938,2100096,2301824
train,4047,19,19456,102,19584,39040
train,4048,59,60416,981,188352,248768
train,4049,45,46080,571,109632,155712
train,4050,42,43008,497,95424,138432
train,4051,70,71680,1381,265152,336832
train,4052,139,142336,5446,1045632,1187968
train,4053,91,93184,2334,448128,541312
train,4054,43,44032,521,100032,144064
train,4055,49,50176,677,129984,180160
train,4056,50,51200,705,135360,186560
train,4057,104,106496,3049,585408,691904
train,4058,25,25600,176,33792,59392
train,4059,63,64512,1119,214848,279360
train,4060,171,175104,8242,1582464,1757568
train,4061,10,10240,28,5376,15616
train,4062,29,29696,237,45504,75200
train,4063,74,75776,1544,296448,372224
train,4064,82,83968,1895,363840,447808
train,4065,81,82944,1849,355008,437952
train,4066,205,209920,11845,2274240,2484160
train,4067,110,112640,3411,654912,767552
train,4068,205,209920,11845,2274240,2484160
train,4069,43,44032,521,100032,144064
train,4070,38,38912,407,78144,117056
train,4071,48,49152,650,124800,173952
train,4072,11,11264,34,6528,17792
train,4073,25,25600,176,33792,59392
train,4074,198,202752,11050,2121600,2324352
train,4075,54,55296,822,157824,213120
train,4076,202,206848,11501,2208192,2415040
train,4077,72,73728,1461,280512,354240
train,4078,24,24576,163,31296,55872
train,4079,128,131072,4618,886656,1017728
train,4080,27,27648,206,39552,67200
train,4081,22,22528,137,26304,48832
train,4082,44,45056,546,104832,149888
train,4083,49,50176,677,129984,180160
train,4084,102,104448,2933,563136,667584
train,4085,41,41984,474,91008,132992
train,4086,274,280576,21160,4062720,4343296
train,4087,24,24576,163,31296,55872
train,4088,72,73728,1461,280512,354240
train,4089,82,83968,1895,363840,447808
train,4090,44,45056,546,104832,149888
train,4091,30,30720,254,48768,79488
train,4092,13,13312,48,9216,22528
train,4093,158,161792,7036,1350912,1512704
train,4094,221,226304,13766,2643072,2869376
train,4095,33,33792,307,58944,92736
train,4096,29,29696,237,45504,75200
train,4097,60,61440,1015,194880,256320
train,4098,66,67584,1228,235776,303360
train,4099,118,120832,3925,753600,874432
train,4100,69,70656,1342,257664,328320
train,4101,26,26624,191,36672,63296
train,4102,68,69632,1303,250176,319808
train,4103,71,72704,1421,272832,345536
train,4104,23,23552,149,28608,52160
train,4105,41,41984,474,91008,132992
train,4106,181,185344,9234,1772928,1958272
train,4107,59,60416,981,188352,248768
train,4108,85,87040,2037,391104,478144
train,4109,150,153600,6342,1217664,1371264
train,4110,84,86016,1989,381888,467904
train,4111,23,23552,149,28608,52160
train,4112,133,136192,4986,957312,1093504
train,4113,43,44032,521,100032,144064
train,4114,107,109568,3227,619584,729152
train,4115,257,263168,18616,3574272,3837440
train,4116,210,215040,12429,2386368,2601408
train,4117,110,112640,3411,654912,767552
train,4118,123,125952,4264,818688,944640
train,4119,215,220160,13028,2501376,2721536
train,4120,80,81920,1804,346368,428288
train,4121,21,21504,125,24000,45504
train,4122,134,137216,5061,971712,1108928
train,4123,41,41984,474,91008,132992
train,4124,65,66560,1191,228672,295232
train,4125,23,23552,149,28608,52160
train,4126,24,24576,163,31296,55872
train,4127,107,109568,3227,619584,729152
train,4128,27,27648,206,39552,67200
train,4129,313,320512,27612,5301504,5622016
train,4130,74,75776,1544,296448,372224
train,4131,79,80896,1759,337728,418624
train,4132,117,119808,3858,740736,860544
train,4133,70,71680,1381,265152,336832
train,4134,16,16384,72,13824,30208
train,4135,38,38912,407,78144,117056
train,4136,75,76800,1586,304512,381312
train,4137,137,140288,5290,1015680,1155968
train,4138,43,44032,521,100032,144064
train,4139,98,100352,2707,519744,620096
train,4140,192,196608,10390,1994880,2191488
train,4141,67,68608,1265,242880,311488
train,4142,111,113664,3473,666816,780480
train,4143,55,56320,853,163776,220096
train,4144,50,51200,705,135360,186560
train,4145,143,146432,5764,1106688,1253120
train,4146,57,58368,916,175872,234240
train,4147,63,64512,1119,214848,279360
train,4148,48,49152,650,124800,173952
train,4149,105,107520,3108,596736,704256
train,4150,105,107520,3108,596736,704256
train,4151,156,159744,6859,1316928,1476672
train,4152,63,64512,1119,214848,279360
train,4153,14,14336,55,10560,24896
train,4154,56,57344,884,169728,227072
train,4155,16,16384,72,13824,30208
train,4156,86,88064,2085,400320,488384
train,4157,43,44032,521,100032,144064
train,4158,177,181248,8830,1695360,1876608
train,4159,39,39936,429,82368,122304
train,4160,34,34816,326,62592,97408
train,4161,72,73728,1461,280512,354240
train,4162,27,27648,206,39552,67200
train,4163,32,32768,289,55488,88256
train,4164,33,33792,307,58944,92736
train,4165,35,35840,345,66240,102080
train,4166,146,149504,6008,1153536,1303040
train,4167,76,77824,1628,312576,390400
train,4168,18,18432,92,17664,36096
train,4169,22,22528,137,26304,48832
train,4170,25,25600,176,33792,59392
train,4171,73,74752,1502,288384,363136
train,4172,43,44032,521,100032,144064
train,4173,50,51200,705,135360,186560
train,4174,59,60416,981,188352,248768
train,4175,51,52224,733,140736,192960
train,4176,37,37888,386,74112,112000
train,4177,23,23552,149,28608,52160
train,4178,28,28672,221,42432,71104
train,4179,48,49152,650,124800,173952
train,4180,205,209920,11845,2274240,2484160
train,4181,73,74752,1502,288384,363136
train,4182,47,48128,623,119616,167744
train,4183,34,34816,326,62592,97408
train,4184,108,110592,3288,631296,741888
train,4185,107,109568,3227,619584,729152
train,4186,223,228352,14016,2691072,2919424
train,4187,53,54272,792,152064,206336
train,4188,81,82944,1849,355008,437952
train,4189,108,110592,3288,631296,741888
train,4190,108,110592,3288,631296,741888
train,4191,52,53248,762,146304,199552
train,4192,30,30720,254,48768,79488
train,4193,57,58368,916,175872,234240
train,4194,43,44032,521,100032,144064
train,4195,19,19456,102,19584,39040
train,4196,18,18432,92,17664,36096
train,4197,44,45056,546,104832,149888
train,4198,54,55296,822,157824,213120
train,4199,40,40960,451,86592,127552
train,4200,411,420864,47609,9140928,9561792
train,4201,76,77824,1628,312576,390400
train,4202,74,75776,1544,296448,372224
train,4203,265,271360,19793,3800256,4071616
train,4204,83,84992,1942,372864,457856
train,4205,55,56320,853,163776,220096
train,4206,70,71680,1381,265152,336832
train,4207,35,35840,345,66240,102080
train,4208,29,29696,237,45504,75200
train,4209,24,24576,163,31296,55872
train,4210,28,28672,221,42432,71104
train,4211,31,31744,271,52032,83776
train,4212,42,43008,497,95424,138432
train,4213,267,273408,20092,3857664,4131072
train,4214,42,43008,497,95424,138432
train,4215,41,41984,474,91008,132992
train,4216,84,86016,1989,381888,467904
train,4217,13,13312,48,9216,22528
train,4218,43,44032,521,100032,144064
train,4219,227,232448,14523,2788416,3020864
train,4220,31,31744,271,52032,83776
train,4221,38,38912,407,78144,117056
train,4222,34,34816,326,62592,97408
train,4223,39,39936,429,82368,122304
train,4224,24,24576,163,31296,55872
train,4225,76,77824,1628,312576,390400
train,4226,35,35840,345,66240,102080
train,4227,28,28672,221,42432,71104
train,4228,37,37888,386,74112,112000
train,4229,75,76800,1586,304512,381312
train,4230,37,37888,386,74112,112000
train,4231,135,138240,5137,986304,1124544
train,4232,329,336896,30507,5857344,6194240
train,4233,81,82944,1849,355008,437952
train,4234,44,45056,546,104832,149888
train,4235,24,24576,163,31296,55872
train,4236,24,24576,163,31296,55872
train,4237,60,61440,1015,194880,256320
train,4238,37,37888,386,74112,112000
train,4239,25,25600,176,33792,59392
train,4240,161,164864,7306,1402752,1567616
train,4241,58,59392,948,182016,241408
train,4242,59,60416,981,188352,248768
train,4243,147,150528,6091,1169472,1320000
train,4244,48,49152,650,124800,173952
train,4245,28,28672,221,42432,71104
train,4246,64,65536,1155,221760,287296
train,4247,32,32768,289,55488,88256
train,4248,23,23552,149,28608,52160
train,4249,45,46080,571,109632,155712
train,4250,21,21504,125,24000,45504
train,4251,50,51200,705,135360,186560
train,4252,13,13312,48,9216,22528
train,4253,178,182272,8930,1714560,1896832
train,4254,166,169984,7767,1491264,1661248
train,4255,57,58368,916,175872,234240
train,4256,116,118784,3793,728256,847040
train,4257,70,71680,1381,265152,336832
train,4258,32,32768,289,55488,88256
train,4259,55,56320,853,163776,220096
train,4260,102,104448,2933,563136,667584
train,4261,23,23552,149,28608,52160
train,4262,63,64512,1119,214848,279360
train,4263,21,21504,125,24000,45504
train,4264,14,14336,55,10560,24896
train,4265,72,73728,1461,280512,354240
train,4266,89,91136,2233,428736,519872
train,4267,31,31744,271,52032,83776
train,4268,114,116736,3663,703296,820032
train,4269,28,28672,221,42432,71104
train,4270,132,135168,4911,942912,1078080
train,4271,48,49152,650,124800,173952
train,4272,133,136192,4986,957312,1093504
train,4273,41,41984,474,91008,132992
train,4274,79,80896,1759,337728,418624
train,4275,54,55296,822,157824,213120
train,4276,13,13312,48,9216,22528
train,4277,36,36864,365,70080,106944
train,4278,94,96256,2491,478272,574528
train,4279,97,99328,2652,509184,608512
train,4280,32,32768,289,55488,88256
train,4281,38,38912,407,78144,117056
train,4282,75,76800,1586,304512,381312
train,4283,21,21504,125,24000,45504
train,4284,54,55296,822,157824,213120
train,4285,91,93184,2334,448128,541312
train,4286,59,60416,981,188352,248768
train,4287,71,72704,1421,272832,345536
train,4288,76,77824,1628,312576,390400
train,4289,28,28672,221,42432,71104
train,4290,131,134144,4837,928704,1062848
train,4291,253,259072,18041,3463872,3722944
train,4292,123,125952,4264,818688,944640
train,4293,40,40960,451,86592,127552
train,4294,71,72704,1421,272832,345536
train,4295,302,309248,25705,4935360,5244608
train,4296,128,131072,4618,886656,1017728
train,4297,67,68608,1265,242880,311488
train,4298,121,123904,4127,792384,916288
train,4299,106,108544,3167,608064,716608
train,4300,36,36864,365,70080,106944
train,4301,48,49152,650,124800,173952
train,4302,11,11264,34,6528,17792
train,4303,111,113664,3473,666816,780480
train,4304,130,133120,4763,914496,1047616
train,4305,135,138240,5137,986304,1124544
train,4306,82,83968,1895,363840,447808
train,4307,316,323584,28144,5403648,5727232
train,4308,140,143360,5524,1060608,1203968
train,4309,58,59392,948,182016,241408
train,4310,64,65536,1155,221760,287296
train,4311,48,49152,650,124800,173952
train,4312,53,54272,792,152064,206336
train,4313,24,24576,163,31296,55872
train,4314,25,25600,176,33792,59392
train,4315,49,50176,677,129984,180160
train,4316,31,31744,271,52032,83776
train,4317,105,107520,3108,596736,704256
train,4318,110,112640,3411,654912,767552
train,4319,126,129024,4475,859200,988224
train,4320,14,14336,55,10560,24896
train,4321,22,22528,137,26304,48832
train,4322,39,39936,429,82368,122304
train,4323,74,75776,1544,296448,372224
train,4324,89,91136,2233,428736,519872
train,4325,38,38912,407,78144,117056
train,4326,48,49152,650,124800,173952
train,4327,66,67584,1228,235776,303360
train,4328,59,60416,981,188352,248768
train,4329,63,64512,1119,214848,279360
train,4330,56,57344,884,169728,227072
train,4331,52,53248,762,146304,199552
train,4332,39,39936,429,82368,122304
train,4333,76,77824,1628,312576,390400
train,4334,16,16384,72,13824,30208
train,4335,266,272384,19942,3828864,4101248
train,4336,63,64512,1119,214848,279360
train,4337,90,92160,2283,438336,530496
train,4338,71,72704,1421,272832,345536
train,4339,135,138240,5137,986304,1124544
train,4340,30,30720,254,48768,79488
train,4341,54,55296,822,157824,213120
train,4342,117,119808,3858,740736,860544
train,4343,26,26624,191,36672,63296
train,4344,50,51200,705,135360,186560
train,4345,46,47104,597,114624,161728
train,4346,15,15360,64,12288,27648
train,4347,63,64512,1119,214848,279360
train,4348,145,148480,5926,1137792,1286272
train,4349,39,39936,429,82368,122304
train,4350,196,200704,10827,2078784,2279488
train,4351,23,23552,149,28608,52160
train,4352,48,49152,650,124800,173952
train,4353,13,13312,48,9216,22528
train,4354,132,135168,4911,942912,1078080
train,4355,16,16384,72,13824,30208
train,4356,11,11264,34,6528,17792
train,4357,366,374784,37755,7248960,7623744
train,4358,49,50176,677,129984,180160
train,4359,55,56320,853,163776,220096
train,4360,55,56320,853,163776,220096
train,4361,49,50176,677,129984,180160
train,4362,80,81920,1804,346368,428288
train,4363,29,29696,237,45504,75200
train,4364,14,14336,55,10560,24896
train,4365,56,57344,884,169728,227072
train,4366,56,57344,884,169728,227072
train,4367,15,15360,64,12288,27648
train,4368,119,121856,3991,766272,888128
train,4369,72,73728,1461,280512,354240
train,4370,290,296960,23703,4550976,4847936
train,4371,88,90112,2183,419136,509248
train,4372,56,57344,884,169728,227072
train,4373,176,180224,8731,1676352,1856576
train,4374,170,174080,8145,1563840,1737920
train,4375,16,16384,72,13824,30208
train,4376,59,60416,981,188352,248768
train,4377,55,56320,853,163776,220096
train,4378,51,52224,733,140736,192960
train,4379,50,51200,705,135360,186560
train,4380,40,40960,451,86592,127552
train,4381,25,25600,176,33792,59392
train,4382,139,142336,5446,1045632,1187968
train,4383,113,115712,3599,691008,806720
train,4384,63,64512,1119,214848,279360
train,4385,99,101376,2763,530496,631872
train,4386,79,80896,1759,337728,418624
train,4387,65,66560,1191,228672,295232
validation,0,32,32768,289,55488,88256
validation,1,55,56320,853,163776,220096
validation,2,39,39936,429,82368,122304
validation,3,35,35840,345,66240,102080
validation,4,26,26624,191,36672,63296
validation,5,45,46080,571,109632,155712
validation,6,23,23552,149,28608,52160
validation,7,64,65536,1155,221760,287296
validation,8,37,37888,386,74112,112000
validation,9,23,23552,149,28608,52160
validation,10,40,40960,451,86592,127552
validation,11,28,28672,221,42432,71104
validation,12,14,14336,55,10560,24896
validation,13,19,19456,102,19584,39040
validation,14,70,71680,1381,265152,336832
validation,15,85,87040,2037,391104,478144
validation,16,56,57344,884,169728,227072
validation,17,25,25600,176,33792,59392
validation,18,20,20480,113,21696,42176
validation,19,67,68608,1265,242880,311488
validation,20,65,66560,1191,228672,295232
validation,21,241,246784,16370,3143040,3389824
validation,22,74,75776,1544,296448,372224
validation,23,16,16384,72,13824,30208
validation,24,211,216064,12548,2409216,2625280
validation,25,21,21504,125,24000,45504
validation,26,33,33792,307,58944,92736
validation,27,69,70656,1342,257664,328320
validation,28,88,90112,2183,419136,509248
validation,29,99,101376,2763,530496,631872
validation,30,35,35840,345,66240,102080
validation,31,110,112640,3411,654912,767552
validation,32,22,22528,137,26304,48832
validation,33,17,17408,82,15744,33152
validation,34,43,44032,521,100032,144064
validation,35,41,41984,474,91008,132992
validation,36,40,40960,451,86592,127552
validation,37,15,15360,64,12288,27648
validation,38,374,382976,39423,7569216,7952192
validation,39,218,223232,13394,2571648,2794880
validation,40,48,49152,650,124800,173952
validation,41,225,230400,14268,2739456,2969856
validation,42,156,159744,6859,1316928,1476672
validation,43,60,61440,1015,194880,256320
validation,44,119,121856,3991,766272,888128
validation,45,194,198656,10608,2036736,2235392
validation,46,49,50176,677,129984,180160
validation,47,40,40960,451,86592,127552
validation,48,65,66560,1191,228672,295232
validation,49,59,60416,981,188352,248768
validation,50,41,41984,474,91008,132992
validation,51,51,52224,733,140736,192960
validation,52,24,24576,163,31296,55872
validation,53,317,324608,28322,5437824,5762432
validation,54,31,31744,271,52032,83776
validation,55,49,50176,677,129984,180160
validation,56,34,34816,326,62592,97408
validation,57,16,16384,72,13824,30208
validation,58,136,139264,5213,1000896,1140160
validation,59,308,315392,26737,5133504,5448896
validation,60,55,56320,853,163776,220096
validation,61,84,86016,1989,381888,467904
validation,62,44,45056,546,104832,149888
validation,63,13,13312,48,9216,22528
validation,64,43,44032,521,100032,144064
validation,65,48,49152,650,124800,173952
validation,66,47,48128,623,119616,167744
validation,67,28,28672,221,42432,71104
validation,68,40,40960,451,86592,127552
validation,69,41,41984,474,91008,132992
validation,70,51,52224,733,140736,192960
validation,71,117,119808,3858,740736,860544
validation,72,346,354304,33741,6478272,6832576
validation,73,202,206848,11500,2208000,2414848
validation,74,85,87040,2037,391104,478144
validation,75,101,103424,2875,552000,655424
validation,76,24,24576,163,31296,55872
validation,77,77,78848,1671,320832,399680
validation,78,180,184320,9132,1753344,1937664
validation,79,85,87040,2037,391104,478144
validation,80,203,207872,11615,2230080,2437952
validation,81,11,11264,34,6528,17792
validation,82,32,32768,289,55488,88256
validation,83,128,131072,4618,886656,1017728
validation,84,34,34816,326,62592,97408
validation,85,18,18432,92,17664,36096
validation,86,173,177152,8435,1619520,1796672
validation,87,114,116736,3663,703296,820032
validation,88,101,103424,2875,552000,655424
validation,89,35,35840,345,66240,102080
validation,90,40,40960,451,86592,127552
validation,91,212,217088,12667,2432064,2649152
validation,92,53,54272,792,152064,206336
validation,93,49,50176,677,129984,180160
validation,94,310,317440,27085,5200320,5517760
validation,95,59,60416,981,188352,248768
validation,96,21,21504,125,24000,45504
validation,97,56,57344,884,169728,227072
validation,98,121,123904,4127,792384,916288
validation,99,21,21504,125,24000,45504
validation,100,31,31744,271,52032,83776
validation,101,34,34816,326,62592,97408
validation,102,181,185344,9234,1772928,1958272
validation,103,43,44032,521,100032,144064
validation,104,297,304128,24861,4773312,5077440
validation,105,181,185344,9234,1772928,1958272
validation,106,19,19456,102,19584,39040
validation,107,61,62464,1049,201408,263872
validation,108,98,100352,2707,519744,620096
validation,109,10,10240,28,5376,15616
validation,110,70,71680,1381,265152,336832
validation,111,121,123904,4127,792384,916288
validation,112,32,32768,289,55488,88256
validation,113,26,26624,191,36672,63296
validation,114,38,38912,407,78144,117056
validation,115,12,12288,41,7872,20160
validation,116,12,12288,41,7872,20160
validation,117,342,350208,32966,6329472,6679680
validation,118,231,236544,15040,2887680,3124224
validation,119,46,47104,597,114624,161728
validation,120,90,92160,2283,438336,530496
validation,121,87,89088,2133,409536,498624
validation,122,133,136192,4986,957312,1093504
validation,123,32,32768,289,55488,88256
validation,124,86,88064,2085,400320,488384
validation,125,288,294912,23377,4488384,4783296
validation,126,37,37888,386,74112,112000
validation,127,88,90112,2183,419136,509248
validation,128,180,184320,9132,1753344,1937664
validation,129,388,397312,42430,8146560,8543872
validation,130,51,52224,733,140736,192960
validation,131,111,113664,3473,666816,780480
validation,132,58,59392,948,182016,241408
validation,133,242,247808,16506,3169152,3416960
validation,134,59,60416,981,188352,248768
validation,135,111,113664,3473,666816,780480
validation,136,55,56320,853,163776,220096
validation,137,38,38912,407,78144,117056
validation,138,118,120832,3925,753600,874432
validation,139,59,60416,981,188352,248768
validation,140,118,120832,3925,753600,874432
validation,141,54,55296,822,157824,213120
validation,142,91,93184,2334,448128,541312
validation,143,66,67584,1228,235776,303360
validation,144,204,208896,11729,2251968,2460864
validation,145,69,70656,1342,257664,328320
validation,146,13,13312,48,9216,22528
validation,147,70,71680,1381,265152,336832
validation,148,18,18432,92,17664,36096
validation,149,31,31744,271,52032,83776
validation,150,26,26624,191,36672,63296
validation,151,323,330752,29404,5645568,5976320
validation,152,130,133120,4763,914496,1047616
validation,153,157,160768,6947,1333824,1494592
validation,154,268,274432,20243,3886656,4161088
validation,155,47,48128,623,119616,167744
validation,156,405,414720,46229,8875968,9290688
validation,157,49,50176,677,129984,180160
validation,158,95,97280,2544,488448,585728
validation,159,14,14336,55,10560,24896
validation,160,87,89088,2133,409536,498624
validation,161,85,87040,2037,391104,478144
validation,162,52,53248,762,146304,199552
validation,163,38,38912,407,78144,117056
validation,164,53,54272,792,152064,206336
validation,165,69,70656,1342,257664,328320
validation,166,27,27648,206,39552,67200
validation,167,11,11264,34,6528,17792
validation,168,79,80896,1759,337728,418624
validation,169,204,208896,11729,2251968,2460864
validation,170,60,61440,1015,194880,256320
validation,171,113,115712,3599,691008,806720
validation,172,24,24576,163,31296,55872
validation,173,64,65536,1155,221760,287296
validation,174,55,56320,853,163776,220096
validation,175,73,74752,1502,288384,363136
validation,176,54,55296,822,157824,213120
validation,177,48,49152,650,124800,173952
validation,178,61,62464,1049,201408,263872
validation,179,25,25600,176,33792,59392
validation,180,131,134144,4837,928704,1062848
validation,181,37,37888,386,74112,112000
validation,182,95,97280,2544,488448,585728
validation,183,131,134144,4837,928704,1062848
validation,184,23,23552,149,28608,52160
validation,185,64,65536,1155,221760,287296
validation,186,146,149504,6008,1153536,1303040
validation,187,29,29696,237,45504,75200
validation,188,14,14336,55,10560,24896
validation,189,38,38912,407,78144,117056
validation,190,20,20480,113,21696,42176
validation,191,42,43008,497,95424,138432
validation,192,84,86016,1989,381888,467904
validation,193,24,24576,163,31296,55872
validation,194,45,46080,571,109632,155712
validation,195,27,27648,206,39552,67200
validation,196,23,23552,149,28608,52160
validation,197,48,49152,650,124800,173952
validation,198,64,65536,1155,221760,287296
validation,199,25,25600,176,33792,59392
validation,200,21,21504,125,24000,45504
validation,201,15,15360,64,12288,27648
validation,202,22,22528,137,26304,48832
validation,203,14,14336,55,10560,24896
validation,204,208,212992,12194,2341248,2554240
validation,205,34,34816,326,62592,97408
validation,206,50,51200,705,135360,186560
validation,207,10,10240,28,5376,15616
validation,208,35,35840,345,66240,102080
validation,209,94,96256,2491,478272,574528
validation,210,40,40960,451,86592,127552
validation,211,23,23552,149,28608,52160
validation,212,49,50176,677,129984,180160
validation,213,51,52224,733,140736,192960
validation,214,94,96256,2491,478272,574528
validation,215,123,125952,4264,818688,944640
validation,216,22,22528,137,26304,48832
validation,217,47,48128,623,119616,167744
validation,218,40,40960,451,86592,127552
validation,219,16,16384,72,13824,30208
validation,220,65,66560,1191,228672,295232
validation,221,48,49152,650,124800,173952
validation,222,62,63488,1084,208128,271616
validation,223,51,52224,733,140736,192960
validation,224,30,30720,254,48768,79488
validation,225,25,25600,176,33792,59392
validation,226,38,38912,407,78144,117056
validation,227,12,12288,41,7872,20160
validation,228,57,58368,916,175872,234240
validation,229,54,55296,822,157824,213120
validation,230,47,48128,623,119616,167744
validation,231,71,72704,1421,272832,345536
validation,232,86,88064,2085,400320,488384
validation,233,60,61440,1015,194880,256320
validation,234,21,21504,125,24000,45504
validation,235,9,9216,23,4416,13632
validation,236,134,137216,5061,971712,1108928
validation,237,51,52224,733,140736,192960
validation,238,26,26624,191,36672,63296
validation,239,47,48128,623,119616,167744
validation,240,84,86016,1989,381888,467904
validation,241,45,46080,571,109632,155712
validation,242,69,70656,1342,257664,328320
validation,243,12,12288,41,7872,20160
validation,244,58,59392,948,182016,241408
validation,245,13,13312,48,9216,22528
validation,246,118,120832,3925,753600,874432
validation,247,24,24576,163,31296,55872
validation,248,164,167936,7581,1455552,1623488
validation,249,98,100352,2707,519744,620096
validation,250,51,52224,733,140736,192960
validation,251,27,27648,206,39552,67200
validation,252,79,80896,1759,337728,418624
validation,253,48,49152,650,124800,173952
validation,254,56,57344,884,169728,227072
validation,255,16,16384,72,13824,30208
validation,256,131,134144,4837,928704,1062848
validation,257,24,24576,163,31296,55872
validation,258,212,217088,12667,2432064,2649152
validation,259,164,167936,7581,1455552,1623488
validation,260,23,23552,149,28608,52160
validation,261,49,50176,677,129984,180160
validation,262,45,46080,571,109632,155712
validation,263,59,60416,981,188352,248768
validation,264,53,54272,792,152064,206336
validation,265,21,21504,125,24000,45504
validation,266,36,36864,365,70080,106944
validation,267,28,28672,221,42432,71104
validation,268,46,47104,597,114624,161728
validation,269,188,192512,9962,1912704,2105216
validation,270,23,23552,149,28608,52160
validation,271,53,54272,792,152064,206336
validation,272,61,62464,1049,201408,263872
validation,273,37,37888,386,74112,112000
validation,274,73,74752,1502,288384,363136
validation,275,116,118784,3793,728256,847040
validation,276,76,77824,1628,312576,390400
validation,277,148,151552,6174,1185408,1336960
validation,278,68,69632,1303,250176,319808
validation,279,91,93184,2334,448128,541312
validation,280,14,14336,55,10560,24896
validation,281,57,58368,916,175872,234240
validation,282,69,70656,1342,257664,328320
validation,283,39,39936,429,82368,122304
validation,284,131,134144,4837,928704,1062848
validation,285,78,79872,1715,329280,409152
validation,286,81,82944,1849,355008,437952
validation,287,81,82944,1849,355008,437952
validation,288,26,26624,191,36672,63296
validation,289,12,12288,41,7872,20160
validation,290,16,16384,72,13824,30208
validation,291,67,68608,1265,242880,311488
validation,292,31,31744,271,52032,83776
validation,293,40,40960,451,86592,127552
validation,294,51,52224,733,140736,192960
validation,295,19,19456,102,19584,39040
validation,296,34,34816,326,62592,97408
validation,297,140,143360,5524,1060608,1203968
validation,298,20,20480,113,21696,42176
validation,299,96,98304,2598,498816,597120
validation,300,34,34816,326,62592,97408
validation,301,234,239616,15433,2963136,3202752
validation,302,103,105472,2990,574080,679552
validation,303,38,38912,407,78144,117056
validation,304,47,48128,623,119616,167744
validation,305,35,35840,345,66240,102080
validation,306,63,64512,1119,214848,279360
validation,307,23,23552,149,28608,52160
validation,308,10,10240,28,5376,15616
validation,309,70,71680,1381,265152,336832
validation,310,154,157696,6684,1283328,1441024
validation,311,91,93184,2334,448128,541312
validation,312,37,37888,386,74112,112000
validation,313,121,123904,4127,792384,916288
validation,314,60,61440,1015,194880,256320
validation,315,17,17408,82,15744,33152
validation,316,43,44032,521,100032,144064
validation,317,74,75776,1544,296448,372224
validation,318,180,184320,9132,1753344,1937664
validation,319,10,10240,28,5376,15616
validation,320,24,24576,163,31296,55872
validation,321,19,19456,102,19584,39040
validation,322,187,191488,9857,1892544,2084032
validation,323,43,44032,521,100032,144064
validation,324,14,14336,55,10560,24896
validation,325,49,50176,677,129984,180160
validation,326,25,25600,176,33792,59392
validation,327,87,89088,2133,409536,498624
validation,328,76,77824,1628,312576,390400
validation,329,260,266240,19053,3658176,3924416
validation,330,47,48128,623,119616,167744
validation,331,75,76800,1586,304512,381312
validation,332,51,52224,733,140736,192960
validation,333,29,29696,237,45504,75200
validation,334,130,133120,4763,914496,1047616
validation,335,30,30720,254,48768,79488
validation,336,251,257024,17757,3409344,3666368
validation,337,30,30720,254,48768,79488
validation,338,20,20480,113,21696,42176
validation,339,42,43008,497,95424,138432
validation,340,16,16384,72,13824,30208
validation,341,88,90112,2183,419136,509248
validation,342,74,75776,1544,296448,372224
validation,343,59,60416,981,188352,248768
validation,344,44,45056,546,104832,149888
validation,345,60,61440,1015,194880,256320
validation,346,137,140288,5290,1015680,1155968
validation,347,31,31744,271,52032,83776
validation,348,87,89088,2133,409536,498624
validation,349,40,40960,451,86592,127552
validation,350,38,38912,407,78144,117056
validation,351,30,30720,254,48768,79488
validation,352,77,78848,1671,320832,399680
validation,353,57,58368,916,175872,234240
validation,354,282,288768,22413,4303296,4592064
validation,355,117,119808,3858,740736,860544
validation,356,34,34816,326,62592,97408
validation,357,19,19456,102,19584,39040
validation,358,24,24576,163,31296,55872
validation,359,62,63488,1084,208128,271616
validation,360,110,112640,3411,654912,767552
validation,361,62,63488,1084,208128,271616
validation,362,40,40960,451,86592,127552
validation,363,61,62464,1049,201408,263872
validation,364,35,35840,345,66240,102080
validation,365,115,117760,3728,715776,833536
validation,366,100,102400,2819,541248,643648
validation,367,196,200704,10827,2078784,2279488
validation,368,67,68608,1265,242880,311488
validation,369,26,26624,191,36672,63296
validation,370,162,165888,7397,1420224,1586112
validation,371,60,61440,1015,194880,256320
validation,372,99,101376,2763,530496,631872
validation,373,24,24576,163,31296,55872
validation,374,44,45056,546,104832,149888
validation,375,21,21504,125,24000,45504
validation,376,169,173056,8050,1545600,1718656
validation,377,22,22528,137,26304,48832
validation,378,11,11264,34,6528,17792
validation,379,127,130048,4546,872832,1002880
validation,380,22,22528,137,26304,48832
validation,381,41,41984,474,91008,132992
validation,382,111,113664,3473,666816,780480
validation,383,52,53248,762,146304,199552
validation,384,105,107520,3108,596736,704256
validation,385,233,238592,15301,2937792,3176384
validation,386,56,57344,884,169728,227072
validation,387,24,24576,163,31296,55872
validation,388,82,83968,1895,363840,447808
validation,389,48,49152,650,124800,173952
validation,390,55,56320,853,163776,220096
validation,391,27,27648,206,39552,67200
validation,392,52,53248,762,146304,199552
validation,393,54,55296,822,157824,213120
validation,394,56,57344,884,169728,227072
validation,395,26,26624,191,36672,63296
validation,396,80,81920,1804,346368,428288
validation,397,157,160768,6947,1333824,1494592
validation,398,90,92160,2283,438336,530496
validation,399,42,43008,497,95424,138432
validation,400,27,27648,206,39552,67200
validation,401,71,72704,1421,272832,345536
validation,402,43,44032,521,100032,144064
validation,403,48,49152,650,124800,173952
validation,404,156,159744,6859,1316928,1476672
validation,405,68,69632,1303,250176,319808
validation,406,22,22528,137,26304,48832
validation,407,99,101376,2763,530496,631872
validation,408,117,119808,3858,740736,860544
validation,409,22,22528,137,26304,48832
validation,410,41,41984,474,91008,132992
validation,411,23,23552,149,28608,52160
validation,412,42,43008,497,95424,138432
validation,413,75,76800,1586,304512,381312
validation,414,122,124928,4195,805440,930368
validation,415,7,7168,14,2688,9856
validation,416,23,23552,149,28608,52160
validation,417,51,52224,733,140736,192960
validation,418,21,21504,125,24000,45504
validation,419,34,34816,326,62592,97408
validation,420,82,83968,1895,363840,447808
validation,421,44,45056,546,104832,149888
validation,422,150,153600,6342,1217664,1371264
validation,423,44,45056,546,104832,149888
validation,424,103,105472,2990,574080,679552
validation,425,72,73728,1461,280512,354240
validation,426,54,55296,822,157824,213120
validation,427,134,137216,5061,971712,1108928
validation,428,56,57344,884,169728,227072
validation,429,87,89088,2133,409536,498624
validation,430,74,75776,1544,296448,372224
validation,431,77,78848,1671,320832,399680
validation,432,265,271360,19793,3800256,4071616
validation,433,22,22528,137,26304,48832
validation,434,61,62464,1049,201408,263872
validation,435,42,43008,497,95424,138432
validation,436,48,49152,650,124800,173952
validation,437,24,24576,163,31296,55872
validation,438,40,40960,451,86592,127552
validation,439,11,11264,34,6528,17792
validation,440,85,87040,2037,391104,478144
validation,441,50,51200,705,135360,186560
validation,442,62,63488,1084,208128,271616
validation,443,53,54272,792,152064,206336
validation,444,154,157696,6684,1283328,1441024
validation,445,17,17408,82,15744,33152
validation,446,21,21504,125,24000,45504
validation,447,63,64512,1119,214848,279360
validation,448,35,35840,345,66240,102080
validation,449,115,117760,3728,715776,833536
validation,450,24,24576,163,31296,55872
validation,451,15,15360,64,12288,27648
validation,452,31,31744,271,52032,83776
validation,453,140,143360,5524,1060608,1203968
validation,454,76,77824,1628,312576,390400
validation,455,13,13312,48,9216,22528
validation,456,78,79872,1715,329280,409152
validation,457,38,38912,407,78144,117056
validation,458,25,25600,176,33792,59392
validation,459,29,29696,237,45504,75200
validation,460,33,33792,307,58944,92736
validation,461,31,31744,271,52032,83776
validation,462,59,60416,981,188352,248768
validation,463,123,125952,4264,818688,944640
validation,464,54,55296,822,157824,213120
validation,465,39,39936,429,82368,122304
validation,466,127,130048,4546,872832,1002880
validation,467,20,20480,113,21696,42176
validation,468,19,19456,102,19584,39040
validation,469,36,36864,365,70080,106944
validation,470,23,23552,149,28608,52160
validation,471,53,54272,792,152064,206336
validation,472,76,77824,1628,312576,390400
validation,473,24,24576,163,31296,55872
validation,474,19,19456,102,19584,39040
validation,475,11,11264,34,6528,17792
validation,476,11,11264,34,6528,17792
validation,477,59,60416,981,188352,248768
validation,478,217,222208,13272,2548224,2770432
validation,479,58,59392,948,182016,241408
validation,480,12,12288,41,7872,20160
validation,481,40,40960,451,86592,127552
validation,482,52,53248,762,146304,199552
validation,483,66,67584,1228,235776,303360
validation,484,90,92160,2283,438336,530496
validation,485,166,169984,7767,1491264,1661248
validation,486,60,61440,1015,194880,256320
validation,487,31,31744,271,52032,83776
validation,488,79,80896,1759,337728,418624
validation,489,44,45056,546,104832,149888
validation,490,14,14336,55,10560,24896
validation,491,18,18432,92,17664,36096
validation,492,15,15360,64,12288,27648
validation,493,69,70656,1342,257664,328320
validation,494,24,24576,163,31296,55872
validation,495,49,50176,677,129984,180160
validation,496,20,20480,113,21696,42176
validation,497,138,141312,5368,1030656,1171968
validation,498,59,60416,981,188352,248768
validation,499,74,75776,1544,296448,372224
validation,500,43,44032,521,100032,144064
validation,501,34,34816,326,62592,97408
validation,502,134,137216,5061,971712,1108928
validation,503,23,23552,149,28608,52160
validation,504,24,24576,163,31296,55872
validation,505,59,60416,981,188352,248768
validation,506,65,66560,1191,228672,295232
validation,507,58,59392,948,182016,241408
validation,508,242,247808,16506,3169152,3416960
validation,509,151,154624,6426,1233792,1388416
validation,510,31,31744,271,52032,83776
validation,511,154,157696,6684,1283328,1441024
validation,512,73,74752,1502,288384,363136
validation,513,29,29696,237,45504,75200
validation,514,59,60416,981,188352,248768
validation,515,186,190464,9751,1872192,2062656
validation,516,42,43008,497,95424,138432
validation,517,224,229376,14142,2715264,2944640
validation,518,71,72704,1421,272832,345536
validation,519,34,34816,326,62592,97408
validation,520,83,84992,1942,372864,457856
validation,521,21,21504,125,24000,45504
validation,522,23,23552,149,28608,52160
validation,523,20,20480,113,21696,42176
validation,524,49,50176,677,129984,180160
validation,525,111,113664,3473,666816,780480
validation,526,99,101376,2763,530496,631872
validation,527,45,46080,571,109632,155712
validation,528,268,274432,20243,3886656,4161088
validation,529,13,13312,48,9216,22528
validation,530,97,99328,2652,509184,608512
validation,531,45,46080,571,109632,155712
validation,532,41,41984,474,91008,132992
validation,533,68,69632,1303,250176,319808
validation,534,77,78848,1671,320832,399680
validation,535,122,124928,4195,805440,930368
validation,536,46,47104,597,114624,161728
validation,537,23,23552,149,28608,52160
validation,538,65,66560,1191,228672,295232
validation,539,58,59392,948,182016,241408
validation,540,46,47104,597,114624,161728
validation,541,165,168960,7673,1473216,1642176
validation,542,47,48128,623,119616,167744
validation,543,9,9216,23,4416,13632
validation,544,20,20480,113,21696,42176
validation,545,19,19456,102,19584,39040
validation,546,69,70656,1342,257664,328320
validation,547,57,58368,916,175872,234240
validation,548,79,80896,1759,337728,418624
validation,549,52,53248,762,146304,199552
validation,550,38,38912,407,78144,117056
validation,551,298,305152,25029,4805568,5110720
validation,552,61,62464,1049,201408,263872
validation,553,45,46080,571,109632,155712
validation,554,15,15360,64,12288,27648
validation,555,108,110592,3288,631296,741888
validation,556,48,49152,650,124800,173952
validation,557,59,60416,981,188352,248768
validation,558,31,31744,271,52032,83776
validation,559,63,64512,1119,214848,279360
validation,560,29,29696,237,45504,75200
validation,561,65,66560,1191,228672,295232
validation,562,60,61440,1015,194880,256320
validation,563,36,36864,365,70080,106944
validation,564,91,93184,2334,448128,541312
validation,565,53,54272,792,152064,206336
validation,566,75,76800,1586,304512,381312
validation,567,33,33792,307,58944,92736
validation,568,23,23552,149,28608,52160
validation,569,20,20480,113,21696,42176
validation,570,40,40960,451,86592,127552
validation,571,99,101376,2763,530496,631872
validation,572,26,26624,191,36672,63296
validation,573,132,135168,4911,942912,1078080
validation,574,22,22528,137,26304,48832
validation,575,89,91136,2233,428736,519872
validation,576,22,22528,137,26304,48832
validation,577,101,103424,2875,552000,655424
validation,578,61,62464,1049,201408,263872
validation,579,47,48128,623,119616,167744
validation,580,60,61440,1015,194880,256320
validation,581,23,23552,149,28608,52160
validation,582,107,109568,3227,619584,729152
validation,583,30,30720,254,48768,79488
validation,584,12,12288,41,7872,20160
validation,585,71,72704,1421,272832,345536
validation,586,181,185344,9234,1772928,1958272
validation,587,245,250880,16918,3248256,3499136
validation,588,54,55296,822,157824,213120
validation,589,16,16384,72,13824,30208
validation,590,141,144384,5604,1075968,1220352
validation,591,40,40960,451,86592,127552
validation,592,170,174080,8145,1563840,1737920
validation,593,190,194560,10175,1953600,2148160
validation,594,32,32768,289,55488,88256
validation,595,37,37888,386,74112,112000
validation,596,50,51200,705,135360,186560
validation,597,33,33792,307,58944,92736
validation,598,40,40960,451,86592,127552
validation,599,19,19456,102,19584,39040
validation,600,234,239616,15433,2963136,3202752
validation,601,79,80896,1759,337728,418624
validation,602,21,21504,125,24000,45504
validation,603,82,83968,1895,363840,447808
validation,604,16,16384,72,13824,30208
validation,605,56,57344,884,169728,227072
validation,606,35,35840,345,66240,102080
validation,607,13,13312,48,9216,22528
validation,608,46,47104,597,114624,161728
validation,609,64,65536,1155,221760,287296
validation,610,54,55296,822,157824,213120
validation,611,42,43008,497,95424,138432
validation,612,27,27648,206,39552,67200
validation,613,21,21504,125,24000,45504
validation,614,12,12288,41,7872,20160
validation,615,174,178176,8533,1638336,1816512
validation,616,75,76800,1586,304512,381312
validation,617,10,10240,28,5376,15616
validation,618,68,69632,1303,250176,319808
validation,619,25,25600,176,33792,59392
validation,620,83,84992,1942,372864,457856
validation,621,133,136192,4986,957312,1093504
validation,622,34,34816,326,62592,97408
validation,623,63,64512,1119,214848,279360
validation,624,71,72704,1421,272832,345536
validation,625,43,44032,521,100032,144064
validation,626,23,23552,149,28608,52160
validation,627,47,48128,623,119616,167744
validation,628,168,172032,7955,1527360,1699392
validation,629,119,121856,3991,766272,888128
validation,630,48,49152,650,124800,173952
validation,631,28,28672,221,42432,71104
validation,632,137,140288,5290,1015680,1155968
validation,633,45,46080,571,109632,155712
validation,634,28,28672,221,42432,71104
validation,635,22,22528,137,26304,48832
validation,636,37,37888,386,74112,112000
validation,637,153,156672,6598,1266816,1423488
validation,638,109,111616,3349,643008,754624
validation,639,77,78848,1671,320832,399680
validation,640,36,36864,365,70080,106944
validation,641,32,32768,289,55488,88256
validation,642,26,26624,191,36672,63296
validation,643,66,67584,1228,235776,303360
validation,644,55,56320,853,163776,220096
validation,645,22,22528,137,26304,48832
validation,646,86,88064,2085,400320,488384
validation,647,24,24576,163,31296,55872
validation,648,20,20480,113,21696,42176
validation,649,22,22528,137,26304,48832
validation,650,73,74752,1502,288384,363136
validation,651,24,24576,163,31296,55872
validation,652,58,59392,948,182016,241408
validation,653,23,23552,149,28608,52160
validation,654,45,46080,571,109632,155712
validation,655,79,80896,1759,337728,418624
validation,656,60,61440,1015,194880,256320
validation,657,236,241664,15698,3014016,3255680
validation,658,52,53248,762,146304,199552
validation,659,11,11264,34,6528,17792
validation,660,57,58368,916,175872,234240
validation,661,26,26624,191,36672,63296
validation,662,33,33792,307,58944,92736
validation,663,87,89088,2133,409536,498624
validation,664,80,81920,1804,346368,428288
validation,665,53,54272,792,152064,206336
validation,666,24,24576,163,31296,55872
validation,667,168,172032,7955,1527360,1699392
validation,668,55,56320,853,163776,220096
validation,669,33,33792,307,58944,92736
validation,670,153,156672,6598,1266816,1423488
validation,671,90,92160,2283,438336,530496
validation,672,69,70656,1342,257664,328320
validation,673,70,71680,1381,265152,336832
validation,674,46,47104,597,114624,161728
validation,675,55,56320,853,163776,220096
validation,676,51,52224,733,140736,192960
validation,677,81,82944,1849,355008,437952
validation,678,392,401408,43309,8315328,8716736
validation,679,17,17408,82,15744,33152
validation,680,55,56320,853,163776,220096
validation,681,138,141312,5368,1030656,1171968
validation,682,217,222208,13272,2548224,2770432
validation,683,56,57344,884,169728,227072
validation,684,161,164864,7306,1402752,1567616
validation,685,105,107520,3108,596736,704256
validation,686,66,67584,1228,235776,303360
validation,687,88,90112,2183,419136,509248
validation,688,74,75776,1544,296448,372224
validation,689,55,56320,853,163776,220096
validation,690,26,26624,191,36672,63296
validation,691,61,62464,1049,201408,263872
validation,692,98,100352,2707,519744,620096
validation,693,19,19456,102,19584,39040
validation,694,68,69632,1303,250176,319808
validation,695,41,41984,474,91008,132992
validation,696,75,76800,1586,304512,381312
validation,697,85,87040,2037,391104,478144
validation,698,106,108544,3167,608064,716608
validation,699,48,49152,650,124800,173952
validation,700,25,25600,176,33792,59392
validation,701,43,44032,521,100032,144064
validation,702,52,53248,762,146304,199552
validation,703,32,32768,289,55488,88256
validation,704,24,24576,163,31296,55872
validation,705,36,36864,365,70080,106944
validation,706,61,62464,1049,201408,263872
validation,707,157,160768,6947,1333824,1494592
validation,708,72,73728,1461,280512,354240
validation,709,26,26624,191,36672,63296
validation,710,36,36864,365,70080,106944
validation,711,161,164864,7306,1402752,1567616
validation,712,42,43008,497,95424,138432
validation,713,15,15360,64,12288,27648
validation,714,33,33792,307,58944,92736
validation,715,19,19456,102,19584,39040
validation,716,13,13312,48,9216,22528
validation,717,19,19456,102,19584,39040
validation,718,86,88064,2085,400320,488384
validation,719,44,45056,546,104832,149888
validation,720,46,47104,597,114624,161728
validation,721,38,38912,407,78144,117056
validation,722,10,10240,28,5376,15616
validation,723,57,58368,916,175872,234240
validation,724,123,125952,4264,818688,944640
validation,725,41,41984,474,91008,132992
validation,726,86,88064,2085,400320,488384
validation,727,81,82944,1849,355008,437952
validation,728,78,79872,1715,329280,409152
validation,729,65,66560,1191,228672,295232
validation,730,115,117760,3728,715776,833536
validation,731,274,280576,21160,4062720,4343296
validation,732,82,83968,1895,363840,447808
validation,733,81,82944,1849,355008,437952
validation,734,59,60416,981,188352,248768
validation,735,17,17408,82,15744,33152
validation,736,159,162816,7125,1368000,1530816
validation,737,13,13312,48,9216,22528
validation,738,41,41984,474,91008,132992
validation,739,166,169984,7767,1491264,1661248
validation,740,117,119808,3858,740736,860544
validation,741,172,176128,8338,1600896,1777024
validation,742,137,140288,5290,1015680,1155968
validation,743,49,50176,677,129984,180160
validation,744,70,71680,1381,265152,336832
validation,745,120,122880,4059,779328,902208
validation,746,78,79872,1715,329280,409152
validation,747,62,63488,1084,208128,271616
validation,748,82,83968,1895,363840,447808
validation,749,51,52224,733,140736,192960
validation,750,67,68608,1265,242880,311488
validation,751,119,121856,3991,766272,888128
validation,752,27,27648,206,39552,67200
validation,753,80,81920,1804,346368,428288
validation,754,22,22528,137,26304,48832
validation,755,349,357376,34329,6591168,6948544
validation,756,22,22528,137,26304,48832
validation,757,34,34816,326,62592,97408
validation,758,15,15360,64,12288,27648
validation,759,89,91136,2233,428736,519872
validation,760,13,13312,48,9216,22528
validation,761,40,40960,451,86592,127552
validation,762,49,50176,677,129984,180160
validation,763,29,29696,237,45504,75200
validation,764,64,65536,1155,221760,287296
validation,765,44,45056,546,104832,149888
validation,766,208,212992,12194,2341248,2554240
validation,767,31,31744,271,52032,83776
validation,768,57,58368,916,175872,234240
validation,769,30,30720,254,48768,79488
validation,770,38,38912,407,78144,117056
validation,771,33,33792,307,58944,92736
validation,772,93,95232,2438,468096,563328
validation,773,19,19456,102,19584,39040
validation,774,62,63488,1084,208128,271616
validation,775,39,39936,429,82368,122304
validation,776,41,41984,474,91008,132992
validation,777,29,29696,237,45504,75200
validation,778,24,24576,163,31296,55872
validation,779,15,15360,64,12288,27648
validation,780,174,178176,8533,1638336,1816512
validation,781,45,46080,571,109632,155712
validation,782,45,46080,571,109632,155712
validation,783,28,28672,221,42432,71104
validation,784,41,41984,474,91008,132992
validation,785,31,31744,271,52032,83776
validation,786,69,70656,1342,257664,328320
validation,787,14,14336,55,10560,24896
validation,788,256,262144,18471,3546432,3808576
validation,789,135,138240,5137,986304,1124544
validation,790,25,25600,176,33792,59392
validation,791,237,242688,15831,3039552,3282240
validation,792,64,65536,1155,221760,287296
validation,793,42,43008,497,95424,138432
validation,794,41,41984,474,91008,132992
validation,795,60,61440,1015,194880,256320
validation,796,28,28672,221,42432,71104
validation,797,15,15360,64,12288,27648
validation,798,13,13312,48,9216,22528
validation,799,29,29696,237,45504,75200
validation,800,22,22528,137,26304,48832
validation,801,19,19456,102,19584,39040
validation,802,86,88064,2085,400320,488384
validation,803,41,41984,474,91008,132992
validation,804,64,65536,1155,221760,287296
validation,805,43,44032,521,100032,144064
validation,806,27,27648,206,39552,67200
validation,807,112,114688,3536,678912,793600
validation,808,36,36864,365,70080,106944
validation,809,36,36864,365,70080,106944
validation,810,44,45056,546,104832,149888
validation,811,102,104448,2933,563136,667584
validation,812,38,38912,407,78144,117056
validation,813,54,55296,822,157824,213120
validation,814,44,45056,546,104832,149888
validation,815,56,57344,884,169728,227072
validation,816,89,91136,2233,428736,519872
validation,817,78,79872,1715,329280,409152
validation,818,146,149504,6008,1153536,1303040
validation,819,127,130048,4546,872832,1002880
validation,820,49,50176,677,129984,180160
validation,821,21,21504,125,24000,45504
validation,822,137,140288,5290,1015680,1155968
validation,823,39,39936,429,82368,122304
validation,824,51,52224,733,140736,192960
validation,825,23,23552,149,28608,52160
validation,826,27,27648,206,39552,67200
validation,827,36,36864,365,70080,106944
validation,828,47,48128,623,119616,167744
validation,829,142,145408,5683,1091136,1236544
validation,830,58,59392,948,182016,241408
validation,831,42,43008,497,95424,138432
validation,832,46,47104,597,114624,161728
validation,833,27,27648,206,39552,67200
validation,834,41,41984,474,91008,132992
validation,835,200,204800,11274,2164608,2369408
validation,836,28,28672,221,42432,71104
validation,837,82,83968,1895,363840,447808
validation,838,281,287744,22255,4272960,4560704
validation,839,20,20480,113,21696,42176
validation,840,17,17408,82,15744,33152
validation,841,56,57344,884,169728,227072
validation,842,73,74752,1502,288384,363136
validation,843,27,27648,206,39552,67200
validation,844,38,38912,407,78144,117056
validation,845,44,45056,546,104832,149888
validation,846,44,45056,546,104832,149888
validation,847,34,34816,326,62592,97408
validation,848,43,44032,521,100032,144064
validation,849,59,60416,981,188352,248768
validation,850,78,79872,1715,329280,409152
validation,851,40,40960,451,86592,127552
validation,852,89,91136,2233,428736,519872
validation,853,96,98304,2598,498816,597120
validation,854,47,48128,623,119616,167744
validation,855,68,69632,1303,250176,319808
validation,856,31,31744,271,52032,83776
validation,857,221,226304,13766,2643072,2869376
validation,858,40,40960,451,86592,127552
validation,859,69,70656,1342,257664,328320
validation,860,28,28672,221,42432,71104
validation,861,44,45056,546,104832,149888
validation,862,51,52224,733,140736,192960
validation,863,64,65536,1155,221760,287296
validation,864,123,125952,4264,818688,944640
validation,865,29,29696,237,45504,75200
validation,866,164,167936,7581,1455552,1623488
validation,867,74,75776,1544,296448,372224
validation,868,40,40960,451,86592,127552
validation,869,156,159744,6859,1316928,1476672
validation,870,36,36864,365,70080,106944
validation,871,72,73728,1461,280512,354240
validation,872,26,26624,191,36672,63296
validation,873,85,87040,2037,391104,478144
validation,874,112,114688,3536,678912,793600
validation,875,38,38912,407,78144,117056
validation,876,22,22528,137,26304,48832
validation,877,16,16384,72,13824,30208
validation,878,215,220160,13028,2501376,2721536
validation,879,25,25600,176,33792,59392
validation,880,14,14336,55,10560,24896
validation,881,65,66560,1191,228672,295232
validation,882,262,268288,19347,3714624,3982912
validation,883,39,39936,429,82368,122304
validation,884,23,23552,149,28608,52160
validation,885,41,41984,474,91008,132992
validation,886,20,20480,113,21696,42176
validation,887,29,29696,237,45504,75200
validation,888,48,49152,650,124800,173952
validation,889,66,67584,1228,235776,303360
validation,890,68,69632,1303,250176,319808
validation,891,93,95232,2438,468096,563328
validation,892,52,53248,762,146304,199552
validation,893,120,122880,4059,779328,902208
validation,894,36,36864,365,70080,106944
validation,895,176,180224,8731,1676352,1856576
validation,896,167,171008,7861,1509312,1680320
validation,897,65,66560,1191,228672,295232
validation,898,42,43008,497,95424,138432
validation,899,46,47104,597,114624,161728
validation,900,14,14336,55,10560,24896
validation,901,67,68608,1265,242880,311488
validation,902,46,47104,597,114624,161728
validation,903,17,17408,82,15744,33152
validation,904,29,29696,237,45504,75200
validation,905,120,122880,4059,779328,902208
validation,906,21,21504,125,24000,45504
validation,907,57,58368,916,175872,234240
validation,908,20,20480,113,21696,42176
validation,909,35,35840,345,66240,102080
validation,910,100,102400,2819,541248,643648
validation,911,30,30720,254,48768,79488
validation,912,146,149504,6008,1153536,1303040
validation,913,34,34816,326,62592,97408
validation,914,30,30720,254,48768,79488
validation,915,47,48128,623,119616,167744
validation,916,28,28672,221,42432,71104
validation,917,81,82944,1849,355008,437952
validation,918,71,72704,1421,272832,345536
validation,919,32,32768,289,55488,88256
validation,920,42,43008,497,95424,138432
validation,921,41,41984,474,91008,132992
validation,922,35,35840,345,66240,102080
validation,923,22,22528,137,26304,48832
validation,924,32,32768,289,55488,88256
validation,925,44,45056,546,104832,149888
validation,926,23,23552,149,28608,52160
validation,927,27,27648,206,39552,67200
validation,928,163,166912,7488,1437696,1604608
validation,929,19,19456,102,19584,39040
validation,930,27,27648,206,39552,67200
validation,931,72,73728,1461,280512,354240
validation,932,57,58368,916,175872,234240
validation,933,48,49152,650,124800,173952
validation,934,84,86016,1989,381888,467904
validation,935,13,13312,48,9216,22528
validation,936,98,100352,2707,519744,620096
validation,937,18,18432,92,17664,36096
validation,938,53,54272,792,152064,206336
validation,939,214,219136,12907,2478144,2697280
validation,940,68,69632,1303,250176,319808
validation,941,83,84992,1942,372864,457856
validation,942,120,122880,4059,779328,902208
validation,943,38,38912,407,78144,117056
validation,944,151,154624,6426,1233792,1388416
validation,945,24,24576,163,31296,55872
validation,946,27,27648,206,39552,67200
validation,947,46,47104,597,114624,161728
validation,948,39,39936,429,82368,122304
validation,949,275,281600,21315,4092480,4374080
validation,950,89,91136,2233,428736,519872
validation,951,25,25600,176,33792,59392
validation,952,103,105472,2990,574080,679552
validation,953,24,24576,163,31296,55872
validation,954,43,44032,521,100032,144064
validation,955,131,134144,4837,928704,1062848
validation,956,72,73728,1461,280512,354240
validation,957,43,44032,521,100032,144064
validation,958,78,79872,1715,329280,409152
validation,959,43,44032,521,100032,144064
validation,960,22,22528,137,26304,48832
validation,961,29,29696,237,45504,75200
validation,962,23,23552,149,28608,52160
validation,963,47,48128,623,119616,167744
validation,964,75,76800,1586,304512,381312
validation,965,65,66560,1191,228672,295232
validation,966,51,52224,733,140736,192960
validation,967,18,18432,92,17664,36096
validation,968,69,70656,1342,257664,328320
validation,969,141,144384,5604,1075968,1220352
validation,970,26,26624,191,36672,63296
validation,971,46,47104,597,114624,161728
validation,972,20,20480,113,21696,42176
validation,973,32,32768,289,55488,88256
validation,974,61,62464,1049,201408,263872
validation,975,76,77824,1628,312576,390400
validation,976,25,25600,176,33792,59392
validation,977,106,108544,3167,608064,716608
validation,978,120,122880,4059,779328,902208
validation,979,20,20480,113,21696,42176
validation,980,68,69632,1303,250176,319808
validation,981,30,30720,254,48768,79488
validation,982,30,30720,254,48768,79488
validation,983,75,76800,1586,304512,381312
validation,984,12,12288,41,7872,20160
validation,985,48,49152,650,124800,173952
validation,986,152,155648,6512,1250304,1405952
validation,987,56,57344,884,169728,227072
validation,988,78,79872,1715,329280,409152
validation,989,35,35840,345,66240,102080
validation,990,57,58368,916,175872,234240
validation,991,108,110592,3288,631296,741888
validation,992,32,32768,289,55488,88256
validation,993,85,87040,2037,391104,478144
validation,994,47,48128,623,119616,167744
validation,995,162,165888,7397,1420224,1586112
validation,996,18,18432,92,17664,36096
validation,997,62,63488,1084,208128,271616
validation,998,220,225280,13641,2619072,2844352
validation,999,55,56320,853,163776,220096
validation,1000,186,190464,9751,1872192,2062656
validation,1001,27,27648,206,39552,67200
validation,1002,52,53248,762,146304,199552
validation,1003,162,165888,7397,1420224,1586112
validation,1004,22,22528,137,26304,48832
validation,1005,102,104448,2933,563136,667584
validation,1006,21,21504,125,24000,45504
validation,1007,43,44032,521,100032,144064
validation,1008,215,220160,13028,2501376,2721536
validation,1009,19,19456,102,19584,39040
validation,1010,60,61440,1015,194880,256320
validation,1011,183,187392,9439,1812288,1999680
validation,1012,113,115712,3599,691008,806720
validation,1013,73,74752,1502,288384,363136
validation,1014,61,62464,1049,201408,263872
validation,1015,21,21504,125,24000,45504
validation,1016,154,157696,6684,1283328,1441024
validation,1017,100,102400,2819,541248,643648
validation,1018,28,28672,221,42432,71104
validation,1019,24,24576,163,31296,55872
validation,1020,214,219136,12908,2478336,2697472
validation,1021,168,172032,7955,1527360,1699392
validation,1022,42,43008,497,95424,138432
validation,1023,212,217088,12667,2432064,2649152
validation,1024,41,41984,474,91008,132992
validation,1025,98,100352,2707,519744,620096
validation,1026,25,25600,176,33792,59392
validation,1027,17,17408,82,15744,33152
validation,1028,22,22528,137,26304,48832
validation,1029,23,23552,149,28608,52160
validation,1030,68,69632,1303,250176,319808
validation,1031,166,169984,7767,1491264,1661248
validation,1032,24,24576,163,31296,55872
validation,1033,85,87040,2037,391104,478144
validation,1034,88,90112,2183,419136,509248
validation,1035,34,34816,326,62592,97408
validation,1036,50,51200,705,135360,186560
validation,1037,129,132096,4690,900480,1032576
validation,1038,14,14336,55,10560,24896
validation,1039,32,32768,289,55488,88256
validation,1040,308,315392,26738,5133696,5449088
validation,1041,35,35840,345,66240,102080
validation,1042,360,368640,36527,7013184,7381824
validation,1043,78,79872,1715,329280,409152
validation,1044,50,51200,705,135360,186560
validation,1045,23,23552,149,28608,52160
validation,1046,97,99328,2652,509184,608512
validation,1047,57,58368,916,175872,234240
validation,1048,29,29696,237,45504,75200
validation,1049,24,24576,163,31296,55872
validation,1050,15,15360,64,12288,27648
validation,1051,75,76800,1586,304512,381312
validation,1052,63,64512,1119,214848,279360
validation,1053,78,79872,1715,329280,409152
validation,1054,20,20480,113,21696,42176
validation,1055,85,87040,2037,391104,478144
validation,1056,75,76800,1586,304512,381312
validation,1057,87,89088,2133,409536,498624
validation,1058,28,28672,221,42432,71104
validation,1059,115,117760,3728,715776,833536
validation,1060,64,65536,1155,221760,287296
validation,1061,20,20480,113,21696,42176
validation,1062,28,28672,221,42432,71104
validation,1063,126,129024,4475,859200,988224
validation,1064,46,47104,597,114624,161728
validation,1065,59,60416,981,188352,248768
validation,1066,15,15360,64,12288,27648
validation,1067,12,12288,41,7872,20160
validation,1068,19,19456,102,19584,39040
validation,1069,30,30720,254,48768,79488
validation,1070,22,22528,137,26304,48832
validation,1071,164,167936,7581,1455552,1623488
validation,1072,30,30720,254,48768,79488
validation,1073,27,27648,206,39552,67200
validation,1074,26,26624,191,36672,63296
validation,1075,35,35840,345,66240,102080
validation,1076,191,195584,10282,1974144,2169728
validation,1077,58,59392,948,182016,241408
validation,1078,158,161792,7036,1350912,1512704
validation,1079,22,22528,137,26304,48832
validation,1080,15,15360,64,12288,27648
validation,1081,62,63488,1084,208128,271616
validation,1082,18,18432,92,17664,36096
validation,1083,114,116736,3663,703296,820032
validation,1084,104,106496,3049,585408,691904
validation,1085,25,25600,176,33792,59392
validation,1086,15,15360,64,12288,27648
validation,1087,24,24576,163,31296,55872
validation,1088,22,22528,137,26304,48832
validation,1089,141,144384,5604,1075968,1220352
validation,1090,33,33792,307,58944,92736
validation,1091,44,45056,546,104832,149888
validation,1092,161,164864,7306,1402752,1567616
validation,1093,65,66560,1191,228672,295232
validation,1094,74,75776,1544,296448,372224
validation,1095,23,23552,149,28608,52160
validation,1096,13,13312,48,9216,22528
test,0,59,60416,981,188352,248768
test,1,43,44032,521,100032,144064
test,2,37,37888,386,74112,112000
test,3,49,50176,677,129984,180160
test,4,27,27648,206,39552,67200
test,5,24,24576,163,31296,55872
test,6,47,48128,623,119616,167744
test,7,35,35840,345,66240,102080
test,8,27,27648,206,39552,67200
test,9,73,74752,1502,288384,363136
test,10,11,11264,34,6528,17792
test,11,200,204800,11274,2164608,2369408
test,12,70,71680,1381,265152,336832
test,13,124,126976,4334,832128,959104
test,14,54,55296,822,157824,213120
test,15,153,156672,6598,1266816,1423488
test,16,141,144384,5604,1075968,1220352
test,17,22,22528,137,26304,48832
test,18,101,103424,2875,552000,655424
test,19,14,14336,55,10560,24896
test,20,81,82944,1849,355008,437952
test,21,22,22528,137,26304,48832
test,22,99,101376,2763,530496,631872
test,23,52,53248,762,146304,199552
test,24,25,25600,176,33792,59392
test,25,139,142336,5446,1045632,1187968
test,26,44,45056,546,104832,149888
test,27,69,70656,1342,257664,328320
test,28,69,70656,1342,257664,328320
test,29,76,77824,1628,312576,390400
test,30,86,88064,2085,400320,488384
test,31,32,32768,289,55488,88256
test,32,25,25600,176,33792,59392
test,33,129,132096,4690,900480,1032576
test,34,12,12288,41,7872,20160
test,35,68,69632,1303,250176,319808
test,36,79,80896,1759,337728,418624
test,37,19,19456,102,19584,39040
test,38,73,74752,1502,288384,363136
test,39,36,36864,365,70080,106944
test,40,65,66560,1191,228672,295232
test,41,22,22528,137,26304,48832
test,42,80,81920,1804,346368,428288
test,43,41,41984,474,91008,132992
test,44,90,92160,2283,438336,530496
test,45,12,12288,41,7872,20160
test,46,50,51200,705,135360,186560
test,47,69,70656,1342,257664,328320
test,48,52,53248,762,146304,199552
test,49,42,43008,497,95424,138432
test,50,27,27648,206,39552,67200
test,51,72,73728,1461,280512,354240
test,52,24,24576,163,31296,55872
test,53,46,47104,597,114624,161728
test,54,50,51200,705,135360,186560
test,55,12,12288,41,7872,20160
test,56,22,22528,137,26304,48832
test,57,55,56320,853,163776,220096
test,58,65,66560,1191,228672,295232
test,59,28,28672,221,42432,71104
test,60,11,11264,34,6528,17792
test,61,132,135168,4911,942912,1078080
test,62,31,31744,271,52032,83776
test,63,62,63488,1084,208128,271616
test,64,20,20480,113,21696,42176
test,65,38,38912,407,78144,117056
test,66,25,25600,176,33792,59392
test,67,91,93184,2334,448128,541312
test,68,26,26624,191,36672,63296
test,69,81,82944,1849,355008,437952
test,70,38,38912,407,78144,117056
test,71,30,30720,254,48768,79488
test,72,56,57344,884,169728,227072
test,73,82,83968,1895,363840,447808
test,74,32,32768,289,55488,88256
test,75,27,27648,206,39552,67200
test,76,24,24576,163,31296,55872
test,77,87,89088,2133,409536,498624
test,78,14,14336,55,10560,24896
test,79,58,59392,948,182016,241408
test,80,35,35840,345,66240,102080
test,81,50,51200,705,135360,186560
test,82,113,115712,3599,691008,806720
test,83,39,39936,429,82368,122304
test,84,80,81920,1804,346368,428288
test,85,69,70656,1342,257664,328320
test,86,48,49152,650,124800,173952
test,87,74,75776,1544,296448,372224
test,88,80,81920,1804,346368,428288
test,89,59,60416,981,188352,248768
test,90,119,121856,3991,766272,888128
test,91,37,37888,386,74112,112000
test,92,28,28672,221,42432,71104
test,93,92,94208,2386,458112,552320
test,94,29,29696,237,45504,75200
test,95,105,107520,3108,596736,704256
test,96,53,54272,792,152064,206336
test,97,44,45056,546,104832,149888
test,98,91,93184,2334,448128,541312
test,99,30,30720,254,48768,79488
test,100,28,28672,221,42432,71104
test,101,249,254976,17475,3355200,3610176
test,102,77,78848,1671,320832,399680
test,103,31,31744,271,52032,83776
test,104,62,63488,1084,208128,271616
test,105,48,49152,650,124800,173952
test,106,67,68608,1265,242880,311488
test,107,86,88064,2085,400320,488384
test,108,25,25600,176,33792,59392
test,109,19,19456,102,19584,39040
test,110,52,53248,762,146304,199552
test,111,88,90112,2183,419136,509248
test,112,29,29696,237,45504,75200
test,113,40,40960,451,86592,127552
test,114,82,83968,1895,363840,447808
test,115,52,53248,762,146304,199552
test,116,110,112640,3411,654912,767552
test,117,119,121856,3991,766272,888128
test,118,108,110592,3288,631296,741888
test,119,69,70656,1342,257664,328320
test,120,64,65536,1155,221760,287296
test,121,15,15360,64,12288,27648
test,122,20,20480,113,21696,42176
test,123,15,15360,64,12288,27648
test,124,26,26624,191,36672,63296
test,125,22,22528,137,26304,48832
test,126,61,62464,1049,201408,263872
test,127,52,53248,762,146304,199552
test,128,192,196608,10390,1994880,2191488
test,129,189,193536,10068,1933056,2126592
test,130,10,10240,28,5376,15616
test,131,37,37888,386,74112,112000
test,132,50,51200,705,135360,186560
test,133,31,31744,271,52032,83776
test,134,30,30720,254,48768,79488
test,135,76,77824,1628,312576,390400
test,136,45,46080,571,109632,155712
test,137,43,44032,521,100032,144064
test,138,150,153600,6342,1217664,1371264
test,139,25,25600,176,33792,59392
test,140,146,149504,6008,1153536,1303040
test,141,49,50176,677,129984,180160
test,142,46,47104,597,114624,161728
test,143,33,33792,307,58944,92736
test,144,52,53248,762,146304,199552
test,145,47,48128,623,119616,167744
test,146,58,59392,948,182016,241408
test,147,25,25600,176,33792,59392
test,148,82,83968,1895,363840,447808
test,149,123,125952,4264,818688,944640
test,150,30,30720,254,48768,79488
test,151,24,24576,163,31296,55872
test,152,106,108544,3167,608064,716608
test,153,72,73728,1461,280512,354240
test,154,13,13312,48,9216,22528
test,155,105,107520,3108,596736,704256
test,156,111,113664,3473,666816,780480
test,157,24,24576,163,31296,55872
test,158,12,12288,41,7872,20160
test,159,164,167936,7581,1455552,1623488
test,160,110,112640,3411,654912,767552
test,161,28,28672,221,42432,71104
test,162,177,181248,8830,1695360,1876608
test,163,141,144384,5604,1075968,1220352
test,164,169,173056,8050,1545600,1718656
test,165,143,146432,5764,1106688,1253120
test,166,31,31744,271,52032,83776
test,167,29,29696,237,45504,75200
test,168,179,183296,9031,1733952,1917248
test,169,213,218112,12787,2455104,2673216
test,170,58,59392,948,182016,241408
test,171,19,19456,102,19584,39040
test,172,22,22528,137,26304,48832
test,173,54,55296,822,157824,213120
test,174,10,10240,28,5376,15616
test,175,28,28672,221,42432,71104
test,176,36,36864,365,70080,106944
test,177,27,27648,206,39552,67200
test,178,47,48128,623,119616,167744
test,179,15,15360,64,12288,27648
test,180,37,37888,386,74112,112000
test,181,14,14336,55,10560,24896
test,182,44,45056,546,104832,149888
test,183,201,205824,11387,2186304,2392128
test,184,18,18432,92,17664,36096
test,185,40,40960,451,86592,127552
test,186,43,44032,521,100032,144064
test,187,10,10240,28,5376,15616
test,188,324,331776,29587,5680704,6012480
test,189,84,86016,1989,381888,467904
test,190,26,26624,191,36672,63296
test,191,36,36864,365,70080,106944
test,192,96,98304,2598,498816,597120
test,193,12,12288,41,7872,20160
test,194,58,59392,948,182016,241408
test,195,68,69632,1303,250176,319808
test,196,208,212992,12194,2341248,2554240
test,197,75,76800,1586,304512,381312
test,198,82,83968,1895,363840,447808
test,199,23,23552,149,28608,52160
test,200,76,77824,1628,312576,390400
test,201,12,12288,41,7872,20160
test,202,22,22528,137,26304,48832
test,203,69,70656,1342,257664,328320
test,204,41,41984,474,91008,132992
test,205,140,143360,5524,1060608,1203968
test,206,19,19456,102,19584,39040
test,207,30,30720,254,48768,79488
test,208,28,28672,221,42432,71104
test,209,298,305152,25030,4805760,5110912
test,210,29,29696,237,45504,75200
test,211,74,75776,1544,296448,372224
test,212,159,162816,7125,1368000,1530816
test,213,20,20480,113,21696,42176
test,214,132,135168,4911,942912,1078080
test,215,28,28672,221,42432,71104
test,216,58,59392,948,182016,241408
test,217,99,101376,2763,530496,631872
test,218,29,29696,237,45504,75200
test,219,40,40960,451,86592,127552
test,220,19,19456,102,19584,39040
test,221,344,352256,33352,6403584,6755840
test,222,17,17408,82,15744,33152
test,223,13,13312,48,9216,22528
test,224,12,12288,41,7872,20160
test,225,52,53248,762,146304,199552
test,226,198,202752,11050,2121600,2324352
test,227,47,48128,623,119616,167744
test,228,26,26624,191,36672,63296
test,229,63,64512,1119,214848,279360
test,230,37,37888,386,74112,112000
test,231,62,63488,1084,208128,271616
test,232,26,26624,191,36672,63296
test,233,23,23552,149,28608,52160
test,234,88,90112,2183,419136,509248
test,235,285,291840,22893,4395456,4687296
test,236,97,99328,2652,509184,608512
test,237,90,92160,2283,438336,530496
test,238,110,112640,3411,654912,767552
test,239,46,47104,597,114624,161728
test,240,66,67584,1228,235776,303360
test,241,72,73728,1461,280512,354240
test,242,24,24576,163,31296,55872
test,243,46,47104,597,114624,161728
test,244,47,48128,623,119616,167744
test,245,38,38912,407,78144,117056
test,246,48,49152,650,124800,173952
test,247,160,163840,7215,1385280,1549120
test,248,135,138240,5137,986304,1124544
test,249,55,56320,853,163776,220096
test,250,27,27648,206,39552,67200
test,251,37,37888,386,74112,112000
test,252,19,19456,102,19584,39040
test,253,118,120832,3925,753600,874432
test,254,25,25600,176,33792,59392
test,255,49,50176,677,129984,180160
test,256,44,45056,546,104832,149888
test,257,71,72704,1421,272832,345536
test,258,25,25600,176,33792,59392
test,259,101,103424,2875,552000,655424
test,260,79,80896,1759,337728,418624
test,261,25,25600,176,33792,59392
test,262,74,75776,1544,296448,372224
test,263,230,235520,14910,2862720,3098240
test,264,38,38912,407,78144,117056
test,265,63,64512,1119,214848,279360
test,266,65,66560,1191,228672,295232
test,267,19,19456,102,19584,39040
test,268,76,77824,1628,312576,390400
test,269,123,125952,4264,818688,944640
test,270,23,23552,149,28608,52160
test,271,12,12288,41,7872,20160
test,272,52,53248,762,146304,199552
test,273,23,23552,149,28608,52160
test,274,21,21504,125,24000,45504
test,275,56,57344,884,169728,227072
test,276,28,28672,221,42432,71104
test,277,36,36864,365,70080,106944
test,278,15,15360,64,12288,27648
test,279,221,226304,13766,2643072,2869376
test,280,19,19456,102,19584,39040
test,281,45,46080,571,109632,155712
test,282,18,18432,92,17664,36096
test,283,94,96256,2491,478272,574528
test,284,31,31744,271,52032,83776
test,285,37,37888,386,74112,112000
test,286,94,96256,2491,478272,574528
test,287,17,17408,82,15744,33152
test,288,71,72704,1421,272832,345536
test,289,73,74752,1502,288384,363136
test,290,15,15360,64,12288,27648
test,291,13,13312,48,9216,22528
test,292,24,24576,163,31296,55872
test,293,81,82944,1849,355008,437952
test,294,36,36864,365,70080,106944
test,295,29,29696,237,45504,75200
test,296,24,24576,163,31296,55872
test,297,16,16384,72,13824,30208
test,298,61,62464,1049,201408,263872
test,299,12,12288,41,7872,20160
test,300,24,24576,163,31296,55872
test,301,230,235520,14910,2862720,3098240
test,302,42,43008,497,95424,138432
test,303,34,34816,326,62592,97408
test,304,65,66560,1191,228672,295232
test,305,84,86016,1989,381888,467904
test,306,27,27648,206,39552,67200
test,307,48,49152,650,124800,173952
test,308,51,52224,733,140736,192960
test,309,13,13312,48,9216,22528
test,310,62,63488,1084,208128,271616
test,311,34,34816,326,62592,97408
test,312,80,81920,1804,346368,428288
test,313,73,74752,1502,288384,363136
test,314,104,106496,3049,585408,691904
test,315,56,57344,884,169728,227072
test,316,22,22528,137,26304,48832
test,317,17,17408,82,15744,33152
test,318,25,25600,176,33792,59392
test,319,30,30720,254,48768,79488
test,320,50,51200,705,135360,186560
test,321,26,26624,191,36672,63296
test,322,18,18432,92,17664,36096
test,323,74,75776,1544,296448,372224
test,324,56,57344,884,169728,227072
test,325,91,93184,2334,448128,541312
test,326,14,14336,55,10560,24896
test,327,36,36864,365,70080,106944
test,328,21,21504,125,24000,45504
test,329,18,18432,92,17664,36096
test,330,176,180224,8731,1676352,1856576
test,331,67,68608,1265,242880,311488
test,332,125,128000,4404,845568,973568
test,333,79,80896,1759,337728,418624
test,334,81,82944,1849,355008,437952
test,335,73,74752,1502,288384,363136
test,336,47,48128,623,119616,167744
test,337,187,191488,9856,1892352,2083840
test,338,44,45056,546,104832,149888
test,339,50,51200,705,135360,186560
test,340,41,41984,474,91008,132992
test,341,35,35840,345,66240,102080
test,342,23,23552,149,28608,52160
test,343,221,226304,13766,2643072,2869376
test,344,34,34816,326,62592,97408
test,345,39,39936,429,82368,122304
test,346,20,20480,113,21696,42176
test,347,19,19456,102,19584,39040
test,348,79,80896,1759,337728,418624
test,349,32,32768,289,55488,88256
test,350,24,24576,163,31296,55872
test,351,26,26624,191,36672,63296
test,352,154,157696,6684,1283328,1441024
test,353,36,36864,365,70080,106944
test,354,54,55296,822,157824,213120
test,355,25,25600,176,33792,59392
test,356,19,19456,102,19584,39040
test,357,18,18432,92,17664,36096
test,358,75,76800,1586,304512,381312
test,359,40,40960,451,86592,127552
test,360,156,159744,6859,1316928,1476672
test,361,82,83968,1895,363840,447808
test,362,33,33792,307,58944,92736
test,363,92,94208,2386,458112,552320
test,364,13,13312,48,9216,22528
test,365,43,44032,521,100032,144064
test,366,17,17408,82,15744,33152
test,367,102,104448,2933,563136,667584
test,368,140,143360,5524,1060608,1203968
test,369,34,34816,326,62592,97408
test,370,37,37888,386,74112,112000
test,371,26,26624,191,36672,63296
test,372,79,80896,1759,337728,418624
test,373,26,26624,191,36672,63296
test,374,24,24576,163,31296,55872
test,375,71,72704,1421,272832,345536
test,376,18,18432,92,17664,36096
test,377,61,62464,1049,201408,263872
test,378,16,16384,72,13824,30208
test,379,36,36864,365,70080,106944
test,380,89,91136,2233,428736,519872
test,381,22,22528,137,26304,48832
test,382,79,80896,1759,337728,418624
test,383,22,22528,137,26304,48832
test,384,152,155648,6512,1250304,1405952
test,385,29,29696,237,45504,75200
test,386,19,19456,102,19584,39040
test,387,40,40960,451,86592,127552
test,388,82,83968,1895,363840,447808
test,389,42,43008,497,95424,138432
test,390,24,24576,163,31296,55872
test,391,38,38912,407,78144,117056
test,392,119,121856,3991,766272,888128
test,393,19,19456,102,19584,39040
test,394,101,103424,2875,552000,655424
test,395,28,28672,221,42432,71104
test,396,35,35840,345,66240,102080
test,397,79,80896,1759,337728,418624
test,398,19,19456,102,19584,39040
test,399,62,63488,1084,208128,271616
test,400,122,124928,4195,805440,930368
test,401,47,48128,623,119616,167744
test,402,37,37888,386,74112,112000
test,403,88,90112,2183,419136,509248
test,404,25,25600,176,33792,59392
test,405,37,37888,386,74112,112000
test,406,35,35840,345,66240,102080
test,407,16,16384,72,13824,30208
test,408,51,52224,733,140736,192960
test,409,218,223232,13394,2571648,2794880
test,410,24,24576,163,31296,55872
test,411,35,35840,345,66240,102080
test,412,45,46080,571,109632,155712
test,413,55,56320,853,163776,220096
test,414,27,27648,206,39552,67200
test,415,60,61440,1015,194880,256320
test,416,24,24576,163,31296,55872
test,417,26,26624,191,36672,63296
test,418,33,33792,307,58944,92736
test,419,57,58368,916,175872,234240
test,420,20,20480,113,21696,42176
test,421,20,20480,113,21696,42176
test,422,214,219136,12907,2478144,2697280
test,423,29,29696,237,45504,75200
test,424,33,33792,307,58944,92736
test,425,82,83968,1895,363840,447808
test,426,40,40960,451,86592,127552
test,427,38,38912,407,78144,117056
test,428,20,20480,113,21696,42176
test,429,29,29696,237,45504,75200
test,430,32,32768,289,55488,88256
test,431,93,95232,2438,468096,563328
test,432,46,47104,597,114624,161728
test,433,14,14336,55,10560,24896
test,434,23,23552,149,28608,52160
test,435,67,68608,1265,242880,311488
test,436,126,129024,4475,859200,988224
test,437,70,71680,1381,265152,336832
test,438,177,181248,8830,1695360,1876608
test,439,84,86016,1989,381888,467904
test,440,25,25600,176,33792,59392
test,441,116,118784,3793,728256,847040
test,442,45,46080,571,109632,155712
test,443,80,81920,1804,346368,428288
test,444,51,52224,733,140736,192960
test,445,207,211968,12077,2318784,2530752
test,446,12,12288,41,7872,20160
test,447,47,48128,623,119616,167744
test,448,29,29696,237,45504,75200
test,449,64,65536,1155,221760,287296
test,450,22,22528,137,26304,48832
test,451,32,32768,289,55488,88256
test,452,28,28672,221,42432,71104
test,453,134,137216,5061,971712,1108928
test,454,93,95232,2438,468096,563328
test,455,33,33792,307,58944,92736
test,456,137,140288,5290,1015680,1155968
test,457,31,31744,271,52032,83776
test,458,104,106496,3049,585408,691904
test,459,36,36864,365,70080,106944
test,460,35,35840,345,66240,102080
test,461,56,57344,884,169728,227072
test,462,64,65536,1155,221760,287296
test,463,47,48128,623,119616,167744
test,464,70,71680,1381,265152,336832
test,465,14,14336,55,10560,24896
test,466,66,67584,1228,235776,303360
test,467,17,17408,82,15744,33152
test,468,37,37888,386,74112,112000
test,469,42,43008,497,95424,138432
test,470,65,66560,1191,228672,295232
test,471,223,228352,14016,2691072,2919424
test,472,15,15360,64,12288,27648
test,473,51,52224,733,140736,192960
test,474,130,133120,4763,914496,1047616
test,475,62,63488,1084,208128,271616
test,476,29,29696,237,45504,75200
test,477,78,79872,1715,329280,409152
test,478,61,62464,1049,201408,263872
test,479,55,56320,853,163776,220096
test,480,10,10240,28,5376,15616
test,481,133,136192,4986,957312,1093504
test,482,97,99328,2652,509184,608512
test,483,93,95232,2438,468096,563328
test,484,47,48128,623,119616,167744
test,485,56,57344,884,169728,227072
test,486,118,120832,3925,753600,874432
test,487,98,100352,2707,519744,620096
test,488,91,93184,2334,448128,541312
test,489,99,101376,2763,530496,631872
test,490,45,46080,571,109632,155712
test,491,42,43008,497,95424,138432
test,492,11,11264,34,6528,17792
test,493,33,33792,307,58944,92736
test,494,68,69632,1303,250176,319808
test,495,81,82944,1849,355008,437952
test,496,20,20480,113,21696,42176
test,497,24,24576,163,31296,55872
test,498,39,39936,429,82368,122304
test,499,39,39936,429,82368,122304
test,500,24,24576,163,31296,55872
test,501,19,19456,102,19584,39040
test,502,33,33792,307,58944,92736
test,503,52,53248,762,146304,199552
test,504,213,218112,12787,2455104,2673216
test,505,109,111616,3349,643008,754624
test,506,25,25600,176,33792,59392
test,507,55,56320,853,163776,220096
test,508,85,87040,2037,391104,478144
test,509,160,163840,7215,1385280,1549120
test,510,153,156672,6598,1266816,1423488
test,511,123,125952,4264,818688,944640
test,512,15,15360,64,12288,27648
test,513,79,80896,1759,337728,418624
test,514,32,32768,289,55488,88256
test,515,79,80896,1759,337728,418624
test,516,38,38912,407,78144,117056
test,517,19,19456,102,19584,39040
test,518,73,74752,1502,288384,363136
test,519,23,23552,149,28608,52160
test,520,156,159744,6859,1316928,1476672
test,521,52,53248,762,146304,199552
test,522,44,45056,546,104832,149888
test,523,66,67584,1228,235776,303360
test,524,70,71680,1381,265152,336832
test,525,48,49152,650,124800,173952
test,526,203,207872,11615,2230080,2437952
test,527,79,80896,1759,337728,418624
test,528,88,90112,2183,419136,509248
test,529,20,20480,113,21696,42176
test,530,37,37888,386,74112,112000
test,531,34,34816,326,62592,97408
test,532,200,204800,11274,2164608,2369408
test,533,381,390144,40913,7855296,8245440
test,534,39,39936,429,82368,122304
test,535,28,28672,221,42432,71104
test,536,61,62464,1049,201408,263872
test,537,26,26624,191,36672,63296
test,538,27,27648,206,39552,67200
test,539,69,70656,1342,257664,328320
test,540,14,14336,55,10560,24896
test,541,17,17408,82,15744,33152
test,542,11,11264,34,6528,17792
test,543,39,39936,429,82368,122304
test,544,29,29696,237,45504,75200
test,545,61,62464,1049,201408,263872
test,546,148,151552,6174,1185408,1336960
test,547,16,16384,72,13824,30208
test,548,44,45056,546,104832,149888
test,549,58,59392,948,182016,241408
test,550,153,156672,6598,1266816,1423488
test,551,22,22528,137,26304,48832
test,552,51,52224,733,140736,192960
test,553,43,44032,521,100032,144064
test,554,144,147456,5844,1122048,1269504
test,555,31,31744,271,52032,83776
test,556,31,31744,271,52032,83776
test,557,56,57344,884,169728,227072
test,558,18,18432,92,17664,36096
test,559,37,37888,386,74112,112000
test,560,48,49152,650,124800,173952
test,561,35,35840,345,66240,102080
test,562,27,27648,206,39552,67200
test,563,25,25600,176,33792,59392
test,564,62,63488,1084,208128,271616
test,565,36,36864,365,70080,106944
test,566,23,23552,149,28608,52160
test,567,18,18432,92,17664,36096
test,568,32,32768,289,55488,88256
test,569,79,80896,1759,337728,418624
test,570,51,52224,733,140736,192960
test,571,23,23552,149,28608,52160
test,572,43,44032,521,100032,144064
test,573,108,110592,3288,631296,741888
test,574,65,66560,1191,228672,295232
test,575,14,14336,55,10560,24896
test,576,30,30720,254,48768,79488
test,577,102,104448,2933,563136,667584
test,578,132,135168,4911,942912,1078080
test,579,26,26624,191,36672,63296
test,580,29,29696,237,45504,75200
test,581,51,52224,733,140736,192960
test,582,210,215040,12429,2386368,2601408
test,583,63,64512,1119,214848,279360
test,584,28,28672,221,42432,71104
test,585,258,264192,18761,3602112,3866304
test,586,22,22528,137,26304,48832
test,587,106,108544,3167,608064,716608
test,588,59,60416,981,188352,248768
test,589,23,23552,149,28608,52160
test,590,81,82944,1849,355008,437952
test,591,12,12288,41,7872,20160
test,592,19,19456,102,19584,39040
test,593,245,250880,16918,3248256,3499136
test,594,65,66560,1191,228672,295232
test,595,74,75776,1544,296448,372224
test,596,23,23552,149,28608,52160
test,597,43,44032,521,100032,144064
test,598,57,58368,916,175872,234240
test,599,25,25600,176,33792,59392
test,600,26,26624,191,36672,63296
test,601,33,33792,307,58944,92736
test,602,22,22528,137,26304,48832
test,603,127,130048,4546,872832,1002880
test,604,45,46080,571,109632,155712
test,605,24,24576,163,31296,55872
test,606,26,26624,191,36672,63296
test,607,26,26624,191,36672,63296
test,608,30,30720,254,48768,79488
test,609,52,53248,762,146304,199552
test,610,93,95232,2438,468096,563328
test,611,88,90112,2183,419136,509248
test,612,26,26624,191,36672,63296
test,613,29,29696,237,45504,75200
test,614,57,58368,916,175872,234240
test,615,42,43008,497,95424,138432
test,616,25,25600,176,33792,59392
test,617,50,51200,705,135360,186560
test,618,48,49152,650,124800,173952
test,619,73,74752,1502,288384,363136
test,620,55,56320,853,163776,220096
test,621,136,139264,5213,1000896,1140160
test,622,78,79872,1715,329280,409152
test,623,27,27648,206,39552,67200
test,624,104,106496,3049,585408,691904
test,625,44,45056,546,104832,149888
test,626,22,22528,137,26304,48832
test,627,48,49152,650,124800,173952
test,628,36,36864,365,70080,106944
test,629,30,30720,254,48768,79488
test,630,96,98304,2598,498816,597120
test,631,20,20480,113,21696,42176
test,632,21,21504,125,24000,45504
test,633,50,51200,705,135360,186560
test,634,50,51200,705,135360,186560
test,635,76,77824,1628,312576,390400
test,636,48,49152,650,124800,173952
test,637,111,113664,3473,666816,780480
test,638,77,78848,1671,320832,399680
test,639,12,12288,41,7872,20160
test,640,146,149504,6008,1153536,1303040
test,641,100,102400,2819,541248,643648
test,642,16,16384,72,13824,30208
test,643,34,34816,326,62592,97408
test,644,92,94208,2386,458112,552320
test,645,27,27648,206,39552,67200
test,646,82,83968,1895,363840,447808
test,647,87,89088,2133,409536,498624
test,648,32,32768,289,55488,88256
test,649,21,21504,125,24000,45504
test,650,30,30720,254,48768,79488
test,651,61,62464,1049,201408,263872
test,652,72,73728,1461,280512,354240
test,653,37,37888,386,74112,112000
test,654,27,27648,206,39552,67200
test,655,391,400384,43089,8273088,8673472
test,656,135,138240,5137,986304,1124544
test,657,85,87040,2037,391104,478144
test,658,42,43008,497,95424,138432
test,659,49,50176,677,129984,180160
test,660,90,92160,2283,438336,530496
test,661,53,54272,792,152064,206336
test,662,46,47104,597,114624,161728
test,663,27,27648,206,39552,67200
test,664,40,40960,451,86592,127552
test,665,126,129024,4475,859200,988224
test,666,29,29696,237,45504,75200
test,667,143,146432,5764,1106688,1253120
test,668,27,27648,206,39552,67200
test,669,102,104448,2933,563136,667584
test,670,79,80896,1759,337728,418624
test,671,15,15360,64,12288,27648
test,672,47,48128,623,119616,167744
test,673,146,149504,6008,1153536,1303040
test,674,61,62464,1049,201408,263872
test,675,41,41984,474,91008,132992
test,676,102,104448,2933,563136,667584
test,677,136,139264,5213,1000896,1140160
test,678,39,39936,429,82368,122304
test,679,43,44032,521,100032,144064
test,680,106,108544,3167,608064,716608
test,681,20,20480,113,21696,42176
test,682,50,51200,705,135360,186560
test,683,138,141312,5368,1030656,1171968
test,684,76,77824,1628,312576,390400
test,685,40,40960,451,86592,127552
test,686,37,37888,386,74112,112000
test,687,74,75776,1544,296448,372224
test,688,50,51200,705,135360,186560
test,689,83,84992,1942,372864,457856
test,690,34,34816,326,62592,97408
test,691,50,51200,705,135360,186560
test,692,74,75776,1544,296448,372224
test,693,100,102400,2819,541248,643648
test,694,32,32768,289,55488,88256
test,695,17,17408,82,15744,33152
test,696,28,28672,221,42432,71104
test,697,46,47104,597,114624,161728
test,698,29,29696,237,45504,75200
test,699,24,24576,163,31296,55872
test,700,72,73728,1461,280512,354240
test,701,107,109568,3227,619584,729152
test,702,11,11264,34,6528,17792
test,703,64,65536,1155,221760,287296
test,704,45,46080,571,109632,155712
test,705,14,14336,55,10560,24896
test,706,76,77824,1628,312576,390400
test,707,42,43008,497,95424,138432
test,708,204,208896,11729,2251968,2460864
test,709,23,23552,149,28608,52160
test,710,170,174080,8145,1563840,1737920
test,711,167,171008,7861,1509312,1680320
test,712,35,35840,345,66240,102080
test,713,313,320512,27612,5301504,5622016
test,714,174,178176,8533,1638336,1816512
test,715,43,44032,521,100032,144064
test,716,90,92160,2283,438336,530496
test,717,69,70656,1342,257664,328320
test,718,114,116736,3663,703296,820032
test,719,58,59392,948,182016,241408
test,720,91,93184,2334,448128,541312
test,721,19,19456,102,19584,39040
test,722,58,59392,948,182016,241408
test,723,72,73728,1461,280512,354240
test,724,22,22528,137,26304,48832
test,725,45,46080,571,109632,155712
test,726,47,48128,623,119616,167744
test,727,22,22528,137,26304,48832
test,728,36,36864,365,70080,106944
test,729,58,59392,948,182016,241408
test,730,25,25600,176,33792,59392
test,731,311,318464,27260,5233920,5552384
test,732,33,33792,307,58944,92736
test,733,127,130048,4546,872832,1002880
test,734,52,53248,762,146304,199552
test,735,36,36864,365,70080,106944
test,736,139,142336,5446,1045632,1187968
test,737,17,17408,82,15744,33152
test,738,42,43008,497,95424,138432
test,739,41,41984,474,91008,132992
test,740,17,17408,82,15744,33152
test,741,251,257024,17757,3409344,3666368
test,742,44,45056,546,104832,149888
test,743,72,73728,1461,280512,354240
test,744,42,43008,497,95424,138432
test,745,104,106496,3049,585408,691904
test,746,25,25600,176,33792,59392
test,747,31,31744,271,52032,83776
test,748,58,59392,948,182016,241408
test,749,91,93184,2334,448128,541312
test,750,12,12288,41,7872,20160
test,751,20,20480,113,21696,42176
test,752,12,12288,41,7872,20160
test,753,21,21504,125,24000,45504
test,754,62,63488,1084,208128,271616
test,755,134,137216,5061,971712,1108928
test,756,151,154624,6426,1233792,1388416
test,757,147,150528,6091,1169472,1320000
test,758,46,47104,597,114624,161728
test,759,73,74752,1502,288384,363136
test,760,55,56320,853,163776,220096
test,761,35,35840,345,66240,102080
test,762,12,12288,41,7872,20160
test,763,197,201728,10938,2100096,2301824
test,764,61,62464,1049,201408,263872
test,765,28,28672,221,42432,71104
test,766,14,14336,55,10560,24896
test,767,35,35840,345,66240,102080
test,768,177,181248,8830,1695360,1876608
test,769,202,206848,11500,2208000,2414848
test,770,26,26624,191,36672,63296
test,771,38,38912,407,78144,117056
test,772,24,24576,163,31296,55872
test,773,76,77824,1628,312576,390400
test,774,67,68608,1265,242880,311488
test,775,85,87040,2037,391104,478144
test,776,50,51200,705,135360,186560
test,777,59,60416,981,188352,248768
test,778,142,145408,5683,1091136,1236544
test,779,55,56320,853,163776,220096
test,780,37,37888,386,74112,112000
test,781,193,197632,10499,2015808,2213440
test,782,35,35840,345,66240,102080
test,783,32,32768,289,55488,88256
test,784,95,97280,2544,488448,585728
test,785,63,64512,1119,214848,279360
test,786,39,39936,429,82368,122304
test,787,69,70656,1342,257664,328320
test,788,144,147456,5844,1122048,1269504
test,789,227,232448,14523,2788416,3020864
test,790,24,24576,163,31296,55872
test,791,30,30720,254,48768,79488
test,792,107,109568,3227,619584,729152
test,793,77,78848,1671,320832,399680
test,794,28,28672,221,42432,71104
test,795,71,72704,1421,272832,345536
test,796,15,15360,64,12288,27648
test,797,16,16384,72,13824,30208
test,798,25,25600,176,33792,59392
test,799,39,39936,429,82368,122304
test,800,281,287744,22255,4272960,4560704
test,801,118,120832,3925,753600,874432
test,802,100,102400,2819,541248,643648
test,803,23,23552,149,28608,52160
test,804,64,65536,1155,221760,287296
test,805,258,264192,18761,3602112,3866304
test,806,17,17408,82,15744,33152
test,807,45,46080,571,109632,155712
test,808,117,119808,3858,740736,860544
test,809,25,25600,176,33792,59392
test,810,62,63488,1084,208128,271616
test,811,19,19456,102,19584,39040
test,812,36,36864,365,70080,106944
test,813,62,63488,1084,208128,271616
test,814,22,22528,137,26304,48832
test,815,35,35840,345,66240,102080
test,816,42,43008,497,95424,138432
test,817,115,117760,3728,715776,833536
test,818,69,70656,1342,257664,328320
test,819,77,78848,1671,320832,399680
test,820,427,437248,51388,9866496,10303744
test,821,45,46080,571,109632,155712
test,822,59,60416,981,188352,248768
test,823,30,30720,254,48768,79488
test,824,70,71680,1381,265152,336832
test,825,64,65536,1155,221760,287296
test,826,35,35840,345,66240,102080
test,827,110,112640,3411,654912,767552
test,828,21,21504,125,24000,45504
test,829,67,68608,1265,242880,311488
test,830,25,25600,176,33792,59392
test,831,129,132096,4690,900480,1032576
test,832,31,31744,271,52032,83776
test,833,114,116736,3663,703296,820032
test,834,29,29696,237,45504,75200
test,835,221,226304,13766,2643072,2869376
test,836,29,29696,237,45504,75200
test,837,10,10240,28,5376,15616
test,838,54,55296,822,157824,213120
test,839,235,240640,15565,2988480,3229120
test,840,39,39936,429,82368,122304
test,841,135,138240,5137,986304,1124544
test,842,28,28672,221,42432,71104
test,843,26,26624,191,36672,63296
test,844,33,33792,307,58944,92736
test,845,83,84992,1942,372864,457856
test,846,56,57344,884,169728,227072
test,847,11,11264,34,6528,17792
test,848,46,47104,597,114624,161728
test,849,139,142336,5446,1045632,1187968
test,850,22,22528,137,26304,48832
test,851,54,55296,822,157824,213120
test,852,27,27648,206,39552,67200
test,853,30,30720,254,48768,79488
test,854,61,62464,1049,201408,263872
test,855,73,74752,1502,288384,363136
test,856,16,16384,72,13824,30208
test,857,25,25600,176,33792,59392
test,858,15,15360,64,12288,27648
test,859,32,32768,289,55488,88256
test,860,319,326656,28681,5506752,5833408
test,861,32,32768,289,55488,88256
test,862,53,54272,792,152064,206336
test,863,97,99328,2652,509184,608512
test,864,44,45056,546,104832,149888
test,865,38,38912,407,78144,117056
test,866,43,44032,521,100032,144064
test,867,57,58368,916,175872,234240
test,868,15,15360,64,12288,27648
test,869,23,23552,149,28608,52160
test,870,103,105472,2990,574080,679552
test,871,14,14336,55,10560,24896
test,872,22,22528,137,26304,48832
test,873,46,47104,597,114624,161728
test,874,67,68608,1265,242880,311488
test,875,31,31744,271,52032,83776
test,876,160,163840,7215,1385280,1549120
test,877,86,88064,2085,400320,488384
test,878,30,30720,254,48768,79488
test,879,74,75776,1544,296448,372224
test,880,99,101376,2763,530496,631872
test,881,25,25600,176,33792,59392
test,882,119,121856,3991,766272,888128
test,883,136,139264,5213,1000896,1140160
test,884,46,47104,597,114624,161728
test,885,15,15360,64,12288,27648
test,886,63,64512,1119,214848,279360
test,887,57,58368,916,175872,234240
test,888,42,43008,497,95424,138432
test,889,49,50176,677,129984,180160
test,890,96,98304,2598,498816,597120
test,891,33,33792,307,58944,92736
test,892,72,73728,1461,280512,354240
test,893,71,72704,1421,272832,345536
test,894,65,66560,1191,228672,295232
test,895,31,31744,271,52032,83776
test,896,47,48128,623,119616,167744
test,897,221,226304,13766,2643072,2869376
test,898,59,60416,981,188352,248768
test,899,28,28672,221,42432,71104
test,900,47,48128,623,119616,167744
test,901,40,40960,451,86592,127552
test,902,35,35840,345,66240,102080
test,903,53,54272,792,152064,206336
test,904,29,29696,237,45504,75200
test,905,36,36864,365,70080,106944
test,906,96,98304,2598,498816,597120
test,907,57,58368,916,175872,234240
test,908,37,37888,386,74112,112000
test,909,70,71680,1381,265152,336832
test,910,36,36864,365,70080,106944
test,911,51,52224,733,140736,192960
test,912,74,75776,1544,296448,372224
test,913,25,25600,176,33792,59392
test,914,132,135168,4911,942912,1078080
test,915,73,74752,1502,288384,363136
test,916,29,29696,237,45504,75200
test,917,47,48128,623,119616,167744
test,918,35,35840,345,66240,102080
test,919,126,129024,4475,859200,988224
test,920,80,81920,1804,346368,428288
test,921,25,25600,176,33792,59392
test,922,68,69632,1303,250176,319808
test,923,128,131072,4618,886656,1017728
test,924,40,40960,451,86592,127552
test,925,245,250880,16918,3248256,3499136
test,926,80,81920,1804,346368,428288
test,927,25,25600,176,33792,59392
test,928,43,44032,521,100032,144064
test,929,28,28672,221,42432,71104
test,930,10,10240,28,5376,15616
test,931,25,25600,176,33792,59392
test,932,23,23552,149,28608,52160
test,933,37,37888,386,74112,112000
test,934,38,38912,407,78144,117056
test,935,51,52224,733,140736,192960
test,936,15,15360,64,12288,27648
test,937,44,45056,546,104832,149888
test,938,30,30720,254,48768,79488
test,939,120,122880,4059,779328,902208
test,940,57,58368,916,175872,234240
test,941,84,86016,1989,381888,467904
test,942,25,25600,176,33792,59392
test,943,70,71680,1381,265152,336832
test,944,61,62464,1049,201408,263872
test,945,34,34816,326,62592,97408
test,946,50,51200,705,135360,186560
test,947,132,135168,4911,942912,1078080
test,948,60,61440,1015,194880,256320
test,949,55,56320,853,163776,220096
test,950,26,26624,191,36672,63296
test,951,88,90112,2183,419136,509248
test,952,155,158720,6771,1300032,1458752
test,953,60,61440,1015,194880,256320
test,954,26,26624,191,36672,63296
test,955,148,151552,6174,1185408,1336960
test,956,30,30720,254,48768,79488
test,957,12,12288,41,7872,20160
test,958,32,32768,289,55488,88256
test,959,36,36864,365,70080,106944
test,960,26,26624,191,36672,63296
test,961,88,90112,2183,419136,509248
test,962,61,62464,1049,201408,263872
test,963,87,89088,2133,409536,498624
test,964,292,299008,24031,4613952,4912960
test,965,90,92160,2283,438336,530496
test,966,32,32768,289,55488,88256
test,967,192,196608,10390,1994880,2191488
test,968,40,40960,451,86592,127552
test,969,41,41984,474,91008,132992
test,970,27,27648,206,39552,67200
test,971,32,32768,289,55488,88256
test,972,24,24576,163,31296,55872
test,973,148,151552,6174,1185408,1336960
test,974,161,164864,7306,1402752,1567616
test,975,43,44032,521,100032,144064
test,976,22,22528,137,26304,48832
test,977,165,168960,7673,1473216,1642176
test,978,57,58368,916,175872,234240
test,979,87,89088,2133,409536,498624
test,980,50,51200,705,135360,186560
test,981,49,50176,677,129984,180160
test,982,24,24576,163,31296,55872
test,983,61,62464,1049,201408,263872
test,984,121,123904,4127,792384,916288
test,985,64,65536,1155,221760,287296
test,986,44,45056,546,104832,149888
test,987,51,52224,733,140736,192960
test,988,224,229376,14142,2715264,2944640
test,989,12,12288,41,7872,20160
test,990,37,37888,386,74112,112000
test,991,58,59392,948,182016,241408
test,992,39,39936,429,82368,122304
test,993,98,100352,2707,519744,620096
test,994,34,34816,326,62592,97408
test,995,22,22528,137,26304,48832
test,996,76,77824,1628,312576,390400
test,997,57,58368,916,175872,234240
test,998,136,139264,5213,1000896,1140160
test,999,129,132096,4690,900480,1032576
test,1000,51,52224,733,140736,192960
test,1001,42,43008,497,95424,138432
test,1002,43,44032,521,100032,144064
test,1003,29,29696,237,45504,75200
test,1004,20,20480,113,21696,42176
test,1005,103,105472,2990,574080,679552
test,1006,71,72704,1421,272832,345536
test,1007,76,77824,1628,312576,390400
test,1008,38,38912,407,78144,117056
test,1009,51,52224,733,140736,192960
test,1010,45,46080,571,109632,155712
test,1011,106,108544,3167,608064,716608
test,1012,27,27648,206,39552,67200
test,1013,100,102400,2819,541248,643648
test,1014,11,11264,34,6528,17792
test,1015,51,52224,733,140736,192960
test,1016,126,129024,4475,859200,988224
test,1017,61,62464,1049,201408,263872
test,1018,130,133120,4763,914496,1047616
test,1019,58,59392,948,182016,241408
test,1020,14,14336,55,10560,24896
test,1021,244,249856,16780,3221760,3471616
test,1022,60,61440,1015,194880,256320
test,1023,41,41984,474,91008,132992
test,1024,24,24576,163,31296,55872
test,1025,63,64512,1119,214848,279360
test,1026,11,11264,34,6528,17792
test,1027,46,47104,597,114624,161728
test,1028,40,40960,451,86592,127552
test,1029,54,55296,822,157824,213120
test,1030,20,20480,113,21696,42176
test,1031,125,128000,4404,845568,973568
test,1032,168,172032,7955,1527360,1699392
test,1033,48,49152,650,124800,173952
test,1034,25,25600,176,33792,59392
test,1035,60,61440,1015,194880,256320
test,1036,26,26624,191,36672,63296
test,1037,31,31744,271,52032,83776
test,1038,45,46080,571,109632,155712
test,1039,30,30720,254,48768,79488
test,1040,35,35840,345,66240,102080
test,1041,54,55296,822,157824,213120
test,1042,63,64512,1119,214848,279360
test,1043,185,189440,9646,1852032,2041472
test,1044,74,75776,1544,296448,372224
test,1045,81,82944,1849,355008,437952
test,1046,38,38912,407,78144,117056
test,1047,26,26624,191,36672,63296
test,1048,194,198656,10608,2036736,2235392
test,1049,62,63488,1084,208128,271616
test,1050,34,34816,326,62592,97408
test,1051,24,24576,163,31296,55872
test,1052,24,24576,163,31296,55872
test,1053,29,29696,237,45504,75200
test,1054,39,39936,429,82368,122304
test,1055,81,82944,1849,355008,437952
test,1056,60,61440,1015,194880,256320
test,1057,70,71680,1381,265152,336832
test,1058,42,43008,497,95424,138432
test,1059,155,158720,6771,1300032,1458752
test,1060,29,29696,237,45504,75200
test,1061,108,110592,3288,631296,741888
test,1062,93,95232,2438,468096,563328
test,1063,56,57344,884,169728,227072
test,1064,75,76800,1586,304512,381312
test,1065,246,251904,17056,3274752,3526656
test,1066,124,126976,4334,832128,959104
test,1067,36,36864,365,70080,106944
test,1068,42,43008,497,95424,138432
test,1069,12,12288,41,7872,20160
test,1070,45,46080,571,109632,155712
test,1071,91,93184,2334,448128,541312
test,1072,71,72704,1421,272832,345536
test,1073,23,23552,149,28608,52160
test,1074,36,36864,365,70080,106944
test,1075,30,30720,254,48768,79488
test,1076,13,13312,48,9216,22528
test,1077,235,240640,15565,2988480,3229120
test,1078,31,31744,271,52032,83776
test,1079,101,103424,2875,552000,655424
test,1080,26,26624,191,36672,63296
test,1081,29,29696,237,45504,75200
test,1082,40,40960,451,86592,127552
test,1083,61,62464,1049,201408,263872
test,1084,62,63488,1084,208128,271616
test,1085,50,51200,705,135360,186560
test,1086,82,83968,1895,363840,447808
test,1087,20,20480,113,21696,42176
test,1088,75,76800,1586,304512,381312
test,1089,34,34816,326,62592,97408
test,1090,49,50176,677,129984,180160
test,1091,28,28672,221,42432,71104
test,1092,22,22528,137,26304,48832
test,1093,79,80896,1759,337728,418624
test,1094,26,26624,191,36672,63296
test,1095,138,141312,5368,1030656,1171968
test,1096,11,11264,34,6528,17792
test,1097,28,28672,221,42432,71104
test,1098,57,58368,916,175872,234240
test,1099,78,79872,1715,329280,409152
test,1100,74,75776,1544,296448,372224
test,1101,40,40960,451,86592,127552
test,1102,43,44032,521,100032,144064
test,1103,63,64512,1119,214848,279360
test,1104,29,29696,237,45504,75200
test,1105,62,63488,1084,208128,271616
test,1106,83,84992,1942,372864,457856
test,1107,129,132096,4690,900480,1032576
test,1108,36,36864,365,70080,106944
test,1109,42,43008,497,95424,138432
test,1110,130,133120,4763,914496,1047616
test,1111,23,23552,149,28608,52160
test,1112,390,399360,42868,8230656,8630016
test,1113,99,101376,2763,530496,631872
test,1114,57,58368,916,175872,234240
test,1115,210,215040,12429,2386368,2601408
test,1116,28,28672,221,42432,71104
test,1117,27,27648,206,39552,67200
test,1118,70,71680,1381,265152,336832
test,1119,228,233472,14651,2812992,3046464
test,1120,80,81920,1804,346368,428288
test,1121,30,30720,254,48768,79488
test,1122,72,73728,1461,280512,354240
test,1123,84,86016,1989,381888,467904
test,1124,77,78848,1671,320832,399680
test,1125,67,68608,1265,242880,311488
test,1126,29,29696,237,45504,75200
test,1127,24,24576,163,31296,55872
test,1128,37,37888,386,74112,112000
test,1129,148,151552,6174,1185408,1336960
test,1130,18,18432,92,17664,36096
test,1131,167,171008,7861,1509312,1680320
test,1132,20,20480,113,21696,42176
test,1133,94,96256,2491,478272,574528
test,1134,59,60416,981,188352,248768
test,1135,22,22528,137,26304,48832
test,1136,24,24576,163,31296,55872
test,1137,76,77824,1628,312576,390400
test,1138,12,12288,41,7872,20160
test,1139,17,17408,82,15744,33152
test,1140,35,35840,345,66240,102080
test,1141,66,67584,1228,235776,303360
test,1142,25,25600,176,33792,59392
test,1143,82,83968,1895,363840,447808
test,1144,62,63488,1084,208128,271616
test,1145,30,30720,254,48768,79488
test,1146,26,26624,191,36672,63296
test,1147,14,14336,55,10560,24896
test,1148,57,58368,916,175872,234240
test,1149,117,119808,3858,740736,860544
test,1150,17,17408,82,15744,33152
test,1151,28,28672,221,42432,71104
test,1152,48,49152,650,124800,173952
test,1153,111,113664,3473,666816,780480
test,1154,45,46080,571,109632,155712
test,1155,28,28672,221,42432,71104
test,1156,23,23552,149,28608,52160
test,1157,66,67584,1228,235776,303360
test,1158,23,23552,149,28608,52160
test,1159,37,37888,386,74112,112000
test,1160,172,176128,8338,1600896,1777024
test,1161,24,24576,163,31296,55872
test,1162,50,51200,705,135360,186560
test,1163,22,22528,137,26304,48832
test,1164,50,51200,705,135360,186560
test,1165,30,30720,254,48768,79488
test,1166,40,40960,451,86592,127552
test,1167,32,32768,289,55488,88256
test,1168,102,104448,2933,563136,667584
test,1169,142,145408,5683,1091136,1236544
test,1170,26,26624,191,36672,63296
test,1171,28,28672,221,42432,71104
test,1172,63,64512,1119,214848,279360
test,1173,96,98304,2598,498816,597120
test,1174,164,167936,7581,1455552,1623488
test,1175,41,41984,474,91008,132992
test,1176,46,47104,597,114624,161728
test,1177,17,17408,82,15744,33152
test,1178,72,73728,1461,280512,354240
test,1179,286,292864,23054,4426368,4719232
test,1180,31,31744,271,52032,83776
test,1181,24,24576,163,31296,55872
test,1182,84,86016,1989,381888,467904
test,1183,73,74752,1502,288384,363136
test,1184,90,92160,2283,438336,530496
test,1185,45,46080,571,109632,155712
test,1186,210,215040,12429,2386368,2601408
test,1187,151,154624,6426,1233792,1388416
test,1188,34,34816,326,62592,97408
test,1189,109,111616,3349,643008,754624
test,1190,47,48128,623,119616,167744
test,1191,87,89088,2133,409536,498624
test,1192,43,44032,521,100032,144064
test,1193,21,21504,125,24000,45504
test,1194,365,373760,37549,7209408,7583168
test,1195,70,71680,1381,265152,336832
test,1196,62,63488,1084,208128,271616
test,1197,50,51200,705,135360,186560
test,1198,319,326656,28681,5506752,5833408
test,1199,80,81920,1804,346368,428288
test,1200,44,45056,546,104832,149888
test,1201,30,30720,254,48768,79488
test,1202,212,217088,12667,2432064,2649152
test,1203,77,78848,1671,320832,399680
test,1204,150,153600,6342,1217664,1371264
test,1205,27,27648,206,39552,67200
test,1206,102,104448,2933,563136,667584
test,1207,13,13312,48,9216,22528
test,1208,64,65536,1155,221760,287296
test,1209,22,22528,137,26304,48832
test,1210,32,32768,289,55488,88256
test,1211,30,30720,254,48768,79488
test,1212,71,72704,1421,272832,345536
test,1213,44,45056,546,104832,149888
test,1214,40,40960,451,86592,127552
test,1215,52,53248,762,146304,199552
test,1216,54,55296,822,157824,213120
test,1217,39,39936,429,82368,122304
test,1218,53,54272,792,152064,206336
test,1219,22,22528,137,26304,48832
test,1220,30,30720,254,48768,79488
test,1221,30,30720,254,48768,79488
test,1222,28,28672,221,42432,71104
test,1223,82,83968,1895,363840,447808
test,1224,47,48128,623,119616,167744
test,1225,57,58368,916,175872,234240
test,1226,82,83968,1895,363840,447808
test,1227,48,49152,650,124800,173952
test,1228,64,65536,1155,221760,287296
test,1229,51,52224,733,140736,192960
test,1230,70,71680,1381,265152,336832
test,1231,50,51200,705,135360,186560
test,1232,68,69632,1303,250176,319808
test,1233,40,40960,451,86592,127552
test,1234,23,23552,149,28608,52160
test,1235,11,11264,34,6528,17792
test,1236,52,53248,762,146304,199552
test,1237,126,129024,4475,859200,988224
test,1238,60,61440,1015,194880,256320
test,1239,26,26624,191,36672,63296
test,1240,84,86016,1989,381888,467904
test,1241,25,25600,176,33792,59392
test,1242,333,340992,31253,6000576,6341568
test,1243,49,50176,677,129984,180160
test,1244,53,54272,792,152064,206336
test,1245,52,53248,762,146304,199552
test,1246,28,28672,221,42432,71104
test,1247,288,294912,23377,4488384,4783296
test,1248,61,62464,1049,201408,263872
test,1249,13,13312,48,9216,22528
test,1250,33,33792,307,58944,92736
test,1251,112,114688,3536,678912,793600
test,1252,179,183296,9031,1733952,1917248
test,1253,63,64512,1119,214848,279360
test,1254,109,111616,3349,643008,754624
test,1255,21,21504,125,24000,45504
test,1256,127,130048,4546,872832,1002880
test,1257,28,28672,221,42432,71104
test,1258,21,21504,125,24000,45504
test,1259,80,81920,1804,346368,428288
test,1260,32,32768,289,55488,88256
test,1261,52,53248,762,146304,199552
test,1262,52,53248,762,146304,199552
test,1263,26,26624,191,36672,63296
test,1264,116,118784,3793,728256,847040
test,1265,109,111616,3349,643008,754624
test,1266,173,177152,8435,1619520,1796672
test,1267,144,147456,5844,1122048,1269504
test,1268,54,55296,822,157824,213120
test,1269,38,38912,407,78144,117056
test,1270,50,51200,705,135360,186560
test,1271,32,32768,289,55488,88256
test,1272,25,25600,176,33792,59392
test,1273,47,48128,623,119616,167744
test,1274,61,62464,1049,201408,263872
test,1275,44,45056,546,104832,149888
test,1276,69,70656,1342,257664,328320
test,1277,79,80896,1759,337728,418624
test,1278,38,38912,407,78144,117056
test,1279,22,22528,137,26304,48832
test,1280,25,25600,176,33792,59392
test,1281,273,279552,21006,4033152,4312704
test,1282,60,61440,1015,194880,256320
test,1283,12,12288,41,7872,20160
test,1284,66,67584,1228,235776,303360
test,1285,31,31744,271,52032,83776
test,1286,236,241664,15698,3014016,3255680
test,1287,67,68608,1265,242880,311488
test,1288,28,28672,221,42432,71104
test,1289,35,35840,345,66240,102080
test,1290,31,31744,271,52032,83776
test,1291,25,25600,176,33792,59392
test,1292,137,140288,5290,1015680,1155968
test,1293,123,125952,4264,818688,944640
test,1294,30,30720,254,48768,79488
test,1295,15,15360,64,12288,27648
test,1296,56,57344,884,169728,227072
test,1297,40,40960,451,86592,127552
test,1298,43,44032,521,100032,144064
test,1299,36,36864,365,70080,106944
test,1300,50,51200,705,135360,186560
test,1301,181,185344,9234,1772928,1958272
test,1302,80,81920,1804,346368,428288
test,1303,59,60416,981,188352,248768
test,1304,10,10240,28,5376,15616
test,1305,46,47104,597,114624,161728
test,1306,82,83968,1895,363840,447808
test,1307,51,52224,733,140736,192960
test,1308,214,219136,12907,2478144,2697280
test,1309,24,24576,163,31296,55872
test,1310,24,24576,163,31296,55872
test,1311,65,66560,1191,228672,295232
test,1312,30,30720,254,48768,79488
test,1313,21,21504,125,24000,45504
test,1314,66,67584,1228,235776,303360
test,1315,46,47104,597,114624,161728
test,1316,71,72704,1421,272832,345536
test,1317,26,26624,191,36672,63296
test,1318,36,36864,365,70080,106944
test,1319,25,25600,176,33792,59392
test,1320,50,51200,705,135360,186560
test,1321,43,44032,521,100032,144064
test,1322,24,24576,163,31296,55872
test,1323,63,64512,1119,214848,279360
test,1324,49,50176,677,129984,180160
test,1325,10,10240,28,5376,15616
test,1326,64,65536,1155,221760,287296
test,1327,20,20480,113,21696,42176
test,1328,315,322560,27966,5369472,5692032
test,1329,160,163840,7215,1385280,1549120
test,1330,51,52224,733,140736,192960
test,1331,58,59392,948,182016,241408
test,1332,151,154624,6426,1233792,1388416
test,1333,17,17408,82,15744,33152
test,1334,24,24576,163,31296,55872
test,1335,45,46080,571,109632,155712
test,1336,41,41984,474,91008,132992
test,1337,60,61440,1015,194880,256320
test,1338,33,33792,307,58944,92736
test,1339,30,30720,254,48768,79488
test,1340,151,154624,6426,1233792,1388416
test,1341,70,71680,1381,265152,336832
test,1342,161,164864,7306,1402752,1567616
test,1343,113,115712,3599,691008,806720
test,1344,71,72704,1421,272832,345536
test,1345,52,53248,762,146304,199552
test,1346,54,55296,822,157824,213120
test,1347,41,41984,474,91008,132992
test,1348,27,27648,206,39552,67200
test,1349,64,65536,1155,221760,287296
test,1350,65,66560,1191,228672,295232
test,1351,60,61440,1015,194880,256320
test,1352,32,32768,289,55488,88256
test,1353,52,53248,762,146304,199552
test,1354,127,130048,4546,872832,1002880
test,1355,24,24576,163,31296,55872
test,1356,105,107520,3108,596736,704256
test,1357,49,50176,677,129984,180160
test,1358,30,30720,254,48768,79488
test,1359,91,93184,2334,448128,541312
test,1360,53,54272,792,152064,206336
test,1361,14,14336,55,10560,24896
test,1362,29,29696,237,45504,75200
test,1363,24,24576,163,31296,55872
test,1364,55,56320,853,163776,220096
test,1365,49,50176,677,129984,180160
test,1366,9,9216,23,4416,13632
test,1367,153,156672,6598,1266816,1423488
test,1368,83,84992,1942,372864,457856
test,1369,12,12288,41,7872,20160
test,1370,119,121856,3991,766272,888128
test,1371,29,29696,237,45504,75200
test,1372,48,49152,650,124800,173952
test,1373,73,74752,1502,288384,363136
test,1374,386,395264,41994,8062848,8458112
test,1375,13,13312,48,9216,22528
test,1376,117,119808,3858,740736,860544
test,1377,148,151552,6174,1185408,1336960
test,1378,24,24576,163,31296,55872
test,1379,21,21504,125,24000,45504
test,1380,60,61440,1015,194880,256320
test,1381,16,16384,72,13824,30208
test,1382,52,53248,762,146304,199552
test,1383,165,168960,7673,1473216,1642176
test,1384,27,27648,206,39552,67200
test,1385,28,28672,221,42432,71104
test,1386,107,109568,3227,619584,729152
test,1387,37,37888,386,74112,112000
test,1388,24,24576,163,31296,55872
test,1389,23,23552,149,28608,52160
test,1390,41,41984,474,91008,132992
test,1391,78,79872,1715,329280,409152
test,1392,42,43008,497,95424,138432
test,1393,24,24576,163,31296,55872
test,1394,25,25600,176,33792,59392
test,1395,77,78848,1671,320832,399680
test,1396,72,73728,1461,280512,354240
test,1397,50,51200,705,135360,186560
test,1398,15,15360,64,12288,27648
test,1399,117,119808,3858,740736,860544
test,1400,17,17408,82,15744,33152
test,1401,39,39936,429,82368,122304
test,1402,50,51200,705,135360,186560
test,1403,140,143360,5524,1060608,1203968
test,1404,216,221184,13150,2524800,2745984
test,1405,41,41984,474,91008,132992
test,1406,97,99328,2652,509184,608512
test,1407,26,26624,191,36672,63296
test,1408,71,72704,1421,272832,345536
test,1409,79,80896,1759,337728,418624
test,1410,96,98304,2598,498816,597120
test,1411,131,134144,4837,928704,1062848
test,1412,50,51200,705,135360,186560
test,1413,40,40960,451,86592,127552
test,1414,58,59392,948,182016,241408
test,1415,78,79872,1715,329280,409152
test,1416,101,103424,2875,552000,655424
test,1417,123,125952,4264,818688,944640
test,1418,37,37888,386,74112,112000
test,1419,60,61440,1015,194880,256320
test,1420,33,33792,307,58944,92736
test,1421,78,79872,1715,329280,409152
test,1422,36,36864,365,70080,106944
test,1423,63,64512,1119,214848,279360
test,1424,40,40960,451,86592,127552
test,1425,62,63488,1084,208128,271616
test,1426,57,58368,916,175872,234240
test,1427,48,49152,650,124800,173952
test,1428,15,15360,64,12288,27648
test,1429,20,20480,113,21696,42176
test,1430,33,33792,307,58944,92736
test,1431,34,34816,326,62592,97408
test,1432,29,29696,237,45504,75200
test,1433,42,43008,497,95424,138432
test,1434,14,14336,55,10560,24896
test,1435,75,76800,1586,304512,381312
test,1436,24,24576,163,31296,55872
test,1437,78,79872,1715,329280,409152
test,1438,75,76800,1586,304512,381312
test,1439,53,54272,792,152064,206336
test,1440,28,28672,221,42432,71104
test,1441,24,24576,163,31296,55872
test,1442,286,292864,23054,4426368,4719232
test,1443,69,70656,1342,257664,328320
test,1444,42,43008,497,95424,138432
test,1445,269,275456,20395,3915840,4191296
test,1446,26,26624,191,36672,63296
test,1447,25,25600,176,33792,59392
test,1448,77,78848,1671,320832,399680
test,1449,29,29696,237,45504,75200
test,1450,24,24576,163,31296,55872
test,1451,43,44032,521,100032,144064
test,1452,78,79872,1715,329280,409152
test,1453,70,71680,1381,265152,336832
test,1454,30,30720,254,48768,79488
test,1455,115,117760,3728,715776,833536
test,1456,151,154624,6426,1233792,1388416
test,1457,33,33792,307,58944,92736
test,1458,77,78848,1671,320832,399680
test,1459,49,50176,677,129984,180160
test,1460,33,33792,307,58944,92736
test,1461,20,20480,113,21696,42176
test,1462,27,27648,206,39552,67200
test,1463,9,9216,23,4416,13632
test,1464,26,26624,191,36672,63296
test,1465,69,70656,1342,257664,328320
test,1466,91,93184,2334,448128,541312
test,1467,46,47104,597,114624,161728
test,1468,25,25600,176,33792,59392
test,1469,43,44032,521,100032,144064
test,1470,29,29696,237,45504,75200
test,1471,12,12288,41,7872,20160
test,1472,82,83968,1895,363840,447808
test,1473,44,45056,546,104832,149888
test,1474,62,63488,1084,208128,271616
test,1475,58,59392,948,182016,241408
test,1476,18,18432,92,17664,36096
test,1477,67,68608,1265,242880,311488
test,1478,139,142336,5446,1045632,1187968
test,1479,40,40960,451,86592,127552
test,1480,69,70656,1342,257664,328320
test,1481,113,115712,3599,691008,806720
test,1482,49,50176,677,129984,180160
test,1483,27,27648,206,39552,67200
test,1484,17,17408,82,15744,33152
test,1485,45,46080,571,109632,155712
test,1486,24,24576,163,31296,55872
test,1487,66,67584,1228,235776,303360
test,1488,65,66560,1191,228672,295232
test,1489,85,87040,2037,391104,478144
test,1490,22,22528,137,26304,48832
test,1491,22,22528,137,26304,48832
test,1492,357,365568,35921,6896832,7262400
test,1493,72,73728,1461,280512,354240
test,1494,30,30720,254,48768,79488
test,1495,110,112640,3411,654912,767552
test,1496,12,12288,41,7872,20160
test,1497,82,83968,1895,363840,447808
test,1498,44,45056,546,104832,149888
test,1499,32,32768,289,55488,88256
test,1500,37,37888,386,74112,112000
test,1501,14,14336,55,10560,24896
test,1502,81,82944,1849,355008,437952
test,1503,230,235520,14910,2862720,3098240
test,1504,34,34816,326,62592,97408
test,1505,47,48128,623,119616,167744
test,1506,25,25600,176,33792,59392
test,1507,24,24576,163,31296,55872
test,1508,18,18432,92,17664,36096
test,1509,57,58368,916,175872,234240
test,1510,102,104448,2933,563136,667584
test,1511,25,25600,176,33792,59392
test,1512,66,67584,1228,235776,303360
test,1513,91,93184,2334,448128,541312
test,1514,220,225280,13641,2619072,2844352
test,1515,19,19456,102,19584,39040
test,1516,78,79872,1715,329280,409152
test,1517,25,25600,176,33792,59392
test,1518,146,149504,6008,1153536,1303040
test,1519,51,52224,733,140736,192960
test,1520,34,34816,326,62592,97408
test,1521,26,26624,191,36672,63296
test,1522,20,20480,113,21696,42176
test,1523,182,186368,9336,1792512,1978880
test,1524,22,22528,137,26304,48832
test,1525,34,34816,326,62592,97408
test,1526,79,80896,1759,337728,418624
test,1527,14,14336,55,10560,24896
test,1528,11,11264,34,6528,17792
test,1529,252,258048,17898,3436416,3694464
test,1530,22,22528,137,26304,48832
test,1531,113,115712,3599,691008,806720
test,1532,27,27648,206,39552,67200
test,1533,78,79872,1715,329280,409152
test,1534,22,22528,137,26304,48832
test,1535,60,61440,1015,194880,256320
test,1536,18,18432,92,17664,36096
test,1537,26,26624,191,36672,63296
test,1538,29,29696,237,45504,75200
test,1539,267,273408,20092,3857664,4131072
test,1540,133,136192,4986,957312,1093504
test,1541,28,28672,221,42432,71104
test,1542,94,96256,2491,478272,574528
test,1543,35,35840,345,66240,102080
test,1544,77,78848,1671,320832,399680
test,1545,20,20480,113,21696,42176
test,1546,186,190464,9751,1872192,2062656
test,1547,24,24576,163,31296,55872
test,1548,32,32768,289,55488,88256
test,1549,22,22528,137,26304,48832
test,1550,36,36864,366,70272,107136
test,1551,92,94208,2386,458112,552320
test,1552,143,146432,5764,1106688,1253120
test,1553,33,33792,307,58944,92736
test,1554,14,14336,55,10560,24896
test,1555,14,14336,55,10560,24896
test,1556,25,25600,176,33792,59392
test,1557,88,90112,2183,419136,509248
test,1558,19,19456,102,19584,39040
test,1559,21,21504,125,24000,45504
test,1560,15,15360,64,12288,27648
test,1561,42,43008,497,95424,138432
test,1562,13,13312,48,9216,22528
test,1563,23,23552,149,28608,52160
test,1564,79,80896,1759,337728,418624
test,1565,81,82944,1849,355008,437952
test,1566,58,59392,948,182016,241408
test,1567,26,26624,191,36672,63296
test,1568,25,25600,176,33792,59392
test,1569,27,27648,206,39552,67200
test,1570,226,231424,14396,2764032,2995456
test,1571,68,69632,1303,250176,319808
test,1572,16,16384,72,13824,30208
test,1573,29,29696,237,45504,75200
test,1574,100,102400,2819,541248,643648
test,1575,25,25600,176,33792,59392
test,1576,16,16384,72,13824,30208
test,1577,34,34816,326,62592,97408
test,1578,232,237568,15170,2912640,3150208
test,1579,22,22528,137,26304,48832
test,1580,77,78848,1671,320832,399680
test,1581,32,32768,289,55488,88256
test,1582,63,64512,1119,214848,279360
test,1583,26,26624,191,36672,63296
test,1584,20,20480,113,21696,42176
test,1585,22,22528,137,26304,48832
test,1586,28,28672,221,42432,71104
test,1587,45,46080,571,109632,155712
test,1588,37,37888,386,74112,112000
test,1589,14,14336,55,10560,24896
test,1590,111,113664,3473,666816,780480
test,1591,23,23552,149,28608,52160
test,1592,67,68608,1265,242880,311488
test,1593,23,23552,149,28608,52160
test,1594,33,33792,307,58944,92736
test,1595,84,86016,1989,381888,467904
test,1596,28,28672,221,42432,71104
test,1597,82,83968,1895,363840,447808
test,1598,146,149504,6008,1153536,1303040
test,1599,24,24576,163,31296,55872
test,1600,46,47104,597,114624,161728
test,1601,44,45056,546,104832,149888
test,1602,83,84992,1942,372864,457856
test,1603,27,27648,206,39552,67200
test,1604,33,33792,307,58944,92736
test,1605,33,33792,307,58944,92736
test,1606,26,26624,191,36672,63296
test,1607,21,21504,125,24000,45504
test,1608,24,24576,163,31296,55872
test,1609,47,48128,623,119616,167744
test,1610,252,258048,17898,3436416,3694464
test,1611,35,35840,345,66240,102080
test,1612,29,29696,237,45504,75200
test,1613,74,75776,1544,296448,372224
test,1614,98,100352,2707,519744,620096
test,1615,38,38912,407,78144,117056
test,1616,98,100352,2707,519744,620096
test,1617,81,82944,1849,355008,437952
test,1618,40,40960,451,86592,127552
test,1619,44,45056,546,104832,149888
test,1620,63,64512,1119,214848,279360
test,1621,166,169984,7767,1491264,1661248
test,1622,74,75776,1544,296448,372224
test,1623,54,55296,822,157824,213120
test,1624,55,56320,853,163776,220096
test,1625,41,41984,474,91008,132992
test,1626,28,28672,221,42432,71104
test,1627,66,67584,1228,235776,303360
test,1628,58,59392,948,182016,241408
test,1629,71,72704,1421,272832,345536
test,1630,120,122880,4059,779328,902208
test,1631,78,79872,1715,329280,409152
test,1632,37,37888,386,74112,112000
test,1633,21,21504,125,24000,45504
test,1634,121,123904,4127,792384,916288
test,1635,76,77824,1628,312576,390400
test,1636,53,54272,792,152064,206336
test,1637,57,58368,916,175872,234240
test,1638,104,106496,3049,585408,691904
test,1639,25,25600,176,33792,59392
test,1640,92,94208,2386,458112,552320
test,1641,36,36864,365,70080,106944
test,1642,133,136192,4986,957312,1093504
test,1643,38,38912,407,78144,117056
test,1644,71,72704,1421,272832,345536
test,1645,34,34816,326,62592,97408
test,1646,84,86016,1989,381888,467904
test,1647,52,53248,762,146304,199552
test,1648,64,65536,1155,221760,287296
test,1649,70,71680,1381,265152,336832
test,1650,26,26624,191,36672,63296
test,1651,36,36864,365,70080,106944
test,1652,47,48128,623,119616,167744
test,1653,11,11264,34,6528,17792
test,1654,39,39936,429,82368,122304
test,1655,126,129024,4475,859200,988224
test,1656,66,67584,1228,235776,303360
test,1657,30,30720,254,48768,79488
test,1658,11,11264,34,6528,17792
test,1659,46,47104,597,114624,161728
test,1660,30,30720,254,48768,79488
test,1661,179,183296,9031,1733952,1917248
test,1662,122,124928,4195,805440,930368
test,1663,66,67584,1228,235776,303360
test,1664,22,22528,137,26304,48832
test,1665,82,83968,1895,363840,447808
test,1666,30,30720,254,48768,79488
test,1667,30,30720,254,48768,79488
test,1668,56,57344,884,169728,227072
test,1669,72,73728,1461,280512,354240
test,1670,28,28672,221,42432,71104
test,1671,27,27648,206,39552,67200
test,1672,65,66560,1191,228672,295232
test,1673,257,263168,18616,3574272,3837440
test,1674,16,16384,72,13824,30208
test,1675,54,55296,822,157824,213120
test,1676,23,23552,149,28608,52160
test,1677,131,134144,4837,928704,1062848
test,1678,41,41984,474,91008,132992
test,1679,72,73728,1461,280512,354240
test,1680,25,25600,176,33792,59392
test,1681,22,22528,137,26304,48832
test,1682,65,66560,1191,228672,295232
test,1683,71,72704,1421,272832,345536
test,1684,29,29696,237,45504,75200
test,1685,30,30720,254,48768,79488
test,1686,37,37888,386,74112,112000
test,1687,75,76800,1586,304512,381312
test,1688,45,46080,571,109632,155712
test,1689,56,57344,884,169728,227072
test,1690,45,46080,571,109632,155712
test,1691,110,112640,3411,654912,767552
test,1692,64,65536,1155,221760,287296
test,1693,38,38912,407,78144,117056
test,1694,159,162816,7125,1368000,1530816
test,1695,150,153600,6342,1217664,1371264
test,1696,174,178176,8533,1638336,1816512
test,1697,69,70656,1342,257664,328320
test,1698,118,120832,3925,753600,874432
test,1699,32,32768,289,55488,88256
test,1700,31,31744,271,52032,83776
test,1701,260,266240,19053,3658176,3924416
test,1702,46,47104,597,114624,161728
test,1703,61,62464,1049,201408,263872
test,1704,135,138240,5137,986304,1124544
test,1705,45,46080,571,109632,155712
test,1706,48,49152,650,124800,173952
test,1707,27,27648,206,39552,67200
test,1708,66,67584,1228,235776,303360
test,1709,208,212992,12194,2341248,2554240
test,1710,69,70656,1342,257664,328320
test,1711,42,43008,497,95424,138432
test,1712,69,70656,1342,257664,328320
test,1713,21,21504,125,24000,45504
test,1714,30,30720,254,48768,79488
test,1715,14,14336,55,10560,24896
test,1716,78,79872,1715,329280,409152
test,1717,144,147456,5844,1122048,1269504
test,1718,55,56320,853,163776,220096
test,1719,70,71680,1381,265152,336832
test,1720,50,51200,705,135360,186560
test,1721,19,19456,102,19584,39040
test,1722,64,65536,1155,221760,287296
test,1723,31,31744,271,52032,83776
test,1724,126,129024,4475,859200,988224
test,1725,39,39936,429,82368,122304
test,1726,31,31744,271,52032,83776
test,1727,36,36864,365,70080,106944
test,1728,71,72704,1421,272832,345536
test,1729,67,68608,1265,242880,311488
test,1730,49,50176,677,129984,180160
test,1731,25,25600,176,33792,59392
test,1732,19,19456,102,19584,39040
test,1733,55,56320,853,163776,220096
test,1734,65,66560,1191,228672,295232
test,1735,44,45056,546,104832,149888
test,1736,80,81920,1804,346368,428288
test,1737,84,86016,1989,381888,467904
test,1738,34,34816,326,62592,97408
test,1739,316,323584,28144,5403648,5727232
test,1740,31,31744,271,52032,83776
test,1741,30,30720,254,48768,79488
test,1742,35,35840,345,66240,102080
test,1743,18,18432,92,17664,36096
test,1744,65,66560,1191,228672,295232
test,1745,21,21504,125,24000,45504
test,1746,26,26624,191,36672,63296
test,1747,32,32768,289,55488,88256
test,1748,39,39936,429,82368,122304
test,1749,21,21504,125,24000,45504
test,1750,38,38912,407,78144,117056
test,1751,232,237568,15170,2912640,3150208
test,1752,134,137216,5061,971712,1108928
test,1753,37,37888,386,74112,112000
test,1754,218,223232,13394,2571648,2794880
test,1755,25,25600,176,33792,59392
test,1756,29,29696,237,45504,75200
test,1757,82,83968,1895,363840,447808
test,1758,87,89088,2133,409536,498624
test,1759,79,80896,1759,337728,418624
test,1760,64,65536,1155,221760,287296
test,1761,134,137216,5061,971712,1108928
test,1762,16,16384,72,13824,30208
test,1763,24,24576,163,31296,55872
test,1764,57,58368,916,175872,234240
test,1765,54,55296,822,157824,213120
test,1766,30,30720,254,48768,79488
test,1767,22,22528,137,26304,48832
test,1768,192,196608,10390,1994880,2191488
test,1769,163,166912,7488,1437696,1604608
test,1770,113,115712,3599,691008,806720
test,1771,36,36864,365,70080,106944
test,1772,52,53248,762,146304,199552
test,1773,10,10240,28,5376,15616
test,1774,21,21504,125,24000,45504
test,1775,26,26624,191,36672,63296
test,1776,80,81920,1804,346368,428288
test,1777,92,94208,2386,458112,552320
test,1778,51,52224,733,140736,192960
test,1779,208,212992,12194,2341248,2554240
test,1780,85,87040,2037,391104,478144
test,1781,31,31744,271,52032,83776
test,1782,80,81920,1804,346368,428288
test,1783,215,220160,13028,2501376,2721536
test,1784,95,97280,2544,488448,585728
test,1785,78,79872,1715,329280,409152
test,1786,32,32768,289,55488,88256
test,1787,19,19456,102,19584,39040
test,1788,19,19456,102,19584,39040
test,1789,113,115712,3599,691008,806720
test,1790,70,71680,1381,265152,336832
test,1791,54,55296,822,157824,213120
test,1792,27,27648,206,39552,67200
test,1793,70,71680,1381,265152,336832
test,1794,22,22528,137,26304,48832
test,1795,25,25600,176,33792,59392
test,1796,148,151552,6174,1185408,1336960
test,1797,41,41984,474,91008,132992
test,1798,19,19456,102,19584,39040
test,1799,80,81920,1804,346368,428288
test,1800,60,61440,1015,194880,256320
test,1801,331,338944,30879,5928768,6267712
test,1802,12,12288,41,7872,20160
test,1803,166,169984,7767,1491264,1661248
test,1804,58,59392,948,182016,241408
test,1805,44,45056,546,104832,149888
test,1806,180,184320,9132,1753344,1937664
test,1807,28,28672,221,42432,71104
test,1808,11,11264,34,6528,17792
test,1809,35,35840,345,66240,102080
test,1810,48,49152,650,124800,173952
test,1811,79,80896,1759,337728,418624
test,1812,52,53248,762,146304,199552
test,1813,114,116736,3663,703296,820032
test,1814,34,34816,326,62592,97408
test,1815,53,54272,792,152064,206336
test,1816,202,206848,11500,2208000,2414848
test,1817,69,70656,1342,257664,328320
test,1818,45,46080,571,109632,155712
test,1819,32,32768,289,55488,88256
test,1820,55,56320,853,163776,220096
test,1821,16,16384,72,13824,30208
test,1822,59,60416,981,188352,248768
test,1823,31,31744,271,52032,83776
test,1824,82,83968,1895,363840,447808
test,1825,62,63488,1084,208128,271616
test,1826,33,33792,307,58944,92736
test,1827,22,22528,137,26304,48832
test,1828,38,38912,407,78144,117056
test,1829,22,22528,137,26304,48832
test,1830,52,53248,762,146304,199552
test,1831,82,83968,1895,363840,447808
test,1832,85,87040,2037,391104,478144
test,1833,30,30720,254,48768,79488
test,1834,52,53248,762,146304,199552
test,1835,128,131072,4618,886656,1017728
test,1836,31,31744,271,52032,83776
test,1837,36,36864,365,70080,106944
test,1838,33,33792,307,58944,92736
test,1839,36,36864,365,70080,106944
test,1840,109,111616,3349,643008,754624
test,1841,17,17408,82,15744,33152
test,1842,41,41984,474,91008,132992
test,1843,29,29696,237,45504,75200
test,1844,69,70656,1342,257664,328320
test,1845,21,21504,125,24000,45504
test,1846,21,21504,125,24000,45504
test,1847,26,26624,191,36672,63296
test,1848,65,66560,1191,228672,295232
test,1849,24,24576,163,31296,55872
test,1850,63,64512,1119,214848,279360
test,1851,60,61440,1015,194880,256320
test,1852,17,17408,82,15744,33152
test,1853,127,130048,4546,872832,1002880
test,1854,46,47104,597,114624,161728
test,1855,75,76800,1586,304512,381312
test,1856,18,18432,92,17664,36096
test,1857,11,11264,34,6528,17792
test,1858,33,33792,307,58944,92736
test,1859,72,73728,1461,280512,354240
test,1860,156,159744,6859,1316928,1476672
test,1861,15,15360,64,12288,27648
test,1862,55,56320,853,163776,220096
test,1863,132,135168,4911,942912,1078080
test,1864,47,48128,623,119616,167744
test,1865,249,254976,17475,3355200,3610176
test,1866,92,94208,2386,458112,552320
test,1867,14,14336,55,10560,24896
test,1868,34,34816,326,62592,97408
test,1869,24,24576,163,31296,55872
test,1870,81,82944,1849,355008,437952
test,1871,224,229376,14142,2715264,2944640
test,1872,55,56320,853,163776,220096
test,1873,129,132096,4690,900480,1032576
test,1874,29,29696,237,45504,75200
test,1875,129,132096,4690,900480,1032576
test,1876,29,29696,237,45504,75200
test,1877,116,118784,3793,728256,847040
test,1878,63,64512,1119,214848,279360
test,1879,24,24576,163,31296,55872
test,1880,14,14336,55,10560,24896
test,1881,68,69632,1303,250176,319808
test,1882,64,65536,1155,221760,287296
test,1883,26,26624,191,36672,63296
test,1884,12,12288,41,7872,20160
test,1885,109,111616,3349,643008,754624
test,1886,14,14336,55,10560,24896
test,1887,56,57344,884,169728,227072
test,1888,133,136192,4986,957312,1093504
test,1889,202,206848,11500,2208000,2414848
test,1890,41,41984,474,91008,132992
test,1891,66,67584,1228,235776,303360
test,1892,42,43008,497,95424,138432
test,1893,97,99328,2652,509184,608512
test,1894,61,62464,1049,201408,263872
test,1895,40,40960,451,86592,127552
test,1896,78,79872,1715,329280,409152
test,1897,24,24576,163,31296,55872
test,1898,53,54272,792,152064,206336
test,1899,45,46080,571,109632,155712
test,1900,87,89088,2133,409536,498624
test,1901,69,70656,1342,257664,328320
test,1902,58,59392,948,182016,241408
test,1903,9,9216,23,4416,13632
test,1904,39,39936,429,82368,122304
test,1905,201,205824,11387,2186304,2392128
test,1906,23,23552,149,28608,52160
test,1907,70,71680,1381,265152,336832
test,1908,27,27648,206,39552,67200
test,1909,69,70656,1342,257664,328320
test,1910,30,30720,254,48768,79488
test,1911,36,36864,365,70080,106944
test,1912,45,46080,571,109632,155712
test,1913,62,63488,1084,208128,271616
test,1914,25,25600,176,33792,59392
test,1915,26,26624,191,36672,63296
test,1916,55,56320,853,163776,220096
test,1917,127,130048,4546,872832,1002880
test,1918,144,147456,5844,1122048,1269504
test,1919,176,180224,8731,1676352,1856576
test,1920,61,62464,1049,201408,263872
test,1921,10,10240,28,5376,15616
test,1922,149,152576,6257,1201344,1353920
test,1923,89,91136,2233,428736,519872
test,1924,32,32768,289,55488,88256
test,1925,74,75776,1544,296448,372224
test,1926,48,49152,650,124800,173952
test,1927,23,23552,149,28608,52160
test,1928,34,34816,326,62592,97408
test,1929,13,13312,48,9216,22528
test,1930,33,33792,307,58944,92736
test,1931,63,64512,1119,214848,279360
test,1932,36,36864,365,70080,106944
test,1933,84,86016,1989,381888,467904
test,1934,38,38912,407,78144,117056
test,1935,146,149504,6008,1153536,1303040
test,1936,23,23552,149,28608,52160
test,1937,16,16384,72,13824,30208
test,1938,104,106496,3049,585408,691904
test,1939,76,77824,1628,312576,390400
test,1940,34,34816,326,62592,97408
test,1941,42,43008,497,95424,138432
test,1942,78,79872,1715,329280,409152
test,1943,146,149504,6008,1153536,1303040
test,1944,135,138240,5137,986304,1124544
test,1945,67,68608,1265,242880,311488
test,1946,248,253952,17335,3328320,3582272
test,1947,75,76800,1586,304512,381312
test,1948,73,74752,1502,288384,363136
test,1949,158,161792,7036,1350912,1512704
test,1950,67,68608,1265,242880,311488
test,1951,21,21504,125,24000,45504
test,1952,49,50176,677,129984,180160
test,1953,70,71680,1381,265152,336832
test,1954,42,43008,497,95424,138432
test,1955,27,27648,206,39552,67200
test,1956,30,30720,254,48768,79488
test,1957,39,39936,429,82368,122304
test,1958,51,52224,733,140736,192960
test,1959,15,15360,64,12288,27648
test,1960,86,88064,2085,400320,488384
test,1961,51,52224,733,140736,192960
test,1962,17,17408,82,15744,33152
test,1963,62,63488,1084,208128,271616
test,1964,121,123904,4127,792384,916288
test,1965,106,108544,3167,608064,716608
test,1966,28,28672,221,42432,71104
test,1967,70,71680,1381,265152,336832
test,1968,28,28672,221,42432,71104
test,1969,43,44032,521,100032,144064
test,1970,34,34816,326,62592,97408
test,1971,41,41984,474,91008,132992
test,1972,57,58368,916,175872,234240
test,1973,66,67584,1228,235776,303360
test,1974,105,107520,3108,596736,704256
test,1975,59,60416,981,188352,248768
test,1976,48,49152,650,124800,173952
test,1977,57,58368,916,175872,234240
test,1978,165,168960,7673,1473216,1642176
test,1979,80,81920,1804,346368,428288
test,1980,40,40960,451,86592,127552
test,1981,26,26624,191,36672,63296
test,1982,64,65536,1155,221760,287296
test,1983,22,22528,137,26304,48832
test,1984,106,108544,3167,608064,716608
test,1985,70,71680,1381,265152,336832
test,1986,31,31744,271,52032,83776
test,1987,27,27648,206,39552,67200
test,1988,15,15360,64,12288,27648
test,1989,62,63488,1084,208128,271616
test,1990,29,29696,237,45504,75200
test,1991,152,155648,6512,1250304,1405952
test,1992,28,28672,221,42432,71104
test,1993,58,59392,948,182016,241408
test,1994,76,77824,1628,312576,390400
test,1995,67,68608,1265,242880,311488
test,1996,147,150528,6091,1169472,1320000
test,1997,118,120832,3925,753600,874432
test,1998,89,91136,2233,428736,519872
test,1999,50,51200,705,135360,186560
test,2000,17,17408,82,15744,33152
test,2001,25,25600,176,33792,59392
test,2002,161,164864,7306,1402752,1567616
test,2003,31,31744,271,52032,83776
test,2004,53,54272,792,152064,206336
test,2005,105,107520,3108,596736,704256
test,2006,33,33792,307,58944,92736
test,2007,64,65536,1155,221760,287296
test,2008,244,249856,16780,3221760,3471616
test,2009,87,89088,2133,409536,498624
test,2010,372,380928,39003,7488576,7869504
test,2011,25,25600,176,33792,59392
test,2012,112,114688,3536,678912,793600
test,2013,16,16384,72,13824,30208
test,2014,42,43008,497,95424,138432
test,2015,49,50176,677,129984,180160
test,2016,40,40960,451,86592,127552
test,2017,42,43008,497,95424,138432
test,2018,111,113664,3473,666816,780480
test,2019,43,44032,521,100032,144064
test,2020,75,76800,1586,304512,381312
test,2021,32,32768,289,55488,88256
test,2022,57,58368,916,175872,234240
test,2023,29,29696,237,45504,75200
test,2024,56,57344,884,169728,227072
test,2025,260,266240,19053,3658176,3924416
test,2026,35,35840,345,66240,102080
test,2027,108,110592,3288,631296,741888
test,2028,140,143360,5524,1060608,1203968
test,2029,43,44032,521,100032,144064
test,2030,50,51200,705,135360,186560
test,2031,72,73728,1461,280512,354240
test,2032,40,40960,451,86592,127552
test,2033,106,108544,3167,608064,716608
test,2034,51,52224,733,140736,192960
test,2035,135,138240,5137,986304,1124544
test,2036,24,24576,163,31296,55872
test,2037,51,52224,733,140736,192960
test,2038,26,26624,191,36672,63296
test,2039,37,37888,386,74112,112000
test,2040,35,35840,345,66240,102080
test,2041,70,71680,1381,265152,336832
test,2042,99,101376,2763,530496,631872
test,2043,130,133120,4763,914496,1047616
test,2044,59,60416,981,188352,248768
test,2045,49,50176,677,129984,180160
test,2046,54,55296,822,157824,213120
test,2047,28,28672,221,42432,71104
test,2048,17,17408,82,15744,33152
test,2049,45,46080,571,109632,155712
test,2050,23,23552,149,28608,52160
test,2051,14,14336,55,10560,24896
test,2052,73,74752,1502,288384,363136
test,2053,97,99328,2652,509184,608512
test,2054,161,164864,7306,1402752,1567616
test,2055,50,51200,705,135360,186560
test,2056,15,15360,64,12288,27648
test,2057,155,158720,6771,1300032,1458752
test,2058,28,28672,221,42432,71104
test,2059,154,157696,6684,1283328,1441024
test,2060,319,326656,28681,5506752,5833408
test,2061,28,28672,221,42432,71104
test,2062,57,58368,916,175872,234240
test,2063,55,56320,853,163776,220096
test,2064,17,17408,82,15744,33152
test,2065,80,81920,1804,346368,428288
test,2066,10,10240,28,5376,15616
test,2067,31,31744,271,52032,83776
test,2068,236,241664,15698,3014016,3255680
test,2069,95,97280,2544,488448,585728
test,2070,27,27648,206,39552,67200
test,2071,105,107520,3108,596736,704256
test,2072,56,57344,884,169728,227072
test,2073,56,57344,884,169728,227072
test,2074,71,72704,1421,272832,345536
test,2075,25,25600,176,33792,59392
test,2076,36,36864,365,70080,106944
test,2077,68,69632,1303,250176,319808
test,2078,30,30720,254,48768,79488
test,2079,24,24576,163,31296,55872
test,2080,76,77824,1628,312576,390400
test,2081,42,43008,497,95424,138432
test,2082,35,35840,345,66240,102080
test,2083,74,75776,1544,296448,372224
test,2084,30,30720,254,48768,79488
test,2085,74,75776,1544,296448,372224
test,2086,62,63488,1084,208128,271616
test,2087,33,33792,307,58944,92736
test,2088,97,99328,2652,509184,608512
test,2089,53,54272,792,152064,206336
test,2090,31,31744,271,52032,83776
test,2091,176,180224,8731,1676352,1856576
test,2092,181,185344,9234,1772928,1958272
test,2093,37,37888,386,74112,112000
test,2094,73,74752,1502,288384,363136
test,2095,45,46080,571,109632,155712
test,2096,133,136192,4986,957312,1093504
test,2097,92,94208,2386,458112,552320
test,2098,27,27648,206,39552,67200
test,2099,16,16384,72,13824,30208
test,2100,24,24576,163,31296,55872
test,2101,13,13312,48,9216,22528
test,2102,70,71680,1381,265152,336832
test,2103,49,50176,677,129984,180160
test,2104,35,35840,345,66240,102080
test,2105,30,30720,254,48768,79488
test,2106,53,54272,792,152064,206336
test,2107,35,35840,345,66240,102080
test,2108,11,11264,34,6528,17792
test,2109,30,30720,254,48768,79488
test,2110,93,95232,2438,468096,563328
test,2111,75,76800,1586,304512,381312
test,2112,66,67584,1228,235776,303360
test,2113,45,46080,571,109632,155712
test,2114,72,73728,1461,280512,354240
test,2115,117,119808,3858,740736,860544
test,2116,83,84992,1942,372864,457856
test,2117,25,25600,176,33792,59392
test,2118,22,22528,137,26304,48832
test,2119,63,64512,1119,214848,279360
test,2120,21,21504,125,24000,45504
test,2121,23,23552,149,28608,52160
test,2122,18,18432,92,17664,36096
test,2123,50,51200,705,135360,186560
test,2124,9,9216,23,4416,13632
test,2125,52,53248,762,146304,199552
test,2126,26,26624,191,36672,63296
test,2127,93,95232,2438,468096,563328
test,2128,36,36864,365,70080,106944
test,2129,20,20480,113,21696,42176
test,2130,86,88064,2085,400320,488384
test,2131,25,25600,176,33792,59392
test,2132,69,70656,1342,257664,328320
test,2133,56,57344,884,169728,227072
test,2134,55,56320,853,163776,220096
test,2135,308,315392,26737,5133504,5448896
test,2136,147,150528,6091,1169472,1320000
test,2137,153,156672,6598,1266816,1423488
test,2138,27,27648,206,39552,67200
test,2139,178,182272,8930,1714560,1896832
test,2140,33,33792,307,58944,92736
test,2141,16,16384,72,13824,30208
test,2142,19,19456,102,19584,39040
test,2143,52,53248,762,146304,199552
test,2144,110,112640,3411,654912,767552
test,2145,30,30720,254,48768,79488
test,2146,22,22528,137,26304,48832
test,2147,126,129024,4475,859200,988224
test,2148,16,16384,72,13824,30208
test,2149,70,71680,1381,265152,336832
test,2150,44,45056,546,104832,149888
test,2151,44,45056,546,104832,149888
test,2152,30,30720,254,48768,79488
test,2153,26,26624,191,36672,63296
test,2154,113,115712,3599,691008,806720
test,2155,77,78848,1671,320832,399680
test,2156,26,26624,191,36672,63296
test,2157,55,56320,853,163776,220096
test,2158,121,123904,4127,792384,916288
test,2159,183,187392,9439,1812288,1999680
test,2160,14,14336,55,10560,24896
test,2161,11,11264,34,6528,17792
test,2162,108,110592,3288,631296,741888
test,2163,24,24576,163,31296,55872
test,2164,114,116736,3663,703296,820032
test,2165,163,166912,7488,1437696,1604608
test,2166,49,50176,677,129984,180160
test,2167,280,286720,22097,4242624,4529344
test,2168,19,19456,102,19584,39040
test,2169,368,376832,38168,7328256,7705088
test,2170,47,48128,623,119616,167744
test,2171,33,33792,307,58944,92736
test,2172,68,69632,1303,250176,319808
test,2173,52,53248,762,146304,199552
test,2174,52,53248,762,146304,199552
test,2175,25,25600,176,33792,59392
test,2176,28,28672,221,42432,71104
test,2177,28,28672,221,42432,71104
test,2178,23,23552,149,28608,52160
test,2179,37,37888,386,74112,112000
test,2180,58,59392,948,182016,241408
test,2181,53,54272,792,152064,206336
test,2182,135,138240,5137,986304,1124544
test,2183,49,50176,677,129984,180160
test,2184,51,52224,733,140736,192960
test,2185,32,32768,289,55488,88256
test,2186,60,61440,1015,194880,256320
test,2187,89,91136,2233,428736,519872
test,2188,191,195584,10282,1974144,2169728
