split,index,nodes,total_values_for_nodes,edges,total_values_for_edges,total_values_for_graph
train,0,1145,879360,19266,2774304,3653664
train,1,1320,1013760,22850,3290400,4304160
train,2,1062,815616,17475,2516400,3332016
train,3,1281,983808,22077,3179088,4162896
train,4,1333,1023744,23123,3329712,4353456
train,5,1002,769536,16291,2345904,3115440
train,6,1068,820224,17598,2534112,3354336
train,7,1401,1075968,24588,3540672,4616640
train,8,1374,1055232,24037,3461328,4516560
train,9,995,764160,16128,2322432,3086592
train,10,1848,1419264,33870,4877280,6296544
train,11,1215,933120,20668,2976192,3909312
train,12,1114,855552,18596,2677824,3533376
train,13,1335,1025280,23166,3335904,4361184
train,14,1192,915456,20183,2906352,3821808
train,15,1132,869376,19014,2738016,3607392
train,16,1059,813312,17414,2507616,3320928
train,17,1543,1185024,27518,3962592,5147616
train,18,1208,927744,20518,2954592,3882336
train,19,957,734976,15286,2201184,2936160
train,20,1103,847104,18348,2642112,3489216
train,21,1065,817920,17536,2525184,3343104
train,22,1122,861696,18780,2704320,3566016
train,23,1187,911616,20080,2891520,3803136
train,24,1202,923136,20391,2936304,3859440
train,25,1069,820992,17618,2536992,3357984
train,26,1053,808704,17293,2490192,3298896
train,27,1312,1007616,22686,3266784,4274400
train,28,1507,1157376,26830,3863520,5020896
train,29,1170,898560,19741,2842704,3741264
train,30,1042,800256,17077,2459088,3259344
train,31,1125,864000,18850,2714400,3578400
train,32,1213,931584,20625,2970000,3901584
train,33,1206,926208,20475,2948400,3874608
train,34,2465,1893120,46722,6727968,8621088
train,35,1216,933888,20690,2979360,3913248
train,36,1080,829440,17849,2570256,3399696
train,37,1349,1036032,23471,3379824,4415856
train,38,1275,979200,21964,3162816,4142016
train,39,1449,1112832,25539,3677616,4790448
train,40,1133,870144,19037,2741328,3611472
train,41,1359,1043712,23694,3411936,4455648
train,42,967,742656,15501,2232144,2974800
train,43,1185,910080,20040,2885760,3795840
train,44,1255,963840,21572,3106368,4070208
train,45,1218,935424,20734,2985696,3921120
train,46,3125,2400000,60536,8717184,11117184
train,47,1611,1237248,28950,4168800,5406048
train,48,1053,808704,17293,2490192,3298896
train,49,1330,1021440,23059,3320496,4341936
train,50,1321,1014528,22871,3293424,4307952
train,51,1170,898560,19741,2842704,3741264
train,52,1317,1011456,22788,3281472,4292928
train,53,1131,868608,18990,2734560,3603168
train,54,1257,965376,21619,3113136,4078512
train,55,1493,1146624,26504,3816576,4963200
train,56,1293,993024,22307,3212208,4205232
train,57,1567,1203456,27999,4031856,5235312
train,58,1259,966912,21666,3119904,4086816
train,59,1297,996096,22385,3223440,4219536
train,60,967,742656,15501,2232144,2974800
train,61,1196,918528,20265,2918160,3836688
train,62,1237,950016,21156,3046464,3996480
train,63,1126,864768,18873,2717712,3582480
train,64,1435,1102080,25250,3636000,4738080
train,65,1359,1043712,23694,3411936,4455648
train,66,1045,802560,17136,2467584,3270144
train,67,1573,1208064,28123,4049712,5257776
train,68,1234,947712,21088,3036672,3984384
train,69,1119,859392,18711,2694384,3553776
train,70,1057,811776,17374,2501856,3313632
train,71,1161,891648,19567,2817648,3709296
train,72,1196,918528,20265,2918160,3836688
train,73,1196,918528,20265,2918160,3836688
train,74,1055,810240,17334,2496096,3306336
train,75,1162,892416,19586,2820384,3712800
train,76,1203,923904,20412,2939328,3863232
train,77,1334,1024512,23145,3332880,4357392
train,78,1156,887808,19472,2803968,3691776
train,79,1045,802560,17136,2467584,3270144
train,80,1378,1058304,24130,3474720,4533024
train,81,1315,1009920,22747,3275568,4285488
train,82,1000,768000,16244,2339136,3107136
train,83,1316,1010688,22767,3278448,4289136
train,84,1212,930816,20604,2966976,3897792
train,85,1184,909312,20019,2882736,3792048
train,86,1261,968448,21708,3125952,4094400
train,87,1024,786432,16735,2409840,3196272
train,88,1169,897792,19721,2839824,3737616
train,89,1233,946944,21066,3033504,3980448
train,90,1167,896256,19682,2834208,3730464
train,91,1019,782592,16643,2396592,3179184
train,92,1092,838656,18106,2607264,3445920
train,93,1173,900864,19800,2851200,3752064
train,94,1060,814080,17434,2510496,3324576
train,95,1107,850176,18438,2655072,3505248
train,96,1290,990720,22249,3203856,4194576
train,97,1363,1046784,23784,3424896,4471680
train,98,1074,824832,17722,2551968,3376800
train,99,1527,1172736,27213,3918672,5091408
train,100,1175,902400,19839,2856816,3759216
train,101,1107,850176,18438,2655072,3505248
train,102,1528,1173504,27231,3921264,5094768
train,103,1093,839424,18128,2610432,3449856
train,104,1188,912384,20101,2894544,3806928
train,105,1399,1074432,24551,3535344,4609776
train,106,1139,874752,19157,2758608,3633360
train,107,1274,978432,21946,3160224,4138656
train,108,1166,895488,19663,2831472,3726960
train,109,1391,1068288,24404,3514176,4582464
train,110,1390,1067520,24386,3511584,4579104
train,111,1023,785664,16716,2407104,3192768
train,112,1191,914688,20162,2903328,3818016
train,113,1446,1110528,25476,3668544,4779072
train,114,1057,811776,17374,2501856,3313632
train,115,1330,1021440,23059,3320496,4341936
train,116,1099,844032,18260,2629440,3473472
train,117,1263,969984,21744,3131136,4101120
train,118,1249,959232,21432,3086208,4045440
train,119,1381,1060608,24201,3484944,4545552
train,120,1160,890880,19548,2814912,3705792
train,121,1345,1032960,23383,3367152,4400112
train,122,1140,875520,19175,2761200,3636720
train,123,1214,932352,20647,2973168,3905520
train,124,1274,978432,21946,3160224,4138656
train,125,1257,965376,21619,3113136,4078512
train,126,1101,845568,18304,2635776,3481344
train,127,1183,908544,19999,2879856,3788400
train,128,1257,965376,21619,3113136,4078512
train,129,1090,837120,18063,2601072,3438192
train,130,1500,1152000,26666,3839904,4991904
train,131,1351,1037568,23515,3386160,4423728
train,132,1041,799488,17058,2456352,3255840
train,133,1109,851712,18483,2661552,3513264
train,134,1165,894720,19644,2828736,3723456
train,135,1414,1085952,24835,3576240,4662192
train,136,1247,957696,21385,3079440,4037136
train,137,1449,1112832,25539,3677616,4790448
train,138,1687,1295616,30502,4392288,5687904
train,139,1187,911616,20080,2891520,3803136
train,140,1233,946944,21066,3033504,3980448
train,141,1165,894720,19644,2828736,3723456
train,142,992,761856,16059,2312496,3074352
train,143,1317,1011456,22788,3281472,4292928
train,144,1337,1026816,23209,3342096,4368912
train,145,1196,918528,20265,2918160,3836688
train,146,1275,979200,21965,3162960,4142160
train,147,1225,940800,20887,3007728,3948528
train,148,1266,972288,21799,3139056,4111344
train,149,1018,781824,16624,2393856,3175680
train,150,2164,1661952,40467,5827248,7489200
train,151,1336,1026048,23187,3338928,4364976
train,152,1254,963072,21548,3102912,4065984
train,153,1756,1348608,32017,4610448,5959056
train,154,1066,818688,17557,2528208,3346896
train,155,1092,838656,18106,2607264,3445920
train,156,2220,1704960,41620,5993280,7698240
train,157,1267,973056,21817,3141648,4114704
train,158,1167,896256,19682,2834208,3730464
train,159,1485,1140480,26323,3790512,4930992
train,160,1184,909312,20019,2882736,3792048
train,161,1199,920832,20328,2927232,3848064
train,162,1117,857856,18665,2687760,3545616
train,163,1414,1085952,24835,3576240,4662192
train,164,1030,791040,16847,2425968,3217008
train,165,1067,819456,17577,2531088,3350544
train,166,1586,1218048,28398,4089312,5307360
train,167,2100,1612800,39125,5634000,7246800
train,168,1082,830976,17891,2576304,3407280
train,169,1405,1079040,24663,3551472,4630512
train,170,1472,1130496,26032,3748608,4879104
train,171,1304,1001472,22524,3243456,4244928
train,172,1092,838656,18106,2607264,3445920
train,173,1317,1011456,22788,3281472,4292928
train,174,1263,969984,21744,3131136,4101120
train,175,1237,950016,21156,3046464,3996480
train,176,1181,907008,19959,2874096,3781104
train,177,1216,933888,20690,2979360,3913248
train,178,1358,1042944,23671,3408624,4451568
train,179,1135,871680,19085,2748240,3619920
train,180,1092,838656,18106,2607264,3445920
train,181,1219,936192,20755,2988720,3924912
train,182,1184,909312,20019,2882736,3792048
train,183,1117,857856,18665,2687760,3545616
train,184,1029,790272,16828,2423232,3213504
train,185,1383,1062144,24248,3491712,4553856
train,186,1079,828672,17828,2567232,3395904
train,187,1527,1172736,27213,3918672,5091408
train,188,1426,1095168,25070,3610080,4705248
train,189,1275,979200,21964,3162816,4142016
train,190,1053,808704,17293,2490192,3298896
train,191,1224,940032,20865,3004560,3944592
train,192,1120,860160,18734,2697696,3557856
train,193,1080,829440,17849,2570256,3399696
train,194,1355,1040640,23604,3398976,4439616
train,195,1116,857088,18642,2684448,3541536
train,196,1346,1033728,23405,3370320,4404048
train,197,1394,1070592,24459,3522096,4592688
train,198,1285,986880,22153,3190032,4176912
train,199,1045,802560,17136,2467584,3270144
train,200,1138,873984,19139,2756016,3630000
train,201,1337,1026816,23209,3342096,4368912
train,202,1138,873984,19139,2756016,3630000
train,203,1206,926208,20475,2948400,3874608
train,204,1353,1039104,23559,3392496,4431600
train,205,1325,1017600,22954,3305376,4322976
train,206,1230,944640,20998,3023712,3968352
train,207,1413,1085184,24816,3573504,4658688
train,208,1068,820224,17598,2534112,3354336
train,209,1184,909312,20019,2882736,3792048
train,210,1224,940032,20865,3004560,3944592
train,211,1451,1114368,25581,3683664,4798032
train,212,1135,871680,19085,2748240,3619920
train,213,1130,867840,18967,2731248,3599088
train,214,1183,908544,19999,2879856,3788400
train,215,1109,851712,18483,2661552,3513264
train,216,1049,805632,17214,2478816,3284448
train,217,1195,917760,20245,2915280,3833040
train,218,1170,898560,19741,2842704,3741264
train,219,1270,975360,21872,3149568,4124928
train,220,1138,873984,19139,2756016,3630000
train,221,1196,918528,20265,2918160,3836688
train,222,1265,971520,21780,3136320,4107840
train,223,1253,962304,21525,3099600,4061904
train,224,1422,1092096,24991,3598704,4690800
train,225,1110,852480,18505,2664720,3517200
train,226,1150,883200,19359,2787696,3670896
train,227,1130,867840,18967,2731248,3599088
train,228,1171,899328,19760,2845440,3744768
train,229,1284,986112,22134,3187296,4173408
train,230,1280,983040,22058,3176352,4159392
train,231,1323,1016064,22912,3299328,4315392
train,232,1043,801024,17096,2461824,3262848
train,233,1957,1502976,36129,5202576,6705552
train,234,1204,924672,20433,2942352,3867024
train,235,1230,944640,20998,3023712,3968352
train,236,1123,862464,18803,2707632,3570096
train,237,1218,935424,20734,2985696,3921120
train,238,1290,990720,22249,3203856,4194576
train,239,1210,929280,20561,2960784,3890064
train,240,1111,853248,18528,2668032,3521280
train,241,1299,997632,22425,3229200,4226832
train,242,1050,806400,17234,2481696,3288096
train,243,1831,1406208,33502,4824288,6230496
train,244,1150,883200,19359,2787696,3670896
train,245,1376,1056768,24084,3468096,4524864
train,246,1329,1020672,23038,3317472,4338144
train,247,1680,1290240,30360,4371840,5662080
train,248,1123,862464,18803,2707632,3570096
train,249,1242,953856,21270,3062880,4016736
train,250,1042,800256,17077,2459088,3259344
train,251,1207,926976,20497,2951568,3878544
train,252,1146,880128,19285,2777040,3657168
train,253,1145,879360,19266,2774304,3653664
train,254,1228,943104,20954,3017376,3960480
train,255,1115,856320,18619,2681136,3537456
train,256,1354,1039872,23582,3395808,4435680
train,257,1109,851712,18483,2661552,3513264
train,258,1290,990720,22249,3203856,4194576
train,259,1024,786432,16735,2409840,3196272
train,260,1164,893952,19624,2825856,3719808
train,261,1453,1115904,25623,3689712,4805616
train,262,1021,784128,16679,2401776,3185904
train,263,1398,1073664,24533,3532752,4606416
train,264,1406,1079808,24682,3554208,4634016
train,265,1195,917760,20245,2915280,3833040
train,266,1182,907776,19979,2876976,3784752
train,267,1260,967680,21690,3123360,4091040
train,268,1080,829440,17849,2570256,3399696
train,269,1379,1059072,24154,3478176,4537248
train,270,1259,966912,21666,3119904,4086816
train,271,1151,883968,19378,2790432,3674400
train,272,1246,956928,21362,3076128,4033056
train,273,1143,877824,19230,2769120,3646944
train,274,1225,940800,20887,3007728,3948528
train,275,1059,813312,17414,2507616,3320928
train,276,1100,844800,18282,2632608,3477408
train,277,1174,901632,19820,2854080,3755712
train,278,1125,864000,18850,2714400,3578400
train,279,1438,1104384,25311,3644784,4749168
train,280,1177,903936,19879,2862576,3766512
train,281,1171,899328,19760,2845440,3744768
train,282,1088,835584,18020,2594880,3430464
train,283,1146,880128,19285,2777040,3657168
train,284,1304,1001472,22524,3243456,4244928
train,285,1151,883968,19378,2790432,3674400
train,286,1111,853248,18528,2668032,3521280
train,287,1053,808704,17293,2490192,3298896
train,288,1072,823296,17681,2546064,3369360
train,289,1095,840960,18172,2616768,3457728
train,290,1210,929280,20561,2960784,3890064
train,291,1209,928512,20539,2957616,3886128
train,292,1081,830208,17870,2573280,3403488
train,293,1086,834048,17977,2588688,3422736
train,294,1403,1077504,24626,3546144,4623648
train,295,1338,1027584,23231,3345264,4372848
train,296,1150,883200,19359,2787696,3670896
train,297,1097,842496,18216,2623104,3465600
train,298,1008,774144,16432,2366208,3140352
train,299,1026,787968,16772,2415168,3203136
train,300,1084,832512,17934,2582496,3415008
train,301,1172,900096,19780,2848320,3748416
train,302,1127,865536,18896,2721024,3586560
train,303,1242,953856,21270,3062880,4016736
train,304,1263,969984,21744,3131136,4101120
train,305,1251,960768,21478,3092832,4053600
train,306,1143,877824,19230,2769120,3646944
train,307,1296,995328,22366,3220704,4216032
train,308,1178,904704,19899,2865456,3770160
train,309,1257,965376,21619,3113136,4078512
train,310,1066,818688,17557,2528208,3346896
train,311,1205,925440,20454,2945376,3870816
train,312,1014,778752,16551,2383344,3162096
train,313,1139,874752,19157,2758608,3633360
train,314,1314,1009152,22726,3272544,4281696
train,315,1142,877056,19211,2766384,3643440
train,316,1140,875520,19175,2761200,3636720
train,317,1327,1019136,22996,3311424,4330560
train,318,1158,889344,19510,2809440,3698784
train,319,1184,909312,20019,2882736,3792048
train,320,1221,937728,20799,2995056,3932784
train,321,1017,781056,16606,2391264,3172320
train,322,1322,1015296,22891,3296304,4311600
train,323,1083,831744,17913,2579472,3411216
train,324,1333,1023744,23123,3329712,4353456
train,325,1186,910848,20060,2888640,3799488
train,326,1355,1040640,23604,3398976,4439616
train,327,1231,945408,21021,3027024,3972432
train,328,1238,950784,21179,3049776,4000560
train,329,1127,865536,18896,2721024,3586560
train,330,1311,1006848,22665,3263760,4270608
train,331,1681,1291008,30380,4374720,5665728
train,332,1542,1184256,27499,3959856,5144112
train,333,1451,1114368,25581,3683664,4798032
train,334,1289,989952,22230,3201120,4191072
train,335,1334,1024512,23145,3332880,4357392
train,336,1106,849408,18415,2651760,3501168
train,337,1109,851712,18483,2661552,3513264
train,338,1226,941568,20909,3010896,3952464
train,339,1259,966912,21666,3119904,4086816
train,340,1395,1071360,24477,3524688,4596048
train,341,1152,884736,19396,2793024,3677760
train,342,1103,847104,18348,2642112,3489216
train,343,1163,893184,19605,2823120,3716304
train,344,1235,948480,21111,3039984,3988464
train,345,1401,1075968,24588,3540672,4616640
train,346,1055,810240,17333,2495952,3306192
train,347,1118,858624,18688,2691072,3549696
train,348,1376,1056768,24084,3468096,4524864
train,349,1140,875520,19175,2761200,3636720
train,350,1262,969216,21726,3128544,4097760
train,351,1104,847872,18371,2645424,3493296
train,352,2313,1776384,43549,6271056,8047440
train,353,1178,904704,19899,2865456,3770160
train,354,1037,796416,16981,2445264,3241680
train,355,1381,1060608,24201,3484944,4545552
train,356,1202,923136,20391,2936304,3859440
train,357,1047,804096,17175,2473200,3277296
train,358,1251,960768,21478,3092832,4053600
train,359,1297,996096,22385,3223440,4219536
train,360,1339,1028352,23252,3348288,4376640
train,361,1096,841728,18194,2619936,3461664
train,362,1325,1017600,22954,3305376,4322976
train,363,1357,1042176,23649,3405456,4447632
train,364,1497,1149696,26596,3829824,4979520
train,365,1337,1026816,23209,3342096,4368912
train,366,1101,845568,18304,2635776,3481344
train,367,1181,907008,19959,2874096,3781104
train,368,1136,872448,19103,2750832,3623280
train,369,1043,801024,17096,2461824,3262848
train,370,1838,1411584,33652,4845888,6257472
train,371,1038,797184,17000,2448000,3245184
train,372,1277,980736,22002,3168288,4149024
train,373,1164,893952,19624,2825856,3719808
train,374,1135,871680,19085,2748240,3619920
train,375,1186,910848,20060,2888640,3799488
train,376,1003,770304,16314,2349216,3119520
train,377,1338,1027584,23231,3345264,4372848
train,378,1358,1042944,23671,3408624,4451568
train,379,1367,1049856,23875,3438000,4487856
train,380,1560,1198080,27856,4011264,5209344
train,381,1110,852480,18505,2664720,3517200
train,382,1690,1297920,30563,4401072,5698992
train,383,1158,889344,19510,2809440,3698784
train,384,1108,850944,18460,2658240,3509184
train,385,1340,1029120,23274,3351456,4380576
train,386,1203,923904,20412,2939328,3863232
train,387,1552,1191936,27695,3988080,5180016
train,388,1206,926208,20475,2948400,3874608
train,389,1371,1052928,23968,3451392,4504320
train,390,1117,857856,18665,2687760,3545616
train,391,1126,864768,18873,2717712,3582480
train,392,1104,847872,18371,2645424,3493296
train,393,1204,924672,20433,2942352,3867024
train,394,1173,900864,19800,2851200,3752064
train,395,1039,797952,17019,2450736,3248688
train,396,1110,852480,18505,2664720,3517200
train,397,1118,858624,18688,2691072,3549696
train,398,1171,899328,19760,2845440,3744768
train,399,1350,1036800,23493,3382992,4419792
train,400,1163,893184,19605,2823120,3716304
train,401,1189,913152,20121,2897424,3810576
train,402,1054,809472,17313,2493072,3302544
train,403,1260,967680,21690,3123360,4091040
train,404,958,735744,15307,2204208,2939952
train,405,993,762624,16082,2315808,3078432
train,406,1219,936192,20755,2988720,3924912
train,407,1136,872448,19103,2750832,3623280
train,408,1101,845568,18304,2635776,3481344
train,409,1291,991488,22268,3206592,4198080
train,410,1304,1001472,22524,3243456,4244928
train,411,1483,1138944,26277,3783888,4922832
train,412,1279,982272,22039,3173616,4155888
train,413,1070,821760,17639,2540016,3361776
train,414,1320,1013760,22850,3290400,4304160
train,415,1172,900096,19780,2848320,3748416
train,416,1221,937728,20799,2995056,3932784
train,417,1210,929280,20561,2960784,3890064
train,418,1305,1002240,22544,3246336,4248576
train,419,1210,929280,20561,2960784,3890064
train,420,2130,1635840,39810,5732640,7368480
train,421,1059,813312,17414,2507616,3320928
train,422,1010,775680,16479,2372976,3148656
train,423,1441,1106688,25373,3653712,4760400
train,424,1176,903168,19859,2859696,3762864
train,425,1252,961536,21502,3096288,4057824
train,426,1138,873984,19139,2756016,3630000
train,427,1400,1075200,24570,3538080,4613280
train,428,1221,937728,20799,2995056,3932784
train,429,1046,803328,17155,2470320,3273648
train,430,1137,873216,19121,2753424,3626640
train,431,1364,1047552,23807,3428208,4475760
train,432,1062,815616,17475,2516400,3332016
train,433,1129,867072,18943,2727792,3594864
train,434,1349,1036032,23471,3379824,4415856
train,435,1207,926976,20497,2951568,3878544
train,436,1257,965376,21619,3113136,4078512
train,437,1167,896256,19682,2834208,3730464
train,438,1664,1277952,30046,4326624,5604576
train,439,1121,860928,18757,2701008,3561936
train,440,1258,966144,21643,3116592,4082736
train,441,1134,870912,19061,2744784,3615696
train,442,1181,907008,19959,2874096,3781104
train,443,1285,986880,22153,3190032,4176912
train,444,1161,891648,19567,2817648,3709296
train,445,1111,853248,18528,2668032,3521280
train,446,1466,1125888,25901,3729744,4855632
train,447,1073,824064,17702,2549088,3373152
train,448,1109,851712,18483,2661552,3513264
train,449,1204,924672,20433,2942352,3867024
train,450,1219,936192,20755,2988720,3924912
train,451,1523,1169664,27138,3907872,5077536
train,452,1258,966144,21643,3116592,4082736
train,453,1321,1014528,22871,3293424,4307952
train,454,1145,879360,19266,2774304,3653664
train,455,1272,976896,21910,3155040,4131936
train,456,1155,887040,19453,2801232,3688272
train,457,1201,922368,20371,2933424,3855792
train,458,924,709632,14609,2103696,2813328
train,459,1256,964608,21595,3109680,4074288
train,460,1271,976128,21890,3152160,4128288
train,461,1368,1050624,23898,3441312,4491936
train,462,1337,1026816,23209,3342096,4368912
train,463,1093,839424,18128,2610432,3449856
train,464,1254,963072,21548,3102912,4065984
train,465,1182,907776,19979,2876976,3784752
train,466,1354,1039872,23582,3395808,4435680
train,467,1147,880896,19303,2779632,3660528
train,468,1153,885504,19415,2795760,3681264
train,469,1195,917760,20245,2915280,3833040
train,470,1131,868608,18990,2734560,3603168
train,471,1132,869376,19014,2738016,3607392
train,472,1242,953856,21270,3062880,4016736
train,473,1026,787968,16772,2415168,3203136
train,474,1259,966912,21666,3119904,4086816
train,475,1057,811776,17374,2501856,3313632
train,476,1224,940032,20865,3004560,3944592
train,477,1232,946176,21043,3030192,3976368
train,478,1124,863232,18826,2710944,3574176
train,479,1347,1034496,23426,3373344,4407840
train,480,1267,973056,21817,3141648,4114704
train,481,1313,1008384,22706,3269664,4278048
train,482,1488,1142784,26390,3800160,4942944
train,483,1418,1089024,24913,3587472,4676496
train,484,976,749568,15699,2260656,3010224
train,485,1385,1063680,24296,3498624,4562304
train,486,1100,844800,18282,2632608,3477408
train,487,1119,859392,18711,2694384,3553776
train,488,1243,954624,21293,3066192,4020816
train,489,1015,779520,16570,2386080,3165600
train,490,1219,936192,20755,2988720,3924912
train,491,962,738816,15393,2216592,2955408
train,492,1478,1135104,26165,3767760,4902864
train,493,1241,953088,21247,3059568,4012656
train,494,1233,946944,21066,3033504,3980448
train,495,1265,971520,21780,3136320,4107840
train,496,1325,1017600,22954,3305376,4322976
train,497,1073,824064,17702,2549088,3373152
train,498,1084,832512,17934,2582496,3415008
train,499,1301,999168,22464,3234816,4233984
validation,0,1312,1007616,22686,3266784,4274400
validation,1,1093,839424,18128,2610432,3449856
validation,2,1022,784896,16698,2404512,3189408
validation,3,1307,1003776,22584,3252096,4255872
validation,4,1065,817920,17536,2525184,3343104
validation,5,1227,942336,20932,3014208,3956544
validation,6,1302,999936,22484,3237696,4237632
validation,7,1270,975360,21872,3149568,4124928
validation,8,1107,850176,18438,2655072,3505248
validation,9,1121,860928,18757,2701008,3561936
validation,10,1240,952320,21224,3056256,4008576
validation,11,1255,963840,21572,3106368,4070208
validation,12,1093,839424,18128,2610432,3449856
validation,13,1027,788736,16791,2417904,3206640
validation,14,1468,1127424,25944,3735936,4863360
validation,15,1345,1032960,23383,3367152,4400112
validation,16,1291,991488,22268,3206592,4198080
validation,17,1039,797952,17019,2450736,3248688
validation,18,1004,771072,16338,2352672,3123744
validation,19,1191,914688,20162,2903328,3818016
validation,20,1159,890112,19529,2812176,3702288
validation,21,1096,841728,18194,2619936,3461664
validation,22,1181,907008,19959,2874096,3781104
validation,23,1245,956160,21339,3072816,4028976
validation,24,1116,857088,18642,2684448,3541536
validation,25,1312,1007616,22686,3266784,4274400
validation,26,1304,1001472,22524,3243456,4244928
validation,27,1318,1012224,22809,3284496,4296720
validation,28,1392,1069056,24422,3516768,4585824
validation,29,1446,1110528,25476,3668544,4779072
validation,30,1336,1026048,23187,3338928,4364976
validation,31,1198,920064,20307,2924208,3844272
validation,32,1106,849408,18415,2651760,3501168
validation,33,1197,919296,20286,2921184,3840480
validation,34,1016,780288,16588,2388672,3168960
validation,35,1354,1039872,23582,3395808,4435680
validation,36,932,715776,14769,2126736,2842512
validation,37,1199,920832,20328,2927232,3848064
validation,38,1060,814080,17434,2510496,3324576
validation,39,1276,979968,21983,3165552,4145520
validation,40,1271,976128,21890,3152160,4128288
validation,41,1335,1025280,23166,3335904,4361184
validation,42,1107,850176,18438,2655072,3505248
validation,43,1170,898560,19741,2842704,3741264
validation,44,1014,778752,16551,2383344,3162096
validation,45,1009,774912,16456,2369664,3144576
validation,46,1238,950784,21179,3049776,4000560
validation,47,1210,929280,20561,2960784,3890064
validation,48,1030,791040,16847,2425968,3217008
validation,49,1023,785664,16716,2407104,3192768
validation,50,1386,1064448,24313,3501072,4565520
validation,51,1176,903168,19859,2859696,3762864
validation,52,1374,1055232,24037,3461328,4516560
validation,53,1098,843264,18238,2626272,3469536
validation,54,1090,837120,18063,2601072,3438192
validation,55,1222,938496,20821,2998224,3936720
validation,56,1199,920832,20328,2927232,3848064
validation,57,1128,866304,18920,2724480,3590784
validation,58,1092,838656,18106,2607264,3445920
validation,59,1246,956928,21362,3076128,4033056
validation,60,1129,867072,18943,2727792,3594864
validation,61,1034,794112,16923,2436912,3231024
validation,62,1325,1017600,22954,3305376,4322976
validation,63,1246,956928,21362,3076128,4033056
validation,64,1356,1041408,23626,3402144,4443552
validation,65,1294,993792,22327,3215088,4208880
validation,66,1244,955392,21316,3069504,4024896
validation,67,1157,888576,19491,2806704,3695280
validation,68,1278,981504,22020,3170880,4152384
validation,69,1192,915456,20183,2906352,3821808
validation,70,1299,997632,22425,3229200,4226832
validation,71,1048,804864,17194,2475936,3280800
validation,72,961,738048,15371,2213424,2951472
validation,73,1357,1042176,23649,3405456,4447632
validation,74,1074,824832,17722,2551968,3376800
validation,75,1348,1035264,23448,3376512,4411776
validation,76,1251,960768,21478,3092832,4053600
validation,77,1056,811008,17354,2498976,3309984
validation,78,1120,860160,18734,2697696,3557856
validation,79,1180,906240,19939,2871216,3777456
validation,80,1126,864768,18873,2717712,3582480
validation,81,1224,940032,20865,3004560,3944592
validation,82,1320,1013760,22850,3290400,4304160
validation,83,1084,832512,17934,2582496,3415008
validation,84,1054,809472,17313,2493072,3302544
validation,85,1097,842496,18216,2623104,3465600
validation,86,1347,1034496,23426,3373344,4407840
validation,87,1078,827904,17806,2564064,3391968
validation,88,1092,838656,18106,2607264,3445920
validation,89,1221,937728,20799,2995056,3932784
validation,90,1337,1026816,23209,3342096,4368912
validation,91,1277,980736,22002,3168288,4149024
validation,92,1248,958464,21408,3082752,4041216
validation,93,1135,871680,19085,2748240,3619920
validation,94,1334,1024512,23145,3332880,4357392
validation,95,1076,826368,17764,2558016,3384384
validation,96,1321,1014528,22871,3293424,4307952
validation,97,1125,864000,18850,2714400,3578400
validation,98,1162,892416,19586,2820384,3712800
validation,99,1026,787968,16772,2415168,3203136
validation,100,1312,1007616,22686,3266784,4274400
validation,101,1259,966912,21666,3119904,4086816
validation,102,1125,864000,18850,2714400,3578400
validation,103,1012,777216,16515,2378160,3155376
validation,104,1276,979968,21983,3165552,4145520
validation,105,1166,895488,19663,2831472,3726960
validation,106,1074,824832,17723,2552112,3376944
validation,107,1314,1009152,22726,3272544,4281696
validation,108,1217,934656,20712,2982528,3917184
validation,109,1071,822528,17660,2543040,3365568
validation,110,993,762624,16082,2315808,3078432
validation,111,994,763392,16105,2319120,3082512
validation,112,1358,1042944,23671,3408624,4451568
validation,113,1000,768000,16244,2339136,3107136
validation,114,1265,971520,21780,3136320,4107840
validation,115,1290,990720,22249,3203856,4194576
validation,116,1159,890112,19529,2812176,3702288
validation,117,1288,989184,22210,3198240,4187424
validation,118,958,735744,15307,2204208,2939952
validation,119,1177,903936,19879,2862576,3766512
validation,120,1089,836352,18041,2597904,3434256
validation,121,1353,1039104,23559,3392496,4431600
validation,122,1249,959232,21432,3086208,4045440
validation,123,1269,974592,21853,3146832,4121424
validation,124,1332,1022976,23102,3326688,4349664
validation,125,1122,861696,18780,2704320,3566016
validation,126,1237,950016,21156,3046464,3996480
validation,127,1609,1235712,28904,4162176,5397888
validation,128,1080,829440,17849,2570256,3399696
validation,129,1275,979200,21964,3162816,4142016
validation,130,1021,784128,16679,2401776,3185904
validation,131,1273,977664,21927,3157488,4135152
validation,132,1106,849408,18415,2651760,3501168
validation,133,1314,1009152,22726,3272544,4281696
validation,134,1088,835584,18020,2594880,3430464
validation,135,1379,1059072,24154,3478176,4537248
validation,136,1068,820224,17598,2534112,3354336
validation,137,1065,817920,17536,2525184,3343104
validation,138,1245,956160,21339,3072816,4028976
validation,139,1270,975360,21872,3149568,4124928
validation,140,1346,1033728,23406,3370464,4404192
validation,141,1150,883200,19359,2787696,3670896
validation,142,1190,913920,20141,2900304,3814224
validation,143,1071,822528,17660,2543040,3365568
validation,144,1388,1065984,24350,3506400,4572384
validation,145,1184,909312,20019,2882736,3792048
validation,146,1328,1019904,23017,3314448,4334352
validation,147,1124,863232,18826,2710944,3574176
validation,148,1169,897792,19721,2839824,3737616
validation,149,1109,851712,18483,2661552,3513264
validation,150,1110,852480,18505,2664720,3517200
validation,151,1046,803328,17155,2470320,3273648
validation,152,1592,1222656,28528,4108032,5330688
validation,153,1177,903936,19879,2862576,3766512
validation,154,1194,916992,20224,2912256,3829248
validation,155,1001,768768,16267,2342448,3111216
validation,156,1172,900096,19780,2848320,3748416
validation,157,1340,1029120,23274,3351456,4380576
validation,158,1138,873984,19139,2756016,3630000
validation,159,1044,801792,17116,2464704,3266496
validation,160,1059,813312,17414,2507616,3320928
validation,161,1101,845568,18304,2635776,3481344
validation,162,1082,830976,17891,2576304,3407280
validation,163,1089,836352,18041,2597904,3434256
validation,164,1141,876288,19193,2763792,3640080
test,0,1282,984576,22096,3181824,4166400
test,1,1135,871680,19085,2748240,3619920
test,2,1269,974592,21853,3146832,4121424
test,3,1100,844800,18282,2632608,3477408
test,4,1269,974592,21853,3146832,4121424
test,5,1412,1084416,24797,3570768,4655184
test,6,1200,921600,20349,2930256,3851856
test,7,1058,812544,17394,2504736,3317280
test,8,1243,954624,21293,3066192,4020816
test,9,1164,893952,19624,2825856,3719808
test,10,1418,1089024,24913,3587472,4676496
test,11,1141,876288,19193,2763792,3640080
test,12,1350,1036800,23493,3382992,4419792
test,13,1272,976896,21909,3154896,4131792
test,14,1321,1014528,22871,3293424,4307952
test,15,1441,1106688,25373,3653712,4760400
test,16,1127,865536,18896,2721024,3586560
test,17,1259,966912,21666,3119904,4086816
test,18,1111,853248,18528,2668032,3521280
test,19,1062,815616,17475,2516400,3332016
test,20,1473,1131264,26054,3751776,4883040
test,21,1042,800256,17077,2459088,3259344
test,22,1387,1065216,24331,3503664,4568880
test,23,1211,930048,20582,2963808,3893856
test,24,1286,987648,22172,3192768,4180416
test,25,1067,819456,17577,2531088,3350544
test,26,1256,964608,21595,3109680,4074288
test,27,1405,1079040,24663,3551472,4630512
test,28,1221,937728,20799,2995056,3932784
test,29,1224,940032,20865,3004560,3944592
test,30,1129,867072,18943,2727792,3594864
test,31,1245,956160,21339,3072816,4028976
test,32,3033,2329344,58590,8436960,10766304
test,33,979,751872,15765,2270160,3022032
test,34,1172,900096,19780,2848320,3748416
test,35,1176,903168,19859,2859696,3762864
test,36,1240,952320,21224,3056256,4008576
test,37,1185,910080,20040,2885760,3795840
test,38,1013,777984,16533,2380752,3158736
test,39,1062,815616,17475,2516400,3332016
test,40,946,726528,15054,2167776,2894304
test,41,1111,853248,18528,2668032,3521280
test,42,1193,916224,20203,2909232,3825456
test,43,1553,1192704,27715,3990960,5183664
test,44,1141,876288,19193,2763792,3640080
test,45,1163,893184,19605,2823120,3716304
test,46,1452,1115136,25602,3686688,4801824
test,47,1091,837888,18085,2604240,3442128
test,48,1334,1024512,23145,3332880,4357392
test,49,1158,889344,19510,2809440,3698784
test,50,1056,811008,17354,2498976,3309984
test,51,1089,836352,18041,2597904,3434256
test,52,1103,847104,18348,2642112,3489216
test,53,1183,908544,19999,2879856,3788400
test,54,1069,820992,17618,2536992,3357984
test,55,1707,1310976,30918,4452192,5763168
test,56,1180,906240,19939,2871216,3777456
test,57,1349,1036032,23471,3379824,4415856
test,58,1285,986880,22153,3190032,4176912
test,59,1144,878592,19248,2771712,3650304
test,60,1242,953856,21270,3062880,4016736
test,61,1358,1042944,23671,3408624,4451568
test,62,1327,1019136,22996,3311424,4330560
test,63,1262,969216,21726,3128544,4097760
test,64,1404,1078272,24645,3548880,4627152
test,65,1237,950016,21156,3046464,3996480
test,66,1019,782592,16643,2396592,3179184
test,67,923,708864,14589,2100816,2809680
test,68,1218,935424,20734,2985696,3921120
test,69,1306,1003008,22564,3249216,4252224
test,70,1061,814848,17454,2513376,3328224
test,71,1374,1055232,24037,3461328,4516560
test,72,1124,863232,18826,2710944,3574176
test,73,1174,901632,19820,2854080,3755712
test,74,974,748032,15654,2254176,3002208
test,75,1336,1026048,23188,3339072,4365120
test,76,1140,875520,19175,2761200,3636720
test,77,1211,930048,20582,2963808,3893856
test,78,1095,840960,18172,2616768,3457728
test,79,1160,890880,19548,2814912,3705792
test,80,1325,1017600,22954,3305376,4322976
test,81,1257,965376,21619,3113136,4078512
test,82,1134,870912,19061,2744784,3615696
test,83,1136,872448,19103,2750832,3623280
test,84,1230,944640,20998,3023712,3968352
test,85,1363,1046784,23784,3424896,4471680
test,86,1092,838656,18106,2607264,3445920
test,87,1102,846336,18326,2638944,3485280
test,88,1212,930816,20604,2966976,3897792
test,89,1164,893952,19624,2825856,3719808
test,90,1127,865536,18896,2721024,3586560
test,91,1174,901632,19820,2854080,3755712
test,92,1048,804864,17194,2475936,3280800
test,93,1330,1021440,23059,3320496,4341936
test,94,1065,817920,17536,2525184,3343104
test,95,1725,1324800,31309,4508496,5833296
test,96,1453,1115904,25623,3689712,4805616
test,97,968,743424,15523,2235312,2978736
test,98,1279,982272,22039,3173616,4155888
test,99,1366,1049088,23853,3434832,4483920
test,100,1245,956160,21339,3072816,4028976
test,101,1043,801024,17096,2461824,3262848
test,102,1070,821760,17639,2540016,3361776
test,103,1287,988416,22191,3195504,4183920
test,104,1009,774912,16456,2369664,3144576
test,105,1250,960000,21455,3089520,4049520
test,106,1071,822528,17660,2543040,3365568
test,107,1144,878592,19248,2771712,3650304
test,108,1345,1032960,23383,3367152,4400112
test,109,1004,771072,16338,2352672,3123744
test,110,1143,877824,19230,2769120,3646944
test,111,1233,946944,21066,3033504,3980448
test,112,1425,1094400,25050,3607200,4701600
test,113,1215,933120,20668,2976192,3909312
test,114,1046,803328,17155,2470320,3273648
test,115,1099,844032,18260,2629440,3473472
test,116,988,758784,15968,2299392,3058176
test,117,979,751872,15765,2270160,3022032
test,118,1091,837888,18085,2604240,3442128
test,119,1168,897024,19702,2837088,3734112
test,120,1226,941568,20909,3010896,3952464
test,121,1170,898560,19741,2842704,3741264
test,122,1105,848640,18393,2648592,3497232
test,123,1071,822528,17660,2543040,3365568
test,124,1393,1069824,24440,3519360,4589184
test,125,1352,1038336,23537,3389328,4427664
test,126,1030,791040,16847,2425968,3217008
test,127,1245,956160,21339,3072816,4028976
test,128,1275,979200,21964,3162816,4142016
test,129,1369,1051392,23921,3444624,4496016
test,130,1150,883200,19359,2787696,3670896
test,131,1136,872448,19103,2750832,3623280
test,132,1161,891648,19567,2817648,3709296
test,133,1257,965376,21619,3113136,4078512
test,134,1324,1016832,22933,3302352,4319184
test,135,1240,952320,21224,3056256,4008576
test,136,1337,1026816,23209,3342096,4368912
test,137,1321,1014528,22871,3293424,4307952
test,138,1255,963840,21572,3106368,4070208
test,139,1163,893184,19605,2823120,3716304
test,140,1263,969984,21744,3131136,4101120
test,141,1081,830208,17870,2573280,3403488
test,142,1033,793344,16904,2434176,3227520
test,143,1036,795648,16961,2442384,3238032
test,144,1133,870144,19037,2741328,3611472
test,145,1215,933120,20668,2976192,3909312
test,146,1079,828672,17828,2567232,3395904
test,147,1109,851712,18483,2661552,3513264
test,148,1335,1025280,23166,3335904,4361184
test,149,998,766464,16198,2332512,3098976
test,150,1127,865536,18896,2721024,3586560
test,151,1337,1026816,23209,3342096,4368912
test,152,1065,817920,17536,2525184,3343104
test,153,1402,1076736,24607,3543408,4620144
test,154,1339,1028352,23252,3348288,4376640
test,155,1226,941568,20909,3010896,3952464
test,156,1233,946944,21066,3033504,3980448
test,157,1375,1056000,24060,3464640,4520640
test,158,1023,785664,16716,2407104,3192768
test,159,1329,1020672,23038,3317472,4338144
test,160,1363,1046784,23784,3424896,4471680
test,161,1030,791040,16847,2425968,3217008
test,162,1394,1070592,24459,3522096,4592688
test,163,1382,1061376,24224,3488256,4549632
test,164,1039,797952,17019,2450736,3248688
test,165,1146,880128,19285,2777040,3657168
test,166,1043,801024,17096,2461824,3262848
test,167,1271,976128,21890,3152160,4128288
test,168,1180,906240,19939,2871216,3777456
test,169,960,737280,15350,2210400,2947680
test,170,1208,927744,20518,2954592,3882336
test,171,1397,1072896,24514,3530016,4602912
test,172,1178,904704,19899,2865456,3770160
test,173,1328,1019904,23017,3314448,4334352
test,174,1155,887040,19453,2801232,3688272
test,175,1301,999168,22464,3234816,4233984
test,176,1139,874752,19157,2758608,3633360
test,177,1043,801024,17096,2461824,3262848
test,178,1237,950016,21156,3046464,3996480
test,179,1324,1016832,22933,3302352,4319184
test,180,1120,860160,18734,2697696,3557856
test,181,1150,883200,19359,2787696,3670896
test,182,1266,972288,21799,3139056,4111344
test,183,1342,1030656,23317,3357648,4388304
test,184,1289,989952,22230,3201120,4191072
test,185,1020,783360,16661,2399184,3182544
test,186,1186,910848,20060,2888640,3799488
test,187,1032,792576,16885,2431440,3224016
test,188,1212,930816,20604,2966976,3897792
test,189,1168,897024,19702,2837088,3734112
test,190,1146,880128,19285,2777040,3657168
test,191,1223,939264,20843,3001392,3940656
test,192,1146,880128,19285,2777040,3657168
test,193,1229,943872,20976,3020544,3964416
test,194,1324,1016832,22933,3302352,4319184
test,195,1129,867072,18943,2727792,3594864
test,196,1237,950016,21156,3046464,3996480
test,197,1361,1045248,23739,3418416,4463664
test,198,1307,1003776,22584,3252096,4255872
test,199,987,758016,15945,2296080,3054096
test,200,1305,1002240,22544,3246336,4248576
test,201,1179,905472,19919,2868336,3773808
test,202,1209,928512,20539,2957616,3886128
test,203,1064,817152,17516,2522304,3339456
test,204,991,761088,16036,2309184,3070272
test,205,1239,951552,21202,3053088,4004640
test,206,1203,923904,20412,2939328,3863232
test,207,1211,930048,20582,2963808,3893856
test,208,1061,814848,17454,2513376,3328224
test,209,1163,893184,19605,2823120,3716304
test,210,1237,950016,21156,3046464,3996480
test,211,925,710400,14629,2106576,2816976
test,212,1284,986112,22134,3187296,4173408
test,213,1310,1006080,22645,3260880,4266960
test,214,1264,970752,21762,3133728,4104480
test,215,986,757248,15923,2292912,3050160
test,216,1296,995328,22366,3220704,4216032
test,217,1108,850944,18460,2658240,3509184
test,218,1247,957696,21385,3079440,4037136
test,219,1405,1079040,24663,3551472,4630512
test,220,1055,810240,17333,2495952,3306192
test,221,1051,807168,17254,2484576,3291744
test,222,947,727296,15075,2170800,2898096
test,223,1090,837120,18063,2601072,3438192
test,224,1141,876288,19193,2763792,3640080
test,225,1108,850944,18460,2658240,3509184
test,226,1096,841728,18194,2619936,3461664
test,227,1194,916992,20224,2912256,3829248
test,228,1263,969984,21744,3131136,4101120
test,229,1093,839424,18128,2610432,3449856
test,230,1073,824064,17702,2549088,3373152
test,231,1305,1002240,22544,3246336,4248576
test,232,999,767232,16221,2335824,3103056
test,233,1034,794112,16923,2436912,3231024
test,234,1024,786432,16735,2409840,3196272
test,235,1101,845568,18304,2635776,3481344
test,236,1093,839424,18128,2610432,3449856
test,237,1381,1060608,24201,3484944,4545552
test,238,1358,1042944,23671,3408624,4451568
test,239,1296,995328,22366,3220704,4216032
test,240,1216,933888,20690,2979360,3913248
test,241,1230,944640,20998,3023712,3968352
test,242,1242,953856,21270,3062880,4016736
test,243,1176,903168,19859,2859696,3762864
test,244,966,741888,15479,2228976,2970864
test,245,3155,2423040,61139,8804016,11227056
test,246,1034,794112,16923,2436912,3231024
test,247,1318,1012224,22809,3284496,4296720
test,248,1120,860160,18734,2697696,3557856
test,249,1057,811776,17374,2501856,3313632
test,250,1468,1127424,25944,3735936,4863360
test,251,2291,1759488,43112,6208128,7967616
test,252,1172,900096,19780,2848320,3748416
test,253,1293,993024,22307,3212208,4205232
test,254,1177,903936,19879,2862576,3766512
test,255,1278,981504,22020,3170880,4152384
test,256,2898,2225664,55797,8034768,10260432
test,257,1163,893184,19605,2823120,3716304
test,258,1211,930048,20582,2963808,3893856
test,259,1350,1036800,23493,3382992,4419792
test,260,1171,899328,19760,2845440,3744768
test,261,1220,936960,20777,2991888,3928848
test,262,1265,971520,21780,3136320,4107840
test,263,1050,806400,17234,2481696,3288096
test,264,1492,1145856,26481,3813264,4959120
test,265,1151,883968,19378,2790432,3674400
test,266,1152,884736,19396,2793024,3677760
test,267,1124,863232,18826,2710944,3574176
test,268,1331,1022208,23081,3323664,4345872
test,269,1049,805632,17214,2478816,3284448
test,270,1124,863232,18826,2710944,3574176
test,271,1361,1045248,23739,3418416,4463664
test,272,1195,917760,20245,2915280,3833040
test,273,1227,942336,20932,3014208,3956544
test,274,1197,919296,20286,2921184,3840480
test,275,1377,1057536,24107,3471408,4528944
test,276,1150,883200,19359,2787696,3670896
test,277,1034,794112,16923,2436912,3231024
test,278,1170,898560,19741,2842704,3741264
test,279,1124,863232,18826,2710944,3574176
test,280,1209,928512,20539,2957616,3886128
test,281,1162,892416,19586,2820384,3712800
test,282,1172,900096,19780,2848320,3748416
test,283,1060,814080,17434,2510496,3324576
test,284,1277,980736,22002,3168288,4149024
test,285,1111,853248,18528,2668032,3521280
test,286,1466,1125888,25901,3729744,4855632
test,287,1180,906240,19939,2871216,3777456
test,288,1310,1006080,22645,3260880,4266960
test,289,997,765696,16174,2329056,3094752
test,290,1212,930816,20604,2966976,3897792
test,291,1136,872448,19103,2750832,3623280
test,292,1196,918528,20265,2918160,3836688
test,293,1137,873216,19121,2753424,3626640
test,294,1330,1021440,23059,3320496,4341936
test,295,1304,1001472,22524,3243456,4244928
test,296,1538,1181184,27421,3948624,5129808
test,297,1040,798720,17038,2453472,3252192
test,298,1299,997632,22425,3229200,4226832
test,299,1267,973056,21817,3141648,4114704
test,300,1116,857088,18642,2684448,3541536
test,301,1030,791040,16847,2425968,3217008
test,302,1245,956160,21339,3072816,4028976
test,303,1037,796416,16981,2445264,3241680
test,304,1451,1114368,25581,3683664,4798032
test,305,1097,842496,18216,2623104,3465600
test,306,1338,1027584,23231,3345264,4372848
test,307,1300,998400,22445,3232080,4230480
test,308,1264,970752,21762,3133728,4104480
test,309,1095,840960,18172,2616768,3457728
test,310,1240,952320,21224,3056256,4008576
test,311,1421,1091328,24971,3595824,4687152
test,312,1346,1033728,23405,3370320,4404048
test,313,1314,1009152,22726,3272544,4281696
test,314,1219,936192,20755,2988720,3924912
test,315,1292,992256,22288,3209472,4201728
test,316,1865,1432320,34251,4932144,6364464
test,317,991,761088,16036,2309184,3070272
test,318,1189,913152,20121,2897424,3810576
test,319,1300,998400,22445,3232080,4230480
test,320,1236,949248,21133,3043152,3992400
test,321,1360,1044480,23716,3415104,4459584
test,322,1230,944640,20998,3023712,3968352
test,323,1049,805632,17214,2478816,3284448
test,324,1160,890880,19548,2814912,3705792
test,325,1028,789504,16810,2420640,3210144
test,326,1097,842496,18216,2623104,3465600
test,327,1023,785664,16716,2407104,3192768
test,328,1301,999168,22464,3234816,4233984
test,329,1046,803328,17155,2470320,3273648
test,330,1147,880896,19303,2779632,3660528
test,331,1315,1009920,22747,3275568,4285488
test,332,1395,1071360,24477,3524688,4596048
test,333,1220,936960,20777,2991888,3928848
test,334,1079,828672,17828,2567232,3395904
