split,index,nodes,total_values_for_nodes,edges,total_values_for_edges,total_values_for_graph
train,0,420,322560,7775,1119600,1442160
train,1,346,265728,5277,759888,1025616
train,2,380,291840,6365,916560,1208400
train,3,290,222720,3707,533808,756528
train,4,125,96000,689,99216,195216
train,5,358,274944,5649,813456,1088400
train,6,121,92928,646,93024,185952
train,7,609,467712,14697,2116368,2584080
train,8,199,152832,1746,251424,404256
train,9,244,187392,2624,377856,565248
train,10,352,270336,5461,786384,1056720
train,11,114,87552,573,82512,170064
train,12,266,204288,3119,449136,653424
train,13,289,221952,3682,530208,752160
train,14,310,238080,4236,609984,848064
train,15,170,130560,1274,183456,314016
train,16,375,288000,6198,892512,1180512
train,17,263,201984,3049,439056,641040
train,18,395,303360,6877,990288,1293648
train,19,102,78336,459,66096,144432
train,20,217,166656,2076,298944,465600
train,21,158,121344,1101,158544,279888
train,22,220,168960,2134,307296,476256
train,23,245,188160,2646,381024,569184
train,24,436,334848,8379,1206576,1541424
train,25,414,317952,7555,1087920,1405872
train,26,309,237312,4209,606096,843408
train,27,410,314880,7409,1066896,1381776
train,28,213,163584,2000,288000,451584
train,29,158,121344,1101,158544,279888
train,30,158,121344,1101,158544,279888
train,31,313,240384,4318,621792,862176
train,32,395,303360,6877,990288,1293648
train,33,596,457728,14223,2048112,2505840
train,34,416,319488,7628,1098432,1417920
train,35,329,252672,4771,687024,939696
train,36,304,233472,4074,586656,820128
train,37,263,201984,3049,439056,641040
train,38,192,147456,1625,234000,381456
train,39,421,323328,7812,1124928,1448256
train,40,391,300288,6738,970272,1270560
train,41,342,262656,5155,742320,1004976
train,42,171,131328,1289,185616,316944
train,43,303,232704,4047,582768,815472
train,44,211,162048,1963,282672,444720
train,45,274,210432,3309,476496,686928
train,46,353,271104,5492,790848,1061952
train,47,421,323328,7812,1124928,1448256
train,48,256,196608,2889,416016,612624
train,49,253,194304,2822,406368,600672
train,50,459,352512,9286,1337184,1689696
train,51,220,168960,2134,307296,476256
train,52,306,235008,4127,594288,829296
train,53,444,340992,8689,1251216,1592208
train,54,95,72960,398,57312,130272
train,55,185,142080,1509,217296,359376
train,56,169,129792,1259,181296,311088
train,57,374,287232,6165,887760,1174992
train,58,444,340992,8689,1251216,1592208
train,59,553,424704,12762,1837728,2262432
train,60,213,163584,2000,288000,451584
train,61,224,172032,2212,318528,490560
train,62,360,276480,5712,822528,1099008
train,63,351,269568,5430,781920,1051488
train,64,351,269568,5430,781920,1051488
train,65,219,168192,2114,304416,472608
train,66,105,80640,486,69984,150624
train,67,85,65280,319,45936,111216
train,68,228,175104,2292,330048,505152
train,69,366,281088,5904,850176,1131264
train,70,253,194304,2822,406368,600672
train,71,186,142848,1525,219600,362448
train,72,104,79872,477,68688,148560
train,73,272,208896,3261,469584,678480
train,74,151,115968,1005,144720,260688
train,75,81,62208,290,41760,103968
train,76,360,276480,5712,822528,1099008
train,77,279,214272,3431,494064,708336
train,78,395,303360,6877,990288,1293648
train,79,261,200448,3003,432432,632880
train,80,410,314880,7409,1066896,1381776
train,81,296,227328,3862,556128,783456
train,82,250,192000,2755,396720,588720
train,83,401,307968,7088,1020672,1328640
train,84,410,314880,7409,1066896,1381776
train,85,145,111360,927,133488,244848
train,86,464,356352,9489,1366416,1722768
train,87,233,178944,2393,344592,523536
train,88,307,235776,4154,598176,833952
train,89,395,303360,6877,990288,1293648
train,90,364,279552,5840,840960,1120512
train,91,457,350976,9205,1325520,1676496
train,92,572,439296,13388,1927872,2367168
train,93,207,158976,1889,272016,430992
train,94,207,158976,1889,272016,430992
train,95,347,266496,5307,764208,1030704
train,96,400,307200,7052,1015488,1322688
train,97,154,118272,1046,150624,268896
train,98,339,260352,5065,729360,989712
train,99,184,141312,1493,214992,356304
train,100,341,261888,5125,738000,999888
train,101,296,227328,3862,556128,783456
train,102,258,198144,2934,422496,620640
train,103,318,244224,4457,641808,886032
train,104,366,281088,5904,850176,1131264
train,105,448,344064,8846,1273824,1617888
train,106,118,90624,614,88416,179040
train,107,210,161280,1944,279936,441216
train,108,234,179712,2414,347616,527328
train,109,256,196608,2889,416016,612624
train,110,271,208128,3237,466128,674256
train,111,187,143616,1542,222048,365664
train,112,298,228864,3914,563616,792480
train,113,357,274176,5618,808992,1083168
train,114,189,145152,1575,226800,371952
train,115,459,352512,9286,1337184,1689696
train,116,415,318720,7591,1093104,1411824
train,117,361,277248,5744,827136,1104384
train,118,162,124416,1157,166608,291024
train,119,416,319488,7628,1098432,1417920
train,120,639,490752,15848,2282112,2772864
train,121,315,241920,4374,629856,871776
train,122,204,156672,1835,264240,420912
train,123,336,258048,4976,716544,974592
train,124,285,218880,3580,515520,734400
train,125,186,142848,1525,219600,362448
train,126,117,89856,604,86976,176832
train,127,213,163584,2000,288000,451584
train,128,240,184320,2539,365616,549936
train,129,418,321024,7701,1108944,1429968
train,130,216,165888,2057,296208,462096
train,131,403,309504,7158,1030752,1340256
train,132,193,148224,1642,236448,384672
train,133,241,185088,2560,368640,553728
train,134,153,117504,1032,148608,266112
train,135,130,99840,745,107280,207120
train,136,175,134400,1350,194400,328800
train,137,315,241920,4374,629856,871776
train,138,701,538368,18443,2655792,3194160
train,139,434,333312,8302,1195488,1528800
train,140,324,248832,4627,666288,915120
train,141,202,155136,1799,259056,414192
train,142,218,167424,2095,301680,469104
train,143,304,233472,4074,586656,820128
train,144,409,314112,7373,1061712,1375824
train,145,269,206592,3190,459360,665952
train,146,101,77568,450,64800,142368
train,147,161,123648,1143,164592,288240
train,148,307,235776,4154,598176,833952
train,149,228,175104,2292,330048,505152
train,150,324,248832,4627,666288,915120
train,151,99,76032,432,62208,138240
train,152,166,127488,1215,174960,302448
train,153,371,284928,6067,873648,1158576
train,154,291,223488,3733,537552,761040
train,155,213,163584,2000,288000,451584
train,156,324,248832,4627,666288,915120
train,157,469,360192,9695,1396080,1756272
train,158,372,285696,6100,878400,1164096
train,159,282,216576,3505,504720,721296
train,160,109,83712,524,75456,159168
train,161,171,131328,1289,185616,316944
train,162,184,141312,1493,214992,356304
train,163,152,116736,1019,146736,263472
train,164,442,339456,8611,1239984,1579440
train,165,349,268032,5369,773136,1041168
train,166,330,253440,4800,691200,944640
train,167,139,106752,852,122688,229440
train,168,121,92928,646,93024,185952
train,169,87,66816,334,48096,114912
train,170,141,108288,877,126288,234576
train,171,485,372480,10368,1492992,1865472
train,172,184,141312,1493,214992,356304
train,173,441,338688,8572,1234368,1573056
train,174,340,261120,5095,733680,994800
train,175,318,244224,4457,641808,886032
train,176,245,188160,2646,381024,569184
train,177,358,274944,5649,813456,1088400
train,178,380,291840,6365,916560,1208400
train,179,398,305664,6982,1005408,1311072
train,180,355,272640,5555,799920,1072560
train,181,92,70656,373,53712,124368
train,182,132,101376,768,110592,211968
train,183,355,272640,5555,799920,1072560
train,184,250,192000,2755,396720,588720
train,185,388,297984,6635,955440,1253424
train,186,266,204288,3119,449136,653424
train,187,334,256512,4917,708048,964560
train,188,298,228864,3914,563616,792480
train,189,322,247296,4570,658080,905376
train,190,492,377856,10669,1536336,1914192
train,191,388,297984,6635,955440,1253424
train,192,271,208128,3237,466128,674256
train,193,336,258048,4976,716544,974592
train,194,250,192000,2755,396720,588720
train,195,266,204288,3119,449136,653424
train,196,421,323328,7812,1124928,1448256
train,197,119,91392,625,90000,181392
train,198,229,175872,2312,332928,508800
train,199,341,261888,5125,738000,999888
train,200,463,355584,9448,1360512,1716096
train,201,318,244224,4457,641808,886032
train,202,487,374016,10453,1505232,1879248
train,203,387,297216,6601,950544,1247760
train,204,224,172032,2212,318528,490560
train,205,262,201216,3026,435744,636960
train,206,269,206592,3190,459360,665952
train,207,574,440832,13455,1937520,2378352
train,208,299,229632,3941,567504,797136
train,209,344,264192,5216,751104,1015296
train,210,374,287232,6165,887760,1174992
train,211,404,310272,7194,1035936,1346208
train,212,156,119808,1073,154512,274320
train,213,399,306432,7017,1010448,1316880
train,214,188,144384,1558,224352,368736
train,215,410,314880,7409,1066896,1381776
train,216,267,205056,3142,452448,657504
train,217,227,174336,2272,327168,501504
train,218,199,152832,1746,251424,404256
train,219,90,69120,357,51408,120528
train,220,273,209664,3285,473040,682704
train,221,399,306432,7017,1010448,1316880
train,222,300,230400,3967,571248,801648
train,223,99,76032,432,62208,138240
train,224,239,183552,2518,362592,546144
train,225,350,268800,5399,777456,1046256
train,226,258,198144,2934,422496,620640
train,227,333,255744,4888,703872,959616
train,228,310,238080,4236,609984,848064
train,229,168,129024,1244,179136,308160
train,230,132,101376,768,110592,211968
train,231,618,474624,15034,2164896,2639520
train,232,432,331776,8226,1184544,1516320
train,233,273,209664,3285,473040,682704
train,234,174,133632,1335,192240,325872
train,235,219,168192,2114,304416,472608
train,236,380,291840,6365,916560,1208400
train,237,247,189696,2689,387216,576912
train,238,371,284928,6067,873648,1158576
train,239,506,388608,11285,1625040,2013648
train,240,285,218880,3580,515520,734400
train,241,576,442368,13523,1947312,2389680
train,242,255,195840,2866,412704,608544
train,243,264,202752,3072,442368,645120
train,244,267,205056,3142,452448,657504
train,245,225,172800,2232,321408,494208
train,246,296,227328,3862,556128,783456
train,247,109,83712,524,75456,159168
train,248,428,328704,8074,1162656,1491360
train,249,160,122880,1129,162576,285456
train,250,289,221952,3682,530208,752160
train,251,390,299520,6704,965376,1264896
train,252,140,107520,864,124416,231936
train,253,281,215808,3481,501264,717072
train,254,275,211200,3334,480096,691296
train,255,217,166656,2076,298944,465600
train,256,295,226560,3836,552384,778944
train,257,339,260352,5065,729360,989712
train,258,252,193536,2799,403056,596592
train,259,312,239616,4291,617904,857520
train,260,108,82944,515,74160,157104
train,261,298,228864,3914,563616,792480
train,262,290,222720,3707,533808,756528
train,263,326,250368,4684,674496,924864
train,264,214,164352,2019,290736,455088
train,265,132,101376,768,110592,211968
train,266,424,325632,7924,1141056,1466688
train,267,228,175104,2292,330048,505152
train,268,344,264192,5216,751104,1015296
train,269,389,298752,6670,960480,1259232
train,270,401,307968,7088,1020672,1328640
train,271,243,186624,2603,374832,561456
train,272,439,337152,8494,1223136,1560288
train,273,313,240384,4318,621792,862176
train,274,172,132096,1304,187776,319872
train,275,328,251904,4742,682848,934752
train,276,181,139008,1444,207936,346944
train,277,202,155136,1799,259056,414192
train,278,283,217344,3530,508320,725664
train,279,566,434688,13187,1898928,2333616
train,280,331,254208,4829,695376,949584
train,281,225,172800,2232,321408,494208
train,282,258,198144,2934,422496,620640
train,283,272,208896,3261,469584,678480
train,284,228,175104,2292,330048,505152
train,285,390,299520,6704,965376,1264896
train,286,343,263424,5186,746784,1010208
train,287,454,348672,9085,1308240,1656912
train,288,339,260352,5065,729360,989712
train,289,77,59136,262,37728,96864
train,290,504,387072,11196,1612224,1999296
train,291,215,165120,2038,293472,458592
train,292,334,256512,4917,708048,964560
train,293,281,215808,3481,501264,717072
train,294,350,268800,5399,777456,1046256
train,295,418,321024,7701,1108944,1429968
train,296,312,239616,4291,617904,857520
train,297,268,205824,3166,455904,661728
train,298,192,147456,1625,234000,381456
train,299,318,244224,4457,641808,886032
train,300,158,121344,1101,158544,279888
train,301,136,104448,816,117504,221952
train,302,300,230400,3967,571248,801648
train,303,153,117504,1032,148608,266112
train,304,234,179712,2414,347616,527328
train,305,354,271872,5524,795456,1067328
train,306,494,379392,10756,1548864,1928256
train,307,368,282624,5969,859536,1142160
train,308,255,195840,2866,412704,608544
train,309,100,76800,441,63504,140304
train,310,240,184320,2539,365616,549936
train,311,303,232704,4047,582768,815472
train,312,424,325632,7924,1141056,1466688
train,313,364,279552,5840,840960,1120512
train,314,774,594432,20756,2988864,3583296
train,315,209,160512,1926,277344,437856
train,316,290,222720,3707,533808,756528
train,317,236,181248,2455,353520,534768
train,318,357,274176,5618,808992,1083168
train,319,220,168960,2134,307296,476256
train,320,148,113664,966,139104,252768
train,321,464,356352,9489,1366416,1722768
train,322,404,310272,7194,1035936,1346208
train,323,372,285696,6100,878400,1164096
train,324,193,148224,1642,236448,384672
train,325,394,302592,6842,985248,1287840
train,326,125,96000,689,99216,195216
train,327,143,109824,902,129888,239712
train,328,370,284160,6034,868896,1153056
train,329,187,143616,1542,222048,365664
train,330,199,152832,1746,251424,404256
train,331,165,126720,1200,172800,299520
train,332,414,317952,7555,1087920,1405872
train,333,415,318720,7591,1093104,1411824
train,334,213,163584,2000,288000,451584
train,335,162,124416,1157,166608,291024
train,336,205,157440,1853,266832,424272
train,337,77,59136,262,37728,96864
train,338,333,255744,4888,703872,959616
train,339,590,453120,14010,2017440,2470560
train,340,254,195072,2844,409536,604608
train,341,444,340992,8689,1251216,1592208
train,342,348,267264,5338,768672,1035936
train,343,100,76800,441,63504,140304
train,344,268,205824,3166,455904,661728
train,345,570,437760,13320,1918080,2355840
train,346,493,378624,10713,1542672,1921296
train,347,358,274944,5649,813456,1088400
train,348,153,117504,1032,148608,266112
train,349,320,245760,4514,650016,895776
train,350,339,260352,5065,729360,989712
train,351,400,307200,7052,1015488,1322688
train,352,257,197376,2911,419184,616560
train,353,247,189696,2689,387216,576912
train,354,345,264960,5246,755424,1020384
train,355,194,148992,1659,238896,387888
train,356,535,410880,12199,1756656,2167536
train,357,241,185088,2560,368640,553728
train,358,205,157440,1853,266832,424272
train,359,308,236544,4181,602064,838608
train,360,220,168960,2134,307296,476256
train,361,194,148992,1659,238896,387888
train,362,190,145920,1592,229248,375168
train,363,198,152064,1728,248832,400896
train,364,130,99840,745,107280,207120
train,365,405,311040,7230,1041120,1352160
train,366,372,285696,6100,878400,1164096
train,367,637,489216,15768,2270592,2759808
train,368,229,175872,2312,332928,508800
train,369,265,203520,3096,445824,649344
train,370,240,184320,2539,365616,549936
train,371,321,246528,4542,654048,900576
train,372,191,146688,1608,231552,378240
train,373,393,301824,6808,980352,1282176
train,374,295,226560,3836,552384,778944
train,375,392,301056,6773,975312,1276368
train,376,311,238848,4263,613872,852720
train,377,511,392448,11492,1654848,2047296
train,378,155,119040,1059,152496,271536
train,379,307,235776,4154,598176,833952
train,380,205,157440,1853,266832,424272
train,381,468,359424,9654,1390176,1749600
train,382,385,295680,6533,940752,1236432
train,383,158,121344,1101,158544,279888
train,384,159,122112,1115,160560,282672
train,385,135,103680,804,115776,219456
train,386,118,90624,614,88416,179040
train,387,430,330240,8150,1173600,1503840
train,388,473,363264,9861,1419984,1783248
train,389,149,114432,979,140976,255408
train,390,241,185088,2560,368640,553728
train,391,218,167424,2095,301680,469104
train,392,199,152832,1746,251424,404256
train,393,58,44544,149,21456,66000
train,394,159,122112,1115,160560,282672
train,395,145,111360,927,133488,244848
train,396,223,171264,2192,315648,486912
train,397,231,177408,2352,338688,516096
train,398,86,66048,326,46944,112992
train,399,457,350976,9205,1325520,1676496
train,400,354,271872,5524,795456,1067328
train,401,237,182016,2476,356544,538560
train,402,174,133632,1335,192240,325872
train,403,340,261120,5095,733680,994800
train,404,208,159744,1907,274608,434352
train,405,310,238080,4236,609984,848064
train,406,357,274176,5618,808992,1083168
train,407,272,208896,3261,469584,678480
train,408,379,291072,6331,911664,1202736
train,409,377,289536,6265,902160,1191696
train,410,314,241152,4346,625824,866976
train,411,362,278016,5776,831744,1109760
train,412,223,171264,2192,315648,486912
train,413,106,81408,496,71424,152832
train,414,318,244224,4457,641808,886032
train,415,396,304128,6912,995328,1299456
train,416,242,185856,2582,371808,557664
train,417,110,84480,534,76896,161376
train,418,307,235776,4154,598176,833952
train,419,432,331776,8226,1184544,1516320
train,420,133,102144,780,112320,214464
train,421,398,305664,6982,1005408,1311072
train,422,258,198144,2934,422496,620640
train,423,237,182016,2476,356544,538560
train,424,176,135168,1366,196704,331872
train,425,299,229632,3941,567504,797136
train,426,750,576000,19944,2871936,3447936
train,427,377,289536,6265,902160,1191696
train,428,140,107520,864,124416,231936
train,429,280,215040,3456,497664,712704
train,430,379,291072,6331,911664,1202736
train,431,175,134400,1350,194400,328800
train,432,77,59136,262,37728,96864
train,433,363,278784,5808,836352,1115136
train,434,200,153600,1763,253872,407472
train,435,664,509952,16867,2428848,2938800
train,436,95,72960,398,57312,130272
train,437,103,79104,468,67392,146496
train,438,305,234240,4100,590400,824640
train,439,254,195072,2844,409536,604608
train,440,447,343296,8807,1268208,1611504
train,441,387,297216,6601,950544,1247760
train,442,237,182016,2476,356544,538560
train,443,120,92160,635,91440,183600
train,444,484,371712,10325,1486800,1858512
train,445,286,219648,3606,519264,738912
train,446,374,287232,6165,887760,1174992
train,447,278,213504,3407,490608,704112
train,448,166,127488,1215,174960,302448
train,449,349,268032,5369,773136,1041168
train,450,154,118272,1046,150624,268896
train,451,403,309504,7158,1030752,1340256
train,452,191,146688,1608,231552,378240
train,453,383,294144,6466,931104,1225248
train,454,299,229632,3941,567504,797136
train,455,106,81408,496,71424,152832
train,456,383,294144,6466,931104,1225248
train,457,234,179712,2414,347616,527328
train,458,344,264192,5216,751104,1015296
train,459,83,63744,304,43776,107520
train,460,297,228096,3888,559872,787968
train,461,218,167424,2095,301680,469104
train,462,246,188928,2668,384192,573120
train,463,361,277248,5744,827136,1104384
train,464,127,97536,711,102384,199920
train,465,274,210432,3309,476496,686928
train,466,315,241920,4374,629856,871776
train,467,413,317184,7518,1082592,1399776
train,468,348,267264,5338,768672,1035936
train,469,401,307968,7088,1020672,1328640
train,470,87,66816,334,48096,114912
train,471,227,174336,2272,327168,501504
train,472,290,222720,3707,533808,756528
train,473,176,135168,1366,196704,331872
train,474,317,243456,4429,637776,881232
train,475,424,325632,7924,1141056,1466688
train,476,349,268032,5369,773136,1041168
train,477,211,162048,1963,282672,444720
train,478,220,168960,2134,307296,476256
train,479,133,102144,780,112320,214464
train,480,177,135936,1381,198864,334800
train,481,325,249600,4656,670464,920064
train,482,287,220416,3631,522864,743280
train,483,91,69888,365,52560,122448
train,484,241,185088,2560,368640,553728
train,485,493,378624,10713,1542672,1921296
train,486,303,232704,4047,582768,815472
train,487,376,288768,6231,897264,1186032
train,488,389,298752,6670,960480,1259232
train,489,381,292608,6398,921312,1213920
train,490,154,118272,1046,150624,268896
train,491,327,251136,4713,678672,929808
train,492,449,344832,8886,1279584,1624416
train,493,287,220416,3631,522864,743280
train,494,434,333312,8302,1195488,1528800
train,495,492,377856,10669,1536336,1914192
train,496,394,302592,6842,985248,1287840
train,497,145,111360,927,133488,244848
train,498,214,164352,2019,290736,455088
train,499,406,311808,7265,1046160,1357968
train,500,263,201984,3049,439056,641040
train,501,226,173568,2252,324288,497856
train,502,225,172800,2232,321408,494208
train,503,481,369408,10197,1468368,1837776
train,504,576,442368,13523,1947312,2389680
train,505,350,268800,5399,777456,1046256
train,506,310,238080,4236,609984,848064
train,507,301,231168,3994,575136,806304
train,508,412,316416,7482,1077408,1393824
train,509,148,113664,966,139104,252768
train,510,109,83712,524,75456,159168
train,511,164,125952,1186,170784,296736
train,512,430,330240,8150,1173600,1503840
train,513,286,219648,3606,519264,738912
train,514,112,86016,553,79632,165648
train,515,439,337152,8494,1223136,1560288
train,516,197,151296,1711,246384,397680
train,517,248,190464,2711,390384,580848
train,518,192,147456,1625,234000,381456
train,519,400,307200,7052,1015488,1322688
train,520,67,51456,198,28512,79968
train,521,309,237312,4209,606096,843408
train,522,460,353280,9326,1342944,1696224
train,523,377,289536,6265,902160,1191696
train,524,142,109056,889,128016,237072
train,525,421,323328,7812,1124928,1448256
train,526,166,127488,1215,174960,302448
train,527,335,257280,4947,712368,969648
train,528,82,62976,297,42768,105744
train,529,226,173568,2252,324288,497856
train,530,229,175872,2312,332928,508800
train,531,224,172032,2212,318528,490560
train,532,340,261120,5095,733680,994800
train,533,311,238848,4263,613872,852720
train,534,356,273408,5586,804384,1077792
train,535,413,317184,7518,1082592,1399776
train,536,403,309504,7158,1030752,1340256
train,537,137,105216,828,119232,224448
train,538,190,145920,1592,229248,375168
train,539,287,220416,3631,522864,743280
train,540,353,271104,5492,790848,1061952
train,541,337,258816,5006,720864,979680
train,542,339,260352,5065,729360,989712
train,543,92,70656,373,53712,124368
train,544,457,350976,9205,1325520,1676496
train,545,395,303360,6877,990288,1293648
train,546,706,542208,18586,2676384,3218592
train,547,231,177408,2352,338688,516096
train,548,186,142848,1525,219600,362448
train,549,158,121344,1101,158544,279888
train,550,214,164352,2019,290736,455088
train,551,306,235008,4127,594288,829296
train,552,252,193536,2799,403056,596592
train,553,319,244992,4485,645840,890832
train,554,93,71424,382,55008,126432
train,555,94,72192,390,56160,128352
train,556,365,280320,5872,845568,1125888
train,557,365,280320,5872,845568,1125888
train,558,246,188928,2668,384192,573120
train,559,257,197376,2911,419184,616560
train,560,537,412416,12260,1765440,2177856
train,561,178,136704,1397,201168,337872
train,562,321,246528,4542,654048,900576
train,563,328,251904,4742,682848,934752
train,564,271,208128,3237,466128,674256
train,565,341,261888,5125,738000,999888
train,566,338,259584,5036,725184,984768
train,567,508,390144,11374,1637856,2028000
train,568,153,117504,1032,148608,266112
train,569,196,150528,1694,243936,394464
train,570,327,251136,4713,678672,929808
train,571,135,103680,804,115776,219456
train,572,198,152064,1728,248832,400896
train,573,360,276480,5712,822528,1099008
train,574,401,307968,7088,1020672,1328640
train,575,343,263424,5186,746784,1010208
train,576,452,347136,9005,1296720,1643856
train,577,263,201984,3049,439056,641040
train,578,590,453120,14010,2017440,2470560
train,579,414,317952,7555,1087920,1405872
train,580,244,187392,2624,377856,565248
train,581,343,263424,5186,746784,1010208
train,582,362,278016,5776,831744,1109760
train,583,453,347904,9045,1302480,1650384
train,584,183,140544,1476,212544,353088
train,585,248,190464,2711,390384,580848
train,586,485,372480,10368,1492992,1865472
train,587,113,86784,563,81072,167856
train,588,204,156672,1835,264240,420912
train,589,85,65280,319,45936,111216
train,590,323,248064,4599,662256,910320
train,591,113,86784,563,81072,167856
train,592,178,136704,1397,201168,337872
train,593,279,214272,3431,494064,708336
train,594,310,238080,4236,609984,848064
train,595,350,268800,5399,777456,1046256
train,596,169,129792,1259,181296,311088
train,597,348,267264,5338,768672,1035936
train,598,356,273408,5586,804384,1077792
train,599,319,244992,4485,645840,890832
train,600,290,222720,3707,533808,756528
train,601,272,208896,3261,469584,678480
train,602,194,148992,1659,238896,387888
train,603,470,360960,9736,1401984,1762944
train,604,155,119040,1059,152496,271536
train,605,381,292608,6398,921312,1213920
train,606,159,122112,1115,160560,282672
train,607,444,340992,8689,1251216,1592208
train,608,231,177408,2352,338688,516096
train,609,88,67584,342,49248,116832
train,610,84,64512,311,44784,109296
train,611,387,297216,6601,950544,1247760
train,612,389,298752,6670,960480,1259232
train,613,157,120576,1087,156528,277104
train,614,317,243456,4429,637776,881232
train,615,211,162048,1963,282672,444720
train,616,301,231168,3994,575136,806304
train,617,202,155136,1799,259056,414192
train,618,514,394752,11578,1667232,2061984
train,619,162,124416,1157,166608,291024
train,620,396,304128,6912,995328,1299456
train,621,278,213504,3407,490608,704112
train,622,106,81408,496,71424,152832
train,623,158,121344,1101,158544,279888
train,624,325,249600,4656,670464,920064
train,625,427,327936,8036,1157184,1485120
train,626,280,215040,3456,497664,712704
train,627,187,143616,1542,222048,365664
train,628,234,179712,2414,347616,527328
train,629,409,314112,7373,1061712,1375824
train,630,222,170496,2173,312912,483408
train,631,260,199680,2980,429120,628800
train,632,287,220416,3631,522864,743280
train,633,361,277248,5744,827136,1104384
train,634,194,148992,1659,238896,387888
train,635,249,191232,2733,393552,584784
train,636,411,315648,7445,1072080,1387728
train,637,139,106752,852,122688,229440
train,638,368,282624,5969,859536,1142160
train,639,92,70656,373,53712,124368
train,640,304,233472,4074,586656,820128
train,641,443,340224,8650,1245600,1585824
train,642,171,131328,1289,185616,316944
train,643,283,217344,3530,508320,725664
train,644,218,167424,2095,301680,469104
train,645,383,294144,6466,931104,1225248
train,646,194,148992,1659,238896,387888
train,647,173,132864,1320,190080,322944
train,648,311,238848,4263,613872,852720
train,649,202,155136,1799,259056,414192
train,650,185,142080,1509,217296,359376
train,651,128,98304,723,104112,202416
train,652,234,179712,2414,347616,527328
train,653,243,186624,2603,374832,561456
train,654,149,114432,979,140976,255408
train,655,347,266496,5307,764208,1030704
train,656,182,139776,1460,210240,350016
train,657,481,369408,10197,1468368,1837776
train,658,306,235008,4127,594288,829296
train,659,265,203520,3096,445824,649344
train,660,348,267264,5338,768672,1035936
train,661,127,97536,711,102384,199920
train,662,281,215808,3481,501264,717072
train,663,227,174336,2272,327168,501504
train,664,251,192768,2777,399888,592656
train,665,199,152832,1746,251424,404256
train,666,270,207360,3213,462672,670032
train,667,190,145920,1592,229248,375168
train,668,283,217344,3530,508320,725664
train,669,106,81408,496,71424,152832
train,670,79,60672,276,39744,100416
train,671,301,231168,3994,575136,806304
train,672,156,119808,1073,154512,274320
train,673,333,255744,4888,703872,959616
train,674,300,230400,3967,571248,801648
train,675,310,238080,4236,609984,848064
train,676,187,143616,1542,222048,365664
train,677,480,368640,10155,1462320,1830960
train,678,285,218880,3580,515520,734400
train,679,358,274944,5649,813456,1088400
train,680,305,234240,4100,590400,824640
train,681,260,199680,2980,429120,628800
train,682,146,112128,940,135360,247488
train,683,162,124416,1157,166608,291024
train,684,376,288768,6231,897264,1186032
train,685,150,115200,992,142848,258048
train,686,331,254208,4829,695376,949584
train,687,464,356352,9489,1366416,1722768
train,688,322,247296,4570,658080,905376
train,689,342,262656,5155,742320,1004976
train,690,320,245760,4514,650016,895776
train,691,278,213504,3407,490608,704112
train,692,332,254976,4858,699552,954528
train,693,340,261120,5095,733680,994800
train,694,78,59904,269,38736,98640
train,695,281,215808,3481,501264,717072
train,696,152,116736,1019,146736,263472
train,697,283,217344,3530,508320,725664
train,698,267,205056,3142,452448,657504
train,699,498,382464,10931,1574064,1956528
train,700,417,320256,7664,1103616,1423872
train,701,346,265728,5277,759888,1025616
train,702,126,96768,700,100800,197568
train,703,163,125184,1171,168624,293808
train,704,273,209664,3285,473040,682704
train,705,254,195072,2844,409536,604608
train,706,167,128256,1230,177120,305376
train,707,407,312576,7301,1051344,1363920
train,708,164,125952,1186,170784,296736
train,709,335,257280,4947,712368,969648
train,710,379,291072,6331,911664,1202736
train,711,263,201984,3049,439056,641040
train,712,204,156672,1835,264240,420912
train,713,209,160512,1926,277344,437856
train,714,397,304896,6947,1000368,1305264
train,715,233,178944,2393,344592,523536
train,716,155,119040,1059,152496,271536
train,717,288,221184,3656,526464,747648
train,718,320,245760,4514,650016,895776
train,719,434,333312,8302,1195488,1528800
train,720,218,167424,2095,301680,469104
train,721,333,255744,4888,703872,959616
train,722,214,164352,2019,290736,455088
train,723,140,107520,864,124416,231936
train,724,395,303360,6877,990288,1293648
train,725,203,155904,1817,261648,417552
train,726,242,185856,2582,371808,557664
train,727,280,215040,3456,497664,712704
train,728,251,192768,2777,399888,592656
train,729,241,185088,2560,368640,553728
train,730,184,141312,1493,214992,356304
train,731,189,145152,1575,226800,371952
train,732,281,215808,3481,501264,717072
train,733,356,273408,5586,804384,1077792
train,734,378,290304,6298,906912,1197216
train,735,454,348672,9085,1308240,1656912
train,736,379,291072,6331,911664,1202736
train,737,117,89856,604,86976,176832
train,738,304,233472,4074,586656,820128
train,739,201,154368,1781,256464,410832
train,740,275,211200,3334,480096,691296
train,741,177,135936,1381,198864,334800
train,742,500,384000,11019,1586736,1970736
train,743,300,230400,3967,571248,801648
train,744,146,112128,940,135360,247488
train,745,192,147456,1625,234000,381456
train,746,311,238848,4263,613872,852720
train,747,157,120576,1087,156528,277104
train,748,187,143616,1542,222048,365664
train,749,342,262656,5155,742320,1004976
train,750,295,226560,3836,552384,778944
train,751,298,228864,3914,563616,792480
train,752,133,102144,780,112320,214464
train,753,249,191232,2733,393552,584784
train,754,220,168960,2134,307296,476256
train,755,209,160512,1926,277344,437856
train,756,246,188928,2668,384192,573120
train,757,302,231936,4020,578880,810816
train,758,325,249600,4656,670464,920064
train,759,290,222720,3707,533808,756528
train,760,280,215040,3456,497664,712704
train,761,449,344832,8886,1279584,1624416
train,762,101,77568,450,64800,142368
train,763,151,115968,1005,144720,260688
train,764,78,59904,269,38736,98640
train,765,260,199680,2980,429120,628800
train,766,313,240384,4318,621792,862176
train,767,451,346368,8965,1290960,1637328
train,768,410,314880,7409,1066896,1381776
train,769,144,110592,914,131616,242208
train,770,146,112128,940,135360,247488
train,771,247,189696,2689,387216,576912
train,772,323,248064,4599,662256,910320
train,773,344,264192,5216,751104,1015296
train,774,274,210432,3309,476496,686928
train,775,429,329472,8112,1168128,1497600
train,776,232,178176,2373,341712,519888
train,777,232,178176,2373,341712,519888
train,778,163,125184,1171,168624,293808
train,779,171,131328,1289,185616,316944
train,780,301,231168,3994,575136,806304
train,781,163,125184,1171,168624,293808
train,782,239,183552,2518,362592,546144
train,783,262,201216,3026,435744,636960
train,784,235,180480,2434,350496,530976
train,785,105,80640,486,69984,150624
train,786,221,169728,2153,310032,479760
train,787,443,340224,8650,1245600,1585824
train,788,78,59904,269,38736,98640
train,789,335,257280,4947,712368,969648
train,790,405,311040,7230,1041120,1352160
train,791,304,233472,4074,586656,820128
train,792,108,82944,515,74160,157104
train,793,438,336384,8456,1217664,1554048
train,794,345,264960,5246,755424,1020384
train,795,134,102912,792,114048,216960
train,796,287,220416,3631,522864,743280
train,797,185,142080,1509,217296,359376
train,798,159,122112,1115,160560,282672
train,799,320,245760,4514,650016,895776
train,800,224,172032,2212,318528,490560
train,801,318,244224,4457,641808,886032
train,802,181,139008,1444,207936,346944
train,803,285,218880,3580,515520,734400
train,804,396,304128,6912,995328,1299456
train,805,361,277248,5744,827136,1104384
train,806,382,293376,6432,926208,1219584
train,807,457,350976,9205,1325520,1676496
train,808,327,251136,4713,678672,929808
train,809,82,62976,297,42768,105744
train,810,271,208128,3237,466128,674256
train,811,393,301824,6808,980352,1282176
train,812,134,102912,792,114048,216960
train,813,74,56832,242,34848,91680
train,814,375,288000,6198,892512,1180512
train,815,393,301824,6808,980352,1282176
train,816,435,334080,8340,1200960,1535040
train,817,391,300288,6738,970272,1270560
train,818,86,66048,326,46944,112992
train,819,497,381696,10887,1567728,1949424
train,820,454,348672,9085,1308240,1656912
train,821,309,237312,4209,606096,843408
train,822,255,195840,2866,412704,608544
train,823,302,231936,4020,578880,810816
train,824,323,248064,4599,662256,910320
train,825,361,277248,5744,827136,1104384
train,826,188,144384,1558,224352,368736
train,827,469,360192,9695,1396080,1756272
train,828,364,279552,5840,840960,1120512
train,829,190,145920,1592,229248,375168
train,830,391,300288,6738,970272,1270560
train,831,139,106752,852,122688,229440
train,832,300,230400,3967,571248,801648
train,833,337,258816,5006,720864,979680
train,834,277,212736,3382,487008,699744
train,835,387,297216,6601,950544,1247760
train,836,313,240384,4318,621792,862176
train,837,231,177408,2352,338688,516096
train,838,155,119040,1059,152496,271536
train,839,451,346368,8965,1290960,1637328
train,840,104,79872,477,68688,148560
train,841,253,194304,2822,406368,600672
train,842,194,148992,1659,238896,387888
train,843,170,130560,1274,183456,314016
train,844,141,108288,877,126288,234576
train,845,215,165120,2038,293472,458592
train,846,394,302592,6842,985248,1287840
train,847,273,209664,3285,473040,682704
train,848,416,319488,7628,1098432,1417920
train,849,373,286464,6132,883008,1169472
train,850,284,218112,3555,511920,730032
train,851,255,195840,2866,412704,608544
train,852,153,117504,1032,148608,266112
train,853,286,219648,3606,519264,738912
train,854,309,237312,4209,606096,843408
train,855,204,156672,1835,264240,420912
train,856,358,274944,5649,813456,1088400
train,857,113,86784,563,81072,167856
train,858,189,145152,1575,226800,371952
train,859,516,396288,11635,1675440,2071728
train,860,422,324096,7849,1130256,1454352
train,861,205,157440,1853,266832,424272
train,862,283,217344,3530,508320,725664
train,863,534,410112,12168,1752192,2162304
train,864,338,259584,5036,725184,984768
train,865,284,218112,3555,511920,730032
train,866,100,76800,441,63504,140304
train,867,184,141312,1493,214992,356304
train,868,144,110592,914,131616,242208
train,869,411,315648,7445,1072080,1387728
train,870,218,167424,2095,301680,469104
train,871,195,149760,1676,241344,391104
train,872,239,183552,2518,362592,546144
train,873,198,152064,1728,248832,400896
train,874,352,270336,5461,786384,1056720
train,875,140,107520,864,124416,231936
train,876,474,364032,9903,1426032,1790064
train,877,388,297984,6635,955440,1253424
train,878,317,243456,4429,637776,881232
train,879,264,202752,3072,442368,645120
train,880,275,211200,3334,480096,691296
train,881,133,102144,780,112320,214464
train,882,206,158208,1871,269424,427632
train,883,300,230400,3967,571248,801648
train,884,263,201984,3049,439056,641040
train,885,181,139008,1444,207936,346944
train,886,408,313344,7337,1056528,1369872
train,887,204,156672,1835,264240,420912
train,888,186,142848,1525,219600,362448
train,889,291,223488,3733,537552,761040
train,890,460,353280,9326,1342944,1696224
train,891,119,91392,625,90000,181392
train,892,339,260352,5065,729360,989712
train,893,290,222720,3707,533808,756528
train,894,383,294144,6466,931104,1225248
train,895,387,297216,6601,950544,1247760
train,896,115,88320,583,83952,172272
train,897,349,268032,5369,773136,1041168
train,898,346,265728,5277,759888,1025616
train,899,199,152832,1746,251424,404256
train,900,437,335616,8417,1212048,1547664
train,901,192,147456,1625,234000,381456
train,902,215,165120,2038,293472,458592
train,903,196,150528,1694,243936,394464
train,904,72,55296,229,32976,88272
train,905,169,129792,1259,181296,311088
train,906,382,293376,6432,926208,1219584
train,907,318,244224,4457,641808,886032
train,908,397,304896,6947,1000368,1305264
train,909,270,207360,3213,462672,670032
train,910,385,295680,6533,940752,1236432
train,911,231,177408,2352,338688,516096
train,912,98,75264,424,61056,136320
train,913,248,190464,2711,390384,580848
train,914,289,221952,3682,530208,752160
train,915,224,172032,2212,318528,490560
train,916,301,231168,3994,575136,806304
train,917,236,181248,2455,353520,534768
train,918,156,119808,1073,154512,274320
train,919,372,285696,6100,878400,1164096
train,920,399,306432,7017,1010448,1316880
train,921,235,180480,2434,350496,530976
train,922,223,171264,2192,315648,486912
train,923,236,181248,2455,353520,534768
train,924,418,321024,7701,1108944,1429968
train,925,393,301824,6808,980352,1282176
train,926,222,170496,2173,312912,483408
train,927,181,139008,1444,207936,346944
train,928,119,91392,625,90000,181392
train,929,231,177408,2352,338688,516096
train,930,73,56064,235,33840,89904
train,931,281,215808,3481,501264,717072
train,932,395,303360,6877,990288,1293648
train,933,296,227328,3862,556128,783456
train,934,215,165120,2038,293472,458592
train,935,114,87552,573,82512,170064
train,936,329,252672,4771,687024,939696
train,937,249,191232,2733,393552,584784
train,938,263,201984,3049,439056,641040
train,939,313,240384,4318,621792,862176
train,940,262,201216,3026,435744,636960
train,941,403,309504,7158,1030752,1340256
train,942,308,236544,4181,602064,838608
train,943,284,218112,3555,511920,730032
train,944,160,122880,1129,162576,285456
train,945,216,165888,2057,296208,462096
train,946,243,186624,2603,374832,561456
train,947,227,174336,2272,327168,501504
train,948,225,172800,2232,321408,494208
train,949,166,127488,1215,174960,302448
train,950,523,401664,11840,1704960,2106624
train,951,325,249600,4656,670464,920064
train,952,351,269568,5430,781920,1051488
train,953,260,199680,2980,429120,628800
train,954,338,259584,5036,725184,984768
train,955,244,187392,2624,377856,565248
train,956,106,81408,496,71424,152832
train,957,254,195072,2844,409536,604608
train,958,359,275712,5681,818064,1093776
train,959,89,68352,350,50400,118752
train,960,217,166656,2076,298944,465600
train,961,163,125184,1171,168624,293808
train,962,241,185088,2560,368640,553728
train,963,274,210432,3309,476496,686928
train,964,167,128256,1230,177120,305376
train,965,183,140544,1476,212544,353088
train,966,478,367104,10071,1450224,1817328
train,967,261,200448,3003,432432,632880
train,968,427,327936,8036,1157184,1485120
train,969,202,155136,1799,259056,414192
train,970,447,343296,8807,1268208,1611504
train,971,451,346368,8965,1290960,1637328
train,972,163,125184,1171,168624,293808
train,973,493,378624,10713,1542672,1921296
train,974,211,162048,1963,282672,444720
train,975,378,290304,6298,906912,1197216
train,976,204,156672,1835,264240,420912
train,977,274,210432,3309,476496,686928
train,978,245,188160,2646,381024,569184
train,979,362,278016,5776,831744,1109760
train,980,513,393984,11549,1663056,2057040
train,981,263,201984,3049,439056,641040
train,982,92,70656,373,53712,124368
train,983,164,125952,1186,170784,296736
train,984,297,228096,3888,559872,787968
train,985,432,331776,8226,1184544,1516320
train,986,155,119040,1059,152496,271536
train,987,299,229632,3941,567504,797136
train,988,412,316416,7482,1077408,1393824
train,989,237,182016,2476,356544,538560
train,990,167,128256,1230,177120,305376
train,991,246,188928,2668,384192,573120
train,992,207,158976,1889,272016,430992
train,993,99,76032,432,62208,138240
train,994,262,201216,3026,435744,636960
train,995,273,209664,3285,473040,682704
train,996,313,240384,4318,621792,862176
train,997,184,141312,1493,214992,356304
train,998,404,310272,7194,1035936,1346208
train,999,221,169728,2153,310032,479760
train,1000,116,89088,594,85536,174624
train,1001,134,102912,792,114048,216960
train,1002,241,185088,2560,368640,553728
train,1003,283,217344,3530,508320,725664
train,1004,185,142080,1509,217296,359376
train,1005,343,263424,5186,746784,1010208
train,1006,179,137472,1413,203472,340944
train,1007,371,284928,6067,873648,1158576
train,1008,361,277248,5744,827136,1104384
train,1009,211,162048,1963,282672,444720
train,1010,268,205824,3166,455904,661728
train,1011,171,131328,1289,185616,316944
train,1012,252,193536,2799,403056,596592
train,1013,187,143616,1542,222048,365664
train,1014,327,251136,4713,678672,929808
train,1015,191,146688,1608,231552,378240
train,1016,180,138240,1428,205632,343872
train,1017,192,147456,1625,234000,381456
train,1018,408,313344,7337,1056528,1369872
train,1019,293,225024,3784,544896,769920
train,1020,429,329472,8112,1168128,1497600
train,1021,395,303360,6877,990288,1293648
train,1022,239,183552,2518,362592,546144
train,1023,540,414720,12353,1778832,2193552
train,1024,226,173568,2252,324288,497856
train,1025,207,158976,1889,272016,430992
train,1026,358,274944,5649,813456,1088400
train,1027,294,225792,3810,548640,774432
train,1028,161,123648,1143,164592,288240
train,1029,180,138240,1428,205632,343872
train,1030,104,79872,477,68688,148560
train,1031,203,155904,1817,261648,417552
train,1032,433,332544,8264,1190016,1522560
train,1033,287,220416,3631,522864,743280
train,1034,352,270336,5461,786384,1056720
train,1035,297,228096,3888,559872,787968
train,1036,214,164352,2019,290736,455088
train,1037,347,266496,5307,764208,1030704
train,1038,227,174336,2272,327168,501504
train,1039,284,218112,3555,511920,730032
train,1040,333,255744,4888,703872,959616
train,1041,188,144384,1558,224352,368736
train,1042,118,90624,614,88416,179040
train,1043,202,155136,1799,259056,414192
train,1044,209,160512,1926,277344,437856
train,1045,116,89088,594,85536,174624
train,1046,223,171264,2192,315648,486912
train,1047,166,127488,1215,174960,302448
train,1048,188,144384,1558,224352,368736
train,1049,327,251136,4713,678672,929808
train,1050,252,193536,2799,403056,596592
train,1051,415,318720,7591,1093104,1411824
train,1052,201,154368,1781,256464,410832
train,1053,250,192000,2755,396720,588720
train,1054,296,227328,3862,556128,783456
train,1055,211,162048,1963,282672,444720
train,1056,148,113664,966,139104,252768
train,1057,211,162048,1963,282672,444720
train,1058,132,101376,768,110592,211968
train,1059,185,142080,1509,217296,359376
train,1060,122,93696,656,94464,188160
train,1061,302,231936,4020,578880,810816
train,1062,234,179712,2414,347616,527328
train,1063,328,251904,4742,682848,934752
train,1064,292,224256,3758,541152,765408
train,1065,117,89856,604,86976,176832
train,1066,251,192768,2777,399888,592656
train,1067,217,166656,2076,298944,465600
train,1068,265,203520,3096,445824,649344
train,1069,247,189696,2689,387216,576912
train,1070,388,297984,6635,955440,1253424
train,1071,317,243456,4429,637776,881232
train,1072,233,178944,2393,344592,523536
train,1073,195,149760,1676,241344,391104
train,1074,131,100608,757,109008,209616
train,1075,241,185088,2560,368640,553728
train,1076,346,265728,5277,759888,1025616
train,1077,322,247296,4570,658080,905376
train,1078,176,135168,1366,196704,331872
train,1079,331,254208,4829,695376,949584
train,1080,309,237312,4209,606096,843408
train,1081,245,188160,2646,381024,569184
train,1082,173,132864,1320,190080,322944
train,1083,137,105216,828,119232,224448
train,1084,193,148224,1642,236448,384672
train,1085,156,119808,1073,154512,274320
train,1086,167,128256,1230,177120,305376
train,1087,94,72192,390,56160,128352
train,1088,102,78336,459,66096,144432
train,1089,328,251904,4742,682848,934752
train,1090,410,314880,7409,1066896,1381776
train,1091,285,218880,3580,515520,734400
train,1092,204,156672,1835,264240,420912
train,1093,528,405504,11988,1726272,2131776
train,1094,209,160512,1926,277344,437856
train,1095,138,105984,840,120960,226944
train,1096,266,204288,3119,449136,653424
train,1097,429,329472,8112,1168128,1497600
train,1098,434,333312,8302,1195488,1528800
train,1099,334,256512,4917,708048,964560
train,1100,324,248832,4627,666288,915120
train,1101,187,143616,1542,222048,365664
train,1102,257,197376,2911,419184,616560
train,1103,484,371712,10325,1486800,1858512
train,1104,137,105216,828,119232,224448
train,1105,77,59136,262,37728,96864
train,1106,312,239616,4291,617904,857520
train,1107,334,256512,4917,708048,964560
train,1108,82,62976,297,42768,105744
train,1109,520,399360,11751,1692144,2091504
train,1110,276,211968,3358,483552,695520
train,1111,156,119808,1073,154512,274320
train,1112,297,228096,3888,559872,787968
train,1113,246,188928,2668,384192,573120
train,1114,296,227328,3862,556128,783456
train,1115,306,235008,4127,594288,829296
train,1116,102,78336,459,66096,144432
train,1117,427,327936,8036,1157184,1485120
train,1118,200,153600,1763,253872,407472
train,1119,215,165120,2038,293472,458592
train,1120,290,222720,3707,533808,756528
train,1121,130,99840,745,107280,207120
train,1122,263,201984,3049,439056,641040
train,1123,136,104448,816,117504,221952
train,1124,74,56832,242,34848,91680
train,1125,286,219648,3606,519264,738912
train,1126,493,378624,10713,1542672,1921296
train,1127,497,381696,10887,1567728,1949424
train,1128,102,78336,459,66096,144432
train,1129,110,84480,534,76896,161376
train,1130,287,220416,3631,522864,743280
train,1131,281,215808,3481,501264,717072
train,1132,246,188928,2668,384192,573120
train,1133,539,413952,12322,1774368,2188320
train,1134,119,91392,625,90000,181392
train,1135,118,90624,614,88416,179040
train,1136,313,240384,4318,621792,862176
train,1137,364,279552,5840,840960,1120512
train,1138,398,305664,6982,1005408,1311072
train,1139,100,76800,441,63504,140304
train,1140,397,304896,6947,1000368,1305264
train,1141,132,101376,768,110592,211968
train,1142,161,123648,1143,164592,288240
train,1143,320,245760,4514,650016,895776
train,1144,274,210432,3309,476496,686928
train,1145,444,340992,8689,1251216,1592208
train,1146,183,140544,1476,212544,353088
train,1147,271,208128,3237,466128,674256
train,1148,213,163584,2000,288000,451584
train,1149,345,264960,5246,755424,1020384
train,1150,439,337152,8494,1223136,1560288
train,1151,354,271872,5524,795456,1067328
train,1152,297,228096,3888,559872,787968
train,1153,254,195072,2844,409536,604608
train,1154,233,178944,2393,344592,523536
train,1155,496,380928,10843,1561392,1942320
train,1156,243,186624,2603,374832,561456
train,1157,320,245760,4514,650016,895776
train,1158,296,227328,3862,556128,783456
train,1159,162,124416,1157,166608,291024
train,1160,106,81408,496,71424,152832
train,1161,376,288768,6231,897264,1186032
train,1162,326,250368,4684,674496,924864
train,1163,383,294144,6466,931104,1225248
train,1164,662,508416,16783,2416752,2925168
train,1165,189,145152,1575,226800,371952
train,1166,271,208128,3237,466128,674256
train,1167,182,139776,1460,210240,350016
train,1168,88,67584,342,49248,116832
train,1169,174,133632,1335,192240,325872
train,1170,313,240384,4318,621792,862176
train,1171,216,165888,2057,296208,462096
train,1172,155,119040,1059,152496,271536
train,1173,596,457728,14223,2048112,2505840
train,1174,154,118272,1046,150624,268896
train,1175,366,281088,5904,850176,1131264
train,1176,301,231168,3994,575136,806304
train,1177,307,235776,4154,598176,833952
train,1178,179,137472,1413,203472,340944
train,1179,487,374016,10453,1505232,1879248
train,1180,87,66816,334,48096,114912
train,1181,55,42240,134,19296,61536
train,1182,141,108288,877,126288,234576
train,1183,529,406272,12018,1730592,2136864
train,1184,199,152832,1746,251424,404256
train,1185,264,202752,3072,442368,645120
train,1186,574,440832,13455,1937520,2378352
train,1187,453,347904,9045,1302480,1650384
train,1188,510,391680,11464,1650816,2042496
train,1189,180,138240,1428,205632,343872
train,1190,390,299520,6704,965376,1264896
train,1191,320,245760,4514,650016,895776
train,1192,166,127488,1215,174960,302448
train,1193,349,268032,5369,773136,1041168
train,1194,267,205056,3142,452448,657504
train,1195,236,181248,2455,353520,534768
train,1196,204,156672,1835,264240,420912
train,1197,247,189696,2689,387216,576912
train,1198,266,204288,3119,449136,653424
train,1199,338,259584,5036,725184,984768
train,1200,181,139008,1444,207936,346944
train,1201,354,271872,5524,795456,1067328
train,1202,250,192000,2755,396720,588720
train,1203,422,324096,7849,1130256,1454352
train,1204,271,208128,3237,466128,674256
train,1205,67,51456,198,28512,79968
train,1206,178,136704,1397,201168,337872
train,1207,166,127488,1215,174960,302448
train,1208,261,200448,3003,432432,632880
train,1209,364,279552,5840,840960,1120512
train,1210,249,191232,2733,393552,584784
train,1211,173,132864,1320,190080,322944
train,1212,262,201216,3026,435744,636960
train,1213,527,404736,11958,1721952,2126688
train,1214,363,278784,5808,836352,1115136
train,1215,207,158976,1889,272016,430992
train,1216,208,159744,1907,274608,434352
train,1217,360,276480,5712,822528,1099008
train,1218,415,318720,7591,1093104,1411824
train,1219,241,185088,2560,368640,553728
train,1220,258,198144,2934,422496,620640
train,1221,634,486912,15650,2253600,2740512
train,1222,197,151296,1711,246384,397680
train,1223,217,166656,2076,298944,465600
train,1224,327,251136,4713,678672,929808
train,1225,81,62208,290,41760,103968
train,1226,396,304128,6912,995328,1299456
train,1227,313,240384,4318,621792,862176
train,1228,550,422400,12666,1823904,2246304
train,1229,111,85248,543,78192,163440
train,1230,290,222720,3707,533808,756528
train,1231,121,92928,646,93024,185952
train,1232,309,237312,4209,606096,843408
train,1233,348,267264,5338,768672,1035936
train,1234,275,211200,3334,480096,691296
train,1235,335,257280,4947,712368,969648
train,1236,95,72960,398,57312,130272
train,1237,367,281856,5937,854928,1136784
train,1238,212,162816,1981,285264,448080
train,1239,181,139008,1444,207936,346944
train,1240,322,247296,4570,658080,905376
train,1241,240,184320,2539,365616,549936
train,1242,199,152832,1746,251424,404256
train,1243,141,108288,877,126288,234576
train,1244,161,123648,1143,164592,288240
train,1245,392,301056,6773,975312,1276368
train,1246,185,142080,1509,217296,359376
train,1247,367,281856,5937,854928,1136784
train,1248,62,47616,170,24480,72096
train,1249,250,192000,2755,396720,588720
train,1250,273,209664,3285,473040,682704
train,1251,84,64512,311,44784,109296
train,1252,571,438528,13354,1922976,2361504
train,1253,366,281088,5904,850176,1131264
train,1254,135,103680,804,115776,219456
train,1255,367,281856,5937,854928,1136784
train,1256,47,36096,98,14112,50208
train,1257,181,139008,1444,207936,346944
train,1258,155,119040,1059,152496,271536
train,1259,352,270336,5461,786384,1056720
train,1260,349,268032,5369,773136,1041168
train,1261,324,248832,4627,666288,915120
train,1262,360,276480,5712,822528,1099008
train,1263,295,226560,3836,552384,778944
train,1264,247,189696,2689,387216,576912
train,1265,273,209664,3285,473040,682704
train,1266,237,182016,2476,356544,538560
train,1267,239,183552,2518,362592,546144
train,1268,317,243456,4429,637776,881232
train,1269,291,223488,3733,537552,761040
train,1270,136,104448,816,117504,221952
train,1271,177,135936,1381,198864,334800
train,1272,161,123648,1143,164592,288240
train,1273,273,209664,3285,473040,682704
train,1274,160,122880,1129,162576,285456
train,1275,282,216576,3505,504720,721296
train,1276,141,108288,877,126288,234576
train,1277,259,198912,2957,425808,624720
train,1278,344,264192,5216,751104,1015296
train,1279,237,182016,2476,356544,538560
train,1280,409,314112,7373,1061712,1375824
train,1281,328,251904,4742,682848,934752
train,1282,216,165888,2057,296208,462096
train,1283,219,168192,2114,304416,472608
train,1284,199,152832,1746,251424,404256
train,1285,198,152064,1728,248832,400896
train,1286,394,302592,6842,985248,1287840
train,1287,298,228864,3914,563616,792480
train,1288,104,79872,477,68688,148560
train,1289,222,170496,2173,312912,483408
train,1290,543,417024,12446,1792224,2209248
train,1291,356,273408,5586,804384,1077792
train,1292,85,65280,319,45936,111216
train,1293,217,166656,2076,298944,465600
train,1294,208,159744,1907,274608,434352
train,1295,226,173568,2252,324288,497856
train,1296,158,121344,1101,158544,279888
train,1297,290,222720,3707,533808,756528
train,1298,167,128256,1230,177120,305376
train,1299,244,187392,2624,377856,565248
train,1300,323,248064,4599,662256,910320
train,1301,183,140544,1476,212544,353088
train,1302,331,254208,4829,695376,949584
train,1303,253,194304,2822,406368,600672
train,1304,155,119040,1059,152496,271536
train,1305,401,307968,7088,1020672,1328640
train,1306,297,228096,3888,559872,787968
train,1307,158,121344,1101,158544,279888
train,1308,142,109056,889,128016,237072
train,1309,181,139008,1444,207936,346944
train,1310,193,148224,1642,236448,384672
train,1311,468,359424,9654,1390176,1749600
train,1312,625,480000,15301,2203344,2683344
train,1313,227,174336,2272,327168,501504
train,1314,318,244224,4457,641808,886032
train,1315,437,335616,8417,1212048,1547664
train,1316,166,127488,1215,174960,302448
train,1317,640,491520,15887,2287728,2779248
train,1318,426,327168,7999,1151856,1479024
train,1319,610,468480,14734,2121696,2590176
train,1320,168,129024,1244,179136,308160
train,1321,380,291840,6365,916560,1208400
train,1322,219,168192,2114,304416,472608
train,1323,199,152832,1746,251424,404256
train,1324,374,287232,6165,887760,1174992
train,1325,152,116736,1019,146736,263472
train,1326,411,315648,7445,1072080,1387728
train,1327,276,211968,3358,483552,695520
train,1328,521,400128,11781,1696464,2096592
train,1329,339,260352,5065,729360,989712
train,1330,283,217344,3530,508320,725664
train,1331,99,76032,432,62208,138240
train,1332,289,221952,3682,530208,752160
train,1333,442,339456,8611,1239984,1579440
train,1334,248,190464,2711,390384,580848
train,1335,250,192000,2755,396720,588720
train,1336,308,236544,4181,602064,838608
train,1337,379,291072,6331,911664,1202736
train,1338,164,125952,1186,170784,296736
train,1339,380,291840,6365,916560,1208400
train,1340,466,357888,9571,1378224,1736112
train,1341,345,264960,5246,755424,1020384
train,1342,202,155136,1799,259056,414192
train,1343,47,36096,98,14112,50208
train,1344,357,274176,5618,808992,1083168
train,1345,246,188928,2668,384192,573120
train,1346,107,82176,505,72720,154896
train,1347,285,218880,3580,515520,734400
train,1348,258,198144,2934,422496,620640
train,1349,118,90624,614,88416,179040
train,1350,344,264192,5216,751104,1015296
train,1351,208,159744,1907,274608,434352
train,1352,411,315648,7445,1072080,1387728
train,1353,61,46848,164,23616,70464
train,1354,271,208128,3237,466128,674256
train,1355,172,132096,1304,187776,319872
train,1356,410,314880,7409,1066896,1381776
train,1357,403,309504,7158,1030752,1340256
train,1358,130,99840,745,107280,207120
train,1359,105,80640,486,69984,150624
train,1360,376,288768,6231,897264,1186032
train,1361,286,219648,3606,519264,738912
train,1362,123,94464,667,96048,190512
train,1363,93,71424,382,55008,126432
train,1364,576,442368,13523,1947312,2389680
train,1365,253,194304,2822,406368,600672
train,1366,257,197376,2911,419184,616560
train,1367,219,168192,2114,304416,472608
train,1368,273,209664,3285,473040,682704
train,1369,74,56832,242,34848,91680
train,1370,226,173568,2252,324288,497856
train,1371,221,169728,2153,310032,479760
train,1372,438,336384,8456,1217664,1554048
train,1373,537,412416,12260,1765440,2177856
train,1374,193,148224,1642,236448,384672
train,1375,231,177408,2352,338688,516096
train,1376,381,292608,6398,921312,1213920
train,1377,364,279552,5840,840960,1120512
train,1378,338,259584,5036,725184,984768
train,1379,212,162816,1981,285264,448080
train,1380,328,251904,4742,682848,934752
train,1381,272,208896,3261,469584,678480
train,1382,189,145152,1575,226800,371952
train,1383,363,278784,5808,836352,1115136
train,1384,168,129024,1244,179136,308160
train,1385,212,162816,1981,285264,448080
train,1386,210,161280,1944,279936,441216
train,1387,48,36864,102,14688,51552
train,1388,154,118272,1046,150624,268896
train,1389,306,235008,4127,594288,829296
train,1390,223,171264,2192,315648,486912
train,1391,410,314880,7409,1066896,1381776
train,1392,421,323328,7812,1124928,1448256
train,1393,99,76032,432,62208,138240
train,1394,295,226560,3836,552384,778944
train,1395,334,256512,4917,708048,964560
train,1396,174,133632,1335,192240,325872
train,1397,415,318720,7591,1093104,1411824
train,1398,112,86016,553,79632,165648
train,1399,133,102144,780,112320,214464
train,1400,571,438528,13354,1922976,2361504
train,1401,114,87552,573,82512,170064
train,1402,521,400128,11781,1696464,2096592
train,1403,439,337152,8494,1223136,1560288
train,1404,93,71424,382,55008,126432
train,1405,336,258048,4976,716544,974592
train,1406,238,182784,2497,359568,542352
train,1407,425,326400,7961,1146384,1472784
train,1408,361,277248,5744,827136,1104384
train,1409,319,244992,4485,645840,890832
train,1410,319,244992,4485,645840,890832
train,1411,238,182784,2497,359568,542352
train,1412,116,89088,594,85536,174624
train,1413,148,113664,966,139104,252768
train,1414,264,202752,3072,442368,645120
train,1415,366,281088,5904,850176,1131264
train,1416,572,439296,13388,1927872,2367168
train,1417,270,207360,3213,462672,670032
train,1418,380,291840,6365,916560,1208400
train,1419,245,188160,2646,381024,569184
train,1420,467,358656,9612,1384128,1742784
train,1421,302,231936,4020,578880,810816
train,1422,554,425472,12794,1842336,2267808
train,1423,266,204288,3119,449136,653424
train,1424,361,277248,5744,827136,1104384
train,1425,348,267264,5338,768672,1035936
train,1426,505,387840,11240,1618560,2006400
train,1427,323,248064,4599,662256,910320
train,1428,197,151296,1711,246384,397680
train,1429,200,153600,1763,253872,407472
train,1430,327,251136,4713,678672,929808
train,1431,253,194304,2822,406368,600672
train,1432,301,231168,3994,575136,806304
train,1433,432,331776,8226,1184544,1516320
train,1434,387,297216,6601,950544,1247760
train,1435,236,181248,2455,353520,534768
train,1436,450,345600,8925,1285200,1630800
train,1437,448,344064,8846,1273824,1617888
train,1438,262,201216,3026,435744,636960
train,1439,357,274176,5618,808992,1083168
train,1440,143,109824,902,129888,239712
train,1441,346,265728,5277,759888,1025616
train,1442,350,268800,5399,777456,1046256
train,1443,311,238848,4263,613872,852720
train,1444,308,236544,4181,602064,838608
train,1445,82,62976,297,42768,105744
train,1446,347,266496,5307,764208,1030704
train,1447,254,195072,2844,409536,604608
train,1448,171,131328,1289,185616,316944
train,1449,544,417792,12477,1796688,2214480
train,1450,427,327936,8036,1157184,1485120
train,1451,318,244224,4457,641808,886032
train,1452,328,251904,4742,682848,934752
train,1453,369,283392,6002,864288,1147680
train,1454,295,226560,3836,552384,778944
train,1455,433,332544,8264,1190016,1522560
train,1456,283,217344,3530,508320,725664
train,1457,499,383232,10975,1580400,1963632
train,1458,344,264192,5216,751104,1015296
train,1459,244,187392,2624,377856,565248
train,1460,429,329472,8112,1168128,1497600
train,1461,282,216576,3505,504720,721296
train,1462,450,345600,8925,1285200,1630800
train,1463,184,141312,1493,214992,356304
train,1464,177,135936,1381,198864,334800
train,1465,302,231936,4020,578880,810816
train,1466,457,350976,9205,1325520,1676496
train,1467,327,251136,4713,678672,929808
train,1468,319,244992,4485,645840,890832
train,1469,426,327168,7999,1151856,1479024
train,1470,186,142848,1525,219600,362448
train,1471,75,57600,248,35712,93312
train,1472,409,314112,7373,1061712,1375824
train,1473,600,460800,14368,2068992,2529792
train,1474,395,303360,6877,990288,1293648
train,1475,271,208128,3237,466128,674256
train,1476,366,281088,5904,850176,1131264
train,1477,288,221184,3656,526464,747648
train,1478,194,148992,1659,238896,387888
train,1479,346,265728,5277,759888,1025616
train,1480,172,132096,1304,187776,319872
train,1481,447,343296,8807,1268208,1611504
train,1482,499,383232,10975,1580400,1963632
train,1483,315,241920,4374,629856,871776
train,1484,278,213504,3407,490608,704112
train,1485,294,225792,3810,548640,774432
train,1486,206,158208,1871,269424,427632
train,1487,238,182784,2497,359568,542352
train,1488,463,355584,9448,1360512,1716096
train,1489,197,151296,1711,246384,397680
train,1490,157,120576,1087,156528,277104
train,1491,263,201984,3049,439056,641040
train,1492,353,271104,5492,790848,1061952
train,1493,164,125952,1186,170784,296736
train,1494,311,238848,4263,613872,852720
train,1495,79,60672,276,39744,100416
train,1496,299,229632,3941,567504,797136
train,1497,407,312576,7301,1051344,1363920
train,1498,451,346368,8965,1290960,1637328
train,1499,343,263424,5186,746784,1010208
train,1500,261,200448,3003,432432,632880
train,1501,271,208128,3237,466128,674256
train,1502,363,278784,5808,836352,1115136
train,1503,453,347904,9045,1302480,1650384
train,1504,150,115200,992,142848,258048
train,1505,98,75264,424,61056,136320
train,1506,461,354048,9367,1348848,1702896
train,1507,353,271104,5492,790848,1061952
train,1508,481,369408,10197,1468368,1837776
train,1509,369,283392,6002,864288,1147680
train,1510,559,429312,12956,1865664,2294976
train,1511,372,285696,6100,878400,1164096
train,1512,401,307968,7088,1020672,1328640
train,1513,456,350208,9165,1319760,1669968
train,1514,204,156672,1835,264240,420912
train,1515,364,279552,5840,840960,1120512
train,1516,221,169728,2153,310032,479760
train,1517,572,439296,13388,1927872,2367168
train,1518,114,87552,573,82512,170064
train,1519,100,76800,441,63504,140304
train,1520,273,209664,3285,473040,682704
train,1521,438,336384,8456,1217664,1554048
train,1522,303,232704,4047,582768,815472
train,1523,223,171264,2192,315648,486912
train,1524,245,188160,2646,381024,569184
train,1525,210,161280,1944,279936,441216
train,1526,107,82176,505,72720,154896
train,1527,382,293376,6432,926208,1219584
train,1528,245,188160,2646,381024,569184
train,1529,287,220416,3631,522864,743280
train,1530,441,338688,8572,1234368,1573056
train,1531,328,251904,4742,682848,934752
train,1532,420,322560,7775,1119600,1442160
train,1533,237,182016,2476,356544,538560
train,1534,379,291072,6331,911664,1202736
train,1535,371,284928,6067,873648,1158576
train,1536,242,185856,2582,371808,557664
train,1537,403,309504,7158,1030752,1340256
train,1538,371,284928,6067,873648,1158576
train,1539,227,174336,2272,327168,501504
train,1540,210,161280,1944,279936,441216
train,1541,127,97536,711,102384,199920
train,1542,271,208128,3237,466128,674256
train,1543,167,128256,1230,177120,305376
train,1544,360,276480,5712,822528,1099008
train,1545,266,204288,3119,449136,653424
train,1546,438,336384,8456,1217664,1554048
train,1547,318,244224,4457,641808,886032
train,1548,419,321792,7738,1114272,1436064
train,1549,302,231936,4020,578880,810816
train,1550,484,371712,10325,1486800,1858512
train,1551,537,412416,12260,1765440,2177856
train,1552,506,388608,11285,1625040,2013648
train,1553,230,176640,2332,335808,512448
train,1554,124,95232,678,97632,192864
train,1555,475,364800,9945,1432080,1796880
train,1556,360,276480,5712,822528,1099008
train,1557,510,391680,11464,1650816,2042496
train,1558,259,198912,2957,425808,624720
train,1559,301,231168,3994,575136,806304
train,1560,368,282624,5969,859536,1142160
train,1561,283,217344,3530,508320,725664
train,1562,317,243456,4429,637776,881232
train,1563,232,178176,2373,341712,519888
train,1564,114,87552,573,82512,170064
train,1565,333,255744,4888,703872,959616
train,1566,74,56832,242,34848,91680
train,1567,523,401664,11839,1704816,2106480
train,1568,288,221184,3656,526464,747648
train,1569,323,248064,4599,662256,910320
train,1570,425,326400,7961,1146384,1472784
train,1571,315,241920,4374,629856,871776
train,1572,223,171264,2192,315648,486912
train,1573,283,217344,3530,508320,725664
train,1574,224,172032,2212,318528,490560
train,1575,199,152832,1746,251424,404256
train,1576,315,241920,4374,629856,871776
train,1577,317,243456,4429,637776,881232
train,1578,226,173568,2252,324288,497856
train,1579,104,79872,477,68688,148560
train,1580,180,138240,1428,205632,343872
train,1581,384,294912,6499,935856,1230768
train,1582,196,150528,1694,243936,394464
train,1583,209,160512,1926,277344,437856
train,1584,80,61440,283,40752,102192
train,1585,303,232704,4047,582768,815472
train,1586,239,183552,2518,362592,546144
train,1587,184,141312,1493,214992,356304
train,1588,484,371712,10325,1486800,1858512
train,1589,145,111360,927,133488,244848
train,1590,427,327936,8036,1157184,1485120
train,1591,375,288000,6198,892512,1180512
train,1592,358,274944,5649,813456,1088400
train,1593,229,175872,2312,332928,508800
train,1594,364,279552,5840,840960,1120512
train,1595,227,174336,2272,327168,501504
train,1596,174,133632,1335,192240,325872
train,1597,158,121344,1101,158544,279888
train,1598,213,163584,2000,288000,451584
train,1599,191,146688,1608,231552,378240
train,1600,318,244224,4457,641808,886032
train,1601,294,225792,3810,548640,774432
train,1602,123,94464,667,96048,190512
train,1603,461,354048,9367,1348848,1702896
train,1604,347,266496,5307,764208,1030704
train,1605,288,221184,3656,526464,747648
train,1606,490,376320,10583,1523952,1900272
train,1607,356,273408,5586,804384,1077792
train,1608,457,350976,9205,1325520,1676496
train,1609,249,191232,2733,393552,584784
train,1610,212,162816,1981,285264,448080
train,1611,178,136704,1397,201168,337872
train,1612,98,75264,424,61056,136320
train,1613,173,132864,1320,190080,322944
train,1614,563,432384,13087,1884528,2316912
train,1615,288,221184,3656,526464,747648
train,1616,126,96768,700,100800,197568
train,1617,733,562944,19399,2793456,3356400
train,1618,476,365568,9986,1437984,1803552
train,1619,303,232704,4047,582768,815472
train,1620,291,223488,3733,537552,761040
train,1621,368,282624,5969,859536,1142160
train,1622,299,229632,3941,567504,797136
train,1623,234,179712,2414,347616,527328
train,1624,315,241920,4374,629856,871776
train,1625,291,223488,3733,537552,761040
train,1626,377,289536,6265,902160,1191696
train,1627,299,229632,3941,567504,797136
train,1628,184,141312,1493,214992,356304
train,1629,216,165888,2057,296208,462096
train,1630,443,340224,8650,1245600,1585824
train,1631,128,98304,723,104112,202416
train,1632,285,218880,3580,515520,734400
train,1633,195,149760,1676,241344,391104
train,1634,475,364800,9945,1432080,1796880
train,1635,73,56064,235,33840,89904
train,1636,243,186624,2603,374832,561456
train,1637,394,302592,6842,985248,1287840
train,1638,334,256512,4917,708048,964560
train,1639,376,288768,6231,897264,1186032
train,1640,248,190464,2711,390384,580848
train,1641,292,224256,3758,541152,765408
train,1642,180,138240,1428,205632,343872
train,1643,381,292608,6398,921312,1213920
train,1644,260,199680,2980,429120,628800
train,1645,291,223488,3733,537552,761040
train,1646,420,322560,7775,1119600,1442160
train,1647,109,83712,524,75456,159168
train,1648,312,239616,4291,617904,857520
train,1649,423,324864,7887,1135728,1460592
train,1650,163,125184,1171,168624,293808
train,1651,380,291840,6365,916560,1208400
train,1652,167,128256,1230,177120,305376
train,1653,338,259584,5036,725184,984768
train,1654,425,326400,7961,1146384,1472784
train,1655,249,191232,2733,393552,584784
train,1656,241,185088,2560,368640,553728
train,1657,407,312576,7301,1051344,1363920
train,1658,204,156672,1835,264240,420912
train,1659,164,125952,1186,170784,296736
train,1660,379,291072,6331,911664,1202736
train,1661,93,71424,382,55008,126432
train,1662,158,121344,1101,158544,279888
train,1663,408,313344,7337,1056528,1369872
train,1664,314,241152,4346,625824,866976
train,1665,404,310272,7194,1035936,1346208
train,1666,416,319488,7628,1098432,1417920
train,1667,351,269568,5430,781920,1051488
train,1668,250,192000,2755,396720,588720
train,1669,477,366336,10028,1444032,1810368
train,1670,114,87552,573,82512,170064
train,1671,227,174336,2272,327168,501504
train,1672,251,192768,2777,399888,592656
train,1673,291,223488,3733,537552,761040
train,1674,202,155136,1799,259056,414192
train,1675,269,206592,3190,459360,665952
train,1676,364,279552,5840,840960,1120512
train,1677,347,266496,5307,764208,1030704
train,1678,397,304896,6947,1000368,1305264
train,1679,53,40704,124,17856,58560
train,1680,88,67584,342,49248,116832
train,1681,74,56832,242,34848,91680
train,1682,229,175872,2312,332928,508800
train,1683,384,294912,6499,935856,1230768
train,1684,274,210432,3309,476496,686928
train,1685,336,258048,4976,716544,974592
train,1686,508,390144,11374,1637856,2028000
train,1687,240,184320,2539,365616,549936
train,1688,302,231936,4020,578880,810816
train,1689,429,329472,8112,1168128,1497600
train,1690,305,234240,4100,590400,824640
train,1691,414,317952,7555,1087920,1405872
train,1692,242,185856,2582,371808,557664
train,1693,306,235008,4127,594288,829296
train,1694,206,158208,1871,269424,427632
train,1695,66,50688,192,27648,78336
train,1696,64,49152,181,26064,75216
train,1697,217,166656,2076,298944,465600
train,1698,496,380928,10843,1561392,1942320
train,1699,328,251904,4742,682848,934752
train,1700,278,213504,3407,490608,704112
train,1701,338,259584,5036,725184,984768
train,1702,324,248832,4627,666288,915120
train,1703,348,267264,5338,768672,1035936
train,1704,512,393216,11521,1659024,2052240
train,1705,391,300288,6738,970272,1270560
train,1706,85,65280,319,45936,111216
train,1707,220,168960,2134,307296,476256
train,1708,99,76032,432,62208,138240
train,1709,328,251904,4742,682848,934752
train,1710,454,348672,9085,1308240,1656912
train,1711,226,173568,2252,324288,497856
train,1712,138,105984,840,120960,226944
train,1713,426,327168,7999,1151856,1479024
train,1714,450,345600,8925,1285200,1630800
train,1715,139,106752,852,122688,229440
train,1716,434,333312,8302,1195488,1528800
train,1717,169,129792,1259,181296,311088
train,1718,170,130560,1274,183456,314016
train,1719,424,325632,7924,1141056,1466688
train,1720,578,443904,13592,1957248,2401152
train,1721,343,263424,5186,746784,1010208
train,1722,277,212736,3382,487008,699744
train,1723,439,337152,8494,1223136,1560288
train,1724,402,308736,7123,1025712,1334448
train,1725,437,335616,8417,1212048,1547664
train,1726,314,241152,4346,625824,866976
train,1727,401,307968,7088,1020672,1328640
train,1728,210,161280,1944,279936,441216
train,1729,180,138240,1428,205632,343872
train,1730,288,221184,3656,526464,747648
train,1731,105,80640,486,69984,150624
train,1732,370,284160,6034,868896,1153056
train,1733,370,284160,6034,868896,1153056
train,1734,218,167424,2095,301680,469104
train,1735,110,84480,534,76896,161376
train,1736,385,295680,6533,940752,1236432
train,1737,655,503040,16493,2374992,2878032
train,1738,381,292608,6398,921312,1213920
train,1739,142,109056,889,128016,237072
train,1740,311,238848,4263,613872,852720
train,1741,359,275712,5681,818064,1093776
train,1742,266,204288,3119,449136,653424
train,1743,529,406272,12018,1730592,2136864
train,1744,205,157440,1853,266832,424272
train,1745,256,196608,2889,416016,612624
train,1746,113,86784,563,81072,167856
train,1747,290,222720,3707,533808,756528
train,1748,414,317952,7555,1087920,1405872
train,1749,196,150528,1694,243936,394464
train,1750,539,413952,12322,1774368,2188320
train,1751,214,164352,2019,290736,455088
train,1752,57,43776,144,20736,64512
train,1753,225,172800,2232,321408,494208
train,1754,301,231168,3994,575136,806304
train,1755,153,117504,1032,148608,266112
train,1756,120,92160,635,91440,183600
train,1757,352,270336,5461,786384,1056720
train,1758,168,129024,1244,179136,308160
train,1759,166,127488,1215,174960,302448
train,1760,372,285696,6100,878400,1164096
train,1761,207,158976,1889,272016,430992
train,1762,150,115200,992,142848,258048
train,1763,197,151296,1711,246384,397680
train,1764,241,185088,2560,368640,553728
train,1765,103,79104,468,67392,146496
train,1766,290,222720,3707,533808,756528
train,1767,232,178176,2373,341712,519888
train,1768,429,329472,8112,1168128,1497600
train,1769,227,174336,2272,327168,501504
train,1770,334,256512,4917,708048,964560
train,1771,344,264192,5216,751104,1015296
train,1772,480,368640,10155,1462320,1830960
train,1773,695,533760,18207,2621808,3155568
train,1774,247,189696,2689,387216,576912
train,1775,156,119808,1073,154512,274320
train,1776,287,220416,3631,522864,743280
train,1777,412,316416,7482,1077408,1393824
train,1778,180,138240,1428,205632,343872
train,1779,344,264192,5216,751104,1015296
train,1780,157,120576,1087,156528,277104
train,1781,262,201216,3026,435744,636960
train,1782,603,463104,14477,2084688,2547792
train,1783,408,313344,7337,1056528,1369872
train,1784,159,122112,1115,160560,282672
train,1785,325,249600,4656,670464,920064
train,1786,638,489984,15808,2276352,2766336
train,1787,150,115200,992,142848,258048
train,1788,380,291840,6365,916560,1208400
train,1789,410,314880,7409,1066896,1381776
train,1790,247,189696,2689,387216,576912
train,1791,230,176640,2332,335808,512448
train,1792,320,245760,4514,650016,895776
train,1793,270,207360,3213,462672,670032
train,1794,280,215040,3456,497664,712704
train,1795,175,134400,1350,194400,328800
train,1796,140,107520,864,124416,231936
train,1797,110,84480,534,76896,161376
train,1798,234,179712,2414,347616,527328
train,1799,427,327936,8036,1157184,1485120
train,1800,319,244992,4485,645840,890832
train,1801,422,324096,7849,1130256,1454352
train,1802,388,297984,6635,955440,1253424
train,1803,423,324864,7887,1135728,1460592
train,1804,446,342528,8767,1262448,1604976
train,1805,292,224256,3758,541152,765408
train,1806,217,166656,2076,298944,465600
train,1807,289,221952,3682,530208,752160
train,1808,507,389376,11330,1631520,2020896
train,1809,86,66048,326,46944,112992
train,1810,407,312576,7301,1051344,1363920
train,1811,205,157440,1853,266832,424272
train,1812,405,311040,7230,1041120,1352160
train,1813,228,175104,2292,330048,505152
train,1814,133,102144,780,112320,214464
train,1815,257,197376,2911,419184,616560
train,1816,246,188928,2668,384192,573120
train,1817,174,133632,1335,192240,325872
train,1818,87,66816,334,48096,114912
train,1819,205,157440,1853,266832,424272
train,1820,78,59904,269,38736,98640
train,1821,493,378624,10713,1542672,1921296
train,1822,117,89856,604,86976,176832
train,1823,261,200448,3003,432432,632880
train,1824,331,254208,4829,695376,949584
train,1825,267,205056,3142,452448,657504
train,1826,401,307968,7088,1020672,1328640
train,1827,287,220416,3631,522864,743280
train,1828,121,92928,646,93024,185952
train,1829,449,344832,8886,1279584,1624416
train,1830,430,330240,8150,1173600,1503840
train,1831,445,341760,8728,1256832,1598592
train,1832,406,311808,7265,1046160,1357968
train,1833,226,173568,2252,324288,497856
train,1834,132,101376,768,110592,211968
train,1835,486,373248,10410,1499040,1872288
train,1836,416,319488,7628,1098432,1417920
train,1837,398,305664,6982,1005408,1311072
train,1838,533,409344,12138,1747872,2157216
train,1839,404,310272,7194,1035936,1346208
train,1840,143,109824,902,129888,239712
train,1841,252,193536,2799,403056,596592
train,1842,371,284928,6067,873648,1158576
train,1843,402,308736,7123,1025712,1334448
train,1844,197,151296,1711,246384,397680
train,1845,327,251136,4713,678672,929808
train,1846,265,203520,3096,445824,649344
train,1847,250,192000,2755,396720,588720
train,1848,442,339456,8611,1239984,1579440
train,1849,391,300288,6738,970272,1270560
train,1850,257,197376,2911,419184,616560
train,1851,291,223488,3733,537552,761040
train,1852,286,219648,3606,519264,738912
train,1853,318,244224,4457,641808,886032
train,1854,287,220416,3631,522864,743280
train,1855,265,203520,3096,445824,649344
train,1856,372,285696,6100,878400,1164096
train,1857,95,72960,398,57312,130272
train,1858,459,352512,9286,1337184,1689696
train,1859,241,185088,2560,368640,553728
train,1860,159,122112,1115,160560,282672
train,1861,452,347136,9005,1296720,1643856
train,1862,282,216576,3505,504720,721296
train,1863,240,184320,2539,365616,549936
train,1864,380,291840,6365,916560,1208400
train,1865,217,166656,2076,298944,465600
train,1866,190,145920,1592,229248,375168
train,1867,385,295680,6533,940752,1236432
train,1868,215,165120,2038,293472,458592
train,1869,338,259584,5036,725184,984768
train,1870,78,59904,269,38736,98640
train,1871,224,172032,2212,318528,490560
train,1872,410,314880,7409,1066896,1381776
train,1873,800,614400,21694,3123936,3738336
train,1874,351,269568,5430,781920,1051488
train,1875,434,333312,8302,1195488,1528800
train,1876,238,182784,2497,359568,542352
train,1877,222,170496,2173,312912,483408
train,1878,147,112896,953,137232,250128
train,1879,47,36096,98,14112,50208
train,1880,301,231168,3994,575136,806304
train,1881,151,115968,1005,144720,260688
train,1882,175,134400,1350,194400,328800
train,1883,198,152064,1728,248832,400896
train,1884,204,156672,1835,264240,420912
train,1885,114,87552,573,82512,170064
train,1886,155,119040,1059,152496,271536
train,1887,170,130560,1274,183456,314016
train,1888,651,499968,16330,2351520,2851488
train,1889,72,55296,229,32976,88272
train,1890,284,218112,3555,511920,730032
train,1891,163,125184,1171,168624,293808
train,1892,343,263424,5186,746784,1010208
train,1893,221,169728,2153,310032,479760
train,1894,217,166656,2076,298944,465600
train,1895,158,121344,1101,158544,279888
train,1896,175,134400,1350,194400,328800
train,1897,415,318720,7591,1093104,1411824
train,1898,395,303360,6877,990288,1293648
train,1899,412,316416,7482,1077408,1393824
train,1900,617,473856,14996,2159424,2633280
train,1901,369,283392,6002,864288,1147680
train,1902,278,213504,3407,490608,704112
train,1903,331,254208,4829,695376,949584
train,1904,307,235776,4154,598176,833952
train,1905,193,148224,1642,236448,384672
train,1906,407,312576,7301,1051344,1363920
train,1907,443,340224,8650,1245600,1585824
train,1908,315,241920,4374,629856,871776
train,1909,309,237312,4209,606096,843408
train,1910,434,333312,8302,1195488,1528800
train,1911,302,231936,4020,578880,810816
train,1912,432,331776,8226,1184544,1516320
train,1913,387,297216,6601,950544,1247760
train,1914,467,358656,9612,1384128,1742784
train,1915,536,411648,12229,1760976,2172624
train,1916,531,407808,12078,1739232,2147040
train,1917,453,347904,9045,1302480,1650384
train,1918,221,169728,2153,310032,479760
train,1919,122,93696,656,94464,188160
train,1920,247,189696,2689,387216,576912
train,1921,281,215808,3481,501264,717072
train,1922,167,128256,1230,177120,305376
train,1923,484,371712,10325,1486800,1858512
train,1924,168,129024,1244,179136,308160
train,1925,198,152064,1728,248832,400896
train,1926,367,281856,5937,854928,1136784
train,1927,383,294144,6466,931104,1225248
train,1928,352,270336,5461,786384,1056720
train,1929,424,325632,7924,1141056,1466688
train,1930,243,186624,2603,374832,561456
train,1931,222,170496,2173,312912,483408
train,1932,515,395520,11607,1671408,2066928
train,1933,325,249600,4656,670464,920064
train,1934,394,302592,6842,985248,1287840
train,1935,123,94464,667,96048,190512
train,1936,303,232704,4047,582768,815472
train,1937,230,176640,2332,335808,512448
train,1938,240,184320,2539,365616,549936
train,1939,141,108288,877,126288,234576
train,1940,402,308736,7123,1025712,1334448
train,1941,154,118272,1046,150624,268896
train,1942,340,261120,5095,733680,994800
train,1943,463,355584,9448,1360512,1716096
train,1944,87,66816,334,48096,114912
train,1945,271,208128,3237,466128,674256
train,1946,66,50688,192,27648,78336
train,1947,111,85248,543,78192,163440
train,1948,413,317184,7518,1082592,1399776
train,1949,426,327168,7999,1151856,1479024
train,1950,402,308736,7123,1025712,1334448
train,1951,113,86784,563,81072,167856
train,1952,278,213504,3407,490608,704112
train,1953,322,247296,4570,658080,905376
train,1954,477,366336,10028,1444032,1810368
train,1955,71,54528,223,32112,86640
train,1956,445,341760,8728,1256832,1598592
train,1957,136,104448,816,117504,221952
train,1958,314,241152,4346,625824,866976
train,1959,240,184320,2539,365616,549936
train,1960,181,139008,1444,207936,346944
train,1961,528,405504,11988,1726272,2131776
train,1962,181,139008,1444,207936,346944
train,1963,215,165120,2038,293472,458592
train,1964,227,174336,2272,327168,501504
train,1965,173,132864,1320,190080,322944
train,1966,485,372480,10368,1492992,1865472
train,1967,713,547584,18791,2705904,3253488
train,1968,222,170496,2173,312912,483408
train,1969,242,185856,2582,371808,557664
train,1970,263,201984,3049,439056,641040
train,1971,240,184320,2539,365616,549936
train,1972,333,255744,4888,703872,959616
train,1973,97,74496,415,59760,134256
train,1974,115,88320,583,83952,172272
train,1975,168,129024,1244,179136,308160
train,1976,236,181248,2455,353520,534768
train,1977,108,82944,515,74160,157104
train,1978,484,371712,10325,1486800,1858512
train,1979,416,319488,7628,1098432,1417920
train,1980,412,316416,7482,1077408,1393824
train,1981,286,219648,3606,519264,738912
train,1982,675,518400,17333,2495952,3014352
train,1983,165,126720,1200,172800,299520
train,1984,338,259584,5036,725184,984768
train,1985,450,345600,8925,1285200,1630800
train,1986,358,274944,5649,813456,1088400
train,1987,218,167424,2095,301680,469104
train,1988,164,125952,1186,170784,296736
train,1989,154,118272,1046,150624,268896
train,1990,231,177408,2352,338688,516096
train,1991,119,91392,625,90000,181392
train,1992,394,302592,6842,985248,1287840
train,1993,194,148992,1659,238896,387888
train,1994,321,246528,4542,654048,900576
train,1995,238,182784,2497,359568,542352
train,1996,263,201984,3049,439056,641040
train,1997,160,122880,1129,162576,285456
train,1998,276,211968,3358,483552,695520
train,1999,385,295680,6533,940752,1236432
train,2000,207,158976,1889,272016,430992
train,2001,214,164352,2019,290736,455088
train,2002,537,412416,12260,1765440,2177856
train,2003,277,212736,3382,487008,699744
train,2004,387,297216,6601,950544,1247760
train,2005,223,171264,2192,315648,486912
train,2006,316,242688,4401,633744,876432
train,2007,163,125184,1171,168624,293808
train,2008,109,83712,524,75456,159168
train,2009,476,365568,9986,1437984,1803552
train,2010,361,277248,5744,827136,1104384
train,2011,361,277248,5744,827136,1104384
train,2012,186,142848,1525,219600,362448
train,2013,377,289536,6265,902160,1191696
train,2014,201,154368,1781,256464,410832
train,2015,161,123648,1143,164592,288240
train,2016,383,294144,6466,931104,1225248
train,2017,88,67584,342,49248,116832
train,2018,63,48384,175,25200,73584
train,2019,292,224256,3758,541152,765408
train,2020,402,308736,7123,1025712,1334448
train,2021,408,313344,7337,1056528,1369872
train,2022,232,178176,2373,341712,519888
train,2023,353,271104,5492,790848,1061952
train,2024,250,192000,2755,396720,588720
train,2025,363,278784,5808,836352,1115136
train,2026,458,351744,9246,1331424,1683168
train,2027,158,121344,1101,158544,279888
train,2028,430,330240,8150,1173600,1503840
train,2029,606,465408,14587,2100528,2565936
train,2030,336,258048,4976,716544,974592
train,2031,404,310272,7194,1035936,1346208
train,2032,42,32256,78,11232,43488
train,2033,88,67584,342,49248,116832
train,2034,560,430080,12989,1870416,2300496
train,2035,211,162048,1963,282672,444720
train,2036,440,337920,8533,1228752,1566672
train,2037,335,257280,4947,712368,969648
train,2038,310,238080,4236,609984,848064
train,2039,330,253440,4800,691200,944640
train,2040,258,198144,2934,422496,620640
train,2041,246,188928,2668,384192,573120
train,2042,235,180480,2434,350496,530976
train,2043,187,143616,1542,222048,365664
train,2044,227,174336,2272,327168,501504
train,2045,100,76800,441,63504,140304
train,2046,193,148224,1642,236448,384672
train,2047,536,411648,12229,1760976,2172624
train,2048,402,308736,7123,1025712,1334448
train,2049,387,297216,6601,950544,1247760
train,2050,278,213504,3407,490608,704112
train,2051,353,271104,5492,790848,1061952
train,2052,247,189696,2689,387216,576912
train,2053,370,284160,6034,868896,1153056
train,2054,376,288768,6231,897264,1186032
train,2055,106,81408,496,71424,152832
train,2056,384,294912,6499,935856,1230768
train,2057,371,284928,6067,873648,1158576
train,2058,227,174336,2272,327168,501504
train,2059,268,205824,3166,455904,661728
train,2060,360,276480,5712,822528,1099008
train,2061,237,182016,2476,356544,538560
train,2062,233,178944,2393,344592,523536
train,2063,323,248064,4599,662256,910320
train,2064,209,160512,1926,277344,437856
train,2065,121,92928,646,93024,185952
train,2066,217,166656,2076,298944,465600
train,2067,229,175872,2312,332928,508800
train,2068,419,321792,7738,1114272,1436064
train,2069,421,323328,7812,1124928,1448256
train,2070,368,282624,5969,859536,1142160
train,2071,574,440832,13455,1937520,2378352
train,2072,240,184320,2539,365616,549936
train,2073,335,257280,4947,712368,969648
train,2074,241,185088,2560,368640,553728
train,2075,92,70656,373,53712,124368
train,2076,131,100608,757,109008,209616
train,2077,358,274944,5649,813456,1088400
train,2078,527,404736,11958,1721952,2126688
train,2079,149,114432,979,140976,255408
train,2080,150,115200,992,142848,258048
train,2081,459,352512,9286,1337184,1689696
train,2082,435,334080,8340,1200960,1535040
train,2083,188,144384,1558,224352,368736
train,2084,354,271872,5524,795456,1067328
train,2085,409,314112,7373,1061712,1375824
train,2086,134,102912,792,114048,216960
train,2087,201,154368,1781,256464,410832
train,2088,283,217344,3530,508320,725664
train,2089,577,443136,13558,1952352,2395488
train,2090,321,246528,4542,654048,900576
train,2091,420,322560,7775,1119600,1442160
train,2092,143,109824,902,129888,239712
train,2093,240,184320,2539,365616,549936
train,2094,473,363264,9861,1419984,1783248
train,2095,436,334848,8379,1206576,1541424
train,2096,309,237312,4209,606096,843408
train,2097,372,285696,6100,878400,1164096
train,2098,399,306432,7017,1010448,1316880
train,2099,408,313344,7337,1056528,1369872
train,2100,266,204288,3119,449136,653424
train,2101,128,98304,723,104112,202416
train,2102,252,193536,2799,403056,596592
train,2103,163,125184,1171,168624,293808
train,2104,400,307200,7052,1015488,1322688
train,2105,273,209664,3285,473040,682704
train,2106,373,286464,6132,883008,1169472
train,2107,212,162816,1981,285264,448080
train,2108,217,166656,2076,298944,465600
train,2109,357,274176,5618,808992,1083168
train,2110,208,159744,1907,274608,434352
train,2111,148,113664,966,139104,252768
train,2112,447,343296,8807,1268208,1611504
train,2113,209,160512,1926,277344,437856
train,2114,295,226560,3836,552384,778944
train,2115,278,213504,3407,490608,704112
train,2116,144,110592,914,131616,242208
train,2117,462,354816,9408,1354752,1709568
train,2118,313,240384,4318,621792,862176
train,2119,375,288000,6198,892512,1180512
train,2120,399,306432,7017,1010448,1316880
train,2121,542,416256,12415,1787760,2204016
train,2122,315,241920,4374,629856,871776
train,2123,89,68352,350,50400,118752
train,2124,180,138240,1428,205632,343872
train,2125,336,258048,4976,716544,974592
train,2126,428,328704,8074,1162656,1491360
train,2127,87,66816,334,48096,114912
train,2128,140,107520,864,124416,231936
train,2129,237,182016,2476,356544,538560
train,2130,175,134400,1350,194400,328800
train,2131,147,112896,953,137232,250128
train,2132,376,288768,6231,897264,1186032
train,2133,354,271872,5524,795456,1067328
train,2134,123,94464,667,96048,190512
train,2135,341,261888,5125,738000,999888
train,2136,214,164352,2019,290736,455088
train,2137,431,331008,8188,1179072,1510080
train,2138,564,433152,13120,1889280,2322432
train,2139,221,169728,2153,310032,479760
train,2140,278,213504,3407,490608,704112
train,2141,129,99072,734,105696,204768
train,2142,130,99840,745,107280,207120
train,2143,314,241152,4346,625824,866976
train,2144,284,218112,3555,511920,730032
train,2145,336,258048,4976,716544,974592
train,2146,421,323328,7812,1124928,1448256
train,2147,151,115968,1005,144720,260688
train,2148,146,112128,940,135360,247488
train,2149,503,386304,11151,1605744,1992048
train,2150,172,132096,1304,187776,319872
train,2151,75,57600,248,35712,93312
train,2152,106,81408,496,71424,152832
train,2153,234,179712,2414,347616,527328
train,2154,303,232704,4047,582768,815472
train,2155,567,435456,13220,1903680,2339136
train,2156,111,85248,543,78192,163440
train,2157,122,93696,656,94464,188160
train,2158,392,301056,6773,975312,1276368
train,2159,274,210432,3309,476496,686928
train,2160,174,133632,1335,192240,325872
train,2161,280,215040,3456,497664,712704
train,2162,316,242688,4401,633744,876432
train,2163,238,182784,2497,359568,542352
train,2164,223,171264,2192,315648,486912
train,2165,106,81408,496,71424,152832
train,2166,83,63744,304,43776,107520
train,2167,226,173568,2252,324288,497856
train,2168,190,145920,1592,229248,375168
train,2169,295,226560,3836,552384,778944
train,2170,195,149760,1676,241344,391104
train,2171,364,279552,5840,840960,1120512
train,2172,181,139008,1444,207936,346944
train,2173,232,178176,2373,341712,519888
train,2174,162,124416,1157,166608,291024
train,2175,288,221184,3656,526464,747648
train,2176,252,193536,2799,403056,596592
train,2177,721,553728,19030,2740320,3294048
train,2178,345,264960,5246,755424,1020384
train,2179,223,171264,2192,315648,486912
train,2180,274,210432,3309,476496,686928
train,2181,234,179712,2414,347616,527328
train,2182,269,206592,3190,459360,665952
train,2183,302,231936,4020,578880,810816
train,2184,240,184320,2539,365616,549936
train,2185,118,90624,614,88416,179040
train,2186,379,291072,6331,911664,1202736
train,2187,322,247296,4570,658080,905376
train,2188,113,86784,563,81072,167856
train,2189,438,336384,8456,1217664,1554048
train,2190,207,158976,1889,272016,430992
train,2191,276,211968,3358,483552,695520
train,2192,244,187392,2624,377856,565248
train,2193,414,317952,7555,1087920,1405872
train,2194,464,356352,9489,1366416,1722768
train,2195,466,357888,9571,1378224,1736112
train,2196,427,327936,8036,1157184,1485120
train,2197,137,105216,828,119232,224448
train,2198,183,140544,1476,212544,353088
train,2199,317,243456,4429,637776,881232
train,2200,291,223488,3733,537552,761040
train,2201,488,374784,10496,1511424,1886208
train,2202,270,207360,3213,462672,670032
train,2203,429,329472,8112,1168128,1497600
train,2204,300,230400,3967,571248,801648
train,2205,332,254976,4858,699552,954528
train,2206,313,240384,4318,621792,862176
train,2207,110,84480,534,76896,161376
train,2208,259,198912,2957,425808,624720
train,2209,416,319488,7628,1098432,1417920
train,2210,240,184320,2539,365616,549936
train,2211,301,231168,3994,575136,806304
train,2212,160,122880,1129,162576,285456
train,2213,251,192768,2777,399888,592656
train,2214,239,183552,2518,362592,546144
train,2215,188,144384,1558,224352,368736
train,2216,434,333312,8302,1195488,1528800
train,2217,212,162816,1981,285264,448080
train,2218,403,309504,7158,1030752,1340256
train,2219,385,295680,6533,940752,1236432
train,2220,384,294912,6499,935856,1230768
train,2221,465,357120,9530,1372320,1729440
train,2222,83,63744,304,43776,107520
train,2223,224,172032,2212,318528,490560
train,2224,462,354816,9408,1354752,1709568
train,2225,390,299520,6704,965376,1264896
train,2226,307,235776,4154,598176,833952
train,2227,88,67584,342,49248,116832
train,2228,276,211968,3358,483552,695520
train,2229,239,183552,2518,362592,546144
train,2230,303,232704,4047,582768,815472
train,2231,219,168192,2114,304416,472608
train,2232,73,56064,235,33840,89904
train,2233,431,331008,8188,1179072,1510080
train,2234,390,299520,6704,965376,1264896
train,2235,116,89088,594,85536,174624
train,2236,405,311040,7230,1041120,1352160
train,2237,134,102912,792,114048,216960
train,2238,229,175872,2312,332928,508800
train,2239,153,117504,1032,148608,266112
train,2240,195,149760,1676,241344,391104
train,2241,190,145920,1592,229248,375168
train,2242,234,179712,2414,347616,527328
train,2243,275,211200,3334,480096,691296
train,2244,232,178176,2373,341712,519888
train,2245,435,334080,8340,1200960,1535040
train,2246,225,172800,2232,321408,494208
train,2247,222,170496,2173,312912,483408
train,2248,441,338688,8572,1234368,1573056
train,2249,317,243456,4429,637776,881232
train,2250,486,373248,10410,1499040,1872288
train,2251,96,73728,407,58608,132336
train,2252,243,186624,2603,374832,561456
train,2253,193,148224,1642,236448,384672
train,2254,446,342528,8767,1262448,1604976
train,2255,486,373248,10410,1499040,1872288
train,2256,266,204288,3119,449136,653424
train,2257,361,277248,5744,827136,1104384
train,2258,284,218112,3555,511920,730032
train,2259,426,327168,7999,1151856,1479024
train,2260,201,154368,1781,256464,410832
train,2261,470,360960,9736,1401984,1762944
train,2262,395,303360,6877,990288,1293648
train,2263,138,105984,840,120960,226944
train,2264,313,240384,4318,621792,862176
train,2265,368,282624,5969,859536,1142160
train,2266,559,429312,12956,1865664,2294976
train,2267,243,186624,2603,374832,561456
train,2268,136,104448,816,117504,221952
train,2269,162,124416,1157,166608,291024
train,2270,261,200448,3003,432432,632880
train,2271,255,195840,2866,412704,608544
train,2272,240,184320,2539,365616,549936
train,2273,106,81408,496,71424,152832
train,2274,321,246528,4542,654048,900576
train,2275,299,229632,3941,567504,797136
train,2276,412,316416,7482,1077408,1393824
train,2277,350,268800,5399,777456,1046256
train,2278,591,453888,14045,2022480,2476368
train,2279,341,261888,5125,738000,999888
train,2280,288,221184,3656,526464,747648
train,2281,468,359424,9654,1390176,1749600
train,2282,385,295680,6533,940752,1236432
train,2283,473,363264,9861,1419984,1783248
train,2284,220,168960,2134,307296,476256
train,2285,574,440832,13455,1937520,2378352
train,2286,233,178944,2393,344592,523536
train,2287,333,255744,4888,703872,959616
train,2288,260,199680,2980,429120,628800
train,2289,232,178176,2373,341712,519888
train,2290,54,41472,129,18576,60048
train,2291,385,295680,6533,940752,1236432
train,2292,98,75264,424,61056,136320
train,2293,286,219648,3606,519264,738912
train,2294,369,283392,6002,864288,1147680
train,2295,117,89856,604,86976,176832
train,2296,382,293376,6432,926208,1219584
train,2297,186,142848,1525,219600,362448
train,2298,312,239616,4291,617904,857520
train,2299,305,234240,4100,590400,824640
train,2300,224,172032,2212,318528,490560
train,2301,252,193536,2799,403056,596592
train,2302,242,185856,2582,371808,557664
train,2303,273,209664,3285,473040,682704
train,2304,368,282624,5969,859536,1142160
train,2305,432,331776,8226,1184544,1516320
train,2306,598,459264,14295,2058480,2517744
train,2307,130,99840,745,107280,207120
train,2308,256,196608,2889,416016,612624
train,2309,281,215808,3481,501264,717072
train,2310,362,278016,5776,831744,1109760
train,2311,203,155904,1817,261648,417552
train,2312,399,306432,7017,1010448,1316880
train,2313,362,278016,5776,831744,1109760
train,2314,435,334080,8340,1200960,1535040
train,2315,340,261120,5095,733680,994800
train,2316,316,242688,4401,633744,876432
train,2317,265,203520,3096,445824,649344
train,2318,224,172032,2212,318528,490560
train,2319,239,183552,2518,362592,546144
train,2320,153,117504,1032,148608,266112
train,2321,400,307200,7053,1015632,1322832
train,2322,463,355584,9448,1360512,1716096
train,2323,361,277248,5744,827136,1104384
train,2324,249,191232,2733,393552,584784
train,2325,236,181248,2455,353520,534768
train,2326,445,341760,8728,1256832,1598592
train,2327,318,244224,4457,641808,886032
train,2328,251,192768,2777,399888,592656
train,2329,277,212736,3382,487008,699744
train,2330,189,145152,1575,226800,371952
train,2331,161,123648,1143,164592,288240
train,2332,304,233472,4074,586656,820128
train,2333,271,208128,3237,466128,674256
train,2334,425,326400,7961,1146384,1472784
train,2335,296,227328,3862,556128,783456
train,2336,373,286464,6132,883008,1169472
train,2337,439,337152,8494,1223136,1560288
train,2338,416,319488,7628,1098432,1417920
train,2339,214,164352,2019,290736,455088
train,2340,223,171264,2192,315648,486912
train,2341,424,325632,7924,1141056,1466688
train,2342,279,214272,3431,494064,708336
train,2343,381,292608,6398,921312,1213920
train,2344,176,135168,1366,196704,331872
train,2345,203,155904,1817,261648,417552
train,2346,236,181248,2455,353520,534768
train,2347,418,321024,7701,1108944,1429968
train,2348,139,106752,852,122688,229440
train,2349,175,134400,1350,194400,328800
train,2350,301,231168,3994,575136,806304
train,2351,381,292608,6398,921312,1213920
train,2352,515,395520,11607,1671408,2066928
train,2353,109,83712,524,75456,159168
train,2354,241,185088,2560,368640,553728
train,2355,153,117504,1032,148608,266112
train,2356,159,122112,1115,160560,282672
train,2357,349,268032,5369,773136,1041168
train,2358,240,184320,2539,365616,549936
train,2359,224,172032,2212,318528,490560
train,2360,144,110592,914,131616,242208
train,2361,367,281856,5937,854928,1136784
train,2362,278,213504,3407,490608,704112
train,2363,189,145152,1575,226800,371952
train,2364,521,400128,11781,1696464,2096592
train,2365,171,131328,1289,185616,316944
train,2366,422,324096,7849,1130256,1454352
train,2367,371,284928,6067,873648,1158576
train,2368,252,193536,2799,403056,596592
train,2369,433,332544,8264,1190016,1522560
train,2370,354,271872,5524,795456,1067328
train,2371,279,214272,3431,494064,708336
train,2372,162,124416,1157,166608,291024
train,2373,370,284160,6034,868896,1153056
train,2374,460,353280,9326,1342944,1696224
train,2375,384,294912,6499,935856,1230768
train,2376,195,149760,1676,241344,391104
train,2377,237,182016,2476,356544,538560
train,2378,132,101376,768,110592,211968
train,2379,246,188928,2668,384192,573120
train,2380,381,292608,6398,921312,1213920
train,2381,262,201216,3026,435744,636960
train,2382,120,92160,635,91440,183600
train,2383,434,333312,8302,1195488,1528800
train,2384,165,126720,1200,172800,299520
train,2385,434,333312,8302,1195488,1528800
train,2386,236,181248,2455,353520,534768
train,2387,96,73728,407,58608,132336
train,2388,113,86784,563,81072,167856
train,2389,217,166656,2076,298944,465600
train,2390,320,245760,4514,650016,895776
train,2391,56,43008,139,20016,63024
train,2392,207,158976,1889,272016,430992
train,2393,272,208896,3261,469584,678480
train,2394,204,156672,1835,264240,420912
train,2395,273,209664,3285,473040,682704
train,2396,162,124416,1157,166608,291024
train,2397,256,196608,2889,416016,612624
train,2398,181,139008,1444,207936,346944
train,2399,320,245760,4514,650016,895776
train,2400,221,169728,2153,310032,479760
train,2401,216,165888,2057,296208,462096
train,2402,301,231168,3994,575136,806304
train,2403,307,235776,4154,598176,833952
train,2404,372,285696,6100,878400,1164096
train,2405,295,226560,3836,552384,778944
train,2406,96,73728,407,58608,132336
train,2407,273,209664,3285,473040,682704
train,2408,149,114432,979,140976,255408
train,2409,361,277248,5744,827136,1104384
train,2410,140,107520,864,124416,231936
train,2411,180,138240,1428,205632,343872
train,2412,281,215808,3481,501264,717072
train,2413,320,245760,4514,650016,895776
train,2414,260,199680,2980,429120,628800
train,2415,311,238848,4263,613872,852720
train,2416,227,174336,2272,327168,501504
train,2417,306,235008,4127,594288,829296
train,2418,442,339456,8611,1239984,1579440
train,2419,307,235776,4154,598176,833952
train,2420,429,329472,8112,1168128,1497600
train,2421,239,183552,2518,362592,546144
train,2422,243,186624,2603,374832,561456
train,2423,587,450816,13904,2002176,2452992
train,2424,373,286464,6132,883008,1169472
train,2425,181,139008,1444,207936,346944
train,2426,392,301056,6773,975312,1276368
train,2427,247,189696,2689,387216,576912
train,2428,223,171264,2192,315648,486912
train,2429,50,38400,111,15984,54384
train,2430,380,291840,6365,916560,1208400
train,2431,149,114432,979,140976,255408
train,2432,530,407040,12048,1734912,2141952
train,2433,430,330240,8150,1173600,1503840
train,2434,381,292608,6398,921312,1213920
train,2435,143,109824,902,129888,239712
train,2436,350,268800,5399,777456,1046256
train,2437,251,192768,2777,399888,592656
train,2438,225,172800,2232,321408,494208
train,2439,160,122880,1129,162576,285456
train,2440,304,233472,4074,586656,820128
train,2441,325,249600,4656,670464,920064
train,2442,209,160512,1926,277344,437856
train,2443,311,238848,4263,613872,852720
train,2444,226,173568,2252,324288,497856
train,2445,85,65280,319,45936,111216
train,2446,194,148992,1659,238896,387888
train,2447,275,211200,3334,480096,691296
train,2448,197,151296,1711,246384,397680
train,2449,439,337152,8494,1223136,1560288
train,2450,238,182784,2497,359568,542352
train,2451,295,226560,3836,552384,778944
train,2452,200,153600,1763,253872,407472
train,2453,459,352512,9286,1337184,1689696
train,2454,308,236544,4181,602064,838608
train,2455,282,216576,3505,504720,721296
train,2456,250,192000,2755,396720,588720
train,2457,348,267264,5338,768672,1035936
train,2458,205,157440,1853,266832,424272
train,2459,410,314880,7409,1066896,1381776
train,2460,149,114432,979,140976,255408
train,2461,241,185088,2560,368640,553728
train,2462,307,235776,4154,598176,833952
train,2463,448,344064,8846,1273824,1617888
train,2464,216,165888,2057,296208,462096
train,2465,155,119040,1059,152496,271536
train,2466,389,298752,6670,960480,1259232
train,2467,321,246528,4542,654048,900576
train,2468,82,62976,297,42768,105744
train,2469,408,313344,7337,1056528,1369872
train,2470,179,137472,1413,203472,340944
train,2471,175,134400,1350,194400,328800
train,2472,162,124416,1157,166608,291024
train,2473,73,56064,235,33840,89904
train,2474,353,271104,5492,790848,1061952
train,2475,227,174336,2272,327168,501504
train,2476,429,329472,8112,1168128,1497600
train,2477,250,192000,2755,396720,588720
train,2478,215,165120,2038,293472,458592
train,2479,225,172800,2232,321408,494208
train,2480,372,285696,6100,878400,1164096
train,2481,231,177408,2352,338688,516096
train,2482,312,239616,4291,617904,857520
train,2483,198,152064,1728,248832,400896
train,2484,279,214272,3431,494064,708336
train,2485,136,104448,816,117504,221952
train,2486,94,72192,390,56160,128352
train,2487,253,194304,2822,406368,600672
train,2488,320,245760,4514,650016,895776
train,2489,329,252672,4771,687024,939696
train,2490,220,168960,2134,307296,476256
train,2491,468,359424,9654,1390176,1749600
train,2492,145,111360,927,133488,244848
train,2493,82,62976,297,42768,105744
train,2494,168,129024,1244,179136,308160
train,2495,257,197376,2911,419184,616560
train,2496,291,223488,3733,537552,761040
train,2497,103,79104,468,67392,146496
train,2498,270,207360,3213,462672,670032
train,2499,431,331008,8188,1179072,1510080
train,2500,386,296448,6567,945648,1242096
train,2501,127,97536,711,102384,199920
train,2502,285,218880,3580,515520,734400
train,2503,214,164352,2019,290736,455088
train,2504,300,230400,3967,571248,801648
train,2505,252,193536,2799,403056,596592
train,2506,299,229632,3941,567504,797136
train,2507,207,158976,1889,272016,430992
train,2508,244,187392,2624,377856,565248
train,2509,103,79104,468,67392,146496
train,2510,203,155904,1817,261648,417552
train,2511,478,367104,10071,1450224,1817328
train,2512,205,157440,1853,266832,424272
train,2513,151,115968,1005,144720,260688
train,2514,598,459264,14295,2058480,2517744
train,2515,385,295680,6533,940752,1236432
train,2516,367,281856,5937,854928,1136784
train,2517,560,430080,12989,1870416,2300496
train,2518,308,236544,4181,602064,838608
train,2519,100,76800,441,63504,140304
train,2520,105,80640,486,69984,150624
train,2521,328,251904,4742,682848,934752
train,2522,452,347136,9005,1296720,1643856
train,2523,151,115968,1005,144720,260688
train,2524,191,146688,1608,231552,378240
train,2525,429,329472,8112,1168128,1497600
train,2526,106,81408,496,71424,152832
train,2527,436,334848,8379,1206576,1541424
train,2528,140,107520,864,124416,231936
train,2529,182,139776,1460,210240,350016
train,2530,248,190464,2711,390384,580848
train,2531,223,171264,2192,315648,486912
train,2532,312,239616,4291,617904,857520
train,2533,114,87552,573,82512,170064
train,2534,246,188928,2668,384192,573120
train,2535,77,59136,262,37728,96864
train,2536,123,94464,667,96048,190512
train,2537,192,147456,1625,234000,381456
train,2538,302,231936,4020,578880,810816
train,2539,92,70656,373,53712,124368
train,2540,66,50688,192,27648,78336
train,2541,186,142848,1525,219600,362448
train,2542,247,189696,2689,387216,576912
train,2543,348,267264,5338,768672,1035936
train,2544,320,245760,4514,650016,895776
train,2545,200,153600,1763,253872,407472
train,2546,354,271872,5524,795456,1067328
train,2547,295,226560,3836,552384,778944
train,2548,334,256512,4917,708048,964560
train,2549,96,73728,407,58608,132336
train,2550,339,260352,5065,729360,989712
train,2551,382,293376,6432,926208,1219584
train,2552,112,86016,553,79632,165648
train,2553,338,259584,5036,725184,984768
train,2554,173,132864,1320,190080,322944
train,2555,503,386304,11151,1605744,1992048
train,2556,216,165888,2057,296208,462096
train,2557,146,112128,940,135360,247488
train,2558,312,239616,4291,617904,857520
train,2559,127,97536,711,102384,199920
train,2560,156,119808,1073,154512,274320
train,2561,364,279552,5840,840960,1120512
train,2562,252,193536,2799,403056,596592
train,2563,253,194304,2822,406368,600672
train,2564,73,56064,235,33840,89904
train,2565,158,121344,1101,158544,279888
train,2566,85,65280,319,45936,111216
train,2567,307,235776,4154,598176,833952
train,2568,249,191232,2733,393552,584784
train,2569,206,158208,1871,269424,427632
train,2570,406,311808,7265,1046160,1357968
train,2571,439,337152,8494,1223136,1560288
train,2572,208,159744,1907,274608,434352
train,2573,471,361728,9778,1408032,1769760
train,2574,280,215040,3456,497664,712704
train,2575,449,344832,8886,1279584,1624416
train,2576,352,270336,5461,786384,1056720
train,2577,235,180480,2434,350496,530976
train,2578,145,111360,927,133488,244848
train,2579,242,185856,2582,371808,557664
train,2580,210,161280,1944,279936,441216
train,2581,261,200448,3003,432432,632880
train,2582,288,221184,3656,526464,747648
train,2583,344,264192,5216,751104,1015296
train,2584,264,202752,3072,442368,645120
train,2585,306,235008,4127,594288,829296
train,2586,314,241152,4346,625824,866976
train,2587,406,311808,7265,1046160,1357968
train,2588,393,301824,6808,980352,1282176
train,2589,139,106752,852,122688,229440
train,2590,170,130560,1274,183456,314016
train,2591,283,217344,3530,508320,725664
train,2592,390,299520,6704,965376,1264896
train,2593,239,183552,2518,362592,546144
train,2594,497,381696,10887,1567728,1949424
train,2595,395,303360,6877,990288,1293648
train,2596,616,473088,14959,2154096,2627184
train,2597,434,333312,8302,1195488,1528800
train,2598,245,188160,2646,381024,569184
train,2599,368,282624,5969,859536,1142160
train,2600,235,180480,2434,350496,530976
train,2601,252,193536,2799,403056,596592
train,2602,256,196608,2889,416016,612624
train,2603,144,110592,914,131616,242208
train,2604,508,390144,11374,1637856,2028000
train,2605,303,232704,4047,582768,815472
train,2606,339,260352,5065,729360,989712
train,2607,233,178944,2393,344592,523536
train,2608,137,105216,828,119232,224448
train,2609,281,215808,3481,501264,717072
train,2610,200,153600,1763,253872,407472
train,2611,154,118272,1046,150624,268896
train,2612,323,248064,4599,662256,910320
train,2613,202,155136,1799,259056,414192
train,2614,420,322560,7775,1119600,1442160
train,2615,397,304896,6947,1000368,1305264
train,2616,445,341760,8728,1256832,1598592
train,2617,88,67584,342,49248,116832
train,2618,176,135168,1366,196704,331872
train,2619,264,202752,3072,442368,645120
train,2620,487,374016,10453,1505232,1879248
train,2621,298,228864,3914,563616,792480
train,2622,211,162048,1963,282672,444720
train,2623,517,397056,11664,1679616,2076672
train,2624,241,185088,2560,368640,553728
train,2625,365,280320,5872,845568,1125888
train,2626,265,203520,3096,445824,649344
train,2627,237,182016,2476,356544,538560
train,2628,462,354816,9408,1354752,1709568
train,2629,519,398592,11722,1687968,2086560
train,2630,303,232704,4047,582768,815472
train,2631,309,237312,4209,606096,843408
train,2632,387,297216,6601,950544,1247760
train,2633,190,145920,1592,229248,375168
train,2634,211,162048,1963,282672,444720
train,2635,288,221184,3656,526464,747648
train,2636,271,208128,3237,466128,674256
train,2637,345,264960,5246,755424,1020384
train,2638,538,413184,12291,1769904,2183088
train,2639,113,86784,563,81072,167856
train,2640,247,189696,2689,387216,576912
train,2641,407,312576,7301,1051344,1363920
train,2642,78,59904,269,38736,98640
train,2643,304,233472,4074,586656,820128
train,2644,381,292608,6398,921312,1213920
train,2645,406,311808,7265,1046160,1357968
train,2646,114,87552,573,82512,170064
train,2647,199,152832,1746,251424,404256
train,2648,202,155136,1799,259056,414192
train,2649,375,288000,6198,892512,1180512
train,2650,256,196608,2889,416016,612624
train,2651,272,208896,3261,469584,678480
train,2652,232,178176,2373,341712,519888
train,2653,168,129024,1244,179136,308160
train,2654,326,250368,4684,674496,924864
train,2655,307,235776,4154,598176,833952
train,2656,421,323328,7812,1124928,1448256
train,2657,177,135936,1381,198864,334800
train,2658,184,141312,1493,214992,356304
train,2659,72,55296,229,32976,88272
train,2660,185,142080,1509,217296,359376
train,2661,279,214272,3431,494064,708336
train,2662,221,169728,2153,310032,479760
train,2663,314,241152,4346,625824,866976
train,2664,444,340992,8689,1251216,1592208
train,2665,167,128256,1230,177120,305376
train,2666,152,116736,1019,146736,263472
train,2667,347,266496,5307,764208,1030704
train,2668,271,208128,3237,466128,674256
train,2669,231,177408,2352,338688,516096
train,2670,366,281088,5904,850176,1131264
train,2671,371,284928,6067,873648,1158576
train,2672,202,155136,1799,259056,414192
train,2673,168,129024,1244,179136,308160
train,2674,317,243456,4429,637776,881232
train,2675,145,111360,927,133488,244848
train,2676,364,279552,5840,840960,1120512
train,2677,146,112128,940,135360,247488
train,2678,277,212736,3382,487008,699744
train,2679,225,172800,2232,321408,494208
train,2680,214,164352,2019,290736,455088
train,2681,220,168960,2134,307296,476256
train,2682,291,223488,3733,537552,761040
train,2683,367,281856,5937,854928,1136784
train,2684,353,271104,5492,790848,1061952
validation,0,148,113664,966,139104,252768
validation,1,128,98304,723,104112,202416
validation,2,134,102912,792,114048,216960
validation,3,225,172800,2232,321408,494208
validation,4,291,223488,3733,537552,761040
validation,5,464,356352,9489,1366416,1722768
validation,6,618,474624,15034,2164896,2639520
validation,7,490,376320,10583,1523952,1900272
validation,8,276,211968,3358,483552,695520
validation,9,337,258816,5006,720864,979680
validation,10,295,226560,3836,552384,778944
validation,11,277,212736,3382,487008,699744
validation,12,111,85248,543,78192,163440
validation,13,243,186624,2603,374832,561456
validation,14,352,270336,5461,786384,1056720
validation,15,444,340992,8689,1251216,1592208
validation,16,323,248064,4599,662256,910320
validation,17,274,210432,3309,476496,686928
validation,18,481,369408,10197,1468368,1837776
validation,19,283,217344,3530,508320,725664
validation,20,184,141312,1493,214992,356304
validation,21,343,263424,5186,746784,1010208
validation,22,504,387072,11196,1612224,1999296
validation,23,249,191232,2733,393552,584784
validation,24,199,152832,1746,251424,404256
validation,25,364,279552,5840,840960,1120512
validation,26,208,159744,1907,274608,434352
validation,27,68,52224,204,29376,81600
validation,28,188,144384,1558,224352,368736
validation,29,197,151296,1711,246384,397680
validation,30,365,280320,5872,845568,1125888
validation,31,411,315648,7445,1072080,1387728
validation,32,315,241920,4374,629856,871776
validation,33,410,314880,7409,1066896,1381776
validation,34,463,355584,9448,1360512,1716096
validation,35,80,61440,283,40752,102192
validation,36,167,128256,1230,177120,305376
validation,37,208,159744,1907,274608,434352
validation,38,234,179712,2414,347616,527328
validation,39,352,270336,5461,786384,1056720
validation,40,380,291840,6365,916560,1208400
validation,41,315,241920,4374,629856,871776
validation,42,467,358656,9612,1384128,1742784
validation,43,123,94464,667,96048,190512
validation,44,202,155136,1799,259056,414192
validation,45,439,337152,8494,1223136,1560288
validation,46,379,291072,6331,911664,1202736
validation,47,193,148224,1642,236448,384672
validation,48,430,330240,8150,1173600,1503840
validation,49,202,155136,1799,259056,414192
validation,50,256,196608,2889,416016,612624
validation,51,257,197376,2911,419184,616560
validation,52,247,189696,2689,387216,576912
validation,53,152,116736,1019,146736,263472
validation,54,393,301824,6808,980352,1282176
validation,55,337,258816,5006,720864,979680
validation,56,427,327936,8036,1157184,1485120
validation,57,217,166656,2076,298944,465600
validation,58,148,113664,966,139104,252768
validation,59,202,155136,1799,259056,414192
validation,60,369,283392,6002,864288,1147680
validation,61,410,314880,7409,1066896,1381776
validation,62,443,340224,8650,1245600,1585824
validation,63,341,261888,5125,738000,999888
validation,64,640,491520,15887,2287728,2779248
validation,65,478,367104,10071,1450224,1817328
validation,66,176,135168,1366,196704,331872
validation,67,200,153600,1763,253872,407472
validation,68,353,271104,5492,790848,1061952
validation,69,192,147456,1625,234000,381456
validation,70,272,208896,3261,469584,678480
validation,71,103,79104,468,67392,146496
validation,72,432,331776,8226,1184544,1516320
validation,73,226,173568,2252,324288,497856
validation,74,209,160512,1926,277344,437856
validation,75,377,289536,6265,902160,1191696
validation,76,167,128256,1230,177120,305376
validation,77,218,167424,2095,301680,469104
validation,78,502,385536,11107,1599408,1984944
validation,79,189,145152,1575,226800,371952
validation,80,46,35328,94,13536,48864
validation,81,437,335616,8417,1212048,1547664
validation,82,361,277248,5744,827136,1104384
validation,83,273,209664,3285,473040,682704
validation,84,257,197376,2911,419184,616560
validation,85,279,214272,3431,494064,708336
validation,86,362,278016,5776,831744,1109760
validation,87,211,162048,1963,282672,444720
validation,88,373,286464,6132,883008,1169472
validation,89,218,167424,2095,301680,469104
validation,90,91,69888,365,52560,122448
validation,91,301,231168,3994,575136,806304
validation,92,161,123648,1143,164592,288240
validation,93,276,211968,3358,483552,695520
validation,94,263,201984,3049,439056,641040
validation,95,234,179712,2414,347616,527328
validation,96,100,76800,441,63504,140304
validation,97,130,99840,745,107280,207120
validation,98,118,90624,614,88416,179040
validation,99,456,350208,9165,1319760,1669968
validation,100,296,227328,3862,556128,783456
validation,101,226,173568,2252,324288,497856
validation,102,342,262656,5155,742320,1004976
validation,103,69,52992,210,30240,83232
validation,104,284,218112,3555,511920,730032
validation,105,473,363264,9861,1419984,1783248
validation,106,319,244992,4485,645840,890832
validation,107,126,96768,700,100800,197568
validation,108,377,289536,6265,902160,1191696
validation,109,293,225024,3784,544896,769920
validation,110,288,221184,3656,526464,747648
validation,111,246,188928,2668,384192,573120
validation,112,181,139008,1444,207936,346944
validation,113,83,63744,304,43776,107520
validation,114,513,393984,11549,1663056,2057040
validation,115,180,138240,1428,205632,343872
validation,116,391,300288,6738,970272,1270560
validation,117,188,144384,1558,224352,368736
validation,118,270,207360,3213,462672,670032
validation,119,292,224256,3758,541152,765408
validation,120,292,224256,3758,541152,765408
validation,121,265,203520,3096,445824,649344
validation,122,355,272640,5555,799920,1072560
validation,123,94,72192,390,56160,128352
validation,124,319,244992,4485,645840,890832
validation,125,383,294144,6466,931104,1225248
validation,126,198,152064,1728,248832,400896
validation,127,397,304896,6947,1000368,1305264
validation,128,486,373248,10410,1499040,1872288
validation,129,307,235776,4154,598176,833952
validation,130,280,215040,3456,497664,712704
validation,131,301,231168,3994,575136,806304
validation,132,347,266496,5307,764208,1030704
validation,133,302,231936,4020,578880,810816
validation,134,276,211968,3358,483552,695520
validation,135,362,278016,5776,831744,1109760
validation,136,114,87552,573,82512,170064
validation,137,311,238848,4263,613872,852720
validation,138,132,101376,768,110592,211968
validation,139,255,195840,2866,412704,608544
validation,140,251,192768,2777,399888,592656
validation,141,400,307200,7052,1015488,1322688
validation,142,221,169728,2153,310032,479760
validation,143,366,281088,5904,850176,1131264
validation,144,137,105216,828,119232,224448
validation,145,247,189696,2689,387216,576912
validation,146,430,330240,8150,1173600,1503840
validation,147,414,317952,7555,1087920,1405872
validation,148,188,144384,1558,224352,368736
validation,149,209,160512,1926,277344,437856
validation,150,241,185088,2560,368640,553728
validation,151,230,176640,2332,335808,512448
validation,152,245,188160,2646,381024,569184
validation,153,453,347904,9045,1302480,1650384
validation,154,110,84480,534,76896,161376
validation,155,251,192768,2777,399888,592656
validation,156,320,245760,4514,650016,895776
validation,157,281,215808,3481,501264,717072
validation,158,339,260352,5065,729360,989712
validation,159,236,181248,2455,353520,534768
validation,160,170,130560,1274,183456,314016
validation,161,173,132864,1320,190080,322944
validation,162,246,188928,2668,384192,573120
validation,163,183,140544,1476,212544,353088
validation,164,408,313344,7337,1056528,1369872
validation,165,575,441600,13489,1942416,2384016
validation,166,189,145152,1575,226800,371952
validation,167,238,182784,2497,359568,542352
validation,168,401,307968,7088,1020672,1328640
validation,169,130,99840,745,107280,207120
validation,170,334,256512,4917,708048,964560
validation,171,109,83712,524,75456,159168
validation,172,299,229632,3941,567504,797136
validation,173,321,246528,4542,654048,900576
validation,174,388,297984,6635,955440,1253424
validation,175,429,329472,8112,1168128,1497600
validation,176,305,234240,4100,590400,824640
validation,177,66,50688,192,27648,78336
validation,178,66,50688,192,27648,78336
validation,179,376,288768,6231,897264,1186032
validation,180,482,370176,10240,1474560,1844736
validation,181,233,178944,2393,344592,523536
validation,182,371,284928,6067,873648,1158576
validation,183,432,331776,8226,1184544,1516320
validation,184,175,134400,1350,194400,328800
validation,185,251,192768,2777,399888,592656
validation,186,354,271872,5524,795456,1067328
validation,187,441,338688,8572,1234368,1573056
validation,188,196,150528,1694,243936,394464
validation,189,334,256512,4917,708048,964560
validation,190,223,171264,2192,315648,486912
validation,191,287,220416,3631,522864,743280
validation,192,281,215808,3481,501264,717072
validation,193,370,284160,6034,868896,1153056
validation,194,208,159744,1907,274608,434352
validation,195,436,334848,8379,1206576,1541424
validation,196,290,222720,3707,533808,756528
validation,197,227,174336,2272,327168,501504
validation,198,257,197376,2911,419184,616560
validation,199,394,302592,6842,985248,1287840
validation,200,167,128256,1230,177120,305376
validation,201,475,364800,9945,1432080,1796880
validation,202,109,83712,524,75456,159168
validation,203,98,75264,424,61056,136320
validation,204,441,338688,8572,1234368,1573056
validation,205,261,200448,3003,432432,632880
validation,206,483,370944,10282,1480608,1851552
validation,207,357,274176,5618,808992,1083168
validation,208,262,201216,3026,435744,636960
validation,209,189,145152,1575,226800,371952
validation,210,248,190464,2711,390384,580848
validation,211,290,222720,3707,533808,756528
validation,212,317,243456,4429,637776,881232
validation,213,264,202752,3072,442368,645120
validation,214,280,215040,3456,497664,712704
validation,215,153,117504,1032,148608,266112
validation,216,287,220416,3631,522864,743280
validation,217,476,365568,9986,1437984,1803552
validation,218,315,241920,4374,629856,871776
validation,219,391,300288,6739,970416,1270704
validation,220,221,169728,2153,310032,479760
validation,221,315,241920,4374,629856,871776
validation,222,328,251904,4742,682848,934752
validation,223,225,172800,2232,321408,494208
validation,224,490,376320,10583,1523952,1900272
validation,225,141,108288,877,126288,234576
validation,226,72,55296,229,32976,88272
validation,227,241,185088,2560,368640,553728
validation,228,225,172800,2232,321408,494208
validation,229,428,328704,8074,1162656,1491360
validation,230,292,224256,3758,541152,765408
validation,231,204,156672,1835,264240,420912
validation,232,151,115968,1005,144720,260688
validation,233,244,187392,2624,377856,565248
validation,234,99,76032,432,62208,138240
validation,235,385,295680,6533,940752,1236432
validation,236,213,163584,2000,288000,451584
validation,237,374,287232,6165,887760,1174992
validation,238,241,185088,2560,368640,553728
validation,239,382,293376,6432,926208,1219584
validation,240,307,235776,4154,598176,833952
validation,241,276,211968,3358,483552,695520
validation,242,101,77568,450,64800,142368
validation,243,191,146688,1608,231552,378240
validation,244,413,317184,7518,1082592,1399776
validation,245,90,69120,357,51408,120528
validation,246,177,135936,1381,198864,334800
validation,247,222,170496,2173,312912,483408
validation,248,384,294912,6499,935856,1230768
validation,249,217,166656,2076,298944,465600
validation,250,417,320256,7664,1103616,1423872
validation,251,218,167424,2095,301680,469104
validation,252,232,178176,2373,341712,519888
validation,253,390,299520,6704,965376,1264896
validation,254,295,226560,3836,552384,778944
validation,255,428,328704,8074,1162656,1491360
validation,256,428,328704,8074,1162656,1491360
validation,257,351,269568,5430,781920,1051488
validation,258,451,346368,8965,1290960,1637328
validation,259,105,80640,486,69984,150624
validation,260,249,191232,2733,393552,584784
validation,261,353,271104,5492,790848,1061952
validation,262,351,269568,5430,781920,1051488
validation,263,325,249600,4656,670464,920064
validation,264,281,215808,3481,501264,717072
validation,265,144,110592,914,131616,242208
validation,266,431,331008,8188,1179072,1510080
validation,267,381,292608,6398,921312,1213920
validation,268,107,82176,505,72720,154896
validation,269,301,231168,3994,575136,806304
validation,270,364,279552,5840,840960,1120512
validation,271,196,150528,1694,243936,394464
validation,272,100,76800,441,63504,140304
validation,273,287,220416,3631,522864,743280
validation,274,99,76032,432,62208,138240
validation,275,194,148992,1659,238896,387888
validation,276,122,93696,656,94464,188160
validation,277,81,62208,290,41760,103968
validation,278,316,242688,4401,633744,876432
validation,279,245,188160,2646,381024,569184
validation,280,130,99840,745,107280,207120
validation,281,81,62208,290,41760,103968
validation,282,289,221952,3682,530208,752160
validation,283,293,225024,3784,544896,769920
validation,284,386,296448,6567,945648,1242096
validation,285,285,218880,3580,515520,734400
validation,286,296,227328,3862,556128,783456
validation,287,103,79104,468,67392,146496
validation,288,193,148224,1642,236448,384672
validation,289,239,183552,2518,362592,546144
validation,290,199,152832,1746,251424,404256
validation,291,188,144384,1558,224352,368736
validation,292,62,47616,170,24480,72096
validation,293,354,271872,5524,795456,1067328
validation,294,290,222720,3707,533808,756528
validation,295,499,383232,10975,1580400,1963632
validation,296,469,360192,9695,1396080,1756272
validation,297,379,291072,6331,911664,1202736
validation,298,295,226560,3836,552384,778944
validation,299,311,238848,4263,613872,852720
validation,300,386,296448,6567,945648,1242096
validation,301,341,261888,5125,738000,999888
validation,302,440,337920,8533,1228752,1566672
validation,303,418,321024,7701,1108944,1429968
validation,304,192,147456,1625,234000,381456
validation,305,216,165888,2057,296208,462096
validation,306,214,164352,2019,290736,455088
validation,307,250,192000,2755,396720,588720
validation,308,215,165120,2038,293472,458592
validation,309,90,69120,357,51408,120528
validation,310,436,334848,8379,1206576,1541424
validation,311,198,152064,1728,248832,400896
validation,312,215,165120,2038,293472,458592
validation,313,336,258048,4976,716544,974592
validation,314,368,282624,5969,859536,1142160
validation,315,219,168192,2114,304416,472608
validation,316,137,105216,828,119232,224448
validation,317,155,119040,1059,152496,271536
validation,318,260,199680,2980,429120,628800
validation,319,575,441600,13489,1942416,2384016
validation,320,168,129024,1244,179136,308160
validation,321,117,89856,604,86976,176832
validation,322,370,284160,6034,868896,1153056
validation,323,281,215808,3481,501264,717072
validation,324,185,142080,1509,217296,359376
validation,325,698,536064,18341,2641104,3177168
validation,326,134,102912,792,114048,216960
validation,327,308,236544,4181,602064,838608
validation,328,392,301056,6773,975312,1276368
validation,329,409,314112,7373,1061712,1375824
validation,330,222,170496,2173,312912,483408
validation,331,371,284928,6067,873648,1158576
validation,332,607,466176,14623,2105712,2571888
validation,333,226,173568,2252,324288,497856
validation,334,345,264960,5246,755424,1020384
validation,335,113,86784,563,81072,167856
validation,336,408,313344,7337,1056528,1369872
validation,337,197,151296,1711,246384,397680
validation,338,386,296448,6567,945648,1242096
validation,339,311,238848,4263,613872,852720
validation,340,375,288000,6198,892512,1180512
validation,341,240,184320,2539,365616,549936
validation,342,200,153600,1763,253872,407472
validation,343,217,166656,2076,298944,465600
validation,344,338,259584,5036,725184,984768
validation,345,346,265728,5277,759888,1025616
validation,346,438,336384,8456,1217664,1554048
validation,347,241,185088,2560,368640,553728
validation,348,215,165120,2038,293472,458592
validation,349,418,321024,7701,1108944,1429968
validation,350,98,75264,424,61056,136320
validation,351,224,172032,2212,318528,490560
validation,352,302,231936,4020,578880,810816
validation,353,391,300288,6738,970272,1270560
validation,354,263,201984,3049,439056,641040
validation,355,400,307200,7052,1015488,1322688
validation,356,132,101376,768,110592,211968
validation,357,158,121344,1101,158544,279888
validation,358,307,235776,4154,598176,833952
validation,359,241,185088,2560,368640,553728
validation,360,206,158208,1871,269424,427632
validation,361,427,327936,8036,1157184,1485120
validation,362,315,241920,4374,629856,871776
validation,363,225,172800,2232,321408,494208
validation,364,251,192768,2777,399888,592656
validation,365,367,281856,5937,854928,1136784
validation,366,258,198144,2934,422496,620640
validation,367,171,131328,1289,185616,316944
validation,368,365,280320,5872,845568,1125888
validation,369,281,215808,3481,501264,717072
validation,370,241,185088,2560,368640,553728
validation,371,70,53760,216,31104,84864
validation,372,261,200448,3003,432432,632880
validation,373,404,310272,7194,1035936,1346208
validation,374,442,339456,8611,1239984,1579440
validation,375,229,175872,2312,332928,508800
validation,376,333,255744,4888,703872,959616
validation,377,228,175104,2292,330048,505152
validation,378,368,282624,5969,859536,1142160
validation,379,257,197376,2911,419184,616560
validation,380,663,509184,16825,2422800,2931984
validation,381,460,353280,9326,1342944,1696224
validation,382,402,308736,7123,1025712,1334448
validation,383,576,442368,13523,1947312,2389680
validation,384,407,312576,7301,1051344,1363920
validation,385,296,227328,3862,556128,783456
validation,386,211,162048,1963,282672,444720
validation,387,278,213504,3407,490608,704112
validation,388,260,199680,2980,429120,628800
validation,389,127,97536,711,102384,199920
validation,390,281,215808,3481,501264,717072
validation,391,217,166656,2076,298944,465600
validation,392,440,337920,8533,1228752,1566672
validation,393,299,229632,3941,567504,797136
validation,394,599,460032,14331,2063664,2523696
validation,395,427,327936,8036,1157184,1485120
validation,396,157,120576,1087,156528,277104
validation,397,276,211968,3358,483552,695520
validation,398,220,168960,2134,307296,476256
validation,399,333,255744,4888,703872,959616
validation,400,469,360192,9695,1396080,1756272
validation,401,175,134400,1350,194400,328800
validation,402,333,255744,4888,703872,959616
validation,403,85,65280,319,45936,111216
validation,404,231,177408,2352,338688,516096
validation,405,390,299520,6704,965376,1264896
validation,406,247,189696,2689,387216,576912
validation,407,156,119808,1073,154512,274320
validation,408,168,129024,1244,179136,308160
validation,409,368,282624,5969,859536,1142160
validation,410,192,147456,1625,234000,381456
validation,411,585,449280,13834,1992096,2441376
validation,412,327,251136,4713,678672,929808
validation,413,283,217344,3530,508320,725664
validation,414,244,187392,2624,377856,565248
validation,415,205,157440,1853,266832,424272
validation,416,268,205824,3166,455904,661728
validation,417,193,148224,1642,236448,384672
validation,418,146,112128,940,135360,247488
validation,419,401,307968,7088,1020672,1328640
validation,420,450,345600,8925,1285200,1630800
validation,421,89,68352,350,50400,118752
validation,422,434,333312,8302,1195488,1528800
validation,423,311,238848,4263,613872,852720
validation,424,194,148992,1659,238896,387888
validation,425,107,82176,505,72720,154896
validation,426,301,231168,3994,575136,806304
validation,427,222,170496,2173,312912,483408
validation,428,423,324864,7887,1135728,1460592
validation,429,121,92928,646,93024,185952
validation,430,164,125952,1186,170784,296736
validation,431,312,239616,4291,617904,857520
validation,432,295,226560,3836,552384,778944
validation,433,191,146688,1608,231552,378240
validation,434,352,270336,5461,786384,1056720
validation,435,415,318720,7591,1093104,1411824
validation,436,507,389376,11330,1631520,2020896
validation,437,116,89088,594,85536,174624
validation,438,221,169728,2153,310032,479760
validation,439,157,120576,1087,156528,277104
validation,440,187,143616,1542,222048,365664
validation,441,69,52992,210,30240,83232
validation,442,372,285696,6100,878400,1164096
validation,443,379,291072,6331,911664,1202736
validation,444,160,122880,1129,162576,285456
validation,445,225,172800,2232,321408,494208
validation,446,330,253440,4800,691200,944640
validation,447,101,77568,450,64800,142368
validation,448,381,292608,6398,921312,1213920
validation,449,398,305664,6982,1005408,1311072
validation,450,209,160512,1926,277344,437856
validation,451,236,181248,2455,353520,534768
validation,452,196,150528,1694,243936,394464
validation,453,217,166656,2076,298944,465600
validation,454,253,194304,2822,406368,600672
validation,455,279,214272,3431,494064,708336
validation,456,126,96768,700,100800,197568
validation,457,351,269568,5430,781920,1051488
validation,458,183,140544,1476,212544,353088
validation,459,213,163584,2000,288000,451584
validation,460,203,155904,1817,261648,417552
validation,461,106,81408,496,71424,152832
validation,462,279,214272,3431,494064,708336
validation,463,214,164352,2019,290736,455088
validation,464,324,248832,4627,666288,915120
validation,465,383,294144,6466,931104,1225248
validation,466,313,240384,4318,621792,862176
validation,467,334,256512,4917,708048,964560
validation,468,132,101376,768,110592,211968
validation,469,419,321792,7738,1114272,1436064
validation,470,166,127488,1215,174960,302448
validation,471,191,146688,1608,231552,378240
validation,472,440,337920,8533,1228752,1566672
validation,473,295,226560,3836,552384,778944
validation,474,276,211968,3358,483552,695520
validation,475,374,287232,6165,887760,1174992
validation,476,440,337920,8533,1228752,1566672
validation,477,125,96000,689,99216,195216
validation,478,269,206592,3190,459360,665952
validation,479,392,301056,6773,975312,1276368
validation,480,362,278016,5776,831744,1109760
validation,481,367,281856,5937,854928,1136784
validation,482,393,301824,6808,980352,1282176
validation,483,209,160512,1926,277344,437856
validation,484,112,86016,553,79632,165648
validation,485,221,169728,2153,310032,479760
validation,486,208,159744,1907,274608,434352
validation,487,426,327168,7999,1151856,1479024
validation,488,418,321024,7701,1108944,1429968
validation,489,182,139776,1460,210240,350016
validation,490,164,125952,1186,170784,296736
validation,491,462,354816,9408,1354752,1709568
validation,492,408,313344,7337,1056528,1369872
validation,493,381,292608,6398,921312,1213920
validation,494,282,216576,3505,504720,721296
validation,495,273,209664,3285,473040,682704
validation,496,296,227328,3862,556128,783456
validation,497,390,299520,6704,965376,1264896
validation,498,227,174336,2272,327168,501504
validation,499,398,305664,6982,1005408,1311072
validation,500,307,235776,4154,598176,833952
validation,501,557,427776,12891,1856304,2284080
validation,502,265,203520,3096,445824,649344
validation,503,438,336384,8456,1217664,1554048
validation,504,324,248832,4627,666288,915120
validation,505,174,133632,1335,192240,325872
validation,506,268,205824,3166,455904,661728
validation,507,297,228096,3888,559872,787968
validation,508,252,193536,2799,403056,596592
validation,509,341,261888,5125,738000,999888
validation,510,424,325632,7924,1141056,1466688
validation,511,164,125952,1186,170784,296736
validation,512,189,145152,1575,226800,371952
validation,513,304,233472,4074,586656,820128
validation,514,233,178944,2393,344592,523536
validation,515,460,353280,9326,1342944,1696224
validation,516,315,241920,4374,629856,871776
validation,517,277,212736,3382,487008,699744
validation,518,305,234240,4100,590400,824640
validation,519,103,79104,468,67392,146496
validation,520,252,193536,2799,403056,596592
validation,521,293,225024,3784,544896,769920
validation,522,121,92928,646,93024,185952
validation,523,414,317952,7555,1087920,1405872
validation,524,218,167424,2095,301680,469104
validation,525,289,221952,3682,530208,752160
validation,526,182,139776,1460,210240,350016
validation,527,470,360960,9736,1401984,1762944
validation,528,141,108288,877,126288,234576
validation,529,171,131328,1289,185616,316944
validation,530,219,168192,2114,304416,472608
validation,531,243,186624,2603,374832,561456
validation,532,384,294912,6499,935856,1230768
validation,533,459,352512,9286,1337184,1689696
validation,534,336,258048,4976,716544,974592
validation,535,232,178176,2373,341712,519888
validation,536,274,210432,3309,476496,686928
validation,537,431,331008,8188,1179072,1510080
validation,538,379,291072,6331,911664,1202736
validation,539,427,327936,8036,1157184,1485120
validation,540,324,248832,4627,666288,915120
validation,541,215,165120,2038,293472,458592
validation,542,358,274944,5649,813456,1088400
validation,543,225,172800,2232,321408,494208
validation,544,227,174336,2272,327168,501504
validation,545,344,264192,5216,751104,1015296
validation,546,231,177408,2352,338688,516096
validation,547,322,247296,4570,658080,905376
validation,548,272,208896,3261,469584,678480
validation,549,813,624384,22185,3194640,3819024
validation,550,272,208896,3261,469584,678480
validation,551,433,332544,8264,1190016,1522560
validation,552,138,105984,840,120960,226944
validation,553,459,352512,9286,1337184,1689696
validation,554,238,182784,2497,359568,542352
validation,555,212,162816,1981,285264,448080
validation,556,99,76032,432,62208,138240
validation,557,219,168192,2114,304416,472608
validation,558,138,105984,840,120960,226944
validation,559,324,248832,4627,666288,915120
validation,560,396,304128,6912,995328,1299456
validation,561,236,181248,2455,353520,534768
validation,562,106,81408,496,71424,152832
validation,563,348,267264,5338,768672,1035936
validation,564,509,390912,11419,1644336,2035248
validation,565,317,243456,4429,637776,881232
validation,566,382,293376,6432,926208,1219584
validation,567,679,521472,17505,2520720,3042192
validation,568,306,235008,4127,594288,829296
validation,569,301,231168,3994,575136,806304
validation,570,568,436224,13254,1908576,2344800
validation,571,152,116736,1019,146736,263472
validation,572,565,433920,13154,1894176,2328096
validation,573,285,218880,3580,515520,734400
validation,574,397,304896,6947,1000368,1305264
validation,575,53,40704,124,17856,58560
validation,576,219,168192,2114,304416,472608
validation,577,336,258048,4976,716544,974592
validation,578,281,215808,3481,501264,717072
validation,579,153,117504,1032,148608,266112
validation,580,168,129024,1244,179136,308160
validation,581,457,350976,9205,1325520,1676496
validation,582,382,293376,6432,926208,1219584
validation,583,136,104448,816,117504,221952
validation,584,239,183552,2518,362592,546144
validation,585,307,235776,4154,598176,833952
validation,586,306,235008,4127,594288,829296
validation,587,282,216576,3505,504720,721296
validation,588,224,172032,2212,318528,490560
validation,589,202,155136,1799,259056,414192
validation,590,293,225024,3784,544896,769920
validation,591,263,201984,3049,439056,641040
validation,592,149,114432,979,140976,255408
validation,593,278,213504,3407,490608,704112
validation,594,391,300288,6738,970272,1270560
validation,595,211,162048,1963,282672,444720
validation,596,375,288000,6198,892512,1180512
validation,597,266,204288,3119,449136,653424
validation,598,80,61440,283,40752,102192
validation,599,93,71424,382,55008,126432
validation,600,109,83712,524,75456,159168
validation,601,219,168192,2114,304416,472608
validation,602,105,80640,486,69984,150624
validation,603,416,319488,7628,1098432,1417920
validation,604,357,274176,5618,808992,1083168
validation,605,158,121344,1101,158544,279888
validation,606,342,262656,5155,742320,1004976
validation,607,334,256512,4917,708048,964560
validation,608,244,187392,2624,377856,565248
validation,609,253,194304,2822,406368,600672
validation,610,424,325632,7924,1141056,1466688
validation,611,451,346368,8965,1290960,1637328
validation,612,339,260352,5065,729360,989712
validation,613,138,105984,840,120960,226944
validation,614,333,255744,4888,703872,959616
validation,615,218,167424,2095,301680,469104
validation,616,290,222720,3707,533808,756528
validation,617,122,93696,656,94464,188160
validation,618,224,172032,2212,318528,490560
validation,619,179,137472,1413,203472,340944
validation,620,368,282624,5969,859536,1142160
validation,621,321,246528,4542,654048,900576
validation,622,219,168192,2114,304416,472608
validation,623,83,63744,304,43776,107520
validation,624,283,217344,3530,508320,725664
validation,625,449,344832,8886,1279584,1624416
validation,626,102,78336,459,66096,144432
validation,627,372,285696,6100,878400,1164096
validation,628,206,158208,1871,269424,427632
validation,629,414,317952,7555,1087920,1405872
validation,630,230,176640,2332,335808,512448
validation,631,220,168960,2134,307296,476256
validation,632,263,201984,3049,439056,641040
validation,633,492,377856,10669,1536336,1914192
validation,634,356,273408,5586,804384,1077792
validation,635,242,185856,2582,371808,557664
validation,636,78,59904,269,38736,98640
validation,637,585,449280,13834,1992096,2441376
validation,638,353,271104,5492,790848,1061952
validation,639,604,463872,14513,2089872,2553744
validation,640,105,80640,486,69984,150624
validation,641,495,380160,10800,1555200,1935360
validation,642,383,294144,6466,931104,1225248
validation,643,156,119808,1073,154512,274320
validation,644,250,192000,2755,396720,588720
validation,645,135,103680,804,115776,219456
validation,646,310,238080,4236,609984,848064
validation,647,310,238080,4236,609984,848064
validation,648,237,182016,2476,356544,538560
validation,649,487,374016,10453,1505232,1879248
validation,650,351,269568,5430,781920,1051488
validation,651,383,294144,6466,931104,1225248
validation,652,95,72960,398,57312,130272
validation,653,323,248064,4599,662256,910320
validation,654,311,238848,4263,613872,852720
validation,655,404,310272,7194,1035936,1346208
validation,656,261,200448,3003,432432,632880
validation,657,357,274176,5618,808992,1083168
validation,658,274,210432,3309,476496,686928
validation,659,367,281856,5937,854928,1136784
validation,660,431,331008,8188,1179072,1510080
validation,661,289,221952,3682,530208,752160
validation,662,343,263424,5186,746784,1010208
validation,663,175,134400,1350,194400,328800
validation,664,171,131328,1289,185616,316944
validation,665,126,96768,700,100800,197568
validation,666,203,155904,1817,261648,417552
validation,667,394,302592,6842,985248,1287840
validation,668,183,140544,1476,212544,353088
validation,669,359,275712,5681,818064,1093776
validation,670,238,182784,2497,359568,542352
validation,671,313,240384,4318,621792,862176
test,0,210,161280,1944,279936,441216
test,1,278,213504,3407,490608,704112
test,2,204,156672,1835,264240,420912
test,3,229,175872,2312,332928,508800
test,4,241,185088,2560,368640,553728
test,5,477,366336,10029,1444176,1810512
test,6,471,361728,9778,1408032,1769760
test,7,374,287232,6165,887760,1174992
test,8,736,565248,19493,2806992,3372240
test,9,540,414720,12353,1778832,2193552
test,10,276,211968,3358,483552,695520
test,11,346,265728,5277,759888,1025616
test,12,224,172032,2212,318528,490560
test,13,139,106752,852,122688,229440
test,14,107,82176,505,72720,154896
test,15,228,175104,2292,330048,505152
test,16,229,175872,2312,332928,508800
test,17,177,135936,1381,198864,334800
test,18,227,174336,2272,327168,501504
test,19,431,331008,8188,1179072,1510080
test,20,276,211968,3358,483552,695520
test,21,158,121344,1101,158544,279888
test,22,349,268032,5369,773136,1041168
test,23,670,514560,17120,2465280,2979840
test,24,378,290304,6298,906912,1197216
test,25,395,303360,6877,990288,1293648
test,26,425,326400,7961,1146384,1472784
test,27,231,177408,2352,338688,516096
test,28,160,122880,1129,162576,285456
test,29,74,56832,242,34848,91680
test,30,473,363264,9861,1419984,1783248
test,31,104,79872,477,68688,148560
test,32,188,144384,1558,224352,368736
test,33,356,273408,5586,804384,1077792
test,34,176,135168,1366,196704,331872
test,35,282,216576,3505,504720,721296
test,36,137,105216,828,119232,224448
test,37,136,104448,816,117504,221952
test,38,175,134400,1350,194400,328800
test,39,222,170496,2173,312912,483408
test,40,420,322560,7775,1119600,1442160
test,41,133,102144,780,112320,214464
test,42,371,284928,6067,873648,1158576
test,43,188,144384,1558,224352,368736
test,44,105,80640,486,69984,150624
test,45,279,214272,3431,494064,708336
test,46,380,291840,6365,916560,1208400
test,47,348,267264,5338,768672,1035936
test,48,370,284160,6034,868896,1153056
test,49,245,188160,2646,381024,569184
test,50,266,204288,3119,449136,653424
test,51,181,139008,1444,207936,346944
test,52,284,218112,3555,511920,730032
test,53,231,177408,2352,338688,516096
test,54,266,204288,3119,449136,653424
test,55,183,140544,1476,212544,353088
test,56,263,201984,3049,439056,641040
test,57,456,350208,9165,1319760,1669968
test,58,228,175104,2292,330048,505152
test,59,200,153600,1763,253872,407472
test,60,379,291072,6331,911664,1202736
test,61,242,185856,2582,371808,557664
test,62,239,183552,2518,362592,546144
test,63,276,211968,3358,483552,695520
test,64,465,357120,9530,1372320,1729440
test,65,433,332544,8264,1190016,1522560
test,66,218,167424,2095,301680,469104
test,67,129,99072,734,105696,204768
test,68,519,398592,11722,1687968,2086560
test,69,214,164352,2019,290736,455088
test,70,218,167424,2095,301680,469104
test,71,259,198912,2957,425808,624720
test,72,369,283392,6002,864288,1147680
test,73,121,92928,646,93024,185952
test,74,322,247296,4570,658080,905376
test,75,332,254976,4858,699552,954528
test,76,351,269568,5430,781920,1051488
test,77,345,264960,5246,755424,1020384
test,78,355,272640,5555,799920,1072560
test,79,218,167424,2095,301680,469104
test,80,159,122112,1115,160560,282672
test,81,104,79872,477,68688,148560
test,82,373,286464,6132,883008,1169472
test,83,315,241920,4374,629856,871776
test,84,392,301056,6773,975312,1276368
test,85,194,148992,1659,238896,387888
test,86,190,145920,1592,229248,375168
test,87,312,239616,4291,617904,857520
test,88,423,324864,7887,1135728,1460592
test,89,165,126720,1200,172800,299520
test,90,309,237312,4209,606096,843408
test,91,428,328704,8074,1162656,1491360
test,92,457,350976,9205,1325520,1676496
test,93,418,321024,7701,1108944,1429968
test,94,302,231936,4020,578880,810816
test,95,478,367104,10071,1450224,1817328
test,96,143,109824,902,129888,239712
test,97,169,129792,1259,181296,311088
test,98,416,319488,7628,1098432,1417920
test,99,306,235008,4127,594288,829296
test,100,368,282624,5969,859536,1142160
test,101,246,188928,2668,384192,573120
test,102,337,258816,5006,720864,979680
test,103,234,179712,2414,347616,527328
test,104,64,49152,181,26064,75216
test,105,365,280320,5872,845568,1125888
test,106,336,258048,4976,716544,974592
test,107,310,238080,4236,609984,848064
test,108,285,218880,3580,515520,734400
test,109,465,357120,9530,1372320,1729440
test,110,248,190464,2711,390384,580848
test,111,417,320256,7664,1103616,1423872
test,112,397,304896,6947,1000368,1305264
test,113,352,270336,5461,786384,1056720
test,114,420,322560,7775,1119600,1442160
test,115,321,246528,4542,654048,900576
test,116,400,307200,7052,1015488,1322688
test,117,215,165120,2038,293472,458592
test,118,722,554496,19060,2744640,3299136
test,119,220,168960,2134,307296,476256
test,120,231,177408,2352,338688,516096
test,121,327,251136,4713,678672,929808
test,122,355,272640,5555,799920,1072560
test,123,409,314112,7373,1061712,1375824
test,124,169,129792,1259,181296,311088
test,125,376,288768,6231,897264,1186032
test,126,79,60672,276,39744,100416
test,127,280,215040,3456,497664,712704
test,128,251,192768,2777,399888,592656
test,129,372,285696,6100,878400,1164096
test,130,229,175872,2312,332928,508800
test,131,92,70656,373,53712,124368
test,132,153,117504,1032,148608,266112
test,133,140,107520,864,124416,231936
test,134,387,297216,6601,950544,1247760
test,135,235,180480,2434,350496,530976
test,136,370,284160,6034,868896,1153056
test,137,460,353280,9326,1342944,1696224
test,138,271,208128,3237,466128,674256
test,139,243,186624,2603,374832,561456
test,140,392,301056,6773,975312,1276368
test,141,104,79872,477,68688,148560
test,142,144,110592,914,131616,242208
test,143,110,84480,534,76896,161376
test,144,420,322560,7775,1119600,1442160
test,145,236,181248,2455,353520,534768
test,146,262,201216,3026,435744,636960
test,147,164,125952,1186,170784,296736
test,148,233,178944,2393,344592,523536
test,149,332,254976,4858,699552,954528
test,150,91,69888,365,52560,122448
test,151,282,216576,3505,504720,721296
test,152,349,268032,5369,773136,1041168
test,153,387,297216,6601,950544,1247760
test,154,470,360960,9736,1401984,1762944
test,155,427,327936,8036,1157184,1485120
test,156,646,496128,16127,2322288,2818416
test,157,241,185088,2560,368640,553728
test,158,270,207360,3213,462672,670032
test,159,218,167424,2095,301680,469104
test,160,278,213504,3407,490608,704112
test,161,558,428544,12924,1861056,2289600
test,162,400,307200,7052,1015488,1322688
test,163,252,193536,2799,403056,596592
test,164,326,250368,4684,674496,924864
test,165,152,116736,1019,146736,263472
test,166,164,125952,1186,170784,296736
test,167,87,66816,334,48096,114912
test,168,344,264192,5216,751104,1015296
test,169,232,178176,2373,341712,519888
test,170,288,221184,3656,526464,747648
test,171,147,112896,953,137232,250128
test,172,185,142080,1509,217296,359376
test,173,377,289536,6265,902160,1191696
test,174,254,195072,2844,409536,604608
test,175,145,111360,927,133488,244848
test,176,448,344064,8846,1273824,1617888
test,177,328,251904,4742,682848,934752
test,178,186,142848,1525,219600,362448
test,179,152,116736,1019,146736,263472
test,180,403,309504,7158,1030752,1340256
test,181,409,314112,7373,1061712,1375824
test,182,64,49152,181,26064,75216
test,183,206,158208,1871,269424,427632
test,184,279,214272,3431,494064,708336
test,185,248,190464,2711,390384,580848
test,186,274,210432,3309,476496,686928
test,187,130,99840,745,107280,207120
test,188,443,340224,8650,1245600,1585824
test,189,271,208128,3237,466128,674256
test,190,153,117504,1032,148608,266112
test,191,335,257280,4947,712368,969648
test,192,349,268032,5369,773136,1041168
test,193,284,218112,3555,511920,730032
test,194,199,152832,1746,251424,404256
test,195,256,196608,2889,416016,612624
test,196,105,80640,486,69984,150624
test,197,251,192768,2777,399888,592656
test,198,262,201216,3026,435744,636960
test,199,350,268800,5399,777456,1046256
test,200,389,298752,6670,960480,1259232
test,201,378,290304,6298,906912,1197216
test,202,242,185856,2582,371808,557664
test,203,476,365568,9986,1437984,1803552
test,204,209,160512,1926,277344,437856
test,205,338,259584,5036,725184,984768
test,206,255,195840,2866,412704,608544
test,207,107,82176,505,72720,154896
test,208,425,326400,7961,1146384,1472784
test,209,183,140544,1476,212544,353088
test,210,380,291840,6365,916560,1208400
test,211,324,248832,4627,666288,915120
test,212,196,150528,1694,243936,394464
test,213,359,275712,5681,818064,1093776
test,214,274,210432,3309,476496,686928
test,215,264,202752,3072,442368,645120
test,216,236,181248,2455,353520,534768
test,217,519,398592,11722,1687968,2086560
test,218,299,229632,3941,567504,797136
test,219,564,433152,13121,1889424,2322576
test,220,265,203520,3096,445824,649344
test,221,479,367872,10113,1456272,1824144
test,222,106,81408,496,71424,152832
test,223,463,355584,9448,1360512,1716096
test,224,275,211200,3334,480096,691296
test,225,306,235008,4127,594288,829296
test,226,180,138240,1428,205632,343872
test,227,463,355584,9448,1360512,1716096
test,228,270,207360,3213,462672,670032
test,229,167,128256,1230,177120,305376
test,230,220,168960,2134,307296,476256
test,231,362,278016,5776,831744,1109760
test,232,311,238848,4263,613872,852720
test,233,257,197376,2911,419184,616560
test,234,172,132096,1304,187776,319872
test,235,155,119040,1059,152496,271536
test,236,266,204288,3119,449136,653424
test,237,173,132864,1320,190080,322944
test,238,310,238080,4236,609984,848064
test,239,379,291072,6331,911664,1202736
test,240,219,168192,2114,304416,472608
test,241,300,230400,3967,571248,801648
test,242,165,126720,1200,172800,299520
test,243,298,228864,3914,563616,792480
test,244,264,202752,3072,442368,645120
test,245,266,204288,3119,449136,653424
test,246,463,355584,9448,1360512,1716096
test,247,250,192000,2755,396720,588720
test,248,484,371712,10325,1486800,1858512
test,249,171,131328,1289,185616,316944
test,250,266,204288,3119,449136,653424
test,251,150,115200,992,142848,258048
test,252,236,181248,2455,353520,534768
test,253,328,251904,4742,682848,934752
test,254,250,192000,2755,396720,588720
test,255,270,207360,3213,462672,670032
test,256,223,171264,2192,315648,486912
test,257,328,251904,4742,682848,934752
test,258,428,328704,8074,1162656,1491360
test,259,302,231936,4020,578880,810816
test,260,225,172800,2232,321408,494208
test,261,333,255744,4888,703872,959616
test,262,330,253440,4800,691200,944640
test,263,231,177408,2352,338688,516096
test,264,185,142080,1509,217296,359376
test,265,310,238080,4236,609984,848064
test,266,386,296448,6567,945648,1242096
test,267,294,225792,3810,548640,774432
test,268,271,208128,3237,466128,674256
test,269,273,209664,3285,473040,682704
test,270,203,155904,1817,261648,417552
test,271,360,276480,5712,822528,1099008
test,272,505,387840,11240,1618560,2006400
test,273,158,121344,1101,158544,279888
test,274,266,204288,3119,449136,653424
test,275,204,156672,1835,264240,420912
test,276,154,118272,1046,150624,268896
test,277,163,125184,1171,168624,293808
test,278,255,195840,2866,412704,608544
test,279,122,93696,656,94464,188160
test,280,201,154368,1781,256464,410832
test,281,240,184320,2539,365616,549936
test,282,103,79104,468,67392,146496
test,283,201,154368,1781,256464,410832
test,284,410,314880,7409,1066896,1381776
test,285,266,204288,3119,449136,653424
test,286,226,173568,2252,324288,497856
test,287,416,319488,7628,1098432,1417920
test,288,241,185088,2560,368640,553728
test,289,215,165120,2038,293472,458592
test,290,389,298752,6670,960480,1259232
test,291,159,122112,1115,160560,282672
test,292,333,255744,4888,703872,959616
test,293,354,271872,5524,795456,1067328
test,294,407,312576,7301,1051344,1363920
test,295,311,238848,4263,613872,852720
test,296,127,97536,711,102384,199920
test,297,429,329472,8112,1168128,1497600
test,298,462,354816,9408,1354752,1709568
test,299,473,363264,9861,1419984,1783248
test,300,297,228096,3888,559872,787968
test,301,91,69888,365,52560,122448
test,302,236,181248,2455,353520,534768
test,303,420,322560,7775,1119600,1442160
test,304,445,341760,8728,1256832,1598592
test,305,367,281856,5937,854928,1136784
test,306,319,244992,4485,645840,890832
test,307,315,241920,4374,629856,871776
test,308,155,119040,1059,152496,271536
test,309,266,204288,3119,449136,653424
test,310,105,80640,486,69984,150624
test,311,122,93696,656,94464,188160
test,312,204,156672,1835,264240,420912
test,313,106,81408,496,71424,152832
test,314,246,188928,2668,384192,573120
test,315,153,117504,1032,148608,266112
test,316,414,317952,7555,1087920,1405872
test,317,134,102912,792,114048,216960
test,318,322,247296,4570,658080,905376
test,319,66,50688,192,27648,78336
test,320,292,224256,3758,541152,765408
test,321,262,201216,3026,435744,636960
test,322,417,320256,7664,1103616,1423872
test,323,265,203520,3096,445824,649344
test,324,239,183552,2518,362592,546144
test,325,111,85248,543,78192,163440
test,326,320,245760,4514,650016,895776
test,327,277,212736,3382,487008,699744
test,328,139,106752,852,122688,229440
test,329,430,330240,8150,1173600,1503840
test,330,180,138240,1428,205632,343872
test,331,195,149760,1676,241344,391104
test,332,181,139008,1444,207936,346944
test,333,380,291840,6365,916560,1208400
test,334,145,111360,927,133488,244848
test,335,539,413952,12322,1774368,2188320
test,336,110,84480,534,76896,161376
test,337,230,176640,2332,335808,512448
test,338,298,228864,3914,563616,792480
test,339,58,44544,149,21456,66000
test,340,80,61440,283,40752,102192
test,341,194,148992,1659,238896,387888
test,342,211,162048,1963,282672,444720
test,343,306,235008,4127,594288,829296
test,344,308,236544,4181,602064,838608
test,345,237,182016,2476,356544,538560
test,346,291,223488,3733,537552,761040
test,347,424,325632,7924,1141056,1466688
test,348,330,253440,4800,691200,944640
test,349,224,172032,2212,318528,490560
test,350,251,192768,2777,399888,592656
test,351,187,143616,1542,222048,365664
test,352,355,272640,5555,799920,1072560
test,353,366,281088,5904,850176,1131264
test,354,176,135168,1366,196704,331872
test,355,713,547584,18791,2705904,3253488
test,356,341,261888,5125,738000,999888
test,357,163,125184,1171,168624,293808
test,358,264,202752,3072,442368,645120
test,359,429,329472,8112,1168128,1497600
test,360,279,214272,3431,494064,708336
test,361,342,262656,5155,742320,1004976
test,362,89,68352,350,50400,118752
test,363,267,205056,3142,452448,657504
test,364,60,46080,159,22896,68976
test,365,175,134400,1350,194400,328800
test,366,106,81408,496,71424,152832
test,367,280,215040,3456,497664,712704
test,368,434,333312,8302,1195488,1528800
test,369,122,93696,656,94464,188160
test,370,355,272640,5555,799920,1072560
test,371,266,204288,3119,449136,653424
test,372,112,86016,553,79632,165648
test,373,321,246528,4542,654048,900576
test,374,363,278784,5808,836352,1115136
test,375,674,517632,17290,2489760,3007392
test,376,265,203520,3096,445824,649344
test,377,252,193536,2799,403056,596592
test,378,216,165888,2057,296208,462096
test,379,176,135168,1366,196704,331872
test,380,121,92928,646,93024,185952
test,381,370,284160,6034,868896,1153056
test,382,287,220416,3631,522864,743280
test,383,117,89856,604,86976,176832
test,384,158,121344,1101,158544,279888
test,385,228,175104,2292,330048,505152
test,386,208,159744,1907,274608,434352
test,387,366,281088,5904,850176,1131264
test,388,290,222720,3707,533808,756528
test,389,141,108288,877,126288,234576
test,390,225,172800,2232,321408,494208
test,391,100,76800,441,63504,140304
test,392,386,296448,6567,945648,1242096
test,393,394,302592,6842,985248,1287840
test,394,455,349440,9125,1314000,1663440
test,395,307,235776,4154,598176,833952
test,396,419,321792,7738,1114272,1436064
test,397,150,115200,992,142848,258048
test,398,318,244224,4457,641808,886032
test,399,209,160512,1926,277344,437856
test,400,410,314880,7409,1066896,1381776
test,401,153,117504,1032,148608,266112
test,402,313,240384,4318,621792,862176
test,403,406,311808,7265,1046160,1357968
test,404,234,179712,2414,347616,527328
test,405,223,171264,2192,315648,486912
test,406,181,139008,1444,207936,346944
test,407,402,308736,7123,1025712,1334448
test,408,446,342528,8767,1262448,1604976
test,409,435,334080,8340,1200960,1535040
test,410,286,219648,3606,519264,738912
test,411,259,198912,2957,425808,624720
test,412,107,82176,505,72720,154896
test,413,411,315648,7445,1072080,1387728
test,414,225,172800,2232,321408,494208
test,415,404,310272,7194,1035936,1346208
test,416,473,363264,9861,1419984,1783248
test,417,423,324864,7887,1135728,1460592
test,418,451,346368,8965,1290960,1637328
test,419,181,139008,1444,207936,346944
test,420,193,148224,1642,236448,384672
test,421,143,109824,902,129888,239712
test,422,180,138240,1428,205632,343872
test,423,178,136704,1397,201168,337872
test,424,521,400128,11781,1696464,2096592
test,425,159,122112,1115,160560,282672
test,426,344,264192,5216,751104,1015296
test,427,195,149760,1676,241344,391104
test,428,294,225792,3810,548640,774432
test,429,167,128256,1230,177120,305376
test,430,210,161280,1944,279936,441216
test,431,173,132864,1320,190080,322944
test,432,366,281088,5904,850176,1131264
test,433,327,251136,4713,678672,929808
test,434,284,218112,3555,511920,730032
test,435,260,199680,2980,429120,628800
test,436,267,205056,3142,452448,657504
test,437,593,455424,14116,2032704,2488128
test,438,432,331776,8226,1184544,1516320
test,439,357,274176,5618,808992,1083168
test,440,621,476928,15148,2181312,2658240
test,441,298,228864,3914,563616,792480
test,442,265,203520,3096,445824,649344
test,443,269,206592,3190,459360,665952
test,444,98,75264,424,61056,136320
test,445,297,228096,3888,559872,787968
test,446,344,264192,5216,751104,1015296
test,447,244,187392,2624,377856,565248
test,448,374,287232,6165,887760,1174992
test,449,253,194304,2822,406368,600672
test,450,505,387840,11240,1618560,2006400
test,451,434,333312,8302,1195488,1528800
test,452,512,393216,11521,1659024,2052240
test,453,437,335616,8417,1212048,1547664
test,454,259,198912,2957,425808,624720
test,455,279,214272,3431,494064,708336
test,456,460,353280,9326,1342944,1696224
test,457,414,317952,7555,1087920,1405872
test,458,422,324096,7849,1130256,1454352
test,459,227,174336,2272,327168,501504
test,460,393,301824,6808,980352,1282176
test,461,346,265728,5277,759888,1025616
test,462,242,185856,2582,371808,557664
test,463,245,188160,2646,381024,569184
test,464,130,99840,745,107280,207120
test,465,340,261120,5095,733680,994800
test,466,151,115968,1005,144720,260688
test,467,352,270336,5461,786384,1056720
test,468,279,214272,3431,494064,708336
test,469,389,298752,6670,960480,1259232
test,470,344,264192,5216,751104,1015296
test,471,265,203520,3096,445824,649344
test,472,131,100608,757,109008,209616
test,473,388,297984,6635,955440,1253424
test,474,236,181248,2455,353520,534768
test,475,690,529920,17985,2589840,3119760
test,476,151,115968,1005,144720,260688
test,477,414,317952,7555,1087920,1405872
test,478,126,96768,700,100800,197568
test,479,189,145152,1575,226800,371952
test,480,410,314880,7409,1066896,1381776
test,481,421,323328,7812,1124928,1448256
test,482,268,205824,3166,455904,661728
test,483,144,110592,914,131616,242208
test,484,406,311808,7265,1046160,1357968
test,485,148,113664,966,139104,252768
test,486,121,92928,646,93024,185952
test,487,286,219648,3606,519264,738912
test,488,434,333312,8302,1195488,1528800
test,489,515,395520,11607,1671408,2066928
test,490,222,170496,2173,312912,483408
test,491,409,314112,7373,1061712,1375824
test,492,265,203520,3096,445824,649344
test,493,343,263424,5186,746784,1010208
test,494,111,85248,543,78192,163440
test,495,218,167424,2095,301680,469104
test,496,301,231168,3994,575136,806304
test,497,593,455424,14116,2032704,2488128
test,498,299,229632,3941,567504,797136
test,499,429,329472,8112,1168128,1497600
test,500,136,104448,816,117504,221952
test,501,263,201984,3049,439056,641040
test,502,212,162816,1981,285264,448080
test,503,204,156672,1835,264240,420912
test,504,199,152832,1746,251424,404256
test,505,385,295680,6533,940752,1236432
test,506,173,132864,1320,190080,322944
test,507,356,273408,5586,804384,1077792
test,508,409,314112,7373,1061712,1375824
test,509,609,467712,14697,2116368,2584080
test,510,237,182016,2476,356544,538560
test,511,215,165120,2038,293472,458592
test,512,264,202752,3072,442368,645120
test,513,410,314880,7409,1066896,1381776
test,514,131,100608,757,109008,209616
test,515,346,265728,5277,759888,1025616
test,516,207,158976,1889,272016,430992
test,517,189,145152,1575,226800,371952
test,518,446,342528,8767,1262448,1604976
test,519,328,251904,4742,682848,934752
test,520,97,74496,415,59760,134256
test,521,143,109824,902,129888,239712
test,522,120,92160,635,91440,183600
test,523,304,233472,4074,586656,820128
test,524,545,418560,12508,1801152,2219712
test,525,259,198912,2957,425808,624720
test,526,663,509184,16825,2422800,2931984
test,527,256,196608,2889,416016,612624
test,528,80,61440,283,40752,102192
test,529,55,42240,134,19296,61536
test,530,430,330240,8150,1173600,1503840
test,531,191,146688,1608,231552,378240
test,532,139,106752,852,122688,229440
test,533,175,134400,1350,194400,328800
test,534,341,261888,5125,738000,999888
test,535,574,440832,13455,1937520,2378352
test,536,137,105216,828,119232,224448
test,537,138,105984,840,120960,226944
test,538,376,288768,6231,897264,1186032
test,539,297,228096,3888,559872,787968
test,540,304,233472,4074,586656,820128
test,541,201,154368,1781,256464,410832
test,542,236,181248,2455,353520,534768
test,543,312,239616,4291,617904,857520
test,544,115,88320,583,83952,172272
test,545,321,246528,4542,654048,900576
test,546,307,235776,4154,598176,833952
test,547,324,248832,4627,666288,915120
test,548,574,440832,13455,1937520,2378352
test,549,140,107520,864,124416,231936
test,550,225,172800,2232,321408,494208
test,551,380,291840,6365,916560,1208400
test,552,211,162048,1963,282672,444720
test,553,168,129024,1244,179136,308160
test,554,216,165888,2057,296208,462096
test,555,109,83712,524,75456,159168
test,556,224,172032,2212,318528,490560
test,557,481,369408,10197,1468368,1837776
test,558,511,392448,11492,1654848,2047296
test,559,295,226560,3836,552384,778944
test,560,360,276480,5712,822528,1099008
test,561,233,178944,2393,344592,523536
test,562,126,96768,700,100800,197568
test,563,505,387840,11240,1618560,2006400
test,564,246,188928,2668,384192,573120
test,565,341,261888,5125,738000,999888
test,566,657,504576,16576,2386944,2891520
test,567,401,307968,7088,1020672,1328640
test,568,387,297216,6601,950544,1247760
test,569,221,169728,2153,310032,479760
test,570,190,145920,1592,229248,375168
test,571,288,221184,3656,526464,747648
test,572,221,169728,2153,310032,479760
test,573,240,184320,2539,365616,549936
test,574,159,122112,1115,160560,282672
test,575,191,146688,1608,231552,378240
test,576,440,337920,8533,1228752,1566672
test,577,120,92160,635,91440,183600
test,578,387,297216,6601,950544,1247760
test,579,154,118272,1046,150624,268896
test,580,392,301056,6773,975312,1276368
test,581,142,109056,889,128016,237072
test,582,326,250368,4684,674496,924864
test,583,225,172800,2232,321408,494208
test,584,594,456192,14152,2037888,2494080
test,585,414,317952,7555,1087920,1405872
test,586,357,274176,5618,808992,1083168
test,587,169,129792,1259,181296,311088
test,588,73,56064,235,33840,89904
test,589,324,248832,4627,666288,915120
test,590,396,304128,6912,995328,1299456
test,591,252,193536,2799,403056,596592
test,592,347,266496,5307,764208,1030704
test,593,319,244992,4485,645840,890832
test,594,268,205824,3166,455904,661728
test,595,237,182016,2476,356544,538560
test,596,524,402432,11869,1709136,2111568
test,597,298,228864,3914,563616,792480
test,598,104,79872,477,68688,148560
test,599,214,164352,2019,290736,455088
test,600,112,86016,553,79632,165648
test,601,243,186624,2603,374832,561456
test,602,169,129792,1259,181296,311088
test,603,223,171264,2192,315648,486912
test,604,315,241920,4374,629856,871776
test,605,478,367104,10071,1450224,1817328
test,606,512,393216,11521,1659024,2052240
test,607,294,225792,3810,548640,774432
test,608,221,169728,2153,310032,479760
test,609,125,96000,689,99216,195216
test,610,296,227328,3862,556128,783456
test,611,305,234240,4100,590400,824640
test,612,475,364800,9945,1432080,1796880
test,613,425,326400,7961,1146384,1472784
test,614,488,374784,10496,1511424,1886208
test,615,353,271104,5492,790848,1061952
test,616,186,142848,1525,219600,362448
test,617,145,111360,927,133488,244848
test,618,233,178944,2393,344592,523536
test,619,278,213504,3407,490608,704112
test,620,215,165120,2038,293472,458592
test,621,287,220416,3631,522864,743280
test,622,520,399360,11751,1692144,2091504
test,623,384,294912,6499,935856,1230768
test,624,83,63744,304,43776,107520
test,625,281,215808,3481,501264,717072
test,626,324,248832,4627,666288,915120
test,627,168,129024,1244,179136,308160
test,628,209,160512,1926,277344,437856
test,629,280,215040,3456,497664,712704
test,630,399,306432,7017,1010448,1316880
test,631,364,279552,5840,840960,1120512
test,632,141,108288,877,126288,234576
test,633,356,273408,5586,804384,1077792
test,634,279,214272,3431,494064,708336
test,635,256,196608,2889,416016,612624
test,636,323,248064,4599,662256,910320
test,637,340,261120,5095,733680,994800
test,638,318,244224,4457,641808,886032
test,639,259,198912,2957,425808,624720
test,640,284,218112,3555,511920,730032
test,641,481,369408,10197,1468368,1837776
test,642,105,80640,486,69984,150624
test,643,313,240384,4318,621792,862176
test,644,413,317184,7518,1082592,1399776
test,645,302,231936,4020,578880,810816
test,646,530,407040,12048,1734912,2141952
test,647,89,68352,350,50400,118752
test,648,454,348672,9085,1308240,1656912
test,649,79,60672,276,39744,100416
test,650,145,111360,927,133488,244848
test,651,440,337920,8533,1228752,1566672
test,652,313,240384,4318,621792,862176
test,653,180,138240,1428,205632,343872
test,654,169,129792,1259,181296,311088
test,655,453,347904,9045,1302480,1650384
test,656,464,356352,9489,1366416,1722768
test,657,457,350976,9205,1325520,1676496
test,658,326,250368,4684,674496,924864
test,659,226,173568,2252,324288,497856
test,660,337,258816,5006,720864,979680
test,661,272,208896,3261,469584,678480
test,662,312,239616,4291,617904,857520
test,663,350,268800,5399,777456,1046256
test,664,303,232704,4047,582768,815472
test,665,327,251136,4713,678672,929808
test,666,390,299520,6704,965376,1264896
test,667,251,192768,2777,399888,592656
test,668,628,482304,15417,2220048,2702352
test,669,263,201984,3049,439056,641040
test,670,267,205056,3142,452448,657504
test,671,317,243456,4429,637776,881232
test,672,397,304896,6947,1000368,1305264
test,673,358,274944,5649,813456,1088400
test,674,469,360192,9695,1396080,1756272
test,675,227,174336,2272,327168,501504
test,676,240,184320,2539,365616,549936
test,677,262,201216,3026,435744,636960
test,678,453,347904,9045,1302480,1650384
test,679,197,151296,1711,246384,397680
test,680,160,122880,1129,162576,285456
test,681,245,188160,2646,381024,569184
test,682,390,299520,6704,965376,1264896
test,683,367,281856,5937,854928,1136784
test,684,253,194304,2822,406368,600672
test,685,580,445440,13661,1967184,2412624
test,686,204,156672,1835,264240,420912
test,687,242,185856,2582,371808,557664
test,688,195,149760,1676,241344,391104
test,689,213,163584,2000,288000,451584
test,690,494,379392,10756,1548864,1928256
test,691,225,172800,2232,321408,494208
test,692,376,288768,6231,897264,1186032
test,693,275,211200,3334,480096,691296
test,694,239,183552,2518,362592,546144
test,695,357,274176,5618,808992,1083168
test,696,438,336384,8456,1217664,1554048
test,697,227,174336,2272,327168,501504
test,698,498,382464,10931,1574064,1956528
test,699,406,311808,7265,1046160,1357968
test,700,346,265728,5277,759888,1025616
test,701,228,175104,2292,330048,505152
test,702,272,208896,3261,469584,678480
test,703,253,194304,2822,406368,600672
test,704,454,348672,9085,1308240,1656912
test,705,278,213504,3407,490608,704112
test,706,304,233472,4074,586656,820128
test,707,122,93696,656,94464,188160
test,708,145,111360,927,133488,244848
test,709,200,153600,1763,253872,407472
test,710,181,139008,1444,207936,346944
test,711,189,145152,1575,226800,371952
test,712,464,356352,9489,1366416,1722768
test,713,107,82176,505,72720,154896
test,714,352,270336,5461,786384,1056720
test,715,123,94464,667,96048,190512
test,716,204,156672,1835,264240,420912
test,717,87,66816,334,48096,114912
test,718,148,113664,966,139104,252768
test,719,89,68352,350,50400,118752
test,720,164,125952,1186,170784,296736
test,721,273,209664,3285,473040,682704
test,722,130,99840,745,107280,207120
test,723,254,195072,2844,409536,604608
test,724,318,244224,4457,641808,886032
test,725,244,187392,2624,377856,565248
test,726,337,258816,5006,720864,979680
test,727,400,307200,7052,1015488,1322688
test,728,132,101376,768,110592,211968
test,729,302,231936,4020,578880,810816
test,730,424,325632,7924,1141056,1466688
test,731,303,232704,4047,582768,815472
test,732,542,416256,12415,1787760,2204016
test,733,223,171264,2192,315648,486912
test,734,206,158208,1871,269424,427632
test,735,137,105216,828,119232,224448
test,736,91,69888,365,52560,122448
test,737,281,215808,3481,501264,717072
test,738,129,99072,734,105696,204768
test,739,478,367104,10071,1450224,1817328
test,740,105,80640,486,69984,150624
test,741,517,397056,11664,1679616,2076672
test,742,447,343296,8807,1268208,1611504
test,743,183,140544,1476,212544,353088
test,744,96,73728,407,58608,132336
test,745,309,237312,4209,606096,843408
test,746,109,83712,524,75456,159168
test,747,203,155904,1817,261648,417552
test,748,271,208128,3237,466128,674256
test,749,158,121344,1101,158544,279888
test,750,658,505344,16617,2392848,2898192
test,751,346,265728,5277,759888,1025616
test,752,285,218880,3580,515520,734400
test,753,309,237312,4209,606096,843408
test,754,166,127488,1215,174960,302448
test,755,486,373248,10410,1499040,1872288
test,756,266,204288,3119,449136,653424
test,757,318,244224,4457,641808,886032
test,758,165,126720,1200,172800,299520
test,759,149,114432,979,140976,255408
test,760,285,218880,3580,515520,734400
test,761,166,127488,1215,174960,302448
test,762,295,226560,3836,552384,778944
test,763,327,251136,4713,678672,929808
test,764,415,318720,7591,1093104,1411824
test,765,202,155136,1799,259056,414192
test,766,180,138240,1428,205632,343872
test,767,85,65280,319,45936,111216
test,768,102,78336,459,66096,144432
test,769,266,204288,3119,449136,653424
test,770,208,159744,1907,274608,434352
test,771,183,140544,1476,212544,353088
test,772,390,299520,6704,965376,1264896
test,773,492,377856,10669,1536336,1914192
test,774,272,208896,3261,469584,678480
test,775,116,89088,594,85536,174624
test,776,115,88320,583,83952,172272
test,777,288,221184,3656,526464,747648
test,778,323,248064,4599,662256,910320
test,779,92,70656,373,53712,124368
test,780,423,324864,7887,1135728,1460592
test,781,579,444672,13626,1962144,2406816
test,782,322,247296,4570,658080,905376
test,783,91,69888,365,52560,122448
test,784,343,263424,5186,746784,1010208
test,785,309,237312,4209,606096,843408
test,786,291,223488,3733,537552,761040
test,787,222,170496,2173,312912,483408
test,788,490,376320,10583,1523952,1900272
test,789,301,231168,3994,575136,806304
test,790,174,133632,1335,192240,325872
test,791,115,88320,583,83952,172272
test,792,290,222720,3707,533808,756528
test,793,424,325632,7924,1141056,1466688
test,794,509,390912,11419,1644336,2035248
test,795,84,64512,311,44784,109296
test,796,205,157440,1853,266832,424272
test,797,141,108288,877,126288,234576
test,798,321,246528,4542,654048,900576
test,799,182,139776,1460,210240,350016
test,800,167,128256,1230,177120,305376
test,801,654,502272,16452,2369088,2871360
test,802,282,216576,3505,504720,721296
test,803,236,181248,2455,353520,534768
test,804,203,155904,1817,261648,417552
test,805,244,187392,2624,377856,565248
test,806,398,305664,6982,1005408,1311072
test,807,347,266496,5307,764208,1030704
test,808,398,305664,6982,1005408,1311072
test,809,286,219648,3606,519264,738912
test,810,238,182784,2497,359568,542352
test,811,49,37632,106,15264,52896
test,812,114,87552,573,82512,170064
test,813,345,264960,5246,755424,1020384
test,814,414,317952,7555,1087920,1405872
test,815,81,62208,290,41760,103968
test,816,263,201984,3049,439056,641040
test,817,102,78336,459,66096,144432
test,818,209,160512,1926,277344,437856
test,819,413,317184,7518,1082592,1399776
test,820,511,392448,11492,1654848,2047296
test,821,239,183552,2518,362592,546144
test,822,615,472320,14921,2148624,2620944
test,823,213,163584,2000,288000,451584
test,824,504,387072,11196,1612224,1999296
test,825,280,215040,3456,497664,712704
test,826,385,295680,6533,940752,1236432
test,827,426,327168,7999,1151856,1479024
test,828,357,274176,5618,808992,1083168
test,829,109,83712,524,75456,159168
test,830,270,207360,3213,462672,670032
test,831,348,267264,5338,768672,1035936
test,832,235,180480,2434,350496,530976
test,833,112,86016,553,79632,165648
test,834,76,58368,255,36720,95088
test,835,164,125952,1186,170784,296736
test,836,524,402432,11869,1709136,2111568
test,837,599,460032,14331,2063664,2523696
test,838,403,309504,7158,1030752,1340256
test,839,187,143616,1542,222048,365664
test,840,166,127488,1215,174960,302448
test,841,382,293376,6432,926208,1219584
test,842,162,124416,1157,166608,291024
test,843,365,280320,5872,845568,1125888
test,844,100,76800,441,63504,140304
test,845,81,62208,290,41760,103968
test,846,481,369408,10197,1468368,1837776
test,847,264,202752,3072,442368,645120
test,848,379,291072,6331,911664,1202736
test,849,292,224256,3758,541152,765408
test,850,292,224256,3758,541152,765408
test,851,349,268032,5369,773136,1041168
test,852,209,160512,1926,277344,437856
test,853,226,173568,2252,324288,497856
test,854,245,188160,2646,381024,569184
test,855,323,248064,4599,662256,910320
test,856,245,188160,2646,381024,569184
test,857,201,154368,1781,256464,410832
test,858,416,319488,7628,1098432,1417920
test,859,249,191232,2733,393552,584784
test,860,251,192768,2777,399888,592656
test,861,248,190464,2711,390384,580848
test,862,382,293376,6432,926208,1219584
test,863,635,487680,15690,2259360,2747040
test,864,118,90624,614,88416,179040
test,865,350,268800,5399,777456,1046256
test,866,453,347904,9045,1302480,1650384
test,867,498,382464,10931,1574064,1956528
test,868,117,89856,604,86976,176832
test,869,316,242688,4401,633744,876432
test,870,166,127488,1215,174960,302448
test,871,141,108288,877,126288,234576
test,872,222,170496,2173,312912,483408
test,873,523,401664,11839,1704816,2106480
test,874,288,221184,3656,526464,747648
test,875,68,52224,204,29376,81600
test,876,469,360192,9695,1396080,1756272
test,877,109,83712,524,75456,159168
test,878,312,239616,4291,617904,857520
test,879,177,135936,1381,198864,334800
test,880,434,333312,8302,1195488,1528800
test,881,259,198912,2957,425808,624720
test,882,186,142848,1525,219600,362448
test,883,429,329472,8112,1168128,1497600
test,884,287,220416,3631,522864,743280
test,885,393,301824,6808,980352,1282176
test,886,273,209664,3285,473040,682704
test,887,451,346368,8965,1290960,1637328
test,888,95,72960,398,57312,130272
test,889,317,243456,4429,637776,881232
test,890,117,89856,604,86976,176832
test,891,271,208128,3237,466128,674256
test,892,432,331776,8226,1184544,1516320
test,893,385,295680,6533,940752,1236432
test,894,299,229632,3941,567504,797136
test,895,142,109056,889,128016,237072
test,896,359,275712,5681,818064,1093776
test,897,365,280320,5872,845568,1125888
test,898,126,96768,700,100800,197568
test,899,397,304896,6947,1000368,1305264
test,900,423,324864,7887,1135728,1460592
test,901,226,173568,2252,324288,497856
test,902,214,164352,2019,290736,455088
test,903,396,304128,6912,995328,1299456
test,904,159,122112,1115,160560,282672
test,905,389,298752,6670,960480,1259232
test,906,179,137472,1413,203472,340944
test,907,146,112128,940,135360,247488
test,908,161,123648,1143,164592,288240
test,909,86,66048,326,46944,112992
test,910,371,284928,6067,873648,1158576
test,911,245,188160,2646,381024,569184
test,912,183,140544,1476,212544,353088
test,913,248,190464,2711,390384,580848
test,914,237,182016,2476,356544,538560
test,915,291,223488,3733,537552,761040
test,916,287,220416,3631,522864,743280
test,917,89,68352,350,50400,118752
test,918,348,267264,5338,768672,1035936
test,919,283,217344,3530,508320,725664
test,920,304,233472,4074,586656,820128
test,921,169,129792,1259,181296,311088
test,922,342,262656,5155,742320,1004976
test,923,175,134400,1350,194400,328800
test,924,256,196608,2889,416016,612624
test,925,83,63744,304,43776,107520
test,926,254,195072,2844,409536,604608
test,927,395,303360,6877,990288,1293648
test,928,243,186624,2603,374832,561456
test,929,113,86784,563,81072,167856
test,930,285,218880,3580,515520,734400
test,931,164,125952,1186,170784,296736
test,932,271,208128,3237,466128,674256
test,933,407,312576,7301,1051344,1363920
test,934,193,148224,1642,236448,384672
test,935,222,170496,2173,312912,483408
test,936,257,197376,2911,419184,616560
test,937,562,431616,13055,1879920,2311536
test,938,398,305664,6982,1005408,1311072
test,939,211,162048,1963,282672,444720
test,940,241,185088,2560,368640,553728
test,941,301,231168,3994,575136,806304
test,942,90,69120,357,51408,120528
test,943,547,420096,12571,1810224,2230320
test,944,490,376320,10583,1523952,1900272
test,945,407,312576,7301,1051344,1363920
test,946,173,132864,1320,190080,322944
test,947,275,211200,3334,480096,691296
test,948,347,266496,5307,764208,1030704
test,949,286,219648,3606,519264,738912
test,950,213,163584,2000,288000,451584
test,951,223,171264,2192,315648,486912
test,952,455,349440,9125,1314000,1663440
test,953,351,269568,5430,781920,1051488
test,954,291,223488,3733,537552,761040
test,955,402,308736,7123,1025712,1334448
test,956,192,147456,1625,234000,381456
test,957,325,249600,4656,670464,920064
test,958,308,236544,4181,602064,838608
test,959,154,118272,1046,150624,268896
test,960,271,208128,3237,466128,674256
test,961,151,115968,1005,144720,260688
test,962,271,208128,3237,466128,674256
test,963,242,185856,2582,371808,557664
test,964,215,165120,2038,293472,458592
test,965,228,175104,2292,330048,505152
test,966,167,128256,1230,177120,305376
test,967,442,339456,8611,1239984,1579440
test,968,357,274176,5618,808992,1083168
test,969,274,210432,3309,476496,686928
test,970,168,129024,1244,179136,308160
test,971,313,240384,4318,621792,862176
test,972,236,181248,2455,353520,534768
test,973,156,119808,1073,154512,274320
test,974,194,148992,1659,238896,387888
test,975,508,390144,11374,1637856,2028000
test,976,187,143616,1542,222048,365664
test,977,161,123648,1143,164592,288240
test,978,365,280320,5872,845568,1125888
test,979,440,337920,8533,1228752,1566672
test,980,302,231936,4020,578880,810816
test,981,271,208128,3237,466128,674256
test,982,456,350208,9165,1319760,1669968
test,983,394,302592,6842,985248,1287840
test,984,409,314112,7373,1061712,1375824
test,985,73,56064,235,33840,89904
test,986,153,117504,1032,148608,266112
test,987,270,207360,3213,462672,670032
test,988,313,240384,4318,621792,862176
test,989,424,325632,7924,1141056,1466688
test,990,190,145920,1592,229248,375168
test,991,108,82944,515,74160,157104
test,992,250,192000,2755,396720,588720
test,993,365,280320,5872,845568,1125888
test,994,272,208896,3261,469584,678480
test,995,121,92928,646,93024,185952
test,996,587,450816,13904,2002176,2452992
test,997,313,240384,4318,621792,862176
test,998,179,137472,1413,203472,340944
test,999,350,268800,5399,777456,1046256
test,1000,283,217344,3530,508320,725664
test,1001,213,163584,2000,288000,451584
test,1002,193,148224,1642,236448,384672
test,1003,297,228096,3888,559872,787968
test,1004,410,314880,7409,1066896,1381776
test,1005,196,150528,1694,243936,394464
test,1006,161,123648,1143,164592,288240
test,1007,538,413184,12291,1769904,2183088
test,1008,189,145152,1575,226800,371952
test,1009,318,244224,4457,641808,886032
test,1010,174,133632,1335,192240,325872
test,1011,313,240384,4318,621792,862176
test,1012,421,323328,7812,1124928,1448256
test,1013,264,202752,3072,442368,645120
test,1014,300,230400,3967,571248,801648
test,1015,209,160512,1926,277344,437856
test,1016,180,138240,1428,205632,343872
test,1017,320,245760,4514,650016,895776
test,1018,141,108288,877,126288,234576
test,1019,252,193536,2799,403056,596592
test,1020,293,225024,3784,544896,769920
test,1021,267,205056,3142,452448,657504
test,1022,101,77568,450,64800,142368
test,1023,170,130560,1274,183456,314016
test,1024,347,266496,5307,764208,1030704
test,1025,406,311808,7265,1046160,1357968
test,1026,73,56064,235,33840,89904
test,1027,251,192768,2777,399888,592656
test,1028,270,207360,3213,462672,670032
test,1029,214,164352,2019,290736,455088
test,1030,196,150528,1694,243936,394464
test,1031,87,66816,334,48096,114912
test,1032,248,190464,2711,390384,580848
test,1033,332,254976,4858,699552,954528
test,1034,260,199680,2980,429120,628800
test,1035,197,151296,1711,246384,397680
test,1036,103,79104,468,67392,146496
test,1037,252,193536,2799,403056,596592
test,1038,268,205824,3166,455904,661728
test,1039,92,70656,373,53712,124368
test,1040,84,64512,311,44784,109296
test,1041,398,305664,6982,1005408,1311072
test,1042,215,165120,2038,293472,458592
test,1043,197,151296,1711,246384,397680
test,1044,329,252672,4771,687024,939696
test,1045,362,278016,5776,831744,1109760
test,1046,455,349440,9125,1314000,1663440
test,1047,455,349440,9125,1314000,1663440
test,1048,238,182784,2497,359568,542352
test,1049,390,299520,6704,965376,1264896
test,1050,286,219648,3606,519264,738912
test,1051,250,192000,2755,396720,588720
test,1052,178,136704,1397,201168,337872
test,1053,207,158976,1889,272016,430992
test,1054,323,248064,4599,662256,910320
test,1055,327,251136,4713,678672,929808
test,1056,267,205056,3142,452448,657504
test,1057,540,414720,12353,1778832,2193552
test,1058,114,87552,573,82512,170064
test,1059,114,87552,573,82512,170064
test,1060,180,138240,1428,205632,343872
test,1061,610,468480,14734,2121696,2590176
test,1062,217,166656,2076,298944,465600
test,1063,589,452352,13974,2012256,2464608
test,1064,224,172032,2212,318528,490560
test,1065,434,333312,8302,1195488,1528800
test,1066,228,175104,2292,330048,505152
test,1067,195,149760,1676,241344,391104
test,1068,202,155136,1799,259056,414192
test,1069,323,248064,4599,662256,910320
test,1070,396,304128,6912,995328,1299456
test,1071,245,188160,2646,381024,569184
test,1072,264,202752,3072,442368,645120
test,1073,202,155136,1799,259056,414192
test,1074,323,248064,4599,662256,910320
test,1075,543,417024,12446,1792224,2209248
test,1076,253,194304,2822,406368,600672
test,1077,440,337920,8533,1228752,1566672
test,1078,359,275712,5681,818064,1093776
test,1079,582,446976,13730,1977120,2424096
test,1080,442,339456,8611,1239984,1579440
test,1081,286,219648,3606,519264,738912
test,1082,207,158976,1889,272016,430992
test,1083,386,296448,6567,945648,1242096
test,1084,410,314880,7409,1066896,1381776
test,1085,372,285696,6100,878400,1164096
test,1086,394,302592,6842,985248,1287840
test,1087,495,380160,10800,1555200,1935360
test,1088,267,205056,3142,452448,657504
test,1089,288,221184,3656,526464,747648
test,1090,62,47616,170,24480,72096
test,1091,314,241152,4346,625824,866976
test,1092,290,222720,3707,533808,756528
test,1093,81,62208,290,41760,103968
test,1094,345,264960,5246,755424,1020384
test,1095,346,265728,5277,759888,1025616
test,1096,546,419328,12540,1805760,2225088
test,1097,492,377856,10669,1536336,1914192
test,1098,341,261888,5125,738000,999888
test,1099,554,425472,12794,1842336,2267808
test,1100,370,284160,6034,868896,1153056
test,1101,466,357888,9571,1378224,1736112
test,1102,133,102144,780,112320,214464
test,1103,128,98304,723,104112,202416
test,1104,291,223488,3733,537552,761040
test,1105,541,415488,12384,1783296,2198784
test,1106,281,215808,3481,501264,717072
test,1107,479,367872,10113,1456272,1824144
test,1108,267,205056,3142,452448,657504
test,1109,308,236544,4181,602064,838608
test,1110,383,294144,6466,931104,1225248
test,1111,272,208896,3261,469584,678480
test,1112,281,215808,3481,501264,717072
test,1113,197,151296,1711,246384,397680
test,1114,439,337152,8494,1223136,1560288
test,1115,225,172800,2232,321408,494208
test,1116,344,264192,5216,751104,1015296
test,1117,127,97536,711,102384,199920
test,1118,407,312576,7301,1051344,1363920
test,1119,223,171264,2192,315648,486912
test,1120,289,221952,3682,530208,752160
test,1121,296,227328,3862,556128,783456
test,1122,319,244992,4485,645840,890832
test,1123,90,69120,357,51408,120528
test,1124,217,166656,2076,298944,465600
test,1125,458,351744,9246,1331424,1683168
test,1126,180,138240,1428,205632,343872
test,1127,312,239616,4291,617904,857520
test,1128,211,162048,1963,282672,444720
test,1129,412,316416,7482,1077408,1393824
test,1130,390,299520,6704,965376,1264896
test,1131,311,238848,4263,613872,852720
test,1132,319,244992,4485,645840,890832
test,1133,245,188160,2646,381024,569184
test,1134,388,297984,6635,955440,1253424
test,1135,339,260352,5065,729360,989712
test,1136,433,332544,8264,1190016,1522560
test,1137,316,242688,4401,633744,876432
test,1138,388,297984,6635,955440,1253424
test,1139,205,157440,1853,266832,424272
test,1140,225,172800,2232,321408,494208
test,1141,190,145920,1592,229248,375168
test,1142,305,234240,4100,590400,824640
test,1143,356,273408,5586,804384,1077792
test,1144,417,320256,7664,1103616,1423872
test,1145,296,227328,3862,556128,783456
test,1146,648,497664,16208,2333952,2831616
test,1147,207,158976,1889,272016,430992
test,1148,461,354048,9367,1348848,1702896
test,1149,377,289536,6265,902160,1191696
test,1150,408,313344,7337,1056528,1369872
test,1151,82,62976,297,42768,105744
test,1152,76,58368,255,36720,95088
test,1153,121,92928,646,93024,185952
test,1154,328,251904,4742,682848,934752
test,1155,357,274176,5618,808992,1083168
test,1156,358,274944,5649,813456,1088400
test,1157,94,72192,390,56160,128352
test,1158,234,179712,2414,347616,527328
test,1159,459,352512,9286,1337184,1689696
test,1160,381,292608,6398,921312,1213920
test,1161,411,315648,7445,1072080,1387728
test,1162,101,77568,450,64800,142368
test,1163,97,74496,415,59760,134256
test,1164,207,158976,1889,272016,430992
test,1165,212,162816,1981,285264,448080
test,1166,222,170496,2173,312912,483408
test,1167,342,262656,5155,742320,1004976
test,1168,143,109824,902,129888,239712
test,1169,118,90624,614,88416,179040
test,1170,487,374016,10453,1505232,1879248
test,1171,252,193536,2799,403056,596592
test,1172,194,148992,1659,238896,387888
test,1173,403,309504,7158,1030752,1340256
test,1174,295,226560,3836,552384,778944
test,1175,184,141312,1493,214992,356304
test,1176,378,290304,6298,906912,1197216
test,1177,119,91392,625,90000,181392
test,1178,306,235008,4127,594288,829296
test,1179,266,204288,3119,449136,653424
test,1180,197,151296,1711,246384,397680
test,1181,369,283392,6002,864288,1147680
test,1182,176,135168,1366,196704,331872
test,1183,223,171264,2192,315648,486912
test,1184,151,115968,1005,144720,260688
test,1185,341,261888,5125,738000,999888
test,1186,335,257280,4947,712368,969648
test,1187,271,208128,3237,466128,674256
test,1188,212,162816,1981,285264,448080
test,1189,89,68352,350,50400,118752
test,1190,233,178944,2393,344592,523536
test,1191,349,268032,5369,773136,1041168
test,1192,346,265728,5277,759888,1025616
test,1193,324,248832,4627,666288,915120
test,1194,375,288000,6198,892512,1180512
test,1195,364,279552,5840,840960,1120512
test,1196,319,244992,4485,645840,890832
test,1197,358,274944,5649,813456,1088400
test,1198,167,128256,1230,177120,305376
test,1199,358,274944,5649,813456,1088400
test,1200,347,266496,5307,764208,1030704
test,1201,212,162816,1981,285264,448080
test,1202,89,68352,350,50400,118752
test,1203,357,274176,5618,808992,1083168
test,1204,290,222720,3707,533808,756528
test,1205,207,158976,1889,272016,430992
test,1206,434,333312,8302,1195488,1528800
test,1207,309,237312,4209,606096,843408
test,1208,344,264192,5216,751104,1015296
test,1209,434,333312,8302,1195488,1528800
test,1210,171,131328,1289,185616,316944
test,1211,176,135168,1366,196704,331872
test,1212,543,417024,12446,1792224,2209248
test,1213,62,47616,170,24480,72096
test,1214,402,308736,7123,1025712,1334448
test,1215,311,238848,4263,613872,852720
test,1216,278,213504,3407,490608,704112
test,1217,256,196608,2889,416016,612624
test,1218,264,202752,3072,442368,645120
test,1219,464,356352,9489,1366416,1722768
test,1220,433,332544,8264,1190016,1522560
test,1221,370,284160,6034,868896,1153056
test,1222,237,182016,2476,356544,538560
test,1223,143,109824,902,129888,239712
test,1224,504,387072,11196,1612224,1999296
test,1225,338,259584,5036,725184,984768
test,1226,440,337920,8533,1228752,1566672
test,1227,279,214272,3431,494064,708336
test,1228,309,237312,4209,606096,843408
test,1229,341,261888,5125,738000,999888
test,1230,547,420096,12571,1810224,2230320
test,1231,280,215040,3456,497664,712704
test,1232,81,62208,290,41760,103968
test,1233,314,241152,4346,625824,866976
test,1234,462,354816,9408,1354752,1709568
test,1235,38,29184,64,9216,38400
test,1236,136,104448,816,117504,221952
test,1237,95,72960,398,57312,130272
test,1238,173,132864,1320,190080,322944
test,1239,351,269568,5430,781920,1051488
test,1240,417,320256,7664,1103616,1423872
test,1241,461,354048,9367,1348848,1702896
test,1242,342,262656,5155,742320,1004976
test,1243,336,258048,4976,716544,974592
test,1244,130,99840,745,107280,207120
test,1245,88,67584,342,49248,116832
test,1246,246,188928,2668,384192,573120
test,1247,293,225024,3784,544896,769920
test,1248,134,102912,792,114048,216960
test,1249,450,345600,8925,1285200,1630800
test,1250,245,188160,2646,381024,569184
test,1251,514,394752,11578,1667232,2061984
test,1252,248,190464,2711,390384,580848
test,1253,364,279552,5840,840960,1120512
test,1254,397,304896,6947,1000368,1305264
test,1255,254,195072,2844,409536,604608
test,1256,333,255744,4888,703872,959616
test,1257,205,157440,1853,266832,424272
test,1258,269,206592,3190,459360,665952
test,1259,432,331776,8226,1184544,1516320
test,1260,115,88320,583,83952,172272
test,1261,203,155904,1817,261648,417552
test,1262,384,294912,6499,935856,1230768
test,1263,438,336384,8456,1217664,1554048
test,1264,187,143616,1542,222048,365664
test,1265,274,210432,3309,476496,686928
test,1266,206,158208,1871,269424,427632
test,1267,287,220416,3631,522864,743280
test,1268,475,364800,9945,1432080,1796880
test,1269,310,238080,4236,609984,848064
test,1270,354,271872,5524,795456,1067328
test,1271,209,160512,1926,277344,437856
test,1272,73,56064,235,33840,89904
test,1273,226,173568,2252,324288,497856
test,1274,229,175872,2312,332928,508800
test,1275,296,227328,3862,556128,783456
test,1276,321,246528,4542,654048,900576
test,1277,469,360192,9695,1396080,1756272
test,1278,419,321792,7738,1114272,1436064
test,1279,356,273408,5586,804384,1077792
test,1280,202,155136,1799,259056,414192
test,1281,218,167424,2095,301680,469104
test,1282,374,287232,6165,887760,1174992
test,1283,249,191232,2733,393552,584784
test,1284,291,223488,3733,537552,761040
test,1285,194,148992,1659,238896,387888
test,1286,636,488448,15729,2264976,2753424
test,1287,99,76032,432,62208,138240
test,1288,60,46080,159,22896,68976
test,1289,292,224256,3758,541152,765408
test,1290,310,238080,4236,609984,848064
test,1291,210,161280,1944,279936,441216
test,1292,173,132864,1320,190080,322944
test,1293,332,254976,4858,699552,954528
test,1294,66,50688,192,27648,78336
test,1295,209,160512,1926,277344,437856
test,1296,261,200448,3003,432432,632880
test,1297,531,407808,12078,1739232,2147040
test,1298,221,169728,2153,310032,479760
test,1299,289,221952,3682,530208,752160
test,1300,147,112896,953,137232,250128
test,1301,147,112896,953,137232,250128
test,1302,206,158208,1871,269424,427632
test,1303,91,69888,365,52560,122448
test,1304,463,355584,9448,1360512,1716096
test,1305,264,202752,3072,442368,645120
test,1306,275,211200,3334,480096,691296
test,1307,68,52224,204,29376,81600
test,1308,382,293376,6432,926208,1219584
test,1309,319,244992,4485,645840,890832
test,1310,100,76800,441,63504,140304
test,1311,263,201984,3049,439056,641040
test,1312,207,158976,1889,272016,430992
test,1313,349,268032,5369,773136,1041168
test,1314,263,201984,3049,439056,641040
test,1315,398,305664,6982,1005408,1311072
test,1316,393,301824,6808,980352,1282176
test,1317,367,281856,5937,854928,1136784
test,1318,166,127488,1215,174960,302448
test,1319,77,59136,262,37728,96864
test,1320,102,78336,459,66096,144432
test,1321,430,330240,8150,1173600,1503840
test,1322,159,122112,1115,160560,282672
test,1323,416,319488,7628,1098432,1417920
test,1324,248,190464,2711,390384,580848
test,1325,387,297216,6601,950544,1247760
test,1326,198,152064,1728,248832,400896
test,1327,185,142080,1509,217296,359376
test,1328,396,304128,6912,995328,1299456
test,1329,133,102144,780,112320,214464
test,1330,570,437760,13320,1918080,2355840
test,1331,450,345600,8925,1285200,1630800
test,1332,190,145920,1592,229248,375168
test,1333,305,234240,4100,590400,824640
test,1334,386,296448,6567,945648,1242096
test,1335,241,185088,2560,368640,553728
test,1336,377,289536,6265,902160,1191696
test,1337,263,201984,3049,439056,641040
test,1338,321,246528,4542,654048,900576
test,1339,353,271104,5492,790848,1061952
test,1340,110,84480,534,76896,161376
test,1341,357,274176,5618,808992,1083168
test,1342,251,192768,2777,399888,592656
test,1343,376,288768,6231,897264,1186032
test,1344,208,159744,1907,274608,434352
test,1345,330,253440,4800,691200,944640
test,1346,248,190464,2711,390384,580848
test,1347,141,108288,877,126288,234576
test,1348,216,165888,2057,296208,462096
test,1349,106,81408,496,71424,152832
test,1350,332,254976,4858,699552,954528
test,1351,227,174336,2272,327168,501504
test,1352,120,92160,635,91440,183600
test,1353,161,123648,1143,164592,288240
test,1354,198,152064,1728,248832,400896
test,1355,541,415488,12384,1783296,2198784
test,1356,240,184320,2539,365616,549936
test,1357,90,69120,357,51408,120528
test,1358,314,241152,4346,625824,866976
test,1359,218,167424,2095,301680,469104
test,1360,271,208128,3237,466128,674256
test,1361,168,129024,1244,179136,308160
test,1362,204,156672,1835,264240,420912
test,1363,212,162816,1981,285264,448080
test,1364,504,387072,11196,1612224,1999296
test,1365,449,344832,8886,1279584,1624416
test,1366,379,291072,6331,911664,1202736
test,1367,344,264192,5216,751104,1015296
test,1368,223,171264,2192,315648,486912
test,1369,257,197376,2911,419184,616560
test,1370,207,158976,1889,272016,430992
test,1371,222,170496,2173,312912,483408
test,1372,220,168960,2134,307296,476256
test,1373,205,157440,1853,266832,424272
test,1374,503,386304,11151,1605744,1992048
test,1375,265,203520,3096,445824,649344
test,1376,47,36096,98,14112,50208
test,1377,647,496896,16168,2328192,2825088
test,1378,332,254976,4858,699552,954528
test,1379,53,40704,124,17856,58560
test,1380,233,178944,2393,344592,523536
test,1381,153,117504,1032,148608,266112
test,1382,233,178944,2393,344592,523536
test,1383,107,82176,505,72720,154896
test,1384,236,181248,2455,353520,534768
test,1385,188,144384,1558,224352,368736
test,1386,370,284160,6034,868896,1153056
test,1387,176,135168,1366,196704,331872
test,1388,274,210432,3309,476496,686928
test,1389,220,168960,2134,307296,476256
test,1390,335,257280,4947,712368,969648
test,1391,378,290304,6298,906912,1197216
test,1392,263,201984,3049,439056,641040
test,1393,349,268032,5369,773136,1041168
test,1394,86,66048,326,46944,112992
test,1395,427,327936,8036,1157184,1485120
test,1396,191,146688,1608,231552,378240
test,1397,556,427008,12859,1851696,2278704
test,1398,107,82176,505,72720,154896
test,1399,337,258816,5006,720864,979680
test,1400,266,204288,3119,449136,653424
test,1401,177,135936,1381,198864,334800
test,1402,173,132864,1320,190080,322944
test,1403,306,235008,4127,594288,829296
test,1404,51,39168,115,16560,55728
test,1405,210,161280,1944,279936,441216
test,1406,247,189696,2689,387216,576912
test,1407,439,337152,8494,1223136,1560288
test,1408,303,232704,4047,582768,815472
test,1409,152,116736,1019,146736,263472
test,1410,396,304128,6912,995328,1299456
test,1411,262,201216,3026,435744,636960
test,1412,299,229632,3941,567504,797136
test,1413,339,260352,5065,729360,989712
test,1414,198,152064,1728,248832,400896
test,1415,513,393984,11549,1663056,2057040
test,1416,180,138240,1428,205632,343872
test,1417,429,329472,8112,1168128,1497600
test,1418,595,456960,14188,2043072,2500032
test,1419,292,224256,3758,541152,765408
test,1420,423,324864,7887,1135728,1460592
test,1421,260,199680,2980,429120,628800
test,1422,327,251136,4713,678672,929808
test,1423,574,440832,13455,1937520,2378352
test,1424,154,118272,1046,150624,268896
test,1425,559,429312,12956,1865664,2294976
test,1426,477,366336,10028,1444032,1810368
test,1427,300,230400,3967,571248,801648
test,1428,316,242688,4401,633744,876432
test,1429,295,226560,3836,552384,778944
test,1430,328,251904,4742,682848,934752
test,1431,303,232704,4047,582768,815472
test,1432,273,209664,3285,473040,682704
test,1433,354,271872,5524,795456,1067328
test,1434,105,80640,486,69984,150624
test,1435,326,250368,4684,674496,924864
test,1436,350,268800,5399,777456,1046256
test,1437,273,209664,3285,473040,682704
test,1438,217,166656,2076,298944,465600
test,1439,68,52224,204,29376,81600
test,1440,327,251136,4713,678672,929808
test,1441,132,101376,768,110592,211968
test,1442,324,248832,4627,666288,915120
test,1443,120,92160,635,91440,183600
test,1444,395,303360,6877,990288,1293648
test,1445,137,105216,828,119232,224448
test,1446,122,93696,656,94464,188160
test,1447,269,206592,3190,459360,665952
test,1448,219,168192,2114,304416,472608
test,1449,185,142080,1509,217296,359376
test,1450,267,205056,3142,452448,657504
test,1451,122,93696,656,94464,188160
test,1452,296,227328,3862,556128,783456
test,1453,110,84480,534,76896,161376
test,1454,415,318720,7591,1093104,1411824
test,1455,623,478464,15224,2192256,2670720
test,1456,281,215808,3481,501264,717072
test,1457,240,184320,2539,365616,549936
test,1458,105,80640,486,69984,150624
test,1459,174,133632,1335,192240,325872
test,1460,375,288000,6198,892512,1180512
test,1461,127,97536,711,102384,199920
test,1462,305,234240,4100,590400,824640
test,1463,513,393984,11549,1663056,2057040
test,1464,176,135168,1366,196704,331872
test,1465,238,182784,2497,359568,542352
test,1466,148,113664,966,139104,252768
test,1467,381,292608,6398,921312,1213920
test,1468,400,307200,7052,1015488,1322688
test,1469,268,205824,3166,455904,661728
test,1470,280,215040,3456,497664,712704
test,1471,429,329472,8112,1168128,1497600
test,1472,292,224256,3758,541152,765408
test,1473,230,176640,2332,335808,512448
test,1474,469,360192,9695,1396080,1756272
test,1475,148,113664,966,139104,252768
test,1476,131,100608,757,109008,209616
test,1477,258,198144,2934,422496,620640
test,1478,342,262656,5155,742320,1004976
test,1479,255,195840,2866,412704,608544
test,1480,539,413952,12322,1774368,2188320
test,1481,251,192768,2777,399888,592656
test,1482,296,227328,3862,556128,783456
test,1483,433,332544,8264,1190016,1522560
test,1484,196,150528,1694,243936,394464
test,1485,174,133632,1335,192240,325872
test,1486,351,269568,5430,781920,1051488
test,1487,464,356352,9489,1366416,1722768
test,1488,274,210432,3309,476496,686928
test,1489,257,197376,2911,419184,616560
test,1490,105,80640,486,69984,150624
test,1491,89,68352,350,50400,118752
test,1492,132,101376,768,110592,211968
test,1493,195,149760,1676,241344,391104
test,1494,296,227328,3862,556128,783456
test,1495,378,290304,6298,906912,1197216
test,1496,644,494592,16047,2310768,2805360
test,1497,299,229632,3941,567504,797136
test,1498,424,325632,7924,1141056,1466688
test,1499,354,271872,5524,795456,1067328
test,1500,190,145920,1592,229248,375168
test,1501,305,234240,4100,590400,824640
test,1502,98,75264,424,61056,136320
test,1503,288,221184,3656,526464,747648
test,1504,285,218880,3580,515520,734400
test,1505,296,227328,3862,556128,783456
test,1506,161,123648,1143,164592,288240
test,1507,619,475392,15072,2170368,2645760
test,1508,201,154368,1781,256464,410832
test,1509,278,213504,3407,490608,704112
test,1510,60,46080,159,22896,68976
test,1511,403,309504,7158,1030752,1340256
test,1512,90,69120,357,51408,120528
test,1513,144,110592,914,131616,242208
test,1514,166,127488,1215,174960,302448
test,1515,262,201216,3026,435744,636960
test,1516,305,234240,4100,590400,824640
test,1517,249,191232,2733,393552,584784
test,1518,98,75264,424,61056,136320
test,1519,178,136704,1397,201168,337872
test,1520,271,208128,3237,466128,674256
test,1521,333,255744,4888,703872,959616
test,1522,368,282624,5969,859536,1142160
test,1523,405,311040,7230,1041120,1352160
test,1524,72,55296,229,32976,88272
test,1525,208,159744,1907,274608,434352
test,1526,298,228864,3914,563616,792480
test,1527,297,228096,3888,559872,787968
test,1528,358,274944,5649,813456,1088400
test,1529,253,194304,2822,406368,600672
test,1530,471,361728,9778,1408032,1769760
test,1531,351,269568,5430,781920,1051488
test,1532,293,225024,3784,544896,769920
test,1533,236,181248,2455,353520,534768
test,1534,295,226560,3836,552384,778944
test,1535,344,264192,5216,751104,1015296
test,1536,202,155136,1799,259056,414192
test,1537,366,281088,5904,850176,1131264
test,1538,456,350208,9165,1319760,1669968
test,1539,311,238848,4263,613872,852720
test,1540,412,316416,7482,1077408,1393824
test,1541,518,397824,11693,1683792,2081616
test,1542,271,208128,3237,466128,674256
test,1543,326,250368,4684,674496,924864
test,1544,185,142080,1509,217296,359376
test,1545,218,167424,2095,301680,469104
test,1546,324,248832,4627,666288,915120
test,1547,284,218112,3555,511920,730032
test,1548,140,107520,864,124416,231936
test,1549,264,202752,3072,442368,645120
test,1550,120,92160,635,91440,183600
test,1551,442,339456,8611,1239984,1579440
test,1552,286,219648,3606,519264,738912
test,1553,482,370176,10240,1474560,1844736
test,1554,223,171264,2192,315648,486912
test,1555,271,208128,3237,466128,674256
test,1556,424,325632,7924,1141056,1466688
test,1557,362,278016,5776,831744,1109760
test,1558,407,312576,7301,1051344,1363920
test,1559,165,126720,1200,172800,299520
test,1560,477,366336,10028,1444032,1810368
test,1561,139,106752,852,122688,229440
test,1562,262,201216,3026,435744,636960
test,1563,302,231936,4020,578880,810816
test,1564,374,287232,6165,887760,1174992
test,1565,402,308736,7123,1025712,1334448
test,1566,378,290304,6298,906912,1197216
test,1567,212,162816,1981,285264,448080
test,1568,292,224256,3758,541152,765408
test,1569,120,92160,635,91440,183600
test,1570,198,152064,1728,248832,400896
test,1571,254,195072,2844,409536,604608
test,1572,296,227328,3862,556128,783456
test,1573,172,132096,1304,187776,319872
test,1574,214,164352,2019,290736,455088
test,1575,110,84480,534,76896,161376
test,1576,163,125184,1171,168624,293808
test,1577,343,263424,5186,746784,1010208
test,1578,283,217344,3530,508320,725664
test,1579,338,259584,5036,725184,984768
test,1580,472,362496,9819,1413936,1776432
test,1581,257,197376,2911,419184,616560
test,1582,363,278784,5808,836352,1115136
test,1583,523,401664,11839,1704816,2106480
test,1584,157,120576,1087,156528,277104
test,1585,196,150528,1694,243936,394464
test,1586,107,82176,505,72720,154896
test,1587,305,234240,4100,590400,824640
test,1588,210,161280,1944,279936,441216
test,1589,361,277248,5744,827136,1104384
test,1590,230,176640,2332,335808,512448
test,1591,486,373248,10410,1499040,1872288
test,1592,188,144384,1558,224352,368736
test,1593,99,76032,432,62208,138240
test,1594,384,294912,6499,935856,1230768
test,1595,377,289536,6265,902160,1191696
test,1596,184,141312,1493,214992,356304
test,1597,383,294144,6466,931104,1225248
test,1598,120,92160,635,91440,183600
test,1599,215,165120,2038,293472,458592
test,1600,224,172032,2212,318528,490560
test,1601,188,144384,1558,224352,368736
test,1602,297,228096,3888,559872,787968
test,1603,356,273408,5586,804384,1077792
test,1604,284,218112,3555,511920,730032
test,1605,252,193536,2799,403056,596592
test,1606,387,297216,6601,950544,1247760
test,1607,380,291840,6365,916560,1208400
test,1608,373,286464,6132,883008,1169472
test,1609,350,268800,5399,777456,1046256
test,1610,196,150528,1694,243936,394464
test,1611,222,170496,2173,312912,483408
test,1612,201,154368,1781,256464,410832
test,1613,137,105216,828,119232,224448
test,1614,318,244224,4457,641808,886032
test,1615,137,105216,828,119232,224448
test,1616,372,285696,6100,878400,1164096
test,1617,228,175104,2292,330048,505152
test,1618,112,86016,553,79632,165648
test,1619,251,192768,2777,399888,592656
test,1620,331,254208,4829,695376,949584
test,1621,294,225792,3810,548640,774432
test,1622,305,234240,4100,590400,824640
test,1623,268,205824,3166,455904,661728
test,1624,154,118272,1046,150624,268896
test,1625,423,324864,7887,1135728,1460592
test,1626,127,97536,711,102384,199920
test,1627,291,223488,3733,537552,761040
test,1628,245,188160,2646,381024,569184
test,1629,457,350976,9205,1325520,1676496
test,1630,111,85248,543,78192,163440
test,1631,241,185088,2560,368640,553728
test,1632,398,305664,6982,1005408,1311072
test,1633,134,102912,792,114048,216960
test,1634,368,282624,5969,859536,1142160
test,1635,240,184320,2539,365616,549936
test,1636,219,168192,2114,304416,472608
test,1637,197,151296,1711,246384,397680
test,1638,284,218112,3555,511920,730032
test,1639,288,221184,3656,526464,747648
test,1640,360,276480,5712,822528,1099008
test,1641,389,298752,6670,960480,1259232
test,1642,511,392448,11492,1654848,2047296
test,1643,152,116736,1019,146736,263472
test,1644,331,254208,4829,695376,949584
test,1645,493,378624,10713,1542672,1921296
test,1646,226,173568,2252,324288,497856
test,1647,450,345600,8925,1285200,1630800
test,1648,282,216576,3505,504720,721296
test,1649,99,76032,432,62208,138240
test,1650,254,195072,2844,409536,604608
test,1651,229,175872,2312,332928,508800
test,1652,181,139008,1444,207936,346944
test,1653,248,190464,2711,390384,580848
test,1654,63,48384,175,25200,73584
test,1655,224,172032,2212,318528,490560
test,1656,90,69120,357,51408,120528
test,1657,236,181248,2455,353520,534768
test,1658,205,157440,1853,266832,424272
test,1659,65,49920,187,26928,76848
test,1660,622,477696,15186,2186784,2664480
test,1661,358,274944,5649,813456,1088400
test,1662,227,174336,2272,327168,501504
test,1663,426,327168,7999,1151856,1479024
test,1664,177,135936,1381,198864,334800
test,1665,128,98304,723,104112,202416
test,1666,561,430848,13022,1875168,2306016
test,1667,185,142080,1509,217296,359376
test,1668,340,261120,5095,733680,994800
test,1669,230,176640,2332,335808,512448
test,1670,324,248832,4627,666288,915120
test,1671,123,94464,667,96048,190512
test,1672,291,223488,3733,537552,761040
test,1673,184,141312,1493,214992,356304
test,1674,457,350976,9205,1325520,1676496
test,1675,247,189696,2689,387216,576912
test,1676,205,157440,1853,266832,424272
test,1677,274,210432,3309,476496,686928
test,1678,473,363264,9861,1419984,1783248
test,1679,277,212736,3382,487008,699744
test,1680,197,151296,1711,246384,397680
test,1681,108,82944,515,74160,157104
test,1682,163,125184,1171,168624,293808
test,1683,210,161280,1944,279936,441216
test,1684,137,105216,828,119232,224448
test,1685,253,194304,2822,406368,600672
test,1686,274,210432,3309,476496,686928
test,1687,240,184320,2539,365616,549936
test,1688,359,275712,5681,818064,1093776
test,1689,154,118272,1046,150624,268896
test,1690,200,153600,1763,253872,407472
test,1691,259,198912,2957,425808,624720
test,1692,296,227328,3862,556128,783456
test,1693,561,430848,13022,1875168,2306016
test,1694,283,217344,3530,508320,725664
test,1695,443,340224,8650,1245600,1585824
test,1696,162,124416,1157,166608,291024
test,1697,515,395520,11607,1671408,2066928
test,1698,276,211968,3358,483552,695520
test,1699,99,76032,432,62208,138240
test,1700,315,241920,4374,629856,871776
test,1701,253,194304,2822,406368,600672
test,1702,419,321792,7738,1114272,1436064
test,1703,302,231936,4020,578880,810816
test,1704,295,226560,3836,552384,778944
test,1705,152,116736,1019,146736,263472
test,1706,408,313344,7337,1056528,1369872
test,1707,379,291072,6331,911664,1202736
test,1708,480,368640,10155,1462320,1830960
test,1709,378,290304,6298,906912,1197216
test,1710,327,251136,4713,678672,929808
test,1711,321,246528,4542,654048,900576
test,1712,221,169728,2153,310032,479760
test,1713,271,208128,3237,466128,674256
test,1714,330,253440,4800,691200,944640
test,1715,150,115200,992,142848,258048
test,1716,359,275712,5681,818064,1093776
test,1717,316,242688,4401,633744,876432
test,1718,81,62208,290,41760,103968
test,1719,180,138240,1428,205632,343872
test,1720,158,121344,1101,158544,279888
test,1721,337,258816,5006,720864,979680
test,1722,301,231168,3994,575136,806304
test,1723,322,247296,4570,658080,905376
test,1724,535,410880,12199,1756656,2167536
test,1725,106,81408,496,71424,152832
test,1726,238,182784,2497,359568,542352
test,1727,223,171264,2192,315648,486912
test,1728,470,360960,9736,1401984,1762944
test,1729,416,319488,7628,1098432,1417920
test,1730,263,201984,3049,439056,641040
test,1731,123,94464,667,96048,190512
test,1732,218,167424,2095,301680,469104
test,1733,238,182784,2497,359568,542352
test,1734,162,124416,1157,166608,291024
test,1735,200,153600,1763,253872,407472
test,1736,53,40704,124,17856,58560
test,1737,817,627456,22339,3216816,3844272
test,1738,206,158208,1871,269424,427632
test,1739,352,270336,5461,786384,1056720
test,1740,130,99840,745,107280,207120
test,1741,335,257280,4947,712368,969648
test,1742,323,248064,4599,662256,910320
test,1743,157,120576,1087,156528,277104
test,1744,456,350208,9165,1319760,1669968
test,1745,252,193536,2799,403056,596592
test,1746,227,174336,2272,327168,501504
test,1747,273,209664,3285,473040,682704
test,1748,236,181248,2455,353520,534768
test,1749,210,161280,1944,279936,441216
test,1750,415,318720,7591,1093104,1411824
test,1751,466,357888,9571,1378224,1736112
test,1752,213,163584,2000,288000,451584
test,1753,303,232704,4047,582768,815472
test,1754,109,83712,524,75456,159168
test,1755,145,111360,927,133488,244848
test,1756,235,180480,2434,350496,530976
test,1757,149,114432,979,140976,255408
test,1758,274,210432,3309,476496,686928
test,1759,130,99840,745,107280,207120
test,1760,286,219648,3606,519264,738912
test,1761,425,326400,7961,1146384,1472784
test,1762,239,183552,2518,362592,546144
test,1763,111,85248,543,78192,163440
test,1764,281,215808,3481,501264,717072
test,1765,221,169728,2153,310032,479760
test,1766,336,258048,4976,716544,974592
test,1767,224,172032,2212,318528,490560
test,1768,187,143616,1542,222048,365664
test,1769,201,154368,1781,256464,410832
test,1770,194,148992,1659,238896,387888
test,1771,264,202752,3072,442368,645120
test,1772,149,114432,979,140976,255408
test,1773,335,257280,4947,712368,969648
test,1774,98,75264,424,61056,136320
test,1775,485,372480,10368,1492992,1865472
test,1776,332,254976,4858,699552,954528
test,1777,467,358656,9612,1384128,1742784
test,1778,409,314112,7373,1061712,1375824
test,1779,86,66048,326,46944,112992
test,1780,391,300288,6738,970272,1270560
test,1781,251,192768,2777,399888,592656
test,1782,183,140544,1476,212544,353088
test,1783,402,308736,7123,1025712,1334448
test,1784,422,324096,7849,1130256,1454352
test,1785,148,113664,966,139104,252768
test,1786,304,233472,4074,586656,820128
test,1787,388,297984,6635,955440,1253424
test,1788,415,318720,7591,1093104,1411824
test,1789,310,238080,4236,609984,848064
test,1790,120,92160,635,91440,183600
test,1791,106,81408,496,71424,152832
test,1792,517,397056,11664,1679616,2076672
test,1793,450,345600,8925,1285200,1630800
test,1794,151,115968,1005,144720,260688
test,1795,419,321792,7738,1114272,1436064
test,1796,315,241920,4374,629856,871776
test,1797,137,105216,828,119232,224448
test,1798,68,52224,204,29376,81600
test,1799,469,360192,9695,1396080,1756272
test,1800,300,230400,3967,571248,801648
test,1801,415,318720,7591,1093104,1411824
test,1802,172,132096,1304,187776,319872
test,1803,433,332544,8264,1190016,1522560
test,1804,344,264192,5216,751104,1015296
test,1805,252,193536,2799,403056,596592
test,1806,347,266496,5307,764208,1030704
test,1807,504,387072,11196,1612224,1999296
test,1808,318,244224,4457,641808,886032
test,1809,86,66048,326,46944,112992
test,1810,437,335616,8417,1212048,1547664
test,1811,480,368640,10155,1462320,1830960
test,1812,293,225024,3784,544896,769920
test,1813,229,175872,2312,332928,508800
test,1814,193,148224,1642,236448,384672
test,1815,393,301824,6808,980352,1282176
test,1816,179,137472,1413,203472,340944
test,1817,367,281856,5937,854928,1136784
test,1818,410,314880,7409,1066896,1381776
test,1819,242,185856,2582,371808,557664
test,1820,137,105216,828,119232,224448
test,1821,695,533760,18207,2621808,3155568
test,1822,205,157440,1853,266832,424272
test,1823,387,297216,6601,950544,1247760
test,1824,261,200448,3003,432432,632880
test,1825,113,86784,563,81072,167856
test,1826,256,196608,2889,416016,612624
test,1827,124,95232,678,97632,192864
test,1828,236,181248,2455,353520,534768
test,1829,132,101376,768,110592,211968
test,1830,176,135168,1366,196704,331872
test,1831,476,365568,9986,1437984,1803552
test,1832,421,323328,7812,1124928,1448256
test,1833,299,229632,3941,567504,797136
test,1834,124,95232,678,97632,192864
test,1835,216,165888,2057,296208,462096
test,1836,385,295680,6533,940752,1236432
test,1837,147,112896,953,137232,250128
test,1838,367,281856,5937,854928,1136784
test,1839,342,262656,5155,742320,1004976
test,1840,280,215040,3456,497664,712704
test,1841,366,281088,5904,850176,1131264
test,1842,377,289536,6265,902160,1191696
test,1843,457,350976,9205,1325520,1676496
test,1844,216,165888,2057,296208,462096
test,1845,286,219648,3606,519264,738912
test,1846,165,126720,1200,172800,299520
test,1847,277,212736,3382,487008,699744
test,1848,371,284928,6067,873648,1158576
test,1849,296,227328,3862,556128,783456
test,1850,318,244224,4457,641808,886032
test,1851,543,417024,12446,1792224,2209248
test,1852,366,281088,5904,850176,1131264
test,1853,84,64512,311,44784,109296
test,1854,299,229632,3941,567504,797136
test,1855,144,110592,914,131616,242208
test,1856,324,248832,4627,666288,915120
test,1857,709,544512,18674,2689056,3233568
test,1858,480,368640,10155,1462320,1830960
test,1859,367,281856,5937,854928,1136784
test,1860,209,160512,1926,277344,437856
test,1861,325,249600,4656,670464,920064
test,1862,278,213504,3407,490608,704112
test,1863,346,265728,5277,759888,1025616
test,1864,105,80640,486,69984,150624
test,1865,208,159744,1907,274608,434352
test,1866,299,229632,3941,567504,797136
test,1867,319,244992,4485,645840,890832
test,1868,443,340224,8650,1245600,1585824
test,1869,249,191232,2733,393552,584784
test,1870,378,290304,6298,906912,1197216
test,1871,343,263424,5186,746784,1010208
test,1872,159,122112,1115,160560,282672
test,1873,292,224256,3758,541152,765408
test,1874,313,240384,4318,621792,862176
test,1875,257,197376,2911,419184,616560
test,1876,163,125184,1171,168624,293808
test,1877,265,203520,3096,445824,649344
test,1878,257,197376,2911,419184,616560
test,1879,352,270336,5461,786384,1056720
test,1880,217,166656,2076,298944,465600
test,1881,165,126720,1200,172800,299520
test,1882,129,99072,734,105696,204768
test,1883,281,215808,3481,501264,717072
test,1884,255,195840,2866,412704,608544
test,1885,263,201984,3049,439056,641040
test,1886,502,385536,11107,1599408,1984944
test,1887,465,357120,9530,1372320,1729440
test,1888,394,302592,6842,985248,1287840
test,1889,362,278016,5776,831744,1109760
test,1890,348,267264,5338,768672,1035936
test,1891,228,175104,2292,330048,505152
test,1892,187,143616,1542,222048,365664
test,1893,436,334848,8379,1206576,1541424
test,1894,273,209664,3285,473040,682704
test,1895,284,218112,3555,511920,730032
test,1896,179,137472,1413,203472,340944
test,1897,126,96768,700,100800,197568
test,1898,264,202752,3072,442368,645120
test,1899,362,278016,5776,831744,1109760
test,1900,220,168960,2134,307296,476256
test,1901,413,317184,7518,1082592,1399776
test,1902,376,288768,6231,897264,1186032
test,1903,487,374016,10453,1505232,1879248
test,1904,249,191232,2733,393552,584784
test,1905,131,100608,757,109008,209616
test,1906,321,246528,4542,654048,900576
test,1907,297,228096,3888,559872,787968
test,1908,324,248832,4627,666288,915120
test,1909,208,159744,1907,274608,434352
test,1910,332,254976,4858,699552,954528
test,1911,126,96768,700,100800,197568
test,1912,567,435456,13220,1903680,2339136
test,1913,233,178944,2393,344592,523536
test,1914,198,152064,1728,248832,400896
test,1915,308,236544,4181,602064,838608
test,1916,405,311040,7230,1041120,1352160
test,1917,358,274944,5649,813456,1088400
test,1918,292,224256,3758,541152,765408
test,1919,599,460032,14331,2063664,2523696
test,1920,244,187392,2624,377856,565248
test,1921,423,324864,7887,1135728,1460592
test,1922,306,235008,4127,594288,829296
test,1923,325,249600,4656,670464,920064
test,1924,286,219648,3606,519264,738912
test,1925,331,254208,4829,695376,949584
test,1926,240,184320,2539,365616,549936
test,1927,281,215808,3481,501264,717072
test,1928,149,114432,979,140976,255408
test,1929,228,175104,2292,330048,505152
test,1930,130,99840,745,107280,207120
test,1931,87,66816,334,48096,114912
test,1932,328,251904,4742,682848,934752
test,1933,201,154368,1781,256464,410832
test,1934,111,85248,543,78192,163440
test,1935,496,380928,10843,1561392,1942320
test,1936,279,214272,3431,494064,708336
test,1937,203,155904,1817,261648,417552
test,1938,272,208896,3261,469584,678480
test,1939,370,284160,6034,868896,1153056
test,1940,271,208128,3237,466128,674256
test,1941,296,227328,3862,556128,783456
test,1942,118,90624,614,88416,179040
test,1943,397,304896,6947,1000368,1305264
test,1944,366,281088,5904,850176,1131264
test,1945,368,282624,5969,859536,1142160
test,1946,246,188928,2668,384192,573120
test,1947,448,344064,8846,1273824,1617888
test,1948,340,261120,5095,733680,994800
test,1949,148,113664,966,139104,252768
test,1950,401,307968,7088,1020672,1328640
test,1951,122,93696,656,94464,188160
test,1952,324,248832,4627,666288,915120
test,1953,204,156672,1835,264240,420912
test,1954,227,174336,2272,327168,501504
test,1955,437,335616,8417,1212048,1547664
test,1956,372,285696,6100,878400,1164096
test,1957,185,142080,1509,217296,359376
test,1958,730,560640,19306,2780064,3340704
test,1959,283,217344,3530,508320,725664
test,1960,225,172800,2232,321408,494208
test,1961,387,297216,6601,950544,1247760
test,1962,126,96768,700,100800,197568
test,1963,115,88320,583,83952,172272
test,1964,329,252672,4771,687024,939696
test,1965,600,460800,14368,2068992,2529792
test,1966,286,219648,3606,519264,738912
test,1967,261,200448,3003,432432,632880
test,1968,304,233472,4074,586656,820128
test,1969,220,168960,2134,307296,476256
test,1970,165,126720,1200,172800,299520
test,1971,136,104448,816,117504,221952
test,1972,255,195840,2866,412704,608544
test,1973,219,168192,2114,304416,472608
test,1974,105,80640,486,69984,150624
test,1975,183,140544,1476,212544,353088
test,1976,104,79872,477,68688,148560
test,1977,79,60672,276,39744,100416
test,1978,372,285696,6100,878400,1164096
test,1979,60,46080,159,22896,68976
test,1980,276,211968,3358,483552,695520
test,1981,156,119808,1073,154512,274320
test,1982,132,101376,768,110592,211968
test,1983,116,89088,594,85536,174624
test,1984,334,256512,4917,708048,964560
test,1985,329,252672,4771,687024,939696
test,1986,383,294144,6466,931104,1225248
test,1987,569,436992,13287,1913328,2350320
test,1988,367,281856,5937,854928,1136784
test,1989,98,75264,424,61056,136320
test,1990,287,220416,3631,522864,743280
test,1991,347,266496,5307,764208,1030704
test,1992,250,192000,2755,396720,588720
test,1993,248,190464,2711,390384,580848
test,1994,286,219648,3606,519264,738912
test,1995,203,155904,1817,261648,417552
test,1996,509,390912,11419,1644336,2035248
test,1997,192,147456,1625,234000,381456
test,1998,346,265728,5277,759888,1025616
test,1999,340,261120,5095,733680,994800
test,2000,302,231936,4020,578880,810816
test,2001,274,210432,3309,476496,686928
test,2002,269,206592,3190,459360,665952
test,2003,310,238080,4236,609984,848064
test,2004,162,124416,1157,166608,291024
test,2005,272,208896,3261,469584,678480
test,2006,277,212736,3382,487008,699744
test,2007,103,79104,468,67392,146496
test,2008,128,98304,723,104112,202416
test,2009,283,217344,3530,508320,725664
test,2010,278,213504,3407,490608,704112
test,2011,257,197376,2911,419184,616560
test,2012,227,174336,2272,327168,501504
test,2013,248,190464,2711,390384,580848
test,2014,410,314880,7409,1066896,1381776
test,2015,174,133632,1335,192240,325872
test,2016,242,185856,2582,371808,557664
test,2017,473,363264,9861,1419984,1783248
test,2018,119,91392,625,90000,181392
test,2019,348,267264,5338,768672,1035936
test,2020,283,217344,3530,508320,725664
test,2021,229,175872,2312,332928,508800
test,2022,152,116736,1019,146736,263472
test,2023,406,311808,7265,1046160,1357968
test,2024,129,99072,734,105696,204768
test,2025,186,142848,1525,219600,362448
test,2026,168,129024,1244,179136,308160
test,2027,338,259584,5036,725184,984768
test,2028,224,172032,2212,318528,490560
test,2029,186,142848,1525,219600,362448
test,2030,340,261120,5095,733680,994800
test,2031,342,262656,5155,742320,1004976
test,2032,251,192768,2777,399888,592656
test,2033,122,93696,656,94464,188160
test,2034,134,102912,792,114048,216960
test,2035,303,232704,4047,582768,815472
test,2036,87,66816,334,48096,114912
test,2037,396,304128,6912,995328,1299456
test,2038,467,358656,9612,1384128,1742784
test,2039,402,308736,7123,1025712,1334448
test,2040,121,92928,646,93024,185952
test,2041,278,213504,3407,490608,704112
test,2042,312,239616,4291,617904,857520
test,2043,105,80640,486,69984,150624
test,2044,446,342528,8767,1262448,1604976
test,2045,571,438528,13354,1922976,2361504
test,2046,185,142080,1509,217296,359376
test,2047,295,226560,3836,552384,778944
test,2048,211,162048,1963,282672,444720
test,2049,182,139776,1460,210240,350016
test,2050,298,228864,3914,563616,792480
test,2051,224,172032,2212,318528,490560
test,2052,420,322560,7775,1119600,1442160
test,2053,323,248064,4599,662256,910320
test,2054,404,310272,7194,1035936,1346208
test,2055,141,108288,877,126288,234576
test,2056,245,188160,2646,381024,569184
test,2057,229,175872,2312,332928,508800
test,2058,259,198912,2957,425808,624720
test,2059,244,187392,2624,377856,565248
test,2060,448,344064,8846,1273824,1617888
test,2061,310,238080,4236,609984,848064
test,2062,225,172800,2232,321408,494208
test,2063,220,168960,2134,307296,476256
test,2064,516,396288,11635,1675440,2071728
test,2065,273,209664,3285,473040,682704
test,2066,170,130560,1274,183456,314016
test,2067,253,194304,2822,406368,600672
test,2068,445,341760,8728,1256832,1598592
test,2069,426,327168,7999,1151856,1479024
test,2070,448,344064,8846,1273824,1617888
test,2071,231,177408,2352,338688,516096
test,2072,162,124416,1157,166608,291024
test,2073,205,157440,1853,266832,424272
test,2074,178,136704,1397,201168,337872
test,2075,244,187392,2624,377856,565248
test,2076,376,288768,6231,897264,1186032
test,2077,84,64512,311,44784,109296
test,2078,175,134400,1350,194400,328800
test,2079,181,139008,1444,207936,346944
test,2080,208,159744,1907,274608,434352
test,2081,168,129024,1244,179136,308160
test,2082,279,214272,3431,494064,708336
test,2083,105,80640,486,69984,150624
test,2084,382,293376,6432,926208,1219584
test,2085,266,204288,3119,449136,653424
test,2086,250,192000,2755,396720,588720
test,2087,320,245760,4514,650016,895776
test,2088,152,116736,1019,146736,263472
test,2089,444,340992,8689,1251216,1592208
test,2090,76,58368,255,36720,95088
test,2091,332,254976,4858,699552,954528
test,2092,216,165888,2057,296208,462096
test,2093,155,119040,1059,152496,271536
test,2094,166,127488,1215,174960,302448
test,2095,284,218112,3555,511920,730032
test,2096,439,337152,8494,1223136,1560288
test,2097,388,297984,6635,955440,1253424
test,2098,357,274176,5618,808992,1083168
test,2099,239,183552,2518,362592,546144
test,2100,179,137472,1413,203472,340944
test,2101,457,350976,9205,1325520,1676496
test,2102,352,270336,5461,786384,1056720
test,2103,407,312576,7301,1051344,1363920
test,2104,308,236544,4181,602064,838608
test,2105,74,56832,242,34848,91680
test,2106,223,171264,2192,315648,486912
test,2107,492,377856,10669,1536336,1914192
test,2108,539,413952,12322,1774368,2188320
test,2109,395,303360,6877,990288,1293648
test,2110,476,365568,9986,1437984,1803552
test,2111,254,195072,2844,409536,604608
test,2112,248,190464,2711,390384,580848
test,2113,186,142848,1525,219600,362448
test,2114,463,355584,9448,1360512,1716096
test,2115,343,263424,5186,746784,1010208
test,2116,67,51456,198,28512,79968
test,2117,275,211200,3334,480096,691296
test,2118,184,141312,1493,214992,356304
test,2119,200,153600,1763,253872,407472
test,2120,88,67584,342,49248,116832
test,2121,578,443904,13592,1957248,2401152
test,2122,324,248832,4627,666288,915120
test,2123,146,112128,940,135360,247488
test,2124,185,142080,1509,217296,359376
test,2125,405,311040,7230,1041120,1352160
test,2126,275,211200,3334,480096,691296
test,2127,103,79104,468,67392,146496
test,2128,243,186624,2603,374832,561456
test,2129,272,208896,3261,469584,678480
test,2130,375,288000,6198,892512,1180512
test,2131,304,233472,4074,586656,820128
test,2132,293,225024,3784,544896,769920
test,2133,123,94464,667,96048,190512
test,2134,367,281856,5937,854928,1136784
test,2135,215,165120,2038,293472,458592
test,2136,172,132096,1304,187776,319872
test,2137,305,234240,4100,590400,824640
test,2138,148,113664,966,139104,252768
test,2139,367,281856,5937,854928,1136784
test,2140,244,187392,2624,377856,565248
test,2141,262,201216,3026,435744,636960
test,2142,278,213504,3407,490608,704112
test,2143,375,288000,6198,892512,1180512
test,2144,413,317184,7518,1082592,1399776
test,2145,335,257280,4947,712368,969648
test,2146,222,170496,2173,312912,483408
test,2147,329,252672,4771,687024,939696
test,2148,412,316416,7482,1077408,1393824
test,2149,225,172800,2232,321408,494208
test,2150,244,187392,2624,377856,565248
test,2151,441,338688,8572,1234368,1573056
test,2152,243,186624,2603,374832,561456
test,2153,283,217344,3530,508320,725664
test,2154,176,135168,1366,196704,331872
test,2155,487,374016,10453,1505232,1879248
test,2156,341,261888,5125,738000,999888
test,2157,516,396288,11635,1675440,2071728
test,2158,95,72960,398,57312,130272
test,2159,228,175104,2292,330048,505152
test,2160,236,181248,2455,353520,534768
test,2161,447,343296,8807,1268208,1611504
test,2162,444,340992,8689,1251216,1592208
test,2163,319,244992,4485,645840,890832
test,2164,290,222720,3707,533808,756528
test,2165,241,185088,2560,368640,553728
test,2166,393,301824,6808,980352,1282176
test,2167,304,233472,4074,586656,820128
test,2168,519,398592,11722,1687968,2086560
test,2169,274,210432,3309,476496,686928
test,2170,286,219648,3606,519264,738912
test,2171,484,371712,10325,1486800,1858512
test,2172,327,251136,4713,678672,929808
test,2173,288,221184,3656,526464,747648
test,2174,266,204288,3119,449136,653424
test,2175,555,426240,12827,1847088,2273328
test,2176,266,204288,3119,449136,653424
test,2177,110,84480,534,76896,161376
test,2178,447,343296,8807,1268208,1611504
test,2179,314,241152,4346,625824,866976
test,2180,115,88320,583,83952,172272
test,2181,337,258816,5006,720864,979680
test,2182,190,145920,1592,229248,375168
test,2183,492,377856,10669,1536336,1914192
test,2184,353,271104,5492,790848,1061952
test,2185,334,256512,4917,708048,964560
test,2186,677,519936,17419,2508336,3028272
test,2187,214,164352,2019,290736,455088
test,2188,386,296448,6567,945648,1242096
test,2189,258,198144,2934,422496,620640
test,2190,194,148992,1659,238896,387888
test,2191,166,127488,1215,174960,302448
test,2192,163,125184,1171,168624,293808
test,2193,287,220416,3631,522864,743280
test,2194,116,89088,594,85536,174624
test,2195,414,317952,7555,1087920,1405872
test,2196,334,256512,4917,708048,964560
test,2197,249,191232,2733,393552,584784
test,2198,409,314112,7373,1061712,1375824
test,2199,205,157440,1853,266832,424272
test,2200,230,176640,2332,335808,512448
test,2201,169,129792,1259,181296,311088
test,2202,109,83712,524,75456,159168
test,2203,93,71424,382,55008,126432
test,2204,210,161280,1944,279936,441216
test,2205,265,203520,3096,445824,649344
test,2206,248,190464,2711,390384,580848
test,2207,348,267264,5338,768672,1035936
test,2208,404,310272,7194,1035936,1346208
test,2209,156,119808,1073,154512,274320
test,2210,262,201216,3026,435744,636960
test,2211,225,172800,2232,321408,494208
test,2212,297,228096,3888,559872,787968
test,2213,283,217344,3530,508320,725664
test,2214,193,148224,1642,236448,384672
test,2215,97,74496,415,59760,134256
test,2216,203,155904,1817,261648,417552
test,2217,103,79104,468,67392,146496
test,2218,291,223488,3733,537552,761040
test,2219,417,320256,7664,1103616,1423872
test,2220,432,331776,8226,1184544,1516320
test,2221,483,370944,10282,1480608,1851552
test,2222,236,181248,2455,353520,534768
test,2223,195,149760,1676,241344,391104
test,2224,310,238080,4236,609984,848064
test,2225,43,33024,82,11808,44832
test,2226,252,193536,2799,403056,596592
test,2227,612,470016,14809,2132496,2602512
test,2228,210,161280,1944,279936,441216
test,2229,310,238080,4236,609984,848064
test,2230,348,267264,5338,768672,1035936
test,2231,88,67584,342,49248,116832
test,2232,188,144384,1558,224352,368736
test,2233,292,224256,3758,541152,765408
test,2234,371,284928,6067,873648,1158576
test,2235,205,157440,1853,266832,424272
test,2236,300,230400,3967,571248,801648
test,2237,429,329472,8112,1168128,1497600
test,2238,285,218880,3580,515520,734400
test,2239,338,259584,5036,725184,984768
test,2240,110,84480,534,76896,161376
test,2241,241,185088,2560,368640,553728
test,2242,327,251136,4713,678672,929808
test,2243,323,248064,4599,662256,910320
test,2244,132,101376,768,110592,211968
test,2245,149,114432,979,140976,255408
test,2246,466,357888,9571,1378224,1736112
test,2247,343,263424,5186,746784,1010208
test,2248,256,196608,2889,416016,612624
test,2249,317,243456,4429,637776,881232
test,2250,372,285696,6100,878400,1164096
test,2251,94,72192,390,56160,128352
test,2252,320,245760,4514,650016,895776
test,2253,288,221184,3656,526464,747648
test,2254,177,135936,1381,198864,334800
test,2255,462,354816,9408,1354752,1709568
test,2256,192,147456,1625,234000,381456
test,2257,181,139008,1444,207936,346944
test,2258,321,246528,4542,654048,900576
test,2259,139,106752,852,122688,229440
test,2260,302,231936,4020,578880,810816
test,2261,195,149760,1676,241344,391104
test,2262,203,155904,1817,261648,417552
test,2263,426,327168,7999,1151856,1479024
test,2264,396,304128,6912,995328,1299456
test,2265,106,81408,496,71424,152832
test,2266,540,414720,12353,1778832,2193552
test,2267,157,120576,1087,156528,277104
test,2268,280,215040,3456,497664,712704
test,2269,147,112896,953,137232,250128
test,2270,492,377856,10669,1536336,1914192
test,2271,347,266496,5307,764208,1030704
test,2272,458,351744,9246,1331424,1683168
test,2273,213,163584,2000,288000,451584
test,2274,421,323328,7812,1124928,1448256
test,2275,261,200448,3003,432432,632880
test,2276,565,433920,13154,1894176,2328096
test,2277,411,315648,7445,1072080,1387728
test,2278,343,263424,5186,746784,1010208
test,2279,171,131328,1289,185616,316944
test,2280,661,507648,16742,2410848,2918496
test,2281,312,239616,4291,617904,857520
test,2282,523,401664,11839,1704816,2106480
test,2283,398,305664,6982,1005408,1311072
test,2284,232,178176,2373,341712,519888
test,2285,340,261120,5095,733680,994800
test,2286,169,129792,1259,181296,311088
test,2287,466,357888,9571,1378224,1736112
test,2288,218,167424,2095,301680,469104
test,2289,153,117504,1032,148608,266112
test,2290,281,215808,3481,501264,717072
test,2291,298,228864,3914,563616,792480
test,2292,225,172800,2232,321408,494208
test,2293,397,304896,6947,1000368,1305264
test,2294,330,253440,4800,691200,944640
test,2295,209,160512,1926,277344,437856
test,2296,340,261120,5095,733680,994800
test,2297,260,199680,2980,429120,628800
test,2298,364,279552,5840,840960,1120512
test,2299,247,189696,2689,387216,576912
test,2300,315,241920,4374,629856,871776
test,2301,118,90624,614,88416,179040
test,2302,381,292608,6398,921312,1213920
test,2303,128,98304,723,104112,202416
test,2304,348,267264,5338,768672,1035936
test,2305,393,301824,6808,980352,1282176
test,2306,467,358656,9612,1384128,1742784
test,2307,212,162816,1981,285264,448080
test,2308,107,82176,505,72720,154896
test,2309,486,373248,10410,1499040,1872288
test,2310,622,477696,15186,2186784,2664480
test,2311,453,347904,9045,1302480,1650384
test,2312,252,193536,2799,403056,596592
test,2313,298,228864,3914,563616,792480
test,2314,287,220416,3631,522864,743280
test,2315,300,230400,3967,571248,801648
test,2316,199,152832,1746,251424,404256
test,2317,310,238080,4236,609984,848064
test,2318,481,369408,10197,1468368,1837776
test,2319,132,101376,768,110592,211968
test,2320,380,291840,6365,916560,1208400
test,2321,414,317952,7555,1087920,1405872
test,2322,215,165120,2038,293472,458592
test,2323,357,274176,5618,808992,1083168
test,2324,105,80640,486,69984,150624
test,2325,462,354816,9408,1354752,1709568
test,2326,227,174336,2272,327168,501504
test,2327,186,142848,1525,219600,362448
test,2328,359,275712,5681,818064,1093776
test,2329,236,181248,2455,353520,534768
test,2330,233,178944,2393,344592,523536
test,2331,305,234240,4100,590400,824640
test,2332,171,131328,1289,185616,316944
test,2333,356,273408,5586,804384,1077792
test,2334,311,238848,4263,613872,852720
test,2335,142,109056,889,128016,237072
test,2336,257,197376,2911,419184,616560
test,2337,119,91392,625,90000,181392
test,2338,347,266496,5307,764208,1030704
test,2339,304,233472,4074,586656,820128
test,2340,121,92928,646,93024,185952
test,2341,366,281088,5904,850176,1131264
test,2342,236,181248,2455,353520,534768
test,2343,164,125952,1186,170784,296736
test,2344,195,149760,1676,241344,391104
test,2345,309,237312,4209,606096,843408
test,2346,300,230400,3967,571248,801648
test,2347,370,284160,6034,868896,1153056
test,2348,213,163584,2000,288000,451584
test,2349,206,158208,1871,269424,427632
test,2350,452,347136,9005,1296720,1643856
test,2351,186,142848,1525,219600,362448
test,2352,295,226560,3836,552384,778944
test,2353,322,247296,4570,658080,905376
test,2354,294,225792,3810,548640,774432
test,2355,293,225024,3784,544896,769920
test,2356,249,191232,2733,393552,584784
test,2357,475,364800,9945,1432080,1796880
test,2358,171,131328,1289,185616,316944
test,2359,183,140544,1476,212544,353088
test,2360,361,277248,5744,827136,1104384
test,2361,326,250368,4684,674496,924864
test,2362,315,241920,4374,629856,871776
test,2363,575,441600,13489,1942416,2384016
test,2364,222,170496,2173,312912,483408
test,2365,191,146688,1608,231552,378240
test,2366,347,266496,5307,764208,1030704
test,2367,267,205056,3142,452448,657504
test,2368,477,366336,10028,1444032,1810368
test,2369,216,165888,2057,296208,462096
test,2370,240,184320,2539,365616,549936
test,2371,74,56832,242,34848,91680
test,2372,286,219648,3606,519264,738912
test,2373,82,62976,297,42768,105744
test,2374,210,161280,1944,279936,441216
test,2375,195,149760,1676,241344,391104
test,2376,288,221184,3656,526464,747648
test,2377,99,76032,432,62208,138240
test,2378,398,305664,6982,1005408,1311072
test,2379,162,124416,1157,166608,291024
test,2380,253,194304,2822,406368,600672
test,2381,332,254976,4858,699552,954528
test,2382,422,324096,7849,1130256,1454352
test,2383,330,253440,4800,691200,944640
test,2384,315,241920,4374,629856,871776
test,2385,141,108288,877,126288,234576
test,2386,251,192768,2777,399888,592656
test,2387,290,222720,3707,533808,756528
test,2388,369,283392,6002,864288,1147680
test,2389,198,152064,1728,248832,400896
test,2390,626,480768,15339,2208816,2689584
test,2391,528,405504,11988,1726272,2131776
test,2392,212,162816,1981,285264,448080
test,2393,181,139008,1444,207936,346944
test,2394,182,139776,1460,210240,350016
test,2395,279,214272,3431,494064,708336
test,2396,226,173568,2252,324288,497856
test,2397,540,414720,12353,1778832,2193552
test,2398,358,274944,5649,813456,1088400
test,2399,446,342528,8767,1262448,1604976
test,2400,232,178176,2373,341712,519888
test,2401,413,317184,7518,1082592,1399776
test,2402,454,348672,9085,1308240,1656912
test,2403,358,274944,5649,813456,1088400
test,2404,206,158208,1871,269424,427632
test,2405,284,218112,3555,511920,730032
test,2406,228,175104,2292,330048,505152
test,2407,375,288000,6198,892512,1180512
test,2408,439,337152,8494,1223136,1560288
test,2409,370,284160,6034,868896,1153056
test,2410,247,189696,2689,387216,576912
test,2411,171,131328,1289,185616,316944
test,2412,273,209664,3285,473040,682704
test,2413,389,298752,6670,960480,1259232
test,2414,451,346368,8965,1290960,1637328
test,2415,457,350976,9205,1325520,1676496
test,2416,277,212736,3382,487008,699744
test,2417,414,317952,7555,1087920,1405872
test,2418,563,432384,13087,1884528,2316912
test,2419,216,165888,2057,296208,462096
test,2420,265,203520,3096,445824,649344
test,2421,164,125952,1186,170784,296736
test,2422,329,252672,4771,687024,939696
test,2423,174,133632,1335,192240,325872
test,2424,230,176640,2332,335808,512448
test,2425,380,291840,6365,916560,1208400
test,2426,398,305664,6982,1005408,1311072
test,2427,424,325632,7924,1141056,1466688
test,2428,308,236544,4181,602064,838608
test,2429,400,307200,7052,1015488,1322688
test,2430,541,415488,12384,1783296,2198784
test,2431,350,268800,5399,777456,1046256
test,2432,568,436224,13253,1908432,2344656
test,2433,293,225024,3784,544896,769920
test,2434,209,160512,1926,277344,437856
test,2435,334,256512,4917,708048,964560
test,2436,246,188928,2668,384192,573120
test,2437,134,102912,792,114048,216960
test,2438,393,301824,6808,980352,1282176
test,2439,115,88320,583,83952,172272
test,2440,456,350208,9165,1319760,1669968
test,2441,467,358656,9612,1384128,1742784
test,2442,369,283392,6002,864288,1147680
test,2443,405,311040,7230,1041120,1352160
test,2444,205,157440,1853,266832,424272
test,2445,92,70656,373,53712,124368
test,2446,369,283392,6002,864288,1147680
test,2447,433,332544,8264,1190016,1522560
test,2448,255,195840,2866,412704,608544
test,2449,180,138240,1428,205632,343872
test,2450,167,128256,1230,177120,305376
test,2451,426,327168,7999,1151856,1479024
test,2452,154,118272,1046,150624,268896
test,2453,84,64512,311,44784,109296
test,2454,400,307200,7052,1015488,1322688
test,2455,221,169728,2153,310032,479760
test,2456,200,153600,1763,253872,407472
test,2457,133,102144,780,112320,214464
test,2458,289,221952,3682,530208,752160
test,2459,494,379392,10756,1548864,1928256
test,2460,217,166656,2076,298944,465600
test,2461,312,239616,4291,617904,857520
test,2462,315,241920,4374,629856,871776
test,2463,323,248064,4599,662256,910320
test,2464,524,402432,11869,1709136,2111568
test,2465,251,192768,2777,399888,592656
test,2466,259,198912,2957,425808,624720
test,2467,300,230400,3967,571248,801648
test,2468,77,59136,262,37728,96864
test,2469,803,616704,21806,3140064,3756768
test,2470,321,246528,4542,654048,900576
test,2471,288,221184,3656,526464,747648
test,2472,167,128256,1230,177120,305376
test,2473,135,103680,804,115776,219456
test,2474,230,176640,2332,335808,512448
test,2475,422,324096,7849,1130256,1454352
test,2476,247,189696,2689,387216,576912
test,2477,183,140544,1476,212544,353088
test,2478,284,218112,3555,511920,730032
test,2479,145,111360,927,133488,244848
test,2480,283,217344,3530,508320,725664
test,2481,118,90624,614,88416,179040
test,2482,244,187392,2624,377856,565248
test,2483,265,203520,3096,445824,649344
test,2484,331,254208,4829,695376,949584
test,2485,409,314112,7373,1061712,1375824
test,2486,371,284928,6067,873648,1158576
test,2487,445,341760,8728,1256832,1598592
test,2488,318,244224,4457,641808,886032
test,2489,193,148224,1642,236448,384672
test,2490,373,286464,6132,883008,1169472
test,2491,338,259584,5036,725184,984768
test,2492,81,62208,290,41760,103968
test,2493,216,165888,2057,296208,462096
test,2494,398,305664,6982,1005408,1311072
test,2495,531,407808,12078,1739232,2147040
test,2496,457,350976,9205,1325520,1676496
test,2497,390,299520,6704,965376,1264896
test,2498,183,140544,1476,212544,353088
test,2499,399,306432,7017,1010448,1316880
test,2500,174,133632,1335,192240,325872
test,2501,115,88320,583,83952,172272
test,2502,297,228096,3888,559872,787968
test,2503,350,268800,5399,777456,1046256
test,2504,161,123648,1143,164592,288240
test,2505,280,215040,3456,497664,712704
test,2506,141,108288,877,126288,234576
test,2507,248,190464,2711,390384,580848
test,2508,428,328704,8074,1162656,1491360
test,2509,56,43008,139,20016,63024
test,2510,238,182784,2497,359568,542352
test,2511,492,377856,10669,1536336,1914192
test,2512,301,231168,3994,575136,806304
test,2513,334,256512,4917,708048,964560
test,2514,181,139008,1444,207936,346944
test,2515,384,294912,6499,935856,1230768
test,2516,86,66048,326,46944,112992
test,2517,396,304128,6912,995328,1299456
test,2518,211,162048,1963,282672,444720
test,2519,118,90624,614,88416,179040
test,2520,178,136704,1397,201168,337872
test,2521,488,374784,10496,1511424,1886208
test,2522,138,105984,840,120960,226944
test,2523,242,185856,2582,371808,557664
test,2524,458,351744,9246,1331424,1683168
test,2525,238,182784,2497,359568,542352
test,2526,255,195840,2866,412704,608544
test,2527,139,106752,852,122688,229440
test,2528,818,628224,22377,3222288,3850512
test,2529,116,89088,594,85536,174624
test,2530,252,193536,2799,403056,596592
test,2531,61,46848,164,23616,70464
test,2532,240,184320,2539,365616,549936
test,2533,247,189696,2689,387216,576912
test,2534,249,191232,2733,393552,584784
test,2535,301,231168,3994,575136,806304
test,2536,114,87552,573,82512,170064
test,2537,253,194304,2822,406368,600672
test,2538,315,241920,4374,629856,871776
test,2539,250,192000,2755,396720,588720
test,2540,191,146688,1608,231552,378240
test,2541,320,245760,4514,650016,895776
test,2542,507,389376,11330,1631520,2020896
test,2543,272,208896,3261,469584,678480
test,2544,401,307968,7088,1020672,1328640
test,2545,474,364032,9903,1426032,1790064
test,2546,381,292608,6398,921312,1213920
test,2547,137,105216,828,119232,224448
test,2548,314,241152,4346,625824,866976
test,2549,323,248064,4599,662256,910320
test,2550,424,325632,7924,1141056,1466688
test,2551,98,75264,424,61056,136320
test,2552,354,271872,5524,795456,1067328
test,2553,177,135936,1381,198864,334800
test,2554,168,129024,1244,179136,308160
test,2555,484,371712,10325,1486800,1858512
test,2556,293,225024,3784,544896,769920
test,2557,400,307200,7052,1015488,1322688
test,2558,197,151296,1711,246384,397680
test,2559,195,149760,1676,241344,391104
test,2560,370,284160,6034,868896,1153056
test,2561,230,176640,2332,335808,512448
test,2562,267,205056,3142,452448,657504
test,2563,161,123648,1143,164592,288240
test,2564,171,131328,1289,185616,316944
test,2565,191,146688,1608,231552,378240
test,2566,310,238080,4236,609984,848064
test,2567,343,263424,5186,746784,1010208
test,2568,228,175104,2292,330048,505152
test,2569,318,244224,4457,641808,886032
test,2570,279,214272,3431,494064,708336
test,2571,160,122880,1129,162576,285456
test,2572,74,56832,242,34848,91680
test,2573,461,354048,9367,1348848,1702896
test,2574,452,347136,9005,1296720,1643856
test,2575,153,117504,1032,148608,266112
test,2576,296,227328,3862,556128,783456
test,2577,69,52992,210,30240,83232
test,2578,213,163584,2001,288144,451728
test,2579,220,168960,2134,307296,476256
test,2580,420,322560,7775,1119600,1442160
test,2581,209,160512,1926,277344,437856
test,2582,324,248832,4627,666288,915120
test,2583,126,96768,700,100800,197568
test,2584,232,178176,2373,341712,519888
test,2585,599,460032,14331,2063664,2523696
test,2586,262,201216,3026,435744,636960
test,2587,172,132096,1304,187776,319872
test,2588,217,166656,2076,298944,465600
test,2589,467,358656,9612,1384128,1742784
test,2590,259,198912,2957,425808,624720
test,2591,163,125184,1171,168624,293808
test,2592,347,266496,5307,764208,1030704
test,2593,371,284928,6067,873648,1158576
test,2594,336,258048,4976,716544,974592
test,2595,167,128256,1230,177120,305376
test,2596,269,206592,3190,459360,665952
test,2597,81,62208,290,41760,103968
test,2598,278,213504,3407,490608,704112
test,2599,235,180480,2434,350496,530976
test,2600,390,299520,6704,965376,1264896
test,2601,374,287232,6165,887760,1174992
test,2602,146,112128,940,135360,247488
test,2603,77,59136,262,37728,96864
test,2604,471,361728,9778,1408032,1769760
test,2605,61,46848,164,23616,70464
test,2606,268,205824,3166,455904,661728
test,2607,154,118272,1046,150624,268896
test,2608,586,450048,13869,1997136,2447184
test,2609,464,356352,9489,1366416,1722768
test,2610,147,112896,953,137232,250128
test,2611,332,254976,4858,699552,954528
test,2612,236,181248,2455,353520,534768
test,2613,158,121344,1101,158544,279888
test,2614,404,310272,7194,1035936,1346208
test,2615,286,219648,3606,519264,738912
test,2616,193,148224,1642,236448,384672
test,2617,498,382464,10931,1574064,1956528
test,2618,295,226560,3836,552384,778944
test,2619,355,272640,5555,799920,1072560
test,2620,73,56064,235,33840,89904
test,2621,82,62976,297,42768,105744
test,2622,426,327168,7999,1151856,1479024
test,2623,406,311808,7265,1046160,1357968
test,2624,413,317184,7518,1082592,1399776
test,2625,266,204288,3119,449136,653424
test,2626,501,384768,11063,1593072,1977840
test,2627,178,136704,1397,201168,337872
test,2628,133,102144,780,112320,214464
test,2629,307,235776,4154,598176,833952
test,2630,100,76800,441,63504,140304
test,2631,189,145152,1575,226800,371952
test,2632,285,218880,3580,515520,734400
test,2633,425,326400,7961,1146384,1472784
test,2634,467,358656,9612,1384128,1742784
test,2635,188,144384,1558,224352,368736
test,2636,391,300288,6738,970272,1270560
test,2637,114,87552,573,82512,170064
test,2638,109,83712,524,75456,159168
test,2639,425,326400,7961,1146384,1472784
test,2640,448,344064,8846,1273824,1617888
test,2641,495,380160,10800,1555200,1935360
test,2642,157,120576,1087,156528,277104
test,2643,429,329472,8112,1168128,1497600
test,2644,306,235008,4127,594288,829296
test,2645,264,202752,3072,442368,645120
test,2646,228,175104,2292,330048,505152
test,2647,250,192000,2755,396720,588720
test,2648,468,359424,9654,1390176,1749600
test,2649,100,76800,441,63504,140304
test,2650,439,337152,8494,1223136,1560288
test,2651,278,213504,3407,490608,704112
test,2652,134,102912,792,114048,216960
test,2653,394,302592,6842,985248,1287840
test,2654,178,136704,1397,201168,337872
test,2655,496,380928,10843,1561392,1942320
test,2656,399,306432,7017,1010448,1316880
test,2657,263,201984,3049,439056,641040
test,2658,315,241920,4374,629856,871776
test,2659,147,112896,953,137232,250128
test,2660,462,354816,9408,1354752,1709568
test,2661,462,354816,9408,1354752,1709568
test,2662,320,245760,4514,650016,895776
test,2663,109,83712,524,75456,159168
test,2664,263,201984,3049,439056,641040
test,2665,403,309504,7158,1030752,1340256
test,2666,142,109056,889,128016,237072
test,2667,257,197376,2911,419184,616560
test,2668,153,117504,1032,148608,266112
test,2669,357,274176,5618,808992,1083168
test,2670,307,235776,4154,598176,833952
test,2671,304,233472,4074,586656,820128
test,2672,186,142848,1525,219600,362448
test,2673,735,564480,19462,2802528,3367008
test,2674,185,142080,1509,217296,359376
test,2675,89,68352,350,50400,118752
test,2676,164,125952,1186,170784,296736
test,2677,200,153600,1763,253872,407472
test,2678,477,366336,10028,1444032,1810368
test,2679,325,249600,4656,670464,920064
test,2680,310,238080,4236,609984,848064
test,2681,167,128256,1230,177120,305376
test,2682,397,304896,6947,1000368,1305264
test,2683,350,268800,5399,777456,1046256
test,2684,197,151296,1711,246384,397680
test,2685,385,295680,6533,940752,1236432
test,2686,156,119808,1073,154512,274320
test,2687,274,210432,3309,476496,686928
test,2688,203,155904,1817,261648,417552
test,2689,400,307200,7052,1015488,1322688
test,2690,96,73728,407,58608,132336
test,2691,355,272640,5555,799920,1072560
test,2692,425,326400,7961,1146384,1472784
test,2693,259,198912,2957,425808,624720
test,2694,343,263424,5186,746784,1010208
test,2695,348,267264,5338,768672,1035936
test,2696,361,277248,5744,827136,1104384
test,2697,338,259584,5036,725184,984768
test,2698,274,210432,3309,476496,686928
test,2699,359,275712,5681,818064,1093776
test,2700,265,203520,3096,445824,649344
test,2701,351,269568,5430,781920,1051488
test,2702,551,423168,12698,1828512,2251680
test,2703,315,241920,4374,629856,871776
test,2704,437,335616,8417,1212048,1547664
test,2705,230,176640,2332,335808,512448
test,2706,83,63744,304,43776,107520
test,2707,269,206592,3190,459360,665952
test,2708,300,230400,3967,571248,801648
test,2709,256,196608,2889,416016,612624
test,2710,263,201984,3049,439056,641040
test,2711,253,194304,2822,406368,600672
test,2712,63,48384,175,25200,73584
test,2713,296,227328,3862,556128,783456
test,2714,184,141312,1493,214992,356304
test,2715,311,238848,4263,613872,852720
test,2716,264,202752,3072,442368,645120
test,2717,396,304128,6912,995328,1299456
test,2718,459,352512,9286,1337184,1689696
test,2719,219,168192,2114,304416,472608
test,2720,442,339456,8611,1239984,1579440
test,2721,588,451584,13939,2007216,2458800
test,2722,651,499968,16330,2351520,2851488
test,2723,349,268032,5369,773136,1041168
test,2724,331,254208,4829,695376,949584
test,2725,136,104448,816,117504,221952
test,2726,166,127488,1215,174960,302448
test,2727,390,299520,6704,965376,1264896
test,2728,679,521472,17505,2520720,3042192
test,2729,324,248832,4627,666288,915120
test,2730,387,297216,6601,950544,1247760
test,2731,241,185088,2560,368640,553728
test,2732,87,66816,334,48096,114912
test,2733,63,48384,175,25200,73584
test,2734,497,381696,10887,1567728,1949424
test,2735,235,180480,2434,350496,530976
test,2736,297,228096,3888,559872,787968
test,2737,285,218880,3580,515520,734400
test,2738,159,122112,1115,160560,282672
test,2739,211,162048,1963,282672,444720
test,2740,425,326400,7961,1146384,1472784
test,2741,263,201984,3049,439056,641040
test,2742,313,240384,4318,621792,862176
test,2743,349,268032,5369,773136,1041168
test,2744,448,344064,8846,1273824,1617888
test,2745,225,172800,2232,321408,494208
test,2746,361,277248,5744,827136,1104384
test,2747,371,284928,6067,873648,1158576
test,2748,228,175104,2292,330048,505152
test,2749,74,56832,242,34848,91680
test,2750,185,142080,1509,217296,359376
test,2751,534,410112,12168,1752192,2162304
test,2752,392,301056,6773,975312,1276368
test,2753,156,119808,1073,154512,274320
test,2754,108,82944,515,74160,157104
test,2755,222,170496,2173,312912,483408
test,2756,106,81408,496,71424,152832
test,2757,89,68352,350,50400,118752
test,2758,484,371712,10325,1486800,1858512
test,2759,370,284160,6034,868896,1153056
test,2760,316,242688,4401,633744,876432
test,2761,58,44544,149,21456,66000
test,2762,174,133632,1335,192240,325872
test,2763,512,393216,11521,1659024,2052240
test,2764,127,97536,711,102384,199920
test,2765,494,379392,10756,1548864,1928256
test,2766,586,450048,13869,1997136,2447184
test,2767,294,225792,3810,548640,774432
test,2768,341,261888,5125,738000,999888
test,2769,432,331776,8226,1184544,1516320
test,2770,198,152064,1728,248832,400896
test,2771,202,155136,1799,259056,414192
test,2772,141,108288,877,126288,234576
test,2773,224,172032,2212,318528,490560
test,2774,208,159744,1907,274608,434352
test,2775,184,141312,1493,214992,356304
test,2776,493,378624,10713,1542672,1921296
test,2777,253,194304,2822,406368,600672
test,2778,177,135936,1381,198864,334800
test,2779,520,399360,11751,1692144,2091504
test,2780,375,288000,6198,892512,1180512
test,2781,276,211968,3358,483552,695520
test,2782,138,105984,840,120960,226944
test,2783,636,488448,15729,2264976,2753424
test,2784,189,145152,1575,226800,371952
test,2785,112,86016,553,79632,165648
test,2786,210,161280,1944,279936,441216
test,2787,230,176640,2332,335808,512448
test,2788,193,148224,1642,236448,384672
test,2789,183,140544,1476,212544,353088
test,2790,296,227328,3862,556128,783456
test,2791,187,143616,1542,222048,365664
test,2792,307,235776,4154,598176,833952
test,2793,98,75264,424,61056,136320
test,2794,296,227328,3862,556128,783456
test,2795,366,281088,5904,850176,1131264
test,2796,64,49152,181,26064,75216
test,2797,270,207360,3213,462672,670032
test,2798,249,191232,2733,393552,584784
test,2799,535,410880,12199,1756656,2167536
test,2800,382,293376,6432,926208,1219584
test,2801,308,236544,4181,602064,838608
test,2802,95,72960,398,57312,130272
test,2803,113,86784,563,81072,167856
test,2804,193,148224,1642,236448,384672
test,2805,247,189696,2689,387216,576912
test,2806,298,228864,3914,563616,792480
test,2807,148,113664,966,139104,252768
test,2808,177,135936,1381,198864,334800
test,2809,188,144384,1558,224352,368736
test,2810,295,226560,3836,552384,778944
test,2811,106,81408,496,71424,152832
test,2812,250,192000,2755,396720,588720
test,2813,186,142848,1525,219600,362448
test,2814,189,145152,1575,226800,371952
test,2815,109,83712,524,75456,159168
test,2816,136,104448,816,117504,221952
test,2817,292,224256,3758,541152,765408
test,2818,68,52224,204,29376,81600
test,2819,436,334848,8379,1206576,1541424
test,2820,389,298752,6670,960480,1259232
test,2821,283,217344,3530,508320,725664
test,2822,390,299520,6704,965376,1264896
test,2823,96,73728,407,58608,132336
test,2824,210,161280,1944,279936,441216
test,2825,161,123648,1143,164592,288240
test,2826,286,219648,3606,519264,738912
test,2827,450,345600,8925,1285200,1630800
test,2828,380,291840,6365,916560,1208400
test,2829,271,208128,3237,466128,674256
test,2830,366,281088,5904,850176,1131264
test,2831,315,241920,4374,629856,871776
test,2832,164,125952,1186,170784,296736
test,2833,151,115968,1005,144720,260688
test,2834,259,198912,2957,425808,624720
test,2835,272,208896,3261,469584,678480
test,2836,255,195840,2866,412704,608544
test,2837,423,324864,7887,1135728,1460592
test,2838,88,67584,342,49248,116832
test,2839,202,155136,1799,259056,414192
test,2840,332,254976,4858,699552,954528
test,2841,472,362496,9819,1413936,1776432
test,2842,260,199680,2980,429120,628800
test,2843,171,131328,1289,185616,316944
test,2844,517,397056,11664,1679616,2076672
test,2845,340,261120,5095,733680,994800
test,2846,309,237312,4209,606096,843408
test,2847,450,345600,8925,1285200,1630800
test,2848,282,216576,3505,504720,721296
test,2849,71,54528,223,32112,86640
test,2850,280,215040,3456,497664,712704
test,2851,258,198144,2934,422496,620640
test,2852,360,276480,5712,822528,1099008
test,2853,151,115968,1005,144720,260688
test,2854,338,259584,5036,725184,984768
test,2855,362,278016,5776,831744,1109760
test,2856,141,108288,877,126288,234576
test,2857,249,191232,2733,393552,584784
test,2858,343,263424,5186,746784,1010208
test,2859,171,131328,1289,185616,316944
test,2860,417,320256,7664,1103616,1423872
test,2861,369,283392,6002,864288,1147680
test,2862,395,303360,6877,990288,1293648
test,2863,368,282624,5969,859536,1142160
test,2864,310,238080,4236,609984,848064
test,2865,79,60672,276,39744,100416
test,2866,432,331776,8226,1184544,1516320
test,2867,237,182016,2476,356544,538560
test,2868,122,93696,656,94464,188160
test,2869,293,225024,3784,544896,769920
test,2870,337,258816,5006,720864,979680
test,2871,136,104448,816,117504,221952
test,2872,281,215808,3481,501264,717072
test,2873,339,260352,5065,729360,989712
test,2874,114,87552,573,82512,170064
test,2875,301,231168,3994,575136,806304
test,2876,281,215808,3481,501264,717072
test,2877,241,185088,2560,368640,553728
test,2878,370,284160,6034,868896,1153056
test,2879,290,222720,3707,533808,756528
test,2880,224,172032,2212,318528,490560
test,2881,263,201984,3049,439056,641040
test,2882,481,369408,10197,1468368,1837776
test,2883,190,145920,1592,229248,375168
test,2884,403,309504,7158,1030752,1340256
test,2885,294,225792,3810,548640,774432
test,2886,250,192000,2755,396720,588720
test,2887,352,270336,5461,786384,1056720
test,2888,361,277248,5744,827136,1104384
test,2889,500,384000,11019,1586736,1970736
test,2890,235,180480,2434,350496,530976
test,2891,124,95232,678,97632,192864
test,2892,180,138240,1428,205632,343872
test,2893,291,223488,3733,537552,761040
test,2894,173,132864,1320,190080,322944
test,2895,334,256512,4917,708048,964560
test,2896,289,221952,3682,530208,752160
test,2897,208,159744,1907,274608,434352
test,2898,230,176640,2332,335808,512448
test,2899,335,257280,4947,712368,969648
test,2900,302,231936,4020,578880,810816
test,2901,104,79872,477,68688,148560
test,2902,285,218880,3580,515520,734400
test,2903,290,222720,3707,533808,756528
test,2904,334,256512,4917,708048,964560
test,2905,333,255744,4888,703872,959616
test,2906,313,240384,4318,621792,862176
test,2907,302,231936,4020,578880,810816
test,2908,76,58368,255,36720,95088
test,2909,150,115200,992,142848,258048
test,2910,303,232704,4047,582768,815472
test,2911,250,192000,2755,396720,588720
test,2912,74,56832,242,34848,91680
test,2913,497,381696,10887,1567728,1949424
test,2914,428,328704,8074,1162656,1491360
test,2915,379,291072,6331,911664,1202736
test,2916,376,288768,6231,897264,1186032
test,2917,404,310272,7194,1035936,1346208
test,2918,137,105216,828,119232,224448
test,2919,361,277248,5744,827136,1104384
test,2920,145,111360,927,133488,244848
test,2921,279,214272,3431,494064,708336
test,2922,234,179712,2414,347616,527328
test,2923,480,368640,10155,1462320,1830960
test,2924,319,244992,4485,645840,890832
test,2925,127,97536,711,102384,199920
test,2926,485,372480,10368,1492992,1865472
test,2927,282,216576,3505,504720,721296
test,2928,298,228864,3914,563616,792480
test,2929,258,198144,2934,422496,620640
test,2930,280,215040,3456,497664,712704
test,2931,378,290304,6298,906912,1197216
test,2932,346,265728,5277,759888,1025616
test,2933,250,192000,2755,396720,588720
test,2934,282,216576,3505,504720,721296
test,2935,371,284928,6067,873648,1158576
test,2936,483,370944,10282,1480608,1851552
test,2937,271,208128,3237,466128,674256
test,2938,289,221952,3682,530208,752160
test,2939,250,192000,2755,396720,588720
test,2940,150,115200,992,142848,258048
test,2941,215,165120,2038,293472,458592
test,2942,308,236544,4181,602064,838608
test,2943,143,109824,902,129888,239712
test,2944,317,243456,4429,637776,881232
test,2945,446,342528,8767,1262448,1604976
test,2946,205,157440,1853,266832,424272
test,2947,108,82944,515,74160,157104
test,2948,490,376320,10583,1523952,1900272
test,2949,87,66816,334,48096,114912
test,2950,202,155136,1799,259056,414192
test,2951,601,461568,14404,2074176,2535744
test,2952,507,389376,11330,1631520,2020896
test,2953,407,312576,7301,1051344,1363920
test,2954,116,89088,594,85536,174624
test,2955,348,267264,5338,768672,1035936
test,2956,295,226560,3836,552384,778944
test,2957,242,185856,2582,371808,557664
test,2958,302,231936,4020,578880,810816
test,2959,163,125184,1171,168624,293808
test,2960,341,261888,5125,738000,999888
test,2961,203,155904,1817,261648,417552
test,2962,326,250368,4684,674496,924864
test,2963,206,158208,1871,269424,427632
test,2964,195,149760,1676,241344,391104
test,2965,403,309504,7158,1030752,1340256
test,2966,215,165120,2038,293472,458592
test,2967,460,353280,9326,1342944,1696224
test,2968,376,288768,6231,897264,1186032
test,2969,339,260352,5065,729360,989712
test,2970,168,129024,1244,179136,308160
test,2971,336,258048,4976,716544,974592
test,2972,326,250368,4684,674496,924864
test,2973,350,268800,5399,777456,1046256
test,2974,143,109824,902,129888,239712
test,2975,83,63744,304,43776,107520
test,2976,355,272640,5555,799920,1072560
test,2977,178,136704,1397,201168,337872
test,2978,140,107520,864,124416,231936
test,2979,84,64512,311,44784,109296
test,2980,371,284928,6067,873648,1158576
test,2981,329,252672,4771,687024,939696
test,2982,126,96768,700,100800,197568
test,2983,298,228864,3914,563616,792480
test,2984,170,130560,1274,183456,314016
test,2985,219,168192,2114,304416,472608
test,2986,220,168960,2134,307296,476256
test,2987,456,350208,9165,1319760,1669968
test,2988,743,570624,19717,2839248,3409872
test,2989,227,174336,2272,327168,501504
test,2990,354,271872,5524,795456,1067328
test,2991,79,60672,276,39744,100416
test,2992,249,191232,2733,393552,584784
test,2993,195,149760,1676,241344,391104
test,2994,331,254208,4829,695376,949584
test,2995,616,473088,14959,2154096,2627184
test,2996,302,231936,4020,578880,810816
test,2997,376,288768,6231,897264,1186032
test,2998,139,106752,852,122688,229440
test,2999,357,274176,5618,808992,1083168
test,3000,269,206592,3190,459360,665952
test,3001,289,221952,3682,530208,752160
test,3002,298,228864,3914,563616,792480
test,3003,334,256512,4917,708048,964560
test,3004,368,282624,5969,859536,1142160
test,3005,142,109056,889,128016,237072
test,3006,192,147456,1625,234000,381456
test,3007,74,56832,242,34848,91680
test,3008,355,272640,5555,799920,1072560
test,3009,121,92928,646,93024,185952
test,3010,85,65280,319,45936,111216
test,3011,261,200448,3003,432432,632880
test,3012,309,237312,4209,606096,843408
test,3013,331,254208,4829,695376,949584
test,3014,192,147456,1625,234000,381456
test,3015,358,274944,5649,813456,1088400
test,3016,315,241920,4374,629856,871776
test,3017,318,244224,4457,641808,886032
test,3018,233,178944,2393,344592,523536
test,3019,337,258816,5006,720864,979680
test,3020,467,358656,9612,1384128,1742784
test,3021,358,274944,5649,813456,1088400
test,3022,518,397824,11693,1683792,2081616
test,3023,273,209664,3285,473040,682704
test,3024,320,245760,4514,650016,895776
test,3025,233,178944,2393,344592,523536
test,3026,282,216576,3505,504720,721296
test,3027,240,184320,2539,365616,549936
test,3028,258,198144,2934,422496,620640
test,3029,408,313344,7337,1056528,1369872
test,3030,367,281856,5937,854928,1136784
test,3031,209,160512,1926,277344,437856
test,3032,186,142848,1525,219600,362448
test,3033,178,136704,1397,201168,337872
test,3034,132,101376,768,110592,211968
test,3035,445,341760,8728,1256832,1598592
test,3036,372,285696,6100,878400,1164096
test,3037,335,257280,4947,712368,969648
test,3038,213,163584,2000,288000,451584
test,3039,195,149760,1676,241344,391104
test,3040,241,185088,2560,368640,553728
test,3041,225,172800,2232,321408,494208
test,3042,259,198912,2957,425808,624720
test,3043,208,159744,1907,274608,434352
test,3044,443,340224,8650,1245600,1585824
test,3045,476,365568,9986,1437984,1803552
test,3046,348,267264,5338,768672,1035936
test,3047,267,205056,3142,452448,657504
test,3048,380,291840,6365,916560,1208400
test,3049,414,317952,7555,1087920,1405872
test,3050,211,162048,1963,282672,444720
test,3051,315,241920,4374,629856,871776
test,3052,236,181248,2455,353520,534768
test,3053,69,52992,210,30240,83232
test,3054,219,168192,2114,304416,472608
test,3055,521,400128,11781,1696464,2096592
test,3056,177,135936,1381,198864,334800
test,3057,539,413952,12322,1774368,2188320
test,3058,170,130560,1274,183456,314016
test,3059,66,50688,192,27648,78336
test,3060,544,417792,12477,1796688,2214480
test,3061,222,170496,2173,312912,483408
test,3062,206,158208,1871,269424,427632
test,3063,344,264192,5216,751104,1015296
test,3064,179,137472,1413,203472,340944
test,3065,259,198912,2957,425808,624720
test,3066,551,423168,12698,1828512,2251680
test,3067,194,148992,1659,238896,387888
test,3068,429,329472,8112,1168128,1497600
test,3069,96,73728,407,58608,132336
test,3070,405,311040,7230,1041120,1352160
test,3071,150,115200,992,142848,258048
test,3072,255,195840,2866,412704,608544
test,3073,396,304128,6912,995328,1299456
test,3074,417,320256,7664,1103616,1423872
test,3075,375,288000,6198,892512,1180512
test,3076,237,182016,2476,356544,538560
test,3077,158,121344,1101,158544,279888
test,3078,408,313344,7337,1056528,1369872
test,3079,319,244992,4485,645840,890832
test,3080,501,384768,11063,1593072,1977840
test,3081,477,366336,10028,1444032,1810368
test,3082,249,191232,2733,393552,584784
test,3083,486,373248,10410,1499040,1872288
test,3084,279,214272,3431,494064,708336
test,3085,363,278784,5808,836352,1115136
test,3086,267,205056,3142,452448,657504
test,3087,383,294144,6466,931104,1225248
test,3088,493,378624,10713,1542672,1921296
test,3089,286,219648,3606,519264,738912
test,3090,260,199680,2980,429120,628800
test,3091,460,353280,9326,1342944,1696224
test,3092,247,189696,2689,387216,576912
test,3093,268,205824,3166,455904,661728
test,3094,357,274176,5618,808992,1083168
test,3095,315,241920,4374,629856,871776
test,3096,233,178944,2393,344592,523536
test,3097,419,321792,7738,1114272,1436064
test,3098,150,115200,992,142848,258048
test,3099,411,315648,7445,1072080,1387728
test,3100,332,254976,4858,699552,954528
test,3101,272,208896,3261,469584,678480
test,3102,365,280320,5872,845568,1125888
test,3103,239,183552,2518,362592,546144
test,3104,190,145920,1592,229248,375168
test,3105,286,219648,3606,519264,738912
test,3106,334,256512,4917,708048,964560
test,3107,284,218112,3555,511920,730032
test,3108,223,171264,2192,315648,486912
test,3109,116,89088,594,85536,174624
test,3110,297,228096,3888,559872,787968
test,3111,214,164352,2019,290736,455088
test,3112,393,301824,6808,980352,1282176
test,3113,125,96000,689,99216,195216
test,3114,175,134400,1350,194400,328800
test,3115,232,178176,2373,341712,519888
test,3116,354,271872,5524,795456,1067328
test,3117,224,172032,2212,318528,490560
test,3118,204,156672,1835,264240,420912
test,3119,58,44544,149,21456,66000
test,3120,43,33024,82,11808,44832
test,3121,129,99072,734,105696,204768
test,3122,320,245760,4514,650016,895776
test,3123,220,168960,2134,307296,476256
test,3124,342,262656,5155,742320,1004976
test,3125,85,65280,319,45936,111216
test,3126,254,195072,2844,409536,604608
test,3127,368,282624,5969,859536,1142160
test,3128,155,119040,1059,152496,271536
test,3129,349,268032,5369,773136,1041168
test,3130,294,225792,3810,548640,774432
test,3131,343,263424,5186,746784,1010208
test,3132,176,135168,1366,196704,331872
test,3133,411,315648,7445,1072080,1387728
test,3134,291,223488,3733,537552,761040
test,3135,198,152064,1728,248832,400896
test,3136,332,254976,4858,699552,954528
test,3137,346,265728,5277,759888,1025616
test,3138,407,312576,7301,1051344,1363920
test,3139,251,192768,2777,399888,592656
test,3140,298,228864,3914,563616,792480
test,3141,77,59136,262,37728,96864
test,3142,314,241152,4346,625824,866976
test,3143,121,92928,646,93024,185952
test,3144,342,262656,5155,742320,1004976
test,3145,376,288768,6231,897264,1186032
test,3146,161,123648,1143,164592,288240
test,3147,367,281856,5937,854928,1136784
test,3148,85,65280,319,45936,111216
test,3149,533,409344,12138,1747872,2157216
test,3150,562,431616,13055,1879920,2311536
test,3151,320,245760,4514,650016,895776
test,3152,212,162816,1981,285264,448080
test,3153,348,267264,5338,768672,1035936
test,3154,359,275712,5681,818064,1093776
test,3155,154,118272,1046,150624,268896
test,3156,345,264960,5246,755424,1020384
test,3157,375,288000,6198,892512,1180512
test,3158,177,135936,1381,198864,334800
test,3159,77,59136,262,37728,96864
test,3160,692,531456,18074,2602656,3134112
test,3161,293,225024,3784,544896,769920
test,3162,133,102144,780,112320,214464
test,3163,380,291840,6365,916560,1208400
test,3164,493,378624,10713,1542672,1921296
test,3165,321,246528,4542,654048,900576
test,3166,379,291072,6331,911664,1202736
test,3167,307,235776,4154,598176,833952
test,3168,346,265728,5277,759888,1025616
test,3169,109,83712,524,75456,159168
test,3170,164,125952,1186,170784,296736
test,3171,241,185088,2560,368640,553728
test,3172,153,117504,1032,148608,266112
test,3173,123,94464,667,96048,190512
test,3174,99,76032,432,62208,138240
test,3175,460,353280,9326,1342944,1696224
test,3176,350,268800,5399,777456,1046256
test,3177,430,330240,8150,1173600,1503840
test,3178,323,248064,4599,662256,910320
test,3179,454,348672,9085,1308240,1656912
test,3180,197,151296,1711,246384,397680
test,3181,307,235776,4154,598176,833952
test,3182,416,319488,7628,1098432,1417920
test,3183,285,218880,3580,515520,734400
test,3184,219,168192,2114,304416,472608
test,3185,81,62208,290,41760,103968
test,3186,449,344832,8886,1279584,1624416
test,3187,279,214272,3431,494064,708336
test,3188,430,330240,8150,1173600,1503840
test,3189,125,96000,689,99216,195216
test,3190,114,87552,573,82512,170064
test,3191,498,382464,10931,1574064,1956528
test,3192,130,99840,745,107280,207120
test,3193,499,383232,10975,1580400,1963632
test,3194,220,168960,2134,307296,476256
test,3195,66,50688,192,27648,78336
test,3196,344,264192,5216,751104,1015296
test,3197,146,112128,940,135360,247488
test,3198,344,264192,5216,751104,1015296
test,3199,377,289536,6265,902160,1191696
test,3200,355,272640,5555,799920,1072560
test,3201,150,115200,992,142848,258048
test,3202,281,215808,3481,501264,717072
test,3203,308,236544,4181,602064,838608
test,3204,229,175872,2312,332928,508800
test,3205,155,119040,1059,152496,271536
test,3206,183,140544,1476,212544,353088
test,3207,227,174336,2272,327168,501504
test,3208,257,197376,2911,419184,616560
test,3209,337,258816,5006,720864,979680
test,3210,341,261888,5125,738000,999888
test,3211,200,153600,1763,253872,407472
test,3212,437,335616,8417,1212048,1547664
test,3213,263,201984,3049,439056,641040
test,3214,299,229632,3941,567504,797136
test,3215,117,89856,604,86976,176832
test,3216,182,139776,1460,210240,350016
test,3217,420,322560,7775,1119600,1442160
test,3218,331,254208,4829,695376,949584
test,3219,351,269568,5430,781920,1051488
test,3220,391,300288,6738,970272,1270560
test,3221,311,238848,4263,613872,852720
test,3222,408,313344,7337,1056528,1369872
test,3223,240,184320,2539,365616,549936
test,3224,416,319488,7628,1098432,1417920
test,3225,125,96000,689,99216,195216
test,3226,239,183552,2518,362592,546144
test,3227,409,314112,7373,1061712,1375824
test,3228,121,92928,646,93024,185952
test,3229,482,370176,10240,1474560,1844736
test,3230,204,156672,1835,264240,420912
test,3231,279,214272,3431,494064,708336
test,3232,308,236544,4181,602064,838608
test,3233,324,248832,4627,666288,915120
test,3234,298,228864,3914,563616,792480
test,3235,233,178944,2393,344592,523536
test,3236,108,82944,515,74160,157104
test,3237,311,238848,4263,613872,852720
test,3238,138,105984,840,120960,226944
test,3239,463,355584,9448,1360512,1716096
test,3240,55,42240,134,19296,61536
test,3241,318,244224,4457,641808,886032
test,3242,92,70656,373,53712,124368
test,3243,280,215040,3456,497664,712704
test,3244,256,196608,2889,416016,612624
test,3245,186,142848,1525,219600,362448
test,3246,432,331776,8226,1184544,1516320
test,3247,252,193536,2799,403056,596592
test,3248,405,311040,7230,1041120,1352160
test,3249,188,144384,1558,224352,368736
test,3250,296,227328,3862,556128,783456
test,3251,301,231168,3994,575136,806304
test,3252,186,142848,1525,219600,362448
test,3253,216,165888,2057,296208,462096
test,3254,256,196608,2889,416016,612624
test,3255,354,271872,5524,795456,1067328
test,3256,120,92160,635,91440,183600
test,3257,299,229632,3941,567504,797136
test,3258,78,59904,269,38736,98640
test,3259,204,156672,1835,264240,420912
test,3260,298,228864,3914,563616,792480
test,3261,395,303360,6877,990288,1293648
test,3262,124,95232,678,97632,192864
test,3263,422,324096,7849,1130256,1454352
test,3264,233,178944,2393,344592,523536
test,3265,620,476160,15110,2175840,2652000
test,3266,308,236544,4181,602064,838608
test,3267,92,70656,373,53712,124368
test,3268,270,207360,3213,462672,670032
test,3269,224,172032,2212,318528,490560
test,3270,378,290304,6298,906912,1197216
test,3271,185,142080,1509,217296,359376
test,3272,191,146688,1608,231552,378240
test,3273,341,261888,5125,738000,999888
test,3274,406,311808,7265,1046160,1357968
test,3275,489,375552,10539,1517616,1893168
test,3276,245,188160,2646,381024,569184
test,3277,269,206592,3190,459360,665952
test,3278,162,124416,1157,166608,291024
test,3279,155,119040,1059,152496,271536
test,3280,364,279552,5840,840960,1120512
test,3281,363,278784,5808,836352,1115136
test,3282,203,155904,1817,261648,417552
test,3283,208,159744,1907,274608,434352
test,3284,431,331008,8188,1179072,1510080
test,3285,376,288768,6231,897264,1186032
test,3286,262,201216,3026,435744,636960
test,3287,493,378624,10713,1542672,1921296
test,3288,538,413184,12291,1769904,2183088
test,3289,139,106752,852,122688,229440
test,3290,249,191232,2733,393552,584784
test,3291,378,290304,6298,906912,1197216
test,3292,242,185856,2582,371808,557664
test,3293,209,160512,1926,277344,437856
test,3294,350,268800,5399,777456,1046256
test,3295,379,291072,6331,911664,1202736
test,3296,100,76800,441,63504,140304
test,3297,218,167424,2095,301680,469104
test,3298,382,293376,6432,926208,1219584
test,3299,259,198912,2957,425808,624720
test,3300,413,317184,7518,1082592,1399776
test,3301,83,63744,304,43776,107520
test,3302,442,339456,8611,1239984,1579440
test,3303,365,280320,5872,845568,1125888
test,3304,348,267264,5338,768672,1035936
test,3305,124,95232,678,97632,192864
test,3306,126,96768,700,100800,197568
test,3307,275,211200,3334,480096,691296
test,3308,308,236544,4181,602064,838608
test,3309,322,247296,4570,658080,905376
test,3310,392,301056,6773,975312,1276368
test,3311,204,156672,1835,264240,420912
test,3312,389,298752,6670,960480,1259232
test,3313,266,204288,3119,449136,653424
test,3314,378,290304,6298,906912,1197216
test,3315,184,141312,1493,214992,356304
test,3316,188,144384,1558,224352,368736
test,3317,429,329472,8112,1168128,1497600
test,3318,188,144384,1558,224352,368736
test,3319,172,132096,1304,187776,319872
test,3320,197,151296,1711,246384,397680
test,3321,333,255744,4888,703872,959616
test,3322,129,99072,734,105696,204768
test,3323,189,145152,1575,226800,371952
test,3324,168,129024,1244,179136,308160
test,3325,343,263424,5186,746784,1010208
test,3326,359,275712,5681,818064,1093776
test,3327,255,195840,2866,412704,608544
test,3328,78,59904,269,38736,98640
test,3329,113,86784,563,81072,167856
test,3330,269,206592,3190,459360,665952
test,3331,401,307968,7088,1020672,1328640
test,3332,203,155904,1817,261648,417552
test,3333,269,206592,3190,459360,665952
test,3334,253,194304,2822,406368,600672
test,3335,175,134400,1350,194400,328800
test,3336,88,67584,342,49248,116832
test,3337,313,240384,4318,621792,862176
test,3338,442,339456,8611,1239984,1579440
test,3339,270,207360,3213,462672,670032
test,3340,169,129792,1259,181296,311088
test,3341,208,159744,1907,274608,434352
test,3342,294,225792,3810,548640,774432
test,3343,331,254208,4829,695376,949584
test,3344,473,363264,9861,1419984,1783248
test,3345,144,110592,914,131616,242208
test,3346,107,82176,505,72720,154896
test,3347,155,119040,1059,152496,271536
test,3348,329,252672,4771,687024,939696
test,3349,112,86016,553,79632,165648
test,3350,196,150528,1694,243936,394464
test,3351,257,197376,2911,419184,616560
test,3352,281,215808,3481,501264,717072
test,3353,487,374016,10453,1505232,1879248
test,3354,212,162816,1981,285264,448080
test,3355,222,170496,2173,312912,483408
test,3356,172,132096,1304,187776,319872
test,3357,191,146688,1608,231552,378240
test,3358,104,79872,477,68688,148560
test,3359,260,199680,2980,429120,628800
test,3360,217,166656,2076,298944,465600
test,3361,76,58368,255,36720,95088
test,3362,81,62208,290,41760,103968
test,3363,365,280320,5872,845568,1125888
test,3364,395,303360,6877,990288,1293648
test,3365,168,129024,1244,179136,308160
test,3366,191,146688,1608,231552,378240
test,3367,163,125184,1171,168624,293808
test,3368,96,73728,407,58608,132336
test,3369,254,195072,2844,409536,604608
test,3370,368,282624,5969,859536,1142160
test,3371,223,171264,2192,315648,486912
test,3372,260,199680,2980,429120,628800
test,3373,265,203520,3096,445824,649344
test,3374,112,86016,553,79632,165648
test,3375,273,209664,3285,473040,682704
test,3376,508,390144,11374,1637856,2028000
test,3377,561,430848,13022,1875168,2306016
test,3378,331,254208,4829,695376,949584
test,3379,255,195840,2866,412704,608544
test,3380,183,140544,1476,212544,353088
test,3381,313,240384,4318,621792,862176
test,3382,269,206592,3190,459360,665952
test,3383,470,360960,9736,1401984,1762944
test,3384,253,194304,2822,406368,600672
test,3385,158,121344,1101,158544,279888
test,3386,364,279552,5840,840960,1120512
test,3387,171,131328,1289,185616,316944
test,3388,334,256512,4917,708048,964560
test,3389,325,249600,4656,670464,920064
test,3390,381,292608,6398,921312,1213920
test,3391,141,108288,877,126288,234576
test,3392,146,112128,940,135360,247488
test,3393,294,225792,3810,548640,774432
test,3394,445,341760,8728,1256832,1598592
test,3395,214,164352,2019,290736,455088
test,3396,158,121344,1101,158544,279888
test,3397,213,163584,2000,288000,451584
test,3398,258,198144,2934,422496,620640
test,3399,201,154368,1781,256464,410832
test,3400,93,71424,382,55008,126432
test,3401,358,274944,5649,813456,1088400
test,3402,224,172032,2212,318528,490560
test,3403,274,210432,3309,476496,686928
test,3404,79,60672,276,39744,100416
test,3405,339,260352,5065,729360,989712
test,3406,636,488448,15729,2264976,2753424
test,3407,257,197376,2911,419184,616560
test,3408,209,160512,1926,277344,437856
test,3409,464,356352,9489,1366416,1722768
test,3410,307,235776,4154,598176,833952
test,3411,286,219648,3606,519264,738912
test,3412,375,288000,6198,892512,1180512
test,3413,503,386304,11152,1605888,1992192
test,3414,273,209664,3285,473040,682704
test,3415,147,112896,953,137232,250128
test,3416,152,116736,1019,146736,263472
test,3417,273,209664,3285,473040,682704
test,3418,400,307200,7052,1015488,1322688
test,3419,363,278784,5808,836352,1115136
test,3420,419,321792,7738,1114272,1436064
test,3421,462,354816,9408,1354752,1709568
test,3422,135,103680,804,115776,219456
test,3423,603,463104,14477,2084688,2547792
test,3424,194,148992,1659,238896,387888
test,3425,220,168960,2134,307296,476256
test,3426,364,279552,5840,840960,1120512
test,3427,127,97536,711,102384,199920
test,3428,398,305664,6982,1005408,1311072
test,3429,264,202752,3072,442368,645120
test,3430,389,298752,6670,960480,1259232
test,3431,150,115200,992,142848,258048
test,3432,149,114432,979,140976,255408
test,3433,60,46080,159,22896,68976
test,3434,297,228096,3888,559872,787968
test,3435,271,208128,3237,466128,674256
test,3436,366,281088,5904,850176,1131264
test,3437,315,241920,4374,629856,871776
test,3438,205,157440,1853,266832,424272
test,3439,355,272640,5555,799920,1072560
test,3440,717,550656,18910,2723040,3273696
test,3441,201,154368,1781,256464,410832
test,3442,285,218880,3580,515520,734400
test,3443,403,309504,7158,1030752,1340256
test,3444,194,148992,1659,238896,387888
test,3445,463,355584,9448,1360512,1716096
test,3446,306,235008,4127,594288,829296
test,3447,193,148224,1642,236448,384672
test,3448,270,207360,3213,462672,670032
test,3449,194,148992,1659,238896,387888
test,3450,363,278784,5808,836352,1115136
test,3451,322,247296,4570,658080,905376
test,3452,203,155904,1817,261648,417552
test,3453,481,369408,10197,1468368,1837776
test,3454,135,103680,804,115776,219456
test,3455,302,231936,4020,578880,810816
test,3456,425,326400,7961,1146384,1472784
test,3457,206,158208,1871,269424,427632
test,3458,430,330240,8150,1173600,1503840
test,3459,349,268032,5369,773136,1041168
test,3460,141,108288,877,126288,234576
test,3461,329,252672,4771,687024,939696
test,3462,351,269568,5430,781920,1051488
test,3463,199,152832,1746,251424,404256
test,3464,598,459264,14295,2058480,2517744
test,3465,246,188928,2668,384192,573120
test,3466,404,310272,7194,1035936,1346208
test,3467,483,370944,10282,1480608,1851552
test,3468,212,162816,1981,285264,448080
test,3469,318,244224,4457,641808,886032
test,3470,234,179712,2414,347616,527328
test,3471,303,232704,4047,582768,815472
test,3472,279,214272,3431,494064,708336
test,3473,427,327936,8036,1157184,1485120
test,3474,197,151296,1711,246384,397680
test,3475,465,357120,9530,1372320,1729440
test,3476,262,201216,3026,435744,636960
test,3477,260,199680,2980,429120,628800
test,3478,137,105216,828,119232,224448
test,3479,68,52224,204,29376,81600
test,3480,322,247296,4570,658080,905376
test,3481,297,228096,3888,559872,787968
test,3482,273,209664,3285,473040,682704
test,3483,297,228096,3888,559872,787968
test,3484,214,164352,2019,290736,455088
test,3485,134,102912,792,114048,216960
test,3486,369,283392,6002,864288,1147680
test,3487,228,175104,2292,330048,505152
test,3488,718,551424,18940,2727360,3278784
test,3489,138,105984,840,120960,226944
test,3490,423,324864,7887,1135728,1460592
test,3491,212,162816,1981,285264,448080
test,3492,294,225792,3810,548640,774432
test,3493,262,201216,3026,435744,636960
test,3494,556,427008,12859,1851696,2278704
test,3495,241,185088,2560,368640,553728
test,3496,175,134400,1350,194400,328800
test,3497,432,331776,8226,1184544,1516320
test,3498,518,397824,11693,1683792,2081616
test,3499,377,289536,6265,902160,1191696
test,3500,332,254976,4858,699552,954528
test,3501,286,219648,3606,519264,738912
test,3502,152,116736,1019,146736,263472
test,3503,201,154368,1781,256464,410832
test,3504,466,357888,9571,1378224,1736112
test,3505,416,319488,7628,1098432,1417920
test,3506,129,99072,734,105696,204768
test,3507,365,280320,5872,845568,1125888
test,3508,650,499200,16289,2345616,2844816
test,3509,425,326400,7961,1146384,1472784
test,3510,249,191232,2733,393552,584784
test,3511,284,218112,3555,511920,730032
test,3512,345,264960,5246,755424,1020384
test,3513,274,210432,3309,476496,686928
test,3514,213,163584,2000,288000,451584
test,3515,193,148224,1642,236448,384672
test,3516,391,300288,6738,970272,1270560
test,3517,125,96000,689,99216,195216
test,3518,96,73728,407,58608,132336
test,3519,310,238080,4236,609984,848064
test,3520,93,71424,382,55008,126432
test,3521,350,268800,5399,777456,1046256
test,3522,582,446976,13730,1977120,2424096
test,3523,174,133632,1335,192240,325872
test,3524,314,241152,4346,625824,866976
test,3525,132,101376,768,110592,211968
test,3526,235,180480,2434,350496,530976
test,3527,249,191232,2733,393552,584784
test,3528,511,392448,11492,1654848,2047296
test,3529,227,174336,2272,327168,501504
test,3530,378,290304,6298,906912,1197216
test,3531,196,150528,1694,243936,394464
test,3532,234,179712,2414,347616,527328
test,3533,85,65280,319,45936,111216
test,3534,433,332544,8264,1190016,1522560
test,3535,304,233472,4074,586656,820128
test,3536,323,248064,4599,662256,910320
test,3537,215,165120,2038,293472,458592
test,3538,349,268032,5369,773136,1041168
test,3539,276,211968,3358,483552,695520
test,3540,288,221184,3656,526464,747648
test,3541,106,81408,496,71424,152832
test,3542,123,94464,667,96048,190512
test,3543,227,174336,2272,327168,501504
test,3544,445,341760,8728,1256832,1598592
test,3545,332,254976,4858,699552,954528
test,3546,379,291072,6331,911664,1202736
test,3547,252,193536,2799,403056,596592
test,3548,188,144384,1558,224352,368736
test,3549,91,69888,365,52560,122448
test,3550,66,50688,192,27648,78336
test,3551,254,195072,2844,409536,604608
test,3552,427,327936,8036,1157184,1485120
test,3553,416,319488,7628,1098432,1417920
test,3554,249,191232,2733,393552,584784
test,3555,384,294912,6499,935856,1230768
test,3556,323,248064,4599,662256,910320
test,3557,271,208128,3237,466128,674256
test,3558,389,298752,6670,960480,1259232
test,3559,157,120576,1087,156528,277104
test,3560,36,27648,58,8352,36000
test,3561,312,239616,4291,617904,857520
test,3562,197,151296,1711,246384,397680
test,3563,244,187392,2624,377856,565248
test,3564,299,229632,3941,567504,797136
test,3565,654,502272,16452,2369088,2871360
test,3566,212,162816,1981,285264,448080
test,3567,168,129024,1244,179136,308160
test,3568,109,83712,524,75456,159168
test,3569,415,318720,7591,1093104,1411824
test,3570,288,221184,3656,526464,747648
test,3571,284,218112,3555,511920,730032
test,3572,304,233472,4074,586656,820128
test,3573,457,350976,9205,1325520,1676496
test,3574,367,281856,5937,854928,1136784
test,3575,145,111360,927,133488,244848
test,3576,244,187392,2624,377856,565248
test,3577,485,372480,10368,1492992,1865472
test,3578,363,278784,5808,836352,1115136
test,3579,126,96768,700,100800,197568
test,3580,183,140544,1476,212544,353088
test,3581,491,377088,10626,1530144,1907232
test,3582,327,251136,4713,678672,929808
test,3583,260,199680,2980,429120,628800
test,3584,156,119808,1073,154512,274320
test,3585,403,309504,7158,1030752,1340256
test,3586,188,144384,1558,224352,368736
test,3587,474,364032,9903,1426032,1790064
test,3588,158,121344,1101,158544,279888
test,3589,340,261120,5095,733680,994800
test,3590,196,150528,1694,243936,394464
test,3591,376,288768,6231,897264,1186032
test,3592,469,360192,9695,1396080,1756272
test,3593,309,237312,4209,606096,843408
test,3594,264,202752,3072,442368,645120
test,3595,303,232704,4047,582768,815472
test,3596,163,125184,1171,168624,293808
test,3597,437,335616,8417,1212048,1547664
test,3598,193,148224,1642,236448,384672
test,3599,482,370176,10240,1474560,1844736
test,3600,160,122880,1129,162576,285456
test,3601,643,493824,16007,2305008,2798832
test,3602,294,225792,3810,548640,774432
test,3603,282,216576,3505,504720,721296
test,3604,436,334848,8379,1206576,1541424
test,3605,163,125184,1171,168624,293808
test,3606,253,194304,2822,406368,600672
test,3607,348,267264,5338,768672,1035936
test,3608,346,265728,5277,759888,1025616
test,3609,447,343296,8807,1268208,1611504
test,3610,470,360960,9736,1401984,1762944
test,3611,172,132096,1304,187776,319872
test,3612,376,288768,6231,897264,1186032
test,3613,299,229632,3941,567504,797136
test,3614,275,211200,3334,480096,691296
test,3615,382,293376,6432,926208,1219584
test,3616,167,128256,1230,177120,305376
test,3617,289,221952,3682,530208,752160
test,3618,126,96768,700,100800,197568
test,3619,276,211968,3358,483552,695520
test,3620,115,88320,583,83952,172272
test,3621,428,328704,8074,1162656,1491360
test,3622,197,151296,1711,246384,397680
test,3623,278,213504,3407,490608,704112
test,3624,434,333312,8302,1195488,1528800
test,3625,84,64512,311,44784,109296
test,3626,176,135168,1366,196704,331872
test,3627,272,208896,3261,469584,678480
test,3628,183,140544,1476,212544,353088
test,3629,233,178944,2393,344592,523536
test,3630,395,303360,6877,990288,1293648
test,3631,394,302592,6842,985248,1287840
test,3632,305,234240,4100,590400,824640
test,3633,221,169728,2153,310032,479760
test,3634,324,248832,4627,666288,915120
test,3635,313,240384,4318,621792,862176
test,3636,210,161280,1944,279936,441216
test,3637,201,154368,1781,256464,410832
test,3638,521,400128,11781,1696464,2096592
test,3639,377,289536,6265,902160,1191696
test,3640,156,119808,1073,154512,274320
test,3641,215,165120,2038,293472,458592
test,3642,178,136704,1397,201168,337872
test,3643,511,392448,11492,1654848,2047296
test,3644,301,231168,3994,575136,806304
test,3645,279,214272,3431,494064,708336
test,3646,161,123648,1143,164592,288240
test,3647,426,327168,7999,1151856,1479024
test,3648,325,249600,4656,670464,920064
test,3649,471,361728,9778,1408032,1769760
test,3650,309,237312,4209,606096,843408
test,3651,272,208896,3261,469584,678480
test,3652,94,72192,390,56160,128352
test,3653,380,291840,6365,916560,1208400
test,3654,634,486912,15650,2253600,2740512
test,3655,215,165120,2038,293472,458592
test,3656,365,280320,5872,845568,1125888
test,3657,186,142848,1525,219600,362448
test,3658,173,132864,1320,190080,322944
test,3659,268,205824,3166,455904,661728
test,3660,159,122112,1115,160560,282672
test,3661,199,152832,1746,251424,404256
test,3662,277,212736,3382,487008,699744
test,3663,317,243456,4429,637776,881232
test,3664,161,123648,1143,164592,288240
test,3665,309,237312,4209,606096,843408
test,3666,255,195840,2866,412704,608544
test,3667,427,327936,8036,1157184,1485120
test,3668,126,96768,700,100800,197568
test,3669,327,251136,4713,678672,929808
test,3670,442,339456,8611,1239984,1579440
test,3671,63,48384,175,25200,73584
test,3672,238,182784,2497,359568,542352
test,3673,463,355584,9448,1360512,1716096
test,3674,500,384000,11019,1586736,1970736
test,3675,508,390144,11374,1637856,2028000
test,3676,177,135936,1381,198864,334800
test,3677,196,150528,1694,243936,394464
test,3678,213,163584,2000,288000,451584
test,3679,500,384000,11019,1586736,1970736
test,3680,373,286464,6132,883008,1169472
test,3681,198,152064,1728,248832,400896
test,3682,360,276480,5712,822528,1099008
test,3683,384,294912,6499,935856,1230768
test,3684,309,237312,4209,606096,843408
test,3685,306,235008,4127,594288,829296
test,3686,145,111360,927,133488,244848
test,3687,277,212736,3382,487008,699744
test,3688,85,65280,319,45936,111216
test,3689,433,332544,8264,1190016,1522560
test,3690,259,198912,2957,425808,624720
test,3691,204,156672,1835,264240,420912
test,3692,336,258048,4976,716544,974592
test,3693,249,191232,2733,393552,584784
test,3694,351,269568,5430,781920,1051488
test,3695,118,90624,614,88416,179040
test,3696,168,129024,1244,179136,308160
test,3697,716,549888,18880,2718720,3268608
test,3698,73,56064,235,33840,89904
test,3699,241,185088,2560,368640,553728
test,3700,332,254976,4858,699552,954528
test,3701,244,187392,2624,377856,565248
test,3702,348,267264,5338,768672,1035936
test,3703,198,152064,1728,248832,400896
test,3704,125,96000,689,99216,195216
test,3705,395,303360,6877,990288,1293648
test,3706,342,262656,5155,742320,1004976
test,3707,194,148992,1659,238896,387888
test,3708,340,261120,5095,733680,994800
test,3709,173,132864,1320,190080,322944
test,3710,229,175872,2312,332928,508800
test,3711,333,255744,4888,703872,959616
test,3712,256,196608,2889,416016,612624
test,3713,120,92160,635,91440,183600
test,3714,218,167424,2095,301680,469104
test,3715,576,442368,13523,1947312,2389680
test,3716,178,136704,1397,201168,337872
test,3717,309,237312,4209,606096,843408
test,3718,235,180480,2434,350496,530976
test,3719,441,338688,8572,1234368,1573056
test,3720,357,274176,5618,808992,1083168
test,3721,247,189696,2689,387216,576912
test,3722,578,443904,13592,1957248,2401152
test,3723,117,89856,604,86976,176832
test,3724,208,159744,1907,274608,434352
test,3725,177,135936,1381,198864,334800
test,3726,97,74496,415,59760,134256
test,3727,182,139776,1460,210240,350016
test,3728,269,206592,3190,459360,665952
test,3729,535,410880,12199,1756656,2167536
test,3730,110,84480,534,76896,161376
test,3731,354,271872,5524,795456,1067328
test,3732,260,199680,2980,429120,628800
test,3733,487,374016,10453,1505232,1879248
test,3734,308,236544,4181,602064,838608
test,3735,207,158976,1889,272016,430992
test,3736,433,332544,8264,1190016,1522560
test,3737,226,173568,2252,324288,497856
test,3738,102,78336,459,66096,144432
test,3739,353,271104,5492,790848,1061952
test,3740,293,225024,3784,544896,769920
test,3741,285,218880,3580,515520,734400
test,3742,411,315648,7445,1072080,1387728
test,3743,147,112896,953,137232,250128
test,3744,100,76800,441,63504,140304
test,3745,420,322560,7775,1119600,1442160
test,3746,92,70656,373,53712,124368
test,3747,162,124416,1157,166608,291024
test,3748,426,327168,7999,1151856,1479024
test,3749,177,135936,1381,198864,334800
test,3750,269,206592,3190,459360,665952
test,3751,173,132864,1320,190080,322944
test,3752,416,319488,7628,1098432,1417920
test,3753,218,167424,2095,301680,469104
test,3754,358,274944,5649,813456,1088400
test,3755,408,313344,7337,1056528,1369872
test,3756,325,249600,4656,670464,920064
test,3757,325,249600,4656,670464,920064
test,3758,229,175872,2312,332928,508800
test,3759,321,246528,4542,654048,900576
test,3760,253,194304,2822,406368,600672
test,3761,191,146688,1608,231552,378240
test,3762,257,197376,2912,419328,616704
test,3763,256,196608,2889,416016,612624
test,3764,108,82944,515,74160,157104
test,3765,225,172800,2232,321408,494208
test,3766,478,367104,10071,1450224,1817328
test,3767,255,195840,2866,412704,608544
test,3768,60,46080,159,22896,68976
test,3769,405,311040,7230,1041120,1352160
test,3770,252,193536,2799,403056,596592
test,3771,230,176640,2332,335808,512448
test,3772,116,89088,594,85536,174624
test,3773,238,182784,2497,359568,542352
test,3774,292,224256,3758,541152,765408
test,3775,223,171264,2192,315648,486912
test,3776,267,205056,3142,452448,657504
test,3777,153,117504,1032,148608,266112
test,3778,190,145920,1592,229248,375168
test,3779,176,135168,1366,196704,331872
test,3780,304,233472,4074,586656,820128
test,3781,99,76032,432,62208,138240
test,3782,193,148224,1642,236448,384672
test,3783,368,282624,5969,859536,1142160
test,3784,286,219648,3606,519264,738912
test,3785,195,149760,1676,241344,391104
test,3786,302,231936,4020,578880,810816
test,3787,475,364800,9945,1432080,1796880
test,3788,162,124416,1157,166608,291024
test,3789,250,192000,2755,396720,588720
test,3790,96,73728,407,58608,132336
test,3791,500,384000,11019,1586736,1970736
test,3792,142,109056,889,128016,237072
test,3793,194,148992,1659,238896,387888
test,3794,143,109824,902,129888,239712
test,3795,222,170496,2173,312912,483408
test,3796,68,52224,204,29376,81600
test,3797,216,165888,2057,296208,462096
test,3798,82,62976,297,42768,105744
test,3799,351,269568,5430,781920,1051488
test,3800,306,235008,4127,594288,829296
test,3801,235,180480,2434,350496,530976
test,3802,94,72192,390,56160,128352
test,3803,310,238080,4236,609984,848064
test,3804,339,260352,5065,729360,989712
test,3805,467,358656,9612,1384128,1742784
test,3806,196,150528,1694,243936,394464
test,3807,478,367104,10071,1450224,1817328
test,3808,458,351744,9246,1331424,1683168
test,3809,291,223488,3733,537552,761040
test,3810,280,215040,3456,497664,712704
test,3811,351,269568,5430,781920,1051488
test,3812,296,227328,3862,556128,783456
test,3813,78,59904,269,38736,98640
test,3814,197,151296,1711,246384,397680
test,3815,181,139008,1444,207936,346944
test,3816,516,396288,11635,1675440,2071728
test,3817,194,148992,1659,238896,387888
test,3818,308,236544,4181,602064,838608
test,3819,202,155136,1799,259056,414192
test,3820,352,270336,5461,786384,1056720
test,3821,141,108288,877,126288,234576
test,3822,333,255744,4888,703872,959616
test,3823,563,432384,13087,1884528,2316912
test,3824,197,151296,1711,246384,397680
test,3825,256,196608,2889,416016,612624
test,3826,203,155904,1817,261648,417552
test,3827,436,334848,8379,1206576,1541424
test,3828,140,107520,864,124416,231936
test,3829,240,184320,2539,365616,549936
test,3830,411,315648,7445,1072080,1387728
test,3831,392,301056,6773,975312,1276368
test,3832,219,168192,2114,304416,472608
test,3833,391,300288,6738,970272,1270560
test,3834,246,188928,2668,384192,573120
test,3835,263,201984,3049,439056,641040
test,3836,319,244992,4485,645840,890832
test,3837,201,154368,1781,256464,410832
test,3838,79,60672,276,39744,100416
test,3839,354,271872,5524,795456,1067328
test,3840,647,496896,16168,2328192,2825088
test,3841,313,240384,4318,621792,862176
test,3842,239,183552,2518,362592,546144
test,3843,152,116736,1019,146736,263472
test,3844,201,154368,1781,256464,410832
test,3845,245,188160,2646,381024,569184
test,3846,377,289536,6265,902160,1191696
test,3847,384,294912,6499,935856,1230768
test,3848,223,171264,2192,315648,486912
test,3849,200,153600,1763,253872,407472
test,3850,237,182016,2476,356544,538560
test,3851,423,324864,7887,1135728,1460592
test,3852,96,73728,407,58608,132336
test,3853,403,309504,7158,1030752,1340256
test,3854,122,93696,656,94464,188160
test,3855,100,76800,441,63504,140304
test,3856,462,354816,9408,1354752,1709568
test,3857,262,201216,3026,435744,636960
test,3858,100,76800,441,63504,140304
test,3859,345,264960,5246,755424,1020384
test,3860,118,90624,614,88416,179040
test,3861,418,321024,7701,1108944,1429968
test,3862,154,118272,1046,150624,268896
test,3863,251,192768,2777,399888,592656
test,3864,372,285696,6100,878400,1164096
test,3865,194,148992,1659,238896,387888
test,3866,102,78336,459,66096,144432
test,3867,329,252672,4771,687024,939696
test,3868,281,215808,3481,501264,717072
test,3869,395,303360,6877,990288,1293648
test,3870,331,254208,4829,695376,949584
test,3871,421,323328,7812,1124928,1448256
test,3872,193,148224,1642,236448,384672
test,3873,295,226560,3836,552384,778944
test,3874,474,364032,9903,1426032,1790064
test,3875,121,92928,646,93024,185952
test,3876,128,98304,723,104112,202416
test,3877,183,140544,1476,212544,353088
test,3878,104,79872,477,68688,148560
test,3879,506,388608,11285,1625040,2013648
test,3880,346,265728,5277,759888,1025616
test,3881,318,244224,4457,641808,886032
test,3882,374,287232,6165,887760,1174992
test,3883,470,360960,9736,1401984,1762944
test,3884,185,142080,1509,217296,359376
test,3885,381,292608,6398,921312,1213920
test,3886,314,241152,4346,625824,866976
test,3887,294,225792,3810,548640,774432
test,3888,98,75264,424,61056,136320
test,3889,356,273408,5586,804384,1077792
test,3890,146,112128,940,135360,247488
test,3891,311,238848,4263,613872,852720
test,3892,132,101376,768,110592,211968
test,3893,286,219648,3606,519264,738912
test,3894,747,573696,19846,2857824,3431520
test,3895,176,135168,1366,196704,331872
test,3896,95,72960,398,57312,130272
test,3897,247,189696,2689,387216,576912
test,3898,126,96768,700,100800,197568
test,3899,265,203520,3096,445824,649344
test,3900,142,109056,889,128016,237072
test,3901,203,155904,1817,261648,417552
test,3902,167,128256,1230,177120,305376
test,3903,493,378624,10713,1542672,1921296
test,3904,428,328704,8074,1162656,1491360
test,3905,195,149760,1676,241344,391104
test,3906,238,182784,2497,359568,542352
test,3907,279,214272,3431,494064,708336
test,3908,287,220416,3631,522864,743280
test,3909,619,475392,15072,2170368,2645760
test,3910,709,544512,18674,2689056,3233568
test,3911,333,255744,4888,703872,959616
test,3912,370,284160,6034,868896,1153056
test,3913,224,172032,2212,318528,490560
test,3914,280,215040,3456,497664,712704
test,3915,291,223488,3733,537552,761040
test,3916,522,400896,11810,1700640,2101536
test,3917,89,68352,350,50400,118752
test,3918,314,241152,4346,625824,866976
test,3919,312,239616,4291,617904,857520
test,3920,360,276480,5712,822528,1099008
test,3921,415,318720,7591,1093104,1411824
test,3922,341,261888,5125,738000,999888
test,3923,210,161280,1944,279936,441216
test,3924,406,311808,7265,1046160,1357968
test,3925,177,135936,1381,198864,334800
test,3926,237,182016,2476,356544,538560
test,3927,199,152832,1746,251424,404256
test,3928,261,200448,3003,432432,632880
test,3929,329,252672,4771,687024,939696
test,3930,198,152064,1728,248832,400896
test,3931,510,391680,11464,1650816,2042496
test,3932,334,256512,4917,708048,964560
test,3933,371,284928,6067,873648,1158576
test,3934,77,59136,262,37728,96864
test,3935,282,216576,3505,504720,721296
test,3936,336,258048,4976,716544,974592
test,3937,260,199680,2980,429120,628800
test,3938,221,169728,2153,310032,479760
test,3939,222,170496,2173,312912,483408
test,3940,154,118272,1046,150624,268896
test,3941,198,152064,1728,248832,400896
test,3942,284,218112,3555,511920,730032
test,3943,338,259584,5036,725184,984768
test,3944,280,215040,3456,497664,712704
test,3945,260,199680,2980,429120,628800
test,3946,52,39936,120,17280,57216
test,3947,238,182784,2497,359568,542352
test,3948,303,232704,4047,582768,815472
test,3949,215,165120,2038,293472,458592
test,3950,294,225792,3810,548640,774432
test,3951,462,354816,9408,1354752,1709568
test,3952,202,155136,1799,259056,414192
test,3953,221,169728,2153,310032,479760
test,3954,165,126720,1200,172800,299520
test,3955,157,120576,1087,156528,277104
test,3956,356,273408,5586,804384,1077792
test,3957,370,284160,6034,868896,1153056
test,3958,176,135168,1366,196704,331872
test,3959,293,225024,3784,544896,769920
test,3960,379,291072,6331,911664,1202736
test,3961,542,416256,12415,1787760,2204016
test,3962,135,103680,804,115776,219456
test,3963,323,248064,4599,662256,910320
test,3964,320,245760,4514,650016,895776
test,3965,86,66048,326,46944,112992
test,3966,168,129024,1244,179136,308160
test,3967,461,354048,9367,1348848,1702896
test,3968,283,217344,3530,508320,725664
test,3969,163,125184,1171,168624,293808
test,3970,410,314880,7409,1066896,1381776
test,3971,278,213504,3407,490608,704112
test,3972,489,375552,10539,1517616,1893168
test,3973,544,417792,12477,1796688,2214480
test,3974,423,324864,7887,1135728,1460592
test,3975,156,119808,1073,154512,274320
test,3976,315,241920,4374,629856,871776
test,3977,315,241920,4374,629856,871776
test,3978,275,211200,3334,480096,691296
test,3979,238,182784,2497,359568,542352
test,3980,578,443904,13592,1957248,2401152
test,3981,188,144384,1558,224352,368736
test,3982,305,234240,4100,590400,824640
test,3983,277,212736,3382,487008,699744
test,3984,138,105984,840,120960,226944
test,3985,364,279552,5840,840960,1120512
test,3986,552,423936,12730,1833120,2257056
test,3987,262,201216,3026,435744,636960
test,3988,305,234240,4100,590400,824640
test,3989,401,307968,7088,1020672,1328640
test,3990,221,169728,2153,310032,479760
test,3991,449,344832,8886,1279584,1624416
test,3992,562,431616,13055,1879920,2311536
test,3993,392,301056,6773,975312,1276368
test,3994,171,131328,1289,185616,316944
test,3995,377,289536,6265,902160,1191696
test,3996,253,194304,2822,406368,600672
test,3997,148,113664,966,139104,252768
test,3998,264,202752,3072,442368,645120
test,3999,368,282624,5969,859536,1142160
test,4000,230,176640,2332,335808,512448
test,4001,417,320256,7664,1103616,1423872
test,4002,323,248064,4599,662256,910320
test,4003,417,320256,7664,1103616,1423872
test,4004,352,270336,5461,786384,1056720
test,4005,326,250368,4684,674496,924864
test,4006,141,108288,877,126288,234576
test,4007,451,346368,8965,1290960,1637328
test,4008,462,354816,9408,1354752,1709568
test,4009,328,251904,4742,682848,934752
test,4010,324,248832,4627,666288,915120
test,4011,300,230400,3967,571248,801648
test,4012,460,353280,9326,1342944,1696224
test,4013,146,112128,940,135360,247488
test,4014,424,325632,7924,1141056,1466688
test,4015,414,317952,7555,1087920,1405872
test,4016,223,171264,2192,315648,486912
test,4017,244,187392,2624,377856,565248
test,4018,224,172032,2212,318528,490560
test,4019,83,63744,304,43776,107520
test,4020,389,298752,6670,960480,1259232
test,4021,334,256512,4917,708048,964560
test,4022,315,241920,4374,629856,871776
test,4023,268,205824,3166,455904,661728
test,4024,317,243456,4429,637776,881232
test,4025,207,158976,1889,272016,430992
test,4026,545,418560,12508,1801152,2219712
test,4027,119,91392,625,90000,181392
test,4028,162,124416,1157,166608,291024
test,4029,286,219648,3606,519264,738912
test,4030,313,240384,4318,621792,862176
test,4031,250,192000,2755,396720,588720
test,4032,294,225792,3810,548640,774432
test,4033,483,370944,10282,1480608,1851552
test,4034,148,113664,966,139104,252768
test,4035,218,167424,2095,301680,469104
test,4036,251,192768,2777,399888,592656
test,4037,155,119040,1059,152496,271536
test,4038,238,182784,2497,359568,542352
test,4039,314,241152,4346,625824,866976
test,4040,310,238080,4236,609984,848064
test,4041,437,335616,8417,1212048,1547664
test,4042,91,69888,365,52560,122448
