split,index,nodes,total_values_for_nodes,edges,total_values_for_edges,total_values_for_graph
train,0,24,18432,103,14832,33264
train,1,303,232704,16367,2356848,2589552
train,2,16,12288,46,6624,18912
train,3,85,65280,1288,185472,250752
train,4,52,39936,482,69408,109344
train,5,41,31488,300,43200,74688
train,6,637,489216,50736,7305984,7795200
train,7,47,36096,394,56736,92832
train,8,51,39168,464,66816,105984
train,9,310,238080,17132,2467008,2705088
train,10,48,36864,411,59184,96048
train,11,55,42240,540,77760,120000
train,12,75,57600,1003,144432,202032
train,13,196,150528,6849,986256,1136784
train,14,188,144384,6301,907344,1051728
train,15,44,33792,345,49680,83472
train,16,96,73728,1643,236592,310320
train,17,115,88320,2358,339552,427872
train,18,318,244224,18027,2595888,2840112
train,19,777,596736,62217,8959248,9555984
train,20,166,127488,4913,707472,834960
train,21,267,205056,12709,1830096,2035152
train,22,271,208128,13092,1885248,2093376
train,23,59,45312,621,89424,134736
train,24,51,39168,464,66816,105984
train,25,28,21504,140,20160,41664
train,26,81,62208,1170,168480,230688
train,27,20,15360,72,10368,25728
train,28,60,46080,642,92448,138528
train,29,45,34560,361,51984,86544
train,30,59,45312,621,89424,134736
train,31,426,327168,32351,4658544,4985712
train,32,25,19200,112,16128,35328
train,33,41,31488,300,43200,74688
train,34,178,136704,5648,813312,950016
train,35,75,57600,1003,144432,202032
train,36,28,21504,140,20160,41664
train,37,27,20736,130,18720,39456
train,38,90,69120,1444,207936,277056
train,39,398,305664,28238,4066272,4371936
train,40,27,20736,130,18720,39456
train,41,65,49920,753,108432,158352
train,42,45,34560,361,51984,86544
train,43,73,56064,950,136800,192864
train,44,48,36864,411,59184,96048
train,45,1055,810240,94164,13559616,14369856
train,46,86,66048,1319,189936,255984
train,47,84,64512,1258,181152,245664
train,48,55,42240,540,77760,120000
train,49,25,19200,112,16128,35328
train,50,625,480000,50078,7211232,7691232
train,51,89,68352,1412,203328,271680
train,52,148,113664,3905,562320,675984
train,53,213,163584,8088,1164672,1328256
train,54,68,52224,825,118800,171024
train,55,341,261888,20729,2984976,3246864
train,56,59,45312,621,89424,134736
train,57,59,45312,621,89424,134736
train,58,62,47616,686,98784,146400
train,59,104,79872,1928,277632,357504
train,60,47,36096,394,56736,92832
train,61,84,64512,1258,181152,245664
train,62,117,89856,2441,351504,441360
train,63,10,7680,18,2592,10272
train,64,70,53760,874,125856,179616
train,65,191,146688,6504,936576,1083264
train,66,55,42240,540,77760,120000
train,67,98,75264,1712,246528,321792
train,68,171,131328,5213,750672,882000
train,69,67,51456,801,115344,166800
train,70,72,55296,924,133056,188352
train,71,25,19200,112,16128,35328
train,72,98,75264,1712,246528,321792
train,73,79,60672,1113,160272,220944
train,74,52,39936,482,69408,109344
train,75,16,12288,46,6624,18912
train,76,321,246528,18369,2645136,2891664
train,77,25,19200,112,16128,35328
train,78,66,50688,777,111888,162576
train,79,30,23040,161,23184,46224
train,80,120,92160,2567,369648,461808
train,81,71,54528,899,129456,183984
train,82,104,79872,1928,277632,357504
train,83,85,65280,1288,185472,250752
train,84,70,53760,874,125856,179616
train,85,81,62208,1170,168480,230688
train,86,36,27648,231,33264,60912
train,87,314,241152,17577,2531088,2772240
train,88,100,76800,1783,256752,333552
train,89,24,18432,103,14832,33264
train,90,25,19200,112,16128,35328
train,91,12,9216,26,3744,12960
train,92,82,62976,1199,172656,235632
train,93,201,154368,7202,1037088,1191456
train,94,49,37632,428,61632,99264
train,95,12,9216,26,3744,12960
train,96,116,89088,2399,345456,434544
train,97,520,399360,46502,6696288,7095648
train,98,31,23808,172,24768,48576
train,99,61,46848,664,95616,142464
train,100,117,89856,2441,351504,441360
train,101,75,57600,1003,144432,202032
train,102,205,157440,7492,1078848,1236288
train,103,64,49152,730,105120,154272
train,104,96,73728,1643,236592,310320
train,105,200,153600,7131,1026864,1180464
train,106,60,46080,642,92448,138528
train,107,62,47616,686,98784,146400
train,108,12,9216,26,3744,12960
train,109,45,34560,361,51984,86544
train,110,58,44544,600,86400,130944
train,111,33,25344,194,27936,53280
train,112,115,88320,2358,339552,427872
train,113,24,18432,103,14832,33264
train,114,78,59904,1085,156240,216144
train,115,32,24576,183,26352,50928
train,116,135,103680,3249,467856,571536
train,117,232,178176,9595,1381680,1559856
train,118,117,89856,2441,351504,441360
train,119,59,45312,621,89424,134736
train,120,600,460800,48870,7037280,7498080
train,121,96,73728,1643,236592,310320
train,122,44,33792,345,49680,83472
train,123,26,19968,121,17424,37392
train,124,63,48384,708,101952,150336
train,125,110,84480,2157,310608,395088
train,126,59,45312,621,89424,134736
train,127,121,92928,2610,375840,468768
train,128,201,154368,7202,1037088,1191456
train,129,43,33024,330,47520,80544
train,130,161,123648,4621,665424,789072
train,131,43,33024,330,47520,80544
train,132,54,41472,520,74880,116352
train,133,46,35328,378,54432,89760
train,134,69,52992,849,122256,175248
train,135,94,72192,1575,226800,298992
train,136,256,196608,11683,1682352,1878960
train,137,81,62208,1170,168480,230688
train,138,181,139008,5840,840960,979968
train,139,107,82176,2041,293904,376080
train,140,188,144384,6301,907344,1051728
train,141,29,22272,150,21600,43872
train,142,103,79104,1892,272448,351552
train,143,164,125952,4795,690480,816432
train,144,52,39936,482,69408,109344
train,145,101,77568,1819,261936,339504
train,146,110,84480,2157,310608,395088
train,147,242,185856,10440,1503360,1689216
train,148,16,12288,46,6624,18912
train,149,99,76032,1747,251568,327600
train,150,225,172800,9025,1299600,1472400
train,151,153,117504,4173,600912,718416
train,152,28,21504,140,20160,41664
train,153,37,28416,244,35136,63552
train,154,44,33792,345,49680,83472
train,155,75,57600,1003,144432,202032
train,156,57,43776,580,83520,127296
train,157,74,56832,977,140688,197520
train,158,102,78336,1855,267120,345456
train,159,141,108288,3544,510336,618624
train,160,41,31488,300,43200,74688
train,161,14,10752,35,5040,15792
train,162,57,43776,580,83520,127296
train,163,51,39168,464,66816,105984
train,164,47,36096,394,56736,92832
train,165,614,471552,49519,7130736,7602288
train,166,75,57600,1003,144432,202032
train,167,304,233472,16475,2372400,2605872
train,168,225,172800,9025,1299600,1472400
train,169,27,20736,130,18720,39456
train,170,38,29184,258,37152,66336
train,171,160,122880,4564,657216,780096
train,172,97,74496,1678,241632,316128
train,173,13,9984,30,4320,14304
train,174,38,29184,258,37152,66336
train,175,23,17664,95,13680,31344
train,176,172,132096,5274,759456,891552
train,177,286,219648,14582,2099808,2319456
train,178,61,46848,664,95616,142464
train,179,173,132864,5336,768384,901248
train,180,393,301824,27533,3964752,4266576
train,181,149,114432,3958,569952,684384
train,182,274,210432,13384,1927296,2137728
train,183,347,266496,21465,3090960,3357456
train,184,51,39168,464,66816,105984
train,185,130,99840,3013,433872,533712
train,186,220,168960,8629,1242576,1411536
train,187,28,21504,140,20160,41664
train,188,324,248832,18714,2694816,2943648
train,189,226,173568,9105,1311120,1484688
train,190,48,36864,411,59184,96048
train,191,286,219648,14582,2099808,2319456
train,192,385,295680,26424,3805056,4100736
train,193,23,17664,95,13680,31344
train,194,539,413952,46858,6747552,7161504
train,195,85,65280,1288,185472,250752
train,196,118,90624,2482,357408,448032
train,197,85,65280,1288,185472,250752
train,198,189,145152,6368,916992,1062144
train,199,124,95232,2741,394704,489936
train,200,75,57600,1003,144432,202032
train,201,329,252672,19296,2778624,3031296
train,202,119,91392,2525,363600,454992
train,203,110,84480,2157,310608,395088
train,204,61,46848,664,95616,142464
train,205,206,158208,7565,1089360,1247568
train,206,41,31488,300,43200,74688
train,207,60,46080,642,92448,138528
train,208,119,91392,2525,363600,454992
train,209,53,40704,501,72144,112848
train,210,24,18432,103,14832,33264
train,211,50,38400,446,64224,102624
train,212,70,53760,874,125856,179616
train,213,25,19200,112,16128,35328
train,214,341,261888,20729,2984976,3246864
train,215,51,39168,464,66816,105984
train,216,24,18432,103,14832,33264
train,217,106,81408,2003,288432,369840
train,218,105,80640,1966,283104,363744
train,219,135,103680,3249,467856,571536
train,220,47,36096,394,56736,92832
train,221,85,65280,1288,185472,250752
train,222,100,76800,1783,256752,333552
train,223,121,92928,2610,375840,468768
train,224,132,101376,3106,447264,548640
train,225,66,50688,777,111888,162576
train,226,48,36864,411,59184,96048
train,227,18,13824,58,8352,22176
train,228,45,34560,361,51984,86544
train,229,28,21504,140,20160,41664
train,230,93,71424,1542,222048,293472
train,231,38,29184,258,37152,66336
train,232,26,19968,121,17424,37392
train,233,154,118272,4228,608832,727104
train,234,96,73728,1643,236592,310320
train,235,333,255744,19768,2846592,3102336
train,236,124,95232,2741,394704,489936
train,237,135,103680,3249,467856,571536
train,238,14,10752,35,5040,15792
train,239,70,53760,874,125856,179616
train,240,38,29184,258,37152,66336
train,241,39,29952,271,39024,68976
train,242,36,27648,231,33264,60912
train,243,745,572160,58977,8492688,9064848
train,244,88,67584,1381,198864,266448
train,245,516,396288,46444,6687936,7084224
train,246,81,62208,1170,168480,230688
train,247,122,93696,2654,382176,475872
train,248,114,87552,2317,333648,421200
train,249,64,49152,730,105120,154272
train,250,76,58368,1030,148320,206688
train,251,26,19968,121,17424,37392
train,252,100,76800,1783,256752,333552
train,253,32,24576,183,26352,50928
train,254,393,301824,27533,3964752,4266576
train,255,485,372480,41933,6038352,6410832
train,256,25,19200,112,16128,35328
train,257,93,71424,1542,222048,293472
train,258,30,23040,161,23184,46224
train,259,81,62208,1170,168480,230688
train,260,15,11520,40,5760,17280
train,261,54,41472,520,74880,116352
train,262,292,224256,15200,2188800,2413056
train,263,30,23040,161,23184,46224
train,264,100,76800,1783,256752,333552
train,265,216,165888,8317,1197648,1363536
train,266,162,124416,4679,673776,798192
train,267,62,47616,686,98784,146400
train,268,226,173568,9105,1311120,1484688
train,269,111,85248,2197,316368,401616
train,270,318,244224,18027,2595888,2840112
train,271,42,32256,315,45360,77616
train,272,65,49920,753,108432,158352
train,273,47,36096,394,56736,92832
train,274,113,86784,2277,327888,414672
train,275,63,48384,708,101952,150336
train,276,25,19200,112,16128,35328
train,277,294,225792,15409,2218896,2444688
train,278,24,18432,103,14832,33264
train,279,118,90624,2482,357408,448032
train,280,34,26112,206,29664,55776
train,281,50,38400,446,64224,102624
train,282,307,235776,16802,2419488,2655264
train,283,73,56064,950,136800,192864
train,284,77,59136,1057,152208,211344
train,285,62,47616,686,98784,146400
train,286,127,97536,2876,414144,511680
train,287,95,72960,1609,231696,304656
train,288,34,26112,206,29664,55776
train,289,99,76032,1747,251568,327600
train,290,68,52224,825,118800,171024
train,291,249,191232,11053,1591632,1782864
train,292,31,23808,172,24768,48576
train,293,100,76800,1783,256752,333552
train,294,305,234240,16583,2387952,2622192
train,295,25,19200,112,16128,35328
train,296,91,69888,1477,212688,282576
train,297,156,119808,4339,624816,744624
train,298,72,55296,924,133056,188352
train,299,11,8448,22,3168,11616
train,300,71,54528,899,129456,183984
train,301,50,38400,446,64224,102624
train,302,275,211200,13482,1941408,2152608
train,303,15,11520,40,5760,17280
train,304,12,9216,26,3744,12960
train,305,66,50688,777,111888,162576
train,306,49,37632,428,61632,99264
train,307,103,79104,1892,272448,351552
train,308,27,20736,130,18720,39456
train,309,150,115200,4011,577584,692784
train,310,99,76032,1747,251568,327600
train,311,330,253440,19413,2795472,3048912
train,312,115,88320,2358,339552,427872
train,313,96,73728,1643,236592,310320
train,314,68,52224,825,118800,171024
train,315,10,7680,18,2592,10272
train,316,30,23040,161,23184,46224
train,317,98,75264,1712,246528,321792
train,318,67,51456,801,115344,166800
train,319,110,84480,2157,310608,395088
train,320,26,19968,121,17424,37392
train,321,47,36096,394,56736,92832
train,322,84,64512,1258,181152,245664
train,323,85,65280,1288,185472,250752
train,324,186,142848,6168,888192,1031040
train,325,880,675840,75125,10818000,11493840
train,326,38,29184,258,37152,66336
train,327,262,201216,12237,1762128,1963344
train,328,285,218880,14480,2085120,2304000
train,329,465,357120,38546,5550624,5907744
train,330,184,141312,6036,869184,1010496
train,331,76,58368,1030,148320,206688
train,332,24,18432,103,14832,33264
train,333,24,18432,103,14832,33264
train,334,78,59904,1085,156240,216144
train,335,24,18432,103,14832,33264
train,336,103,79104,1892,272448,351552
train,337,808,620544,65704,9461376,10081920
train,338,203,155904,7346,1057824,1213728
train,339,28,21504,140,20160,41664
train,340,14,10752,35,5040,15792
train,341,96,73728,1643,236592,310320
train,342,127,97536,2876,414144,511680
train,343,84,64512,1258,181152,245664
train,344,161,123648,4621,665424,789072
train,345,127,97536,2876,414144,511680
train,346,107,82176,2041,293904,376080
train,347,175,134400,5460,786240,920640
train,348,30,23040,161,23184,46224
train,349,127,97536,2876,414144,511680
train,350,80,61440,1141,164304,225744
train,351,172,132096,5274,759456,891552
train,352,99,76032,1747,251568,327600
train,353,15,11520,40,5760,17280
train,354,91,69888,1477,212688,282576
train,355,95,72960,1609,231696,304656
train,356,13,9984,30,4320,14304
train,357,59,45312,621,89424,134736
train,358,46,35328,378,54432,89760
train,359,146,112128,3800,547200,659328
train,360,109,83712,2118,304992,388704
train,361,54,41472,520,74880,116352
train,362,203,155904,7346,1057824,1213728
train,363,45,34560,361,51984,86544
train,364,12,9216,26,3744,12960
train,365,120,92160,2567,369648,461808
train,366,591,453888,48490,6982560,7436448
train,367,96,73728,1643,236592,310320
train,368,16,12288,46,6624,18912
train,369,14,10752,35,5040,15792
train,370,26,19968,121,17424,37392
train,371,332,254976,19649,2829456,3084432
train,372,95,72960,1609,231696,304656
train,373,117,89856,2441,351504,441360
train,374,18,13824,58,8352,22176
train,375,287,220416,14684,2114496,2334912
train,376,39,29952,271,39024,68976
train,377,32,24576,183,26352,50928
train,378,15,11520,40,5760,17280
train,379,26,19968,121,17424,37392
train,380,26,19968,121,17424,37392
train,381,103,79104,1892,272448,351552
train,382,63,48384,708,101952,150336
train,383,204,156672,7419,1068336,1225008
train,384,139,106752,3445,496080,602832
train,385,28,21504,140,20160,41664
train,386,102,78336,1855,267120,345456
train,387,88,67584,1381,198864,266448
train,388,42,32256,315,45360,77616
train,389,78,59904,1085,156240,216144
train,390,9,6912,15,2160,9072
train,391,34,26112,206,29664,55776
train,392,182,139776,5905,850320,990096
train,393,183,140544,5970,859680,1000224
train,394,100,76800,1783,256752,333552
train,395,32,24576,183,26352,50928
train,396,89,68352,1412,203328,271680
train,397,229,175872,9349,1346256,1522128
train,398,11,8448,22,3168,11616
train,399,114,87552,2317,333648,421200
train,400,72,55296,924,133056,188352
train,401,14,10752,35,5040,15792
train,402,94,72192,1575,226800,298992
train,403,25,19200,112,16128,35328
train,404,25,19200,112,16128,35328
train,405,179,137472,5712,822528,960000
train,406,233,178944,9678,1393632,1572576
train,407,493,378624,43327,6239088,6617712
train,408,424,325632,32048,4614912,4940544
train,409,94,72192,1575,226800,298992
train,410,108,82944,2080,299520,382464
train,411,116,89088,2399,345456,434544
train,412,149,114432,3958,569952,684384
train,413,68,52224,825,118800,171024
train,414,71,54528,899,129456,183984
train,415,205,157440,7492,1078848,1236288
train,416,214,164352,8164,1175616,1339968
train,417,37,28416,244,35136,63552
train,418,47,36096,394,56736,92832
train,419,27,20736,130,18720,39456
train,420,51,39168,464,66816,105984
train,421,157,120576,4394,632736,753312
train,422,52,39936,482,69408,109344
train,423,113,86784,2277,327888,414672
train,424,593,455424,48572,6994368,7449792
train,425,124,95232,2741,394704,489936
train,426,378,290304,25472,3667968,3958272
train,427,113,86784,2277,327888,414672
train,428,121,92928,2610,375840,468768
train,429,80,61440,1141,164304,225744
train,430,11,8448,22,3168,11616
train,431,113,86784,2277,327888,414672
train,432,28,21504,140,20160,41664
train,433,360,276480,23103,3326832,3603312
train,434,60,46080,642,92448,138528
train,435,217,166656,8395,1208880,1375536
train,436,78,59904,1085,156240,216144
train,437,93,71424,1542,222048,293472
train,438,38,29184,258,37152,66336
train,439,99,76032,1747,251568,327600
train,440,157,120576,4394,632736,753312
train,441,42,32256,315,45360,77616
train,442,106,81408,2003,288432,369840
train,443,150,115200,4011,577584,692784
train,444,56,43008,559,80496,123504
train,445,99,76032,1747,251568,327600
train,446,76,58368,1030,148320,206688
train,447,62,47616,686,98784,146400
train,448,26,19968,121,17424,37392
train,449,208,159744,7713,1110672,1270416
train,450,103,79104,1892,272448,351552
train,451,26,19968,121,17424,37392
train,452,23,17664,95,13680,31344
train,453,103,79104,1892,272448,351552
train,454,128,98304,2921,420624,518928
train,455,186,142848,6168,888192,1031040
train,456,199,152832,7060,1016640,1169472
train,457,122,93696,2654,382176,475872
train,458,16,12288,46,6624,18912
train,459,75,57600,1003,144432,202032
train,460,100,76800,1783,256752,333552
train,461,75,57600,1003,144432,202032
train,462,84,64512,1258,181152,245664
train,463,14,10752,35,5040,15792
train,464,26,19968,121,17424,37392
train,465,81,62208,1170,168480,230688
train,466,45,34560,361,51984,86544
train,467,13,9984,30,4320,14304
train,468,82,62976,1199,172656,235632
train,469,602,462336,48958,7049952,7512288
train,470,95,72960,1609,231696,304656
train,471,29,22272,150,21600,43872
train,472,419,321792,31297,4506768,4828560
train,473,147,112896,3852,554688,667584
train,474,57,43776,580,83520,127296
train,475,206,158208,7565,1089360,1247568
train,476,289,221952,14889,2144016,2365968
train,477,70,53760,874,125856,179616
train,478,53,40704,501,72144,112848
train,479,51,39168,464,66816,105984
train,480,470,360960,39379,5670576,6031536
train,481,288,221184,14786,2129184,2350368
train,482,29,22272,150,21600,43872
train,483,138,105984,3395,488880,594864
train,484,94,72192,1575,226800,298992
train,485,225,172800,9025,1299600,1472400
train,486,104,79872,1928,277632,357504
train,487,53,40704,501,72144,112848
train,488,50,38400,446,64224,102624
train,489,14,10752,35,5040,15792
train,490,427,327936,32503,4680432,5008368
train,491,35,26880,219,31536,58416
train,492,57,43776,580,83520,127296
train,493,194,148992,6709,966096,1115088
train,494,48,36864,411,59184,96048
train,495,125,96000,2786,401184,497184
train,496,88,67584,1381,198864,266448
train,497,15,11520,40,5760,17280
train,498,188,144384,6301,907344,1051728
train,499,81,62208,1170,168480,230688
train,500,776,595968,62110,8943840,9539808
train,501,110,84480,2157,310608,395088
train,502,77,59136,1057,152208,211344
train,503,105,80640,1966,283104,363744
train,504,12,9216,26,3744,12960
train,505,312,239616,17353,2498832,2738448
train,506,132,101376,3106,447264,548640
train,507,75,57600,1003,144432,202032
train,508,24,18432,103,14832,33264
train,509,120,92160,2567,369648,461808
train,510,74,56832,977,140688,197520
train,511,67,51456,801,115344,166800
train,512,115,88320,2358,339552,427872
train,513,143,109824,3646,525024,634848
train,514,25,19200,112,16128,35328
train,515,45,34560,361,51984,86544
train,516,75,57600,1003,144432,202032
train,517,28,21504,140,20160,41664
train,518,53,40704,501,72144,112848
train,519,58,44544,600,86400,130944
train,520,66,50688,777,111888,162576
train,521,38,29184,258,37152,66336
train,522,121,92928,2610,375840,468768
train,523,252,193536,11321,1630224,1823760
train,524,79,60672,1113,160272,220944
train,525,31,23808,172,24768,48576
train,526,23,17664,95,13680,31344
train,527,85,65280,1288,185472,250752
train,528,117,89856,2441,351504,441360
train,529,16,12288,46,6624,18912
train,530,86,66048,1319,189936,255984
train,531,74,56832,977,140688,197520
train,532,25,19200,112,16128,35328
train,533,15,11520,40,5760,17280
train,534,79,60672,1113,160272,220944
train,535,614,471552,49519,7130736,7602288
train,536,143,109824,3646,525024,634848
train,537,108,82944,2080,299520,382464
train,538,95,72960,1609,231696,304656
train,539,85,65280,1288,185472,250752
train,540,123,94464,2697,388368,482832
train,541,73,56064,950,136800,192864
train,542,709,544512,55768,8030592,8575104
train,543,234,179712,9761,1405584,1585296
train,544,291,223488,15096,2173824,2397312
train,545,52,39936,482,69408,109344
train,546,42,32256,315,45360,77616
train,547,77,59136,1057,152208,211344
train,548,99,76032,1747,251568,327600
train,549,405,311040,29240,4210560,4521600
train,550,38,29184,258,37152,66336
train,551,572,439296,47782,6880608,7319904
train,552,53,40704,501,72144,112848
train,553,242,185856,10440,1503360,1689216
train,554,98,75264,1712,246528,321792
train,555,189,145152,6368,916992,1062144
train,556,128,98304,2921,420624,518928
train,557,204,156672,7419,1068336,1225008
train,558,63,48384,708,101952,150336
train,559,709,544512,55768,8030592,8575104
train,560,51,39168,464,66816,105984
train,561,83,63744,1228,176832,240576
train,562,311,238848,17242,2482848,2721696
train,563,71,54528,899,129456,183984
train,564,67,51456,801,115344,166800
train,565,106,81408,2003,288432,369840
train,566,80,61440,1141,164304,225744
train,567,226,173568,9105,1311120,1484688
train,568,95,72960,1609,231696,304656
train,569,118,90624,2482,357408,448032
train,570,28,21504,140,20160,41664
train,571,41,31488,300,43200,74688
train,572,74,56832,977,140688,197520
train,573,13,9984,30,4320,14304
train,574,116,89088,2399,345456,434544
train,575,38,29184,258,37152,66336
train,576,12,9216,26,3744,12960
train,577,32,24576,183,26352,50928
train,578,56,43008,559,80496,123504
train,579,151,115968,4065,585360,701328
train,580,53,40704,501,72144,112848
train,581,34,26112,206,29664,55776
train,582,85,65280,1288,185472,250752
train,583,24,18432,103,14832,33264
train,584,17,13056,52,7488,20544
train,585,117,89856,2441,351504,441360
train,586,73,56064,950,136800,192864
train,587,36,27648,231,33264,60912
train,588,164,125952,4795,690480,816432
train,589,216,165888,8317,1197648,1363536
train,590,106,81408,2003,288432,369840
train,591,65,49920,753,108432,158352
train,592,106,81408,2003,288432,369840
train,593,248,190464,10964,1578816,1769280
train,594,16,12288,46,6624,18912
train,595,15,11520,40,5760,17280
train,596,94,72192,1575,226800,298992
train,597,88,67584,1381,198864,266448
train,598,46,35328,378,54432,89760
train,599,107,82176,2041,293904,376080
train,600,43,33024,330,47520,80544
train,601,19,14592,65,9360,23952
train,602,11,8448,22,3168,11616
train,603,336,258048,20126,2898144,3156192
train,604,362,278016,23361,3363984,3642000
train,605,126,96768,2830,407520,504288
train,606,55,42240,540,77760,120000
train,607,69,52992,849,122256,175248
train,608,22,16896,87,12528,29424
train,609,244,187392,10614,1528416,1715808
train,610,55,42240,540,77760,120000
train,611,47,36096,394,56736,92832
train,612,118,90624,2482,357408,448032
train,613,55,42240,540,77760,120000
train,614,19,14592,65,9360,23952
train,615,101,77568,1819,261936,339504
train,616,134,102912,3201,460944,563856
train,617,157,120576,4394,632736,753312
train,618,30,23040,161,23184,46224
train,619,72,55296,924,133056,188352
train,620,26,19968,121,17424,37392
train,621,48,36864,411,59184,96048
train,622,71,54528,899,129456,183984
train,623,72,55296,924,133056,188352
train,624,97,74496,1678,241632,316128
train,625,83,63744,1228,176832,240576
train,626,75,57600,1003,144432,202032
train,627,37,28416,244,35136,63552
train,628,101,77568,1819,261936,339504
train,629,73,56064,950,136800,192864
train,630,87,66816,1350,194400,261216
train,631,71,54528,899,129456,183984
train,632,76,58368,1030,148320,206688
train,633,76,58368,1030,148320,206688
train,634,25,19200,112,16128,35328
train,635,115,88320,2358,339552,427872
train,636,38,29184,258,37152,66336
train,637,226,173568,9105,1311120,1484688
train,638,113,86784,2277,327888,414672
train,639,29,22272,150,21600,43872
train,640,159,122112,4507,649008,771120
train,641,27,20736,130,18720,39456
train,642,26,19968,121,17424,37392
train,643,48,36864,411,59184,96048
train,644,51,39168,464,66816,105984
train,645,11,8448,22,3168,11616
train,646,589,452352,48409,6970896,7423248
train,647,74,56832,977,140688,197520
train,648,26,19968,121,17424,37392
train,649,128,98304,2921,420624,518928
train,650,41,31488,300,43200,74688
train,651,42,32256,315,45360,77616
train,652,24,18432,103,14832,33264
train,653,106,81408,2003,288432,369840
train,654,46,35328,378,54432,89760
train,655,47,36096,394,56736,92832
train,656,23,17664,95,13680,31344
train,657,25,19200,112,16128,35328
train,658,59,45312,621,89424,134736
train,659,105,80640,1966,283104,363744
train,660,37,28416,244,35136,63552
train,661,60,46080,642,92448,138528
train,662,70,53760,874,125856,179616
train,663,25,19200,112,16128,35328
train,664,117,89856,2441,351504,441360
train,665,380,291840,25742,3706848,3998688
train,666,501,384768,44745,6443280,6828048
train,667,58,44544,600,86400,130944
train,668,25,19200,112,16128,35328
train,669,83,63744,1228,176832,240576
train,670,33,25344,194,27936,53280
train,671,101,77568,1819,261936,339504
train,672,149,114432,3958,569952,684384
train,673,125,96000,2786,401184,497184
train,674,15,11520,40,5760,17280
train,675,97,74496,1678,241632,316128
train,676,453,347904,36582,5267808,5615712
train,677,87,66816,1350,194400,261216
train,678,28,21504,140,20160,41664
train,679,47,36096,394,56736,92832
train,680,52,39936,482,69408,109344
train,681,28,21504,140,20160,41664
train,682,67,51456,801,115344,166800
train,683,27,20736,130,18720,39456
train,684,95,72960,1609,231696,304656
train,685,15,11520,40,5760,17280
train,686,57,43776,580,83520,127296
train,687,52,39936,482,69408,109344
train,688,15,11520,40,5760,17280
train,689,474,364032,40052,5767488,6131520
train,690,62,47616,686,98784,146400
train,691,66,50688,777,111888,162576
train,692,71,54528,899,129456,183984
train,693,228,175104,9267,1334448,1509552
train,694,55,42240,540,77760,120000
train,695,179,137472,5712,822528,960000
train,696,177,135936,5585,804240,940176
train,697,43,33024,330,47520,80544
train,698,27,20736,130,18720,39456
train,699,121,92928,2610,375840,468768
train,700,16,12288,46,6624,18912
train,701,84,64512,1258,181152,245664
train,702,45,34560,361,51984,86544
train,703,57,43776,580,83520,127296
train,704,80,61440,1141,164304,225744
train,705,444,340992,35143,5060592,5401584
train,706,29,22272,150,21600,43872
train,707,332,254976,19649,2829456,3084432
train,708,110,84480,2157,310608,395088
train,709,12,9216,26,3744,12960
train,710,790,606720,63637,9163728,9770448
train,711,38,29184,258,37152,66336
train,712,706,542208,55521,7995024,8537232
train,713,33,25344,194,27936,53280
train,714,122,93696,2654,382176,475872
train,715,113,86784,2277,327888,414672
train,716,14,10752,35,5040,15792
train,717,92,70656,1509,217296,287952
train,718,120,92160,2567,369648,461808
train,719,114,87552,2317,333648,421200
train,720,59,45312,621,89424,134736
train,721,41,31488,300,43200,74688
train,722,41,31488,300,43200,74688
train,723,46,35328,378,54432,89760
train,724,82,62976,1199,172656,235632
train,725,51,39168,464,66816,105984
train,726,29,22272,150,21600,43872
train,727,249,191232,11053,1591632,1782864
train,728,50,38400,446,64224,102624
train,729,24,18432,103,14832,33264
train,730,93,71424,1542,222048,293472
train,731,114,87552,2317,333648,421200
train,732,530,407040,46674,6721056,7128096
train,733,35,26880,219,31536,58416
train,734,73,56064,950,136800,192864
train,735,46,35328,378,54432,89760
train,736,344,264192,21095,3037680,3301872
train,737,111,85248,2197,316368,401616
train,738,81,62208,1170,168480,230688
train,739,203,155904,7346,1057824,1213728
train,740,80,61440,1141,164304,225744
train,741,83,63744,1228,176832,240576
train,742,142,109056,3595,517680,626736
train,743,189,145152,6368,916992,1062144
train,744,66,50688,777,111888,162576
train,745,203,155904,7346,1057824,1213728
train,746,74,56832,977,140688,197520
train,747,305,234240,16583,2387952,2622192
train,748,54,41472,520,74880,116352
train,749,103,79104,1892,272448,351552
train,750,94,72192,1575,226800,298992
train,751,105,80640,1966,283104,363744
train,752,320,245760,18255,2628720,2874480
train,753,49,37632,428,61632,99264
train,754,90,69120,1444,207936,277056
train,755,17,13056,52,7488,20544
train,756,61,46848,664,95616,142464
train,757,127,97536,2876,414144,511680
train,758,81,62208,1170,168480,230688
train,759,213,163584,8088,1164672,1328256
train,760,81,62208,1170,168480,230688
train,761,217,166656,8395,1208880,1375536
train,762,109,83712,2118,304992,388704
train,763,51,39168,464,66816,105984
train,764,51,39168,464,66816,105984
train,765,25,19200,112,16128,35328
train,766,607,466176,49186,7082784,7548960
train,767,49,37632,428,61632,99264
train,768,57,43776,580,83520,127296
train,769,211,162048,7937,1142928,1304976
train,770,105,80640,1966,283104,363744
train,771,72,55296,924,133056,188352
train,772,423,324864,31897,4593168,4918032
train,773,243,186624,10527,1515888,1702512
train,774,98,75264,1712,246528,321792
train,775,104,79872,1928,277632,357504
train,776,157,120576,4394,632736,753312
train,777,28,21504,140,20160,41664
train,778,7,5376,9,1296,6672
train,779,14,10752,35,5040,15792
train,780,117,89856,2441,351504,441360
train,781,122,93696,2654,382176,475872
train,782,92,70656,1509,217296,287952
train,783,89,68352,1412,203328,271680
train,784,29,22272,150,21600,43872
train,785,60,46080,642,92448,138528
train,786,114,87552,2317,333648,421200
train,787,99,76032,1747,251568,327600
train,788,61,46848,664,95616,142464
train,789,117,89856,2441,351504,441360
train,790,92,70656,1509,217296,287952
train,791,208,159744,7713,1110672,1270416
train,792,79,60672,1113,160272,220944
train,793,130,99840,3013,433872,533712
train,794,195,149760,6779,976176,1125936
train,795,78,59904,1085,156240,216144
train,796,104,79872,1928,277632,357504
train,797,94,72192,1575,226800,298992
train,798,200,153600,7131,1026864,1180464
train,799,81,62208,1170,168480,230688
train,800,68,52224,825,118800,171024
train,801,46,35328,378,54432,89760
train,802,90,69120,1444,207936,277056
train,803,105,80640,1966,283104,363744
train,804,50,38400,446,64224,102624
train,805,31,23808,172,24768,48576
train,806,26,19968,121,17424,37392
train,807,77,59136,1057,152208,211344
train,808,65,49920,753,108432,158352
train,809,71,54528,899,129456,183984
train,810,84,64512,1258,181152,245664
train,811,49,37632,428,61632,99264
train,812,11,8448,22,3168,11616
train,813,137,105216,3346,481824,587040
train,814,24,18432,103,14832,33264
train,815,323,248064,18599,2678256,2926320
train,816,70,53760,874,125856,179616
train,817,77,59136,1057,152208,211344
train,818,10,7680,18,2592,10272
train,819,50,38400,446,64224,102624
train,820,24,18432,103,14832,33264
train,821,157,120576,4394,632736,753312
train,822,15,11520,40,5760,17280
train,823,83,63744,1228,176832,240576
train,824,23,17664,95,13680,31344
train,825,306,235008,16692,2403648,2638656
train,826,24,18432,103,14832,33264
train,827,62,47616,686,98784,146400
train,828,67,51456,801,115344,166800
train,829,47,36096,394,56736,92832
train,830,33,25344,194,27936,53280
train,831,28,21504,140,20160,41664
train,832,78,59904,1085,156240,216144
train,833,117,89856,2441,351504,441360
train,834,244,187392,10614,1528416,1715808
train,835,115,88320,2358,339552,427872
train,836,34,26112,206,29664,55776
train,837,49,37632,428,61632,99264
train,838,27,20736,130,18720,39456
train,839,131,100608,3060,440640,541248
train,840,703,539904,55278,7960032,8499936
train,841,138,105984,3395,488880,594864
train,842,77,59136,1057,152208,211344
train,843,16,12288,46,6624,18912
train,844,54,41472,520,74880,116352
train,845,769,590592,61372,8837568,9428160
train,846,26,19968,121,17424,37392
train,847,818,628224,66902,9633888,10262112
train,848,81,62208,1170,168480,230688
train,849,212,162816,8012,1153728,1316544
train,850,62,47616,686,98784,146400
train,851,25,19200,112,16128,35328
train,852,108,82944,2080,299520,382464
train,853,183,140544,5970,859680,1000224
train,854,119,91392,2525,363600,454992
train,855,16,12288,46,6624,18912
train,856,55,42240,540,77760,120000
train,857,561,430848,47431,6830064,7260912
train,858,294,225792,15409,2218896,2444688
train,859,39,29952,271,39024,68976
train,860,87,66816,1350,194400,261216
train,861,81,62208,1170,168480,230688
train,862,29,22272,150,21600,43872
train,863,47,36096,394,56736,92832
train,864,93,71424,1542,222048,293472
train,865,123,94464,2697,388368,482832
train,866,11,8448,22,3168,11616
train,867,50,38400,446,64224,102624
train,868,68,52224,825,118800,171024
train,869,68,52224,825,118800,171024
train,870,98,75264,1712,246528,321792
train,871,216,165888,8317,1197648,1363536
train,872,18,13824,58,8352,22176
train,873,33,25344,194,27936,53280
train,874,30,23040,161,23184,46224
train,875,42,32256,315,45360,77616
train,876,61,46848,664,95616,142464
train,877,27,20736,130,18720,39456
train,878,79,60672,1113,160272,220944
train,879,382,293376,26013,3745872,4039248
train,880,12,9216,26,3744,12960
train,881,210,161280,7862,1132128,1293408
train,882,32,24576,183,26352,50928
train,883,25,19200,112,16128,35328
train,884,111,85248,2197,316368,401616
train,885,67,51456,801,115344,166800
train,886,181,139008,5840,840960,979968
train,887,44,33792,345,49680,83472
train,888,115,88320,2358,339552,427872
train,889,82,62976,1199,172656,235632
train,890,42,32256,315,45360,77616
train,891,73,56064,950,136800,192864
train,892,51,39168,464,66816,105984
train,893,256,196608,11683,1682352,1878960
train,894,240,184320,10268,1478592,1662912
train,895,253,194304,11411,1643184,1837488
train,896,274,210432,13384,1927296,2137728
train,897,84,64512,1258,181152,245664
train,898,52,39936,482,69408,109344
train,899,78,59904,1085,156240,216144
train,900,219,168192,8550,1231200,1399392
train,901,52,39936,482,69408,109344
train,902,214,164352,8164,1175616,1339968
train,903,79,60672,1113,160272,220944
train,904,221,169728,8707,1253808,1423536
train,905,632,485376,50456,7265664,7751040
train,906,123,94464,2697,388368,482832
train,907,341,261888,20729,2984976,3246864
train,908,90,69120,1444,207936,277056
train,909,55,42240,540,77760,120000
train,910,226,173568,9105,1311120,1484688
train,911,123,94464,2697,388368,482832
train,912,60,46080,642,92448,138528
train,913,56,43008,559,80496,123504
train,914,123,94464,2697,388368,482832
train,915,148,113664,3905,562320,675984
train,916,80,61440,1141,164304,225744
train,917,66,50688,777,111888,162576
train,918,300,230400,16044,2310336,2540736
train,919,300,230400,16044,2310336,2540736
train,920,16,12288,46,6624,18912
train,921,53,40704,501,72144,112848
train,922,109,83712,2118,304992,388704
train,923,102,78336,1855,267120,345456
train,924,439,337152,34356,4947264,5284416
train,925,103,79104,1892,272448,351552
train,926,49,37632,428,61632,99264
train,927,32,24576,183,26352,50928
train,928,593,455424,48572,6994368,7449792
train,929,92,70656,1509,217296,287952
train,930,26,19968,121,17424,37392
train,931,88,67584,1381,198864,266448
train,932,223,171264,8865,1276560,1447824
train,933,99,76032,1747,251568,327600
train,934,109,83712,2118,304992,388704
train,935,90,69120,1444,207936,277056
train,936,91,69888,1477,212688,282576
train,937,15,11520,40,5760,17280
train,938,23,17664,95,13680,31344
train,939,52,39936,482,69408,109344
train,940,45,34560,361,51984,86544
train,941,25,19200,112,16128,35328
train,942,127,97536,2876,414144,511680
train,943,56,43008,559,80496,123504
train,944,328,251904,19179,2761776,3013680
train,945,181,139008,5840,840960,979968
train,946,32,24576,183,26352,50928
train,947,14,10752,35,5040,15792
train,948,147,112896,3852,554688,667584
train,949,108,82944,2080,299520,382464
train,950,60,46080,642,92448,138528
train,951,92,70656,1509,217296,287952
train,952,14,10752,35,5040,15792
train,953,123,94464,2697,388368,482832
train,954,26,19968,121,17424,37392
train,955,18,13824,58,8352,22176
train,956,71,54528,899,129456,183984
train,957,17,13056,52,7488,20544
train,958,119,91392,2525,363600,454992
train,959,27,20736,130,18720,39456
train,960,104,79872,1928,277632,357504
train,961,80,61440,1141,164304,225744
train,962,48,36864,411,59184,96048
train,963,66,50688,777,111888,162576
train,964,216,165888,8317,1197648,1363536
train,965,101,77568,1819,261936,339504
train,966,100,76800,1783,256752,333552
train,967,22,16896,87,12528,29424
train,968,57,43776,580,83520,127296
train,969,31,23808,172,24768,48576
train,970,275,211200,13482,1941408,2152608
train,971,19,14592,65,9360,23952
train,972,51,39168,464,66816,105984
train,973,90,69120,1444,207936,277056
train,974,27,20736,130,18720,39456
train,975,74,56832,977,140688,197520
train,976,83,63744,1228,176832,240576
train,977,14,10752,35,5040,15792
train,978,108,82944,2080,299520,382464
train,979,58,44544,600,86400,130944
train,980,17,13056,52,7488,20544
train,981,58,44544,600,86400,130944
train,982,25,19200,112,16128,35328
train,983,17,13056,52,7488,20544
train,984,44,33792,345,49680,83472
train,985,345,264960,21218,3055392,3320352
train,986,62,47616,686,98784,146400
train,987,360,276480,23103,3326832,3603312
train,988,237,182016,10013,1441872,1623888
train,989,264,202752,12425,1789200,1991952
train,990,25,19200,112,16128,35328
train,991,58,44544,600,86400,130944
train,992,68,52224,825,118800,171024
train,993,65,49920,753,108432,158352
train,994,222,170496,8786,1265184,1435680
train,995,24,18432,103,14832,33264
train,996,54,41472,520,74880,116352
train,997,14,10752,35,5040,15792
train,998,27,20736,130,18720,39456
train,999,39,29952,271,39024,68976
train,1000,63,48384,708,101952,150336
train,1001,119,91392,2525,363600,454992
train,1002,117,89856,2441,351504,441360
train,1003,181,139008,5840,840960,979968
train,1004,171,131328,5213,750672,882000
train,1005,83,63744,1228,176832,240576
train,1006,181,139008,5840,840960,979968
train,1007,65,49920,753,108432,158352
train,1008,15,11520,40,5760,17280
train,1009,124,95232,2741,394704,489936
train,1010,79,60672,1113,160272,220944
train,1011,506,388608,45643,6572592,6961200
train,1012,546,419328,47022,6771168,7190496
train,1013,112,86016,2236,321984,408000
train,1014,83,63744,1228,176832,240576
train,1015,30,23040,161,23184,46224
train,1016,101,77568,1819,261936,339504
train,1017,112,86016,2236,321984,408000
train,1018,15,11520,40,5760,17280
train,1019,45,34560,361,51984,86544
train,1020,175,134400,5460,786240,920640
train,1021,615,472320,49568,7137792,7610112
train,1022,21,16128,79,11376,27504
train,1023,365,280320,23750,3420000,3700320
train,1024,11,8448,22,3168,11616
train,1025,56,43008,559,80496,123504
train,1026,117,89856,2441,351504,441360
train,1027,74,56832,977,140688,197520
train,1028,76,58368,1030,148320,206688
train,1029,132,101376,3106,447264,548640
train,1030,52,39936,482,69408,109344
train,1031,25,19200,112,16128,35328
train,1032,175,134400,5460,786240,920640
train,1033,48,36864,411,59184,96048
train,1034,73,56064,950,136800,192864
train,1035,41,31488,300,43200,74688
train,1036,142,109056,3595,517680,626736
train,1037,30,23040,161,23184,46224
train,1038,227,174336,9186,1322784,1497120
train,1039,120,92160,2567,369648,461808
train,1040,12,9216,26,3744,12960
train,1041,17,13056,52,7488,20544
train,1042,66,50688,777,111888,162576
train,1043,51,39168,464,66816,105984
train,1044,116,89088,2399,345456,434544
train,1045,104,79872,1928,277632,357504
train,1046,51,39168,464,66816,105984
train,1047,100,76800,1783,256752,333552
train,1048,106,81408,2003,288432,369840
train,1049,28,21504,140,20160,41664
train,1050,111,85248,2197,316368,401616
train,1051,177,135936,5585,804240,940176
train,1052,89,68352,1412,203328,271680
train,1053,108,82944,2080,299520,382464
train,1054,54,41472,520,74880,116352
train,1055,65,49920,753,108432,158352
train,1056,114,87552,2317,333648,421200
train,1057,68,52224,825,118800,171024
train,1058,117,89856,2441,351504,441360
train,1059,47,36096,394,56736,92832
train,1060,20,15360,72,10368,25728
train,1061,96,73728,1643,236592,310320
train,1062,64,49152,730,105120,154272
train,1063,144,110592,3697,532368,642960
train,1064,291,223488,15096,2173824,2397312
train,1065,31,23808,172,24768,48576
train,1066,25,19200,112,16128,35328
train,1067,539,413952,46858,6747552,7161504
train,1068,204,156672,7419,1068336,1225008
train,1069,66,50688,777,111888,162576
train,1070,32,24576,183,26352,50928
train,1071,25,19200,112,16128,35328
train,1072,215,165120,8241,1186704,1351824
train,1073,85,65280,1288,185472,250752
train,1074,141,108288,3544,510336,618624
train,1075,288,221184,14786,2129184,2350368
train,1076,9,6912,15,2160,9072
train,1077,42,32256,315,45360,77616
train,1078,39,29952,271,39024,68976
train,1079,10,7680,18,2592,10272
train,1080,28,21504,140,20160,41664
train,1081,25,19200,112,16128,35328
train,1082,80,61440,1141,164304,225744
train,1083,75,57600,1003,144432,202032
train,1084,360,276480,23103,3326832,3603312
train,1085,62,47616,686,98784,146400
train,1086,306,235008,16692,2403648,2638656
train,1087,55,42240,540,77760,120000
train,1088,30,23040,161,23184,46224
train,1089,234,179712,9761,1405584,1585296
train,1090,44,33792,345,49680,83472
train,1091,24,18432,103,14832,33264
train,1092,143,109824,3646,525024,634848
train,1093,33,25344,194,27936,53280
train,1094,66,50688,777,111888,162576
train,1095,226,173568,9105,1311120,1484688
train,1096,18,13824,58,8352,22176
train,1097,69,52992,849,122256,175248
train,1098,30,23040,161,23184,46224
train,1099,26,19968,121,17424,37392
train,1100,38,29184,258,37152,66336
train,1101,49,37632,428,61632,99264
train,1102,23,17664,95,13680,31344
train,1103,13,9984,30,4320,14304
train,1104,124,95232,2741,394704,489936
train,1105,26,19968,121,17424,37392
train,1106,154,118272,4228,608832,727104
train,1107,56,43008,559,80496,123504
train,1108,181,139008,5840,840960,979968
train,1109,82,62976,1199,172656,235632
train,1110,39,29952,271,39024,68976
train,1111,32,24576,183,26352,50928
train,1112,76,58368,1030,148320,206688
train,1113,75,57600,1003,144432,202032
train,1114,25,19200,112,16128,35328
train,1115,284,218112,14378,2070432,2288544
train,1116,770,591360,61477,8852688,9444048
train,1117,15,11520,40,5760,17280
train,1118,175,134400,5460,786240,920640
train,1119,79,60672,1113,160272,220944
train,1120,118,90624,2482,357408,448032
train,1121,43,33024,330,47520,80544
train,1122,301,231168,16151,2325744,2556912
train,1123,57,43776,580,83520,127296
train,1124,701,538368,55118,7936992,8475360
train,1125,127,97536,2876,414144,511680
train,1126,39,29952,271,39024,68976
train,1127,73,56064,950,136800,192864
train,1128,116,89088,2399,345456,434544
train,1129,115,88320,2358,339552,427872
train,1130,291,223488,15096,2173824,2397312
train,1131,20,15360,72,10368,25728
train,1132,47,36096,394,56736,92832
train,1133,13,9984,30,4320,14304
train,1134,75,57600,1003,144432,202032
train,1135,68,52224,825,118800,171024
train,1136,137,105216,3346,481824,587040
train,1137,33,25344,194,27936,53280
train,1138,27,20736,130,18720,39456
train,1139,25,19200,112,16128,35328
train,1140,26,19968,121,17424,37392
train,1141,53,40704,501,72144,112848
train,1142,592,454656,48530,6988320,7442976
train,1143,9,6912,15,2160,9072
train,1144,269,206592,12900,1857600,2064192
train,1145,203,155904,7346,1057824,1213728
train,1146,213,163584,8088,1164672,1328256
train,1147,99,76032,1747,251568,327600
train,1148,62,47616,686,98784,146400
train,1149,53,40704,501,72144,112848
train,1150,18,13824,58,8352,22176
train,1151,113,86784,2277,327888,414672
train,1152,129,99072,2967,427248,526320
train,1153,324,248832,18714,2694816,2943648
train,1154,112,86016,2236,321984,408000
train,1155,124,95232,2741,394704,489936
train,1156,161,123648,4621,665424,789072
train,1157,23,17664,95,13680,31344
train,1158,68,52224,825,118800,171024
train,1159,108,82944,2080,299520,382464
train,1160,68,52224,825,118800,171024
train,1161,40,30720,286,41184,71904
train,1162,324,248832,18714,2694816,2943648
train,1163,51,39168,464,66816,105984
train,1164,81,62208,1170,168480,230688
train,1165,122,93696,2654,382176,475872
train,1166,102,78336,1855,267120,345456
train,1167,42,32256,315,45360,77616
train,1168,29,22272,150,21600,43872
train,1169,32,24576,183,26352,50928
train,1170,59,45312,621,89424,134736
train,1171,156,119808,4339,624816,744624
train,1172,78,59904,1085,156240,216144
train,1173,142,109056,3595,517680,626736
train,1174,38,29184,258,37152,66336
train,1175,79,60672,1113,160272,220944
train,1176,49,37632,428,61632,99264
train,1177,81,62208,1170,168480,230688
train,1178,113,86784,2277,327888,414672
train,1179,48,36864,411,59184,96048
train,1180,675,518400,53162,7655328,8173728
train,1181,29,22272,150,21600,43872
train,1182,95,72960,1609,231696,304656
train,1183,43,33024,330,47520,80544
train,1184,315,241920,17689,2547216,2789136
train,1185,86,66048,1319,189936,255984
train,1186,74,56832,977,140688,197520
train,1187,24,18432,103,14832,33264
train,1188,44,33792,345,49680,83472
train,1189,295,226560,15514,2234016,2460576
train,1190,448,344064,35779,5152176,5496240
train,1191,143,109824,3646,525024,634848
train,1192,12,9216,26,3744,12960
train,1193,103,79104,1892,272448,351552
train,1194,98,75264,1712,246528,321792
train,1195,14,10752,35,5040,15792
train,1196,203,155904,7346,1057824,1213728
train,1197,14,10752,35,5040,15792
train,1198,23,17664,95,13680,31344
train,1199,115,88320,2358,339552,427872
train,1200,94,72192,1575,226800,298992
train,1201,79,60672,1113,160272,220944
train,1202,148,113664,3905,562320,675984
train,1203,109,83712,2118,304992,388704
train,1204,87,66816,1350,194400,261216
train,1205,341,261888,20729,2984976,3246864
train,1206,548,420864,47072,6778368,7199232
train,1207,49,37632,428,61632,99264
train,1208,524,402432,46567,6705648,7108080
train,1209,87,66816,1350,194400,261216
train,1210,118,90624,2482,357408,448032
train,1211,61,46848,664,95616,142464
train,1212,82,62976,1199,172656,235632
train,1213,111,85248,2197,316368,401616
train,1214,140,107520,3494,503136,610656
train,1215,14,10752,35,5040,15792
train,1216,258,198144,11866,1708704,1906848
train,1217,47,36096,394,56736,92832
train,1218,12,9216,26,3744,12960
train,1219,10,7680,18,2592,10272
train,1220,205,157440,7492,1078848,1236288
train,1221,90,69120,1444,207936,277056
train,1222,244,187392,10614,1528416,1715808
train,1223,254,195072,11501,1656144,1851216
train,1224,248,190464,10964,1578816,1769280
train,1225,52,39936,482,69408,109344
train,1226,57,43776,580,83520,127296
train,1227,310,238080,17132,2467008,2705088
train,1228,109,83712,2118,304992,388704
train,1229,302,231936,16259,2341296,2573232
train,1230,36,27648,231,33264,60912
train,1231,331,254208,19531,2812464,3066672
train,1232,205,157440,7492,1078848,1236288
train,1233,11,8448,22,3168,11616
train,1234,49,37632,428,61632,99264
train,1235,80,61440,1141,164304,225744
train,1236,133,102144,3154,454176,556320
train,1237,12,9216,26,3744,12960
train,1238,112,86016,2236,321984,408000
train,1239,28,21504,140,20160,41664
train,1240,353,271104,22214,3198816,3469920
train,1241,112,86016,2236,321984,408000
train,1242,58,44544,600,86400,130944
train,1243,89,68352,1412,203328,271680
train,1244,99,76032,1747,251568,327600
train,1245,210,161280,7862,1132128,1293408
train,1246,107,82176,2041,293904,376080
train,1247,103,79104,1892,272448,351552
train,1248,765,587520,60959,8778096,9365616
train,1249,133,102144,3154,454176,556320
train,1250,139,106752,3445,496080,602832
train,1251,27,20736,130,18720,39456
train,1252,81,62208,1170,168480,230688
train,1253,200,153600,7131,1026864,1180464
train,1254,26,19968,121,17424,37392
train,1255,78,59904,1085,156240,216144
train,1256,143,109824,3646,525024,634848
train,1257,24,18432,103,14832,33264
train,1258,56,43008,559,80496,123504
train,1259,191,146688,6504,936576,1083264
train,1260,32,24576,183,26352,50928
train,1261,56,43008,559,80496,123504
train,1262,286,219648,14582,2099808,2319456
train,1263,32,24576,183,26352,50928
train,1264,47,36096,394,56736,92832
train,1265,108,82944,2080,299520,382464
train,1266,48,36864,411,59184,96048
train,1267,69,52992,849,122256,175248
train,1268,58,44544,600,86400,130944
train,1269,49,37632,428,61632,99264
train,1270,56,43008,559,80496,123504
train,1271,161,123648,4621,665424,789072
train,1272,45,34560,361,51984,86544
train,1273,132,101376,3106,447264,548640
train,1274,94,72192,1575,226800,298992
train,1275,125,96000,2786,401184,497184
train,1276,27,20736,130,18720,39456
train,1277,173,132864,5336,768384,901248
train,1278,378,290304,25472,3667968,3958272
train,1279,66,50688,777,111888,162576
train,1280,103,79104,1892,272448,351552
train,1281,53,40704,501,72144,112848
train,1282,16,12288,46,6624,18912
train,1283,91,69888,1477,212688,282576
train,1284,34,26112,206,29664,55776
train,1285,188,144384,6301,907344,1051728
train,1286,53,40704,501,72144,112848
train,1287,260,199680,12051,1735344,1935024
train,1288,499,383232,44388,6391872,6775104
train,1289,292,224256,15200,2188800,2413056
train,1290,72,55296,924,133056,188352
train,1291,46,35328,378,54432,89760
train,1292,28,21504,140,20160,41664
train,1293,139,106752,3445,496080,602832
train,1294,47,36096,394,56736,92832
train,1295,52,39936,482,69408,109344
train,1296,109,83712,2118,304992,388704
train,1297,27,20736,130,18720,39456
train,1298,52,39936,482,69408,109344
train,1299,12,9216,26,3744,12960
train,1300,65,49920,753,108432,158352
train,1301,153,117504,4173,600912,718416
train,1302,29,22272,150,21600,43872
train,1303,20,15360,72,10368,25728
train,1304,29,22272,150,21600,43872
train,1305,388,297984,26837,3864528,4162512
train,1306,61,46848,664,95616,142464
train,1307,313,240384,17465,2514960,2755344
train,1308,64,49152,730,105120,154272
train,1309,27,20736,130,18720,39456
train,1310,34,26112,206,29664,55776
train,1311,25,19200,112,16128,35328
train,1312,779,598272,62431,8990064,9588336
train,1313,234,179712,9761,1405584,1585296
train,1314,26,19968,121,17424,37392
train,1315,59,45312,621,89424,134736
train,1316,67,51456,801,115344,166800
train,1317,17,13056,52,7488,20544
train,1318,121,92928,2610,375840,468768
train,1319,152,116736,4119,593136,709872
train,1320,217,166656,8395,1208880,1375536
train,1321,64,49152,730,105120,154272
train,1322,59,45312,621,89424,134736
train,1323,12,9216,26,3744,12960
train,1324,109,83712,2118,304992,388704
train,1325,48,36864,411,59184,96048
train,1326,107,82176,2041,293904,376080
train,1327,107,82176,2041,293904,376080
train,1328,55,42240,540,77760,120000
train,1329,657,504576,51949,7480656,7985232
train,1330,214,164352,8164,1175616,1339968
train,1331,83,63744,1228,176832,240576
train,1332,231,177408,9513,1369872,1547280
train,1333,10,7680,18,2592,10272
train,1334,191,146688,6504,936576,1083264
train,1335,104,79872,1928,277632,357504
train,1336,10,7680,18,2592,10272
train,1337,255,195840,11592,1669248,1865088
train,1338,36,27648,231,33264,60912
train,1339,66,50688,777,111888,162576
train,1340,72,55296,924,133056,188352
train,1341,78,59904,1085,156240,216144
train,1342,153,117504,4173,600912,718416
train,1343,34,26112,206,29664,55776
train,1344,79,60672,1113,160272,220944
train,1345,70,53760,874,125856,179616
train,1346,49,37632,428,61632,99264
train,1347,93,71424,1542,222048,293472
train,1348,30,23040,161,23184,46224
train,1349,446,342528,35460,5106240,5448768
train,1350,145,111360,3748,539712,651072
train,1351,313,240384,17465,2514960,2755344
train,1352,83,63744,1228,176832,240576
train,1353,57,43776,580,83520,127296
train,1354,23,17664,95,13680,31344
train,1355,161,123648,4621,665424,789072
train,1356,42,32256,315,45360,77616
train,1357,176,135168,5522,795168,930336
train,1358,51,39168,464,66816,105984
train,1359,207,158976,7639,1100016,1258992
train,1360,43,33024,330,47520,80544
train,1361,114,87552,2317,333648,421200
train,1362,78,59904,1085,156240,216144
train,1363,91,69888,1477,212688,282576
train,1364,221,169728,8707,1253808,1423536
train,1365,64,49152,730,105120,154272
train,1366,121,92928,2610,375840,468768
train,1367,88,67584,1381,198864,266448
train,1368,322,247296,18484,2661696,2908992
train,1369,58,44544,600,86400,130944
train,1370,41,31488,300,43200,74688
train,1371,592,454656,48530,6988320,7442976
train,1372,488,374784,42453,6113232,6488016
train,1373,78,59904,1085,156240,216144
train,1374,50,38400,446,64224,102624
train,1375,108,82944,2080,299520,382464
train,1376,92,70656,1509,217296,287952
train,1377,100,76800,1783,256752,333552
train,1378,81,62208,1170,168480,230688
train,1379,46,35328,378,54432,89760
train,1380,69,52992,849,122256,175248
train,1381,24,18432,103,14832,33264
train,1382,32,24576,183,26352,50928
train,1383,64,49152,730,105120,154272
train,1384,16,12288,46,6624,18912
train,1385,450,345600,36099,5198256,5543856
train,1386,115,88320,2358,339552,427872
train,1387,78,59904,1085,156240,216144
train,1388,24,18432,103,14832,33264
train,1389,323,248064,18599,2678256,2926320
train,1390,23,17664,95,13680,31344
train,1391,101,77568,1819,261936,339504
train,1392,93,71424,1542,222048,293472
train,1393,135,103680,3249,467856,571536
train,1394,54,41472,520,74880,116352
train,1395,588,451584,48369,6965136,7416720
train,1396,45,34560,361,51984,86544
train,1397,281,215808,14076,2026944,2242752
train,1398,26,19968,121,17424,37392
train,1399,185,142080,6101,878544,1020624
train,1400,88,67584,1381,198864,266448
train,1401,32,24576,183,26352,50928
train,1402,233,178944,9678,1393632,1572576
train,1403,26,19968,121,17424,37392
train,1404,13,9984,30,4320,14304
train,1405,101,77568,1819,261936,339504
train,1406,107,82176,2041,293904,376080
train,1407,32,24576,183,26352,50928
train,1408,60,46080,642,92448,138528
train,1409,218,167424,8472,1219968,1387392
train,1410,66,50688,777,111888,162576
train,1411,114,87552,2317,333648,421200
train,1412,375,288000,25069,3609936,3897936
train,1413,37,28416,244,35136,63552
train,1414,899,690432,77919,11220336,11910768
train,1415,86,66048,1319,189936,255984
train,1416,207,158976,7639,1100016,1258992
train,1417,822,631296,67391,9704304,10335600
train,1418,25,19200,112,16128,35328
train,1419,90,69120,1444,207936,277056
train,1420,40,30720,286,41184,71904
train,1421,70,53760,874,125856,179616
train,1422,102,78336,1855,267120,345456
train,1423,64,49152,730,105120,154272
train,1424,51,39168,464,66816,105984
train,1425,112,86016,2236,321984,408000
train,1426,193,148224,6641,956304,1104528
train,1427,53,40704,501,72144,112848
train,1428,222,170496,8786,1265184,1435680
train,1429,80,61440,1141,164304,225744
train,1430,60,46080,642,92448,138528
train,1431,98,75264,1712,246528,321792
train,1432,187,143616,6234,897696,1041312
train,1433,103,79104,1892,272448,351552
train,1434,51,39168,464,66816,105984
train,1435,109,83712,2118,304992,388704
train,1436,118,90624,2482,357408,448032
train,1437,50,38400,446,64224,102624
train,1438,48,36864,411,59184,96048
train,1439,79,60672,1113,160272,220944
train,1440,740,568320,58503,8424432,8992752
train,1441,89,68352,1412,203328,271680
train,1442,291,223488,15096,2173824,2397312
train,1443,14,10752,35,5040,15792
train,1444,45,34560,361,51984,86544
train,1445,45,34560,361,51984,86544
train,1446,92,70656,1509,217296,287952
train,1447,98,75264,1712,246528,321792
train,1448,29,22272,150,21600,43872
train,1449,401,307968,28665,4127760,4435728
train,1450,138,105984,3395,488880,594864
train,1451,157,120576,4394,632736,753312
train,1452,114,87552,2317,333648,421200
train,1453,54,41472,520,74880,116352
train,1454,33,25344,194,27936,53280
train,1455,108,82944,2080,299520,382464
train,1456,67,51456,801,115344,166800
train,1457,42,32256,315,45360,77616
train,1458,190,145920,6436,926784,1072704
train,1459,46,35328,378,54432,89760
train,1460,39,29952,271,39024,68976
train,1461,146,112128,3800,547200,659328
train,1462,54,41472,520,74880,116352
train,1463,53,40704,501,72144,112848
train,1464,117,89856,2441,351504,441360
train,1465,22,16896,87,12528,29424
train,1466,69,52992,849,122256,175248
train,1467,39,29952,271,39024,68976
train,1468,303,232704,16367,2356848,2589552
train,1469,73,56064,950,136800,192864
train,1470,49,37632,428,61632,99264
train,1471,91,69888,1477,212688,282576
train,1472,109,83712,2118,304992,388704
train,1473,316,242688,17801,2563344,2806032
train,1474,115,88320,2358,339552,427872
train,1475,632,485376,50456,7265664,7751040
train,1476,31,23808,172,24768,48576
train,1477,147,112896,3852,554688,667584
train,1478,59,45312,621,89424,134736
train,1479,233,178944,9678,1393632,1572576
train,1480,85,65280,1288,185472,250752
train,1481,22,16896,87,12528,29424
train,1482,190,145920,6436,926784,1072704
train,1483,9,6912,15,2160,9072
train,1484,621,476928,49869,7181136,7658064
train,1485,205,157440,7492,1078848,1236288
train,1486,7,5376,9,1296,6672
train,1487,15,11520,40,5760,17280
train,1488,42,32256,315,45360,77616
train,1489,70,53760,874,125856,179616
train,1490,55,42240,540,77760,120000
train,1491,39,29952,271,39024,68976
train,1492,115,88320,2358,339552,427872
train,1493,61,46848,664,95616,142464
train,1494,79,60672,1113,160272,220944
train,1495,71,54528,899,129456,183984
train,1496,38,29184,258,37152,66336
train,1497,469,360192,39212,5646528,6006720
train,1498,111,85248,2197,316368,401616
train,1499,38,29184,258,37152,66336
train,1500,97,74496,1678,241632,316128
train,1501,17,13056,52,7488,20544
train,1502,47,36096,394,56736,92832
train,1503,49,37632,428,61632,99264
train,1504,170,130560,5152,741888,872448
train,1505,79,60672,1113,160272,220944
train,1506,84,64512,1258,181152,245664
train,1507,277,212736,13678,1969632,2182368
train,1508,56,43008,559,80496,123504
train,1509,97,74496,1678,241632,316128
train,1510,810,622080,65941,9495504,10117584
train,1511,234,179712,9761,1405584,1585296
train,1512,100,76800,1783,256752,333552
train,1513,58,44544,600,86400,130944
train,1514,45,34560,361,51984,86544
train,1515,105,80640,1966,283104,363744
train,1516,47,36096,394,56736,92832
train,1517,101,77568,1819,261936,339504
train,1518,547,420096,47046,6774624,7194720
train,1519,542,416256,46926,6757344,7173600
train,1520,45,34560,361,51984,86544
train,1521,226,173568,9105,1311120,1484688
train,1522,455,349440,36906,5314464,5663904
train,1523,68,52224,825,118800,171024
train,1524,147,112896,3852,554688,667584
train,1525,275,211200,13482,1941408,2152608
train,1526,27,20736,130,18720,39456
train,1527,38,29184,258,37152,66336
train,1528,88,67584,1381,198864,266448
train,1529,109,83712,2118,304992,388704
train,1530,196,150528,6849,986256,1136784
train,1531,257,197376,11775,1695600,1892976
train,1532,163,125184,4737,682128,807312
train,1533,60,46080,642,92448,138528
train,1534,104,79872,1928,277632,357504
train,1535,58,44544,600,86400,130944
train,1536,81,62208,1170,168480,230688
train,1537,261,200448,12144,1748736,1949184
train,1538,26,19968,121,17424,37392
train,1539,154,118272,4228,608832,727104
train,1540,28,21504,140,20160,41664
train,1541,60,46080,642,92448,138528
train,1542,16,12288,46,6624,18912
train,1543,64,49152,730,105120,154272
train,1544,201,154368,7202,1037088,1191456
train,1545,195,149760,6779,976176,1125936
train,1546,25,19200,112,16128,35328
train,1547,129,99072,2967,427248,526320
train,1548,37,28416,244,35136,63552
train,1549,99,76032,1747,251568,327600
train,1550,13,9984,30,4320,14304
train,1551,95,72960,1609,231696,304656
train,1552,111,85248,2197,316368,401616
train,1553,81,62208,1170,168480,230688
train,1554,95,72960,1609,231696,304656
train,1555,415,318720,30702,4421088,4739808
train,1556,42,32256,315,45360,77616
train,1557,73,56064,950,136800,192864
train,1558,44,33792,345,49680,83472
train,1559,98,75264,1712,246528,321792
train,1560,89,68352,1412,203328,271680
train,1561,102,78336,1855,267120,345456
train,1562,25,19200,112,16128,35328
train,1563,505,387840,45462,6546528,6934368
train,1564,14,10752,35,5040,15792
train,1565,143,109824,3646,525024,634848
train,1566,420,322560,31446,4528224,4850784
train,1567,207,158976,7639,1100016,1258992
train,1568,14,10752,35,5040,15792
train,1569,62,47616,686,98784,146400
train,1570,63,48384,708,101952,150336
train,1571,13,9984,30,4320,14304
train,1572,186,142848,6168,888192,1031040
train,1573,53,40704,501,72144,112848
train,1574,117,89856,2441,351504,441360
train,1575,119,91392,2525,363600,454992
train,1576,58,44544,600,86400,130944
train,1577,313,240384,17465,2514960,2755344
train,1578,218,167424,8472,1219968,1387392
train,1579,104,79872,1928,277632,357504
train,1580,89,68352,1412,203328,271680
train,1581,196,150528,6849,986256,1136784
train,1582,11,8448,22,3168,11616
train,1583,112,86016,2236,321984,408000
train,1584,46,35328,378,54432,89760
train,1585,48,36864,411,59184,96048
train,1586,105,80640,1966,283104,363744
train,1587,220,168960,8628,1242432,1411392
train,1588,110,84480,2157,310608,395088
train,1589,101,77568,1819,261936,339504
train,1590,57,43776,580,83520,127296
train,1591,271,208128,13092,1885248,2093376
train,1592,97,74496,1678,241632,316128
train,1593,162,124416,4679,673776,798192
train,1594,11,8448,22,3168,11616
train,1595,174,133632,5397,777168,910800
train,1596,46,35328,378,54432,89760
train,1597,45,34560,361,51984,86544
train,1598,64,49152,730,105120,154272
train,1599,152,116736,4119,593136,709872
train,1600,98,75264,1712,246528,321792
train,1601,334,256512,19887,2863728,3120240
train,1602,182,139776,5905,850320,990096
train,1603,104,79872,1928,277632,357504
train,1604,67,51456,801,115344,166800
train,1605,83,63744,1228,176832,240576
train,1606,377,289536,25337,3648528,3938064
train,1607,52,39936,482,69408,109344
train,1608,62,47616,686,98784,146400
train,1609,83,63744,1228,176832,240576
train,1610,69,52992,849,122256,175248
train,1611,248,190464,10964,1578816,1769280
train,1612,65,49920,753,108432,158352
train,1613,64,49152,730,105120,154272
train,1614,103,79104,1892,272448,351552
train,1615,92,70656,1509,217296,287952
train,1616,59,45312,621,89424,134736
train,1617,20,15360,72,10368,25728
train,1618,30,23040,161,23184,46224
train,1619,24,18432,103,14832,33264
train,1620,104,79872,1928,277632,357504
train,1621,347,266496,21465,3090960,3357456
train,1622,28,21504,140,20160,41664
train,1623,312,239616,17353,2498832,2738448
train,1624,15,11520,40,5760,17280
train,1625,93,71424,1542,222048,293472
train,1626,89,68352,1412,203328,271680
train,1627,45,34560,361,51984,86544
train,1628,256,196608,11683,1682352,1878960
train,1629,122,93696,2654,382176,475872
train,1630,12,9216,26,3744,12960
train,1631,132,101376,3106,447264,548640
train,1632,83,63744,1228,176832,240576
train,1633,198,152064,6989,1006416,1158480
train,1634,77,59136,1057,152208,211344
train,1635,124,95232,2741,394704,489936
train,1636,54,41472,520,74880,116352
train,1637,130,99840,3013,433872,533712
train,1638,25,19200,112,16128,35328
train,1639,147,112896,3852,554688,667584
train,1640,88,67584,1381,198864,266448
train,1641,142,109056,3595,517680,626736
train,1642,116,89088,2399,345456,434544
train,1643,144,110592,3697,532368,642960
train,1644,105,80640,1966,283104,363744
train,1645,68,52224,825,118800,171024
train,1646,12,9216,26,3744,12960
train,1647,76,58368,1030,148320,206688
train,1648,77,59136,1057,152208,211344
train,1649,113,86784,2277,327888,414672
train,1650,71,54528,899,129456,183984
train,1651,119,91392,2525,363600,454992
train,1652,27,20736,130,18720,39456
train,1653,101,77568,1819,261936,339504
train,1654,92,70656,1509,217296,287952
train,1655,76,58368,1030,148320,206688
train,1656,632,485376,50456,7265664,7751040
train,1657,55,42240,540,77760,120000
train,1658,123,94464,2697,388368,482832
train,1659,160,122880,4564,657216,780096
train,1660,379,291072,25606,3687264,3978336
train,1661,45,34560,361,51984,86544
train,1662,130,99840,3013,433872,533712
train,1663,18,13824,58,8352,22176
train,1664,68,52224,825,118800,171024
train,1665,342,262656,20851,3002544,3265200
train,1666,29,22272,150,21600,43872
train,1667,14,10752,35,5040,15792
train,1668,127,97536,2876,414144,511680
train,1669,81,62208,1170,168480,230688
train,1670,106,81408,2003,288432,369840
train,1671,59,45312,621,89424,134736
train,1672,64,49152,730,105120,154272
train,1673,58,44544,600,86400,130944
train,1674,466,357888,38712,5574528,5932416
train,1675,15,11520,40,5760,17280
train,1676,142,109056,3595,517680,626736
train,1677,115,88320,2358,339552,427872
train,1678,425,326400,32199,4636656,4963056
train,1679,37,28416,244,35136,63552
train,1680,73,56064,950,136800,192864
train,1681,474,364032,40052,5767488,6131520
train,1682,25,19200,112,16128,35328
train,1683,23,17664,95,13680,31344
train,1684,84,64512,1258,181152,245664
train,1685,39,29952,271,39024,68976
train,1686,27,20736,130,18720,39456
train,1687,60,46080,642,92448,138528
train,1688,100,76800,1783,256752,333552
train,1689,86,66048,1319,189936,255984
train,1690,120,92160,2567,369648,461808
train,1691,56,43008,559,80496,123504
train,1692,92,70656,1509,217296,287952
train,1693,18,13824,58,8352,22176
train,1694,208,159744,7713,1110672,1270416
train,1695,30,23040,161,23184,46224
train,1696,82,62976,1199,172656,235632
train,1697,105,80640,1966,283104,363744
train,1698,43,33024,330,47520,80544
train,1699,311,238848,17242,2482848,2721696
train,1700,233,178944,9678,1393632,1572576
train,1701,215,165120,8241,1186704,1351824
train,1702,110,84480,2157,310608,395088
train,1703,12,9216,26,3744,12960
train,1704,24,18432,103,14832,33264
train,1705,13,9984,30,4320,14304
train,1706,26,19968,121,17424,37392
train,1707,304,233472,16475,2372400,2605872
train,1708,11,8448,22,3168,11616
train,1709,762,585216,60652,8733888,9319104
train,1710,55,42240,540,77760,120000
train,1711,89,68352,1412,203328,271680
train,1712,67,51456,801,115344,166800
train,1713,107,82176,2041,293904,376080
train,1714,104,79872,1928,277632,357504
train,1715,104,79872,1928,277632,357504
train,1716,175,134400,5460,786240,920640
train,1717,16,12288,46,6624,18912
train,1718,165,126720,4854,698976,825696
train,1719,57,43776,580,83520,127296
train,1720,24,18432,103,14832,33264
train,1721,35,26880,219,31536,58416
train,1722,161,123648,4621,665424,789072
train,1723,86,66048,1319,189936,255984
train,1724,332,254976,19649,2829456,3084432
train,1725,32,24576,183,26352,50928
train,1726,169,129792,5092,733248,863040
train,1727,197,151296,6919,996336,1147632
train,1728,61,46848,664,95616,142464
train,1729,158,121344,4451,640944,762288
train,1730,79,60672,1113,160272,220944
train,1731,103,79104,1892,272448,351552
train,1732,124,95232,2741,394704,489936
train,1733,116,89088,2399,345456,434544
train,1734,23,17664,95,13680,31344
train,1735,66,50688,777,111888,162576
train,1736,188,144384,6301,907344,1051728
train,1737,297,228096,15725,2264400,2492496
train,1738,17,13056,52,7488,20544
train,1739,78,59904,1085,156240,216144
train,1740,68,52224,825,118800,171024
train,1741,110,84480,2157,310608,395088
train,1742,99,76032,1747,251568,327600
train,1743,129,99072,2967,427248,526320
train,1744,284,218112,14378,2070432,2288544
train,1745,60,46080,642,92448,138528
train,1746,146,112128,3800,547200,659328
train,1747,79,60672,1113,160272,220944
train,1748,109,83712,2118,304992,388704
train,1749,75,57600,1003,144432,202032
train,1750,216,165888,8317,1197648,1363536
train,1751,12,9216,26,3744,12960
train,1752,89,68352,1412,203328,271680
train,1753,23,17664,95,13680,31344
train,1754,126,96768,2830,407520,504288
train,1755,45,34560,361,51984,86544
train,1756,48,36864,411,59184,96048
train,1757,44,33792,345,49680,83472
train,1758,199,152832,7060,1016640,1169472
train,1759,28,21504,140,20160,41664
train,1760,86,66048,1319,189936,255984
train,1761,46,35328,378,54432,89760
train,1762,98,75264,1712,246528,321792
train,1763,48,36864,411,59184,96048
train,1764,57,43776,580,83520,127296
train,1765,71,54528,899,129456,183984
train,1766,23,17664,95,13680,31344
train,1767,75,57600,1003,144432,202032
train,1768,156,119808,4339,624816,744624
train,1769,60,46080,642,92448,138528
train,1770,288,221184,14786,2129184,2350368
train,1771,380,291840,25742,3706848,3998688
train,1772,34,26112,206,29664,55776
train,1773,74,56832,977,140688,197520
train,1774,263,201984,12331,1775664,1977648
train,1775,13,9984,30,4320,14304
train,1776,26,19968,121,17424,37392
train,1777,65,49920,753,108432,158352
train,1778,58,44544,600,86400,130944
train,1779,95,72960,1609,231696,304656
train,1780,130,99840,3013,433872,533712
train,1781,680,522240,53519,7706736,8228976
train,1782,98,75264,1712,246528,321792
train,1783,114,87552,2317,333648,421200
train,1784,40,30720,286,41184,71904
train,1785,86,66048,1319,189936,255984
train,1786,111,85248,2197,316368,401616
train,1787,58,44544,600,86400,130944
train,1788,39,29952,271,39024,68976
train,1789,208,159744,7713,1110672,1270416
train,1790,438,336384,34199,4924656,5261040
train,1791,84,64512,1258,181152,245664
train,1792,165,126720,4854,698976,825696
train,1793,54,41472,520,74880,116352
train,1794,92,70656,1509,217296,287952
train,1795,238,182784,10098,1454112,1636896
train,1796,102,78336,1855,267120,345456
train,1797,58,44544,600,86400,130944
train,1798,192,147456,6572,946368,1093824
train,1799,29,22272,150,21600,43872
train,1800,301,231168,16151,2325744,2556912
train,1801,25,19200,112,16128,35328
train,1802,104,79872,1928,277632,357504
train,1803,46,35328,378,54432,89760
train,1804,136,104448,3298,474912,579360
train,1805,225,172800,9025,1299600,1472400
train,1806,25,19200,112,16128,35328
train,1807,45,34560,361,51984,86544
train,1808,78,59904,1085,156240,216144
train,1809,83,63744,1228,176832,240576
train,1810,102,78336,1855,267120,345456
train,1811,201,154368,7202,1037088,1191456
train,1812,88,67584,1381,198864,266448
train,1813,191,146688,6504,936576,1083264
train,1814,12,9216,26,3744,12960
train,1815,16,12288,46,6624,18912
train,1816,105,80640,1966,283104,363744
train,1817,421,323328,31596,4549824,4873152
train,1818,351,269568,21963,3162672,3432240
train,1819,107,82176,2041,293904,376080
train,1820,178,136704,5648,813312,950016
train,1821,85,65280,1288,185472,250752
train,1822,112,86016,2236,321984,408000
train,1823,26,19968,121,17424,37392
train,1824,185,142080,6101,878544,1020624
train,1825,30,23040,161,23184,46224
train,1826,21,16128,79,11376,27504
train,1827,58,44544,600,86400,130944
train,1828,57,43776,580,83520,127296
train,1829,36,27648,231,33264,60912
train,1830,110,84480,2157,310608,395088
train,1831,30,23040,161,23184,46224
train,1832,68,52224,825,118800,171024
train,1833,593,455424,48572,6994368,7449792
train,1834,217,166656,8395,1208880,1375536
train,1835,159,122112,4507,649008,771120
train,1836,88,67584,1381,198864,266448
train,1837,319,244992,18141,2612304,2857296
train,1838,60,46080,642,92448,138528
train,1839,131,100608,3060,440640,541248
train,1840,590,453120,48449,6976656,7429776
train,1841,31,23808,172,24768,48576
train,1842,397,304896,28096,4045824,4350720
train,1843,15,11520,40,5760,17280
train,1844,86,66048,1319,189936,255984
train,1845,196,150528,6849,986256,1136784
train,1846,24,18432,103,14832,33264
train,1847,73,56064,950,136800,192864
train,1848,127,97536,2876,414144,511680
train,1849,756,580608,60049,8647056,9227664
train,1850,198,152064,6989,1006416,1158480
train,1851,607,466176,49186,7082784,7548960
train,1852,806,619008,65468,9427392,10046400
train,1853,29,22272,150,21600,43872
train,1854,149,114432,3958,569952,684384
train,1855,108,82944,2080,299520,382464
train,1856,81,62208,1170,168480,230688
train,1857,43,33024,330,47520,80544
train,1858,33,25344,194,27936,53280
train,1859,29,22272,150,21600,43872
train,1860,71,54528,899,129456,183984
train,1861,27,20736,130,18720,39456
train,1862,59,45312,621,89424,134736
train,1863,18,13824,58,8352,22176
train,1864,14,10752,35,5040,15792
train,1865,72,55296,924,133056,188352
train,1866,40,30720,286,41184,71904
train,1867,16,12288,46,6624,18912
train,1868,162,124416,4679,673776,798192
train,1869,749,575232,59362,8548128,9123360
train,1870,27,20736,130,18720,39456
train,1871,94,72192,1575,226800,298992
train,1872,95,72960,1609,231696,304656
train,1873,82,62976,1199,172656,235632
train,1874,14,10752,35,5040,15792
train,1875,416,319488,30850,4442400,4761888
train,1876,27,20736,130,18720,39456
train,1877,450,345600,36099,5198256,5543856
train,1878,416,319488,30850,4442400,4761888
train,1879,24,18432,103,14832,33264
train,1880,138,105984,3395,488880,594864
train,1881,122,93696,2654,382176,475872
train,1882,90,69120,1444,207936,277056
train,1883,172,132096,5274,759456,891552
train,1884,23,17664,95,13680,31344
train,1885,16,12288,46,6624,18912
train,1886,67,51456,801,115344,166800
train,1887,16,12288,46,6624,18912
train,1888,20,15360,72,10368,25728
train,1889,100,76800,1783,256752,333552
train,1890,127,97536,2876,414144,511680
train,1891,59,45312,621,89424,134736
train,1892,276,211968,13580,1955520,2167488
train,1893,51,39168,464,66816,105984
train,1894,28,21504,140,20160,41664
train,1895,56,43008,559,80496,123504
train,1896,28,21504,140,20160,41664
train,1897,108,82944,2080,299520,382464
train,1898,101,77568,1819,261936,339504
train,1899,175,134400,5460,786240,920640
train,1900,65,49920,753,108432,158352
train,1901,180,138240,5776,831744,969984
train,1902,149,114432,3958,569952,684384
train,1903,100,76800,1783,256752,333552
train,1904,28,21504,140,20160,41664
train,1905,17,13056,52,7488,20544
train,1906,84,64512,1258,181152,245664
train,1907,32,24576,183,26352,50928
train,1908,25,19200,112,16128,35328
train,1909,151,115968,4065,585360,701328
train,1910,78,59904,1085,156240,216144
train,1911,84,64512,1258,181152,245664
train,1912,56,43008,559,80496,123504
train,1913,54,41472,520,74880,116352
train,1914,61,46848,664,95616,142464
train,1915,105,80640,1966,283104,363744
train,1916,102,78336,1855,267120,345456
train,1917,41,31488,300,43200,74688
train,1918,36,27648,231,33264,60912
train,1919,54,41472,520,74880,116352
train,1920,277,212736,13678,1969632,2182368
train,1921,204,156672,7419,1068336,1225008
train,1922,26,19968,121,17424,37392
train,1923,203,155904,7346,1057824,1213728
train,1924,330,253440,19413,2795472,3048912
train,1925,224,172032,8945,1288080,1460112
train,1926,38,29184,258,37152,66336
train,1927,462,354816,38050,5479200,5834016
train,1928,42,32256,315,45360,77616
train,1929,196,150528,6849,986256,1136784
train,1930,178,136704,5648,813312,950016
train,1931,113,86784,2277,327888,414672
train,1932,161,123648,4621,665424,789072
train,1933,224,172032,8945,1288080,1460112
train,1934,97,74496,1678,241632,316128
train,1935,130,99840,3013,433872,533712
train,1936,33,25344,194,27936,53280
train,1937,70,53760,874,125856,179616
train,1938,126,96768,2830,407520,504288
train,1939,54,41472,520,74880,116352
train,1940,119,91392,2525,363600,454992
train,1941,278,213504,13777,1983888,2197392
train,1942,147,112896,3852,554688,667584
train,1943,16,12288,46,6624,18912
train,1944,34,26112,206,29664,55776
train,1945,54,41472,520,74880,116352
train,1946,100,76800,1783,256752,333552
train,1947,21,16128,79,11376,27504
train,1948,53,40704,501,72144,112848
train,1949,81,62208,1170,168480,230688
train,1950,64,49152,730,105120,154272
train,1951,109,83712,2118,304992,388704
train,1952,29,22272,150,21600,43872
train,1953,46,35328,378,54432,89760
train,1954,17,13056,52,7488,20544
train,1955,93,71424,1542,222048,293472
train,1956,396,304128,27955,4025520,4329648
train,1957,204,156672,7419,1068336,1225008
train,1958,321,246528,18369,2645136,2891664
train,1959,123,94464,2697,388368,482832
train,1960,27,20736,130,18720,39456
train,1961,55,42240,540,77760,120000
train,1962,187,143616,6234,897696,1041312
train,1963,245,188160,10701,1540944,1729104
train,1964,58,44544,600,86400,130944
train,1965,15,11520,40,5760,17280
train,1966,61,46848,664,95616,142464
train,1967,58,44544,600,86400,130944
train,1968,125,96000,2786,401184,497184
train,1969,41,31488,300,43200,74688
train,1970,29,22272,150,21600,43872
train,1971,217,166656,8395,1208880,1375536
train,1972,159,122112,4507,649008,771120
train,1973,98,75264,1712,246528,321792
train,1974,708,543744,55685,8018640,8562384
train,1975,156,119808,4339,624816,744624
train,1976,50,38400,446,64224,102624
train,1977,67,51456,801,115344,166800
train,1978,60,46080,642,92448,138528
train,1979,27,20736,130,18720,39456
train,1980,110,84480,2157,310608,395088
train,1981,56,43008,559,80496,123504
train,1982,46,35328,378,54432,89760
train,1983,64,49152,730,105120,154272
train,1984,17,13056,52,7488,20544
train,1985,113,86784,2277,327888,414672
train,1986,19,14592,65,9360,23952
train,1987,121,92928,2610,375840,468768
train,1988,27,20736,130,18720,39456
train,1989,124,95232,2741,394704,489936
train,1990,27,20736,130,18720,39456
train,1991,154,118272,4228,608832,727104
train,1992,115,88320,2358,339552,427872
train,1993,130,99840,3013,433872,533712
train,1994,51,39168,464,66816,105984
train,1995,230,176640,9431,1358064,1534704
train,1996,256,196608,11683,1682352,1878960
train,1997,76,58368,1030,148320,206688
train,1998,67,51456,801,115344,166800
train,1999,205,157440,7492,1078848,1236288
train,2000,10,7680,18,2592,10272
train,2001,38,29184,258,37152,66336
train,2002,125,96000,2786,401184,497184
train,2003,13,9984,30,4320,14304
train,2004,216,165888,8317,1197648,1363536
train,2005,114,87552,2317,333648,421200
train,2006,125,96000,2786,401184,497184
train,2007,9,6912,15,2160,9072
train,2008,132,101376,3106,447264,548640
train,2009,43,33024,330,47520,80544
train,2010,139,106752,3445,496080,602832
train,2011,107,82176,2041,293904,376080
train,2012,181,139008,5840,840960,979968
train,2013,201,154368,7202,1037088,1191456
train,2014,117,89856,2441,351504,441360
train,2015,215,165120,8241,1186704,1351824
train,2016,43,33024,330,47520,80544
train,2017,245,188160,10701,1540944,1729104
train,2018,80,61440,1141,164304,225744
train,2019,309,237312,17021,2451024,2688336
train,2020,50,38400,446,64224,102624
train,2021,85,65280,1288,185472,250752
train,2022,27,20736,130,18720,39456
train,2023,95,72960,1609,231696,304656
train,2024,76,58368,1030,148320,206688
train,2025,102,78336,1855,267120,345456
train,2026,42,32256,315,45360,77616
train,2027,93,71424,1542,222048,293472
train,2028,25,19200,112,16128,35328
train,2029,124,95232,2741,394704,489936
train,2030,203,155904,7346,1057824,1213728
train,2031,69,52992,849,122256,175248
train,2032,32,24576,183,26352,50928
train,2033,183,140544,5970,859680,1000224
train,2034,316,242688,17801,2563344,2806032
train,2035,135,103680,3249,467856,571536
train,2036,17,13056,52,7488,20544
train,2037,393,301824,27533,3964752,4266576
train,2038,127,97536,2876,414144,511680
train,2039,58,44544,600,86400,130944
train,2040,204,156672,7419,1068336,1225008
train,2041,17,13056,52,7488,20544
train,2042,53,40704,501,72144,112848
train,2043,78,59904,1085,156240,216144
train,2044,78,59904,1085,156240,216144
train,2045,79,60672,1113,160272,220944
train,2046,77,59136,1057,152208,211344
train,2047,33,25344,194,27936,53280
train,2048,115,88320,2358,339552,427872
train,2049,80,61440,1141,164304,225744
train,2050,17,13056,52,7488,20544
train,2051,66,50688,777,111888,162576
train,2052,51,39168,464,66816,105984
train,2053,96,73728,1643,236592,310320
train,2054,209,160512,7787,1121328,1281840
train,2055,94,72192,1575,226800,298992
train,2056,25,19200,112,16128,35328
train,2057,231,177408,9513,1369872,1547280
train,2058,12,9216,26,3744,12960
train,2059,91,69888,1477,212688,282576
train,2060,181,139008,5840,840960,979968
train,2061,59,45312,621,89424,134736
train,2062,55,42240,540,77760,120000
train,2063,78,59904,1085,156240,216144
train,2064,110,84480,2157,310608,395088
train,2065,51,39168,464,66816,105984
train,2066,84,64512,1258,181152,245664
train,2067,108,82944,2080,299520,382464
train,2068,69,52992,849,122256,175248
train,2069,18,13824,58,8352,22176
train,2070,25,19200,112,16128,35328
train,2071,295,226560,15514,2234016,2460576
train,2072,60,46080,642,92448,138528
train,2073,449,344832,35939,5175216,5520048
train,2074,791,607488,63749,9179856,9787344
train,2075,81,62208,1170,168480,230688
train,2076,92,70656,1509,217296,287952
train,2077,129,99072,2967,427248,526320
train,2078,131,100608,3060,440640,541248
train,2079,73,56064,950,136800,192864
train,2080,65,49920,753,108432,158352
train,2081,70,53760,874,125856,179616
train,2082,27,20736,130,18720,39456
train,2083,58,44544,600,86400,130944
train,2084,297,228096,15725,2264400,2492496
train,2085,185,142080,6101,878544,1020624
train,2086,15,11520,40,5760,17280
train,2087,15,11520,40,5760,17280
train,2088,91,69888,1477,212688,282576
train,2089,84,64512,1258,181152,245664
train,2090,425,326400,32199,4636656,4963056
train,2091,45,34560,361,51984,86544
train,2092,88,67584,1381,198864,266448
train,2093,11,8448,22,3168,11616
train,2094,181,139008,5840,840960,979968
train,2095,65,49920,753,108432,158352
train,2096,43,33024,330,47520,80544
train,2097,231,177408,9513,1369872,1547280
train,2098,23,17664,95,13680,31344
train,2099,21,16128,79,11376,27504
train,2100,14,10752,35,5040,15792
train,2101,32,24576,183,26352,50928
train,2102,79,60672,1113,160272,220944
train,2103,67,51456,801,115344,166800
train,2104,94,72192,1575,226800,298992
train,2105,94,72192,1575,226800,298992
train,2106,51,39168,464,66816,105984
train,2107,25,19200,112,16128,35328
train,2108,102,78336,1855,267120,345456
train,2109,119,91392,2525,363600,454992
train,2110,46,35328,378,54432,89760
train,2111,91,69888,1477,212688,282576
train,2112,85,65280,1288,185472,250752
train,2113,120,92160,2567,369648,461808
train,2114,321,246528,18369,2645136,2891664
train,2115,139,106752,3445,496080,602832
train,2116,30,23040,161,23184,46224
train,2117,131,100608,3060,440640,541248
train,2118,115,88320,2358,339552,427872
train,2119,152,116736,4119,593136,709872
train,2120,97,74496,1678,241632,316128
train,2121,70,53760,874,125856,179616
train,2122,99,76032,1747,251568,327600
train,2123,316,242688,17801,2563344,2806032
train,2124,340,261120,20608,2967552,3228672
train,2125,153,117504,4173,600912,718416
train,2126,127,97536,2876,414144,511680
train,2127,111,85248,2197,316368,401616
train,2128,176,135168,5522,795168,930336
train,2129,24,18432,103,14832,33264
train,2130,17,13056,52,7488,20544
train,2131,93,71424,1542,222048,293472
train,2132,138,105984,3395,488880,594864
train,2133,141,108288,3544,510336,618624
train,2134,16,12288,46,6624,18912
train,2135,69,52992,849,122256,175248
train,2136,11,8448,22,3168,11616
train,2137,19,14592,65,9360,23952
train,2138,69,52992,849,122256,175248
train,2139,22,16896,87,12528,29424
train,2140,26,19968,121,17424,37392
train,2141,183,140544,5970,859680,1000224
train,2142,53,40704,501,72144,112848
train,2143,83,63744,1228,176832,240576
train,2144,54,41472,520,74880,116352
train,2145,35,26880,219,31536,58416
train,2146,17,13056,52,7488,20544
train,2147,129,99072,2967,427248,526320
train,2148,20,15360,72,10368,25728
train,2149,704,540672,55359,7971696,8512368
train,2150,46,35328,378,54432,89760
train,2151,213,163584,8088,1164672,1328256
train,2152,46,35328,378,54432,89760
train,2153,152,116736,4119,593136,709872
train,2154,49,37632,428,61632,99264
train,2155,274,210432,13384,1927296,2137728
train,2156,49,37632,428,61632,99264
train,2157,82,62976,1199,172656,235632
train,2158,144,110592,3697,532368,642960
train,2159,47,36096,394,56736,92832
train,2160,332,254976,19649,2829456,3084432
train,2161,82,62976,1199,172656,235632
train,2162,50,38400,446,64224,102624
train,2163,111,85248,2197,316368,401616
train,2164,97,74496,1678,241632,316128
train,2165,122,93696,2654,382176,475872
train,2166,107,82176,2041,293904,376080
train,2167,45,34560,361,51984,86544
train,2168,113,86784,2277,327888,414672
train,2169,62,47616,686,98784,146400
train,2170,167,128256,4972,715968,844224
train,2171,42,32256,315,45360,77616
train,2172,92,70656,1509,217296,287952
train,2173,434,333312,33578,4835232,5168544
train,2174,700,537600,55038,7925472,8463072
train,2175,146,112128,3800,547200,659328
train,2176,129,99072,2967,427248,526320
train,2177,82,62976,1199,172656,235632
train,2178,65,49920,753,108432,158352
train,2179,104,79872,1928,277632,357504
train,2180,295,226560,15514,2234016,2460576
train,2181,229,175872,9349,1346256,1522128
train,2182,228,175104,9267,1334448,1509552
train,2183,207,158976,7639,1100016,1258992
train,2184,147,112896,3852,554688,667584
train,2185,31,23808,172,24768,48576
train,2186,133,102144,3154,454176,556320
train,2187,12,9216,26,3744,12960
train,2188,12,9216,26,3744,12960
train,2189,20,15360,72,10368,25728
train,2190,35,26880,219,31536,58416
train,2191,730,560640,57583,8291952,8852592
train,2192,354,271872,22340,3216960,3488832
train,2193,483,370944,41588,5988672,6359616
train,2194,63,48384,708,101952,150336
train,2195,114,87552,2317,333648,421200
train,2196,79,60672,1113,160272,220944
train,2197,29,22272,150,21600,43872
train,2198,142,109056,3595,517680,626736
train,2199,347,266496,21465,3090960,3357456
train,2200,26,19968,121,17424,37392
train,2201,96,73728,1643,236592,310320
train,2202,71,54528,899,129456,183984
train,2203,16,12288,46,6624,18912
train,2204,89,68352,1412,203328,271680
train,2205,432,331776,33269,4790736,5122512
train,2206,125,96000,2786,401184,497184
train,2207,92,70656,1509,217296,287952
train,2208,343,263424,20973,3020112,3283536
train,2209,196,150528,6849,986256,1136784
train,2210,653,501504,51695,7444080,7945584
train,2211,83,63744,1228,176832,240576
train,2212,97,74496,1678,241632,316128
train,2213,185,142080,6101,878544,1020624
train,2214,74,56832,977,140688,197520
train,2215,562,431616,47461,6834384,7266000
train,2216,42,32256,315,45360,77616
train,2217,75,57600,1003,144432,202032
train,2218,90,69120,1444,207936,277056
train,2219,83,63744,1228,176832,240576
train,2220,36,27648,231,33264,60912
train,2221,46,35328,378,54432,89760
train,2222,217,166656,8395,1208880,1375536
train,2223,48,36864,411,59184,96048
train,2224,300,230400,16044,2310336,2540736
train,2225,8,6144,12,1728,7872
train,2226,30,23040,161,23184,46224
train,2227,514,394752,46417,6684048,7078800
train,2228,48,36864,411,59184,96048
train,2229,109,83712,2118,304992,388704
train,2230,15,11520,40,5760,17280
train,2231,364,279552,23620,3401280,3680832
train,2232,51,39168,464,66816,105984
train,2233,239,183552,10183,1466352,1649904
train,2234,30,23040,161,23184,46224
train,2235,14,10752,35,5040,15792
train,2236,48,36864,411,59184,96048
train,2237,352,270336,22088,3180672,3451008
train,2238,22,16896,87,12528,29424
train,2239,49,37632,428,61632,99264
train,2240,106,81408,2003,288432,369840
train,2241,410,314880,29967,4315248,4630128
train,2242,353,271104,22214,3198816,3469920
train,2243,241,185088,10354,1490976,1676064
train,2244,77,59136,1057,152208,211344
train,2245,26,19968,121,17424,37392
train,2246,92,70656,1509,217296,287952
train,2247,25,19200,112,16128,35328
train,2248,328,251904,19179,2761776,3013680
train,2249,58,44544,600,86400,130944
train,2250,110,84480,2157,310608,395088
train,2251,91,69888,1477,212688,282576
train,2252,114,87552,2317,333648,421200
train,2253,59,45312,621,89424,134736
train,2254,14,10752,35,5040,15792
train,2255,96,73728,1643,236592,310320
train,2256,115,88320,2358,339552,427872
train,2257,231,177408,9513,1369872,1547280
train,2258,417,320256,30999,4463856,4784112
train,2259,90,69120,1444,207936,277056
train,2260,148,113664,3905,562320,675984
train,2261,55,42240,540,77760,120000
train,2262,36,27648,231,33264,60912
train,2263,52,39936,482,69408,109344
train,2264,153,117504,4173,600912,718416
train,2265,74,56832,977,140688,197520
train,2266,104,79872,1928,277632,357504
train,2267,28,21504,140,20160,41664
train,2268,49,37632,428,61632,99264
train,2269,28,21504,140,20160,41664
train,2270,12,9216,26,3744,12960
train,2271,21,16128,79,11376,27504
train,2272,62,47616,686,98784,146400
train,2273,201,154368,7202,1037088,1191456
train,2274,143,109824,3646,525024,634848
train,2275,28,21504,140,20160,41664
train,2276,262,201216,12237,1762128,1963344
train,2277,257,197376,11775,1695600,1892976
train,2278,100,76800,1783,256752,333552
train,2279,28,21504,140,20160,41664
train,2280,64,49152,730,105120,154272
train,2281,138,105984,3395,488880,594864
train,2282,108,82944,2080,299520,382464
train,2283,265,203520,12519,1802736,2006256
train,2284,17,13056,52,7488,20544
train,2285,28,21504,140,20160,41664
train,2286,160,122880,4564,657216,780096
train,2287,15,11520,40,5760,17280
train,2288,49,37632,428,61632,99264
train,2289,536,411648,46793,6738192,7149840
train,2290,82,62976,1199,172656,235632
train,2291,239,183552,10183,1466352,1649904
train,2292,59,45312,621,89424,134736
train,2293,327,251136,19062,2744928,2996064
train,2294,64,49152,730,105120,154272
train,2295,33,25344,194,27936,53280
train,2296,86,66048,1319,189936,255984
train,2297,66,50688,777,111888,162576
train,2298,65,49920,753,108432,158352
train,2299,52,39936,482,69408,109344
train,2300,15,11520,40,5760,17280
train,2301,25,19200,112,16128,35328
train,2302,105,80640,1966,283104,363744
train,2303,312,239616,17353,2498832,2738448
train,2304,150,115200,4011,577584,692784
train,2305,762,585216,60652,8733888,9319104
train,2306,41,31488,300,43200,74688
train,2307,122,93696,2654,382176,475872
train,2308,67,51456,801,115344,166800
train,2309,727,558336,57314,8253216,8811552
train,2310,201,154368,7202,1037088,1191456
train,2311,97,74496,1678,241632,316128
train,2312,85,65280,1288,185472,250752
train,2313,49,37632,428,61632,99264
train,2314,40,30720,286,41184,71904
train,2315,26,19968,121,17424,37392
train,2316,547,420096,47046,6774624,7194720
train,2317,82,62976,1199,172656,235632
train,2318,296,227328,15619,2249136,2476464
train,2319,113,86784,2277,327888,414672
train,2320,69,52992,849,122256,175248
train,2321,182,139776,5905,850320,990096
train,2322,26,19968,121,17424,37392
train,2323,116,89088,2399,345456,434544
train,2324,72,55296,924,133056,188352
train,2325,28,21504,140,20160,41664
train,2326,32,24576,183,26352,50928
train,2327,53,40704,501,72144,112848
train,2328,47,36096,394,56736,92832
train,2329,12,9216,26,3744,12960
train,2330,48,36864,411,59184,96048
train,2331,38,29184,258,37152,66336
train,2332,29,22272,150,21600,43872
train,2333,256,196608,11683,1682352,1878960
train,2334,72,55296,924,133056,188352
train,2335,219,168192,8550,1231200,1399392
train,2336,408,313344,29675,4273200,4586544
train,2337,46,35328,378,54432,89760
train,2338,77,59136,1057,152208,211344
train,2339,52,39936,482,69408,109344
train,2340,54,41472,520,74880,116352
train,2341,276,211968,13580,1955520,2167488
train,2342,38,29184,258,37152,66336
train,2343,29,22272,150,21600,43872
train,2344,49,37632,428,61632,99264
train,2345,243,186624,10527,1515888,1702512
train,2346,138,105984,3395,488880,594864
train,2347,13,9984,30,4320,14304
train,2348,133,102144,3154,454176,556320
train,2349,77,59136,1057,152208,211344
train,2350,27,20736,130,18720,39456
train,2351,91,69888,1477,212688,282576
train,2352,753,578304,59752,8604288,9182592
train,2353,15,11520,40,5760,17280
train,2354,223,171264,8865,1276560,1447824
train,2355,102,78336,1855,267120,345456
train,2356,60,46080,642,92448,138528
train,2357,13,9984,30,4320,14304
train,2358,51,39168,464,66816,105984
train,2359,101,77568,1819,261936,339504
train,2360,163,125184,4737,682128,807312
train,2361,180,138240,5776,831744,969984
train,2362,14,10752,35,5040,15792
train,2363,265,203520,12519,1802736,2006256
train,2364,86,66048,1319,189936,255984
train,2365,13,9984,30,4320,14304
train,2366,68,52224,825,118800,171024
train,2367,133,102144,3154,454176,556320
train,2368,314,241152,17577,2531088,2772240
train,2369,34,26112,206,29664,55776
train,2370,81,62208,1170,168480,230688
train,2371,14,10752,35,5040,15792
train,2372,77,59136,1057,152208,211344
train,2373,235,180480,9845,1417680,1598160
train,2374,52,39936,482,69408,109344
train,2375,161,123648,4621,665424,789072
train,2376,178,136704,5648,813312,950016
train,2377,233,178944,9678,1393632,1572576
train,2378,72,55296,924,133056,188352
train,2379,83,63744,1228,176832,240576
train,2380,92,70656,1509,217296,287952
train,2381,451,346368,36260,5221440,5567808
train,2382,156,119808,4339,624816,744624
train,2383,240,184320,10268,1478592,1662912
train,2384,171,131328,5213,750672,882000
train,2385,178,136704,5648,813312,950016
train,2386,79,60672,1113,160272,220944
train,2387,32,24576,183,26352,50928
train,2388,517,397056,46458,6689952,7087008
train,2389,102,78336,1855,267120,345456
train,2390,39,29952,271,39024,68976
train,2391,64,49152,730,105120,154272
train,2392,238,182784,10098,1454112,1636896
train,2393,49,37632,428,61632,99264
train,2394,38,29184,258,37152,66336
train,2395,170,130560,5152,741888,872448
train,2396,139,106752,3445,496080,602832
train,2397,74,56832,977,140688,197520
train,2398,39,29952,271,39024,68976
train,2399,14,10752,35,5040,15792
train,2400,34,26112,206,29664,55776
train,2401,226,173568,9105,1311120,1484688
train,2402,53,40704,501,72144,112848
train,2403,13,9984,30,4320,14304
train,2404,35,26880,219,31536,58416
train,2405,108,82944,2080,299520,382464
train,2406,24,18432,103,14832,33264
train,2407,99,76032,1747,251568,327600
train,2408,39,29952,271,39024,68976
train,2409,116,89088,2399,345456,434544
train,2410,73,56064,950,136800,192864
train,2411,351,269568,21963,3162672,3432240
train,2412,398,305664,28238,4066272,4371936
train,2413,50,38400,446,64224,102624
train,2414,102,78336,1855,267120,345456
train,2415,333,255744,19768,2846592,3102336
train,2416,218,167424,8472,1219968,1387392
train,2417,283,217344,14277,2055888,2273232
train,2418,12,9216,26,3744,12960
train,2419,17,13056,52,7488,20544
train,2420,56,43008,559,80496,123504
train,2421,39,29952,271,39024,68976
train,2422,150,115200,4011,577584,692784
train,2423,28,21504,140,20160,41664
train,2424,115,88320,2358,339552,427872
train,2425,67,51456,801,115344,166800
train,2426,256,196608,11683,1682352,1878960
train,2427,16,12288,46,6624,18912
train,2428,116,89088,2399,345456,434544
train,2429,173,132864,5336,768384,901248
train,2430,156,119808,4339,624816,744624
train,2431,27,20736,130,18720,39456
train,2432,85,65280,1288,185472,250752
train,2433,32,24576,183,26352,50928
train,2434,13,9984,30,4320,14304
train,2435,68,52224,825,118800,171024
train,2436,84,64512,1258,181152,245664
train,2437,117,89856,2441,351504,441360
train,2438,459,352512,37558,5408352,5760864
train,2439,33,25344,194,27936,53280
train,2440,96,73728,1643,236592,310320
train,2441,59,45312,621,89424,134736
train,2442,80,61440,1141,164304,225744
train,2443,73,56064,950,136800,192864
train,2444,42,32256,315,45360,77616
train,2445,129,99072,2967,427248,526320
train,2446,116,89088,2399,345456,434544
train,2447,36,27648,231,33264,60912
train,2448,510,391680,46367,6676848,7068528
train,2449,58,44544,600,86400,130944
train,2450,35,26880,219,31536,58416
train,2451,841,645888,69792,10050048,10695936
train,2452,45,34560,361,51984,86544
train,2453,76,58368,1030,148320,206688
train,2454,216,165888,8317,1197648,1363536
train,2455,45,34560,361,51984,86544
train,2456,69,52992,849,122256,175248
train,2457,210,161280,7862,1132128,1293408
train,2458,80,61440,1141,164304,225744
train,2459,266,204288,12614,1816416,2020704
train,2460,84,64512,1258,181152,245664
train,2461,26,19968,121,17424,37392
train,2462,94,72192,1575,226800,298992
train,2463,190,145920,6436,926784,1072704
train,2464,103,79104,1892,272448,351552
train,2465,97,74496,1678,241632,316128
train,2466,112,86016,2236,321984,408000
train,2467,74,56832,977,140688,197520
train,2468,86,66048,1319,189936,255984
train,2469,383,294144,26150,3765600,4059744
train,2470,13,9984,30,4320,14304
train,2471,13,9984,30,4320,14304
train,2472,72,55296,924,133056,188352
train,2473,114,87552,2317,333648,421200
train,2474,54,41472,520,74880,116352
train,2475,250,192000,11142,1604448,1796448
train,2476,47,36096,394,56736,92832
train,2477,62,47616,686,98784,146400
train,2478,14,10752,35,5040,15792
train,2479,28,21504,140,20160,41664
train,2480,124,95232,2741,394704,489936
train,2481,68,52224,825,118800,171024
train,2482,75,57600,1003,144432,202032
train,2483,61,46848,664,95616,142464
train,2484,13,9984,30,4320,14304
train,2485,25,19200,112,16128,35328
train,2486,418,321024,31147,4485168,4806192
train,2487,10,7680,18,2592,10272
train,2488,23,17664,95,13680,31344
train,2489,118,90624,2482,357408,448032
train,2490,258,198144,11866,1708704,1906848
train,2491,109,83712,2118,304992,388704
train,2492,13,9984,30,4320,14304
train,2493,116,89088,2399,345456,434544
train,2494,79,60672,1113,160272,220944
train,2495,95,72960,1609,231696,304656
train,2496,124,95232,2741,394704,489936
train,2497,346,265728,21341,3073104,3338832
train,2498,105,80640,1966,283104,363744
train,2499,96,73728,1643,236592,310320
train,2500,322,247296,18484,2661696,2908992
train,2501,49,37632,428,61632,99264
train,2502,66,50688,777,111888,162576
train,2503,176,135168,5522,795168,930336
train,2504,383,294144,26150,3765600,4059744
train,2505,208,159744,7713,1110672,1270416
train,2506,74,56832,977,140688,197520
train,2507,64,49152,730,105120,154272
train,2508,85,65280,1288,185472,250752
train,2509,64,49152,730,105120,154272
train,2510,52,39936,482,69408,109344
train,2511,159,122112,4507,649008,771120
train,2512,214,164352,8164,1175616,1339968
train,2513,17,13056,52,7488,20544
train,2514,209,160512,7787,1121328,1281840
train,2515,98,75264,1712,246528,321792
train,2516,23,17664,95,13680,31344
train,2517,100,76800,1783,256752,333552
train,2518,32,24576,183,26352,50928
train,2519,485,372480,41933,6038352,6410832
train,2520,75,57600,1003,144432,202032
train,2521,57,43776,580,83520,127296
train,2522,90,69120,1444,207936,277056
train,2523,10,7680,18,2592,10272
train,2524,55,42240,540,77760,120000
train,2525,48,36864,411,59184,96048
train,2526,141,108288,3544,510336,618624
train,2527,316,242688,17801,2563344,2806032
train,2528,93,71424,1542,222048,293472
train,2529,68,52224,825,118800,171024
train,2530,435,334080,33732,4857408,5191488
train,2531,201,154368,7202,1037088,1191456
train,2532,117,89856,2441,351504,441360
train,2533,46,35328,378,54432,89760
train,2534,24,18432,103,14832,33264
train,2535,137,105216,3346,481824,587040
train,2536,119,91392,2525,363600,454992
train,2537,80,61440,1141,164304,225744
train,2538,62,47616,686,98784,146400
train,2539,90,69120,1444,207936,277056
train,2540,12,9216,26,3744,12960
train,2541,241,185088,10354,1490976,1676064
train,2542,112,86016,2236,321984,408000
train,2543,62,47616,686,98784,146400
train,2544,13,9984,30,4320,14304
train,2545,38,29184,258,37152,66336
train,2546,43,33024,330,47520,80544
train,2547,89,68352,1412,203328,271680
train,2548,79,60672,1113,160272,220944
train,2549,103,79104,1892,272448,351552
train,2550,32,24576,183,26352,50928
train,2551,53,40704,501,72144,112848
train,2552,25,19200,112,16128,35328
train,2553,238,182784,10098,1454112,1636896
train,2554,27,20736,130,18720,39456
train,2555,227,174336,9186,1322784,1497120
train,2556,28,21504,140,20160,41664
train,2557,174,133632,5397,777168,910800
train,2558,103,79104,1892,272448,351552
train,2559,49,37632,428,61632,99264
train,2560,418,321024,31147,4485168,4806192
train,2561,236,181248,9929,1429776,1611024
train,2562,26,19968,121,17424,37392
train,2563,43,33024,330,47520,80544
train,2564,56,43008,559,80496,123504
train,2565,123,94464,2697,388368,482832
train,2566,162,124416,4679,673776,798192
train,2567,110,84480,2157,310608,395088
train,2568,257,197376,11775,1695600,1892976
train,2569,110,84480,2157,310608,395088
train,2570,137,105216,3346,481824,587040
train,2571,159,122112,4507,649008,771120
train,2572,89,68352,1412,203328,271680
train,2573,28,21504,140,20160,41664
train,2574,53,40704,501,72144,112848
train,2575,13,9984,30,4320,14304
train,2576,157,120576,4394,632736,753312
train,2577,416,319488,30850,4442400,4761888
train,2578,15,11520,40,5760,17280
train,2579,92,70656,1509,217296,287952
train,2580,211,162048,7937,1142928,1304976
train,2581,221,169728,8707,1253808,1423536
train,2582,104,79872,1928,277632,357504
train,2583,154,118272,4228,608832,727104
train,2584,54,41472,520,74880,116352
train,2585,77,59136,1057,152208,211344
train,2586,53,40704,501,72144,112848
train,2587,14,10752,35,5040,15792
train,2588,95,72960,1609,231696,304656
train,2589,26,19968,121,17424,37392
train,2590,33,25344,194,27936,53280
train,2591,86,66048,1319,189936,255984
train,2592,51,39168,464,66816,105984
train,2593,25,19200,112,16128,35328
train,2594,59,45312,621,89424,134736
train,2595,108,82944,2080,299520,382464
train,2596,76,58368,1030,148320,206688
train,2597,105,80640,1966,283104,363744
train,2598,45,34560,361,51984,86544
train,2599,55,42240,540,77760,120000
train,2600,122,93696,2654,382176,475872
train,2601,77,59136,1057,152208,211344
train,2602,213,163584,8088,1164672,1328256
train,2603,68,52224,825,118800,171024
train,2604,86,66048,1319,189936,255984
train,2605,121,92928,2610,375840,468768
train,2606,29,22272,150,21600,43872
train,2607,87,66816,1350,194400,261216
train,2608,44,33792,345,49680,83472
train,2609,44,33792,345,49680,83472
train,2610,125,96000,2786,401184,497184
train,2611,204,156672,7419,1068336,1225008
train,2612,116,89088,2399,345456,434544
train,2613,38,29184,258,37152,66336
train,2614,105,80640,1966,283104,363744
train,2615,41,31488,300,43200,74688
train,2616,94,72192,1575,226800,298992
train,2617,18,13824,58,8352,22176
train,2618,163,125184,4737,682128,807312
train,2619,26,19968,121,17424,37392
train,2620,415,318720,30702,4421088,4739808
train,2621,114,87552,2317,333648,421200
train,2622,76,58368,1030,148320,206688
train,2623,58,44544,600,86400,130944
train,2624,90,69120,1444,207936,277056
train,2625,157,120576,4394,632736,753312
train,2626,66,50688,777,111888,162576
train,2627,454,348672,36744,5291136,5639808
train,2628,177,135936,5585,804240,940176
train,2629,52,39936,482,69408,109344
train,2630,177,135936,5585,804240,940176
train,2631,34,26112,206,29664,55776
train,2632,40,30720,286,41184,71904
train,2633,110,84480,2157,310608,395088
train,2634,60,46080,642,92448,138528
train,2635,117,89856,2441,351504,441360
train,2636,190,145920,6436,926784,1072704
train,2637,97,74496,1678,241632,316128
train,2638,282,216576,14177,2041488,2258064
train,2639,119,91392,2525,363600,454992
train,2640,26,19968,121,17424,37392
train,2641,27,20736,130,18720,39456
train,2642,102,78336,1855,267120,345456
train,2643,165,126720,4854,698976,825696
train,2644,53,40704,501,72144,112848
train,2645,422,324096,31746,4571424,4895520
train,2646,129,99072,2967,427248,526320
train,2647,57,43776,580,83520,127296
train,2648,30,23040,161,23184,46224
train,2649,31,23808,172,24768,48576
train,2650,43,33024,330,47520,80544
train,2651,88,67584,1381,198864,266448
train,2652,55,42240,540,77760,120000
train,2653,72,55296,924,133056,188352
train,2654,27,20736,130,18720,39456
train,2655,221,169728,8707,1253808,1423536
train,2656,354,271872,22340,3216960,3488832
train,2657,52,39936,482,69408,109344
train,2658,46,35328,378,54432,89760
train,2659,15,11520,40,5760,17280
train,2660,311,238848,17242,2482848,2721696
train,2661,197,151296,6919,996336,1147632
train,2662,98,75264,1712,246528,321792
train,2663,85,65280,1288,185472,250752
train,2664,110,84480,2157,310608,395088
train,2665,80,61440,1141,164304,225744
train,2666,15,11520,40,5760,17280
train,2667,105,80640,1966,283104,363744
train,2668,41,31488,300,43200,74688
train,2669,13,9984,30,4320,14304
train,2670,263,201984,12331,1775664,1977648
train,2671,505,387840,45462,6546528,6934368
train,2672,147,112896,3852,554688,667584
train,2673,52,39936,482,69408,109344
train,2674,28,21504,140,20160,41664
train,2675,233,178944,9678,1393632,1572576
train,2676,249,191232,11053,1591632,1782864
train,2677,41,31488,300,43200,74688
train,2678,124,95232,2741,394704,489936
train,2679,23,17664,95,13680,31344
train,2680,158,121344,4451,640944,762288
train,2681,53,40704,501,72144,112848
train,2682,151,115968,4065,585360,701328
train,2683,70,53760,874,125856,179616
train,2684,87,66816,1350,194400,261216
train,2685,29,22272,150,21600,43872
train,2686,76,58368,1030,148320,206688
train,2687,80,61440,1141,164304,225744
train,2688,50,38400,446,64224,102624
train,2689,118,90624,2482,357408,448032
train,2690,231,177408,9513,1369872,1547280
train,2691,127,97536,2876,414144,511680
train,2692,64,49152,730,105120,154272
train,2693,62,47616,686,98784,146400
train,2694,112,86016,2236,321984,408000
train,2695,51,39168,464,66816,105984
train,2696,397,304896,28096,4045824,4350720
train,2697,96,73728,1643,236592,310320
train,2698,55,42240,540,77760,120000
train,2699,29,22272,150,21600,43872
train,2700,77,59136,1057,152208,211344
train,2701,51,39168,464,66816,105984
train,2702,523,401664,46550,6703200,7104864
train,2703,13,9984,30,4320,14304
train,2704,333,255744,19768,2846592,3102336
train,2705,82,62976,1199,172656,235632
train,2706,25,19200,112,16128,35328
train,2707,25,19200,112,16128,35328
train,2708,58,44544,600,86400,130944
train,2709,29,22272,150,21600,43872
train,2710,133,102144,3154,454176,556320
train,2711,25,19200,112,16128,35328
train,2712,138,105984,3395,488880,594864
train,2713,14,10752,35,5040,15792
train,2714,136,104448,3298,474912,579360
train,2715,11,8448,22,3168,11616
train,2716,317,243456,17914,2579616,2823072
train,2717,52,39936,482,69408,109344
train,2718,271,208128,13092,1885248,2093376
train,2719,123,94464,2697,388368,482832
train,2720,91,69888,1477,212688,282576
train,2721,23,17664,95,13680,31344
train,2722,97,74496,1678,241632,316128
train,2723,230,176640,9431,1358064,1534704
train,2724,44,33792,345,49680,83472
train,2725,290,222720,14992,2158848,2381568
train,2726,375,288000,25069,3609936,3897936
train,2727,103,79104,1892,272448,351552
train,2728,59,45312,621,89424,134736
train,2729,87,66816,1350,194400,261216
train,2730,44,33792,345,49680,83472
train,2731,52,39936,482,69408,109344
train,2732,59,45312,621,89424,134736
train,2733,104,79872,1928,277632,357504
train,2734,209,160512,7787,1121328,1281840
train,2735,121,92928,2610,375840,468768
train,2736,64,49152,730,105120,154272
train,2737,53,40704,501,72144,112848
train,2738,61,46848,664,95616,142464
train,2739,104,79872,1928,277632,357504
train,2740,57,43776,580,83520,127296
train,2741,36,27648,231,33264,60912
train,2742,39,29952,271,39024,68976
train,2743,32,24576,183,26352,50928
train,2744,114,87552,2317,333648,421200
train,2745,72,55296,924,133056,188352
train,2746,15,11520,40,5760,17280
train,2747,85,65280,1288,185472,250752
train,2748,104,79872,1928,277632,357504
train,2749,112,86016,2236,321984,408000
train,2750,53,40704,501,72144,112848
train,2751,943,724224,84884,12223296,12947520
train,2752,23,17664,95,13680,31344
train,2753,11,8448,22,3168,11616
train,2754,374,287232,24935,3590640,3877872
train,2755,208,159744,7713,1110672,1270416
train,2756,134,102912,3201,460944,563856
train,2757,276,211968,13580,1955520,2167488
train,2758,629,483072,50292,7242048,7725120
train,2759,24,18432,103,14832,33264
train,2760,66,50688,777,111888,162576
train,2761,12,9216,26,3744,12960
train,2762,70,53760,874,125856,179616
train,2763,97,74496,1678,241632,316128
train,2764,161,123648,4621,665424,789072
train,2765,28,21504,140,20160,41664
train,2766,58,44544,600,86400,130944
train,2767,67,51456,801,115344,166800
train,2768,68,52224,825,118800,171024
train,2769,84,64512,1258,181152,245664
train,2770,283,217344,14277,2055888,2273232
train,2771,312,239616,17353,2498832,2738448
train,2772,15,11520,40,5760,17280
train,2773,135,103680,3249,467856,571536
train,2774,209,160512,7787,1121328,1281840
train,2775,75,57600,1003,144432,202032
train,2776,28,21504,140,20160,41664
train,2777,80,61440,1141,164304,225744
train,2778,23,17664,95,13680,31344
train,2779,26,19968,121,17424,37392
train,2780,65,49920,753,108432,158352
train,2781,79,60672,1113,160272,220944
train,2782,188,144384,6301,907344,1051728
train,2783,112,86016,2236,321984,408000
train,2784,417,320256,30999,4463856,4784112
train,2785,254,195072,11501,1656144,1851216
train,2786,430,330240,32962,4746528,5076768
train,2787,84,64512,1258,181152,245664
train,2788,93,71424,1542,222048,293472
train,2789,153,117504,4173,600912,718416
train,2790,98,75264,1712,246528,321792
train,2791,123,94464,2697,388368,482832
train,2792,62,47616,686,98784,146400
train,2793,323,248064,18599,2678256,2926320
train,2794,85,65280,1288,185472,250752
train,2795,55,42240,540,77760,120000
train,2796,66,50688,777,111888,162576
train,2797,82,62976,1199,172656,235632
train,2798,107,82176,2041,293904,376080
train,2799,528,405504,46637,6715728,7121232
train,2800,146,112128,3800,547200,659328
train,2801,26,19968,121,17424,37392
train,2802,212,162816,8012,1153728,1316544
train,2803,55,42240,540,77760,120000
train,2804,219,168192,8550,1231200,1399392
train,2805,81,62208,1170,168480,230688
train,2806,121,92928,2610,375840,468768
train,2807,207,158976,7639,1100016,1258992
train,2808,43,33024,330,47520,80544
train,2809,43,33024,330,47520,80544
train,2810,111,85248,2197,316368,401616
train,2811,114,87552,2317,333648,421200
train,2812,108,82944,2080,299520,382464
train,2813,136,104448,3298,474912,579360
train,2814,223,171264,8865,1276560,1447824
train,2815,306,235008,16692,2403648,2638656
train,2816,86,66048,1319,189936,255984
train,2817,48,36864,411,59184,96048
train,2818,107,82176,2041,293904,376080
train,2819,97,74496,1678,241632,316128
train,2820,17,13056,52,7488,20544
train,2821,226,173568,9105,1311120,1484688
train,2822,223,171264,8865,1276560,1447824
train,2823,97,74496,1678,241632,316128
train,2824,12,9216,26,3744,12960
train,2825,66,50688,777,111888,162576
train,2826,14,10752,35,5040,15792
train,2827,79,60672,1113,160272,220944
train,2828,28,21504,140,20160,41664
train,2829,120,92160,2567,369648,461808
train,2830,336,258048,20126,2898144,3156192
train,2831,276,211968,13580,1955520,2167488
train,2832,53,40704,501,72144,112848
train,2833,83,63744,1228,176832,240576
train,2834,379,291072,25606,3687264,3978336
train,2835,32,24576,183,26352,50928
train,2836,212,162816,8012,1153728,1316544
train,2837,102,78336,1855,267120,345456
train,2838,97,74496,1678,241632,316128
train,2839,181,139008,5840,840960,979968
train,2840,72,55296,924,133056,188352
train,2841,27,20736,130,18720,39456
train,2842,14,10752,35,5040,15792
train,2843,54,41472,520,74880,116352
train,2844,38,29184,258,37152,66336
train,2845,307,235776,16802,2419488,2655264
train,2846,27,20736,130,18720,39456
train,2847,19,14592,65,9360,23952
train,2848,387,297216,26699,3844656,4141872
train,2849,51,39168,464,66816,105984
train,2850,158,121344,4451,640944,762288
train,2851,36,27648,231,33264,60912
train,2852,108,82944,2080,299520,382464
train,2853,111,85248,2197,316368,401616
train,2854,46,35328,378,54432,89760
train,2855,29,22272,150,21600,43872
train,2856,32,24576,183,26352,50928
train,2857,105,80640,1966,283104,363744
train,2858,27,20736,130,18720,39456
train,2859,35,26880,219,31536,58416
train,2860,233,178944,9678,1393632,1572576
train,2861,171,131328,5213,750672,882000
train,2862,40,30720,286,41184,71904
train,2863,527,404736,46619,6713136,7117872
train,2864,40,30720,286,41184,71904
train,2865,77,59136,1057,152208,211344
train,2866,45,34560,361,51984,86544
train,2867,92,70656,1509,217296,287952
train,2868,75,57600,1003,144432,202032
train,2869,13,9984,30,4320,14304
train,2870,16,12288,46,6624,18912
train,2871,344,264192,21095,3037680,3301872
train,2872,76,58368,1030,148320,206688
train,2873,112,86016,2236,321984,408000
train,2874,48,36864,411,59184,96048
train,2875,97,74496,1678,241632,316128
train,2876,103,79104,1892,272448,351552
train,2877,78,59904,1085,156240,216144
train,2878,99,76032,1747,251568,327600
train,2879,322,247296,18484,2661696,2908992
train,2880,98,75264,1712,246528,321792
train,2881,82,62976,1199,172656,235632
train,2882,25,19200,112,16128,35328
train,2883,137,105216,3346,481824,587040
train,2884,109,83712,2118,304992,388704
train,2885,32,24576,183,26352,50928
train,2886,85,65280,1288,185472,250752
train,2887,46,35328,378,54432,89760
train,2888,81,62208,1170,168480,230688
train,2889,277,212736,13678,1969632,2182368
train,2890,27,20736,130,18720,39456
train,2891,110,84480,2157,310608,395088
train,2892,31,23808,172,24768,48576
train,2893,123,94464,2697,388368,482832
train,2894,76,58368,1030,148320,206688
train,2895,97,74496,1678,241632,316128
train,2896,12,9216,26,3744,12960
train,2897,44,33792,345,49680,83472
train,2898,76,58368,1030,148320,206688
train,2899,15,11520,40,5760,17280
train,2900,86,66048,1319,189936,255984
train,2901,81,62208,1170,168480,230688
train,2902,92,70656,1509,217296,287952
train,2903,121,92928,2610,375840,468768
train,2904,17,13056,52,7488,20544
train,2905,86,66048,1319,189936,255984
train,2906,179,137472,5712,822528,960000
train,2907,57,43776,580,83520,127296
train,2908,69,52992,849,122256,175248
train,2909,78,59904,1085,156240,216144
train,2910,238,182784,10098,1454112,1636896
train,2911,168,129024,5032,724608,853632
train,2912,119,91392,2525,363600,454992
train,2913,143,109824,3646,525024,634848
train,2914,102,78336,1855,267120,345456
train,2915,123,94464,2697,388368,482832
train,2916,52,39936,482,69408,109344
train,2917,123,94464,2697,388368,482832
train,2918,54,41472,520,74880,116352
train,2919,48,36864,411,59184,96048
train,2920,48,36864,411,59184,96048
train,2921,28,21504,140,20160,41664
train,2922,47,36096,394,56736,92832
train,2923,92,70656,1509,217296,287952
train,2924,47,36096,394,56736,92832
train,2925,928,712704,82432,11870208,12582912
train,2926,65,49920,753,108432,158352
train,2927,72,55296,924,133056,188352
train,2928,50,38400,446,64224,102624
train,2929,198,152064,6989,1006416,1158480
train,2930,9,6912,15,2160,9072
train,2931,419,321792,31297,4506768,4828560
train,2932,111,85248,2197,316368,401616
train,2933,13,9984,30,4320,14304
train,2934,721,553728,56786,8177184,8730912
train,2935,27,20736,130,18720,39456
train,2936,30,23040,161,23184,46224
train,2937,40,30720,286,41184,71904
train,2938,23,17664,95,13680,31344
train,2939,115,88320,2358,339552,427872
train,2940,80,61440,1141,164304,225744
train,2941,14,10752,35,5040,15792
train,2942,23,17664,95,13680,31344
train,2943,19,14592,65,9360,23952
train,2944,103,79104,1892,272448,351552
train,2945,32,24576,183,26352,50928
train,2946,113,86784,2277,327888,414672
train,2947,68,52224,825,118800,171024
train,2948,138,105984,3395,488880,594864
train,2949,15,11520,40,5760,17280
train,2950,142,109056,3595,517680,626736
train,2951,144,110592,3697,532368,642960
train,2952,54,41472,520,74880,116352
train,2953,81,62208,1170,168480,230688
train,2954,43,33024,330,47520,80544
train,2955,125,96000,2786,401184,497184
train,2956,15,11520,40,5760,17280
train,2957,185,142080,6101,878544,1020624
train,2958,125,96000,2786,401184,497184
train,2959,87,66816,1350,194400,261216
train,2960,105,80640,1966,283104,363744
train,2961,102,78336,1855,267120,345456
train,2962,13,9984,30,4320,14304
train,2963,87,66816,1350,194400,261216
train,2964,102,78336,1855,267120,345456
train,2965,124,95232,2741,394704,489936
train,2966,24,18432,103,14832,33264
train,2967,72,55296,924,133056,188352
train,2968,16,12288,46,6624,18912
train,2969,42,32256,315,45360,77616
train,2970,43,33024,330,47520,80544
train,2971,96,73728,1643,236592,310320
train,2972,120,92160,2567,369648,461808
train,2973,28,21504,140,20160,41664
train,2974,522,400896,46534,6700896,7101792
train,2975,54,41472,520,74880,116352
train,2976,27,20736,130,18720,39456
train,2977,77,59136,1057,152208,211344
train,2978,144,110592,3697,532368,642960
train,2979,25,19200,112,16128,35328
train,2980,57,43776,580,83520,127296
train,2981,381,292608,25877,3726288,4018896
train,2982,109,83712,2118,304992,388704
train,2983,35,26880,219,31536,58416
train,2984,122,93696,2654,382176,475872
train,2985,31,23808,172,24768,48576
train,2986,26,19968,121,17424,37392
train,2987,86,66048,1319,189936,255984
train,2988,29,22272,150,21600,43872
train,2989,217,166656,8395,1208880,1375536
train,2990,114,87552,2317,333648,421200
train,2991,51,39168,464,66816,105984
train,2992,240,184320,10268,1478592,1662912
train,2993,23,17664,95,13680,31344
train,2994,130,99840,3013,433872,533712
train,2995,28,21504,140,20160,41664
train,2996,14,10752,35,5040,15792
train,2997,14,10752,35,5040,15792
train,2998,900,691200,78070,11242080,11933280
train,2999,305,234240,16583,2387952,2622192
train,3000,78,59904,1085,156240,216144
train,3001,380,291840,25742,3706848,3998688
train,3002,215,165120,8241,1186704,1351824
train,3003,25,19200,112,16128,35328
train,3004,118,90624,2482,357408,448032
train,3005,15,11520,40,5760,17280
train,3006,28,21504,140,20160,41664
train,3007,119,91392,2525,363600,454992
train,3008,111,85248,2197,316368,401616
train,3009,14,10752,35,5040,15792
train,3010,249,191232,11053,1591632,1782864
train,3011,100,76800,1783,256752,333552
train,3012,49,37632,428,61632,99264
train,3013,132,101376,3106,447264,548640
train,3014,158,121344,4451,640944,762288
train,3015,47,36096,394,56736,92832
train,3016,198,152064,6989,1006416,1158480
train,3017,14,10752,35,5040,15792
train,3018,137,105216,3346,481824,587040
train,3019,64,49152,730,105120,154272
train,3020,78,59904,1085,156240,216144
train,3021,20,15360,72,10368,25728
train,3022,533,409344,46732,6729408,7138752
train,3023,84,64512,1258,181152,245664
train,3024,115,88320,2358,339552,427872
train,3025,102,78336,1855,267120,345456
train,3026,29,22272,150,21600,43872
train,3027,44,33792,345,49680,83472
train,3028,43,33024,330,47520,80544
train,3029,46,35328,378,54432,89760
train,3030,26,19968,121,17424,37392
train,3031,42,32256,315,45360,77616
train,3032,40,30720,286,41184,71904
train,3033,173,132864,5336,768384,901248
train,3034,159,122112,4507,649008,771120
train,3035,95,72960,1609,231696,304656
train,3036,140,107520,3494,503136,610656
train,3037,26,19968,121,17424,37392
train,3038,31,23808,172,24768,48576
train,3039,105,80640,1966,283104,363744
train,3040,91,69888,1477,212688,282576
train,3041,25,19200,112,16128,35328
train,3042,335,257280,20006,2880864,3138144
train,3043,81,62208,1170,168480,230688
train,3044,73,56064,950,136800,192864
train,3045,68,52224,825,118800,171024
train,3046,10,7680,18,2592,10272
train,3047,42,32256,315,45360,77616
train,3048,12,9216,26,3744,12960
train,3049,28,21504,140,20160,41664
train,3050,30,23040,161,23184,46224
train,3051,38,29184,258,37152,66336
train,3052,114,87552,2317,333648,421200
train,3053,40,30720,286,41184,71904
train,3054,24,18432,103,14832,33264
train,3055,48,36864,411,59184,96048
train,3056,62,47616,686,98784,146400
train,3057,39,29952,271,39024,68976
train,3058,69,52992,849,122256,175248
train,3059,39,29952,271,39024,68976
train,3060,100,76800,1783,256752,333552
train,3061,140,107520,3494,503136,610656
train,3062,101,77568,1819,261936,339504
train,3063,36,27648,231,33264,60912
train,3064,60,46080,642,92448,138528
train,3065,43,33024,330,47520,80544
train,3066,147,112896,3852,554688,667584
train,3067,43,33024,330,47520,80544
train,3068,112,86016,2236,321984,408000
train,3069,63,48384,708,101952,150336
train,3070,235,180480,9845,1417680,1598160
train,3071,110,84480,2157,310608,395088
train,3072,44,33792,345,49680,83472
train,3073,326,250368,18946,2728224,2978592
train,3074,162,124416,4679,673776,798192
train,3075,175,134400,5460,786240,920640
train,3076,74,56832,977,140688,197520
train,3077,75,57600,1003,144432,202032
train,3078,70,53760,874,125856,179616
train,3079,50,38400,446,64224,102624
train,3080,73,56064,950,136800,192864
train,3081,93,71424,1542,222048,293472
train,3082,11,8448,22,3168,11616
train,3083,134,102912,3201,460944,563856
train,3084,121,92928,2610,375840,468768
train,3085,261,200448,12144,1748736,1949184
train,3086,66,50688,777,111888,162576
train,3087,232,178176,9595,1381680,1559856
train,3088,32,24576,183,26352,50928
train,3089,60,46080,642,92448,138528
train,3090,16,12288,46,6624,18912
train,3091,73,56064,950,136800,192864
train,3092,103,79104,1892,272448,351552
train,3093,156,119808,4339,624816,744624
train,3094,229,175872,9349,1346256,1522128
train,3095,22,16896,87,12528,29424
train,3096,93,71424,1542,222048,293472
train,3097,113,86784,2277,327888,414672
train,3098,29,22272,150,21600,43872
train,3099,50,38400,446,64224,102624
train,3100,137,105216,3346,481824,587040
train,3101,116,89088,2399,345456,434544
train,3102,12,9216,26,3744,12960
train,3103,104,79872,1928,277632,357504
train,3104,140,107520,3494,503136,610656
train,3105,105,80640,1966,283104,363744
train,3106,29,22272,150,21600,43872
train,3107,805,618240,65351,9410544,10028784
train,3108,82,62976,1199,172656,235632
train,3109,25,19200,112,16128,35328
train,3110,111,85248,2197,316368,401616
train,3111,124,95232,2741,394704,489936
train,3112,222,170496,8786,1265184,1435680
train,3113,119,91392,2525,363600,454992
train,3114,107,82176,2041,293904,376080
train,3115,62,47616,686,98784,146400
train,3116,425,326400,32199,4636656,4963056
train,3117,57,43776,580,83520,127296
train,3118,25,19200,112,16128,35328
train,3119,177,135936,5585,804240,940176
train,3120,52,39936,482,69408,109344
train,3121,215,165120,8241,1186704,1351824
train,3122,68,52224,825,118800,171024
train,3123,84,64512,1258,181152,245664
train,3124,85,65280,1288,185472,250752
train,3125,118,90624,2482,357408,448032
train,3126,24,18432,103,14832,33264
train,3127,107,82176,2041,293904,376080
train,3128,45,34560,361,51984,86544
train,3129,102,78336,1855,267120,345456
train,3130,97,74496,1678,241632,316128
train,3131,17,13056,52,7488,20544
train,3132,133,102144,3154,454176,556320
train,3133,27,20736,130,18720,39456
train,3134,50,38400,446,64224,102624
train,3135,186,142848,6168,888192,1031040
train,3136,93,71424,1542,222048,293472
train,3137,24,18432,103,14832,33264
train,3138,110,84480,2157,310608,395088
train,3139,64,49152,730,105120,154272
train,3140,66,50688,777,111888,162576
train,3141,51,39168,464,66816,105984
train,3142,46,35328,378,54432,89760
train,3143,77,59136,1057,152208,211344
train,3144,121,92928,2610,375840,468768
train,3145,97,74496,1678,241632,316128
train,3146,130,99840,3013,433872,533712
train,3147,27,20736,130,18720,39456
train,3148,59,45312,621,89424,134736
train,3149,67,51456,801,115344,166800
train,3150,53,40704,501,72144,112848
train,3151,13,9984,30,4320,14304
train,3152,9,6912,15,2160,9072
train,3153,56,43008,559,80496,123504
train,3154,52,39936,482,69408,109344
train,3155,102,78336,1855,267120,345456
train,3156,29,22272,150,21600,43872
train,3157,56,43008,559,80496,123504
train,3158,29,22272,150,21600,43872
train,3159,285,218880,14480,2085120,2304000
train,3160,12,9216,26,3744,12960
train,3161,79,60672,1113,160272,220944
train,3162,23,17664,95,13680,31344
train,3163,42,32256,315,45360,77616
train,3164,59,45312,621,89424,134736
train,3165,203,155904,7346,1057824,1213728
train,3166,28,21504,140,20160,41664
train,3167,55,42240,540,77760,120000
train,3168,285,218880,14480,2085120,2304000
train,3169,128,98304,2921,420624,518928
train,3170,12,9216,26,3744,12960
train,3171,57,43776,580,83520,127296
train,3172,204,156672,7419,1068336,1225008
train,3173,14,10752,35,5040,15792
train,3174,40,30720,286,41184,71904
train,3175,115,88320,2358,339552,427872
train,3176,305,234240,16583,2387952,2622192
train,3177,69,52992,849,122256,175248
train,3178,72,55296,924,133056,188352
train,3179,27,20736,130,18720,39456
train,3180,43,33024,330,47520,80544
train,3181,163,125184,4737,682128,807312
train,3182,63,48384,708,101952,150336
train,3183,428,328704,32656,4702464,5031168
train,3184,11,8448,22,3168,11616
train,3185,238,182784,10098,1454112,1636896
train,3186,73,56064,950,136800,192864
train,3187,25,19200,112,16128,35328
train,3188,13,9984,30,4320,14304
train,3189,188,144384,6301,907344,1051728
train,3190,14,10752,35,5040,15792
train,3191,13,9984,30,4320,14304
train,3192,96,73728,1643,236592,310320
train,3193,231,177408,9513,1369872,1547280
train,3194,72,55296,924,133056,188352
train,3195,70,53760,874,125856,179616
train,3196,786,603648,63194,9099936,9703584
train,3197,58,44544,600,86400,130944
train,3198,123,94464,2697,388368,482832
train,3199,94,72192,1575,226800,298992
train,3200,26,19968,121,17424,37392
train,3201,64,49152,730,105120,154272
train,3202,204,156672,7419,1068336,1225008
train,3203,13,9984,30,4320,14304
train,3204,13,9984,30,4320,14304
train,3205,13,9984,30,4320,14304
train,3206,8,6144,12,1728,7872
train,3207,11,8448,22,3168,11616
train,3208,72,55296,924,133056,188352
train,3209,267,205056,12709,1830096,2035152
train,3210,210,161280,7862,1132128,1293408
train,3211,61,46848,664,95616,142464
train,3212,53,40704,501,72144,112848
train,3213,32,24576,183,26352,50928
train,3214,99,76032,1747,251568,327600
train,3215,101,77568,1819,261936,339504
train,3216,100,76800,1783,256752,333552
train,3217,107,82176,2041,293904,376080
train,3218,52,39936,482,69408,109344
train,3219,158,121344,4451,640944,762288
train,3220,64,49152,730,105120,154272
train,3221,11,8448,22,3168,11616
train,3222,13,9984,30,4320,14304
train,3223,333,255744,19768,2846592,3102336
train,3224,46,35328,378,54432,89760
train,3225,447,343296,35619,5129136,5472432
train,3226,170,130560,5152,741888,872448
train,3227,347,266496,21465,3090960,3357456
train,3228,32,24576,183,26352,50928
train,3229,25,19200,112,16128,35328
train,3230,358,274944,22847,3289968,3564912
train,3231,112,86016,2236,321984,408000
train,3232,602,462336,48958,7049952,7512288
train,3233,133,102144,3154,454176,556320
train,3234,26,19968,121,17424,37392
train,3235,95,72960,1609,231696,304656
train,3236,119,91392,2525,363600,454992
train,3237,32,24576,183,26352,50928
train,3238,295,226560,15514,2234016,2460576
train,3239,159,122112,4507,649008,771120
train,3240,270,207360,12996,1871424,2078784
train,3241,72,55296,924,133056,188352
train,3242,68,52224,825,118800,171024
train,3243,102,78336,1855,267120,345456
train,3244,310,238080,17132,2467008,2705088
train,3245,274,210432,13384,1927296,2137728
train,3246,25,19200,112,16128,35328
train,3247,77,59136,1057,152208,211344
train,3248,104,79872,1928,277632,357504
train,3249,34,26112,206,29664,55776
train,3250,213,163584,8088,1164672,1328256
train,3251,77,59136,1057,152208,211344
train,3252,23,17664,95,13680,31344
train,3253,111,85248,2197,316368,401616
train,3254,51,39168,464,66816,105984
train,3255,74,56832,977,140688,197520
train,3256,46,35328,378,54432,89760
train,3257,24,18432,103,14832,33264
train,3258,92,70656,1509,217296,287952
train,3259,10,7680,18,2592,10272
train,3260,110,84480,2157,310608,395088
train,3261,245,188160,10701,1540944,1729104
train,3262,124,95232,2741,394704,489936
train,3263,105,80640,1966,283104,363744
train,3264,42,32256,315,45360,77616
train,3265,54,41472,520,74880,116352
train,3266,251,192768,11231,1617264,1810032
train,3267,14,10752,35,5040,15792
train,3268,80,61440,1141,164304,225744
train,3269,154,118272,4228,608832,727104
train,3270,89,68352,1412,203328,271680
train,3271,318,244224,18027,2595888,2840112
train,3272,65,49920,753,108432,158352
train,3273,49,37632,428,61632,99264
train,3274,17,13056,52,7488,20544
train,3275,292,224256,15200,2188800,2413056
train,3276,22,16896,87,12528,29424
train,3277,42,32256,315,45360,77616
train,3278,38,29184,258,37152,66336
train,3279,144,110592,3697,532368,642960
train,3280,106,81408,2003,288432,369840
train,3281,119,91392,2525,363600,454992
train,3282,25,19200,112,16128,35328
train,3283,79,60672,1113,160272,220944
train,3284,227,174336,9186,1322784,1497120
train,3285,82,62976,1199,172656,235632
train,3286,147,112896,3852,554688,667584
train,3287,75,57600,1003,144432,202032
train,3288,314,241152,17577,2531088,2772240
train,3289,95,72960,1609,231696,304656
train,3290,10,7680,18,2592,10272
train,3291,130,99840,3013,433872,533712
train,3292,168,129024,5032,724608,853632
train,3293,76,58368,1030,148320,206688
train,3294,11,8448,22,3168,11616
train,3295,96,73728,1643,236592,310320
train,3296,70,53760,874,125856,179616
train,3297,194,148992,6709,966096,1115088
train,3298,49,37632,428,61632,99264
train,3299,50,38400,446,64224,102624
train,3300,13,9984,30,4320,14304
train,3301,79,60672,1113,160272,220944
train,3302,63,48384,708,101952,150336
train,3303,229,175872,9349,1346256,1522128
train,3304,745,572160,58977,8492688,9064848
train,3305,16,12288,46,6624,18912
train,3306,88,67584,1381,198864,266448
train,3307,116,89088,2399,345456,434544
train,3308,19,14592,65,9360,23952
train,3309,97,74496,1678,241632,316128
train,3310,60,46080,642,92448,138528
train,3311,368,282624,24142,3476448,3759072
train,3312,183,140544,5970,859680,1000224
train,3313,102,78336,1855,267120,345456
train,3314,17,13056,52,7488,20544
train,3315,278,213504,13777,1983888,2197392
train,3316,45,34560,361,51984,86544
train,3317,194,148992,6709,966096,1115088
train,3318,114,87552,2317,333648,421200
train,3319,280,215040,13976,2012544,2227584
train,3320,97,74496,1678,241632,316128
train,3321,95,72960,1609,231696,304656
train,3322,10,7680,18,2592,10272
train,3323,79,60672,1113,160272,220944
train,3324,62,47616,686,98784,146400
train,3325,152,116736,4119,593136,709872
train,3326,44,33792,345,49680,83472
train,3327,13,9984,30,4320,14304
train,3328,97,74496,1678,241632,316128
train,3329,201,154368,7202,1037088,1191456
train,3330,90,69120,1444,207936,277056
train,3331,12,9216,26,3744,12960
train,3332,11,8448,22,3168,11616
train,3333,175,134400,5460,786240,920640
train,3334,271,208128,13092,1885248,2093376
train,3335,269,206592,12900,1857600,2064192
train,3336,60,46080,642,92448,138528
train,3337,371,284928,24537,3533328,3818256
train,3338,97,74496,1678,241632,316128
train,3339,102,78336,1855,267120,345456
train,3340,102,78336,1855,267120,345456
train,3341,25,19200,112,16128,35328
train,3342,11,8448,22,3168,11616
train,3343,106,81408,2003,288432,369840
train,3344,18,13824,58,8352,22176
train,3345,72,55296,924,133056,188352
train,3346,73,56064,950,136800,192864
train,3347,120,92160,2567,369648,461808
train,3348,204,156672,7419,1068336,1225008
train,3349,31,23808,172,24768,48576
train,3350,12,9216,26,3744,12960
train,3351,243,186624,10527,1515888,1702512
train,3352,90,69120,1444,207936,277056
train,3353,30,23040,161,23184,46224
train,3354,60,46080,642,92448,138528
train,3355,60,46080,642,92448,138528
train,3356,52,39936,482,69408,109344
train,3357,234,179712,9761,1405584,1585296
train,3358,65,49920,753,108432,158352
train,3359,236,181248,9929,1429776,1611024
train,3360,316,242688,17801,2563344,2806032
train,3361,294,225792,15409,2218896,2444688
train,3362,28,21504,140,20160,41664
train,3363,605,464640,49094,7069536,7534176
train,3364,65,49920,753,108432,158352
train,3365,98,75264,1712,246528,321792
train,3366,132,101376,3106,447264,548640
train,3367,20,15360,72,10368,25728
train,3368,149,114432,3958,569952,684384
train,3369,51,39168,464,66816,105984
train,3370,116,89088,2399,345456,434544
train,3371,81,62208,1170,168480,230688
train,3372,59,45312,621,89424,134736
train,3373,185,142080,6101,878544,1020624
train,3374,79,60672,1113,160272,220944
train,3375,51,39168,464,66816,105984
train,3376,27,20736,130,18720,39456
train,3377,62,47616,686,98784,146400
train,3378,116,89088,2399,345456,434544
train,3379,878,674304,74838,10776672,11450976
train,3380,48,36864,411,59184,96048
train,3381,26,19968,121,17424,37392
train,3382,109,83712,2118,304992,388704
train,3383,122,93696,2654,382176,475872
train,3384,80,61440,1141,164304,225744
train,3385,15,11520,40,5760,17280
train,3386,64,49152,730,105120,154272
train,3387,107,82176,2041,293904,376080
train,3388,22,16896,87,12528,29424
train,3389,100,76800,1783,256752,333552
train,3390,49,37632,428,61632,99264
train,3391,38,29184,258,37152,66336
train,3392,23,17664,95,13680,31344
train,3393,100,76800,1783,256752,333552
train,3394,65,49920,753,108432,158352
train,3395,313,240384,17465,2514960,2755344
train,3396,73,56064,950,136800,192864
train,3397,30,23040,161,23184,46224
train,3398,197,151296,6919,996336,1147632
train,3399,15,11520,40,5760,17280
train,3400,379,291072,25606,3687264,3978336
train,3401,140,107520,3494,503136,610656
train,3402,267,205056,12709,1830096,2035152
train,3403,63,48384,708,101952,150336
train,3404,66,50688,777,111888,162576
train,3405,82,62976,1199,172656,235632
train,3406,382,293376,26013,3745872,4039248
train,3407,79,60672,1113,160272,220944
train,3408,36,27648,231,33264,60912
train,3409,95,72960,1609,231696,304656
train,3410,95,72960,1609,231696,304656
train,3411,120,92160,2567,369648,461808
train,3412,139,106752,3445,496080,602832
train,3413,62,47616,686,98784,146400
train,3414,685,526080,53885,7759440,8285520
train,3415,114,87552,2317,333648,421200
train,3416,30,23040,161,23184,46224
train,3417,118,90624,2482,357408,448032
train,3418,224,172032,8945,1288080,1460112
train,3419,70,53760,874,125856,179616
train,3420,41,31488,300,43200,74688
train,3421,195,149760,6779,976176,1125936
train,3422,51,39168,464,66816,105984
train,3423,61,46848,664,95616,142464
train,3424,19,14592,65,9360,23952
train,3425,65,49920,753,108432,158352
train,3426,109,83712,2118,304992,388704
train,3427,166,127488,4913,707472,834960
train,3428,44,33792,345,49680,83472
train,3429,26,19968,121,17424,37392
train,3430,94,72192,1575,226800,298992
train,3431,141,108288,3544,510336,618624
train,3432,293,225024,15304,2203776,2428800
train,3433,332,254976,19649,2829456,3084432
train,3434,43,33024,330,47520,80544
train,3435,230,176640,9431,1358064,1534704
train,3436,15,11520,40,5760,17280
train,3437,264,202752,12425,1789200,1991952
train,3438,463,355584,38215,5502960,5858544
train,3439,138,105984,3395,488880,594864
train,3440,87,66816,1350,194400,261216
train,3441,116,89088,2399,345456,434544
train,3442,99,76032,1748,251712,327744
train,3443,24,18432,103,14832,33264
train,3444,196,150528,6849,986256,1136784
train,3445,104,79872,1928,277632,357504
train,3446,24,18432,103,14832,33264
train,3447,80,61440,1141,164304,225744
train,3448,205,157440,7492,1078848,1236288
train,3449,249,191232,11053,1591632,1782864
train,3450,11,8448,22,3168,11616
train,3451,15,11520,40,5760,17280
train,3452,16,12288,46,6624,18912
train,3453,25,19200,112,16128,35328
train,3454,201,154368,7202,1037088,1191456
train,3455,11,8448,22,3168,11616
train,3456,103,79104,1892,272448,351552
train,3457,93,71424,1542,222048,293472
train,3458,138,105984,3395,488880,594864
train,3459,27,20736,130,18720,39456
train,3460,96,73728,1643,236592,310320
train,3461,47,36096,394,56736,92832
train,3462,41,31488,300,43200,74688
train,3463,494,379392,43503,6264432,6643824
train,3464,62,47616,686,98784,146400
train,3465,12,9216,26,3744,12960
train,3466,122,93696,2654,382176,475872
train,3467,49,37632,428,61632,99264
train,3468,106,81408,2003,288432,369840
train,3469,98,75264,1712,246528,321792
train,3470,19,14592,65,9360,23952
train,3471,14,10752,35,5040,15792
train,3472,113,86784,2277,327888,414672
train,3473,660,506880,52143,7508592,8015472
train,3474,29,22272,150,21600,43872
train,3475,39,29952,271,39024,68976
train,3476,16,12288,46,6624,18912
train,3477,38,29184,258,37152,66336
train,3478,102,78336,1855,267120,345456
train,3479,108,82944,2080,299520,382464
train,3480,101,77568,1819,261936,339504
train,3481,180,138240,5776,831744,969984
train,3482,291,223488,15096,2173824,2397312
train,3483,38,29184,258,37152,66336
train,3484,114,87552,2317,333648,421200
train,3485,88,67584,1381,198864,266448
train,3486,158,121344,4451,640944,762288
train,3487,237,182016,10013,1441872,1623888
train,3488,111,85248,2197,316368,401616
train,3489,39,29952,271,39024,68976
train,3490,194,148992,6709,966096,1115088
train,3491,81,62208,1170,168480,230688
train,3492,82,62976,1199,172656,235632
train,3493,36,27648,231,33264,60912
train,3494,149,114432,3958,569952,684384
train,3495,13,9984,30,4320,14304
train,3496,365,280320,23750,3420000,3700320
train,3497,290,222720,14992,2158848,2381568
train,3498,75,57600,1003,144432,202032
train,3499,141,108288,3544,510336,618624
train,3500,16,12288,46,6624,18912
train,3501,93,71424,1542,222048,293472
train,3502,49,37632,428,61632,99264
train,3503,296,227328,15619,2249136,2476464
train,3504,81,62208,1170,168480,230688
train,3505,508,390144,46004,6624576,7014720
train,3506,105,80640,1966,283104,363744
train,3507,25,19200,112,16128,35328
train,3508,286,219648,14582,2099808,2319456
train,3509,18,13824,58,8352,22176
train,3510,215,165120,8241,1186704,1351824
train,3511,582,446976,48138,6931872,7378848
train,3512,277,212736,13678,1969632,2182368
train,3513,46,35328,378,54432,89760
train,3514,17,13056,52,7488,20544
train,3515,174,133632,5397,777168,910800
train,3516,98,75264,1712,246528,321792
train,3517,193,148224,6641,956304,1104528
train,3518,394,302592,27674,3985056,4287648
train,3519,40,30720,286,41184,71904
train,3520,88,67584,1381,198864,266448
train,3521,121,92928,2610,375840,468768
train,3522,27,20736,130,18720,39456
train,3523,41,31488,300,43200,74688
train,3524,234,179712,9761,1405584,1585296
train,3525,85,65280,1288,185472,250752
train,3526,14,10752,35,5040,15792
train,3527,76,58368,1030,148320,206688
train,3528,60,46080,642,92448,138528
train,3529,65,49920,753,108432,158352
train,3530,92,70656,1509,217296,287952
train,3531,66,50688,777,111888,162576
train,3532,109,83712,2118,304992,388704
train,3533,14,10752,35,5040,15792
train,3534,253,194304,11411,1643184,1837488
train,3535,75,57600,1003,144432,202032
train,3536,104,79872,1928,277632,357504
train,3537,13,9984,30,4320,14304
train,3538,16,12288,46,6624,18912
train,3539,195,149760,6779,976176,1125936
train,3540,71,54528,899,129456,183984
train,3541,24,18432,103,14832,33264
train,3542,29,22272,150,21600,43872
train,3543,66,50688,777,111888,162576
train,3544,72,55296,924,133056,188352
train,3545,585,449280,48252,6948288,7397568
train,3546,68,52224,825,118800,171024
train,3547,24,18432,103,14832,33264
train,3548,229,175872,9349,1346256,1522128
train,3549,57,43776,580,83520,127296
train,3550,41,31488,300,43200,74688
train,3551,15,11520,40,5760,17280
train,3552,62,47616,686,98784,146400
train,3553,147,112896,3852,554688,667584
train,3554,91,69888,1477,212688,282576
train,3555,49,37632,428,61632,99264
train,3556,48,36864,411,59184,96048
train,3557,210,161280,7862,1132128,1293408
train,3558,643,493824,51085,7356240,7850064
train,3559,110,84480,2157,310608,395088
train,3560,50,38400,446,64224,102624
train,3561,269,206592,12900,1857600,2064192
train,3562,98,75264,1712,246528,321792
train,3563,29,22272,150,21600,43872
train,3564,93,71424,1542,222048,293472
train,3565,250,192000,11142,1604448,1796448
train,3566,135,103680,3249,467856,571536
train,3567,147,112896,3852,554688,667584
train,3568,12,9216,26,3744,12960
train,3569,327,251136,19062,2744928,2996064
train,3570,67,51456,801,115344,166800
train,3571,60,46080,642,92448,138528
train,3572,60,46080,642,92448,138528
train,3573,99,76032,1747,251568,327600
train,3574,315,241920,17689,2547216,2789136
train,3575,195,149760,6779,976176,1125936
train,3576,24,18432,103,14832,33264
train,3577,25,19200,112,16128,35328
train,3578,60,46080,642,92448,138528
train,3579,26,19968,121,17424,37392
train,3580,115,88320,2358,339552,427872
train,3581,27,20736,130,18720,39456
train,3582,72,55296,924,133056,188352
train,3583,32,24576,183,26352,50928
train,3584,189,145152,6368,916992,1062144
train,3585,213,163584,8088,1164672,1328256
train,3586,104,79872,1928,277632,357504
train,3587,450,345600,36099,5198256,5543856
train,3588,287,220416,14684,2114496,2334912
train,3589,55,42240,540,77760,120000
train,3590,38,29184,258,37152,66336
train,3591,77,59136,1057,152208,211344
train,3592,107,82176,2041,293904,376080
train,3593,42,32256,315,45360,77616
train,3594,59,45312,621,89424,134736
train,3595,77,59136,1057,152208,211344
train,3596,59,45312,621,89424,134736
train,3597,112,86016,2236,321984,408000
train,3598,77,59136,1057,152208,211344
train,3599,15,11520,40,5760,17280
train,3600,174,133632,5397,777168,910800
train,3601,233,178944,9678,1393632,1572576
train,3602,54,41472,520,74880,116352
train,3603,64,49152,730,105120,154272
train,3604,93,71424,1542,222048,293472
train,3605,252,193536,11321,1630224,1823760
train,3606,93,71424,1542,222048,293472
train,3607,428,328704,32656,4702464,5031168
train,3608,54,41472,520,74880,116352
train,3609,135,103680,3249,467856,571536
train,3610,282,216576,14177,2041488,2258064
train,3611,751,576768,59556,8576064,9152832
train,3612,119,91392,2525,363600,454992
train,3613,50,38400,446,64224,102624
train,3614,418,321024,31147,4485168,4806192
train,3615,118,90624,2482,357408,448032
train,3616,148,113664,3905,562320,675984
train,3617,129,99072,2967,427248,526320
train,3618,45,34560,361,51984,86544
train,3619,226,173568,9105,1311120,1484688
train,3620,75,57600,1003,144432,202032
train,3621,112,86016,2236,321984,408000
train,3622,26,19968,121,17424,37392
train,3623,107,82176,2041,293904,376080
train,3624,101,77568,1819,261936,339504
train,3625,203,155904,7346,1057824,1213728
train,3626,35,26880,219,31536,58416
train,3627,121,92928,2610,375840,468768
train,3628,53,40704,501,72144,112848
train,3629,111,85248,2197,316368,401616
train,3630,54,41472,520,74880,116352
train,3631,73,56064,950,136800,192864
train,3632,71,54528,899,129456,183984
train,3633,15,11520,40,5760,17280
train,3634,72,55296,924,133056,188352
train,3635,38,29184,258,37152,66336
train,3636,230,176640,9431,1358064,1534704
train,3637,68,52224,825,118800,171024
train,3638,30,23040,161,23184,46224
train,3639,766,588288,61062,8792928,9381216
train,3640,16,12288,46,6624,18912
train,3641,81,62208,1170,168480,230688
train,3642,179,137472,5712,822528,960000
train,3643,24,18432,103,14832,33264
train,3644,26,19968,121,17424,37392
train,3645,60,46080,642,92448,138528
train,3646,27,20736,130,18720,39456
train,3647,13,9984,30,4320,14304
train,3648,99,76032,1747,251568,327600
train,3649,120,92160,2567,369648,461808
train,3650,24,18432,103,14832,33264
train,3651,34,26112,206,29664,55776
train,3652,81,62208,1170,168480,230688
train,3653,17,13056,52,7488,20544
train,3654,155,119040,4283,616752,735792
train,3655,43,33024,330,47520,80544
train,3656,77,59136,1057,152208,211344
train,3657,50,38400,446,64224,102624
train,3658,24,18432,103,14832,33264
train,3659,171,131328,5213,750672,882000
train,3660,250,192000,11142,1604448,1796448
train,3661,13,9984,30,4320,14304
train,3662,281,215808,14076,2026944,2242752
train,3663,16,12288,46,6624,18912
train,3664,72,55296,924,133056,188352
train,3665,23,17664,95,13680,31344
train,3666,194,148992,6709,966096,1115088
train,3667,34,26112,206,29664,55776
train,3668,27,20736,130,18720,39456
train,3669,61,46848,664,95616,142464
train,3670,284,218112,14378,2070432,2288544
train,3671,156,119808,4339,624816,744624
train,3672,204,156672,7419,1068336,1225008
train,3673,25,19200,112,16128,35328
train,3674,259,198912,11959,1722096,1921008
train,3675,42,32256,315,45360,77616
train,3676,204,156672,7419,1068336,1225008
train,3677,185,142080,6101,878544,1020624
train,3678,57,43776,580,83520,127296
train,3679,24,18432,103,14832,33264
train,3680,188,144384,6301,907344,1051728
train,3681,141,108288,3544,510336,618624
train,3682,125,96000,2786,401184,497184
train,3683,74,56832,977,140688,197520
train,3684,16,12288,46,6624,18912
train,3685,124,95232,2741,394704,489936
train,3686,194,148992,6709,966096,1115088
train,3687,27,20736,130,18720,39456
train,3688,14,10752,35,5040,15792
train,3689,112,86016,2236,321984,408000
train,3690,27,20736,130,18720,39456
train,3691,98,75264,1712,246528,321792
train,3692,25,19200,112,16128,35328
train,3693,10,7680,18,2592,10272
train,3694,101,77568,1819,261936,339504
train,3695,115,88320,2358,339552,427872
train,3696,108,82944,2080,299520,382464
train,3697,78,59904,1085,156240,216144
train,3698,82,62976,1199,172656,235632
train,3699,27,20736,130,18720,39456
train,3700,39,29952,271,39024,68976
train,3701,24,18432,103,14832,33264
train,3702,25,19200,112,16128,35328
train,3703,99,76032,1747,251568,327600
train,3704,82,62976,1199,172656,235632
train,3705,190,145920,6436,926784,1072704
train,3706,46,35328,378,54432,89760
train,3707,216,165888,8317,1197648,1363536
train,3708,15,11520,40,5760,17280
train,3709,220,168960,8628,1242432,1411392
train,3710,101,77568,1819,261936,339504
train,3711,100,76800,1783,256752,333552
train,3712,223,171264,8865,1276560,1447824
train,3713,185,142080,6101,878544,1020624
train,3714,57,43776,580,83520,127296
train,3715,53,40704,501,72144,112848
train,3716,28,21504,140,20160,41664
train,3717,34,26112,206,29664,55776
train,3718,13,9984,30,4320,14304
train,3719,216,165888,8317,1197648,1363536
train,3720,101,77568,1819,261936,339504
train,3721,73,56064,950,136800,192864
train,3722,27,20736,130,18720,39456
train,3723,80,61440,1141,164304,225744
train,3724,70,53760,874,125856,179616
train,3725,103,79104,1892,272448,351552
train,3726,89,68352,1412,203328,271680
train,3727,67,51456,801,115344,166800
train,3728,293,225024,15304,2203776,2428800
train,3729,156,119808,4339,624816,744624
train,3730,86,66048,1319,189936,255984
train,3731,33,25344,194,27936,53280
train,3732,75,57600,1003,144432,202032
train,3733,92,70656,1509,217296,287952
train,3734,645,495360,51204,7373376,7868736
train,3735,86,66048,1319,189936,255984
train,3736,252,193536,11321,1630224,1823760
train,3737,31,23808,172,24768,48576
train,3738,175,134400,5460,786240,920640
train,3739,136,104448,3298,474912,579360
train,3740,247,189696,10876,1566144,1755840
train,3741,13,9984,30,4320,14304
train,3742,26,19968,121,17424,37392
train,3743,66,50688,777,111888,162576
train,3744,102,78336,1855,267120,345456
train,3745,203,155904,7346,1057824,1213728
train,3746,96,73728,1643,236592,310320
train,3747,216,165888,8317,1197648,1363536
train,3748,24,18432,103,14832,33264
train,3749,12,9216,26,3744,12960
train,3750,45,34560,361,51984,86544
train,3751,110,84480,2157,310608,395088
train,3752,29,22272,150,21600,43872
train,3753,81,62208,1170,168480,230688
train,3754,52,39936,482,69408,109344
train,3755,173,132864,5336,768384,901248
train,3756,36,27648,231,33264,60912
train,3757,70,53760,874,125856,179616
train,3758,42,32256,315,45360,77616
train,3759,100,76800,1783,256752,333552
train,3760,825,633600,67761,9757584,10391184
train,3761,642,493056,51026,7347744,7840800
train,3762,29,22272,150,21600,43872
train,3763,51,39168,464,66816,105984
train,3764,49,37632,428,61632,99264
train,3765,281,215808,14076,2026944,2242752
train,3766,332,254976,19649,2829456,3084432
train,3767,158,121344,4451,640944,762288
train,3768,196,150528,6849,986256,1136784
train,3769,25,19200,112,16128,35328
train,3770,25,19200,112,16128,35328
train,3771,163,125184,4737,682128,807312
train,3772,27,20736,130,18720,39456
train,3773,57,43776,580,83520,127296
train,3774,37,28416,244,35136,63552
train,3775,82,62976,1199,172656,235632
train,3776,92,70656,1509,217296,287952
train,3777,130,99840,3013,433872,533712
train,3778,70,53760,874,125856,179616
train,3779,51,39168,464,66816,105984
train,3780,127,97536,2876,414144,511680
train,3781,101,77568,1819,261936,339504
train,3782,53,40704,501,72144,112848
train,3783,198,152064,6989,1006416,1158480
train,3784,15,11520,40,5760,17280
train,3785,78,59904,1085,156240,216144
train,3786,124,95232,2741,394704,489936
train,3787,265,203520,12519,1802736,2006256
train,3788,53,40704,501,72144,112848
train,3789,130,99840,3013,433872,533712
train,3790,132,101376,3106,447264,548640
train,3791,269,206592,12900,1857600,2064192
train,3792,132,101376,3106,447264,548640
train,3793,125,96000,2786,401184,497184
train,3794,315,241920,17689,2547216,2789136
train,3795,188,144384,6301,907344,1051728
train,3796,55,42240,540,77760,120000
train,3797,82,62976,1199,172656,235632
train,3798,28,21504,140,20160,41664
train,3799,36,27648,231,33264,60912
train,3800,54,41472,520,74880,116352
train,3801,113,86784,2277,327888,414672
train,3802,26,19968,121,17424,37392
train,3803,16,12288,46,6624,18912
train,3804,26,19968,121,17424,37392
train,3805,84,64512,1258,181152,245664
train,3806,76,58368,1030,148320,206688
train,3807,102,78336,1855,267120,345456
train,3808,58,44544,600,86400,130944
train,3809,188,144384,6301,907344,1051728
train,3810,153,117504,4173,600912,718416
train,3811,97,74496,1678,241632,316128
train,3812,12,9216,26,3744,12960
train,3813,182,139776,5905,850320,990096
train,3814,180,138240,5776,831744,969984
train,3815,134,102912,3201,460944,563856
train,3816,213,163584,8088,1164672,1328256
train,3817,73,56064,950,136800,192864
train,3818,54,41472,520,74880,116352
train,3819,92,70656,1509,217296,287952
train,3820,200,153600,7131,1026864,1180464
train,3821,104,79872,1928,277632,357504
train,3822,454,348672,36744,5291136,5639808
train,3823,13,9984,30,4320,14304
train,3824,115,88320,2358,339552,427872
train,3825,17,13056,52,7488,20544
train,3826,102,78336,1855,267120,345456
train,3827,118,90624,2482,357408,448032
train,3828,60,46080,642,92448,138528
train,3829,307,235776,16802,2419488,2655264
train,3830,7,5376,9,1296,6672
train,3831,620,476160,49818,7173792,7649952
train,3832,11,8448,22,3168,11616
train,3833,84,64512,1258,181152,245664
train,3834,75,57600,1003,144432,202032
train,3835,92,70656,1509,217296,287952
train,3836,40,30720,286,41184,71904
train,3837,181,139008,5840,840960,979968
train,3838,79,60672,1113,160272,220944
train,3839,47,36096,394,56736,92832
train,3840,114,87552,2317,333648,421200
train,3841,146,112128,3800,547200,659328
train,3842,9,6912,15,2160,9072
train,3843,55,42240,540,77760,120000
train,3844,40,30720,286,41184,71904
train,3845,59,45312,621,89424,134736
train,3846,340,261120,20608,2967552,3228672
train,3847,80,61440,1141,164304,225744
train,3848,55,42240,540,77760,120000
train,3849,393,301824,27533,3964752,4266576
train,3850,30,23040,161,23184,46224
train,3851,27,20736,130,18720,39456
train,3852,226,173568,9105,1311120,1484688
train,3853,91,69888,1477,212688,282576
train,3854,41,31488,300,43200,74688
train,3855,13,9984,30,4320,14304
train,3856,209,160512,7787,1121328,1281840
train,3857,19,14592,65,9360,23952
train,3858,38,29184,258,37152,66336
train,3859,144,110592,3697,532368,642960
train,3860,15,11520,40,5760,17280
train,3861,12,9216,26,3744,12960
train,3862,25,19200,112,16128,35328
train,3863,170,130560,5152,741888,872448
train,3864,219,168192,8550,1231200,1399392
train,3865,49,37632,428,61632,99264
train,3866,65,49920,753,108432,158352
train,3867,73,56064,950,136800,192864
train,3868,77,59136,1057,152208,211344
train,3869,61,46848,664,95616,142464
train,3870,28,21504,140,20160,41664
train,3871,16,12288,46,6624,18912
train,3872,62,47616,686,98784,146400
train,3873,58,44544,600,86400,130944
train,3874,506,388608,45643,6572592,6961200
train,3875,19,14592,65,9360,23952
train,3876,116,89088,2399,345456,434544
train,3877,43,33024,330,47520,80544
train,3878,222,170496,8786,1265184,1435680
train,3879,117,89856,2441,351504,441360
train,3880,68,52224,825,118800,171024
train,3881,18,13824,58,8352,22176
train,3882,14,10752,35,5040,15792
train,3883,190,145920,6436,926784,1072704
train,3884,13,9984,30,4320,14304
train,3885,764,586752,60856,8763264,9350016
train,3886,23,17664,95,13680,31344
train,3887,37,28416,244,35136,63552
train,3888,73,56064,950,136800,192864
train,3889,103,79104,1892,272448,351552
train,3890,44,33792,345,49680,83472
train,3891,37,28416,244,35136,63552
train,3892,114,87552,2317,333648,421200
train,3893,467,358656,38878,5598432,5957088
train,3894,137,105216,3346,481824,587040
train,3895,36,27648,231,33264,60912
train,3896,24,18432,103,14832,33264
train,3897,55,42240,540,77760,120000
train,3898,104,79872,1928,277632,357504
train,3899,457,350976,37231,5361264,5712240
train,3900,57,43776,580,83520,127296
train,3901,119,91392,2525,363600,454992
train,3902,76,58368,1030,148320,206688
train,3903,92,70656,1509,217296,287952
train,3904,43,33024,330,47520,80544
train,3905,15,11520,40,5760,17280
train,3906,277,212736,13678,1969632,2182368
train,3907,189,145152,6368,916992,1062144
train,3908,28,21504,140,20160,41664
train,3909,149,114432,3958,569952,684384
train,3910,32,24576,183,26352,50928
train,3911,51,39168,464,66816,105984
train,3912,94,72192,1575,226800,298992
train,3913,282,216576,14177,2041488,2258064
train,3914,110,84480,2157,310608,395088
train,3915,327,251136,19062,2744928,2996064
train,3916,137,105216,3346,481824,587040
train,3917,136,104448,3298,474912,579360
train,3918,273,209664,13286,1913184,2122848
train,3919,506,388608,45643,6572592,6961200
train,3920,268,205824,12804,1843776,2049600
train,3921,26,19968,121,17424,37392
train,3922,19,14592,65,9360,23952
train,3923,18,13824,58,8352,22176
train,3924,112,86016,2236,321984,408000
train,3925,59,45312,621,89424,134736
train,3926,169,129792,5092,733248,863040
train,3927,34,26112,206,29664,55776
train,3928,56,43008,559,80496,123504
train,3929,92,70656,1509,217296,287952
train,3930,97,74496,1678,241632,316128
train,3931,221,169728,8707,1253808,1423536
train,3932,98,75264,1712,246528,321792
train,3933,31,23808,172,24768,48576
train,3934,99,76032,1747,251568,327600
train,3935,478,367104,40731,5865264,6232368
train,3936,32,24576,183,26352,50928
train,3937,30,23040,161,23184,46224
train,3938,29,22272,150,21600,43872
train,3939,64,49152,730,105120,154272
train,3940,299,229632,15937,2294928,2524560
train,3941,33,25344,194,27936,53280
train,3942,699,536832,54958,7913952,8450784
train,3943,23,17664,95,13680,31344
train,3944,103,79104,1892,272448,351552
train,3945,143,109824,3646,525024,634848
train,3946,103,79104,1892,272448,351552
train,3947,11,8448,22,3168,11616
train,3948,51,39168,464,66816,105984
train,3949,13,9984,30,4320,14304
train,3950,13,9984,30,4320,14304
train,3951,65,49920,753,108432,158352
train,3952,43,33024,330,47520,80544
train,3953,85,65280,1288,185472,250752
train,3954,27,20736,130,18720,39456
train,3955,218,167424,8472,1219968,1387392
train,3956,239,183552,10183,1466352,1649904
train,3957,131,100608,3060,440640,541248
train,3958,20,15360,72,10368,25728
train,3959,85,65280,1288,185472,250752
train,3960,47,36096,394,56736,92832
train,3961,29,22272,150,21600,43872
train,3962,37,28416,244,35136,63552
train,3963,333,255744,19768,2846592,3102336
train,3964,81,62208,1170,168480,230688
train,3965,35,26880,219,31536,58416
train,3966,106,81408,2003,288432,369840
train,3967,101,77568,1819,261936,339504
train,3968,122,93696,2654,382176,475872
train,3969,98,75264,1712,246528,321792
train,3970,172,132096,5274,759456,891552
train,3971,60,46080,642,92448,138528
train,3972,111,85248,2197,316368,401616
train,3973,151,115968,4065,585360,701328
train,3974,34,26112,206,29664,55776
train,3975,118,90624,2482,357408,448032
train,3976,121,92928,2610,375840,468768
train,3977,134,102912,3201,460944,563856
train,3978,104,79872,1928,277632,357504
train,3979,59,45312,621,89424,134736
train,3980,59,45312,621,89424,134736
train,3981,58,44544,600,86400,130944
train,3982,144,110592,3697,532368,642960
train,3983,124,95232,2741,394704,489936
train,3984,91,69888,1477,212688,282576
train,3985,101,77568,1819,261936,339504
train,3986,244,187392,10614,1528416,1715808
train,3987,63,48384,708,101952,150336
train,3988,46,35328,378,54432,89760
train,3989,99,76032,1747,251568,327600
train,3990,361,277248,23232,3345408,3622656
train,3991,18,13824,58,8352,22176
train,3992,319,244992,18141,2612304,2857296
train,3993,225,172800,9025,1299600,1472400
train,3994,108,82944,2080,299520,382464
train,3995,294,225792,15409,2218896,2444688
train,3996,111,85248,2197,316368,401616
train,3997,26,19968,121,17424,37392
train,3998,17,13056,52,7488,20544
train,3999,65,49920,753,108432,158352
train,4000,106,81408,2003,288432,369840
train,4001,98,75264,1713,246672,321936
train,4002,25,19200,112,16128,35328
train,4003,59,45312,621,89424,134736
train,4004,118,90624,2482,357408,448032
train,4005,73,56064,950,136800,192864
train,4006,59,45312,621,89424,134736
train,4007,229,175872,9349,1346256,1522128
train,4008,38,29184,258,37152,66336
train,4009,89,68352,1412,203328,271680
train,4010,80,61440,1141,164304,225744
train,4011,188,144384,6301,907344,1051728
train,4012,11,8448,22,3168,11616
train,4013,61,46848,664,95616,142464
train,4014,475,364800,40221,5791824,6156624
train,4015,63,48384,708,101952,150336
train,4016,135,103680,3249,467856,571536
train,4017,131,100608,3060,440640,541248
train,4018,101,77568,1819,261936,339504
train,4019,23,17664,95,13680,31344
train,4020,95,72960,1609,231696,304656
train,4021,194,148992,6709,966096,1115088
train,4022,96,73728,1643,236592,310320
train,4023,79,60672,1113,160272,220944
train,4024,710,545280,55851,8042544,8587824
train,4025,38,29184,258,37152,66336
train,4026,212,162816,8012,1153728,1316544
train,4027,74,56832,977,140688,197520
train,4028,262,201216,12237,1762128,1963344
train,4029,67,51456,801,115344,166800
train,4030,78,59904,1085,156240,216144
train,4031,97,74496,1678,241632,316128
train,4032,35,26880,219,31536,58416
train,4033,34,26112,206,29664,55776
train,4034,82,62976,1199,172656,235632
train,4035,25,19200,112,16128,35328
train,4036,522,400896,46534,6700896,7101792
train,4037,77,59136,1057,152208,211344
train,4038,198,152064,6989,1006416,1158480
train,4039,69,52992,849,122256,175248
train,4040,27,20736,130,18720,39456
train,4041,72,55296,924,133056,188352
train,4042,137,105216,3346,481824,587040
train,4043,165,126720,4854,698976,825696
train,4044,763,585984,60754,8748576,9334560
train,4045,142,109056,3595,517680,626736
train,4046,360,276480,23103,3326832,3603312
train,4047,27,20736,130,18720,39456
train,4048,81,62208,1170,168480,230688
train,4049,97,74496,1678,241632,316128
train,4050,85,65280,1288,185472,250752
train,4051,128,98304,2921,420624,518928
train,4052,323,248064,18599,2678256,2926320
train,4053,159,122112,4507,649008,771120
train,4054,94,72192,1575,226800,298992
train,4055,59,45312,621,89424,134736
train,4056,84,64512,1258,181152,245664
train,4057,166,127488,4913,707472,834960
train,4058,51,39168,464,66816,105984
train,4059,102,78336,1855,267120,345456
train,4060,297,228096,15725,2264400,2492496
train,4061,13,9984,30,4320,14304
train,4062,42,32256,315,45360,77616
train,4063,117,89856,2441,351504,441360
train,4064,140,107520,3494,503136,610656
train,4065,221,169728,8707,1253808,1423536
train,4066,377,289536,25337,3648528,3938064
train,4067,178,136704,5648,813312,950016
train,4068,384,294912,26287,3785328,4080240
train,4069,55,42240,540,77760,120000
train,4070,71,54528,899,129456,183984
train,4071,68,52224,825,118800,171024
train,4072,12,9216,26,3744,12960
train,4073,58,44544,600,86400,130944
train,4074,428,328704,32656,4702464,5031168
train,4075,68,52224,825,118800,171024
train,4076,401,307968,28665,4127760,4435728
train,4077,126,96768,2830,407520,504288
train,4078,28,21504,140,20160,41664
train,4079,224,172032,8945,1288080,1460112
train,4080,48,36864,411,59184,96048
train,4081,24,18432,103,14832,33264
train,4082,62,47616,686,98784,146400
train,4083,69,52992,849,122256,175248
train,4084,173,132864,5336,768384,901248
train,4085,51,39168,464,66816,105984
train,4086,528,405504,46637,6715728,7121232
train,4087,29,22272,150,21600,43872
train,4088,109,83712,2118,304992,388704
train,4089,104,79872,1928,277632,357504
train,4090,58,44544,600,86400,130944
train,4091,53,40704,501,72144,112848
train,4092,13,9984,30,4320,14304
train,4093,211,162048,7937,1142928,1304976
train,4094,558,428544,47342,6817248,7245792
train,4095,56,43008,559,80496,123504
train,4096,38,29184,258,37152,66336
train,4097,69,52992,849,122256,175248
train,4098,100,76800,1783,256752,333552
train,4099,184,141312,6036,869184,1010496
train,4100,120,92160,2567,369648,461808
train,4101,27,20736,130,18720,39456
train,4102,102,78336,1855,267120,345456
train,4103,85,65280,1288,185472,250752
train,4104,54,41472,520,74880,116352
train,4105,44,33792,345,49680,83472
train,4106,332,254976,19649,2829456,3084432
train,4107,84,64512,1258,181152,245664
train,4108,118,90624,2482,357408,448032
train,4109,327,251136,19062,2744928,2996064
train,4110,136,104448,3298,474912,579360
train,4111,24,18432,103,14832,33264
train,4112,247,189696,10876,1566144,1755840
train,4113,57,43776,580,83520,127296
train,4114,179,137472,5712,822528,960000
train,4115,507,389376,45823,6598512,6987888
train,4116,528,405504,46637,6715728,7121232
train,4117,166,127488,4913,707472,834960
train,4118,247,189696,10876,1566144,1755840
train,4119,434,333312,33578,4835232,5168544
train,4120,112,86016,2236,321984,408000
train,4121,21,16128,79,11376,27504
train,4122,217,166656,8395,1208880,1375536
train,4123,45,34560,361,51984,86544
train,4124,93,71424,1542,222048,293472
train,4125,25,19200,112,16128,35328
train,4126,28,21504,140,20160,41664
train,4127,170,130560,5152,741888,872448
train,4128,47,36096,394,56736,92832
train,4129,619,475392,49767,7166448,7641840
train,4130,123,94464,2697,388368,482832
train,4131,122,93696,2654,382176,475872
train,4132,188,144384,6301,907344,1051728
train,4133,84,64512,1258,181152,245664
train,4134,16,12288,46,6624,18912
train,4135,52,39936,482,69408,109344
train,4136,86,66048,1319,189936,255984
train,4137,252,193536,11321,1630224,1823760
train,4138,77,59136,1057,152208,211344
train,4139,164,125952,4795,690480,816432
train,4140,422,324096,31746,4571424,4895520
train,4141,102,78336,1855,267120,345456
train,4142,162,124416,4679,673776,798192
train,4143,78,59904,1085,156240,216144
train,4144,114,87552,2317,333648,421200
train,4145,211,162048,7937,1142928,1304976
train,4146,87,66816,1350,194400,261216
train,4147,84,64512,1258,181152,245664
train,4148,63,48384,708,101952,150336
train,4149,206,158208,7565,1089360,1247568
train,4150,219,168192,8550,1231200,1399392
train,4151,218,167424,8472,1219968,1387392
train,4152,76,58368,1030,148320,206688
train,4153,15,11520,40,5760,17280
train,4154,74,56832,977,140688,197520
train,4155,24,18432,103,14832,33264
train,4156,170,130560,5152,741888,872448
train,4157,57,43776,580,83520,127296
train,4158,300,230400,16044,2310336,2540736
train,4159,41,31488,300,43200,74688
train,4160,44,33792,345,49680,83472
train,4161,113,86784,2277,327888,414672
train,4162,34,26112,206,29664,55776
train,4163,68,52224,825,118800,171024
train,4164,50,38400,446,64224,102624
train,4165,64,49152,730,105120,154272
train,4166,268,205824,12804,1843776,2049600
train,4167,112,86016,2236,321984,408000
train,4168,27,20736,130,18720,39456
train,4169,28,21504,140,20160,41664
train,4170,28,21504,140,20160,41664
train,4171,107,82176,2041,293904,376080
train,4172,58,44544,600,86400,130944
train,4173,61,46848,664,95616,142464
train,4174,68,52224,825,118800,171024
train,4175,152,116736,4119,593136,709872
train,4176,47,36096,394,56736,92832
train,4177,29,22272,150,21600,43872
train,4178,31,23808,172,24768,48576
train,4179,129,99072,2967,427248,526320
train,4180,491,377088,42977,6188688,6565776
train,4181,144,110592,3697,532368,642960
train,4182,114,87552,2317,333648,421200
train,4183,74,56832,977,140688,197520
train,4184,164,125952,4795,690480,816432
train,4185,175,134400,5460,786240,920640
train,4186,412,316416,30260,4357440,4673856
train,4187,71,54528,899,129456,183984
train,4188,141,108288,3544,510336,618624
train,4189,179,137472,5712,822528,960000
train,4190,162,124416,4679,673776,798192
train,4191,69,52992,849,122256,175248
train,4192,56,43008,559,80496,123504
train,4193,77,59136,1057,152208,211344
train,4194,56,43008,559,80496,123504
train,4195,25,19200,112,16128,35328
train,4196,17,13056,52,7488,20544
train,4197,61,46848,664,95616,142464
train,4198,61,46848,664,95616,142464
train,4199,55,42240,540,77760,120000
train,4200,844,648192,70183,10106352,10754544
train,4201,156,119808,4339,624816,744624
train,4202,108,82944,2080,299520,382464
train,4203,535,410880,46773,6735312,7146192
train,4204,131,100608,3060,440640,541248
train,4205,87,66816,1350,194400,261216
train,4206,105,80640,1966,283104,363744
train,4207,42,32256,315,45360,77616
train,4208,42,32256,315,45360,77616
train,4209,26,19968,121,17424,37392
train,4210,51,39168,464,66816,105984
train,4211,42,32256,315,45360,77616
train,4212,65,49920,753,108432,158352
train,4213,511,392448,46379,6678576,7071024
train,4214,88,67584,1381,198864,266448
train,4215,47,36096,394,56736,92832
train,4216,132,101376,3106,447264,548640
train,4217,11,8448,22,3168,11616
train,4218,67,51456,801,115344,166800
train,4219,518,397824,46473,6692112,7089936
train,4220,39,29952,271,39024,68976
train,4221,68,52224,825,118800,171024
train,4222,62,47616,686,98784,146400
train,4223,58,44544,600,86400,130944
train,4224,32,24576,183,26352,50928
train,4225,122,93696,2654,382176,475872
train,4226,44,33792,345,49680,83472
train,4227,31,23808,172,24768,48576
train,4228,47,36096,394,56736,92832
train,4229,119,91392,2525,363600,454992
train,4230,40,30720,286,41184,71904
train,4231,287,220416,14684,2114496,2334912
train,4232,723,555264,56961,8202384,8757648
train,4233,122,93696,2654,382176,475872
train,4234,49,37632,428,61632,99264
train,4235,25,19200,112,16128,35328
train,4236,55,42240,540,77760,120000
train,4237,107,82176,2041,293904,376080
train,4238,66,50688,777,111888,162576
train,4239,45,34560,361,51984,86544
train,4240,290,222720,14992,2158848,2381568
train,4241,53,40704,501,72144,112848
train,4242,73,56064,950,136800,192864
train,4243,256,196608,11683,1682352,1878960
train,4244,55,42240,540,77760,120000
train,4245,39,29952,271,39024,68976
train,4246,135,103680,3249,467856,571536
train,4247,69,52992,849,122256,175248
train,4248,26,19968,121,17424,37392
train,4249,73,56064,950,136800,192864
train,4250,24,18432,103,14832,33264
train,4251,105,80640,1966,283104,363744
train,4252,13,9984,30,4320,14304
train,4253,356,273408,22593,3253392,3526800
train,4254,316,242688,17801,2563344,2806032
train,4255,94,72192,1575,226800,298992
train,4256,214,164352,8164,1175616,1339968
train,4257,120,92160,2567,369648,461808
train,4258,40,30720,286,41184,71904
train,4259,101,77568,1819,261936,339504
train,4260,191,146688,6504,936576,1083264
train,4261,25,19200,112,16128,35328
train,4262,88,67584,1381,198864,266448
train,4263,44,33792,345,49680,83472
train,4264,13,9984,30,4320,14304
train,4265,92,70656,1509,217296,287952
train,4266,130,99840,3013,433872,533712
train,4267,56,43008,559,80496,123504
train,4268,158,121344,4451,640944,762288
train,4269,36,27648,231,33264,60912
train,4270,230,176640,9431,1358064,1534704
train,4271,72,55296,924,133056,188352
train,4272,172,132096,5274,759456,891552
train,4273,55,42240,540,77760,120000
train,4274,142,109056,3595,517680,626736
train,4275,77,59136,1057,152208,211344
train,4276,12,9216,26,3744,12960
train,4277,46,35328,378,54432,89760
train,4278,145,111360,3748,539712,651072
train,4279,166,127488,4913,707472,834960
train,4280,51,39168,464,66816,105984
train,4281,96,73728,1643,236592,310320
train,4282,106,81408,2003,288432,369840
train,4283,24,18432,103,14832,33264
train,4284,73,56064,950,136800,192864
train,4285,153,117504,4173,600912,718416
train,4286,99,76032,1747,251568,327600
train,4287,94,72192,1575,226800,298992
train,4288,122,93696,2654,382176,475872
train,4289,63,48384,708,101952,150336
train,4290,230,176640,9431,1358064,1534704
train,4291,533,409344,46732,6729408,7138752
train,4292,180,138240,5776,831744,969984
train,4293,60,46080,642,92448,138528
train,4294,112,86016,2236,321984,408000
train,4295,566,434688,47585,6852240,7286928
train,4296,211,162048,7937,1142928,1304976
train,4297,150,115200,4011,577584,692784
train,4298,189,145152,6368,916992,1062144
train,4299,175,134400,5460,786240,920640
train,4300,37,28416,244,35136,63552
train,4301,91,69888,1477,212688,282576
train,4302,13,9984,30,4320,14304
train,4303,174,133632,5397,777168,910800
train,4304,224,172032,8945,1288080,1460112
train,4305,240,184320,10268,1478592,1662912
train,4306,112,86016,2236,321984,408000
train,4307,716,549888,56356,8115264,8665152
train,4308,303,232704,16367,2356848,2589552
train,4309,198,152064,6989,1006416,1158480
train,4310,105,80640,1966,283104,363744
train,4311,62,47616,686,98784,146400
train,4312,72,55296,924,133056,188352
train,4313,40,30720,286,41184,71904
train,4314,26,19968,121,17424,37392
train,4315,49,37632,428,61632,99264
train,4316,58,44544,600,86400,130944
train,4317,184,141312,6036,869184,1010496
train,4318,223,171264,8865,1276560,1447824
train,4319,208,159744,7713,1110672,1270416
train,4320,14,10752,35,5040,15792
train,4321,24,18432,103,14832,33264
train,4322,68,52224,825,118800,171024
train,4323,107,82176,2041,293904,376080
train,4324,117,89856,2441,351504,441360
train,4325,72,55296,924,133056,188352
train,4326,56,43008,559,80496,123504
train,4327,84,64512,1258,181152,245664
train,4328,158,121344,4451,640944,762288
train,4329,86,66048,1319,189936,255984
train,4330,79,60672,1113,160272,220944
train,4331,67,51456,801,115344,166800
train,4332,88,67584,1381,198864,266448
train,4333,119,91392,2525,363600,454992
train,4334,14,10752,35,5040,15792
train,4335,551,423168,47150,6789600,7212768
train,4336,94,72192,1575,226800,298992
train,4337,129,99072,2967,427248,526320
train,4338,93,71424,1542,222048,293472
train,4339,215,165120,8241,1186704,1351824
train,4340,38,29184,258,37152,66336
train,4341,97,74496,1678,241632,316128
train,4342,222,170496,8786,1265184,1435680
train,4343,55,42240,540,77760,120000
train,4344,126,96768,2830,407520,504288
train,4345,79,60672,1113,160272,220944
train,4346,18,13824,58,8352,22176
train,4347,81,62208,1170,168480,230688
train,4348,273,209664,13286,1913184,2122848
train,4349,52,39936,482,69408,109344
train,4350,376,288768,25203,3629232,3918000
train,4351,22,16896,87,12528,29424
train,4352,59,45312,621,89424,134736
train,4353,15,11520,40,5760,17280
train,4354,276,211968,13580,1955520,2167488
train,4355,17,13056,52,7488,20544
train,4356,14,10752,35,5040,15792
train,4357,819,628992,67023,9651312,10280304
train,4358,98,75264,1712,246528,321792
train,4359,99,76032,1747,251568,327600
train,4360,85,65280,1288,185472,250752
train,4361,61,46848,664,95616,142464
train,4362,124,95232,2741,394704,489936
train,4363,32,24576,183,26352,50928
train,4364,11,8448,22,3168,11616
train,4365,70,53760,874,125856,179616
train,4366,71,54528,899,129456,183984
train,4367,15,11520,40,5760,17280
train,4368,221,169728,8707,1253808,1423536
train,4369,108,82944,2080,299520,382464
train,4370,680,522240,53519,7706736,8228976
train,4371,147,112896,3852,554688,667584
train,4372,144,110592,3697,532368,642960
train,4373,309,237312,17021,2451024,2688336
train,4374,266,204288,12614,1816416,2020704
train,4375,17,13056,52,7488,20544
train,4376,77,59136,1057,152208,211344
train,4377,63,48384,708,101952,150336
train,4378,60,46080,642,92448,138528
train,4379,93,71424,1542,222048,293472
train,4380,59,45312,621,89424,134736
train,4381,49,37632,428,61632,99264
train,4382,232,178176,9595,1381680,1559856
train,4383,150,115200,4011,577584,692784
train,4384,91,69888,1477,212688,282576
train,4385,166,127488,4913,707472,834960
train,4386,93,71424,1542,222048,293472
train,4387,79,60672,1113,160272,220944
validation,0,46,35328,378,54432,89760
validation,1,73,56064,950,136800,192864
validation,2,71,54528,899,129456,183984
validation,3,75,57600,1003,144432,202032
validation,4,52,39936,482,69408,109344
validation,5,57,43776,580,83520,127296
validation,6,26,19968,121,17424,37392
validation,7,95,72960,1609,231696,304656
validation,8,44,33792,345,49680,83472
validation,9,27,20736,130,18720,39456
validation,10,67,51456,801,115344,166800
validation,11,33,25344,194,27936,53280
validation,12,14,10752,35,5040,15792
validation,13,26,19968,121,17424,37392
validation,14,87,66816,1350,194400,261216
validation,15,146,112128,3800,547200,659328
validation,16,85,65280,1288,185472,250752
validation,17,30,23040,161,23184,46224
validation,18,19,14592,65,9360,23952
validation,19,89,68352,1412,203328,271680
validation,20,101,77568,1819,261936,339504
validation,21,426,327168,32351,4658544,4985712
validation,22,108,82944,2080,299520,382464
validation,23,16,12288,46,6624,18912
validation,24,414,317952,30554,4399776,4717728
validation,25,46,35328,378,54432,89760
validation,26,46,35328,378,54432,89760
validation,27,84,64512,1258,181152,245664
validation,28,114,87552,2317,333648,421200
validation,29,199,152832,7060,1016640,1169472
validation,30,43,33024,330,47520,80544
validation,31,228,175104,9267,1334448,1509552
validation,32,25,19200,112,16128,35328
validation,33,15,11520,40,5760,17280
validation,34,50,38400,446,64224,102624
validation,35,72,55296,924,133056,188352
validation,36,52,39936,482,69408,109344
validation,37,14,10752,35,5040,15792
validation,38,754,579072,59851,8618544,9197616
validation,39,426,327168,32351,4658544,4985712
validation,40,88,67584,1381,198864,266448
validation,41,485,372480,41933,6038352,6410832
validation,42,274,210432,13384,1927296,2137728
validation,43,81,62208,1170,168480,230688
validation,44,211,162048,7937,1142928,1304976
validation,45,358,274944,22847,3289968,3564912
validation,46,55,42240,540,77760,120000
validation,47,40,30720,286,41184,71904
validation,48,89,68352,1412,203328,271680
validation,49,70,53760,874,125856,179616
validation,50,91,69888,1477,212688,282576
validation,51,90,69120,1444,207936,277056
validation,52,37,28416,244,35136,63552
validation,53,741,569088,58597,8437968,9007056
validation,54,39,29952,271,39024,68976
validation,55,78,59904,1085,156240,216144
validation,56,47,36096,394,56736,92832
validation,57,21,16128,79,11376,27504
validation,58,275,211200,13482,1941408,2152608
validation,59,681,523008,53592,7717248,8240256
validation,60,77,59136,1057,152208,211344
validation,61,178,136704,5648,813312,950016
validation,62,64,49152,730,105120,154272
validation,63,12,9216,26,3744,12960
validation,64,49,37632,428,61632,99264
validation,65,74,56832,977,140688,197520
validation,66,55,42240,540,77760,120000
validation,67,55,42240,540,77760,120000
validation,68,71,54528,899,129456,183984
validation,69,90,69120,1444,207936,277056
validation,70,66,50688,777,111888,162576
validation,71,265,203520,12519,1802736,2006256
validation,72,703,539904,55278,7960032,8499936
validation,73,365,280320,23750,3420000,3700320
validation,74,218,167424,8472,1219968,1387392
validation,75,177,135936,5585,804240,940176
validation,76,25,19200,112,16128,35328
validation,77,123,94464,2697,388368,482832
validation,78,272,208896,13189,1899216,2108112
validation,79,134,102912,3201,460944,563856
validation,80,394,302592,27673,3984912,4287504
validation,81,9,6912,15,2160,9072
validation,82,62,47616,686,98784,146400
validation,83,207,158976,7639,1100016,1258992
validation,84,64,49152,730,105120,154272
validation,85,25,19200,112,16128,35328
validation,86,302,231936,16259,2341296,2573232
validation,87,185,142080,6101,878544,1020624
validation,88,145,111360,3748,539712,651072
validation,89,88,67584,1381,198864,266448
validation,90,59,45312,621,89424,134736
validation,91,390,299520,27114,3904416,4203936
validation,92,74,56832,977,140688,197520
validation,93,122,93696,2654,382176,475872
validation,94,706,542208,55521,7995024,8537232
validation,95,89,68352,1412,203328,271680
validation,96,34,26112,206,29664,55776
validation,97,85,65280,1288,185472,250752
validation,98,213,163584,8088,1164672,1328256
validation,99,33,25344,194,27936,53280
validation,100,51,39168,464,66816,105984
validation,101,38,29184,258,37152,66336
validation,102,312,239616,17353,2498832,2738448
validation,103,70,53760,874,125856,179616
validation,104,663,509184,52340,7536960,8046144
validation,105,306,235008,16692,2403648,2638656
validation,106,18,13824,58,8352,22176
validation,107,119,91392,2525,363600,454992
validation,108,170,130560,5152,741888,872448
validation,109,10,7680,18,2592,10272
validation,110,98,75264,1712,246528,321792
validation,111,235,180480,9845,1417680,1598160
validation,112,41,31488,300,43200,74688
validation,113,32,24576,183,26352,50928
validation,114,46,35328,378,54432,89760
validation,115,14,10752,35,5040,15792
validation,116,14,10752,35,5040,15792
validation,117,710,545280,55852,8042688,8587968
validation,118,489,375552,42627,6138288,6513840
validation,119,76,58368,1030,148320,206688
validation,120,130,99840,3013,433872,533712
validation,121,123,94464,2697,388368,482832
validation,122,249,191232,11053,1591632,1782864
validation,123,34,26112,206,29664,55776
validation,124,118,90624,2482,357408,448032
validation,125,688,528384,54109,7791696,8320080
validation,126,62,47616,686,98784,146400
validation,127,110,84480,2157,310608,395088
validation,128,358,274944,22847,3289968,3564912
validation,129,787,604416,63304,9115776,9720192
validation,130,90,69120,1444,207936,277056
validation,131,193,148224,6641,956304,1104528
validation,132,98,75264,1712,246528,321792
validation,133,412,316416,30260,4357440,4673856
validation,134,72,55296,924,133056,188352
validation,135,176,135168,5522,795168,930336
validation,136,91,69888,1477,212688,282576
validation,137,46,35328,378,54432,89760
validation,138,184,141312,6036,869184,1010496
validation,139,105,80640,1966,283104,363744
validation,140,178,136704,5648,813312,950016
validation,141,73,56064,950,136800,192864
validation,142,180,138240,5776,831744,969984
validation,143,85,65280,1288,185472,250752
validation,144,395,303360,27814,4005216,4308576
validation,145,83,63744,1228,176832,240576
validation,146,13,9984,30,4320,14304
validation,147,98,75264,1712,246528,321792
validation,148,25,19200,112,16128,35328
validation,149,59,45312,621,89424,134736
validation,150,29,22272,150,21600,43872
validation,151,668,513024,52676,7585344,8098368
validation,152,255,195840,11592,1669248,1865088
validation,153,294,225792,15409,2218896,2444688
validation,154,684,525312,53811,7748784,8274096
validation,155,64,49152,730,105120,154272
validation,156,802,615936,65002,9360288,9976224
validation,157,102,78336,1855,267120,345456
validation,158,172,132096,5274,759456,891552
validation,159,13,9984,30,4320,14304
validation,160,151,115968,4065,585360,701328
validation,161,141,108288,3544,510336,618624
validation,162,102,78336,1855,267120,345456
validation,163,47,36096,394,56736,92832
validation,164,80,61440,1141,164304,225744
validation,165,112,86016,2236,321984,408000
validation,166,30,23040,161,23184,46224
validation,167,11,8448,22,3168,11616
validation,168,83,63744,1228,176832,240576
validation,169,444,340992,35143,5060592,5401584
validation,170,74,56832,977,140688,197520
validation,171,157,120576,4394,632736,753312
validation,172,39,29952,271,39024,68976
validation,173,97,74496,1678,241632,316128
validation,174,65,49920,753,108432,158352
validation,175,107,82176,2041,293904,376080
validation,176,95,72960,1609,231696,304656
validation,177,77,59136,1057,152208,211344
validation,178,142,109056,3595,517680,626736
validation,179,26,19968,121,17424,37392
validation,180,241,185088,10354,1490976,1676064
validation,181,95,72960,1609,231696,304656
validation,182,217,166656,8395,1208880,1375536
validation,183,196,150528,6849,986256,1136784
validation,184,22,16896,87,12528,29424
validation,185,93,71424,1542,222048,293472
validation,186,289,221952,14889,2144016,2365968
validation,187,51,39168,464,66816,105984
validation,188,13,9984,30,4320,14304
validation,189,74,56832,977,140688,197520
validation,190,37,28416,244,35136,63552
validation,191,80,61440,1141,164304,225744
validation,192,121,92928,2610,375840,468768
validation,193,49,37632,428,61632,99264
validation,194,72,55296,924,133056,188352
validation,195,28,21504,140,20160,41664
validation,196,25,19200,112,16128,35328
validation,197,72,55296,924,133056,188352
validation,198,96,73728,1643,236592,310320
validation,199,28,21504,140,20160,41664
validation,200,23,17664,95,13680,31344
validation,201,16,12288,46,6624,18912
validation,202,53,40704,501,72144,112848
validation,203,14,10752,35,5040,15792
validation,204,358,274944,22847,3289968,3564912
validation,205,48,36864,411,59184,96048
validation,206,124,95232,2741,394704,489936
validation,207,11,8448,22,3168,11616
validation,208,65,49920,753,108432,158352
validation,209,139,106752,3445,496080,602832
validation,210,53,40704,501,72144,112848
validation,211,26,19968,121,17424,37392
validation,212,60,46080,642,92448,138528
validation,213,93,71424,1542,222048,293472
validation,214,115,88320,2358,339552,427872
validation,215,266,204288,12614,1816416,2020704
validation,216,26,19968,121,17424,37392
validation,217,61,46848,664,95616,142464
validation,218,78,59904,1085,156240,216144
validation,219,15,11520,40,5760,17280
validation,220,89,68352,1412,203328,271680
validation,221,90,69120,1444,207936,277056
validation,222,102,78336,1855,267120,345456
validation,223,68,52224,825,118800,171024
validation,224,58,44544,600,86400,130944
validation,225,58,44544,600,86400,130944
validation,226,77,59136,1057,152208,211344
validation,227,13,9984,30,4320,14304
validation,228,75,57600,1003,144432,202032
validation,229,77,59136,1057,152208,211344
validation,230,58,44544,600,86400,130944
validation,231,105,80640,1966,283104,363744
validation,232,112,86016,2236,321984,408000
validation,233,84,64512,1258,181152,245664
validation,234,55,42240,540,77760,120000
validation,235,14,10752,35,5040,15792
validation,236,217,166656,8395,1208880,1375536
validation,237,97,74496,1678,241632,316128
validation,238,45,34560,361,51984,86544
validation,239,68,52224,825,118800,171024
validation,240,126,96768,2830,407520,504288
validation,241,61,46848,664,95616,142464
validation,242,100,76800,1783,256752,333552
validation,243,12,9216,26,3744,12960
validation,244,143,109824,3646,525024,634848
validation,245,12,9216,26,3744,12960
validation,246,185,142080,6101,878544,1020624
validation,247,25,19200,112,16128,35328
validation,248,330,253440,19413,2795472,3048912
validation,249,151,115968,4065,585360,701328
validation,250,100,76800,1783,256752,333552
validation,251,27,20736,130,18720,39456
validation,252,126,96768,2830,407520,504288
validation,253,54,41472,520,74880,116352
validation,254,64,49152,730,105120,154272
validation,255,16,12288,46,6624,18912
validation,256,267,205056,12709,1830096,2035152
validation,257,36,27648,231,33264,60912
validation,258,332,254976,19649,2829456,3084432
validation,259,223,171264,8865,1276560,1447824
validation,260,54,41472,520,74880,116352
validation,261,66,50688,777,111888,162576
validation,262,82,62976,1199,172656,235632
validation,263,80,61440,1141,164304,225744
validation,264,88,67584,1381,198864,266448
validation,265,24,18432,103,14832,33264
validation,266,46,35328,378,54432,89760
validation,267,39,29952,271,39024,68976
validation,268,86,66048,1319,189936,255984
validation,269,438,336384,34199,4924656,5261040
validation,270,54,41472,520,74880,116352
validation,271,108,82944,2080,299520,382464
validation,272,117,89856,2441,351504,441360
validation,273,79,60672,1113,160272,220944
validation,274,123,94464,2697,388368,482832
validation,275,233,178944,9678,1393632,1572576
validation,276,100,76800,1783,256752,333552
validation,277,365,280320,23750,3420000,3700320
validation,278,118,90624,2482,357408,448032
validation,279,112,86016,2236,321984,408000
validation,280,11,8448,22,3168,11616
validation,281,135,103680,3249,467856,571536
validation,282,100,76800,1783,256752,333552
validation,283,64,49152,730,105120,154272
validation,284,202,155136,7274,1047456,1202592
validation,285,115,88320,2358,339552,427872
validation,286,149,114432,3958,569952,684384
validation,287,124,95232,2741,394704,489936
validation,288,27,20736,130,18720,39456
validation,289,11,8448,22,3168,11616
validation,290,17,13056,52,7488,20544
validation,291,103,79104,1892,272448,351552
validation,292,47,36096,394,56736,92832
validation,293,73,56064,950,136800,192864
validation,294,71,54528,899,129456,183984
validation,295,42,32256,315,45360,77616
validation,296,51,39168,464,66816,105984
validation,297,222,170496,8786,1265184,1435680
validation,298,37,28416,244,35136,63552
validation,299,116,89088,2399,345456,434544
validation,300,61,46848,664,95616,142464
validation,301,474,364032,40052,5767488,6131520
validation,302,172,132096,5274,759456,891552
validation,303,75,57600,1003,144432,202032
validation,304,59,45312,621,89424,134736
validation,305,41,31488,300,43200,74688
validation,306,93,71424,1542,222048,293472
validation,307,25,19200,112,16128,35328
validation,308,11,8448,22,3168,11616
validation,309,103,79104,1892,272448,351552
validation,310,294,225792,15409,2218896,2444688
validation,311,118,90624,2482,357408,448032
validation,312,44,33792,345,49680,83472
validation,313,219,168192,8550,1231200,1399392
validation,314,83,63744,1228,176832,240576
validation,315,15,11520,40,5760,17280
validation,316,77,59136,1057,152208,211344
validation,317,82,62976,1199,172656,235632
validation,318,329,252672,19296,2778624,3031296
validation,319,11,8448,22,3168,11616
validation,320,29,22272,150,21600,43872
validation,321,23,17664,95,13680,31344
validation,322,353,271104,22214,3198816,3469920
validation,323,63,48384,708,101952,150336
validation,324,15,11520,40,5760,17280
validation,325,79,60672,1113,160272,220944
validation,326,28,21504,140,20160,41664
validation,327,115,88320,2358,339552,427872
validation,328,116,89088,2399,345456,434544
validation,329,514,394752,46417,6684048,7078800
validation,330,73,56064,950,136800,192864
validation,331,107,82176,2041,293904,376080
validation,332,64,49152,730,105120,154272
validation,333,29,22272,150,21600,43872
validation,334,292,224256,15200,2188800,2413056
validation,335,38,29184,258,37152,66336
validation,336,461,354048,37885,5455440,5809488
validation,337,58,44544,600,86400,130944
validation,338,20,15360,72,10368,25728
validation,339,55,42240,540,77760,120000
validation,340,15,11520,40,5760,17280
validation,341,153,117504,4173,600912,718416
validation,342,111,85248,2197,316368,401616
validation,343,84,64512,1258,181152,245664
validation,344,68,52224,825,118800,171024
validation,345,81,62208,1170,168480,230688
validation,346,256,196608,11683,1682352,1878960
validation,347,42,32256,315,45360,77616
validation,348,142,109056,3595,517680,626736
validation,349,50,38400,446,64224,102624
validation,350,50,38400,446,64224,102624
validation,351,55,42240,540,77760,120000
validation,352,112,86016,2236,321984,408000
validation,353,123,94464,2697,388368,482832
validation,354,534,410112,46752,6732288,7142400
validation,355,169,129792,5092,733248,863040
validation,356,60,46080,642,92448,138528
validation,357,27,20736,130,18720,39456
validation,358,26,19968,121,17424,37392
validation,359,94,72192,1575,226800,298992
validation,360,184,141312,6036,869184,1010496
validation,361,100,76800,1783,256752,333552
validation,362,38,29184,258,37152,66336
validation,363,118,90624,2482,357408,448032
validation,364,43,33024,330,47520,80544
validation,365,191,146688,6504,936576,1083264
validation,366,284,218112,14378,2070432,2288544
validation,367,334,256512,19887,2863728,3120240
validation,368,153,117504,4173,600912,718416
validation,369,27,20736,130,18720,39456
validation,370,314,241152,17577,2531088,2772240
validation,371,88,67584,1381,198864,266448
validation,372,170,130560,5152,741888,872448
validation,373,26,19968,121,17424,37392
validation,374,51,39168,464,66816,105984
validation,375,31,23808,172,24768,48576
validation,376,433,332544,33423,4812912,5145456
validation,377,25,19200,112,16128,35328
validation,378,11,8448,22,3168,11616
validation,379,217,166656,8395,1208880,1375536
validation,380,52,39936,482,69408,109344
validation,381,100,76800,1783,256752,333552
validation,382,189,145152,6368,916992,1062144
validation,383,83,63744,1228,176832,240576
validation,384,166,127488,4913,707472,834960
validation,385,489,375552,42627,6138288,6513840
validation,386,82,62976,1199,172656,235632
validation,387,27,20736,130,18720,39456
validation,388,120,92160,2567,369648,461808
validation,389,66,50688,777,111888,162576
validation,390,121,92928,2610,375840,468768
validation,391,32,24576,183,26352,50928
validation,392,64,49152,730,105120,154272
validation,393,70,53760,874,125856,179616
validation,394,125,96000,2786,401184,497184
validation,395,29,22272,150,21600,43872
validation,396,113,86784,2277,327888,414672
validation,397,245,188160,10701,1540944,1729104
validation,398,119,91392,2525,363600,454992
validation,399,59,45312,621,89424,134736
validation,400,51,39168,464,66816,105984
validation,401,89,68352,1412,203328,271680
validation,402,87,66816,1350,194400,261216
validation,403,74,56832,977,140688,197520
validation,404,321,246528,18369,2645136,2891664
validation,405,102,78336,1855,267120,345456
validation,406,44,33792,345,49680,83472
validation,407,193,148224,6641,956304,1104528
validation,408,203,155904,7346,1057824,1213728
validation,409,24,18432,103,14832,33264
validation,410,58,44544,600,86400,130944
validation,411,24,18432,103,14832,33264
validation,412,66,50688,777,111888,162576
validation,413,112,86016,2236,321984,408000
validation,414,210,161280,7862,1132128,1293408
validation,415,7,5376,9,1296,6672
validation,416,46,35328,378,54432,89760
validation,417,129,99072,2967,427248,526320
validation,418,26,19968,121,17424,37392
validation,419,40,30720,286,41184,71904
validation,420,141,108288,3544,510336,618624
validation,421,108,82944,2080,299520,382464
validation,422,223,171264,8865,1276560,1447824
validation,423,63,48384,708,101952,150336
validation,424,193,148224,6641,956304,1104528
validation,425,90,69120,1444,207936,277056
validation,426,69,52992,849,122256,175248
validation,427,210,161280,7862,1132128,1293408
validation,428,71,54528,899,129456,183984
validation,429,144,110592,3697,532368,642960
validation,430,114,87552,2317,333648,421200
validation,431,130,99840,3013,433872,533712
validation,432,501,384768,44745,6443280,6828048
validation,433,45,34560,361,51984,86544
validation,434,85,65280,1288,185472,250752
validation,435,70,53760,874,125856,179616
validation,436,70,53760,874,125856,179616
validation,437,48,36864,411,59184,96048
validation,438,54,41472,520,74880,116352
validation,439,13,9984,30,4320,14304
validation,440,146,112128,3800,547200,659328
validation,441,64,49152,730,105120,154272
validation,442,79,60672,1113,160272,220944
validation,443,70,53760,874,125856,179616
validation,444,265,203520,12519,1802736,2006256
validation,445,34,26112,206,29664,55776
validation,446,28,21504,140,20160,41664
validation,447,85,65280,1288,185472,250752
validation,448,50,38400,446,64224,102624
validation,449,190,145920,6436,926784,1072704
validation,450,61,46848,664,95616,142464
validation,451,17,13056,52,7488,20544
validation,452,61,46848,664,95616,142464
validation,453,212,162816,8012,1153728,1316544
validation,454,176,135168,5522,795168,930336
validation,455,14,10752,35,5040,15792
validation,456,122,93696,2654,382176,475872
validation,457,71,54528,899,129456,183984
validation,458,28,21504,140,20160,41664
validation,459,36,27648,231,33264,60912
validation,460,38,29184,258,37152,66336
validation,461,47,36096,394,56736,92832
validation,462,72,55296,924,133056,188352
validation,463,239,183552,10183,1466352,1649904
validation,464,73,56064,950,136800,192864
validation,465,61,46848,664,95616,142464
validation,466,209,160512,7787,1121328,1281840
validation,467,26,19968,121,17424,37392
validation,468,24,18432,103,14832,33264
validation,469,65,49920,753,108432,158352
validation,470,50,38400,446,64224,102624
validation,471,74,56832,977,140688,197520
validation,472,112,86016,2236,321984,408000
validation,473,27,20736,130,18720,39456
validation,474,16,12288,46,6624,18912
validation,475,12,9216,26,3744,12960
validation,476,10,7680,18,2592,10272
validation,477,99,76032,1747,251568,327600
validation,478,400,307200,28523,4107312,4414512
validation,479,66,50688,777,111888,162576
validation,480,11,8448,22,3168,11616
validation,481,100,76800,1783,256752,333552
validation,482,114,87552,2317,333648,421200
validation,483,77,59136,1057,152208,211344
validation,484,124,95232,2741,394704,489936
validation,485,285,218880,14480,2085120,2304000
validation,486,95,72960,1609,231696,304656
validation,487,37,28416,244,35136,63552
validation,488,103,79104,1892,272448,351552
validation,489,103,79104,1892,272448,351552
validation,490,13,9984,30,4320,14304
validation,491,16,12288,46,6624,18912
validation,492,14,10752,35,5040,15792
validation,493,84,64512,1258,181152,245664
validation,494,32,24576,183,26352,50928
validation,495,66,50688,777,111888,162576
validation,496,59,45312,621,89424,134736
validation,497,241,185088,10354,1490976,1676064
validation,498,93,71424,1542,222048,293472
validation,499,121,92928,2610,375840,468768
validation,500,95,72960,1609,231696,304656
validation,501,51,39168,464,66816,105984
validation,502,209,160512,7787,1121328,1281840
validation,503,20,15360,72,10368,25728
validation,504,47,36096,394,56736,92832
validation,505,87,66816,1350,194400,261216
validation,506,96,73728,1643,236592,310320
validation,507,99,76032,1747,251568,327600
validation,508,515,395520,46430,6685920,7081440
validation,509,307,235776,16802,2419488,2655264
validation,510,41,31488,300,43200,74688
validation,511,334,256512,19887,2863728,3120240
validation,512,115,88320,2358,339552,427872
validation,513,40,30720,286,41184,71904
validation,514,92,70656,1509,217296,287952
validation,515,385,295680,26424,3805056,4100736
validation,516,72,55296,924,133056,188352
validation,517,489,375552,42627,6138288,6513840
validation,518,128,98304,2921,420624,518928
validation,519,79,60672,1113,160272,220944
validation,520,123,94464,2697,388368,482832
validation,521,26,19968,121,17424,37392
validation,522,45,34560,361,51984,86544
validation,523,19,14592,65,9360,23952
validation,524,94,72192,1575,226800,298992
validation,525,196,150528,6849,986256,1136784
validation,526,162,124416,4679,673776,798192
validation,527,83,63744,1228,176832,240576
validation,528,409,314112,29821,4294224,4608336
validation,529,12,9216,26,3744,12960
validation,530,152,116736,4119,593136,709872
validation,531,87,66816,1350,194400,261216
validation,532,52,39936,482,69408,109344
validation,533,119,91392,2525,363600,454992
validation,534,111,85248,2197,316368,401616
validation,535,209,160512,7787,1121328,1281840
validation,536,56,43008,559,80496,123504
validation,537,22,16896,87,12528,29424
validation,538,94,72192,1575,226800,298992
validation,539,120,92160,2567,369648,461808
validation,540,68,52224,825,118800,171024
validation,541,297,228096,15725,2264400,2492496
validation,542,62,47616,686,98784,146400
validation,543,9,6912,15,2160,9072
validation,544,24,18432,103,14832,33264
validation,545,28,21504,140,20160,41664
validation,546,104,79872,1928,277632,357504
validation,547,126,96768,2830,407520,504288
validation,548,98,75264,1712,246528,321792
validation,549,80,61440,1141,164304,225744
validation,550,57,43776,580,83520,127296
validation,551,563,432384,47491,6838704,7271088
validation,552,88,67584,1381,198864,266448
validation,553,63,48384,708,101952,150336
validation,554,16,12288,46,6624,18912
validation,555,165,126720,4854,698976,825696
validation,556,70,53760,874,125856,179616
validation,557,93,71424,1542,222048,293472
validation,558,40,30720,286,41184,71904
validation,559,92,70656,1509,217296,287952
validation,560,32,24576,183,26352,50928
validation,561,96,73728,1643,236592,310320
validation,562,107,82176,2041,293904,376080
validation,563,84,64512,1258,181152,245664
validation,564,130,99840,3013,433872,533712
validation,565,69,52992,849,122256,175248
validation,566,97,74496,1678,241632,316128
validation,567,59,45312,621,89424,134736
validation,568,26,19968,121,17424,37392
validation,569,24,18432,103,14832,33264
validation,570,55,42240,540,77760,120000
validation,571,221,169728,8707,1253808,1423536
validation,572,29,22272,150,21600,43872
validation,573,264,202752,12425,1789200,1991952
validation,574,24,18432,103,14832,33264
validation,575,145,111360,3748,539712,651072
validation,576,40,30720,286,41184,71904
validation,577,135,103680,3249,467856,571536
validation,578,70,53760,874,125856,179616
validation,579,61,46848,664,95616,142464
validation,580,79,60672,1113,160272,220944
validation,581,25,19200,112,16128,35328
validation,582,204,156672,7419,1068336,1225008
validation,583,70,53760,874,125856,179616
validation,584,13,9984,30,4320,14304
validation,585,102,78336,1855,267120,345456
validation,586,328,251904,19179,2761776,3013680
validation,587,512,393216,46391,6680304,7073520
validation,588,86,66048,1319,189936,255984
validation,589,21,16128,79,11376,27504
validation,590,234,179712,9761,1405584,1585296
validation,591,90,69120,1444,207936,277056
validation,592,333,255744,19768,2846592,3102336
validation,593,363,278784,23490,3382560,3661344
validation,594,46,35328,378,54432,89760
validation,595,96,73728,1643,236592,310320
validation,596,85,65280,1288,185472,250752
validation,597,37,28416,244,35136,63552
validation,598,41,31488,300,43200,74688
validation,599,25,19200,112,16128,35328
validation,600,545,418560,46998,6767712,7186272
validation,601,112,86016,2236,321984,408000
validation,602,32,24576,183,26352,50928
validation,603,129,99072,2967,427248,526320
validation,604,19,14592,65,9360,23952
validation,605,69,52992,849,122256,175248
validation,606,49,37632,428,61632,99264
validation,607,11,8448,22,3168,11616
validation,608,76,58368,1030,148320,206688
validation,609,79,60672,1113,160272,220944
validation,610,62,47616,686,98784,146400
validation,611,63,48384,708,101952,150336
validation,612,33,25344,194,27936,53280
validation,613,25,19200,112,16128,35328
validation,614,14,10752,35,5040,15792
validation,615,357,274176,22720,3271680,3545856
validation,616,84,64512,1258,181152,245664
validation,617,8,6144,12,1728,7872
validation,618,142,109056,3595,517680,626736
validation,619,46,35328,378,54432,89760
validation,620,158,121344,4451,640944,762288
validation,621,212,162816,8012,1153728,1316544
validation,622,70,53760,874,125856,179616
validation,623,91,69888,1477,212688,282576
validation,624,91,69888,1477,212688,282576
validation,625,48,36864,411,59184,96048
validation,626,27,20736,130,18720,39456
validation,627,97,74496,1678,241632,316128
validation,628,336,258048,20126,2898144,3156192
validation,629,153,117504,4173,600912,718416
validation,630,71,54528,899,129456,183984
validation,631,31,23808,172,24768,48576
validation,632,306,235008,16692,2403648,2638656
validation,633,54,41472,520,74880,116352
validation,634,66,50688,777,111888,162576
validation,635,27,20736,130,18720,39456
validation,636,46,35328,378,54432,89760
validation,637,300,230400,16044,2310336,2540736
validation,638,237,182016,10013,1441872,1623888
validation,639,107,82176,2041,293904,376080
validation,640,60,46080,642,92448,138528
validation,641,42,32256,315,45360,77616
validation,642,27,20736,130,18720,39456
validation,643,110,84480,2157,310608,395088
validation,644,99,76032,1747,251568,327600
validation,645,33,25344,194,27936,53280
validation,646,139,106752,3445,496080,602832
validation,647,27,20736,130,18720,39456
validation,648,44,33792,345,49680,83472
validation,649,23,17664,95,13680,31344
validation,650,99,76032,1747,251568,327600
validation,651,25,19200,112,16128,35328
validation,652,94,72192,1575,226800,298992
validation,653,32,24576,183,26352,50928
validation,654,125,96000,2786,401184,497184
validation,655,116,89088,2399,345456,434544
validation,656,79,60672,1113,160272,220944
validation,657,439,337152,34356,4947264,5284416
validation,658,69,52992,849,122256,175248
validation,659,15,11520,40,5760,17280
validation,660,73,56064,950,136800,192864
validation,661,42,32256,315,45360,77616
validation,662,41,31488,300,43200,74688
validation,663,130,99840,3013,433872,533712
validation,664,98,75264,1712,246528,321792
validation,665,111,85248,2197,316368,401616
validation,666,26,19968,121,17424,37392
validation,667,298,228864,15831,2279664,2508528
validation,668,79,60672,1113,160272,220944
validation,669,37,28416,244,35136,63552
validation,670,293,225024,15304,2203776,2428800
validation,671,125,96000,2786,401184,497184
validation,672,174,133632,5397,777168,910800
validation,673,96,73728,1643,236592,310320
validation,674,75,57600,1003,144432,202032
validation,675,85,65280,1288,185472,250752
validation,676,76,58368,1030,148320,206688
validation,677,118,90624,2482,357408,448032
validation,678,912,700416,79905,11506320,12206736
validation,679,22,16896,87,12528,29424
validation,680,70,53760,874,125856,179616
validation,681,214,164352,8164,1175616,1339968
validation,682,380,291840,25742,3706848,3998688
validation,683,75,57600,1003,144432,202032
validation,684,251,192768,11231,1617264,1810032
validation,685,158,121344,4451,640944,762288
validation,686,83,63744,1228,176832,240576
validation,687,121,92928,2610,375840,468768
validation,688,111,85248,2197,316368,401616
validation,689,110,84480,2157,310608,395088
validation,690,60,46080,642,92448,138528
validation,691,89,68352,1412,203328,271680
validation,692,148,113664,3905,562320,675984
validation,693,24,18432,103,14832,33264
validation,694,106,81408,2003,288432,369840
validation,695,84,64512,1258,181152,245664
validation,696,113,86784,2277,327888,414672
validation,697,117,89856,2441,351504,441360
validation,698,157,120576,4394,632736,753312
validation,699,60,46080,642,92448,138528
validation,700,30,23040,161,23184,46224
validation,701,69,52992,849,122256,175248
validation,702,76,58368,1030,148320,206688
validation,703,40,30720,286,41184,71904
validation,704,24,18432,103,14832,33264
validation,705,46,35328,378,54432,89760
validation,706,71,54528,899,129456,183984
validation,707,252,193536,11321,1630224,1823760
validation,708,108,82944,2080,299520,382464
validation,709,28,21504,140,20160,41664
validation,710,46,35328,378,54432,89760
validation,711,299,229632,15937,2294928,2524560
validation,712,56,43008,559,80496,123504
validation,713,14,10752,35,5040,15792
validation,714,45,34560,361,51984,86544
validation,715,20,15360,72,10368,25728
validation,716,14,10752,35,5040,15792
validation,717,22,16896,87,12528,29424
validation,718,134,102912,3201,460944,563856
validation,719,64,49152,730,105120,154272
validation,720,64,49152,730,105120,154272
validation,721,66,50688,777,111888,162576
validation,722,9,6912,15,2160,9072
validation,723,91,69888,1477,212688,282576
validation,724,212,162816,8012,1153728,1316544
validation,725,46,35328,378,54432,89760
validation,726,112,86016,2236,321984,408000
validation,727,126,96768,2830,407520,504288
validation,728,111,85248,2197,316368,401616
validation,729,101,77568,1819,261936,339504
validation,730,183,140544,5970,859680,1000224
validation,731,514,394752,46417,6684048,7078800
validation,732,118,90624,2482,357408,448032
validation,733,100,76800,1783,256752,333552
validation,734,75,57600,1003,144432,202032
validation,735,16,12288,46,6624,18912
validation,736,271,208128,13092,1885248,2093376
validation,737,13,9984,30,4320,14304
validation,738,70,53760,874,125856,179616
validation,739,248,190464,10964,1578816,1769280
validation,740,186,142848,6168,888192,1031040
validation,741,358,274944,22847,3289968,3564912
validation,742,260,199680,12051,1735344,1935024
validation,743,79,60672,1113,160272,220944
validation,744,93,71424,1542,222048,293472
validation,745,199,152832,7060,1016640,1169472
validation,746,106,81408,2003,288432,369840
validation,747,80,61440,1141,164304,225744
validation,748,143,109824,3646,525024,634848
validation,749,65,49920,753,108432,158352
validation,750,127,97536,2876,414144,511680
validation,751,170,130560,5152,741888,872448
validation,752,38,29184,258,37152,66336
validation,753,134,102912,3201,460944,563856
validation,754,42,32256,315,45360,77616
validation,755,793,609024,63974,9212256,9821280
validation,756,38,29184,258,37152,66336
validation,757,84,64512,1258,181152,245664
validation,758,17,13056,52,7488,20544
validation,759,132,101376,3106,447264,548640
validation,760,13,9984,30,4320,14304
validation,761,82,62976,1199,172656,235632
validation,762,64,49152,730,105120,154272
validation,763,110,84480,2157,310608,395088
validation,764,81,62208,1170,168480,230688
validation,765,86,66048,1319,189936,255984
validation,766,401,307968,28665,4127760,4435728
validation,767,45,34560,361,51984,86544
validation,768,121,92928,2610,375840,468768
validation,769,56,43008,559,80496,123504
validation,770,47,36096,394,56736,92832
validation,771,39,29952,271,39024,68976
validation,772,117,89856,2441,351504,441360
validation,773,14,10752,35,5040,15792
validation,774,99,76032,1747,251568,327600
validation,775,52,39936,482,69408,109344
validation,776,68,52224,825,118800,171024
validation,777,50,38400,446,64224,102624
validation,778,47,36096,394,56736,92832
validation,779,15,11520,40,5760,17280
validation,780,274,210432,13384,1927296,2137728
validation,781,64,49152,730,105120,154272
validation,782,59,45312,621,89424,134736
validation,783,62,47616,686,98784,146400
validation,784,41,31488,300,43200,74688
validation,785,49,37632,428,61632,99264
validation,786,84,64512,1258,181152,245664
validation,787,15,11520,40,5760,17280
validation,788,549,421632,47097,6781968,7203600
validation,789,231,177408,9513,1369872,1547280
validation,790,41,31488,300,43200,74688
validation,791,473,363264,39883,5743152,6106416
validation,792,84,64512,1258,181152,245664
validation,793,82,62976,1199,172656,235632
validation,794,87,66816,1350,194400,261216
validation,795,85,65280,1288,185472,250752
validation,796,63,48384,708,101952,150336
validation,797,12,9216,26,3744,12960
validation,798,13,9984,30,4320,14304
validation,799,36,27648,231,33264,60912
validation,800,24,18432,103,14832,33264
validation,801,30,23040,161,23184,46224
validation,802,111,85248,2197,316368,401616
validation,803,54,41472,520,74880,116352
validation,804,104,79872,1928,277632,357504
validation,805,73,56064,950,136800,192864
validation,806,50,38400,446,64224,102624
validation,807,184,141312,6036,869184,1010496
validation,808,66,50688,777,111888,162576
validation,809,48,36864,411,59184,96048
validation,810,54,41472,520,74880,116352
validation,811,169,129792,5092,733248,863040
validation,812,47,36096,394,56736,92832
validation,813,133,102144,3154,454176,556320
validation,814,77,59136,1057,152208,211344
validation,815,86,66048,1319,189936,255984
validation,816,179,137472,5712,822528,960000
validation,817,122,93696,2654,382176,475872
validation,818,229,175872,9349,1346256,1522128
validation,819,207,158976,7639,1100016,1258992
validation,820,119,91392,2525,363600,454992
validation,821,33,25344,194,27936,53280
validation,822,209,160512,7787,1121328,1281840
validation,823,49,37632,428,61632,99264
validation,824,76,58368,1030,148320,206688
validation,825,57,43776,580,83520,127296
validation,826,57,43776,580,83520,127296
validation,827,88,67584,1381,198864,266448
validation,828,109,83712,2118,304992,388704
validation,829,235,180480,9845,1417680,1598160
validation,830,138,105984,3395,488880,594864
validation,831,66,50688,777,111888,162576
validation,832,64,49152,730,105120,154272
validation,833,52,39936,482,69408,109344
validation,834,76,58368,1030,148320,206688
validation,835,348,267264,21589,3108816,3376080
validation,836,56,43008,559,80496,123504
validation,837,104,79872,1928,277632,357504
validation,838,634,486912,50567,7281648,7768560
validation,839,23,17664,95,13680,31344
validation,840,25,19200,112,16128,35328
validation,841,75,57600,1003,144432,202032
validation,842,116,89088,2399,345456,434544
validation,843,30,23040,161,23184,46224
validation,844,72,55296,924,133056,188352
validation,845,127,97536,2876,414144,511680
validation,846,87,66816,1350,194400,261216
validation,847,46,35328,378,54432,89760
validation,848,68,52224,825,118800,171024
validation,849,135,103680,3249,467856,571536
validation,850,110,84480,2157,310608,395088
validation,851,59,45312,621,89424,134736
validation,852,145,111360,3748,539712,651072
validation,853,154,118272,4228,608832,727104
validation,854,53,40704,501,72144,112848
validation,855,92,70656,1509,217296,287952
validation,856,65,49920,753,108432,158352
validation,857,519,398592,46487,6694128,7092720
validation,858,44,33792,345,49680,83472
validation,859,110,84480,2157,310608,395088
validation,860,59,45312,621,89424,134736
validation,861,88,67584,1381,198864,266448
validation,862,60,46080,642,92448,138528
validation,863,96,73728,1643,236592,310320
validation,864,212,162816,8012,1153728,1316544
validation,865,34,26112,206,29664,55776
validation,866,311,238848,17242,2482848,2721696
validation,867,111,85248,2197,316368,401616
validation,868,45,34560,361,51984,86544
validation,869,223,171264,8865,1276560,1447824
validation,870,71,54528,899,129456,183984
validation,871,91,69888,1477,212688,282576
validation,872,48,36864,411,59184,96048
validation,873,108,82944,2080,299520,382464
validation,874,218,167424,8472,1219968,1387392
validation,875,66,50688,777,111888,162576
validation,876,25,19200,112,16128,35328
validation,877,16,12288,46,6624,18912
validation,878,407,312576,29530,4252320,4564896
validation,879,49,37632,428,61632,99264
validation,880,14,10752,35,5040,15792
validation,881,84,64512,1258,181152,245664
validation,882,560,430080,47401,6825744,7255824
validation,883,46,35328,378,54432,89760
validation,884,25,19200,112,16128,35328
validation,885,57,43776,580,83520,127296
validation,886,26,19968,121,17424,37392
validation,887,35,26880,219,31536,58416
validation,888,105,80640,1966,283104,363744
validation,889,107,82176,2041,293904,376080
validation,890,105,80640,1966,283104,363744
validation,891,155,119040,4283,616752,735792
validation,892,70,53760,874,125856,179616
validation,893,205,157440,7492,1078848,1236288
validation,894,46,35328,378,54432,89760
validation,895,376,288768,25203,3629232,3918000
validation,896,285,218880,14480,2085120,2304000
validation,897,80,61440,1141,164304,225744
validation,898,46,35328,378,54432,89760
validation,899,71,54528,899,129456,183984
validation,900,12,9216,26,3744,12960
validation,901,107,82176,2041,293904,376080
validation,902,52,39936,482,69408,109344
validation,903,22,16896,87,12528,29424
validation,904,61,46848,664,95616,142464
validation,905,169,129792,5092,733248,863040
validation,906,24,18432,103,14832,33264
validation,907,68,52224,825,118800,171024
validation,908,29,22272,150,21600,43872
validation,909,42,32256,315,45360,77616
validation,910,174,133632,5397,777168,910800
validation,911,68,52224,825,118800,171024
validation,912,258,198144,11866,1708704,1906848
validation,913,40,30720,286,41184,71904
validation,914,40,30720,286,41184,71904
validation,915,65,49920,753,108432,158352
validation,916,55,42240,540,77760,120000
validation,917,144,110592,3697,532368,642960
validation,918,105,80640,1966,283104,363744
validation,919,42,32256,315,45360,77616
validation,920,62,47616,686,98784,146400
validation,921,45,34560,361,51984,86544
validation,922,46,35328,378,54432,89760
validation,923,26,19968,121,17424,37392
validation,924,41,31488,300,43200,74688
validation,925,52,39936,482,69408,109344
validation,926,24,18432,103,14832,33264
validation,927,54,41472,520,74880,116352
validation,928,293,225024,15304,2203776,2428800
validation,929,27,20736,130,18720,39456
validation,930,53,40704,501,72144,112848
validation,931,99,76032,1747,251568,327600
validation,932,74,56832,977,140688,197520
validation,933,60,46080,642,92448,138528
validation,934,110,84480,2157,310608,395088
validation,935,14,10752,35,5040,15792
validation,936,139,106752,3445,496080,602832
validation,937,14,10752,35,5040,15792
validation,938,74,56832,977,140688,197520
validation,939,367,281856,24011,3457584,3739440
validation,940,84,64512,1258,181152,245664
validation,941,141,108288,3544,510336,618624
validation,942,196,150528,6849,986256,1136784
validation,943,60,46080,642,92448,138528
validation,944,228,175104,9267,1334448,1509552
validation,945,52,39936,482,69408,109344
validation,946,32,24576,183,26352,50928
validation,947,54,41472,520,74880,116352
validation,948,73,56064,950,136800,192864
validation,949,584,448512,48214,6942816,7391328
validation,950,131,100608,3060,440640,541248
validation,951,48,36864,411,59184,96048
validation,952,187,143616,6234,897696,1041312
validation,953,33,25344,194,27936,53280
validation,954,88,67584,1381,198864,266448
validation,955,220,168960,8628,1242432,1411392
validation,956,79,60672,1113,160272,220944
validation,957,73,56064,950,136800,192864
validation,958,110,84480,2157,310608,395088
validation,959,52,39936,482,69408,109344
validation,960,23,17664,95,13680,31344
validation,961,41,31488,300,43200,74688
validation,962,27,20736,130,18720,39456
validation,963,66,50688,777,111888,162576
validation,964,132,101376,3106,447264,548640
validation,965,96,73728,1643,236592,310320
validation,966,65,49920,753,108432,158352
validation,967,21,16128,79,11376,27504
validation,968,91,69888,1477,212688,282576
validation,969,219,168192,8550,1231200,1399392
validation,970,32,24576,183,26352,50928
validation,971,70,53760,874,125856,179616
validation,972,29,22272,150,21600,43872
validation,973,59,45312,621,89424,134736
validation,974,87,66816,1350,194400,261216
validation,975,105,80640,1966,283104,363744
validation,976,63,48384,708,101952,150336
validation,977,198,152064,6989,1006416,1158480
validation,978,169,129792,5092,733248,863040
validation,979,42,32256,315,45360,77616
validation,980,97,74496,1678,241632,316128
validation,981,40,30720,286,41184,71904
validation,982,38,29184,258,37152,66336
validation,983,101,77568,1819,261936,339504
validation,984,10,7680,18,2592,10272
validation,985,78,59904,1085,156240,216144
validation,986,343,263424,20973,3020112,3283536
validation,987,63,48384,708,101952,150336
validation,988,141,108288,3544,510336,618624
validation,989,60,46080,642,92448,138528
validation,990,96,73728,1643,236592,310320
validation,991,229,175872,9349,1346256,1522128
validation,992,72,55296,924,133056,188352
validation,993,124,95232,2741,394704,489936
validation,994,74,56832,977,140688,197520
validation,995,287,220416,14684,2114496,2334912
validation,996,29,22272,150,21600,43872
validation,997,78,59904,1085,156240,216144
validation,998,487,374016,42279,6088176,6462192
validation,999,82,62976,1199,172656,235632
validation,1000,311,238848,17242,2482848,2721696
validation,1001,52,39936,482,69408,109344
validation,1002,76,58368,1030,148320,206688
validation,1003,297,228096,15725,2264400,2492496
validation,1004,27,20736,130,18720,39456
validation,1005,151,115968,4065,585360,701328
validation,1006,18,13824,58,8352,22176
validation,1007,68,52224,825,118800,171024
validation,1008,404,310272,29096,4189824,4500096
validation,1009,16,12288,46,6624,18912
validation,1010,80,61440,1141,164304,225744
validation,1011,330,253440,19413,2795472,3048912
validation,1012,157,120576,4394,632736,753312
validation,1013,112,86016,2236,321984,408000
validation,1014,113,86784,2277,327888,414672
validation,1015,46,35328,378,54432,89760
validation,1016,282,216576,14177,2041488,2258064
validation,1017,147,112896,3852,554688,667584
validation,1018,58,44544,600,86400,130944
validation,1019,26,19968,121,17424,37392
validation,1020,482,370176,41416,5963904,6334080
validation,1021,320,245760,18255,2628720,2874480
validation,1022,76,58368,1030,148320,206688
validation,1023,420,322560,31446,4528224,4850784
validation,1024,88,67584,1381,198864,266448
validation,1025,192,147456,6572,946368,1093824
validation,1026,32,24576,183,26352,50928
validation,1027,25,19200,112,16128,35328
validation,1028,27,20736,130,18720,39456
validation,1029,24,18432,103,14832,33264
validation,1030,81,62208,1170,168480,230688
validation,1031,333,255744,19768,2846592,3102336
validation,1032,38,29184,258,37152,66336
validation,1033,108,82944,2080,299520,382464
validation,1034,118,90624,2482,357408,448032
validation,1035,39,29952,271,39024,68976
validation,1036,65,49920,753,108432,158352
validation,1037,245,188160,10701,1540944,1729104
validation,1038,13,9984,30,4320,14304
validation,1039,66,50688,777,111888,162576
validation,1040,625,480000,50078,7211232,7691232
validation,1041,60,46080,642,92448,138528
validation,1042,660,506880,52143,7508592,8015472
validation,1043,121,92928,2610,375840,468768
validation,1044,56,43008,559,80496,123504
validation,1045,25,19200,112,16128,35328
validation,1046,158,121344,4451,640944,762288
validation,1047,69,52992,849,122256,175248
validation,1048,36,27648,231,33264,60912
validation,1049,59,45312,621,89424,134736
validation,1050,12,9216,26,3744,12960
validation,1051,110,84480,2157,310608,395088
validation,1052,93,71424,1542,222048,293472
validation,1053,115,88320,2358,339552,427872
validation,1054,28,21504,140,20160,41664
validation,1055,109,83712,2118,304992,388704
validation,1056,104,79872,1928,277632,357504
validation,1057,221,169728,8707,1253808,1423536
validation,1058,51,39168,464,66816,105984
validation,1059,189,145152,6368,916992,1062144
validation,1060,105,80640,1966,283104,363744
validation,1061,29,22272,150,21600,43872
validation,1062,64,49152,730,105120,154272
validation,1063,236,181248,9929,1429776,1611024
validation,1064,84,64512,1258,181152,245664
validation,1065,167,128256,4972,715968,844224
validation,1066,17,13056,52,7488,20544
validation,1067,11,8448,22,3168,11616
validation,1068,15,11520,40,5760,17280
validation,1069,35,26880,219,31536,58416
validation,1070,29,22272,150,21600,43872
validation,1071,324,248832,18714,2694816,2943648
validation,1072,70,53760,874,125856,179616
validation,1073,51,39168,464,66816,105984
validation,1074,28,21504,140,20160,41664
validation,1075,66,50688,777,111888,162576
validation,1076,383,294144,26150,3765600,4059744
validation,1077,73,56064,950,136800,192864
validation,1078,228,175104,9267,1334448,1509552
validation,1079,42,32256,315,45360,77616
validation,1080,14,10752,35,5040,15792
validation,1081,102,78336,1855,267120,345456
validation,1082,14,10752,35,5040,15792
validation,1083,198,152064,6989,1006416,1158480
validation,1084,161,123648,4621,665424,789072
validation,1085,31,23808,172,24768,48576
validation,1086,13,9984,30,4320,14304
validation,1087,49,37632,428,61632,99264
validation,1088,30,23040,161,23184,46224
validation,1089,327,251136,19062,2744928,2996064
validation,1090,39,29952,271,39024,68976
validation,1091,83,63744,1228,176832,240576
validation,1092,240,184320,10268,1478592,1662912
validation,1093,85,65280,1288,185472,250752
validation,1094,101,77568,1819,261936,339504
validation,1095,24,18432,103,14832,33264
validation,1096,15,11520,40,5760,17280
test,0,104,79872,1928,277632,357504
test,1,98,75264,1712,246528,321792
test,2,83,63744,1228,176832,240576
test,3,53,40704,501,72144,112848
test,4,65,49920,753,108432,158352
test,5,35,26880,219,31536,58416
test,6,122,93696,2654,382176,475872
test,7,65,49920,753,108432,158352
test,8,59,45312,621,89424,134736
test,9,101,77568,1819,261936,339504
test,10,10,7680,18,2592,10272
test,11,469,360192,39212,5646528,6006720
test,12,91,69888,1477,212688,282576
test,13,215,165120,8241,1186704,1351824
test,14,148,113664,3905,562320,675984
test,15,246,188928,10788,1553472,1742400
test,16,190,145920,6436,926784,1072704
test,17,39,29952,271,39024,68976
test,18,227,174336,9186,1322784,1497120
test,19,13,9984,30,4320,14304
test,20,122,93696,2654,382176,475872
test,21,25,19200,112,16128,35328
test,22,143,109824,3646,525024,634848
test,23,66,50688,777,111888,162576
test,24,49,37632,428,61632,99264
test,25,195,149760,6779,976176,1125936
test,26,58,44544,600,86400,130944
test,27,98,75264,1712,246528,321792
test,28,103,79104,1892,272448,351552
test,29,127,97536,2876,414144,511680
test,30,117,89856,2441,351504,441360
test,31,42,32256,315,45360,77616
test,32,49,37632,428,61632,99264
test,33,178,136704,5648,813312,950016
test,34,11,8448,22,3168,11616
test,35,90,69120,1444,207936,277056
test,36,130,99840,3013,433872,533712
test,37,27,20736,130,18720,39456
test,38,106,81408,2003,288432,369840
test,39,54,41472,520,74880,116352
test,40,109,83712,2118,304992,388704
test,41,24,18432,103,14832,33264
test,42,113,86784,2277,327888,414672
test,43,87,66816,1350,194400,261216
test,44,135,103680,3249,467856,571536
test,45,12,9216,26,3744,12960
test,46,63,48384,708,101952,150336
test,47,102,78336,1855,267120,345456
test,48,80,61440,1141,164304,225744
test,49,69,52992,849,122256,175248
test,50,51,39168,464,66816,105984
test,51,107,82176,2041,293904,376080
test,52,47,36096,394,56736,92832
test,53,99,76032,1747,251568,327600
test,54,74,56832,977,140688,197520
test,55,15,11520,40,5760,17280
test,56,27,20736,130,18720,39456
test,57,82,62976,1199,172656,235632
test,58,90,69120,1444,207936,277056
test,59,35,26880,219,31536,58416
test,60,15,11520,40,5760,17280
test,61,242,185856,10440,1503360,1689216
test,62,51,39168,464,66816,105984
test,63,78,59904,1085,156240,216144
test,64,43,33024,330,47520,80544
test,65,79,60672,1113,160272,220944
test,66,36,27648,231,33264,60912
test,67,105,80640,1966,283104,363744
test,68,63,48384,708,101952,150336
test,69,120,92160,2567,369648,461808
test,70,84,64512,1258,181152,245664
test,71,43,33024,330,47520,80544
test,72,65,49920,753,108432,158352
test,73,116,89088,2399,345456,434544
test,74,44,33792,345,49680,83472
test,75,59,45312,621,89424,134736
test,76,28,21504,140,20160,41664
test,77,147,112896,3852,554688,667584
test,78,12,9216,26,3744,12960
test,79,95,72960,1609,231696,304656
test,80,63,48384,708,101952,150336
test,81,57,43776,580,83520,127296
test,82,157,120576,4394,632736,753312
test,83,53,40704,501,72144,112848
test,84,110,84480,2157,310608,395088
test,85,92,70656,1509,217296,287952
test,86,114,87552,2317,333648,421200
test,87,120,92160,2567,369648,461808
test,88,111,85248,2197,316368,401616
test,89,231,177408,9513,1369872,1547280
test,90,192,147456,6572,946368,1093824
test,91,41,31488,300,43200,74688
test,92,52,39936,482,69408,109344
test,93,143,109824,3646,525024,634848
test,94,32,24576,183,26352,50928
test,95,168,129024,5032,724608,853632
test,96,82,62976,1199,172656,235632
test,97,58,44544,600,86400,130944
test,98,124,95232,2741,394704,489936
test,99,40,30720,286,41184,71904
test,100,28,21504,140,20160,41664
test,101,495,380160,43680,6289920,6670080
test,102,95,72960,1609,231696,304656
test,103,49,37632,428,61632,99264
test,104,109,83712,2118,304992,388704
test,105,109,83712,2118,304992,388704
test,106,98,75264,1712,246528,321792
test,107,115,88320,2358,339552,427872
test,108,66,50688,777,111888,162576
test,109,24,18432,103,14832,33264
test,110,87,66816,1350,194400,261216
test,111,110,84480,2157,310608,395088
test,112,32,24576,183,26352,50928
test,113,50,38400,446,64224,102624
test,114,105,80640,1966,283104,363744
test,115,66,50688,777,111888,162576
test,116,198,152064,6989,1006416,1158480
test,117,212,162816,8012,1153728,1316544
test,118,160,122880,4564,657216,780096
test,119,101,77568,1819,261936,339504
test,120,91,69888,1477,212688,282576
test,121,17,13056,52,7488,20544
test,122,26,19968,121,17424,37392
test,123,15,11520,40,5760,17280
test,124,24,18432,103,14832,33264
test,125,26,19968,121,17424,37392
test,126,108,82944,2080,299520,382464
test,127,92,70656,1509,217296,287952
test,128,376,288768,25203,3629232,3918000
test,129,367,281856,24011,3457584,3739440
test,130,9,6912,15,2160,9072
test,131,50,38400,446,64224,102624
test,132,75,57600,1003,144432,202032
test,133,54,41472,520,74880,116352
test,134,48,36864,411,59184,96048
test,135,106,81408,2003,288432,369840
test,136,101,77568,1819,261936,339504
test,137,59,45312,621,89424,134736
test,138,304,233472,16475,2372400,2605872
test,139,49,37632,428,61632,99264
test,140,234,179712,9761,1405584,1585296
test,141,76,58368,1030,148320,206688
test,142,147,112896,3852,554688,667584
test,143,63,48384,708,101952,150336
test,144,81,62208,1170,168480,230688
test,145,115,88320,2358,339552,427872
test,146,78,59904,1085,156240,216144
test,147,40,30720,286,41184,71904
test,148,109,83712,2118,304992,388704
test,149,303,232704,16367,2356848,2589552
test,150,39,29952,271,39024,68976
test,151,52,39936,482,69408,109344
test,152,139,106752,3445,496080,602832
test,153,102,78336,1855,267120,345456
test,154,14,10752,35,5040,15792
test,155,163,125184,4737,682128,807312
test,156,230,176640,9431,1358064,1534704
test,157,27,20736,130,18720,39456
test,158,10,7680,18,2592,10272
test,159,267,205056,12709,1830096,2035152
test,160,198,152064,6989,1006416,1158480
test,161,34,26112,206,29664,55776
test,162,308,236544,16911,2435184,2671728
test,163,247,189696,10876,1566144,1755840
test,164,371,284928,24537,3533328,3818256
test,165,213,163584,8088,1164672,1328256
test,166,64,49152,730,105120,154272
test,167,42,32256,315,45360,77616
test,168,271,208128,13092,1885248,2093376
test,169,502,385536,44924,6469056,6854592
test,170,88,67584,1381,198864,266448
test,171,27,20736,130,18720,39456
test,172,28,21504,140,20160,41664
test,173,75,57600,1003,144432,202032
test,174,10,7680,18,2592,10272
test,175,41,31488,300,43200,74688
test,176,59,45312,621,89424,134736
test,177,52,39936,482,69408,109344
test,178,75,57600,1003,144432,202032
test,179,13,9984,30,4320,14304
test,180,76,58368,1030,148320,206688
test,181,13,9984,30,4320,14304
test,182,87,66816,1350,194400,261216
test,183,335,257280,20006,2880864,3138144
test,184,23,17664,95,13680,31344
test,185,57,43776,580,83520,127296
test,186,52,39936,482,69408,109344
test,187,13,9984,30,4320,14304
test,188,674,517632,53091,7645104,8162736
test,189,124,95232,2741,394704,489936
test,190,74,56832,977,140688,197520
test,191,70,53760,874,125856,179616
test,192,153,117504,4173,600912,718416
test,193,12,9216,26,3744,12960
test,194,76,58368,1030,148320,206688
test,195,90,69120,1444,207936,277056
test,196,492,377856,43152,6213888,6591744
test,197,119,91392,2525,363600,454992
test,198,128,98304,2921,420624,518928
test,199,43,33024,330,47520,80544
test,200,99,76032,1747,251568,327600
test,201,12,9216,26,3744,12960
test,202,30,23040,161,23184,46224
test,203,118,90624,2482,357408,448032
test,204,40,30720,286,41184,71904
test,205,278,213504,13777,1983888,2197392
test,206,26,19968,121,17424,37392
test,207,75,57600,1003,144432,202032
test,208,36,27648,231,33264,60912
test,209,612,470016,49422,7116768,7586784
test,210,31,23808,172,24768,48576
test,211,101,77568,1819,261936,339504
test,212,296,227328,15619,2249136,2476464
test,213,19,14592,65,9360,23952
test,214,216,165888,8317,1197648,1363536
test,215,71,54528,899,129456,183984
test,216,97,74496,1678,241632,316128
test,217,186,142848,6168,888192,1031040
test,218,47,36096,394,56736,92832
test,219,54,41472,520,74880,116352
test,220,32,24576,183,26352,50928
test,221,707,542976,55603,8006832,8549808
test,222,20,15360,72,10368,25728
test,223,14,10752,35,5040,15792
test,224,12,9216,26,3744,12960
test,225,60,46080,642,92448,138528
test,226,399,306432,28380,4086720,4393152
test,227,60,46080,642,92448,138528
test,228,41,31488,300,43200,74688
test,229,97,74496,1678,241632,316128
test,230,93,71424,1542,222048,293472
test,231,75,57600,1003,144432,202032
test,232,35,26880,219,31536,58416
test,233,36,27648,231,33264,60912
test,234,122,93696,2654,382176,475872
test,235,539,413952,46858,6747552,7161504
test,236,141,108288,3544,510336,618624
test,237,122,93696,2654,382176,475872
test,238,174,133632,5397,777168,910800
test,239,67,51456,801,115344,166800
test,240,182,139776,5905,850320,990096
test,241,147,112896,3852,554688,667584
test,242,26,19968,121,17424,37392
test,243,79,60672,1113,160272,220944
test,244,71,54528,899,129456,183984
test,245,45,34560,361,51984,86544
test,246,149,114432,3958,569952,684384
test,247,252,193536,11321,1630224,1823760
test,248,214,164352,8164,1175616,1339968
test,249,84,64512,1258,181152,245664
test,250,32,24576,183,26352,50928
test,251,76,58368,1030,148320,206688
test,252,23,17664,95,13680,31344
test,253,204,156672,7419,1068336,1225008
test,254,32,24576,183,26352,50928
test,255,89,68352,1412,203328,271680
test,256,58,44544,600,86400,130944
test,257,101,77568,1819,261936,339504
test,258,49,37632,428,61632,99264
test,259,173,132864,5336,768384,901248
test,260,130,99840,3013,433872,533712
test,261,58,44544,600,86400,130944
test,262,111,85248,2197,316368,401616
test,263,527,404736,46619,6713136,7117872
test,264,42,32256,315,45360,77616
test,265,81,62208,1170,168480,230688
test,266,88,67584,1381,198864,266448
test,267,20,15360,72,10368,25728
test,268,112,86016,2236,321984,408000
test,269,222,170496,8786,1265184,1435680
test,270,26,19968,121,17424,37392
test,271,11,8448,22,3168,11616
test,272,72,55296,924,133056,188352
test,273,31,23808,172,24768,48576
test,274,26,19968,121,17424,37392
test,275,69,52992,849,122256,175248
test,276,59,45312,621,89424,134736
test,277,58,44544,600,86400,130944
test,278,12,9216,26,3744,12960
test,279,487,374016,42279,6088176,6462192
test,280,18,13824,58,8352,22176
test,281,62,47616,686,98784,146400
test,282,24,18432,103,14832,33264
test,283,128,98304,2921,420624,518928
test,284,57,43776,580,83520,127296
test,285,73,56064,950,136800,192864
test,286,221,169728,8707,1253808,1423536
test,287,15,11520,40,5760,17280
test,288,113,86784,2277,327888,414672
test,289,109,83712,2118,304992,388704
test,290,13,9984,30,4320,14304
test,291,13,9984,30,4320,14304
test,292,33,25344,194,27936,53280
test,293,121,92928,2610,375840,468768
test,294,39,29952,271,39024,68976
test,295,35,26880,219,31536,58416
test,296,32,24576,183,26352,50928
test,297,16,12288,46,6624,18912
test,298,79,60672,1113,160272,220944
test,299,13,9984,30,4320,14304
test,300,36,27648,231,33264,60912
test,301,456,350208,37068,5337792,5688000
test,302,59,45312,621,89424,134736
test,303,69,52992,849,122256,175248
test,304,90,69120,1444,207936,277056
test,305,143,109824,3646,525024,634848
test,306,47,36096,394,56736,92832
test,307,59,45312,621,89424,134736
test,308,67,51456,801,115344,166800
test,309,14,10752,35,5040,15792
test,310,75,57600,1003,144432,202032
test,311,50,38400,446,64224,102624
test,312,120,92160,2567,369648,461808
test,313,101,77568,1819,261936,339504
test,314,245,188160,10701,1540944,1729104
test,315,68,52224,825,118800,171024
test,316,46,35328,378,54432,89760
test,317,15,11520,40,5760,17280
test,318,55,42240,540,77760,120000
test,319,64,49152,730,105120,154272
test,320,61,46848,664,95616,142464
test,321,48,36864,411,59184,96048
test,322,32,24576,183,26352,50928
test,323,107,82176,2041,293904,376080
test,324,70,53760,874,125856,179616
test,325,180,138240,5776,831744,969984
test,326,13,9984,30,4320,14304
test,327,60,46080,642,92448,138528
test,328,28,21504,140,20160,41664
test,329,26,19968,121,17424,37392
test,330,320,245760,18255,2628720,2874480
test,331,96,73728,1643,236592,310320
test,332,181,139008,5840,840960,979968
test,333,118,90624,2482,357408,448032
test,334,111,85248,2197,316368,401616
test,335,96,73728,1643,236592,310320
test,336,108,82944,2080,299520,382464
test,337,345,264960,21218,3055392,3320352
test,338,101,77568,1819,261936,339504
test,339,67,51456,801,115344,166800
test,340,84,64512,1258,181152,245664
test,341,43,33024,330,47520,80544
test,342,42,32256,315,45360,77616
test,343,468,359424,39045,5622480,5981904
test,344,52,39936,482,69408,109344
test,345,65,49920,753,108432,158352
test,346,28,21504,140,20160,41664
test,347,16,12288,46,6624,18912
test,348,121,92928,2610,375840,468768
test,349,73,56064,950,136800,192864
test,350,47,36096,394,56736,92832
test,351,38,29184,258,37152,66336
test,352,237,182016,10013,1441872,1623888
test,353,62,47616,686,98784,146400
test,354,70,53760,874,125856,179616
test,355,34,26112,206,29664,55776
test,356,26,19968,121,17424,37392
test,357,16,12288,46,6624,18912
test,358,128,98304,2921,420624,518928
test,359,87,66816,1350,194400,261216
test,360,303,232704,16367,2356848,2589552
test,361,120,92160,2567,369648,461808
test,362,58,44544,600,86400,130944
test,363,118,90624,2482,357408,448032
test,364,14,10752,35,5040,15792
test,365,59,45312,621,89424,134736
test,366,13,9984,30,4320,14304
test,367,179,137472,5712,822528,960000
test,368,199,152832,7060,1016640,1169472
test,369,36,27648,231,33264,60912
test,370,76,58368,1030,148320,206688
test,371,53,40704,501,72144,112848
test,372,121,92928,2610,375840,468768
test,373,26,19968,121,17424,37392
test,374,28,21504,140,20160,41664
test,375,108,82944,2080,299520,382464
test,376,18,13824,58,8352,22176
test,377,87,66816,1350,194400,261216
test,378,15,11520,40,5760,17280
test,379,59,45312,621,89424,134736
test,380,148,113664,3905,562320,675984
test,381,33,25344,194,27936,53280
test,382,108,82944,2080,299520,382464
test,383,26,19968,121,17424,37392
test,384,245,188160,10701,1540944,1729104
test,385,58,44544,600,86400,130944
test,386,27,20736,130,18720,39456
test,387,68,52224,825,118800,171024
test,388,126,96768,2830,407520,504288
test,389,97,74496,1678,241632,316128
test,390,52,39936,482,69408,109344
test,391,60,46080,642,92448,138528
test,392,207,158976,7639,1100016,1258992
test,393,31,23808,172,24768,48576
test,394,135,103680,3249,467856,571536
test,395,36,27648,231,33264,60912
test,396,43,33024,330,47520,80544
test,397,116,89088,2399,345456,434544
test,398,27,20736,130,18720,39456
test,399,84,64512,1258,181152,245664
test,400,227,174336,9186,1322784,1497120
test,401,118,90624,2482,357408,448032
test,402,43,33024,330,47520,80544
test,403,137,105216,3346,481824,587040
test,404,38,29184,258,37152,66336
test,405,77,59136,1057,152208,211344
test,406,40,30720,286,41184,71904
test,407,18,13824,58,8352,22176
test,408,63,48384,708,101952,150336
test,409,407,312576,29530,4252320,4564896
test,410,44,33792,345,49680,83472
test,411,41,31488,300,43200,74688
test,412,55,42240,540,77760,120000
test,413,72,55296,924,133056,188352
test,414,51,39168,464,66816,105984
test,415,114,87552,2317,333648,421200
test,416,50,38400,446,64224,102624
test,417,27,20736,130,18720,39456
test,418,48,36864,411,59184,96048
test,419,55,42240,540,77760,120000
test,420,24,18432,103,14832,33264
test,421,24,18432,103,14832,33264
test,422,424,325632,32048,4614912,4940544
test,423,62,47616,686,98784,146400
test,424,50,38400,446,64224,102624
test,425,155,119040,4283,616752,735792
test,426,58,44544,600,86400,130944
test,427,41,31488,300,43200,74688
test,428,25,19200,112,16128,35328
test,429,35,26880,219,31536,58416
test,430,51,39168,464,66816,105984
test,431,165,126720,4854,698976,825696
test,432,55,42240,540,77760,120000
test,433,16,12288,46,6624,18912
test,434,25,19200,112,16128,35328
test,435,91,69888,1477,212688,282576
test,436,280,215040,13976,2012544,2227584
test,437,92,70656,1509,217296,287952
test,438,337,258816,20246,2915424,3174240
test,439,125,96000,2786,401184,497184
test,440,48,36864,411,59184,96048
test,441,175,134400,5460,786240,920640
test,442,59,45312,621,89424,134736
test,443,189,145152,6368,916992,1062144
test,444,96,73728,1643,236592,310320
test,445,342,262656,20851,3002544,3265200
test,446,10,7680,18,2592,10272
test,447,96,73728,1643,236592,310320
test,448,33,25344,194,27936,53280
test,449,122,93696,2654,382176,475872
test,450,29,22272,150,21600,43872
test,451,34,26112,206,29664,55776
test,452,35,26880,219,31536,58416
test,453,213,163584,8088,1164672,1328256
test,454,138,105984,3395,488880,594864
test,455,65,49920,753,108432,158352
test,456,241,185088,10354,1490976,1676064
test,457,42,32256,315,45360,77616
test,458,185,142080,6101,878544,1020624
test,459,45,34560,361,51984,86544
test,460,50,38400,446,64224,102624
test,461,72,55296,924,133056,188352
test,462,86,66048,1319,189936,255984
test,463,117,89856,2441,351504,441360
test,464,93,71424,1542,222048,293472
test,465,13,9984,30,4320,14304
test,466,103,79104,1892,272448,351552
test,467,18,13824,58,8352,22176
test,468,75,57600,1003,144432,202032
test,469,47,36096,394,56736,92832
test,470,111,85248,2197,316368,401616
test,471,425,326400,32199,4636656,4963056
test,472,14,10752,35,5040,15792
test,473,64,49152,730,105120,154272
test,474,191,146688,6504,936576,1083264
test,475,85,65280,1288,185472,250752
test,476,46,35328,378,54432,89760
test,477,119,91392,2525,363600,454992
test,478,80,61440,1141,164304,225744
test,479,71,54528,899,129456,183984
test,480,13,9984,30,4320,14304
test,481,295,226560,15514,2234016,2460576
test,482,126,96768,2830,407520,504288
test,483,146,112128,3800,547200,659328
test,484,67,51456,801,115344,166800
test,485,89,68352,1412,203328,271680
test,486,217,166656,8395,1208880,1375536
test,487,152,116736,4119,593136,709872
test,488,124,95232,2741,394704,489936
test,489,176,135168,5522,795168,930336
test,490,85,65280,1288,185472,250752
test,491,87,66816,1350,194400,261216
test,492,13,9984,30,4320,14304
test,493,55,42240,540,77760,120000
test,494,94,72192,1575,226800,298992
test,495,115,88320,2358,339552,427872
test,496,16,12288,46,6624,18912
test,497,45,34560,361,51984,86544
test,498,74,56832,977,140688,197520
test,499,62,47616,686,98784,146400
test,500,45,34560,361,51984,86544
test,501,23,17664,95,13680,31344
test,502,58,44544,600,86400,130944
test,503,64,49152,730,105120,154272
test,504,368,282624,24142,3476448,3759072
test,505,137,105216,3346,481824,587040
test,506,46,35328,378,54432,89760
test,507,70,53760,874,125856,179616
test,508,183,140544,5970,859680,1000224
test,509,278,213504,13777,1983888,2197392
test,510,320,245760,18255,2628720,2874480
test,511,303,232704,16367,2356848,2589552
test,512,13,9984,30,4320,14304
test,513,106,81408,2003,288432,369840
test,514,43,33024,330,47520,80544
test,515,101,77568,1819,261936,339504
test,516,57,43776,580,83520,127296
test,517,31,23808,172,24768,48576
test,518,114,87552,2317,333648,421200
test,519,51,39168,464,66816,105984
test,520,291,223488,15096,2173824,2397312
test,521,70,53760,874,125856,179616
test,522,47,36096,394,56736,92832
test,523,127,97536,2876,414144,511680
test,524,95,72960,1609,231696,304656
test,525,88,67584,1381,198864,266448
test,526,496,380928,43856,6315264,6696192
test,527,144,110592,3697,532368,642960
test,528,107,82176,2041,293904,376080
test,529,27,20736,130,18720,39456
test,530,55,42240,540,77760,120000
test,531,48,36864,411,59184,96048
test,532,388,297984,26837,3864528,4162512
test,533,766,588288,61062,8792928,9381216
test,534,57,43776,580,83520,127296
test,535,53,40704,501,72144,112848
test,536,176,135168,5522,795168,930336
test,537,46,35328,378,54432,89760
test,538,43,33024,330,47520,80544
test,539,107,82176,2041,293904,376080
test,540,15,11520,40,5760,17280
test,541,16,12288,46,6624,18912
test,542,10,7680,18,2592,10272
test,543,68,52224,825,118800,171024
test,544,53,40704,501,72144,112848
test,545,78,59904,1085,156240,216144
test,546,244,187392,10614,1528416,1715808
test,547,15,11520,40,5760,17280
test,548,66,50688,777,111888,162576
test,549,84,64512,1258,181152,245664
test,550,409,314112,29821,4294224,4608336
test,551,39,29952,271,39024,68976
test,552,118,90624,2482,357408,448032
test,553,45,34560,361,51984,86544
test,554,240,184320,10268,1478592,1662912
test,555,60,46080,642,92448,138528
test,556,64,49152,730,105120,154272
test,557,125,96000,2786,401184,497184
test,558,15,11520,40,5760,17280
test,559,55,42240,540,77760,120000
test,560,61,46848,664,95616,142464
test,561,39,29952,271,39024,68976
test,562,27,20736,130,18720,39456
test,563,36,27648,231,33264,60912
test,564,92,70656,1509,217296,287952
test,565,71,54528,899,129456,183984
test,566,40,30720,286,41184,71904
test,567,16,12288,46,6624,18912
test,568,43,33024,330,47520,80544
test,569,128,98304,2921,420624,518928
test,570,61,46848,664,95616,142464
test,571,32,24576,183,26352,50928
test,572,97,74496,1678,241632,316128
test,573,196,150528,6849,986256,1136784
test,574,92,70656,1509,217296,287952
test,575,13,9984,30,4320,14304
test,576,48,36864,411,59184,96048
test,577,148,113664,3905,562320,675984
test,578,200,153600,7131,1026864,1180464
test,579,40,30720,286,41184,71904
test,580,55,42240,540,77760,120000
test,581,144,110592,3697,532368,642960
test,582,387,297216,26699,3844656,4141872
test,583,88,67584,1381,198864,266448
test,584,60,46080,642,92448,138528
test,585,543,417024,46949,6760656,7177680
test,586,49,37632,428,61632,99264
test,587,189,145152,6368,916992,1062144
test,588,74,56832,977,140688,197520
test,589,25,19200,112,16128,35328
test,590,234,179712,9761,1405584,1585296
test,591,13,9984,30,4320,14304
test,592,28,21504,140,20160,41664
test,593,514,394752,46417,6684048,7078800
test,594,119,91392,2525,363600,454992
test,595,117,89856,2441,351504,441360
test,596,25,19200,112,16128,35328
test,597,78,59904,1085,156240,216144
test,598,71,54528,899,129456,183984
test,599,25,19200,112,16128,35328
test,600,30,23040,161,23184,46224
test,601,61,46848,664,95616,142464
test,602,26,19968,121,17424,37392
test,603,207,158976,7639,1100016,1258992
test,604,52,39936,482,69408,109344
test,605,36,27648,231,33264,60912
test,606,49,37632,428,61632,99264
test,607,56,43008,559,80496,123504
test,608,52,39936,482,69408,109344
test,609,82,62976,1199,172656,235632
test,610,174,133632,5397,777168,910800
test,611,115,88320,2358,339552,427872
test,612,41,31488,300,43200,74688
test,613,32,24576,183,26352,50928
test,614,85,65280,1288,185472,250752
test,615,80,61440,1141,164304,225744
test,616,36,27648,231,33264,60912
test,617,95,72960,1609,231696,304656
test,618,71,54528,899,129456,183984
test,619,103,79104,1892,272448,351552
test,620,111,85248,2197,316368,401616
test,621,208,159744,7713,1110672,1270416
test,622,92,70656,1509,217296,287952
test,623,35,26880,219,31536,58416
test,624,165,126720,4854,698976,825696
test,625,57,43776,580,83520,127296
test,626,26,19968,121,17424,37392
test,627,79,60672,1113,160272,220944
test,628,77,59136,1057,152208,211344
test,629,67,51456,801,115344,166800
test,630,148,113664,3905,562320,675984
test,631,20,15360,72,10368,25728
test,632,28,21504,140,20160,41664
test,633,117,89856,2441,351504,441360
test,634,67,51456,801,115344,166800
test,635,107,82176,2041,293904,376080
test,636,68,52224,825,118800,171024
test,637,186,142848,6168,888192,1031040
test,638,109,83712,2118,304992,388704
test,639,11,8448,22,3168,11616
test,640,314,241152,17577,2531088,2772240
test,641,181,139008,5840,840960,979968
test,642,15,11520,40,5760,17280
test,643,53,40704,501,72144,112848
test,644,183,140544,5970,859680,1000224
test,645,67,51456,801,115344,166800
test,646,110,84480,2157,310608,395088
test,647,129,99072,2967,427248,526320
test,648,51,39168,464,66816,105984
test,649,37,28416,244,35136,63552
test,650,35,26880,219,31536,58416
test,651,82,62976,1199,172656,235632
test,652,116,89088,2399,345456,434544
test,653,54,41472,520,74880,116352
test,654,27,20736,130,18720,39456
test,655,793,609024,63974,9212256,9821280
test,656,208,159744,7713,1110672,1270416
test,657,138,105984,3395,488880,594864
test,658,54,41472,520,74880,116352
test,659,71,54528,899,129456,183984
test,660,136,104448,3298,474912,579360
test,661,79,60672,1113,160272,220944
test,662,111,85248,2197,316368,401616
test,663,47,36096,394,56736,92832
test,664,84,64512,1258,181152,245664
test,665,292,224256,15200,2188800,2413056
test,666,47,36096,394,56736,92832
test,667,255,195840,11592,1669248,1865088
test,668,28,21504,140,20160,41664
test,669,141,108288,3544,510336,618624
test,670,110,84480,2157,310608,395088
test,671,20,15360,72,10368,25728
test,672,60,46080,642,92448,138528
test,673,282,216576,14177,2041488,2258064
test,674,102,78336,1855,267120,345456
test,675,50,38400,446,64224,102624
test,676,169,129792,5092,733248,863040
test,677,266,204288,12614,1816416,2020704
test,678,88,67584,1381,198864,266448
test,679,56,43008,559,80496,123504
test,680,189,145152,6368,916992,1062144
test,681,27,20736,130,18720,39456
test,682,72,55296,924,133056,188352
test,683,196,150528,6849,986256,1136784
test,684,138,105984,3395,488880,594864
test,685,67,51456,801,115344,166800
test,686,60,46080,642,92448,138528
test,687,128,98304,2921,420624,518928
test,688,106,81408,2003,288432,369840
test,689,154,118272,4228,608832,727104
test,690,41,31488,300,43200,74688
test,691,80,61440,1141,164304,225744
test,692,103,79104,1892,272448,351552
test,693,137,105216,3346,481824,587040
test,694,39,29952,271,39024,68976
test,695,15,11520,40,5760,17280
test,696,53,40704,501,72144,112848
test,697,54,41472,520,74880,116352
test,698,32,24576,183,26352,50928
test,699,48,36864,411,59184,96048
test,700,94,72192,1575,226800,298992
test,701,136,104448,3298,474912,579360
test,702,13,9984,30,4320,14304
test,703,116,89088,2399,345456,434544
test,704,91,69888,1477,212688,282576
test,705,13,9984,30,4320,14304
test,706,127,97536,2876,414144,511680
test,707,64,49152,730,105120,154272
test,708,384,294912,26287,3785328,4080240
test,709,38,29184,258,37152,66336
test,710,291,223488,15096,2173824,2397312
test,711,304,233472,16475,2372400,2605872
test,712,44,33792,345,49680,83472
test,713,641,492288,50968,7339392,7831680
test,714,311,238848,17242,2482848,2721696
test,715,59,45312,621,89424,134736
test,716,155,119040,4283,616752,735792
test,717,96,73728,1643,236592,310320
test,718,214,164352,8164,1175616,1339968
test,719,81,62208,1170,168480,230688
test,720,127,97536,2876,414144,511680
test,721,40,30720,286,41184,71904
test,722,91,69888,1477,212688,282576
test,723,99,76032,1747,251568,327600
test,724,26,19968,121,17424,37392
test,725,82,62976,1199,172656,235632
test,726,69,52992,849,122256,175248
test,727,23,17664,95,13680,31344
test,728,59,45312,621,89424,134736
test,729,81,62208,1170,168480,230688
test,730,52,39936,482,69408,109344
test,731,578,443904,47991,6910704,7354608
test,732,43,33024,330,47520,80544
test,733,239,183552,10183,1466352,1649904
test,734,60,46080,642,92448,138528
test,735,53,40704,501,72144,112848
test,736,302,231936,16259,2341296,2573232
test,737,17,13056,52,7488,20544
test,738,50,38400,446,64224,102624
test,739,71,54528,899,129456,183984
test,740,16,12288,46,6624,18912
test,741,530,407040,46674,6721056,7128096
test,742,55,42240,540,77760,120000
test,743,96,73728,1643,236592,310320
test,744,103,79104,1892,272448,351552
test,745,182,139776,5905,850320,990096
test,746,42,32256,315,45360,77616
test,747,37,28416,244,35136,63552
test,748,74,56832,977,140688,197520
test,749,198,152064,6989,1006416,1158480
test,750,10,7680,18,2592,10272
test,751,29,22272,150,21600,43872
test,752,11,8448,22,3168,11616
test,753,26,19968,121,17424,37392
test,754,101,77568,1819,261936,339504
test,755,218,167424,8472,1219968,1387392
test,756,277,212736,13678,1969632,2182368
test,757,285,218880,14480,2085120,2304000
test,758,49,37632,428,61632,99264
test,759,106,81408,2003,288432,369840
test,760,83,63744,1228,176832,240576
test,761,54,41472,520,74880,116352
test,762,11,8448,22,3168,11616
test,763,309,237312,17021,2451024,2688336
test,764,125,96000,2786,401184,497184
test,765,48,36864,411,59184,96048
test,766,14,10752,35,5040,15792
test,767,51,39168,464,66816,105984
test,768,328,251904,19179,2761776,3013680
test,769,345,264960,21218,3055392,3320352
test,770,41,31488,300,43200,74688
test,771,44,33792,345,49680,83472
test,772,22,16896,87,12528,29424
test,773,111,85248,2197,316368,401616
test,774,86,66048,1319,189936,255984
test,775,148,113664,3905,562320,675984
test,776,94,72192,1575,226800,298992
test,777,75,57600,1003,144432,202032
test,778,218,167424,8472,1219968,1387392
test,779,75,57600,1003,144432,202032
test,780,50,38400,446,64224,102624
test,781,338,259584,20366,2932704,3192288
test,782,54,41472,520,74880,116352
test,783,51,39168,464,66816,105984
test,784,134,102912,3201,460944,563856
test,785,84,64512,1258,181152,245664
test,786,61,46848,664,95616,142464
test,787,102,78336,1855,267120,345456
test,788,252,193536,11321,1630224,1823760
test,789,452,347136,36421,5244624,5591760
test,790,24,18432,103,14832,33264
test,791,64,49152,730,105120,154272
test,792,198,152064,6989,1006416,1158480
test,793,108,82944,2080,299520,382464
test,794,55,42240,540,77760,120000
test,795,120,92160,2567,369648,461808
test,796,21,16128,79,11376,27504
test,797,14,10752,35,5040,15792
test,798,39,29952,271,39024,68976
test,799,68,52224,825,118800,171024
test,800,586,450048,48291,6953904,7403952
test,801,247,189696,10876,1566144,1755840
test,802,153,117504,4173,600912,718416
test,803,28,21504,140,20160,41664
test,804,109,83712,2118,304992,388704
test,805,557,427776,47314,6813216,7240992
test,806,14,10752,35,5040,15792
test,807,86,66048,1319,189936,255984
test,808,189,145152,6368,916992,1062144
test,809,50,38400,446,64224,102624
test,810,91,69888,1477,212688,282576
test,811,22,16896,87,12528,29424
test,812,49,37632,428,61632,99264
test,813,85,65280,1288,185472,250752
test,814,29,22272,150,21600,43872
test,815,41,31488,300,43200,74688
test,816,61,46848,664,95616,142464
test,817,226,173568,9105,1311120,1484688
test,818,108,82944,2080,299520,382464
test,819,134,102912,3201,460944,563856
test,820,859,659712,72186,10394784,11054496
test,821,83,63744,1228,176832,240576
test,822,143,109824,3646,525024,634848
test,823,75,57600,1003,144432,202032
test,824,108,82944,2080,299520,382464
test,825,82,62976,1199,172656,235632
test,826,46,35328,378,54432,89760
test,827,194,148992,6709,966096,1115088
test,828,38,29184,258,37152,66336
test,829,94,72192,1575,226800,298992
test,830,68,52224,825,118800,171024
test,831,220,168960,8628,1242432,1411392
test,832,69,52992,849,122256,175248
test,833,252,193536,11321,1630224,1823760
test,834,60,46080,642,92448,138528
test,835,367,281856,24011,3457584,3739440
test,836,70,53760,874,125856,179616
test,837,13,9984,30,4320,14304
test,838,77,59136,1057,152208,211344
test,839,476,365568,40391,5816304,6181872
test,840,81,62208,1170,168480,230688
test,841,201,154368,7202,1037088,1191456
test,842,37,28416,244,35136,63552
test,843,49,37632,428,61632,99264
test,844,40,30720,286,41184,71904
test,845,132,101376,3106,447264,548640
test,846,105,80640,1966,283104,363744
test,847,13,9984,30,4320,14304
test,848,82,62976,1199,172656,235632
test,849,258,198144,11866,1708704,1906848
test,850,29,22272,150,21600,43872
test,851,68,52224,825,118800,171024
test,852,52,39936,482,69408,109344
test,853,51,39168,464,66816,105984
test,854,150,115200,4011,577584,692784
test,855,101,77568,1819,261936,339504
test,856,15,11520,40,5760,17280
test,857,35,26880,219,31536,58416
test,858,13,9984,30,4320,14304
test,859,58,44544,600,86400,130944
test,860,586,450048,48291,6953904,7403952
test,861,53,40704,501,72144,112848
test,862,80,61440,1141,164304,225744
test,863,145,111360,3748,539712,651072
test,864,62,47616,686,98784,146400
test,865,72,55296,924,133056,188352
test,866,104,79872,1928,277632,357504
test,867,95,72960,1609,231696,304656
test,868,17,13056,52,7488,20544
test,869,43,33024,330,47520,80544
test,870,171,131328,5213,750672,882000
test,871,13,9984,30,4320,14304
test,872,47,36096,394,56736,92832
test,873,86,66048,1319,189936,255984
test,874,96,73728,1643,236592,310320
test,875,42,32256,315,45360,77616
test,876,255,195840,11592,1669248,1865088
test,877,123,94464,2697,388368,482832
test,878,57,43776,580,83520,127296
test,879,111,85248,2197,316368,401616
test,880,153,117504,4173,600912,718416
test,881,36,27648,231,33264,60912
test,882,174,133632,5397,777168,910800
test,883,233,178944,9678,1393632,1572576
test,884,145,111360,3748,539712,651072
test,885,13,9984,30,4320,14304
test,886,97,74496,1678,241632,316128
test,887,61,46848,664,95616,142464
test,888,84,64512,1258,181152,245664
test,889,96,73728,1643,236592,310320
test,890,114,87552,2317,333648,421200
test,891,50,38400,446,64224,102624
test,892,92,70656,1509,217296,287952
test,893,105,80640,1966,283104,363744
test,894,102,78336,1855,267120,345456
test,895,39,29952,271,39024,68976
test,896,107,82176,2041,293904,376080
test,897,592,454656,48530,6988320,7442976
test,898,75,57600,1003,144432,202032
test,899,41,31488,300,43200,74688
test,900,66,50688,777,111888,162576
test,901,76,58368,1030,148320,206688
test,902,56,43008,559,80496,123504
test,903,63,48384,708,101952,150336
test,904,36,27648,231,33264,60912
test,905,62,47616,686,98784,146400
test,906,237,182016,10013,1441872,1623888
test,907,102,78336,1855,267120,345456
test,908,68,52224,825,118800,171024
test,909,89,68352,1412,203328,271680
test,910,41,31488,300,43200,74688
test,911,72,55296,924,133056,188352
test,912,116,89088,2399,345456,434544
test,913,52,39936,482,69408,109344
test,914,232,178176,9595,1381680,1559856
test,915,123,94464,2697,388368,482832
test,916,37,28416,244,35136,63552
test,917,84,64512,1258,181152,245664
test,918,54,41472,520,74880,116352
test,919,205,157440,7492,1078848,1236288
test,920,138,105984,3395,488880,594864
test,921,48,36864,411,59184,96048
test,922,153,117504,4173,600912,718416
test,923,218,167424,8472,1219968,1387392
test,924,64,49152,730,105120,154272
test,925,514,394752,46417,6684048,7078800
test,926,115,88320,2358,339552,427872
test,927,32,24576,183,26352,50928
test,928,45,34560,361,51984,86544
test,929,37,28416,244,35136,63552
test,930,13,9984,30,4320,14304
test,931,28,21504,140,20160,41664
test,932,68,52224,825,118800,171024
test,933,65,49920,753,108432,158352
test,934,62,47616,686,98784,146400
test,935,125,96000,2786,401184,497184
test,936,14,10752,35,5040,15792
test,937,57,43776,580,83520,127296
test,938,44,33792,345,49680,83472
test,939,233,178944,9678,1393632,1572576
test,940,73,56064,950,136800,192864
test,941,111,85248,2197,316368,401616
test,942,40,30720,286,41184,71904
test,943,108,82944,2080,299520,382464
test,944,84,64512,1258,181152,245664
test,945,45,34560,361,51984,86544
test,946,83,63744,1228,176832,240576
test,947,210,161280,7862,1132128,1293408
test,948,113,86784,2277,327888,414672
test,949,129,99072,2967,427248,526320
test,950,38,29184,258,37152,66336
test,951,211,162048,7937,1142928,1304976
test,952,317,243456,17914,2579616,2823072
test,953,88,67584,1381,198864,266448
test,954,48,36864,411,59184,96048
test,955,283,217344,14277,2055888,2273232
test,956,53,40704,501,72144,112848
test,957,14,10752,35,5040,15792
test,958,38,29184,258,37152,66336
test,959,56,43008,559,80496,123504
test,960,90,69120,1444,207936,277056
test,961,127,97536,2876,414144,511680
test,962,71,54528,899,129456,183984
test,963,117,89856,2441,351504,441360
test,964,661,507648,52208,7517952,8025600
test,965,187,143616,6234,897696,1041312
test,966,63,48384,708,101952,150336
test,967,394,302592,27673,3984912,4287504
test,968,71,54528,899,129456,183984
test,969,64,49152,730,105120,154272
test,970,27,20736,130,18720,39456
test,971,79,60672,1113,160272,220944
test,972,33,25344,194,27936,53280
test,973,275,211200,13482,1941408,2152608
test,974,327,251136,19062,2744928,2996064
test,975,63,48384,708,101952,150336
test,976,19,14592,65,9360,23952
test,977,316,242688,17801,2563344,2806032
test,978,69,52992,849,122256,175248
test,979,117,89856,2441,351504,441360
test,980,74,56832,977,140688,197520
test,981,76,58368,1030,148320,206688
test,982,32,24576,183,26352,50928
test,983,83,63744,1228,176832,240576
test,984,176,135168,5522,795168,930336
test,985,89,68352,1412,203328,271680
test,986,63,48384,708,101952,150336
test,987,60,46080,642,92448,138528
test,988,463,355584,38215,5502960,5858544
test,989,11,8448,22,3168,11616
test,990,81,62208,1170,168480,230688
test,991,95,72960,1609,231696,304656
test,992,60,46080,642,92448,138528
test,993,130,99840,3013,433872,533712
test,994,43,33024,330,47520,80544
test,995,25,19200,112,16128,35328
test,996,122,93696,2654,382176,475872
test,997,81,62208,1170,168480,230688
test,998,212,162816,8012,1153728,1316544
test,999,227,174336,9186,1322784,1497120
test,1000,75,57600,1003,144432,202032
test,1001,64,49152,730,105120,154272
test,1002,54,41472,520,74880,116352
test,1003,69,52992,849,122256,175248
test,1004,28,21504,140,20160,41664
test,1005,162,124416,4679,673776,798192
test,1006,108,82944,2080,299520,382464
test,1007,107,82176,2041,293904,376080
test,1008,39,29952,271,39024,68976
test,1009,69,52992,849,122256,175248
test,1010,57,43776,580,83520,127296
test,1011,209,160512,7787,1121328,1281840
test,1012,56,43008,559,80496,123504
test,1013,151,115968,4065,585360,701328
test,1014,12,9216,26,3744,12960
test,1015,180,138240,5776,831744,969984
test,1016,292,224256,15200,2188800,2413056
test,1017,85,65280,1288,185472,250752
test,1018,223,171264,8865,1276560,1447824
test,1019,108,82944,2080,299520,382464
test,1020,12,9216,26,3744,12960
test,1021,447,343296,35619,5129136,5472432
test,1022,82,62976,1199,172656,235632
test,1023,67,51456,801,115344,166800
test,1024,50,38400,446,64224,102624
test,1025,89,68352,1412,203328,271680
test,1026,10,7680,18,2592,10272
test,1027,68,52224,825,118800,171024
test,1028,64,49152,730,105120,154272
test,1029,68,52224,825,118800,171024
test,1030,25,19200,112,16128,35328
test,1031,210,161280,7862,1132128,1293408
test,1032,337,258816,20246,2915424,3174240
test,1033,135,103680,3249,467856,571536
test,1034,33,25344,194,27936,53280
test,1035,86,66048,1319,189936,255984
test,1036,32,24576,183,26352,50928
test,1037,34,26112,206,29664,55776
test,1038,64,49152,730,105120,154272
test,1039,60,46080,642,92448,138528
test,1040,43,33024,330,47520,80544
test,1041,73,56064,950,136800,192864
test,1042,88,67584,1381,198864,266448
test,1043,304,233472,16475,2372400,2605872
test,1044,93,71424,1542,222048,293472
test,1045,162,124416,4679,673776,798192
test,1046,50,38400,446,64224,102624
test,1047,67,51456,801,115344,166800
test,1048,380,291840,25742,3706848,3998688
test,1049,75,57600,1003,144432,202032
test,1050,62,47616,686,98784,146400
test,1051,33,25344,194,27936,53280
test,1052,42,32256,315,45360,77616
test,1053,50,38400,446,64224,102624
test,1054,56,43008,559,80496,123504
test,1055,122,93696,2654,382176,475872
test,1056,87,66816,1350,194400,261216
test,1057,166,127488,4913,707472,834960
test,1058,92,70656,1509,217296,287952
test,1059,271,208128,13092,1885248,2093376
test,1060,63,48384,708,101952,150336
test,1061,170,130560,5152,741888,872448
test,1062,211,162048,7937,1142928,1304976
test,1063,130,99840,3013,433872,533712
test,1064,108,82944,2080,299520,382464
test,1065,498,382464,44211,6366384,6748848
test,1066,194,148992,6709,966096,1115088
test,1067,42,32256,315,45360,77616
test,1068,117,89856,2441,351504,441360
test,1069,12,9216,26,3744,12960
test,1070,66,50688,777,111888,162576
test,1071,158,121344,4451,640944,762288
test,1072,111,85248,2197,316368,401616
test,1073,51,39168,464,66816,105984
test,1074,90,69120,1444,207936,277056
test,1075,35,26880,219,31536,58416
test,1076,14,10752,35,5040,15792
test,1077,563,432384,47491,6838704,7271088
test,1078,73,56064,950,136800,192864
test,1079,134,102912,3201,460944,563856
test,1080,58,44544,600,86400,130944
test,1081,45,34560,361,51984,86544
test,1082,49,37632,428,61632,99264
test,1083,80,61440,1141,164304,225744
test,1084,138,105984,3395,488880,594864
test,1085,76,58368,1030,148320,206688
test,1086,121,92928,2610,375840,468768
test,1087,33,25344,194,27936,53280
test,1088,94,72192,1575,226800,298992
test,1089,55,42240,540,77760,120000
test,1090,93,71424,1542,222048,293472
test,1091,34,26112,206,29664,55776
test,1092,20,15360,72,10368,25728
test,1093,147,112896,3852,554688,667584
test,1094,70,53760,874,125856,179616
test,1095,196,150528,6849,986256,1136784
test,1096,13,9984,30,4320,14304
test,1097,49,37632,428,61632,99264
test,1098,99,76032,1747,251568,327600
test,1099,159,122112,4507,649008,771120
test,1100,112,86016,2236,321984,408000
test,1101,45,34560,361,51984,86544
test,1102,79,60672,1113,160272,220944
test,1103,95,72960,1609,231696,304656
test,1104,57,43776,580,83520,127296
test,1105,98,75264,1712,246528,321792
test,1106,122,93696,2654,382176,475872
test,1107,249,191232,11053,1591632,1782864
test,1108,57,43776,580,83520,127296
test,1109,77,59136,1057,152208,211344
test,1110,207,158976,7639,1100016,1258992
test,1111,41,31488,300,43200,74688
test,1112,889,682752,76432,11006208,11688960
test,1113,127,97536,2876,414144,511680
test,1114,71,54528,899,129456,183984
test,1115,387,297216,26699,3844656,4141872
test,1116,29,22272,150,21600,43872
test,1117,57,43776,580,83520,127296
test,1118,159,122112,4507,649008,771120
test,1119,433,332544,33423,4812912,5145456
test,1120,109,83712,2118,304992,388704
test,1121,42,32256,315,45360,77616
test,1122,104,79872,1928,277632,357504
test,1123,125,96000,2786,401184,497184
test,1124,106,81408,2003,288432,369840
test,1125,102,78336,1855,267120,345456
test,1126,58,44544,600,86400,130944
test,1127,27,20736,130,18720,39456
test,1128,62,47616,686,98784,146400
test,1129,293,225024,15304,2203776,2428800
test,1130,25,19200,112,16128,35328
test,1131,301,231168,16151,2325744,2556912
test,1132,27,20736,130,18720,39456
test,1133,171,131328,5213,750672,882000
test,1134,69,52992,849,122256,175248
test,1135,24,18432,103,14832,33264
test,1136,44,33792,345,49680,83472
test,1137,108,82944,2080,299520,382464
test,1138,15,11520,40,5760,17280
test,1139,17,13056,52,7488,20544
test,1140,59,45312,621,89424,134736
test,1141,200,153600,7131,1026864,1180464
test,1142,38,29184,258,37152,66336
test,1143,273,209664,13286,1913184,2122848
test,1144,95,72960,1609,231696,304656
test,1145,64,49152,730,105120,154272
test,1146,52,39936,482,69408,109344
test,1147,11,8448,22,3168,11616
test,1148,94,72192,1575,226800,298992
test,1149,177,135936,5585,804240,940176
test,1150,15,11520,40,5760,17280
test,1151,30,23040,161,23184,46224
test,1152,61,46848,664,95616,142464
test,1153,204,156672,7419,1068336,1225008
test,1154,81,62208,1170,168480,230688
test,1155,32,24576,183,26352,50928
test,1156,45,34560,361,51984,86544
test,1157,77,59136,1057,152208,211344
test,1158,24,18432,103,14832,33264
test,1159,86,66048,1319,189936,255984
test,1160,282,216576,14177,2041488,2258064
test,1161,27,20736,130,18720,39456
test,1162,69,52992,849,122256,175248
test,1163,21,16128,79,11376,27504
test,1164,101,77568,1819,261936,339504
test,1165,43,33024,330,47520,80544
test,1166,59,45312,621,89424,134736
test,1167,42,32256,315,45360,77616
test,1168,157,120576,4394,632736,753312
test,1169,217,166656,8395,1208880,1375536
test,1170,56,43008,559,80496,123504
test,1171,34,26112,206,29664,55776
test,1172,93,71424,1542,222048,293472
test,1173,111,85248,2197,316368,401616
test,1174,439,337152,34356,4947264,5284416
test,1175,57,43776,580,83520,127296
test,1176,61,46848,664,95616,142464
test,1177,17,13056,52,7488,20544
test,1178,96,73728,1643,236592,310320
test,1179,698,536064,54880,7902720,8438784
test,1180,59,45312,621,89424,134736
test,1181,56,43008,559,80496,123504
test,1182,113,86784,2277,327888,414672
test,1183,122,93696,2654,382176,475872
test,1184,208,159744,7713,1110672,1270416
test,1185,61,46848,664,95616,142464
test,1186,420,322560,31446,4528224,4850784
test,1187,319,244992,18141,2612304,2857296
test,1188,39,29952,271,39024,68976
test,1189,152,116736,4119,593136,709872
test,1190,67,51456,801,115344,166800
test,1191,210,161280,7862,1132128,1293408
test,1192,53,40704,501,72144,112848
test,1193,26,19968,121,17424,37392
test,1194,786,603648,63194,9099936,9703584
test,1195,95,72960,1609,231696,304656
test,1196,147,112896,3852,554688,667584
test,1197,125,96000,2786,401184,497184
test,1198,674,517632,53091,7645104,8162736
test,1199,142,109056,3595,517680,626736
test,1200,87,66816,1350,194400,261216
test,1201,62,47616,686,98784,146400
test,1202,385,295680,26424,3805056,4100736
test,1203,107,82176,2041,293904,376080
test,1204,255,195840,11592,1669248,1865088
test,1205,52,39936,482,69408,109344
test,1206,204,156672,7419,1068336,1225008
test,1207,13,9984,30,4320,14304
test,1208,83,63744,1228,176832,240576
test,1209,35,26880,219,31536,58416
test,1210,60,46080,642,92448,138528
test,1211,36,27648,231,33264,60912
test,1212,97,74496,1678,241632,316128
test,1213,78,59904,1085,156240,216144
test,1214,66,50688,777,111888,162576
test,1215,87,66816,1350,194400,261216
test,1216,92,70656,1509,217296,287952
test,1217,67,51456,801,115344,166800
test,1218,69,52992,849,122256,175248
test,1219,22,16896,87,12528,29424
test,1220,88,67584,1381,198864,266448
test,1221,32,24576,183,26352,50928
test,1222,52,39936,482,69408,109344
test,1223,96,73728,1643,236592,310320
test,1224,76,58368,1030,148320,206688
test,1225,85,65280,1288,185472,250752
test,1226,124,95232,2741,394704,489936
test,1227,109,83712,2118,304992,388704
test,1228,101,77568,1819,261936,339504
test,1229,94,72192,1575,226800,298992
test,1230,98,75264,1712,246528,321792
test,1231,103,79104,1892,272448,351552
test,1232,134,102912,3201,460944,563856
test,1233,96,73728,1643,236592,310320
test,1234,54,41472,520,74880,116352
test,1235,9,6912,15,2160,9072
test,1236,114,87552,2317,333648,421200
test,1237,193,148224,6641,956304,1104528
test,1238,99,76032,1747,251568,327600
test,1239,50,38400,446,64224,102624
test,1240,198,152064,6989,1006416,1158480
test,1241,68,52224,825,118800,171024
test,1242,583,447744,48176,6937344,7385088
test,1243,75,57600,1003,144432,202032
test,1244,88,67584,1381,198864,266448
test,1245,85,65280,1288,185472,250752
test,1246,42,32256,315,45360,77616
test,1247,614,471552,49519,7130736,7602288
test,1248,102,78336,1855,267120,345456
test,1249,10,7680,18,2592,10272
test,1250,75,57600,1003,144432,202032
test,1251,176,135168,5522,795168,930336
test,1252,300,230400,16044,2310336,2540736
test,1253,172,132096,5274,759456,891552
test,1254,179,137472,5712,822528,960000
test,1255,34,26112,206,29664,55776
test,1256,212,162816,8012,1153728,1316544
test,1257,47,36096,394,56736,92832
test,1258,35,26880,219,31536,58416
test,1259,113,86784,2277,327888,414672
test,1260,38,29184,258,37152,66336
test,1261,81,62208,1170,168480,230688
test,1262,71,54528,899,129456,183984
test,1263,34,26112,206,29664,55776
test,1264,193,148224,6641,956304,1104528
test,1265,190,145920,6436,926784,1072704
test,1266,416,319488,30850,4442400,4761888
test,1267,225,172800,9025,1299600,1472400
test,1268,61,46848,664,95616,142464
test,1269,70,53760,874,125856,179616
test,1270,92,70656,1509,217296,287952
test,1271,43,33024,330,47520,80544
test,1272,31,23808,172,24768,48576
test,1273,62,47616,686,98784,146400
test,1274,85,65280,1288,185472,250752
test,1275,83,63744,1228,176832,240576
test,1276,98,75264,1712,246528,321792
test,1277,113,86784,2277,327888,414672
test,1278,57,43776,580,83520,127296
test,1279,28,21504,140,20160,41664
test,1280,34,26112,206,29664,55776
test,1281,571,438528,47748,6875712,7314240
test,1282,68,52224,825,118800,171024
test,1283,10,7680,18,2592,10272
test,1284,95,72960,1609,231696,304656
test,1285,34,26112,206,29664,55776
test,1286,437,335616,34043,4902192,5237808
test,1287,90,69120,1444,207936,277056
test,1288,35,26880,219,31536,58416
test,1289,47,36096,394,56736,92832
test,1290,65,49920,753,108432,158352
test,1291,34,26112,206,29664,55776
test,1292,261,200448,12144,1748736,1949184
test,1293,219,168192,8550,1231200,1399392
test,1294,59,45312,621,89424,134736
test,1295,19,14592,65,9360,23952
test,1296,75,57600,1003,144432,202032
test,1297,62,47616,686,98784,146400
test,1298,55,42240,540,77760,120000
test,1299,83,63744,1228,176832,240576
test,1300,120,92160,2567,369648,461808
test,1301,371,284928,24537,3533328,3818256
test,1302,107,82176,2041,293904,376080
test,1303,68,52224,825,118800,171024
test,1304,10,7680,18,2592,10272
test,1305,73,56064,950,136800,192864
test,1306,115,88320,2358,339552,427872
test,1307,56,43008,559,80496,123504
test,1308,473,363264,39883,5743152,6106416
test,1309,47,36096,394,56736,92832
test,1310,46,35328,378,54432,89760
test,1311,100,76800,1783,256752,333552
test,1312,48,36864,411,59184,96048
test,1313,30,23040,161,23184,46224
test,1314,95,72960,1609,231696,304656
test,1315,83,63744,1228,176832,240576
test,1316,106,81408,2003,288432,369840
test,1317,42,32256,315,45360,77616
test,1318,83,63744,1228,176832,240576
test,1319,28,21504,140,20160,41664
test,1320,65,49920,753,108432,158352
test,1321,87,66816,1350,194400,261216
test,1322,53,40704,501,72144,112848
test,1323,96,73728,1643,236592,310320
test,1324,88,67584,1381,198864,266448
test,1325,12,9216,26,3744,12960
test,1326,89,68352,1412,203328,271680
test,1327,17,13056,52,7488,20544
test,1328,723,555264,56961,8202384,8757648
test,1329,327,251136,19062,2744928,2996064
test,1330,65,49920,753,108432,158352
test,1331,143,109824,3646,525024,634848
test,1332,253,194304,11411,1643184,1837488
test,1333,13,9984,30,4320,14304
test,1334,34,26112,206,29664,55776
test,1335,58,44544,600,86400,130944
test,1336,55,42240,540,77760,120000
test,1337,103,79104,1892,272448,351552
test,1338,55,42240,540,77760,120000
test,1339,40,30720,286,41184,71904
test,1340,230,176640,9431,1358064,1534704
test,1341,102,78336,1855,267120,345456
test,1342,212,162816,8012,1153728,1316544
test,1343,244,187392,10614,1528416,1715808
test,1344,149,114432,3958,569952,684384
test,1345,113,86784,2277,327888,414672
test,1346,77,59136,1057,152208,211344
test,1347,69,52992,849,122256,175248
test,1348,43,33024,330,47520,80544
test,1349,73,56064,950,136800,192864
test,1350,87,66816,1350,194400,261216
test,1351,71,54528,899,129456,183984
test,1352,45,34560,361,51984,86544
test,1353,81,62208,1170,168480,230688
test,1354,212,162816,8012,1153728,1316544
test,1355,28,21504,140,20160,41664
test,1356,146,112128,3800,547200,659328
test,1357,60,46080,642,92448,138528
test,1358,56,43008,559,80496,123504
test,1359,163,125184,4737,682128,807312
test,1360,115,88320,2358,339552,427872
test,1361,14,10752,35,5040,15792
test,1362,36,27648,231,33264,60912
test,1363,44,33792,345,49680,83472
test,1364,76,58368,1030,148320,206688
test,1365,81,62208,1170,168480,230688
test,1366,10,7680,18,2592,10272
test,1367,254,195072,11501,1656144,1851216
test,1368,115,88320,2358,339552,427872
test,1369,9,6912,15,2160,9072
test,1370,183,140544,5970,859680,1000224
test,1371,41,31488,300,43200,74688
test,1372,111,85248,2197,316368,401616
test,1373,85,65280,1288,185472,250752
test,1374,794,609792,64087,9228528,9838320
test,1375,12,9216,26,3744,12960
test,1376,208,159744,7713,1110672,1270416
test,1377,220,168960,8628,1242432,1411392
test,1378,31,23808,172,24768,48576
test,1379,28,21504,140,20160,41664
test,1380,70,53760,874,125856,179616
test,1381,15,11520,40,5760,17280
test,1382,81,62208,1170,168480,230688
test,1383,302,231936,16259,2341296,2573232
test,1384,44,33792,345,49680,83472
test,1385,50,38400,446,64224,102624
test,1386,156,119808,4339,624816,744624
test,1387,68,52224,825,118800,171024
test,1388,44,33792,345,49680,83472
test,1389,25,19200,112,16128,35328
test,1390,63,48384,708,101952,150336
test,1391,111,85248,2197,316368,401616
test,1392,78,59904,1085,156240,216144
test,1393,25,19200,112,16128,35328
test,1394,26,19968,121,17424,37392
test,1395,120,92160,2567,369648,461808
test,1396,111,85248,2197,316368,401616
test,1397,72,55296,924,133056,188352
test,1398,16,12288,46,6624,18912
test,1399,230,176640,9431,1358064,1534704
test,1400,16,12288,46,6624,18912
test,1401,60,46080,642,92448,138528
test,1402,69,52992,849,122256,175248
test,1403,287,220416,14684,2114496,2334912
test,1404,495,380160,43680,6289920,6670080
test,1405,63,48384,708,101952,150336
test,1406,216,165888,8317,1197648,1363536
test,1407,35,26880,219,31536,58416
test,1408,94,72192,1575,226800,298992
test,1409,117,89856,2441,351504,441360
test,1410,142,109056,3595,517680,626736
test,1411,206,158208,7565,1089360,1247568
test,1412,62,47616,686,98784,146400
test,1413,74,56832,977,140688,197520
test,1414,120,92160,2567,369648,461808
test,1415,124,95232,2741,394704,489936
test,1416,161,123648,4621,665424,789072
test,1417,231,177408,9513,1369872,1547280
test,1418,56,43008,559,80496,123504
test,1419,78,59904,1085,156240,216144
test,1420,50,38400,446,64224,102624
test,1421,100,76800,1783,256752,333552
test,1422,45,34560,361,51984,86544
test,1423,107,82176,2041,293904,376080
test,1424,55,42240,540,77760,120000
test,1425,90,69120,1444,207936,277056
test,1426,106,81408,2003,288432,369840
test,1427,83,63744,1228,176832,240576
test,1428,13,9984,30,4320,14304
test,1429,17,13056,52,7488,20544
test,1430,66,50688,777,111888,162576
test,1431,58,44544,600,86400,130944
test,1432,42,32256,315,45360,77616
test,1433,56,43008,559,80496,123504
test,1434,12,9216,26,3744,12960
test,1435,107,82176,2041,293904,376080
test,1436,30,23040,161,23184,46224
test,1437,104,79872,1928,277632,357504
test,1438,125,96000,2786,401184,497184
test,1439,113,86784,2277,327888,414672
test,1440,58,44544,600,86400,130944
test,1441,50,38400,446,64224,102624
test,1442,528,405504,46637,6715728,7121232
test,1443,102,78336,1855,267120,345456
test,1444,51,39168,464,66816,105984
test,1445,572,439296,47782,6880608,7319904
test,1446,35,26880,219,31536,58416
test,1447,32,24576,183,26352,50928
test,1448,155,119040,4283,616752,735792
test,1449,59,45312,621,89424,134736
test,1450,31,23808,172,24768,48576
test,1451,93,71424,1542,222048,293472
test,1452,113,86784,2277,327888,414672
test,1453,96,73728,1643,236592,310320
test,1454,34,26112,206,29664,55776
test,1455,157,120576,4394,632736,753312
test,1456,288,221184,14786,2129184,2350368
test,1457,45,34560,361,51984,86544
test,1458,110,84480,2157,310608,395088
test,1459,69,52992,849,122256,175248
test,1460,43,33024,330,47520,80544
test,1461,25,19200,112,16128,35328
test,1462,48,36864,411,59184,96048
test,1463,8,6144,12,1728,7872
test,1464,71,54528,899,129456,183984
test,1465,101,77568,1819,261936,339504
test,1466,147,112896,3852,554688,667584
test,1467,79,60672,1113,160272,220944
test,1468,37,28416,244,35136,63552
test,1469,71,54528,899,129456,183984
test,1470,61,46848,664,95616,142464
test,1471,12,9216,26,3744,12960
test,1472,120,92160,2567,369648,461808
test,1473,85,65280,1288,185472,250752
test,1474,110,84480,2157,310608,395088
test,1475,101,77568,1819,261936,339504
test,1476,17,13056,52,7488,20544
test,1477,94,72192,1575,226800,298992
test,1478,212,162816,8012,1153728,1316544
test,1479,59,45312,621,89424,134736
test,1480,152,116736,4119,593136,709872
test,1481,177,135936,5585,804240,940176
test,1482,69,52992,849,122256,175248
test,1483,47,36096,394,56736,92832
test,1484,21,16128,79,11376,27504
test,1485,50,38400,446,64224,102624
test,1486,68,52224,825,118800,171024
test,1487,93,71424,1542,222048,293472
test,1488,123,94464,2697,388368,482832
test,1489,109,83712,2118,304992,388704
test,1490,24,18432,103,14832,33264
test,1491,27,20736,130,18720,39456
test,1492,712,546816,56018,8066592,8613408
test,1493,150,115200,4011,577584,692784
test,1494,33,25344,194,27936,53280
test,1495,176,135168,5522,795168,930336
test,1496,12,9216,26,3744,12960
test,1497,118,90624,2482,357408,448032
test,1498,71,54528,899,129456,183984
test,1499,40,30720,286,41184,71904
test,1500,44,33792,345,49680,83472
test,1501,14,10752,35,5040,15792
test,1502,131,100608,3060,440640,541248
test,1503,408,313344,29675,4273200,4586544
test,1504,53,40704,501,72144,112848
test,1505,69,52992,849,122256,175248
test,1506,42,32256,315,45360,77616
test,1507,39,29952,271,39024,68976
test,1508,22,16896,87,12528,29424
test,1509,81,62208,1170,168480,230688
test,1510,177,135936,5585,804240,940176
test,1511,37,28416,244,35136,63552
test,1512,113,86784,2277,327888,414672
test,1513,147,112896,3852,554688,667584
test,1514,411,315648,30113,4336272,4651920
test,1515,17,13056,52,7488,20544
test,1516,103,79104,1892,272448,351552
test,1517,45,34560,361,51984,86544
test,1518,246,188928,10788,1553472,1742400
test,1519,68,52224,825,118800,171024
test,1520,40,30720,286,41184,71904
test,1521,45,34560,361,51984,86544
test,1522,15,11520,40,5760,17280
test,1523,370,284160,24405,3514320,3798480
test,1524,36,27648,231,33264,60912
test,1525,44,33792,345,49680,83472
test,1526,95,72960,1609,231696,304656
test,1527,14,10752,35,5040,15792
test,1528,10,7680,18,2592,10272
test,1529,546,419328,47022,6771168,7190496
test,1530,24,18432,103,14832,33264
test,1531,213,163584,8088,1164672,1328256
test,1532,37,28416,244,35136,63552
test,1533,117,89856,2441,351504,441360
test,1534,45,34560,361,51984,86544
test,1535,69,52992,849,122256,175248
test,1536,17,13056,52,7488,20544
test,1537,52,39936,482,69408,109344
test,1538,36,27648,231,33264,60912
test,1539,727,558336,57314,8253216,8811552
test,1540,231,177408,9513,1369872,1547280
test,1541,41,31488,300,43200,74688
test,1542,202,155136,7274,1047456,1202592
test,1543,40,30720,286,41184,71904
test,1544,106,81408,2003,288432,369840
test,1545,30,23040,161,23184,46224
test,1546,356,273408,22593,3253392,3526800
test,1547,49,37632,428,61632,99264
test,1548,53,40704,501,72144,112848
test,1549,47,36096,394,56736,92832
test,1550,75,57600,1003,144432,202032
test,1551,222,170496,8786,1265184,1435680
test,1552,232,178176,9595,1381680,1559856
test,1553,72,55296,924,133056,188352
test,1554,13,9984,30,4320,14304
test,1555,13,9984,30,4320,14304
test,1556,31,23808,172,24768,48576
test,1557,156,119808,4339,624816,744624
test,1558,15,11520,40,5760,17280
test,1559,27,20736,130,18720,39456
test,1560,15,11520,40,5760,17280
test,1561,59,45312,621,89424,134736
test,1562,13,9984,30,4320,14304
test,1563,51,39168,464,66816,105984
test,1564,104,79872,1928,277632,357504
test,1565,141,108288,3544,510336,618624
test,1566,73,56064,950,136800,192864
test,1567,66,50688,777,111888,162576
test,1568,37,28416,244,35136,63552
test,1569,60,46080,642,92448,138528
test,1570,522,400896,46534,6700896,7101792
test,1571,104,79872,1928,277632,357504
test,1572,17,13056,52,7488,20544
test,1573,63,48384,708,101952,150336
test,1574,191,146688,6504,936576,1083264
test,1575,63,48384,708,101952,150336
test,1576,23,17664,95,13680,31344
test,1577,46,35328,378,54432,89760
test,1578,429,329472,32808,4724352,5053824
test,1579,33,25344,194,27936,53280
test,1580,107,82176,2041,293904,376080
test,1581,55,42240,540,77760,120000
test,1582,118,90624,2482,357408,448032
test,1583,39,29952,271,39024,68976
test,1584,34,26112,206,29664,55776
test,1585,32,24576,183,26352,50928
test,1586,75,57600,1003,144432,202032
test,1587,159,122112,4507,649008,771120
test,1588,75,57600,1003,144432,202032
test,1589,15,11520,40,5760,17280
test,1590,152,116736,4119,593136,709872
test,1591,26,19968,121,17424,37392
test,1592,128,98304,2921,420624,518928
test,1593,29,22272,150,21600,43872
test,1594,43,33024,330,47520,80544
test,1595,112,86016,2236,321984,408000
test,1596,38,29184,258,37152,66336
test,1597,107,82176,2041,293904,376080
test,1598,221,169728,8707,1253808,1423536
test,1599,52,39936,482,69408,109344
test,1600,56,43008,559,80496,123504
test,1601,92,70656,1509,217296,287952
test,1602,129,99072,2967,427248,526320
test,1603,47,36096,394,56736,92832
test,1604,40,30720,286,41184,71904
test,1605,66,50688,777,111888,162576
test,1606,86,66048,1319,189936,255984
test,1607,31,23808,172,24768,48576
test,1608,37,28416,244,35136,63552
test,1609,67,51456,801,115344,166800
test,1610,539,413952,46858,6747552,7161504
test,1611,49,37632,428,61632,99264
test,1612,37,28416,244,35136,63552
test,1613,105,80640,1966,283104,363744
test,1614,184,141312,6036,869184,1010496
test,1615,85,65280,1288,185472,250752
test,1616,129,99072,2967,427248,526320
test,1617,105,80640,1966,283104,363744
test,1618,40,30720,286,41184,71904
test,1619,76,58368,1030,148320,206688
test,1620,84,64512,1258,181152,245664
test,1621,291,223488,15096,2173824,2397312
test,1622,98,75264,1712,246528,321792
test,1623,77,59136,1057,152208,211344
test,1624,86,66048,1319,189936,255984
test,1625,61,46848,664,95616,142464
test,1626,37,28416,244,35136,63552
test,1627,72,55296,924,133056,188352
test,1628,67,51456,801,115344,166800
test,1629,151,115968,4065,585360,701328
test,1630,200,153600,7131,1026864,1180464
test,1631,131,100608,3060,440640,541248
test,1632,69,52992,849,122256,175248
test,1633,24,18432,103,14832,33264
test,1634,197,151296,6919,996336,1147632
test,1635,121,92928,2610,375840,468768
test,1636,83,63744,1228,176832,240576
test,1637,70,53760,874,125856,179616
test,1638,168,129024,5032,724608,853632
test,1639,32,24576,183,26352,50928
test,1640,137,105216,3346,481824,587040
test,1641,57,43776,580,83520,127296
test,1642,211,162048,7937,1142928,1304976
test,1643,52,39936,482,69408,109344
test,1644,113,86784,2277,327888,414672
test,1645,59,45312,621,89424,134736
test,1646,116,89088,2399,345456,434544
test,1647,66,50688,777,111888,162576
test,1648,101,77568,1819,261936,339504
test,1649,160,122880,4564,657216,780096
test,1650,37,28416,244,35136,63552
test,1651,58,44544,600,86400,130944
test,1652,98,75264,1712,246528,321792
test,1653,14,10752,35,5040,15792
test,1654,73,56064,950,136800,192864
test,1655,193,148224,6641,956304,1104528
test,1656,88,67584,1381,198864,266448
test,1657,56,43008,559,80496,123504
test,1658,10,7680,18,2592,10272
test,1659,63,48384,708,101952,150336
test,1660,37,28416,244,35136,63552
test,1661,374,287232,24935,3590640,3877872
test,1662,201,154368,7202,1037088,1191456
test,1663,95,72960,1609,231696,304656
test,1664,30,23040,161,23184,46224
test,1665,116,89088,2399,345456,434544
test,1666,55,42240,540,77760,120000
test,1667,64,49152,730,105120,154272
test,1668,67,51456,801,115344,166800
test,1669,154,118272,4228,608832,727104
test,1670,54,41472,520,74880,116352
test,1671,34,26112,206,29664,55776
test,1672,131,100608,3060,440640,541248
test,1673,504,387072,45283,6520752,6907824
test,1674,16,12288,46,6624,18912
test,1675,78,59904,1085,156240,216144
test,1676,25,19200,112,16128,35328
test,1677,261,200448,12144,1748736,1949184
test,1678,72,55296,924,133056,188352
test,1679,114,87552,2317,333648,421200
test,1680,37,28416,244,35136,63552
test,1681,36,27648,231,33264,60912
test,1682,73,56064,950,136800,192864
test,1683,102,78336,1855,267120,345456
test,1684,60,46080,642,92448,138528
test,1685,39,29952,271,39024,68976
test,1686,50,38400,446,64224,102624
test,1687,128,98304,2921,420624,518928
test,1688,78,59904,1085,156240,216144
test,1689,76,58368,1030,148320,206688
test,1690,57,43776,580,83520,127296
test,1691,180,138240,5776,831744,969984
test,1692,102,78336,1855,267120,345456
test,1693,49,37632,428,61632,99264
test,1694,311,238848,17242,2482848,2721696
test,1695,247,189696,10876,1566144,1755840
test,1696,398,305664,28238,4066272,4371936
test,1697,111,85248,2197,316368,401616
test,1698,171,131328,5213,750672,882000
test,1699,60,46080,642,92448,138528
test,1700,50,38400,446,64224,102624
test,1701,472,362496,39715,5718960,6081456
test,1702,103,79104,1892,272448,351552
test,1703,96,73728,1643,236592,310320
test,1704,242,185856,10440,1503360,1689216
test,1705,94,72192,1575,226800,298992
test,1706,90,69120,1444,207936,277056
test,1707,59,45312,621,89424,134736
test,1708,94,72192,1575,226800,298992
test,1709,393,301824,27533,3964752,4266576
test,1710,92,70656,1509,217296,287952
test,1711,55,42240,540,77760,120000
test,1712,107,82176,2041,293904,376080
test,1713,33,25344,194,27936,53280
test,1714,64,49152,730,105120,154272
test,1715,13,9984,30,4320,14304
test,1716,101,77568,1819,261936,339504
test,1717,343,263424,20973,3020112,3283536
test,1718,90,69120,1444,207936,277056
test,1719,106,81408,2003,288432,369840
test,1720,77,59136,1057,152208,211344
test,1721,30,23040,161,23184,46224
test,1722,109,83712,2118,304992,388704
test,1723,46,35328,378,54432,89760
test,1724,250,192000,11142,1604448,1796448
test,1725,48,36864,411,59184,96048
test,1726,54,41472,520,74880,116352
test,1727,71,54528,899,129456,183984
test,1728,118,90624,2482,357408,448032
test,1729,98,75264,1712,246528,321792
test,1730,73,56064,950,136800,192864
test,1731,25,19200,112,16128,35328
test,1732,26,19968,121,17424,37392
test,1733,87,66816,1350,194400,261216
test,1734,109,83712,2118,304992,388704
test,1735,72,55296,924,133056,188352
test,1736,114,87552,2317,333648,421200
test,1737,194,148992,6709,966096,1115088
test,1738,58,44544,600,86400,130944
test,1739,614,471552,49519,7130736,7602288
test,1740,60,46080,642,92448,138528
test,1741,48,36864,411,59184,96048
test,1742,44,33792,345,49680,83472
test,1743,16,12288,46,6624,18912
test,1744,90,69120,1444,207936,277056
test,1745,33,25344,194,27936,53280
test,1746,31,23808,172,24768,48576
test,1747,34,26112,206,29664,55776
test,1748,70,53760,874,125856,179616
test,1749,27,20736,130,18720,39456
test,1750,59,45312,621,89424,134736
test,1751,495,380160,43680,6289920,6670080
test,1752,213,163584,8088,1164672,1328256
test,1753,60,46080,642,92448,138528
test,1754,429,329472,32808,4724352,5053824
test,1755,25,19200,112,16128,35328
test,1756,53,40704,501,72144,112848
test,1757,149,114432,3958,569952,684384
test,1758,169,129792,5092,733248,863040
test,1759,123,94464,2697,388368,482832
test,1760,96,73728,1643,236592,310320
test,1761,219,168192,8550,1231200,1399392
test,1762,14,10752,35,5040,15792
test,1763,35,26880,219,31536,58416
test,1764,77,59136,1057,152208,211344
test,1765,116,89088,2399,345456,434544
test,1766,47,36096,394,56736,92832
test,1767,29,22272,150,21600,43872
test,1768,332,254976,19649,2829456,3084432
test,1769,304,233472,16475,2372400,2605872
test,1770,162,124416,4679,673776,798192
test,1771,46,35328,378,54432,89760
test,1772,79,60672,1113,160272,220944
test,1773,13,9984,30,4320,14304
test,1774,28,21504,140,20160,41664
test,1775,30,23040,161,23184,46224
test,1776,113,86784,2277,327888,414672
test,1777,116,89088,2399,345456,434544
test,1778,58,44544,600,86400,130944
test,1779,380,291840,25742,3706848,3998688
test,1780,113,86784,2277,327888,414672
test,1781,56,43008,559,80496,123504
test,1782,104,79872,1928,277632,357504
test,1783,399,306432,28380,4086720,4393152
test,1784,165,126720,4854,698976,825696
test,1785,97,74496,1678,241632,316128
test,1786,62,47616,686,98784,146400
test,1787,15,11520,40,5760,17280
test,1788,20,15360,72,10368,25728
test,1789,179,137472,5712,822528,960000
test,1790,102,78336,1855,267120,345456
test,1791,79,60672,1113,160272,220944
test,1792,42,32256,315,45360,77616
test,1793,96,73728,1643,236592,310320
test,1794,34,26112,206,29664,55776
test,1795,41,31488,300,43200,74688
test,1796,264,202752,12425,1789200,1991952
test,1797,81,62208,1170,168480,230688
test,1798,30,23040,161,23184,46224
test,1799,112,86016,2236,321984,408000
test,1800,100,76800,1783,256752,333552
test,1801,817,627456,66780,9616320,10243776
test,1802,13,9984,30,4320,14304
test,1803,356,273408,22593,3253392,3526800
test,1804,77,59136,1057,152208,211344
test,1805,79,60672,1113,160272,220944
test,1806,318,244224,18027,2595888,2840112
test,1807,54,41472,520,74880,116352
test,1808,11,8448,22,3168,11616
test,1809,61,46848,664,95616,142464
test,1810,77,59136,1057,152208,211344
test,1811,121,92928,2610,375840,468768
test,1812,77,59136,1057,152208,211344
test,1813,180,138240,5776,831744,969984
test,1814,39,29952,271,39024,68976
test,1815,80,61440,1141,164304,225744
test,1816,354,271872,22340,3216960,3488832
test,1817,84,64512,1258,181152,245664
test,1818,67,51456,801,115344,166800
test,1819,62,47616,686,98784,146400
test,1820,92,70656,1509,217296,287952
test,1821,14,10752,35,5040,15792
test,1822,81,62208,1170,168480,230688
test,1823,42,32256,315,45360,77616
test,1824,134,102912,3201,460944,563856
test,1825,114,87552,2317,333648,421200
test,1826,43,33024,330,47520,80544
test,1827,29,22272,150,21600,43872
test,1828,67,51456,801,115344,166800
test,1829,48,36864,411,59184,96048
test,1830,135,103680,3249,467856,571536
test,1831,103,79104,1892,272448,351552
test,1832,112,86016,2236,321984,408000
test,1833,45,34560,361,51984,86544
test,1834,67,51456,801,115344,166800
test,1835,211,162048,7937,1142928,1304976
test,1836,44,33792,345,49680,83472
test,1837,41,31488,300,43200,74688
test,1838,42,32256,315,45360,77616
test,1839,61,46848,664,95616,142464
test,1840,166,127488,4913,707472,834960
test,1841,16,12288,46,6624,18912
test,1842,51,39168,464,66816,105984
test,1843,52,39936,482,69408,109344
test,1844,102,78336,1855,267120,345456
test,1845,21,16128,79,11376,27504
test,1846,26,19968,121,17424,37392
test,1847,39,29952,271,39024,68976
test,1848,93,71424,1542,222048,293472
test,1849,27,20736,130,18720,39456
test,1850,95,72960,1609,231696,304656
test,1851,99,76032,1747,251568,327600
test,1852,17,13056,52,7488,20544
test,1853,261,200448,12144,1748736,1949184
test,1854,66,50688,777,111888,162576
test,1855,113,86784,2277,327888,414672
test,1856,20,15360,72,10368,25728
test,1857,13,9984,30,4320,14304
test,1858,48,36864,411,59184,96048
test,1859,112,86016,2236,321984,408000
test,1860,252,193536,11321,1630224,1823760
test,1861,13,9984,30,4320,14304
test,1862,80,61440,1141,164304,225744
test,1863,216,165888,8317,1197648,1363536
test,1864,85,65280,1288,185472,250752
test,1865,528,405504,46637,6715728,7121232
test,1866,144,110592,3697,532368,642960
test,1867,13,9984,30,4320,14304
test,1868,59,45312,621,89424,134736
test,1869,29,22272,150,21600,43872
test,1870,105,80640,1966,283104,363744
test,1871,518,397824,46473,6692112,7089936
test,1872,102,78336,1855,267120,345456
test,1873,229,175872,9349,1346256,1522128
test,1874,53,40704,501,72144,112848
test,1875,210,161280,7862,1132128,1293408
test,1876,31,23808,172,24768,48576
test,1877,168,129024,5032,724608,853632
test,1878,178,136704,5648,813312,950016
test,1879,26,19968,121,17424,37392
test,1880,12,9216,26,3744,12960
test,1881,97,74496,1678,241632,316128
test,1882,104,79872,1928,277632,357504
test,1883,102,78336,1855,267120,345456
test,1884,13,9984,30,4320,14304
test,1885,255,195840,11592,1669248,1865088
test,1886,14,10752,35,5040,15792
test,1887,82,62976,1199,172656,235632
test,1888,240,184320,10268,1478592,1662912
test,1889,400,307200,28523,4107312,4414512
test,1890,73,56064,950,136800,192864
test,1891,110,84480,2157,310608,395088
test,1892,52,39936,482,69408,109344
test,1893,153,117504,4173,600912,718416
test,1894,73,56064,950,136800,192864
test,1895,70,53760,874,125856,179616
test,1896,131,100608,3060,440640,541248
test,1897,49,37632,428,61632,99264
test,1898,66,50688,777,111888,162576
test,1899,56,43008,559,80496,123504
test,1900,118,90624,2482,357408,448032
test,1901,92,70656,1509,217296,287952
test,1902,68,52224,825,118800,171024
test,1903,8,6144,12,1728,7872
test,1904,82,62976,1199,172656,235632
test,1905,389,298752,26976,3884544,4183296
test,1906,54,41472,520,74880,116352
test,1907,115,88320,2358,339552,427872
test,1908,46,35328,378,54432,89760
test,1909,89,68352,1412,203328,271680
test,1910,50,38400,446,64224,102624
test,1911,48,36864,411,59184,96048
test,1912,46,35328,378,54432,89760
test,1913,146,112128,3800,547200,659328
test,1914,34,26112,206,29664,55776
test,1915,51,39168,464,66816,105984
test,1916,97,74496,1678,241632,316128
test,1917,181,139008,5840,840960,979968
test,1918,237,182016,10013,1441872,1623888
test,1919,481,369408,41244,5939136,6308544
test,1920,79,60672,1113,160272,220944
test,1921,13,9984,30,4320,14304
test,1922,226,173568,9105,1311120,1484688
test,1923,122,93696,2654,382176,475872
test,1924,65,49920,753,108432,158352
test,1925,153,117504,4173,600912,718416
test,1926,61,46848,664,95616,142464
test,1927,30,23040,161,23184,46224
test,1928,56,43008,559,80496,123504
test,1929,12,9216,26,3744,12960
test,1930,55,42240,540,77760,120000
test,1931,76,58368,1030,148320,206688
test,1932,86,66048,1319,189936,255984
test,1933,143,109824,3646,525024,634848
test,1934,67,51456,801,115344,166800
test,1935,273,209664,13286,1913184,2122848
test,1936,24,18432,103,14832,33264
test,1937,16,12288,46,6624,18912
test,1938,129,99072,2967,427248,526320
test,1939,135,103680,3249,467856,571536
test,1940,40,30720,286,41184,71904
test,1941,69,52992,849,122256,175248
test,1942,117,89856,2441,351504,441360
test,1943,229,175872,9349,1346256,1522128
test,1944,216,165888,8317,1197648,1363536
test,1945,91,69888,1477,212688,282576
test,1946,432,331776,33269,4790736,5122512
test,1947,110,84480,2157,310608,395088
test,1948,122,93696,2654,382176,475872
test,1949,303,232704,16367,2356848,2589552
test,1950,104,79872,1928,277632,357504
test,1951,24,18432,103,14832,33264
test,1952,69,52992,849,122256,175248
test,1953,92,70656,1509,217296,287952
test,1954,80,61440,1141,164304,225744
test,1955,53,40704,501,72144,112848
test,1956,32,24576,183,26352,50928
test,1957,58,44544,600,86400,130944
test,1958,88,67584,1381,198864,266448
test,1959,15,11520,40,5760,17280
test,1960,129,99072,2967,427248,526320
test,1961,146,112128,3800,547200,659328
test,1962,13,9984,30,4320,14304
test,1963,82,62976,1199,172656,235632
test,1964,219,168192,8550,1231200,1399392
test,1965,180,138240,5776,831744,969984
test,1966,47,36096,394,56736,92832
test,1967,99,76032,1747,251568,327600
test,1968,58,44544,600,86400,130944
test,1969,71,54528,899,129456,183984
test,1970,67,51456,801,115344,166800
test,1971,86,66048,1319,189936,255984
test,1972,66,50688,777,111888,162576
test,1973,110,84480,2157,310608,395088
test,1974,165,126720,4854,698976,825696
test,1975,134,102912,3201,460944,563856
test,1976,113,86784,2277,327888,414672
test,1977,84,64512,1258,181152,245664
test,1978,340,261120,20608,2967552,3228672
test,1979,128,98304,2921,420624,518928
test,1980,50,38400,446,64224,102624
test,1981,51,39168,464,66816,105984
test,1982,80,61440,1141,164304,225744
test,1983,56,43008,559,80496,123504
test,1984,169,129792,5092,733248,863040
test,1985,91,69888,1477,212688,282576
test,1986,52,39936,482,69408,109344
test,1987,48,36864,411,59184,96048
test,1988,12,9216,26,3744,12960
test,1989,92,70656,1509,217296,287952
test,1990,58,44544,600,86400,130944
test,1991,237,182016,10013,1441872,1623888
test,1992,56,43008,559,80496,123504
test,1993,107,82176,2041,293904,376080
test,1994,114,87552,2317,333648,421200
test,1995,98,75264,1712,246528,321792
test,1996,231,177408,9513,1369872,1547280
test,1997,195,149760,6779,976176,1125936
test,1998,126,96768,2830,407520,504288
test,1999,64,49152,730,105120,154272
test,2000,27,20736,130,18720,39456
test,2001,45,34560,361,51984,86544
test,2002,392,301056,27393,3944592,4245648
test,2003,42,32256,315,45360,77616
test,2004,48,36864,411,59184,96048
test,2005,151,115968,4065,585360,701328
test,2006,41,31488,300,43200,74688
test,2007,203,155904,7346,1057824,1213728
test,2008,455,349440,36906,5314464,5663904
test,2009,171,131328,5213,750672,882000
test,2010,884,678912,75702,10901088,11580000
test,2011,36,27648,231,33264,60912
test,2012,208,159744,7713,1110672,1270416
test,2013,16,12288,46,6624,18912
test,2014,51,39168,464,66816,105984
test,2015,104,79872,1928,277632,357504
test,2016,76,58368,1030,148320,206688
test,2017,58,44544,600,86400,130944
test,2018,196,150528,6849,986256,1136784
test,2019,66,50688,777,111888,162576
test,2020,142,109056,3595,517680,626736
test,2021,38,29184,258,37152,66336
test,2022,68,52224,825,118800,171024
test,2023,44,33792,345,49680,83472
test,2024,131,100608,3060,440640,541248
test,2025,484,371712,41760,6013440,6385152
test,2026,43,33024,330,47520,80544
test,2027,187,143616,6234,897696,1041312
test,2028,240,184320,10268,1478592,1662912
test,2029,67,51456,801,115344,166800
test,2030,66,50688,777,111888,162576
test,2031,114,87552,2317,333648,421200
test,2032,79,60672,1113,160272,220944
test,2033,219,168192,8550,1231200,1399392
test,2034,62,47616,686,98784,146400
test,2035,220,168960,8628,1242432,1411392
test,2036,47,36096,394,56736,92832
test,2037,135,103680,3249,467856,571536
test,2038,32,24576,183,26352,50928
test,2039,73,56064,950,136800,192864
test,2040,41,31488,300,43200,74688
test,2041,101,77568,1819,261936,339504
test,2042,168,129024,5032,724608,853632
test,2043,224,172032,8945,1288080,1460112
test,2044,112,86016,2236,321984,408000
test,2045,63,48384,708,101952,150336
test,2046,63,48384,708,101952,150336
test,2047,59,45312,621,89424,134736
test,2048,13,9984,30,4320,14304
test,2049,71,54528,899,129456,183984
test,2050,30,23040,161,23184,46224
test,2051,14,10752,35,5040,15792
test,2052,107,82176,2041,293904,376080
test,2053,171,131328,5213,750672,882000
test,2054,301,231168,16151,2325744,2556912
test,2055,71,54528,899,129456,183984
test,2056,15,11520,40,5760,17280
test,2057,326,250368,18946,2728224,2978592
test,2058,57,43776,580,83520,127296
test,2059,283,217344,14277,2055888,2273232
test,2060,733,562944,57856,8331264,8894208
test,2061,49,37632,428,61632,99264
test,2062,74,56832,977,140688,197520
test,2063,73,56064,950,136800,192864
test,2064,15,11520,40,5760,17280
test,2065,116,89088,2399,345456,434544
test,2066,10,7680,18,2592,10272
test,2067,49,37632,428,61632,99264
test,2068,431,331008,33115,4768560,5099568
test,2069,160,122880,4564,657216,780096
test,2070,51,39168,464,66816,105984
test,2071,169,129792,5092,733248,863040
test,2072,108,82944,2080,299520,382464
test,2073,93,71424,1542,222048,293472
test,2074,92,70656,1509,217296,287952
test,2075,26,19968,121,17424,37392
test,2076,42,32256,315,45360,77616
test,2077,102,78336,1855,267120,345456
test,2078,62,47616,686,98784,146400
test,2079,40,30720,286,41184,71904
test,2080,104,79872,1928,277632,357504
test,2081,65,49920,753,108432,158352
test,2082,48,36864,411,59184,96048
test,2083,130,99840,3013,433872,533712
test,2084,53,40704,501,72144,112848
test,2085,113,86784,2277,327888,414672
test,2086,93,71424,1542,222048,293472
test,2087,37,28416,244,35136,63552
test,2088,171,131328,5213,750672,882000
test,2089,77,59136,1057,152208,211344
test,2090,55,42240,540,77760,120000
test,2091,294,225792,15409,2218896,2444688
test,2092,279,214272,13877,1998288,2212560
test,2093,65,49920,753,108432,158352
test,2094,82,62976,1199,172656,235632
test,2095,57,43776,580,83520,127296
test,2096,256,196608,11683,1682352,1878960
test,2097,188,144384,6301,907344,1051728
test,2098,35,26880,219,31536,58416
test,2099,14,10752,35,5040,15792
test,2100,54,41472,520,74880,116352
test,2101,13,9984,30,4320,14304
test,2102,94,72192,1575,226800,298992
test,2103,101,77568,1819,261936,339504
test,2104,72,55296,924,133056,188352
test,2105,37,28416,244,35136,63552
test,2106,64,49152,730,105120,154272
test,2107,47,36096,394,56736,92832
test,2108,10,7680,18,2592,10272
test,2109,61,46848,664,95616,142464
test,2110,161,123648,4621,665424,789072
test,2111,119,91392,2525,363600,454992
test,2112,83,63744,1228,176832,240576
test,2113,51,39168,464,66816,105984
test,2114,105,80640,1966,283104,363744
test,2115,206,158208,7565,1089360,1247568
test,2116,102,78336,1855,267120,345456
test,2117,59,45312,621,89424,134736
test,2118,39,29952,271,39024,68976
test,2119,101,77568,1819,261936,339504
test,2120,27,20736,130,18720,39456
test,2121,47,36096,394,56736,92832
test,2122,17,13056,52,7488,20544
test,2123,68,52224,825,118800,171024
test,2124,12,9216,26,3744,12960
test,2125,65,49920,753,108432,158352
test,2126,27,20736,130,18720,39456
test,2127,212,162816,8012,1153728,1316544
test,2128,46,35328,378,54432,89760
test,2129,28,21504,140,20160,41664
test,2130,212,162816,8012,1153728,1316544
test,2131,32,24576,183,26352,50928
test,2132,96,73728,1643,236592,310320
test,2133,81,62208,1170,168480,230688
test,2134,72,55296,924,133056,188352
test,2135,623,478464,49973,7196112,7674576
test,2136,296,227328,15619,2249136,2476464
test,2137,204,156672,7419,1068336,1225008
test,2138,49,37632,428,61632,99264
test,2139,327,251136,19062,2744928,2996064
test,2140,45,34560,361,51984,86544
test,2141,16,12288,46,6624,18912
test,2142,28,21504,140,20160,41664
test,2143,61,46848,664,95616,142464
test,2144,158,121344,4451,640944,762288
test,2145,57,43776,580,83520,127296
test,2146,31,23808,172,24768,48576
test,2147,209,160512,7787,1121328,1281840
test,2148,18,13824,58,8352,22176
test,2149,98,75264,1712,246528,321792
test,2150,51,39168,464,66816,105984
test,2151,76,58368,1030,148320,206688
test,2152,38,29184,258,37152,66336
test,2153,49,37632,428,61632,99264
test,2154,218,167424,8472,1219968,1387392
test,2155,126,96768,2830,407520,504288
test,2156,27,20736,130,18720,39456
test,2157,72,55296,924,133056,188352
test,2158,177,135936,5585,804240,940176
test,2159,323,248064,18599,2678256,2926320
test,2160,13,9984,30,4320,14304
test,2161,14,10752,35,5040,15792
test,2162,164,125952,4795,690480,816432
test,2163,48,36864,411,59184,96048
test,2164,192,147456,6572,946368,1093824
test,2165,401,307968,28665,4127760,4435728
test,2166,86,66048,1319,189936,255984
test,2167,662,508416,52274,7527456,8035872
test,2168,31,23808,172,24768,48576
test,2169,878,674304,74838,10776672,11450976
test,2170,58,44544,600,86400,130944
test,2171,62,47616,686,98784,146400
test,2172,116,89088,2399,345456,434544
test,2173,68,52224,825,118800,171024
test,2174,64,49152,730,105120,154272
test,2175,34,26112,206,29664,55776
test,2176,58,44544,600,86400,130944
test,2177,47,36096,394,56736,92832
test,2178,40,30720,286,41184,71904
test,2179,46,35328,378,54432,89760
test,2180,116,89088,2399,345456,434544
test,2181,78,59904,1085,156240,216144
test,2182,210,161280,7862,1132128,1293408
test,2183,128,98304,2921,420624,518928
test,2184,101,77568,1819,261936,339504
test,2185,43,33024,330,47520,80544
test,2186,87,66816,1350,194400,261216
test,2187,113,86784,2277,327888,414672
test,2188,428,328704,32656,4702464,5031168
