split,index,nodes,total_values_for_nodes,edges,total_values_for_edges,total_values_for_graph
train,0,61,46848,1898,273312,320160
train,1,15,11520,115,16560,28080
train,2,37,28416,698,100512,128928
train,3,19,14592,184,26496,41088
train,4,42,32256,900,129600,161856
train,5,23,17664,270,38880,56544
train,6,14,10752,100,14400,25152
train,7,21,16128,225,32400,48528
train,8,20,15360,204,29376,44736
train,9,34,26112,590,84960,111072
train,10,34,26112,590,84960,111072
train,11,24,18432,294,42336,60768
train,12,26,19968,345,49680,69648
train,13,10,7680,51,7344,15024
train,14,16,12288,131,18864,31152
train,15,17,13056,147,21168,34224
train,16,29,22272,429,61776,84048
train,17,9,6912,41,5904,12816
train,18,22,16896,247,35568,52464
train,19,32,24576,522,75168,99744
train,20,12,9216,73,10512,19728
train,21,3,2304,5,720,3024
train,22,39,29952,776,111744,141696
train,23,18,13824,165,23760,37584
train,24,12,9216,73,10512,19728
train,25,19,14592,184,26496,41088
train,26,21,16128,225,32400,48528
train,27,32,24576,522,75168,99744
train,28,22,16896,247,35568,52464
train,29,5,3840,13,1872,5712
train,30,32,24576,522,75168,99744
train,31,23,17664,270,38880,56544
train,32,5,3840,13,1872,5712
train,33,23,17664,270,38880,56544
train,34,39,29952,776,111744,141696
train,35,36,27648,661,95184,122832
train,36,42,32256,900,129600,161856
train,37,37,28416,698,100512,128928
train,38,37,28416,698,100512,128928
train,39,42,32256,900,129600,161856
train,40,29,22272,429,61776,84048
train,41,17,13056,147,21168,34224
train,42,16,12288,131,18864,31152
train,43,15,11520,115,16560,28080
train,44,34,26112,590,84960,111072
train,45,17,13056,147,21168,34224
train,46,25,19200,319,45936,65136
train,47,29,22272,429,61776,84048
train,48,42,32256,900,129600,161856
train,49,17,13056,147,21168,34224
train,50,15,11520,115,16560,28080
train,51,31,23808,490,70560,94368
train,52,31,23808,490,70560,94368
train,53,29,22272,429,61776,84048
train,54,17,13056,147,21168,34224
train,55,26,19968,345,49680,69648
train,56,16,12288,131,18864,31152
train,57,3,2304,5,720,3024
train,58,34,26112,590,84960,111072
train,59,28,21504,400,57600,79104
train,60,6,4608,18,2592,7200
train,61,38,29184,737,106128,135312
train,62,23,17664,270,38880,56544
train,63,18,13824,165,23760,37584
train,64,3,2304,5,720,3024
train,65,18,13824,165,23760,37584
train,66,22,16896,247,35568,52464
train,67,23,17664,270,38880,56544
train,68,21,16128,225,32400,48528
train,69,44,33792,988,142272,176064
train,70,7,5376,25,3600,8976
train,71,16,12288,131,18864,31152
train,72,23,17664,270,38880,56544
train,73,36,27648,661,95184,122832
train,74,9,6912,41,5904,12816
train,75,21,16128,225,32400,48528
train,76,15,11520,115,16560,28080
train,77,37,28416,698,100512,128928
train,78,25,19200,319,45936,65136
train,79,32,24576,522,75168,99744
train,80,14,10752,100,14400,25152
train,81,12,9216,73,10512,19728
train,82,22,16896,247,35568,52464
train,83,10,7680,51,7344,15024
train,84,34,26112,590,84960,111072
train,85,23,17664,270,38880,56544
train,86,24,18432,294,42336,60768
train,87,32,24576,522,75168,99744
train,88,36,27648,661,95184,122832
train,89,11,8448,62,8928,17376
train,90,6,4608,18,2592,7200
train,91,35,26880,625,90000,116880
train,92,17,13056,147,21168,34224
train,93,17,13056,147,21168,34224
train,94,9,6912,41,5904,12816
train,95,21,16128,225,32400,48528
train,96,32,24576,522,75168,99744
train,97,16,12288,131,18864,31152
train,98,16,12288,131,18864,31152
train,99,29,22272,429,61776,84048
train,100,21,16128,225,32400,48528
train,101,29,22272,429,61776,84048
train,102,29,22272,429,61776,84048
train,103,51,39168,1327,191088,230256
train,104,20,15360,204,29376,44736
train,105,38,29184,737,106128,135312
train,106,18,13824,165,23760,37584
train,107,19,14592,184,26496,41088
train,108,22,16896,247,35568,52464
train,109,19,14592,184,26496,41088
train,110,17,13056,147,21168,34224
train,111,32,24576,522,75168,99744
train,112,33,25344,556,80064,105408
train,113,26,19968,345,49680,69648
train,114,16,12288,131,18864,31152
train,115,16,12288,131,18864,31152
train,116,5,3840,13,1872,5712
train,117,21,16128,225,32400,48528
train,118,11,8448,62,8928,17376
train,119,63,48384,2025,291600,339984
train,120,11,8448,62,8928,17376
train,121,23,17664,270,38880,56544
train,122,8,6144,33,4752,10896
train,123,28,21504,400,57600,79104
train,124,36,27648,661,95184,122832
train,125,32,24576,522,75168,99744
train,126,20,15360,204,29376,44736
train,127,34,26112,590,84960,111072
train,128,24,18432,294,42336,60768
train,129,28,21504,400,57600,79104
train,130,24,18432,294,42336,60768
train,131,39,29952,776,111744,141696
train,132,30,23040,459,66096,89136
train,133,39,29952,776,111744,141696
train,134,51,39168,1327,191088,230256
train,135,39,29952,776,111744,141696
train,136,16,12288,131,18864,31152
train,137,45,34560,1033,148752,183312
train,138,38,29184,737,106128,135312
train,139,14,10752,100,14400,25152
train,140,31,23808,490,70560,94368
train,141,7,5376,25,3600,8976
train,142,15,11520,115,16560,28080
train,143,16,12288,131,18864,31152
train,144,18,13824,165,23760,37584
train,145,26,19968,345,49680,69648
train,146,19,14592,184,26496,41088
train,147,24,18432,294,42336,60768
train,148,32,24576,522,75168,99744
train,149,12,9216,73,10512,19728
train,150,35,26880,625,90000,116880
train,151,13,9984,86,12384,22368
train,152,18,13824,165,23760,37584
train,153,26,19968,345,49680,69648
train,154,13,9984,86,12384,22368
train,155,11,8448,62,8928,17376
train,156,28,21504,400,57600,79104
train,157,27,20736,372,53568,74304
train,158,33,25344,556,80064,105408
train,159,7,5376,25,3600,8976
train,160,12,9216,73,10512,19728
train,161,26,19968,345,49680,69648
train,162,4,3072,8,1152,4224
train,163,7,5376,25,3600,8976
train,164,23,17664,270,38880,56544
train,165,12,9216,73,10512,19728
train,166,29,22272,429,61776,84048
train,167,7,5376,25,3600,8976
train,168,27,20736,372,53568,74304
train,169,19,14592,184,26496,41088
train,170,27,20736,372,53568,74304
train,171,36,27648,661,95184,122832
train,172,20,15360,204,29376,44736
train,173,11,8448,62,8928,17376
train,174,18,13824,165,23760,37584
train,175,33,25344,556,80064,105408
train,176,10,7680,51,7344,15024
train,177,31,23808,490,70560,94368
train,178,10,7680,51,7344,15024
train,179,32,24576,522,75168,99744
train,180,23,17664,270,38880,56544
train,181,42,32256,900,129600,161856
train,182,24,18432,294,42336,60768
train,183,16,12288,131,18864,31152
train,184,22,16896,247,35568,52464
train,185,21,16128,225,32400,48528
train,186,10,7680,51,7344,15024
train,187,21,16128,225,32400,48528
train,188,29,22272,429,61776,84048
train,189,43,33024,943,135792,168816
train,190,18,13824,165,23760,37584
train,191,10,7680,51,7344,15024
train,192,36,27648,661,95184,122832
train,193,17,13056,147,21168,34224
train,194,32,24576,522,75168,99744
train,195,29,22272,429,61776,84048
train,196,24,18432,294,42336,60768
train,197,11,8448,62,8928,17376
train,198,16,12288,131,18864,31152
train,199,15,11520,115,16560,28080
train,200,18,13824,165,23760,37584
train,201,32,24576,522,75168,99744
train,202,10,7680,51,7344,15024
train,203,20,15360,204,29376,44736
train,204,6,4608,18,2592,7200
train,205,21,16128,225,32400,48528
train,206,20,15360,204,29376,44736
train,207,39,29952,776,111744,141696
train,208,17,13056,147,21168,34224
train,209,20,15360,204,29376,44736
train,210,13,9984,86,12384,22368
train,211,38,29184,737,106128,135312
train,212,25,19200,319,45936,65136
train,213,31,23808,490,70560,94368
train,214,14,10752,100,14400,25152
train,215,26,19968,345,49680,69648
train,216,21,16128,225,32400,48528
train,217,29,22272,429,61776,84048
train,218,7,5376,25,3600,8976
train,219,26,19968,345,49680,69648
train,220,17,13056,147,21168,34224
train,221,31,23808,490,70560,94368
train,222,38,29184,737,106128,135312
train,223,28,21504,400,57600,79104
train,224,28,21504,400,57600,79104
train,225,6,4608,18,2592,7200
train,226,30,23040,459,66096,89136
train,227,31,23808,490,70560,94368
train,228,9,6912,41,5904,12816
train,229,53,40704,1433,206352,247056
train,230,24,18432,294,42336,60768
train,231,12,9216,73,10512,19728
train,232,17,13056,147,21168,34224
train,233,11,8448,62,8928,17376
train,234,8,6144,33,4752,10896
train,235,26,19968,345,49680,69648
train,236,15,11520,115,16560,28080
train,237,24,18432,294,42336,60768
train,238,18,13824,165,23760,37584
train,239,6,4608,18,2592,7200
train,240,36,27648,661,95184,122832
train,241,14,10752,100,14400,25152
train,242,12,9216,73,10512,19728
train,243,13,9984,86,12384,22368
train,244,6,4608,18,2592,7200
train,245,25,19200,319,45936,65136
train,246,32,24576,522,75168,99744
train,247,31,23808,490,70560,94368
train,248,10,7680,51,7344,15024
train,249,27,20736,372,53568,74304
train,250,33,25344,556,80064,105408
train,251,7,5376,25,3600,8976
train,252,25,19200,319,45936,65136
train,253,16,12288,131,18864,31152
train,254,28,21504,400,57600,79104
train,255,5,3840,13,1872,5712
train,256,22,16896,247,35568,52464
train,257,11,8448,62,8928,17376
train,258,34,26112,590,84960,111072
train,259,14,10752,100,14400,25152
train,260,22,16896,247,35568,52464
train,261,30,23040,459,66096,89136
train,262,41,31488,858,123552,155040
train,263,38,29184,737,106128,135312
train,264,7,5376,25,3600,8976
train,265,23,17664,270,38880,56544
train,266,16,12288,131,18864,31152
train,267,30,23040,459,66096,89136
train,268,21,16128,225,32400,48528
train,269,41,31488,858,123552,155040
train,270,33,25344,556,80064,105408
train,271,13,9984,86,12384,22368
train,272,23,17664,270,38880,56544
train,273,35,26880,625,90000,116880
train,274,27,20736,372,53568,74304
train,275,34,26112,590,84960,111072
train,276,34,26112,590,84960,111072
train,277,20,15360,204,29376,44736
train,278,30,23040,459,66096,89136
train,279,4,3072,8,1152,4224
train,280,10,7680,51,7344,15024
train,281,23,17664,270,38880,56544
train,282,18,13824,165,23760,37584
train,283,20,15360,204,29376,44736
train,284,18,13824,165,23760,37584
train,285,30,23040,459,66096,89136
train,286,9,6912,41,5904,12816
train,287,48,36864,1175,169200,206064
train,288,17,13056,147,21168,34224
train,289,24,18432,294,42336,60768
train,290,12,9216,73,10512,19728
train,291,39,29952,776,111744,141696
train,292,26,19968,345,49680,69648
train,293,49,37632,1225,176400,214032
train,294,17,13056,147,21168,34224
train,295,8,6144,33,4752,10896
train,296,42,32256,900,129600,161856
train,297,29,22272,429,61776,84048
train,298,19,14592,184,26496,41088
train,299,7,5376,25,3600,8976
train,300,28,21504,400,57600,79104
train,301,20,15360,204,29376,44736
train,302,21,16128,225,32400,48528
train,303,19,14592,184,26496,41088
train,304,9,6912,41,5904,12816
train,305,5,3840,13,1872,5712
train,306,7,5376,25,3600,8976
train,307,24,18432,294,42336,60768
train,308,18,13824,165,23760,37584
train,309,22,16896,247,35568,52464
train,310,13,9984,86,12384,22368
train,311,27,20736,372,53568,74304
train,312,39,29952,776,111744,141696
train,313,42,32256,900,129600,161856
train,314,10,7680,51,7344,15024
train,315,42,32256,900,129600,161856
train,316,22,16896,247,35568,52464
train,317,23,17664,270,38880,56544
train,318,7,5376,25,3600,8976
train,319,35,26880,625,90000,116880
train,320,28,21504,400,57600,79104
train,321,27,20736,372,53568,74304
train,322,16,12288,131,18864,31152
train,323,18,13824,165,23760,37584
train,324,30,23040,459,66096,89136
train,325,20,15360,204,29376,44736
train,326,24,18432,294,42336,60768
train,327,24,18432,294,42336,60768
train,328,41,31488,858,123552,155040
train,329,11,8448,62,8928,17376
train,330,35,26880,625,90000,116880
train,331,16,12288,131,18864,31152
train,332,26,19968,345,49680,69648
train,333,27,20736,372,53568,74304
train,334,39,29952,776,111744,141696
train,335,44,33792,988,142272,176064
train,336,22,16896,247,35568,52464
train,337,10,7680,51,7344,15024
train,338,33,25344,556,80064,105408
train,339,6,4608,18,2592,7200
train,340,18,13824,165,23760,37584
train,341,49,37632,1225,176400,214032
train,342,8,6144,33,4752,10896
train,343,5,3840,13,1872,5712
train,344,5,3840,13,1872,5712
train,345,34,26112,590,84960,111072
train,346,28,21504,400,57600,79104
train,347,18,13824,165,23760,37584
train,348,9,6912,41,5904,12816
train,349,9,6912,41,5904,12816
train,350,31,23808,490,70560,94368
train,351,18,13824,165,23760,37584
train,352,42,32256,900,129600,161856
train,353,12,9216,73,10512,19728
train,354,28,21504,400,57600,79104
train,355,22,16896,247,35568,52464
train,356,24,18432,294,42336,60768
train,357,26,19968,345,49680,69648
train,358,39,29952,776,111744,141696
train,359,16,12288,131,18864,31152
train,360,12,9216,73,10512,19728
train,361,24,18432,294,42336,60768
train,362,18,13824,165,23760,37584
train,363,21,16128,225,32400,48528
train,364,16,12288,131,18864,31152
train,365,22,16896,247,35568,52464
train,366,31,23808,490,70560,94368
train,367,19,14592,184,26496,41088
train,368,36,27648,661,95184,122832
train,369,54,41472,1488,214272,255744
train,370,44,33792,988,142272,176064
train,371,11,8448,62,8928,17376
train,372,32,24576,522,75168,99744
train,373,10,7680,51,7344,15024
train,374,14,10752,100,14400,25152
train,375,19,14592,184,26496,41088
train,376,24,18432,294,42336,60768
train,377,14,10752,100,14400,25152
train,378,13,9984,86,12384,22368
train,379,37,28416,698,100512,128928
train,380,20,15360,204,29376,44736
train,381,8,6144,33,4752,10896
train,382,11,8448,62,8928,17376
train,383,10,7680,51,7344,15024
train,384,14,10752,100,14400,25152
train,385,8,6144,33,4752,10896
train,386,13,9984,86,12384,22368
train,387,8,6144,33,4752,10896
train,388,24,18432,294,42336,60768
train,389,31,23808,490,70560,94368
train,390,23,17664,270,38880,56544
train,391,5,3840,13,1872,5712
train,392,19,14592,184,26496,41088
train,393,24,18432,294,42336,60768
train,394,11,8448,62,8928,17376
train,395,22,16896,247,35568,52464
train,396,46,35328,1079,155376,190704
train,397,13,9984,86,12384,22368
train,398,14,10752,100,14400,25152
train,399,35,26880,625,90000,116880
train,400,9,6912,41,5904,12816
train,401,45,34560,1033,148752,183312
train,402,24,18432,294,42336,60768
train,403,39,29952,776,111744,141696
train,404,50,38400,1275,183600,222000
train,405,44,33792,988,142272,176064
train,406,27,20736,372,53568,74304
train,407,12,9216,73,10512,19728
train,408,29,22272,429,61776,84048
train,409,15,11520,115,16560,28080
train,410,24,18432,294,42336,60768
train,411,9,6912,41,5904,12816
train,412,22,16896,247,35568,52464
train,413,27,20736,372,53568,74304
train,414,41,31488,858,123552,155040
train,415,9,6912,41,5904,12816
train,416,29,22272,429,61776,84048
train,417,17,13056,147,21168,34224
train,418,35,26880,625,90000,116880
train,419,16,12288,131,18864,31152
train,420,18,13824,165,23760,37584
train,421,29,22272,429,61776,84048
train,422,10,7680,51,7344,15024
train,423,15,11520,115,16560,28080
train,424,29,22272,429,61776,84048
train,425,11,8448,62,8928,17376
train,426,24,18432,294,42336,60768
train,427,23,17664,270,38880,56544
train,428,26,19968,345,49680,69648
train,429,30,23040,459,66096,89136
train,430,17,13056,147,21168,34224
train,431,29,22272,429,61776,84048
train,432,29,22272,429,61776,84048
train,433,18,13824,165,23760,37584
train,434,36,27648,661,95184,122832
train,435,22,16896,247,35568,52464
train,436,35,26880,625,90000,116880
train,437,20,15360,204,29376,44736
train,438,14,10752,100,14400,25152
train,439,14,10752,100,14400,25152
train,440,12,9216,73,10512,19728
train,441,36,27648,661,95184,122832
train,442,41,31488,858,123552,155040
train,443,15,11520,115,16560,28080
train,444,16,12288,131,18864,31152
train,445,35,26880,625,90000,116880
train,446,16,12288,131,18864,31152
train,447,38,29184,737,106128,135312
train,448,23,17664,270,38880,56544
train,449,31,23808,490,70560,94368
train,450,34,26112,590,84960,111072
train,451,21,16128,225,32400,48528
train,452,8,6144,33,4752,10896
train,453,14,10752,100,14400,25152
train,454,8,6144,33,4752,10896
train,455,12,9216,73,10512,19728
train,456,45,34560,1033,148752,183312
train,457,37,28416,698,100512,128928
train,458,5,3840,13,1872,5712
train,459,29,22272,429,61776,84048
train,460,11,8448,62,8928,17376
train,461,32,24576,522,75168,99744
train,462,47,36096,1127,162288,198384
train,463,23,17664,270,38880,56544
train,464,20,15360,204,29376,44736
train,465,34,26112,590,84960,111072
train,466,25,19200,319,45936,65136
train,467,30,23040,459,66096,89136
train,468,32,24576,522,75168,99744
train,469,16,12288,131,18864,31152
train,470,23,17664,270,38880,56544
train,471,29,22272,429,61776,84048
train,472,29,22272,429,61776,84048
train,473,17,13056,147,21168,34224
train,474,33,25344,556,80064,105408
train,475,26,19968,345,49680,69648
train,476,34,26112,590,84960,111072
train,477,51,39168,1327,191088,230256
train,478,16,12288,131,18864,31152
train,479,23,17664,270,38880,56544
train,480,30,23040,459,66096,89136
train,481,32,24576,522,75168,99744
train,482,5,3840,13,1872,5712
train,483,12,9216,73,10512,19728
train,484,45,34560,1033,148752,183312
train,485,17,13056,147,21168,34224
train,486,25,19200,319,45936,65136
train,487,15,11520,115,16560,28080
train,488,29,22272,429,61776,84048
train,489,38,29184,737,106128,135312
train,490,14,10752,100,14400,25152
train,491,31,23808,490,70560,94368
train,492,9,6912,41,5904,12816
train,493,25,19200,319,45936,65136
train,494,7,5376,25,3600,8976
train,495,18,13824,165,23760,37584
train,496,16,12288,131,18864,31152
train,497,20,15360,204,29376,44736
train,498,35,26880,625,90000,116880
train,499,17,13056,147,21168,34224
train,500,26,19968,345,49680,69648
train,501,8,6144,33,4752,10896
train,502,30,23040,459,66096,89136
train,503,46,35328,1079,155376,190704
train,504,38,29184,737,106128,135312
train,505,24,18432,294,42336,60768
train,506,23,17664,270,38880,56544
train,507,33,25344,556,80064,105408
train,508,29,22272,429,61776,84048
train,509,31,23808,490,70560,94368
train,510,33,25344,556,80064,105408
train,511,18,13824,165,23760,37584
train,512,11,8448,62,8928,17376
train,513,22,16896,247,35568,52464
train,514,17,13056,147,21168,34224
train,515,15,11520,115,16560,28080
train,516,32,24576,522,75168,99744
train,517,22,16896,247,35568,52464
train,518,16,12288,131,18864,31152
train,519,14,10752,100,14400,25152
train,520,43,33024,943,135792,168816
train,521,20,15360,204,29376,44736
train,522,7,5376,25,3600,8976
train,523,10,7680,51,7344,15024
train,524,16,12288,131,18864,31152
train,525,9,6912,41,5904,12816
train,526,30,23040,459,66096,89136
train,527,30,23040,459,66096,89136
train,528,15,11520,115,16560,28080
train,529,22,16896,247,35568,52464
train,530,19,14592,184,26496,41088
train,531,23,17664,270,38880,56544
train,532,17,13056,147,21168,34224
train,533,27,20736,372,53568,74304
train,534,27,20736,372,53568,74304
train,535,21,16128,225,32400,48528
train,536,51,39168,1327,191088,230256
train,537,23,17664,270,38880,56544
train,538,9,6912,41,5904,12816
train,539,26,19968,345,49680,69648
train,540,17,13056,147,21168,34224
train,541,26,19968,345,49680,69648
train,542,5,3840,13,1872,5712
train,543,16,12288,131,18864,31152
train,544,37,28416,698,100512,128928
train,545,45,34560,1033,148752,183312
train,546,28,21504,400,57600,79104
train,547,37,28416,698,100512,128928
train,548,23,17664,270,38880,56544
train,549,13,9984,86,12384,22368
train,550,15,11520,115,16560,28080
train,551,37,28416,698,100512,128928
train,552,15,11520,115,16560,28080
train,553,25,19200,319,45936,65136
train,554,23,17664,270,38880,56544
train,555,6,4608,18,2592,7200
train,556,25,19200,319,45936,65136
train,557,14,10752,100,14400,25152
train,558,30,23040,459,66096,89136
train,559,33,25344,556,80064,105408
train,560,14,10752,100,14400,25152
train,561,18,13824,165,23760,37584
train,562,8,6144,33,4752,10896
train,563,19,14592,184,26496,41088
train,564,34,26112,590,84960,111072
train,565,38,29184,737,106128,135312
train,566,45,34560,1033,148752,183312
train,567,26,19968,345,49680,69648
train,568,12,9216,73,10512,19728
train,569,11,8448,62,8928,17376
train,570,9,6912,41,5904,12816
train,571,20,15360,204,29376,44736
train,572,22,16896,247,35568,52464
train,573,38,29184,737,106128,135312
train,574,10,7680,51,7344,15024
train,575,37,28416,698,100512,128928
train,576,27,20736,372,53568,74304
train,577,34,26112,590,84960,111072
train,578,21,16128,225,32400,48528
train,579,16,12288,131,18864,31152
train,580,16,12288,131,18864,31152
train,581,26,19968,345,49680,69648
train,582,25,19200,319,45936,65136
train,583,15,11520,115,16560,28080
train,584,28,21504,400,57600,79104
train,585,27,20736,372,53568,74304
train,586,17,13056,147,21168,34224
train,587,21,16128,225,32400,48528
train,588,22,16896,247,35568,52464
train,589,50,38400,1275,183600,222000
train,590,26,19968,345,49680,69648
train,591,27,20736,372,53568,74304
train,592,26,19968,345,49680,69648
train,593,17,13056,147,21168,34224
train,594,32,24576,522,75168,99744
train,595,51,39168,1327,191088,230256
train,596,14,10752,100,14400,25152
train,597,7,5376,25,3600,8976
train,598,33,25344,556,80064,105408
train,599,24,18432,294,42336,60768
train,600,23,17664,270,38880,56544
train,601,26,19968,345,49680,69648
train,602,7,5376,25,3600,8976
train,603,20,15360,204,29376,44736
train,604,7,5376,25,3600,8976
train,605,19,14592,184,26496,41088
train,606,11,8448,62,8928,17376
train,607,20,15360,204,29376,44736
train,608,22,16896,247,35568,52464
train,609,18,13824,165,23760,37584
train,610,13,9984,86,12384,22368
train,611,32,24576,522,75168,99744
train,612,9,6912,41,5904,12816
train,613,36,27648,661,95184,122832
train,614,11,8448,62,8928,17376
train,615,39,29952,776,111744,141696
train,616,28,21504,400,57600,79104
train,617,9,6912,41,5904,12816
train,618,41,31488,858,123552,155040
train,619,12,9216,73,10512,19728
train,620,37,28416,698,100512,128928
train,621,3,2304,5,720,3024
train,622,44,33792,988,142272,176064
train,623,11,8448,62,8928,17376
train,624,21,16128,225,32400,48528
train,625,22,16896,247,35568,52464
train,626,31,23808,490,70560,94368
train,627,34,26112,590,84960,111072
train,628,38,29184,737,106128,135312
train,629,11,8448,62,8928,17376
train,630,4,3072,8,1152,4224
train,631,44,33792,988,142272,176064
train,632,22,16896,247,35568,52464
train,633,23,17664,270,38880,56544
train,634,25,19200,319,45936,65136
train,635,7,5376,25,3600,8976
train,636,20,15360,204,29376,44736
train,637,18,13824,165,23760,37584
train,638,26,19968,345,49680,69648
train,639,21,16128,225,32400,48528
train,640,28,21504,400,57600,79104
train,641,54,41472,1488,214272,255744
train,642,36,27648,661,95184,122832
train,643,51,39168,1327,191088,230256
train,644,34,26112,590,84960,111072
train,645,33,25344,556,80064,105408
train,646,17,13056,147,21168,34224
train,647,15,11520,115,16560,28080
train,648,22,16896,247,35568,52464
train,649,19,14592,184,26496,41088
train,650,16,12288,131,18864,31152
train,651,43,33024,943,135792,168816
train,652,17,13056,147,21168,34224
train,653,21,16128,225,32400,48528
train,654,13,9984,86,12384,22368
train,655,29,22272,429,61776,84048
train,656,13,9984,86,12384,22368
train,657,23,17664,270,38880,56544
train,658,27,20736,372,53568,74304
train,659,4,3072,8,1152,4224
train,660,26,19968,345,49680,69648
train,661,19,14592,184,26496,41088
train,662,24,18432,294,42336,60768
train,663,2,1536,2,288,1824
train,664,14,10752,100,14400,25152
train,665,12,9216,73,10512,19728
train,666,17,13056,147,21168,34224
train,667,21,16128,225,32400,48528
train,668,8,6144,33,4752,10896
train,669,12,9216,73,10512,19728
train,670,36,27648,661,95184,122832
train,671,15,11520,115,16560,28080
train,672,17,13056,147,21168,34224
train,673,8,6144,33,4752,10896
train,674,17,13056,147,21168,34224
train,675,18,13824,165,23760,37584
train,676,41,31488,858,123552,155040
train,677,23,17664,270,38880,56544
train,678,17,13056,147,21168,34224
train,679,6,4608,18,2592,7200
train,680,12,9216,73,10512,19728
train,681,12,9216,73,10512,19728
train,682,8,6144,33,4752,10896
train,683,20,15360,204,29376,44736
train,684,18,13824,165,23760,37584
train,685,9,6912,41,5904,12816
train,686,7,5376,25,3600,8976
train,687,15,11520,115,16560,28080
train,688,13,9984,86,12384,22368
train,689,23,17664,270,38880,56544
train,690,11,8448,62,8928,17376
train,691,5,3840,13,1872,5712
train,692,12,9216,73,10512,19728
train,693,28,21504,400,57600,79104
train,694,8,6144,33,4752,10896
train,695,60,46080,1837,264528,310608
train,696,31,23808,490,70560,94368
train,697,30,23040,459,66096,89136
train,698,13,9984,86,12384,22368
train,699,14,10752,100,14400,25152
train,700,44,33792,988,142272,176064
train,701,15,11520,115,16560,28080
train,702,12,9216,73,10512,19728
train,703,17,13056,147,21168,34224
train,704,25,19200,319,45936,65136
train,705,25,19200,319,45936,65136
train,706,12,9216,73,10512,19728
train,707,33,25344,556,80064,105408
train,708,23,17664,270,38880,56544
train,709,19,14592,184,26496,41088
train,710,34,26112,590,84960,111072
train,711,25,19200,319,45936,65136
train,712,14,10752,100,14400,25152
train,713,22,16896,247,35568,52464
train,714,49,37632,1225,176400,214032
train,715,23,17664,270,38880,56544
train,716,31,23808,490,70560,94368
train,717,19,14592,184,26496,41088
train,718,39,29952,776,111744,141696
train,719,33,25344,556,80064,105408
train,720,16,12288,131,18864,31152
train,721,36,27648,661,95184,122832
train,722,12,9216,73,10512,19728
train,723,39,29952,776,111744,141696
train,724,20,15360,204,29376,44736
train,725,16,12288,131,18864,31152
train,726,24,18432,294,42336,60768
train,727,6,4608,18,2592,7200
train,728,31,23808,490,70560,94368
train,729,32,24576,522,75168,99744
train,730,23,17664,270,38880,56544
train,731,19,14592,184,26496,41088
train,732,40,30720,816,117504,148224
train,733,31,23808,490,70560,94368
train,734,30,23040,459,66096,89136
train,735,38,29184,737,106128,135312
train,736,33,25344,556,80064,105408
train,737,4,3072,8,1152,4224
train,738,18,13824,165,23760,37584
train,739,13,9984,86,12384,22368
train,740,28,21504,400,57600,79104
train,741,12,9216,73,10512,19728
train,742,15,11520,115,16560,28080
train,743,16,12288,131,18864,31152
train,744,4,3072,8,1152,4224
train,745,12,9216,73,10512,19728
train,746,27,20736,372,53568,74304
train,747,35,26880,625,90000,116880
train,748,17,13056,147,21168,34224
train,749,18,13824,165,23760,37584
train,750,25,19200,319,45936,65136
train,751,25,19200,319,45936,65136
train,752,11,8448,62,8928,17376
train,753,24,18432,294,42336,60768
train,754,20,15360,204,29376,44736
train,755,26,19968,345,49680,69648
train,756,30,23040,459,66096,89136
train,757,18,13824,165,23760,37584
train,758,10,7680,51,7344,15024
train,759,26,19968,345,49680,69648
train,760,6,4608,18,2592,7200
train,761,27,20736,372,53568,74304
train,762,19,14592,184,26496,41088
train,763,39,29952,776,111744,141696
train,764,26,19968,345,49680,69648
train,765,27,20736,372,53568,74304
train,766,16,12288,131,18864,31152
train,767,15,11520,115,16560,28080
train,768,40,30720,816,117504,148224
train,769,23,17664,270,38880,56544
train,770,27,20736,372,53568,74304
train,771,12,9216,73,10512,19728
train,772,24,18432,294,42336,60768
train,773,27,20736,372,53568,74304
train,774,34,26112,590,84960,111072
train,775,24,18432,294,42336,60768
train,776,47,36096,1127,162288,198384
train,777,36,27648,661,95184,122832
train,778,41,31488,858,123552,155040
train,779,39,29952,776,111744,141696
train,780,35,26880,625,90000,116880
train,781,42,32256,900,129600,161856
train,782,32,24576,522,75168,99744
train,783,25,19200,319,45936,65136
train,784,14,10752,100,14400,25152
train,785,11,8448,62,8928,17376
train,786,14,10752,100,14400,25152
train,787,31,23808,490,70560,94368
train,788,52,39936,1379,198576,238512
train,789,8,6144,33,4752,10896
train,790,25,19200,319,45936,65136
train,791,11,8448,62,8928,17376
train,792,12,9216,73,10512,19728
train,793,28,21504,400,57600,79104
train,794,10,7680,51,7344,15024
train,795,39,29952,776,111744,141696
train,796,40,30720,816,117504,148224
train,797,8,6144,33,4752,10896
train,798,16,12288,131,18864,31152
train,799,19,14592,184,26496,41088
train,800,36,27648,661,95184,122832
train,801,18,13824,165,23760,37584
train,802,9,6912,41,5904,12816
train,803,25,19200,319,45936,65136
train,804,14,10752,100,14400,25152
train,805,25,19200,319,45936,65136
train,806,39,29952,776,111744,141696
train,807,35,26880,625,90000,116880
train,808,30,23040,459,66096,89136
train,809,5,3840,13,1872,5712
train,810,18,13824,165,23760,37584
train,811,11,8448,62,8928,17376
train,812,27,20736,372,53568,74304
train,813,37,28416,698,100512,128928
train,814,49,37632,1225,176400,214032
train,815,43,33024,943,135792,168816
train,816,19,14592,184,26496,41088
train,817,38,29184,737,106128,135312
train,818,30,23040,459,66096,89136
train,819,19,14592,184,26496,41088
train,820,18,13824,165,23760,37584
train,821,21,16128,225,32400,48528
train,822,22,16896,247,35568,52464
train,823,16,12288,131,18864,31152
train,824,29,22272,429,61776,84048
train,825,41,31488,858,123552,155040
train,826,8,6144,33,4752,10896
train,827,40,30720,816,117504,148224
train,828,16,12288,131,18864,31152
train,829,27,20736,372,53568,74304
train,830,44,33792,988,142272,176064
train,831,25,19200,319,45936,65136
train,832,42,32256,900,129600,161856
train,833,11,8448,62,8928,17376
train,834,29,22272,429,61776,84048
train,835,21,16128,225,32400,48528
train,836,39,29952,776,111744,141696
train,837,18,13824,165,23760,37584
train,838,23,17664,270,38880,56544
train,839,27,20736,372,53568,74304
train,840,39,29952,776,111744,141696
train,841,30,23040,459,66096,89136
train,842,10,7680,51,7344,15024
train,843,12,9216,73,10512,19728
train,844,36,27648,661,95184,122832
train,845,7,5376,25,3600,8976
train,846,54,41472,1488,214272,255744
train,847,27,20736,372,53568,74304
train,848,16,12288,131,18864,31152
train,849,17,13056,147,21168,34224
train,850,19,14592,184,26496,41088
train,851,9,6912,41,5904,12816
train,852,38,29184,737,106128,135312
train,853,14,10752,100,14400,25152
train,854,24,18432,294,42336,60768
train,855,14,10752,100,14400,25152
train,856,23,17664,270,38880,56544
train,857,53,40704,1433,206352,247056
train,858,34,26112,590,84960,111072
train,859,35,26880,625,90000,116880
train,860,6,4608,18,2592,7200
train,861,37,28416,698,100512,128928
train,862,19,14592,184,26496,41088
train,863,9,6912,41,5904,12816
train,864,41,31488,858,123552,155040
train,865,19,14592,184,26496,41088
train,866,36,27648,661,95184,122832
train,867,15,11520,115,16560,28080
train,868,20,15360,204,29376,44736
train,869,34,26112,590,84960,111072
train,870,18,13824,165,23760,37584
train,871,23,17664,270,38880,56544
train,872,26,19968,345,49680,69648
train,873,18,13824,165,23760,37584
train,874,20,15360,204,29376,44736
train,875,43,33024,943,135792,168816
train,876,11,8448,62,8928,17376
train,877,32,24576,522,75168,99744
train,878,26,19968,345,49680,69648
train,879,22,16896,247,35568,52464
train,880,12,9216,73,10512,19728
train,881,12,9216,73,10512,19728
train,882,26,19968,345,49680,69648
train,883,15,11520,115,16560,28080
train,884,7,5376,25,3600,8976
train,885,8,6144,33,4752,10896
train,886,19,14592,184,26496,41088
train,887,20,15360,204,29376,44736
train,888,14,10752,100,14400,25152
train,889,20,15360,204,29376,44736
train,890,27,20736,372,53568,74304
train,891,7,5376,25,3600,8976
train,892,26,19968,345,49680,69648
train,893,21,16128,225,32400,48528
train,894,13,9984,86,12384,22368
train,895,39,29952,776,111744,141696
train,896,35,26880,625,90000,116880
train,897,20,15360,204,29376,44736
train,898,28,21504,400,57600,79104
train,899,18,13824,165,23760,37584
train,900,25,19200,319,45936,65136
train,901,22,16896,247,35568,52464
train,902,18,13824,165,23760,37584
train,903,20,15360,204,29376,44736
train,904,26,19968,345,49680,69648
train,905,9,6912,41,5904,12816
train,906,52,39936,1379,198576,238512
train,907,29,22272,429,61776,84048
train,908,26,19968,345,49680,69648
train,909,9,6912,41,5904,12816
train,910,8,6144,33,4752,10896
train,911,26,19968,345,49680,69648
train,912,17,13056,147,21168,34224
train,913,36,27648,661,95184,122832
train,914,9,6912,41,5904,12816
train,915,17,13056,147,21168,34224
train,916,26,19968,345,49680,69648
train,917,25,19200,319,45936,65136
train,918,12,9216,73,10512,19728
train,919,43,33024,943,135792,168816
train,920,13,9984,86,12384,22368
train,921,34,26112,590,84960,111072
train,922,29,22272,429,61776,84048
train,923,10,7680,51,7344,15024
train,924,25,19200,319,45936,65136
train,925,14,10752,100,14400,25152
train,926,17,13056,147,21168,34224
train,927,25,19200,319,45936,65136
train,928,9,6912,41,5904,12816
train,929,33,25344,556,80064,105408
train,930,8,6144,33,4752,10896
train,931,28,21504,400,57600,79104
train,932,10,7680,51,7344,15024
train,933,35,26880,625,90000,116880
train,934,15,11520,115,16560,28080
train,935,31,23808,490,70560,94368
train,936,15,11520,115,16560,28080
train,937,22,16896,247,35568,52464
train,938,22,16896,247,35568,52464
train,939,8,6144,33,4752,10896
train,940,26,19968,345,49680,69648
train,941,27,20736,372,53568,74304
train,942,5,3840,13,1872,5712
train,943,9,6912,41,5904,12816
train,944,19,14592,184,26496,41088
train,945,7,5376,25,3600,8976
train,946,19,14592,184,26496,41088
train,947,20,15360,204,29376,44736
train,948,26,19968,345,49680,69648
train,949,24,18432,294,42336,60768
train,950,21,16128,225,32400,48528
train,951,10,7680,51,7344,15024
train,952,24,18432,294,42336,60768
train,953,14,10752,100,14400,25152
train,954,16,12288,131,18864,31152
train,955,42,32256,900,129600,161856
train,956,9,6912,41,5904,12816
train,957,6,4608,18,2592,7200
train,958,19,14592,184,26496,41088
train,959,25,19200,319,45936,65136
train,960,32,24576,522,75168,99744
train,961,10,7680,51,7344,15024
train,962,32,24576,522,75168,99744
train,963,10,7680,51,7344,15024
train,964,41,31488,858,123552,155040
train,965,8,6144,33,4752,10896
train,966,24,18432,294,42336,60768
train,967,23,17664,270,38880,56544
train,968,32,24576,522,75168,99744
train,969,9,6912,41,5904,12816
train,970,52,39936,1379,198576,238512
train,971,22,16896,247,35568,52464
train,972,47,36096,1127,162288,198384
train,973,32,24576,522,75168,99744
train,974,29,22272,429,61776,84048
train,975,43,33024,943,135792,168816
train,976,26,19968,345,49680,69648
train,977,14,10752,100,14400,25152
train,978,10,7680,51,7344,15024
train,979,31,23808,490,70560,94368
train,980,19,14592,184,26496,41088
train,981,11,8448,62,8928,17376
train,982,33,25344,556,80064,105408
train,983,3,2304,5,720,3024
train,984,25,19200,319,45936,65136
train,985,31,23808,490,70560,94368
train,986,38,29184,737,106128,135312
train,987,42,32256,900,129600,161856
train,988,27,20736,372,53568,74304
train,989,20,15360,204,29376,44736
train,990,21,16128,225,32400,48528
train,991,22,16896,247,35568,52464
train,992,45,34560,1033,148752,183312
train,993,4,3072,8,1152,4224
train,994,14,10752,100,14400,25152
train,995,36,27648,661,95184,122832
train,996,15,11520,115,16560,28080
train,997,26,19968,345,49680,69648
train,998,34,26112,590,84960,111072
train,999,36,27648,661,95184,122832
train,1000,38,29184,737,106128,135312
train,1001,17,13056,147,21168,34224
train,1002,17,13056,147,21168,34224
train,1003,39,29952,776,111744,141696
train,1004,32,24576,522,75168,99744
train,1005,15,11520,115,16560,28080
train,1006,34,26112,590,84960,111072
train,1007,25,19200,319,45936,65136
train,1008,37,28416,698,100512,128928
train,1009,34,26112,590,84960,111072
train,1010,24,18432,294,42336,60768
train,1011,28,21504,400,57600,79104
train,1012,9,6912,41,5904,12816
train,1013,18,13824,165,23760,37584
train,1014,35,26880,625,90000,116880
train,1015,16,12288,131,18864,31152
train,1016,35,26880,625,90000,116880
train,1017,30,23040,459,66096,89136
train,1018,39,29952,776,111744,141696
train,1019,20,15360,204,29376,44736
train,1020,32,24576,522,75168,99744
train,1021,12,9216,73,10512,19728
train,1022,9,6912,41,5904,12816
train,1023,20,15360,204,29376,44736
train,1024,16,12288,131,18864,31152
train,1025,25,19200,319,45936,65136
train,1026,31,23808,490,70560,94368
train,1027,38,29184,737,106128,135312
train,1028,7,5376,25,3600,8976
train,1029,26,19968,345,49680,69648
train,1030,13,9984,86,12384,22368
train,1031,27,20736,372,53568,74304
train,1032,29,22272,429,61776,84048
train,1033,24,18432,294,42336,60768
train,1034,10,7680,51,7344,15024
train,1035,36,27648,661,95184,122832
train,1036,20,15360,204,29376,44736
train,1037,27,20736,372,53568,74304
train,1038,27,20736,372,53568,74304
train,1039,23,17664,270,38880,56544
train,1040,25,19200,319,45936,65136
train,1041,38,29184,737,106128,135312
train,1042,28,21504,400,57600,79104
train,1043,23,17664,270,38880,56544
train,1044,18,13824,165,23760,37584
train,1045,13,9984,86,12384,22368
train,1046,23,17664,270,38880,56544
train,1047,17,13056,147,21168,34224
train,1048,11,8448,62,8928,17376
train,1049,23,17664,270,38880,56544
train,1050,39,29952,776,111744,141696
train,1051,23,17664,270,38880,56544
train,1052,15,11520,115,16560,28080
train,1053,30,23040,459,66096,89136
train,1054,18,13824,165,23760,37584
train,1055,19,14592,184,26496,41088
train,1056,20,15360,204,29376,44736
train,1057,18,13824,165,23760,37584
train,1058,14,10752,100,14400,25152
train,1059,8,6144,33,4752,10896
train,1060,25,19200,319,45936,65136
train,1061,16,12288,131,18864,31152
train,1062,28,21504,400,57600,79104
train,1063,23,17664,270,38880,56544
train,1064,39,29952,776,111744,141696
train,1065,18,13824,165,23760,37584
train,1066,22,16896,247,35568,52464
train,1067,37,28416,698,100512,128928
train,1068,20,15360,204,29376,44736
train,1069,29,22272,429,61776,84048
train,1070,2,1536,2,288,1824
train,1071,23,17664,270,38880,56544
train,1072,22,16896,247,35568,52464
train,1073,33,25344,556,80064,105408
train,1074,12,9216,73,10512,19728
train,1075,35,26880,625,90000,116880
train,1076,33,25344,556,80064,105408
train,1077,12,9216,73,10512,19728
train,1078,9,6912,41,5904,12816
train,1079,40,30720,816,117504,148224
train,1080,14,10752,100,14400,25152
train,1081,19,14592,184,26496,41088
train,1082,10,7680,51,7344,15024
train,1083,7,5376,25,3600,8976
train,1084,18,13824,165,23760,37584
train,1085,29,22272,429,61776,84048
train,1086,16,12288,131,18864,31152
train,1087,20,15360,204,29376,44736
train,1088,11,8448,62,8928,17376
train,1089,26,19968,345,49680,69648
train,1090,31,23808,490,70560,94368
train,1091,36,27648,661,95184,122832
train,1092,30,23040,459,66096,89136
train,1093,12,9216,73,10512,19728
train,1094,16,12288,131,18864,31152
train,1095,22,16896,247,35568,52464
train,1096,46,35328,1079,155376,190704
train,1097,31,23808,490,70560,94368
train,1098,28,21504,400,57600,79104
train,1099,35,26880,625,90000,116880
train,1100,22,16896,247,35568,52464
train,1101,25,19200,319,45936,65136
train,1102,32,24576,522,75168,99744
train,1103,13,9984,86,12384,22368
train,1104,31,23808,490,70560,94368
train,1105,28,21504,400,57600,79104
train,1106,18,13824,165,23760,37584
train,1107,4,3072,8,1152,4224
train,1108,20,15360,204,29376,44736
train,1109,10,7680,51,7344,15024
train,1110,11,8448,62,8928,17376
train,1111,41,31488,858,123552,155040
train,1112,19,14592,184,26496,41088
train,1113,16,12288,131,18864,31152
train,1114,46,35328,1079,155376,190704
train,1115,42,32256,900,129600,161856
train,1116,9,6912,41,5904,12816
train,1117,34,26112,590,84960,111072
train,1118,54,41472,1488,214272,255744
train,1119,11,8448,62,8928,17376
train,1120,18,13824,165,23760,37584
train,1121,24,18432,294,42336,60768
train,1122,24,18432,294,42336,60768
train,1123,12,9216,73,10512,19728
train,1124,14,10752,100,14400,25152
train,1125,23,17664,270,38880,56544
train,1126,17,13056,147,21168,34224
train,1127,46,35328,1079,155376,190704
train,1128,31,23808,490,70560,94368
train,1129,19,14592,184,26496,41088
train,1130,12,9216,73,10512,19728
train,1131,45,34560,1033,148752,183312
train,1132,11,8448,62,8928,17376
train,1133,39,29952,776,111744,141696
train,1134,34,26112,590,84960,111072
train,1135,26,19968,345,49680,69648
train,1136,34,26112,590,84960,111072
train,1137,24,18432,294,42336,60768
train,1138,26,19968,345,49680,69648
train,1139,35,26880,625,90000,116880
train,1140,15,11520,115,16560,28080
train,1141,7,5376,25,3600,8976
train,1142,13,9984,86,12384,22368
train,1143,6,4608,18,2592,7200
train,1144,8,6144,33,4752,10896
train,1145,18,13824,165,23760,37584
train,1146,41,31488,858,123552,155040
train,1147,16,12288,131,18864,31152
train,1148,4,3072,8,1152,4224
train,1149,34,26112,590,84960,111072
train,1150,6,4608,18,2592,7200
train,1151,17,13056,147,21168,34224
train,1152,10,7680,51,7344,15024
train,1153,20,15360,204,29376,44736
train,1154,20,15360,204,29376,44736
train,1155,20,15360,204,29376,44736
train,1156,47,36096,1127,162288,198384
train,1157,10,7680,51,7344,15024
train,1158,37,28416,698,100512,128928
train,1159,21,16128,225,32400,48528
train,1160,13,9984,86,12384,22368
train,1161,26,19968,345,49680,69648
train,1162,40,30720,816,117504,148224
train,1163,24,18432,294,42336,60768
train,1164,16,12288,131,18864,31152
train,1165,23,17664,270,38880,56544
train,1166,18,13824,165,23760,37584
train,1167,27,20736,372,53568,74304
train,1168,10,7680,51,7344,15024
train,1169,30,23040,459,66096,89136
train,1170,38,29184,737,106128,135312
train,1171,17,13056,147,21168,34224
train,1172,36,27648,661,95184,122832
train,1173,18,13824,165,23760,37584
train,1174,14,10752,100,14400,25152
train,1175,10,7680,51,7344,15024
train,1176,22,16896,247,35568,52464
train,1177,10,7680,51,7344,15024
train,1178,17,13056,147,21168,34224
train,1179,9,6912,41,5904,12816
train,1180,30,23040,459,66096,89136
train,1181,9,6912,41,5904,12816
train,1182,7,5376,25,3600,8976
train,1183,14,10752,100,14400,25152
train,1184,27,20736,372,53568,74304
train,1185,13,9984,86,12384,22368
train,1186,14,10752,100,14400,25152
train,1187,21,16128,225,32400,48528
train,1188,28,21504,400,57600,79104
train,1189,37,28416,698,100512,128928
train,1190,21,16128,225,32400,48528
train,1191,22,16896,247,35568,52464
train,1192,43,33024,943,135792,168816
train,1193,19,14592,184,26496,41088
train,1194,18,13824,165,23760,37584
train,1195,13,9984,86,12384,22368
train,1196,29,22272,429,61776,84048
train,1197,17,13056,147,21168,34224
train,1198,6,4608,18,2592,7200
train,1199,31,23808,490,70560,94368
train,1200,39,29952,776,111744,141696
train,1201,13,9984,86,12384,22368
train,1202,7,5376,25,3600,8976
train,1203,32,24576,522,75168,99744
train,1204,38,29184,737,106128,135312
train,1205,28,21504,400,57600,79104
train,1206,22,16896,247,35568,52464
train,1207,13,9984,86,12384,22368
train,1208,15,11520,115,16560,28080
train,1209,15,11520,115,16560,28080
train,1210,38,29184,737,106128,135312
train,1211,27,20736,372,53568,74304
train,1212,11,8448,62,8928,17376
train,1213,34,26112,590,84960,111072
train,1214,10,7680,51,7344,15024
train,1215,31,23808,490,70560,94368
train,1216,11,8448,62,8928,17376
train,1217,7,5376,25,3600,8976
train,1218,15,11520,115,16560,28080
train,1219,23,17664,270,38880,56544
train,1220,17,13056,147,21168,34224
train,1221,32,24576,522,75168,99744
train,1222,11,8448,62,8928,17376
train,1223,11,8448,62,8928,17376
train,1224,21,16128,225,32400,48528
train,1225,20,15360,204,29376,44736
train,1226,14,10752,100,14400,25152
train,1227,22,16896,247,35568,52464
train,1228,46,35328,1079,155376,190704
train,1229,42,32256,900,129600,161856
train,1230,9,6912,41,5904,12816
train,1231,6,4608,18,2592,7200
train,1232,12,9216,73,10512,19728
train,1233,14,10752,100,14400,25152
train,1234,35,26880,625,90000,116880
train,1235,35,26880,625,90000,116880
train,1236,26,19968,345,49680,69648
train,1237,27,20736,372,53568,74304
train,1238,16,12288,131,18864,31152
train,1239,61,46848,1898,273312,320160
train,1240,14,10752,100,14400,25152
train,1241,6,4608,18,2592,7200
train,1242,23,17664,270,38880,56544
train,1243,24,18432,294,42336,60768
train,1244,38,29184,737,106128,135312
train,1245,16,12288,131,18864,31152
train,1246,16,12288,131,18864,31152
train,1247,34,26112,590,84960,111072
train,1248,24,18432,294,42336,60768
train,1249,5,3840,13,1872,5712
train,1250,4,3072,8,1152,4224
train,1251,8,6144,33,4752,10896
train,1252,15,11520,115,16560,28080
train,1253,15,11520,115,16560,28080
train,1254,26,19968,345,49680,69648
train,1255,11,8448,62,8928,17376
train,1256,18,13824,165,23760,37584
train,1257,25,19200,319,45936,65136
train,1258,30,23040,459,66096,89136
train,1259,6,4608,18,2592,7200
train,1260,13,9984,86,12384,22368
train,1261,21,16128,225,32400,48528
train,1262,7,5376,25,3600,8976
train,1263,41,31488,858,123552,155040
train,1264,28,21504,400,57600,79104
train,1265,32,24576,522,75168,99744
train,1266,12,9216,73,10512,19728
train,1267,31,23808,490,70560,94368
train,1268,27,20736,372,53568,74304
train,1269,12,9216,73,10512,19728
train,1270,26,19968,345,49680,69648
train,1271,35,26880,625,90000,116880
train,1272,30,23040,459,66096,89136
train,1273,26,19968,345,49680,69648
train,1274,31,23808,490,70560,94368
train,1275,32,24576,522,75168,99744
train,1276,27,20736,372,53568,74304
train,1277,21,16128,225,32400,48528
train,1278,20,15360,204,29376,44736
train,1279,29,22272,429,61776,84048
train,1280,31,23808,490,70560,94368
train,1281,17,13056,147,21168,34224
train,1282,44,33792,988,142272,176064
train,1283,25,19200,319,45936,65136
train,1284,26,19968,345,49680,69648
train,1285,10,7680,51,7344,15024
train,1286,35,26880,625,90000,116880
train,1287,23,17664,270,38880,56544
train,1288,31,23808,490,70560,94368
train,1289,45,34560,1033,148752,183312
train,1290,33,25344,556,80064,105408
train,1291,11,8448,62,8928,17376
train,1292,30,23040,459,66096,89136
train,1293,58,44544,1716,247104,291648
train,1294,22,16896,247,35568,52464
train,1295,29,22272,429,61776,84048
train,1296,23,17664,270,38880,56544
train,1297,10,7680,51,7344,15024
train,1298,24,18432,294,42336,60768
train,1299,10,7680,51,7344,15024
train,1300,37,28416,698,100512,128928
train,1301,28,21504,400,57600,79104
train,1302,17,13056,147,21168,34224
train,1303,30,23040,459,66096,89136
train,1304,29,22272,429,61776,84048
train,1305,15,11520,115,16560,28080
train,1306,21,16128,225,32400,48528
train,1307,26,19968,345,49680,69648
train,1308,50,38400,1275,183600,222000
train,1309,8,6144,33,4752,10896
train,1310,16,12288,131,18864,31152
train,1311,7,5376,25,3600,8976
train,1312,31,23808,490,70560,94368
train,1313,5,3840,13,1872,5712
train,1314,23,17664,270,38880,56544
train,1315,12,9216,73,10512,19728
train,1316,11,8448,62,8928,17376
train,1317,11,8448,62,8928,17376
train,1318,16,12288,131,18864,31152
train,1319,15,11520,115,16560,28080
train,1320,3,2304,5,720,3024
train,1321,5,3840,13,1872,5712
train,1322,17,13056,147,21168,34224
train,1323,23,17664,270,38880,56544
train,1324,18,13824,165,23760,37584
train,1325,22,16896,247,35568,52464
train,1326,24,18432,294,42336,60768
train,1327,4,3072,8,1152,4224
train,1328,25,19200,319,45936,65136
train,1329,18,13824,165,23760,37584
train,1330,14,10752,100,14400,25152
train,1331,31,23808,490,70560,94368
train,1332,25,19200,319,45936,65136
train,1333,24,18432,294,42336,60768
train,1334,34,26112,590,84960,111072
train,1335,15,11520,115,16560,28080
train,1336,28,21504,400,57600,79104
train,1337,16,12288,131,18864,31152
train,1338,21,16128,225,32400,48528
train,1339,35,26880,625,90000,116880
train,1340,28,21504,400,57600,79104
train,1341,45,34560,1033,148752,183312
train,1342,17,13056,147,21168,34224
train,1343,24,18432,294,42336,60768
train,1344,9,6912,41,5904,12816
train,1345,38,29184,737,106128,135312
train,1346,23,17664,270,38880,56544
train,1347,12,9216,73,10512,19728
train,1348,10,7680,51,7344,15024
train,1349,5,3840,13,1872,5712
train,1350,15,11520,115,16560,28080
train,1351,17,13056,147,21168,34224
train,1352,23,17664,270,38880,56544
train,1353,16,12288,131,18864,31152
train,1354,9,6912,41,5904,12816
train,1355,4,3072,8,1152,4224
train,1356,25,19200,319,45936,65136
train,1357,42,32256,900,129600,161856
train,1358,27,20736,372,53568,74304
train,1359,22,16896,247,35568,52464
train,1360,11,8448,62,8928,17376
train,1361,27,20736,372,53568,74304
train,1362,25,19200,319,45936,65136
train,1363,4,3072,8,1152,4224
train,1364,21,16128,225,32400,48528
train,1365,34,26112,590,84960,111072
train,1366,36,27648,661,95184,122832
train,1367,14,10752,100,14400,25152
train,1368,51,39168,1327,191088,230256
train,1369,22,16896,247,35568,52464
train,1370,21,16128,225,32400,48528
train,1371,57,43776,1658,238752,282528
train,1372,26,19968,345,49680,69648
train,1373,11,8448,62,8928,17376
train,1374,13,9984,86,12384,22368
train,1375,19,14592,184,26496,41088
train,1376,36,27648,661,95184,122832
train,1377,41,31488,858,123552,155040
train,1378,13,9984,86,12384,22368
train,1379,24,18432,294,42336,60768
train,1380,27,20736,372,53568,74304
train,1381,37,28416,698,100512,128928
train,1382,20,15360,204,29376,44736
train,1383,14,10752,100,14400,25152
train,1384,25,19200,319,45936,65136
train,1385,12,9216,73,10512,19728
train,1386,16,12288,131,18864,31152
train,1387,16,12288,131,18864,31152
train,1388,22,16896,247,35568,52464
train,1389,31,23808,490,70560,94368
train,1390,5,3840,13,1872,5712
train,1391,14,10752,100,14400,25152
train,1392,16,12288,131,18864,31152
train,1393,37,28416,698,100512,128928
train,1394,14,10752,100,14400,25152
train,1395,31,23808,490,70560,94368
train,1396,33,25344,556,80064,105408
train,1397,20,15360,204,29376,44736
train,1398,20,15360,204,29376,44736
train,1399,28,21504,400,57600,79104
train,1400,29,22272,429,61776,84048
train,1401,9,6912,41,5904,12816
train,1402,15,11520,115,16560,28080
train,1403,17,13056,147,21168,34224
train,1404,6,4608,18,2592,7200
train,1405,17,13056,147,21168,34224
train,1406,20,15360,204,29376,44736
train,1407,12,9216,73,10512,19728
train,1408,18,13824,165,23760,37584
train,1409,13,9984,86,12384,22368
train,1410,21,16128,225,32400,48528
train,1411,47,36096,1127,162288,198384
train,1412,37,28416,698,100512,128928
train,1413,26,19968,345,49680,69648
train,1414,26,19968,345,49680,69648
train,1415,28,21504,400,57600,79104
train,1416,16,12288,131,18864,31152
train,1417,16,12288,131,18864,31152
train,1418,38,29184,737,106128,135312
train,1419,28,21504,400,57600,79104
train,1420,20,15360,204,29376,44736
train,1421,24,18432,294,42336,60768
train,1422,17,13056,147,21168,34224
train,1423,25,19200,319,45936,65136
train,1424,27,20736,372,53568,74304
train,1425,52,39936,1379,198576,238512
train,1426,6,4608,18,2592,7200
train,1427,10,7680,51,7344,15024
train,1428,23,17664,270,38880,56544
train,1429,38,29184,737,106128,135312
train,1430,31,23808,490,70560,94368
train,1431,27,20736,372,53568,74304
train,1432,11,8448,62,8928,17376
train,1433,7,5376,25,3600,8976
train,1434,26,19968,345,49680,69648
train,1435,30,23040,459,66096,89136
train,1436,18,13824,165,23760,37584
train,1437,21,16128,225,32400,48528
train,1438,25,19200,319,45936,65136
train,1439,27,20736,372,53568,74304
train,1440,16,12288,131,18864,31152
train,1441,14,10752,100,14400,25152
train,1442,24,18432,294,42336,60768
train,1443,29,22272,429,61776,84048
train,1444,20,15360,204,29376,44736
train,1445,37,28416,698,100512,128928
train,1446,15,11520,115,16560,28080
train,1447,33,25344,556,80064,105408
train,1448,40,30720,816,117504,148224
train,1449,11,8448,62,8928,17376
train,1450,8,6144,33,4752,10896
train,1451,11,8448,62,8928,17376
train,1452,36,27648,661,95184,122832
train,1453,12,9216,73,10512,19728
train,1454,31,23808,490,70560,94368
train,1455,31,23808,490,70560,94368
train,1456,14,10752,100,14400,25152
train,1457,39,29952,776,111744,141696
train,1458,14,10752,100,14400,25152
train,1459,18,13824,165,23760,37584
train,1460,34,26112,590,84960,111072
train,1461,22,16896,247,35568,52464
train,1462,18,13824,165,23760,37584
train,1463,10,7680,51,7344,15024
train,1464,21,16128,225,32400,48528
train,1465,15,11520,115,16560,28080
train,1466,37,28416,698,100512,128928
train,1467,28,21504,400,57600,79104
train,1468,16,12288,131,18864,31152
train,1469,17,13056,147,21168,34224
train,1470,12,9216,73,10512,19728
train,1471,38,29184,737,106128,135312
train,1472,40,30720,816,117504,148224
train,1473,30,23040,459,66096,89136
train,1474,28,21504,400,57600,79104
train,1475,22,16896,247,35568,52464
train,1476,18,13824,165,23760,37584
train,1477,14,10752,100,14400,25152
train,1478,36,27648,661,95184,122832
train,1479,28,21504,400,57600,79104
train,1480,15,11520,115,16560,28080
train,1481,47,36096,1127,162288,198384
train,1482,36,27648,661,95184,122832
train,1483,5,3840,13,1872,5712
train,1484,26,19968,345,49680,69648
train,1485,36,27648,661,95184,122832
train,1486,35,26880,625,90000,116880
train,1487,11,8448,62,8928,17376
train,1488,16,12288,131,18864,31152
train,1489,6,4608,18,2592,7200
train,1490,13,9984,86,12384,22368
train,1491,13,9984,86,12384,22368
train,1492,15,11520,115,16560,28080
train,1493,35,26880,625,90000,116880
train,1494,22,16896,247,35568,52464
train,1495,8,6144,33,4752,10896
train,1496,33,25344,556,80064,105408
train,1497,25,19200,319,45936,65136
train,1498,37,28416,698,100512,128928
train,1499,42,32256,900,129600,161856
train,1500,27,20736,372,53568,74304
train,1501,18,13824,165,23760,37584
train,1502,18,13824,165,23760,37584
train,1503,22,16896,247,35568,52464
train,1504,14,10752,100,14400,25152
train,1505,9,6912,41,5904,12816
train,1506,41,31488,858,123552,155040
train,1507,6,4608,18,2592,7200
train,1508,45,34560,1033,148752,183312
train,1509,32,24576,522,75168,99744
train,1510,17,13056,147,21168,34224
train,1511,13,9984,86,12384,22368
train,1512,15,11520,115,16560,28080
train,1513,9,6912,41,5904,12816
train,1514,31,23808,490,70560,94368
train,1515,40,30720,816,117504,148224
train,1516,13,9984,86,12384,22368
train,1517,22,16896,247,35568,52464
train,1518,11,8448,62,8928,17376
train,1519,12,9216,73,10512,19728
train,1520,18,13824,165,23760,37584
train,1521,13,9984,86,12384,22368
train,1522,12,9216,73,10512,19728
train,1523,15,11520,115,16560,28080
train,1524,41,31488,858,123552,155040
train,1525,18,13824,165,23760,37584
train,1526,25,19200,319,45936,65136
train,1527,32,24576,522,75168,99744
train,1528,39,29952,776,111744,141696
train,1529,6,4608,18,2592,7200
train,1530,36,27648,661,95184,122832
train,1531,25,19200,319,45936,65136
train,1532,23,17664,270,38880,56544
train,1533,37,28416,698,100512,128928
train,1534,17,13056,147,21168,34224
train,1535,19,14592,184,26496,41088
train,1536,11,8448,62,8928,17376
train,1537,16,12288,131,18864,31152
train,1538,16,12288,131,18864,31152
train,1539,30,23040,459,66096,89136
train,1540,11,8448,62,8928,17376
train,1541,32,24576,522,75168,99744
train,1542,26,19968,345,49680,69648
train,1543,21,16128,225,32400,48528
train,1544,30,23040,459,66096,89136
train,1545,29,22272,429,61776,84048
train,1546,23,17664,270,38880,56544
train,1547,41,31488,858,123552,155040
train,1548,23,17664,270,38880,56544
train,1549,14,10752,100,14400,25152
train,1550,11,8448,62,8928,17376
train,1551,16,12288,131,18864,31152
train,1552,22,16896,247,35568,52464
train,1553,50,38400,1275,183600,222000
train,1554,8,6144,33,4752,10896
train,1555,26,19968,345,49680,69648
train,1556,10,7680,51,7344,15024
train,1557,35,26880,625,90000,116880
train,1558,17,13056,147,21168,34224
train,1559,34,26112,590,84960,111072
train,1560,19,14592,184,26496,41088
train,1561,6,4608,18,2592,7200
train,1562,13,9984,86,12384,22368
train,1563,9,6912,41,5904,12816
train,1564,8,6144,33,4752,10896
train,1565,41,31488,858,123552,155040
train,1566,26,19968,345,49680,69648
train,1567,15,11520,115,16560,28080
train,1568,36,27648,661,95184,122832
train,1569,17,13056,147,21168,34224
train,1570,36,27648,661,95184,122832
train,1571,30,23040,459,66096,89136
train,1572,30,23040,459,66096,89136
train,1573,27,20736,372,53568,74304
train,1574,22,16896,247,35568,52464
train,1575,13,9984,86,12384,22368
train,1576,7,5376,25,3600,8976
train,1577,22,16896,247,35568,52464
train,1578,10,7680,51,7344,15024
train,1579,45,34560,1033,148752,183312
train,1580,46,35328,1079,155376,190704
train,1581,29,22272,429,61776,84048
train,1582,55,42240,1543,222192,264432
train,1583,5,3840,13,1872,5712
train,1584,6,4608,18,2592,7200
train,1585,14,10752,100,14400,25152
train,1586,17,13056,147,21168,34224
train,1587,43,33024,943,135792,168816
train,1588,11,8448,62,8928,17376
train,1589,31,23808,490,70560,94368
train,1590,14,10752,100,14400,25152
train,1591,29,22272,429,61776,84048
train,1592,27,20736,372,53568,74304
train,1593,36,27648,661,95184,122832
train,1594,32,24576,522,75168,99744
train,1595,10,7680,51,7344,15024
train,1596,13,9984,86,12384,22368
train,1597,11,8448,62,8928,17376
train,1598,15,11520,115,16560,28080
train,1599,35,26880,625,90000,116880
train,1600,32,24576,522,75168,99744
train,1601,34,26112,590,84960,111072
train,1602,8,6144,33,4752,10896
train,1603,15,11520,115,16560,28080
train,1604,38,29184,737,106128,135312
train,1605,15,11520,115,16560,28080
train,1606,25,19200,319,45936,65136
train,1607,22,16896,247,35568,52464
train,1608,11,8448,62,8928,17376
train,1609,21,16128,225,32400,48528
train,1610,46,35328,1079,155376,190704
train,1611,12,9216,73,10512,19728
train,1612,24,18432,294,42336,60768
train,1613,19,14592,184,26496,41088
train,1614,24,18432,294,42336,60768
train,1615,17,13056,147,21168,34224
train,1616,33,25344,556,80064,105408
train,1617,21,16128,225,32400,48528
train,1618,17,13056,147,21168,34224
train,1619,10,7680,51,7344,15024
train,1620,39,29952,776,111744,141696
train,1621,17,13056,147,21168,34224
train,1622,8,6144,33,4752,10896
train,1623,9,6912,41,5904,12816
train,1624,30,23040,459,66096,89136
train,1625,42,32256,900,129600,161856
train,1626,13,9984,86,12384,22368
train,1627,20,15360,204,29376,44736
train,1628,28,21504,400,57600,79104
train,1629,12,9216,73,10512,19728
train,1630,16,12288,131,18864,31152
train,1631,34,26112,590,84960,111072
train,1632,22,16896,247,35568,52464
train,1633,19,14592,184,26496,41088
train,1634,3,2304,5,720,3024
train,1635,30,23040,459,66096,89136
train,1636,36,27648,661,95184,122832
train,1637,10,7680,51,7344,15024
train,1638,9,6912,41,5904,12816
train,1639,12,9216,73,10512,19728
train,1640,54,41472,1488,214272,255744
train,1641,19,14592,184,26496,41088
train,1642,24,18432,294,42336,60768
train,1643,19,14592,184,26496,41088
train,1644,32,24576,522,75168,99744
train,1645,12,9216,73,10512,19728
train,1646,39,29952,776,111744,141696
train,1647,15,11520,115,16560,28080
train,1648,4,3072,8,1152,4224
train,1649,18,13824,165,23760,37584
train,1650,8,6144,33,4752,10896
train,1651,25,19200,319,45936,65136
train,1652,33,25344,556,80064,105408
train,1653,54,41472,1488,214272,255744
train,1654,35,26880,625,90000,116880
train,1655,20,15360,204,29376,44736
train,1656,13,9984,86,12384,22368
train,1657,18,13824,165,23760,37584
train,1658,21,16128,225,32400,48528
train,1659,23,17664,270,38880,56544
train,1660,10,7680,51,7344,15024
train,1661,23,17664,270,38880,56544
train,1662,11,8448,62,8928,17376
train,1663,15,11520,115,16560,28080
train,1664,18,13824,165,23760,37584
train,1665,13,9984,86,12384,22368
train,1666,12,9216,73,10512,19728
train,1667,10,7680,51,7344,15024
train,1668,18,13824,165,23760,37584
train,1669,9,6912,41,5904,12816
train,1670,17,13056,147,21168,34224
train,1671,9,6912,41,5904,12816
train,1672,15,11520,115,16560,28080
train,1673,16,12288,131,18864,31152
train,1674,24,18432,294,42336,60768
train,1675,40,30720,816,117504,148224
train,1676,48,36864,1175,169200,206064
train,1677,34,26112,590,84960,111072
train,1678,18,13824,165,23760,37584
train,1679,22,16896,247,35568,52464
train,1680,23,17664,270,38880,56544
train,1681,34,26112,590,84960,111072
train,1682,15,11520,115,16560,28080
train,1683,34,26112,590,84960,111072
train,1684,19,14592,184,26496,41088
train,1685,42,32256,900,129600,161856
train,1686,3,2304,5,720,3024
train,1687,10,7680,51,7344,15024
train,1688,20,15360,204,29376,44736
train,1689,30,23040,459,66096,89136
train,1690,39,29952,776,111744,141696
train,1691,45,34560,1033,148752,183312
train,1692,16,12288,131,18864,31152
train,1693,21,16128,225,32400,48528
train,1694,30,23040,459,66096,89136
train,1695,31,23808,490,70560,94368
train,1696,14,10752,100,14400,25152
train,1697,17,13056,147,21168,34224
train,1698,9,6912,41,5904,12816
train,1699,32,24576,522,75168,99744
train,1700,5,3840,13,1872,5712
train,1701,23,17664,270,38880,56544
train,1702,26,19968,345,49680,69648
train,1703,25,19200,319,45936,65136
train,1704,41,31488,858,123552,155040
train,1705,47,36096,1127,162288,198384
train,1706,33,25344,556,80064,105408
train,1707,23,17664,270,38880,56544
train,1708,10,7680,51,7344,15024
train,1709,25,19200,319,45936,65136
train,1710,5,3840,13,1872,5712
train,1711,7,5376,25,3600,8976
train,1712,12,9216,73,10512,19728
train,1713,22,16896,247,35568,52464
train,1714,14,10752,100,14400,25152
train,1715,6,4608,18,2592,7200
train,1716,18,13824,165,23760,37584
train,1717,45,34560,1033,148752,183312
train,1718,4,3072,8,1152,4224
train,1719,44,33792,988,142272,176064
train,1720,25,19200,319,45936,65136
train,1721,11,8448,62,8928,17376
train,1722,44,33792,988,142272,176064
train,1723,24,18432,294,42336,60768
train,1724,17,13056,147,21168,34224
train,1725,9,6912,41,5904,12816
train,1726,13,9984,86,12384,22368
train,1727,44,33792,988,142272,176064
train,1728,16,12288,131,18864,31152
train,1729,21,16128,225,32400,48528
train,1730,8,6144,33,4752,10896
train,1731,19,14592,184,26496,41088
train,1732,24,18432,294,42336,60768
train,1733,14,10752,100,14400,25152
train,1734,16,12288,131,18864,31152
train,1735,29,22272,429,61776,84048
train,1736,5,3840,13,1872,5712
train,1737,29,22272,429,61776,84048
train,1738,32,24576,522,75168,99744
train,1739,38,29184,737,106128,135312
train,1740,34,26112,590,84960,111072
train,1741,40,30720,816,117504,148224
train,1742,4,3072,8,1152,4224
train,1743,34,26112,590,84960,111072
train,1744,12,9216,73,10512,19728
train,1745,33,25344,556,80064,105408
train,1746,15,11520,115,16560,28080
train,1747,6,4608,18,2592,7200
train,1748,13,9984,86,12384,22368
train,1749,39,29952,776,111744,141696
train,1750,31,23808,490,70560,94368
train,1751,28,21504,400,57600,79104
train,1752,25,19200,319,45936,65136
train,1753,50,38400,1275,183600,222000
train,1754,25,19200,319,45936,65136
train,1755,22,16896,247,35568,52464
train,1756,39,29952,776,111744,141696
train,1757,17,13056,147,21168,34224
train,1758,16,12288,131,18864,31152
train,1759,12,9216,73,10512,19728
train,1760,32,24576,522,75168,99744
train,1761,21,16128,225,32400,48528
train,1762,15,11520,115,16560,28080
train,1763,34,26112,590,84960,111072
train,1764,39,29952,776,111744,141696
train,1765,17,13056,147,21168,34224
train,1766,45,34560,1033,148752,183312
train,1767,11,8448,62,8928,17376
train,1768,12,9216,73,10512,19728
train,1769,24,18432,294,42336,60768
train,1770,13,9984,86,12384,22368
train,1771,29,22272,429,61776,84048
train,1772,33,25344,556,80064,105408
train,1773,17,13056,147,21168,34224
train,1774,15,11520,115,16560,28080
train,1775,18,13824,165,23760,37584
train,1776,20,15360,204,29376,44736
train,1777,3,2304,5,720,3024
train,1778,22,16896,247,35568,52464
train,1779,26,19968,345,49680,69648
train,1780,22,16896,247,35568,52464
train,1781,35,26880,625,90000,116880
train,1782,19,14592,184,26496,41088
train,1783,23,17664,270,38880,56544
train,1784,3,2304,5,720,3024
train,1785,20,15360,204,29376,44736
train,1786,27,20736,372,53568,74304
train,1787,13,9984,86,12384,22368
train,1788,39,29952,776,111744,141696
train,1789,20,15360,204,29376,44736
train,1790,20,15360,204,29376,44736
train,1791,4,3072,8,1152,4224
train,1792,16,12288,131,18864,31152
train,1793,17,13056,147,21168,34224
train,1794,23,17664,270,38880,56544
train,1795,23,17664,270,38880,56544
train,1796,10,7680,51,7344,15024
train,1797,26,19968,345,49680,69648
train,1798,18,13824,165,23760,37584
train,1799,34,26112,590,84960,111072
train,1800,33,25344,556,80064,105408
train,1801,46,35328,1079,155376,190704
train,1802,15,11520,115,16560,28080
train,1803,12,9216,73,10512,19728
train,1804,13,9984,86,12384,22368
train,1805,31,23808,490,70560,94368
train,1806,8,6144,33,4752,10896
train,1807,31,23808,490,70560,94368
train,1808,11,8448,62,8928,17376
train,1809,11,8448,62,8928,17376
train,1810,17,13056,147,21168,34224
train,1811,18,13824,165,23760,37584
train,1812,22,16896,247,35568,52464
train,1813,9,6912,41,5904,12816
train,1814,35,26880,625,90000,116880
train,1815,25,19200,319,45936,65136
train,1816,14,10752,100,14400,25152
train,1817,21,16128,225,32400,48528
train,1818,30,23040,459,66096,89136
train,1819,10,7680,51,7344,15024
train,1820,17,13056,147,21168,34224
train,1821,8,6144,33,4752,10896
train,1822,21,16128,225,32400,48528
train,1823,47,36096,1127,162288,198384
train,1824,19,14592,184,26496,41088
train,1825,38,29184,737,106128,135312
train,1826,11,8448,62,8928,17376
train,1827,27,20736,372,53568,74304
train,1828,16,12288,131,18864,31152
train,1829,20,15360,204,29376,44736
train,1830,10,7680,51,7344,15024
train,1831,22,16896,247,35568,52464
train,1832,33,25344,556,80064,105408
train,1833,14,10752,100,14400,25152
train,1834,13,9984,86,12384,22368
train,1835,7,5376,25,3600,8976
train,1836,21,16128,225,32400,48528
train,1837,21,16128,225,32400,48528
train,1838,26,19968,345,49680,69648
train,1839,20,15360,204,29376,44736
train,1840,15,11520,115,16560,28080
train,1841,14,10752,100,14400,25152
train,1842,39,29952,776,111744,141696
train,1843,21,16128,225,32400,48528
train,1844,38,29184,737,106128,135312
train,1845,18,13824,165,23760,37584
train,1846,9,6912,41,5904,12816
train,1847,49,37632,1225,176400,214032
train,1848,29,22272,429,61776,84048
train,1849,35,26880,625,90000,116880
train,1850,21,16128,225,32400,48528
train,1851,22,16896,247,35568,52464
train,1852,54,41472,1488,214272,255744
train,1853,42,32256,900,129600,161856
train,1854,26,19968,345,49680,69648
train,1855,6,4608,18,2592,7200
train,1856,26,19968,345,49680,69648
train,1857,19,14592,184,26496,41088
train,1858,33,25344,556,80064,105408
train,1859,18,13824,165,23760,37584
train,1860,21,16128,225,32400,48528
train,1861,10,7680,51,7344,15024
train,1862,61,46848,1898,273312,320160
train,1863,10,7680,51,7344,15024
train,1864,15,11520,115,16560,28080
train,1865,20,15360,204,29376,44736
train,1866,21,16128,225,32400,48528
train,1867,26,19968,345,49680,69648
train,1868,23,17664,270,38880,56544
train,1869,47,36096,1127,162288,198384
train,1870,36,27648,661,95184,122832
train,1871,20,15360,204,29376,44736
train,1872,4,3072,8,1152,4224
train,1873,20,15360,204,29376,44736
train,1874,31,23808,490,70560,94368
train,1875,26,19968,345,49680,69648
train,1876,10,7680,51,7344,15024
train,1877,18,13824,165,23760,37584
train,1878,5,3840,13,1872,5712
train,1879,15,11520,115,16560,28080
train,1880,16,12288,131,18864,31152
train,1881,16,12288,131,18864,31152
train,1882,6,4608,18,2592,7200
train,1883,42,32256,900,129600,161856
train,1884,34,26112,590,84960,111072
train,1885,33,25344,556,80064,105408
train,1886,33,25344,556,80064,105408
train,1887,10,7680,51,7344,15024
train,1888,6,4608,18,2592,7200
train,1889,13,9984,86,12384,22368
train,1890,25,19200,319,45936,65136
train,1891,12,9216,73,10512,19728
train,1892,9,6912,41,5904,12816
train,1893,13,9984,86,12384,22368
train,1894,9,6912,41,5904,12816
train,1895,26,19968,345,49680,69648
train,1896,12,9216,73,10512,19728
train,1897,16,12288,131,18864,31152
train,1898,29,22272,429,61776,84048
train,1899,51,39168,1327,191088,230256
train,1900,9,6912,41,5904,12816
train,1901,28,21504,400,57600,79104
train,1902,34,26112,590,84960,111072
train,1903,19,14592,184,26496,41088
train,1904,7,5376,25,3600,8976
train,1905,18,13824,165,23760,37584
train,1906,24,18432,294,42336,60768
train,1907,24,18432,294,42336,60768
train,1908,11,8448,62,8928,17376
train,1909,14,10752,100,14400,25152
train,1910,12,9216,73,10512,19728
train,1911,30,23040,459,66096,89136
train,1912,4,3072,8,1152,4224
train,1913,25,19200,319,45936,65136
train,1914,24,18432,294,42336,60768
train,1915,9,6912,41,5904,12816
train,1916,13,9984,86,12384,22368
train,1917,27,20736,372,53568,74304
train,1918,5,3840,13,1872,5712
train,1919,15,11520,115,16560,28080
train,1920,10,7680,51,7344,15024
train,1921,35,26880,625,90000,116880
train,1922,22,16896,247,35568,52464
train,1923,11,8448,62,8928,17376
train,1924,5,3840,13,1872,5712
train,1925,18,13824,165,23760,37584
train,1926,17,13056,147,21168,34224
train,1927,19,14592,184,26496,41088
train,1928,41,31488,858,123552,155040
train,1929,32,24576,522,75168,99744
train,1930,13,9984,86,12384,22368
train,1931,30,23040,459,66096,89136
train,1932,41,31488,858,123552,155040
train,1933,6,4608,18,2592,7200
train,1934,6,4608,18,2592,7200
train,1935,13,9984,86,12384,22368
train,1936,21,16128,225,32400,48528
train,1937,36,27648,661,95184,122832
train,1938,5,3840,13,1872,5712
train,1939,37,28416,698,100512,128928
train,1940,21,16128,225,32400,48528
train,1941,4,3072,8,1152,4224
train,1942,12,9216,73,10512,19728
train,1943,24,18432,294,42336,60768
train,1944,20,15360,204,29376,44736
train,1945,38,29184,737,106128,135312
train,1946,14,10752,100,14400,25152
train,1947,4,3072,8,1152,4224
train,1948,25,19200,319,45936,65136
train,1949,26,19968,345,49680,69648
train,1950,12,9216,73,10512,19728
train,1951,5,3840,13,1872,5712
train,1952,43,33024,943,135792,168816
train,1953,41,31488,858,123552,155040
train,1954,18,13824,165,23760,37584
train,1955,27,20736,372,53568,74304
train,1956,16,12288,131,18864,31152
train,1957,16,12288,131,18864,31152
train,1958,24,18432,294,42336,60768
train,1959,22,16896,247,35568,52464
train,1960,33,25344,556,80064,105408
train,1961,4,3072,8,1152,4224
train,1962,15,11520,115,16560,28080
train,1963,50,38400,1275,183600,222000
train,1964,30,23040,459,66096,89136
train,1965,28,21504,400,57600,79104
train,1966,30,23040,459,66096,89136
train,1967,17,13056,147,21168,34224
train,1968,14,10752,100,14400,25152
train,1969,34,26112,590,84960,111072
train,1970,19,14592,184,26496,41088
train,1971,7,5376,25,3600,8976
train,1972,19,14592,184,26496,41088
train,1973,12,9216,73,10512,19728
train,1974,37,28416,698,100512,128928
train,1975,23,17664,270,38880,56544
train,1976,45,34560,1033,148752,183312
train,1977,10,7680,51,7344,15024
train,1978,7,5376,25,3600,8976
train,1979,11,8448,62,8928,17376
train,1980,32,24576,522,75168,99744
train,1981,43,33024,943,135792,168816
train,1982,9,6912,41,5904,12816
train,1983,43,33024,943,135792,168816
train,1984,26,19968,345,49680,69648
train,1985,25,19200,319,45936,65136
train,1986,16,12288,131,18864,31152
train,1987,16,12288,131,18864,31152
train,1988,21,16128,225,32400,48528
train,1989,21,16128,225,32400,48528
train,1990,7,5376,25,3600,8976
train,1991,20,15360,204,29376,44736
train,1992,9,6912,41,5904,12816
train,1993,8,6144,33,4752,10896
train,1994,8,6144,33,4752,10896
train,1995,36,27648,661,95184,122832
train,1996,9,6912,41,5904,12816
train,1997,19,14592,184,26496,41088
train,1998,34,26112,590,84960,111072
train,1999,23,17664,270,38880,56544
train,2000,24,18432,294,42336,60768
train,2001,16,12288,131,18864,31152
train,2002,19,14592,184,26496,41088
train,2003,32,24576,522,75168,99744
train,2004,47,36096,1127,162288,198384
train,2005,23,17664,270,38880,56544
train,2006,43,33024,943,135792,168816
train,2007,35,26880,625,90000,116880
train,2008,37,28416,698,100512,128928
train,2009,21,16128,225,32400,48528
train,2010,25,19200,319,45936,65136
train,2011,25,19200,319,45936,65136
train,2012,26,19968,345,49680,69648
train,2013,34,26112,590,84960,111072
train,2014,5,3840,13,1872,5712
train,2015,28,21504,400,57600,79104
train,2016,38,29184,737,106128,135312
train,2017,20,15360,204,29376,44736
train,2018,30,23040,459,66096,89136
train,2019,39,29952,776,111744,141696
train,2020,20,15360,204,29376,44736
train,2021,11,8448,62,8928,17376
train,2022,30,23040,459,66096,89136
train,2023,8,6144,33,4752,10896
train,2024,27,20736,372,53568,74304
train,2025,26,19968,345,49680,69648
train,2026,40,30720,816,117504,148224
train,2027,7,5376,25,3600,8976
train,2028,15,11520,115,16560,28080
train,2029,20,15360,204,29376,44736
train,2030,8,6144,33,4752,10896
train,2031,52,39936,1379,198576,238512
train,2032,17,13056,147,21168,34224
train,2033,28,21504,400,57600,79104
train,2034,16,12288,131,18864,31152
train,2035,10,7680,51,7344,15024
train,2036,38,29184,737,106128,135312
train,2037,6,4608,18,2592,7200
train,2038,27,20736,372,53568,74304
train,2039,35,26880,625,90000,116880
train,2040,16,12288,131,18864,31152
train,2041,55,42240,1543,222192,264432
train,2042,5,3840,13,1872,5712
train,2043,15,11520,115,16560,28080
train,2044,36,27648,661,95184,122832
train,2045,17,13056,147,21168,34224
train,2046,20,15360,204,29376,44736
train,2047,15,11520,115,16560,28080
train,2048,37,28416,698,100512,128928
train,2049,19,14592,184,26496,41088
train,2050,15,11520,115,16560,28080
train,2051,30,23040,459,66096,89136
train,2052,64,49152,2090,300960,350112
train,2053,18,13824,165,23760,37584
train,2054,15,11520,115,16560,28080
train,2055,21,16128,225,32400,48528
train,2056,6,4608,18,2592,7200
train,2057,17,13056,147,21168,34224
train,2058,39,29952,776,111744,141696
train,2059,15,11520,115,16560,28080
train,2060,12,9216,73,10512,19728
train,2061,16,12288,131,18864,31152
train,2062,17,13056,147,21168,34224
train,2063,24,18432,294,42336,60768
train,2064,23,17664,270,38880,56544
train,2065,27,20736,372,53568,74304
train,2066,39,29952,776,111744,141696
train,2067,19,14592,184,26496,41088
train,2068,28,21504,400,57600,79104
train,2069,21,16128,225,32400,48528
train,2070,15,11520,115,16560,28080
train,2071,23,17664,270,38880,56544
train,2072,15,11520,115,16560,28080
train,2073,27,20736,372,53568,74304
train,2074,8,6144,33,4752,10896
train,2075,25,19200,319,45936,65136
train,2076,25,19200,319,45936,65136
train,2077,24,18432,294,42336,60768
train,2078,7,5376,25,3600,8976
train,2079,17,13056,147,21168,34224
train,2080,35,26880,625,90000,116880
train,2081,10,7680,51,7344,15024
train,2082,25,19200,319,45936,65136
train,2083,28,21504,400,57600,79104
train,2084,35,26880,625,90000,116880
train,2085,19,14592,184,26496,41088
train,2086,8,6144,33,4752,10896
train,2087,21,16128,225,32400,48528
train,2088,9,6912,41,5904,12816
train,2089,30,23040,459,66096,89136
train,2090,9,6912,41,5904,12816
train,2091,22,16896,247,35568,52464
train,2092,21,16128,225,32400,48528
train,2093,10,7680,51,7344,15024
train,2094,26,19968,345,49680,69648
train,2095,4,3072,8,1152,4224
train,2096,14,10752,100,14400,25152
train,2097,5,3840,13,1872,5712
train,2098,22,16896,247,35568,52464
train,2099,42,32256,900,129600,161856
train,2100,37,28416,698,100512,128928
train,2101,39,29952,776,111744,141696
train,2102,22,16896,247,35568,52464
train,2103,13,9984,86,12384,22368
train,2104,9,6912,41,5904,12816
train,2105,22,16896,247,35568,52464
train,2106,20,15360,204,29376,44736
train,2107,64,49152,2090,300960,350112
train,2108,22,16896,247,35568,52464
train,2109,4,3072,8,1152,4224
train,2110,14,10752,100,14400,25152
train,2111,19,14592,184,26496,41088
train,2112,47,36096,1127,162288,198384
train,2113,11,8448,62,8928,17376
train,2114,50,38400,1275,183600,222000
train,2115,8,6144,33,4752,10896
train,2116,27,20736,372,53568,74304
train,2117,33,25344,556,80064,105408
train,2118,29,22272,429,61776,84048
train,2119,7,5376,25,3600,8976
train,2120,27,20736,372,53568,74304
train,2121,8,6144,33,4752,10896
train,2122,24,18432,294,42336,60768
train,2123,19,14592,184,26496,41088
train,2124,18,13824,165,23760,37584
train,2125,22,16896,247,35568,52464
train,2126,31,23808,490,70560,94368
train,2127,40,30720,816,117504,148224
train,2128,9,6912,41,5904,12816
train,2129,10,7680,51,7344,15024
train,2130,15,11520,115,16560,28080
train,2131,4,3072,8,1152,4224
train,2132,27,20736,372,53568,74304
train,2133,4,3072,8,1152,4224
train,2134,31,23808,490,70560,94368
train,2135,27,20736,372,53568,74304
train,2136,32,24576,522,75168,99744
train,2137,7,5376,25,3600,8976
train,2138,23,17664,270,38880,56544
train,2139,22,16896,247,35568,52464
train,2140,9,6912,41,5904,12816
train,2141,30,23040,459,66096,89136
train,2142,9,6912,41,5904,12816
train,2143,28,21504,400,57600,79104
train,2144,17,13056,147,21168,34224
train,2145,32,24576,522,75168,99744
train,2146,13,9984,86,12384,22368
train,2147,33,25344,556,80064,105408
train,2148,23,17664,270,38880,56544
train,2149,20,15360,204,29376,44736
train,2150,32,24576,522,75168,99744
train,2151,47,36096,1127,162288,198384
train,2152,25,19200,319,45936,65136
train,2153,12,9216,73,10512,19728
train,2154,24,18432,294,42336,60768
train,2155,14,10752,100,14400,25152
train,2156,3,2304,5,720,3024
train,2157,7,5376,25,3600,8976
train,2158,13,9984,86,12384,22368
train,2159,34,26112,590,84960,111072
train,2160,12,9216,73,10512,19728
train,2161,18,13824,165,23760,37584
train,2162,7,5376,25,3600,8976
train,2163,27,20736,372,53568,74304
train,2164,46,35328,1079,155376,190704
train,2165,7,5376,25,3600,8976
train,2166,13,9984,86,12384,22368
train,2167,13,9984,86,12384,22368
train,2168,25,19200,319,45936,65136
train,2169,14,10752,100,14400,25152
train,2170,27,20736,372,53568,74304
train,2171,23,17664,270,38880,56544
train,2172,24,18432,294,42336,60768
train,2173,37,28416,698,100512,128928
train,2174,20,15360,204,29376,44736
train,2175,29,22272,429,61776,84048
train,2176,29,22272,429,61776,84048
train,2177,11,8448,62,8928,17376
train,2178,33,25344,556,80064,105408
train,2179,9,6912,41,5904,12816
train,2180,26,19968,345,49680,69648
train,2181,20,15360,204,29376,44736
train,2182,11,8448,62,8928,17376
train,2183,27,20736,372,53568,74304
train,2184,17,13056,147,21168,34224
train,2185,3,2304,5,720,3024
train,2186,27,20736,372,53568,74304
train,2187,16,12288,131,18864,31152
train,2188,18,13824,165,23760,37584
train,2189,28,21504,400,57600,79104
train,2190,26,19968,345,49680,69648
train,2191,43,33024,943,135792,168816
train,2192,32,24576,522,75168,99744
train,2193,9,6912,41,5904,12816
train,2194,28,21504,400,57600,79104
train,2195,4,3072,8,1152,4224
train,2196,29,22272,429,61776,84048
train,2197,21,16128,225,32400,48528
train,2198,18,13824,165,23760,37584
train,2199,27,20736,372,53568,74304
train,2200,15,11520,115,16560,28080
train,2201,16,12288,131,18864,31152
train,2202,21,16128,225,32400,48528
train,2203,7,5376,25,3600,8976
train,2204,11,8448,62,8928,17376
train,2205,28,21504,400,57600,79104
train,2206,23,17664,270,38880,56544
train,2207,7,5376,25,3600,8976
train,2208,36,27648,661,95184,122832
train,2209,29,22272,429,61776,84048
train,2210,19,14592,184,26496,41088
train,2211,37,28416,698,100512,128928
train,2212,40,30720,816,117504,148224
train,2213,15,11520,115,16560,28080
train,2214,25,19200,319,45936,65136
train,2215,33,25344,556,80064,105408
train,2216,38,29184,737,106128,135312
train,2217,51,39168,1327,191088,230256
train,2218,28,21504,400,57600,79104
train,2219,11,8448,62,8928,17376
train,2220,8,6144,33,4752,10896
train,2221,10,7680,51,7344,15024
train,2222,17,13056,147,21168,34224
train,2223,17,13056,147,21168,34224
train,2224,36,27648,661,95184,122832
train,2225,10,7680,51,7344,15024
train,2226,19,14592,184,26496,41088
train,2227,24,18432,294,42336,60768
train,2228,22,16896,247,35568,52464
train,2229,21,16128,225,32400,48528
train,2230,42,32256,900,129600,161856
train,2231,12,9216,73,10512,19728
train,2232,25,19200,319,45936,65136
train,2233,31,23808,490,70560,94368
train,2234,36,27648,661,95184,122832
train,2235,21,16128,225,32400,48528
train,2236,33,25344,556,80064,105408
train,2237,12,9216,73,10512,19728
train,2238,17,13056,147,21168,34224
train,2239,6,4608,18,2592,7200
train,2240,31,23808,490,70560,94368
train,2241,29,22272,429,61776,84048
train,2242,27,20736,372,53568,74304
train,2243,20,15360,204,29376,44736
train,2244,10,7680,51,7344,15024
train,2245,9,6912,41,5904,12816
train,2246,34,26112,590,84960,111072
train,2247,46,35328,1079,155376,190704
train,2248,38,29184,737,106128,135312
train,2249,8,6144,33,4752,10896
train,2250,29,22272,429,61776,84048
train,2251,16,12288,131,18864,31152
train,2252,30,23040,459,66096,89136
train,2253,58,44544,1716,247104,291648
train,2254,3,2304,5,720,3024
train,2255,26,19968,345,49680,69648
train,2256,16,12288,131,18864,31152
train,2257,12,9216,73,10512,19728
train,2258,29,22272,429,61776,84048
train,2259,14,10752,100,14400,25152
train,2260,44,33792,988,142272,176064
train,2261,7,5376,25,3600,8976
train,2262,14,10752,100,14400,25152
train,2263,31,23808,490,70560,94368
train,2264,29,22272,429,61776,84048
train,2265,22,16896,247,35568,52464
train,2266,25,19200,319,45936,65136
train,2267,34,26112,590,84960,111072
train,2268,25,19200,319,45936,65136
train,2269,31,23808,490,70560,94368
train,2270,17,13056,147,21168,34224
train,2271,28,21504,400,57600,79104
train,2272,34,26112,590,84960,111072
train,2273,29,22272,429,61776,84048
train,2274,26,19968,345,49680,69648
train,2275,23,17664,270,38880,56544
train,2276,18,13824,165,23760,37584
train,2277,41,31488,858,123552,155040
train,2278,8,6144,33,4752,10896
train,2279,29,22272,429,61776,84048
train,2280,29,22272,429,61776,84048
train,2281,14,10752,100,14400,25152
train,2282,24,18432,294,42336,60768
train,2283,8,6144,33,4752,10896
train,2284,23,17664,270,38880,56544
train,2285,29,22272,429,61776,84048
train,2286,18,13824,165,23760,37584
train,2287,38,29184,737,106128,135312
train,2288,23,17664,270,38880,56544
train,2289,15,11520,115,16560,28080
train,2290,31,23808,490,70560,94368
train,2291,10,7680,51,7344,15024
train,2292,20,15360,204,29376,44736
train,2293,18,13824,165,23760,37584
train,2294,8,6144,33,4752,10896
train,2295,30,23040,459,66096,89136
train,2296,31,23808,490,70560,94368
train,2297,27,20736,372,53568,74304
train,2298,22,16896,247,35568,52464
train,2299,28,21504,400,57600,79104
train,2300,22,16896,247,35568,52464
train,2301,11,8448,62,8928,17376
train,2302,37,28416,698,100512,128928
train,2303,9,6912,41,5904,12816
train,2304,34,26112,590,84960,111072
train,2305,36,27648,661,95184,122832
train,2306,31,23808,490,70560,94368
train,2307,10,7680,51,7344,15024
train,2308,45,34560,1033,148752,183312
train,2309,13,9984,86,12384,22368
train,2310,20,15360,204,29376,44736
train,2311,26,19968,345,49680,69648
train,2312,8,6144,33,4752,10896
train,2313,29,22272,429,61776,84048
train,2314,15,11520,115,16560,28080
train,2315,24,18432,294,42336,60768
train,2316,31,23808,490,70560,94368
train,2317,23,17664,270,38880,56544
train,2318,29,22272,429,61776,84048
train,2319,20,15360,204,29376,44736
train,2320,19,14592,184,26496,41088
train,2321,18,13824,165,23760,37584
train,2322,15,11520,115,16560,28080
train,2323,34,26112,590,84960,111072
train,2324,43,33024,943,135792,168816
train,2325,11,8448,62,8928,17376
train,2326,30,23040,459,66096,89136
train,2327,41,31488,858,123552,155040
train,2328,24,18432,294,42336,60768
train,2329,27,20736,372,53568,74304
train,2330,22,16896,247,35568,52464
train,2331,17,13056,147,21168,34224
train,2332,40,30720,816,117504,148224
train,2333,11,8448,62,8928,17376
train,2334,17,13056,147,21168,34224
train,2335,30,23040,459,66096,89136
train,2336,25,19200,319,45936,65136
train,2337,21,16128,225,32400,48528
train,2338,21,16128,225,32400,48528
train,2339,28,21504,400,57600,79104
train,2340,46,35328,1079,155376,190704
train,2341,16,12288,131,18864,31152
train,2342,16,12288,131,18864,31152
train,2343,21,16128,225,32400,48528
train,2344,25,19200,319,45936,65136
train,2345,28,21504,400,57600,79104
train,2346,32,24576,522,75168,99744
train,2347,15,11520,115,16560,28080
train,2348,25,19200,319,45936,65136
train,2349,33,25344,556,80064,105408
train,2350,48,36864,1175,169200,206064
train,2351,16,12288,131,18864,31152
train,2352,9,6912,41,5904,12816
train,2353,17,13056,147,21168,34224
train,2354,20,15360,204,29376,44736
train,2355,33,25344,556,80064,105408
train,2356,36,27648,661,95184,122832
train,2357,17,13056,147,21168,34224
train,2358,30,23040,459,66096,89136
train,2359,11,8448,62,8928,17376
train,2360,46,35328,1079,155376,190704
train,2361,36,27648,661,95184,122832
train,2362,7,5376,25,3600,8976
train,2363,13,9984,86,12384,22368
train,2364,40,30720,816,117504,148224
train,2365,40,30720,816,117504,148224
train,2366,17,13056,147,21168,34224
train,2367,11,8448,62,8928,17376
train,2368,25,19200,319,45936,65136
train,2369,12,9216,73,10512,19728
train,2370,39,29952,776,111744,141696
train,2371,32,24576,522,75168,99744
train,2372,21,16128,225,32400,48528
train,2373,20,15360,204,29376,44736
train,2374,14,10752,100,14400,25152
train,2375,22,16896,247,35568,52464
train,2376,6,4608,18,2592,7200
train,2377,6,4608,18,2592,7200
train,2378,34,26112,590,84960,111072
train,2379,14,10752,100,14400,25152
train,2380,16,12288,131,18864,31152
train,2381,34,26112,590,84960,111072
train,2382,25,19200,319,45936,65136
train,2383,17,13056,147,21168,34224
train,2384,22,16896,247,35568,52464
train,2385,34,26112,590,84960,111072
train,2386,27,20736,372,53568,74304
train,2387,19,14592,184,26496,41088
train,2388,34,26112,590,84960,111072
train,2389,32,24576,522,75168,99744
train,2390,21,16128,225,32400,48528
train,2391,34,26112,590,84960,111072
train,2392,13,9984,86,12384,22368
train,2393,25,19200,319,45936,65136
train,2394,30,23040,459,66096,89136
train,2395,24,18432,294,42336,60768
train,2396,13,9984,86,12384,22368
train,2397,11,8448,62,8928,17376
train,2398,9,6912,41,5904,12816
train,2399,24,18432,294,42336,60768
train,2400,35,26880,625,90000,116880
train,2401,27,20736,372,53568,74304
train,2402,21,16128,225,32400,48528
train,2403,28,21504,400,57600,79104
train,2404,24,18432,294,42336,60768
train,2405,17,13056,147,21168,34224
train,2406,20,15360,204,29376,44736
train,2407,25,19200,319,45936,65136
train,2408,15,11520,115,16560,28080
train,2409,6,4608,18,2592,7200
train,2410,10,7680,51,7344,15024
train,2411,8,6144,33,4752,10896
train,2412,16,12288,131,18864,31152
train,2413,10,7680,51,7344,15024
train,2414,27,20736,372,53568,74304
train,2415,18,13824,165,23760,37584
train,2416,31,23808,490,70560,94368
train,2417,18,13824,165,23760,37584
train,2418,15,11520,115,16560,28080
train,2419,18,13824,165,23760,37584
train,2420,5,3840,13,1872,5712
train,2421,22,16896,247,35568,52464
train,2422,6,4608,18,2592,7200
train,2423,18,13824,165,23760,37584
train,2424,29,22272,429,61776,84048
train,2425,12,9216,73,10512,19728
train,2426,22,16896,247,35568,52464
train,2427,23,17664,270,38880,56544
train,2428,25,19200,319,45936,65136
train,2429,21,16128,225,32400,48528
train,2430,26,19968,345,49680,69648
train,2431,33,25344,556,80064,105408
train,2432,17,13056,147,21168,34224
train,2433,7,5376,25,3600,8976
train,2434,27,20736,372,53568,74304
train,2435,30,23040,459,66096,89136
train,2436,12,9216,73,10512,19728
train,2437,20,15360,204,29376,44736
train,2438,29,22272,429,61776,84048
train,2439,39,29952,776,111744,141696
train,2440,30,23040,459,66096,89136
train,2441,31,23808,490,70560,94368
train,2442,26,19968,345,49680,69648
train,2443,29,22272,429,61776,84048
train,2444,34,26112,590,84960,111072
train,2445,13,9984,86,12384,22368
train,2446,9,6912,41,5904,12816
train,2447,30,23040,459,66096,89136
train,2448,9,6912,41,5904,12816
train,2449,33,25344,556,80064,105408
train,2450,21,16128,225,32400,48528
train,2451,19,14592,184,26496,41088
train,2452,19,14592,184,26496,41088
train,2453,35,26880,625,90000,116880
train,2454,9,6912,41,5904,12816
train,2455,22,16896,247,35568,52464
train,2456,42,32256,900,129600,161856
train,2457,8,6144,33,4752,10896
train,2458,32,24576,522,75168,99744
train,2459,20,15360,204,29376,44736
train,2460,11,8448,62,8928,17376
train,2461,55,42240,1543,222192,264432
train,2462,8,6144,33,4752,10896
train,2463,42,32256,900,129600,161856
train,2464,29,22272,429,61776,84048
train,2465,24,18432,294,42336,60768
train,2466,18,13824,165,23760,37584
train,2467,21,16128,225,32400,48528
train,2468,22,16896,247,35568,52464
train,2469,18,13824,165,23760,37584
train,2470,8,6144,33,4752,10896
train,2471,12,9216,73,10512,19728
train,2472,16,12288,131,18864,31152
train,2473,26,19968,345,49680,69648
train,2474,23,17664,270,38880,56544
train,2475,19,14592,184,26496,41088
train,2476,19,14592,184,26496,41088
train,2477,34,26112,590,84960,111072
train,2478,34,26112,590,84960,111072
train,2479,29,22272,429,61776,84048
train,2480,49,37632,1225,176400,214032
train,2481,11,8448,62,8928,17376
train,2482,32,24576,522,75168,99744
train,2483,51,39168,1327,191088,230256
train,2484,36,27648,661,95184,122832
train,2485,27,20736,372,53568,74304
train,2486,23,17664,270,38880,56544
train,2487,32,24576,522,75168,99744
train,2488,38,29184,737,106128,135312
train,2489,30,23040,459,66096,89136
train,2490,15,11520,115,16560,28080
train,2491,26,19968,345,49680,69648
train,2492,50,38400,1275,183600,222000
train,2493,35,26880,625,90000,116880
train,2494,29,22272,429,61776,84048
train,2495,49,37632,1225,176400,214032
train,2496,32,24576,522,75168,99744
train,2497,47,36096,1127,162288,198384
train,2498,15,11520,115,16560,28080
train,2499,46,35328,1079,155376,190704
train,2500,29,22272,429,61776,84048
train,2501,13,9984,86,12384,22368
train,2502,33,25344,556,80064,105408
train,2503,43,33024,943,135792,168816
train,2504,27,20736,372,53568,74304
train,2505,23,17664,270,38880,56544
train,2506,15,11520,115,16560,28080
train,2507,33,25344,556,80064,105408
train,2508,41,31488,858,123552,155040
train,2509,14,10752,100,14400,25152
train,2510,26,19968,345,49680,69648
train,2511,12,9216,73,10512,19728
train,2512,6,4608,18,2592,7200
train,2513,26,19968,345,49680,69648
train,2514,24,18432,294,42336,60768
train,2515,14,10752,100,14400,25152
train,2516,25,19200,319,45936,65136
train,2517,16,12288,131,18864,31152
train,2518,32,24576,522,75168,99744
train,2519,29,22272,429,61776,84048
train,2520,10,7680,51,7344,15024
train,2521,21,16128,225,32400,48528
train,2522,22,16896,247,35568,52464
train,2523,42,32256,900,129600,161856
train,2524,3,2304,5,720,3024
train,2525,12,9216,73,10512,19728
train,2526,30,23040,459,66096,89136
train,2527,41,31488,858,123552,155040
train,2528,42,32256,900,129600,161856
train,2529,16,12288,131,18864,31152
train,2530,12,9216,73,10512,19728
train,2531,24,18432,294,42336,60768
train,2532,25,19200,319,45936,65136
train,2533,24,18432,294,42336,60768
train,2534,17,13056,147,21168,34224
train,2535,24,18432,294,42336,60768
train,2536,10,7680,51,7344,15024
train,2537,30,23040,459,66096,89136
train,2538,28,21504,400,57600,79104
train,2539,36,27648,661,95184,122832
train,2540,11,8448,62,8928,17376
train,2541,41,31488,858,123552,155040
train,2542,8,6144,33,4752,10896
train,2543,18,13824,165,23760,37584
train,2544,28,21504,400,57600,79104
train,2545,17,13056,147,21168,34224
train,2546,3,2304,5,720,3024
train,2547,16,12288,131,18864,31152
train,2548,6,4608,18,2592,7200
train,2549,15,11520,115,16560,28080
train,2550,44,33792,988,142272,176064
train,2551,38,29184,737,106128,135312
train,2552,33,25344,556,80064,105408
train,2553,27,20736,372,53568,74304
train,2554,30,23040,459,66096,89136
train,2555,27,20736,372,53568,74304
train,2556,30,23040,459,66096,89136
train,2557,56,43008,1600,230400,273408
train,2558,6,4608,18,2592,7200
train,2559,10,7680,51,7344,15024
train,2560,7,5376,25,3600,8976
train,2561,7,5376,25,3600,8976
train,2562,46,35328,1079,155376,190704
train,2563,30,23040,459,66096,89136
train,2564,32,24576,522,75168,99744
train,2565,22,16896,247,35568,52464
train,2566,21,16128,225,32400,48528
train,2567,12,9216,73,10512,19728
train,2568,22,16896,247,35568,52464
train,2569,10,7680,51,7344,15024
train,2570,17,13056,147,21168,34224
train,2571,10,7680,51,7344,15024
train,2572,33,25344,556,80064,105408
train,2573,25,19200,319,45936,65136
train,2574,35,26880,625,90000,116880
train,2575,20,15360,204,29376,44736
train,2576,21,16128,225,32400,48528
train,2577,51,39168,1327,191088,230256
train,2578,25,19200,319,45936,65136
train,2579,41,31488,858,123552,155040
train,2580,39,29952,776,111744,141696
train,2581,27,20736,372,53568,74304
train,2582,19,14592,184,26496,41088
train,2583,21,16128,225,32400,48528
train,2584,20,15360,204,29376,44736
train,2585,21,16128,225,32400,48528
train,2586,9,6912,41,5904,12816
train,2587,10,7680,51,7344,15024
train,2588,14,10752,100,14400,25152
train,2589,18,13824,165,23760,37584
train,2590,7,5376,25,3600,8976
train,2591,53,40704,1433,206352,247056
train,2592,15,11520,115,16560,28080
train,2593,19,14592,184,26496,41088
train,2594,26,19968,345,49680,69648
train,2595,17,13056,147,21168,34224
train,2596,35,26880,625,90000,116880
train,2597,44,33792,988,142272,176064
train,2598,41,31488,858,123552,155040
train,2599,22,16896,247,35568,52464
train,2600,28,21504,400,57600,79104
train,2601,44,33792,988,142272,176064
train,2602,20,15360,204,29376,44736
train,2603,38,29184,737,106128,135312
train,2604,54,41472,1488,214272,255744
train,2605,10,7680,51,7344,15024
train,2606,6,4608,18,2592,7200
train,2607,27,20736,372,53568,74304
train,2608,30,23040,459,66096,89136
train,2609,31,23808,490,70560,94368
train,2610,21,16128,225,32400,48528
train,2611,24,18432,294,42336,60768
train,2612,19,14592,184,26496,41088
train,2613,17,13056,147,21168,34224
train,2614,9,6912,41,5904,12816
train,2615,15,11520,115,16560,28080
train,2616,23,17664,270,38880,56544
train,2617,9,6912,41,5904,12816
train,2618,39,29952,776,111744,141696
train,2619,37,28416,698,100512,128928
train,2620,35,26880,625,90000,116880
train,2621,15,11520,115,16560,28080
train,2622,39,29952,776,111744,141696
train,2623,12,9216,73,10512,19728
train,2624,10,7680,51,7344,15024
train,2625,20,15360,204,29376,44736
train,2626,43,33024,943,135792,168816
train,2627,19,14592,184,26496,41088
train,2628,46,35328,1079,155376,190704
train,2629,20,15360,204,29376,44736
train,2630,35,26880,625,90000,116880
train,2631,38,29184,737,106128,135312
train,2632,32,24576,522,75168,99744
train,2633,15,11520,115,16560,28080
train,2634,21,16128,225,32400,48528
train,2635,31,23808,490,70560,94368
train,2636,27,20736,372,53568,74304
train,2637,13,9984,86,12384,22368
train,2638,30,23040,459,66096,89136
train,2639,27,20736,372,53568,74304
train,2640,18,13824,165,23760,37584
train,2641,26,19968,345,49680,69648
train,2642,53,40704,1433,206352,247056
train,2643,22,16896,247,35568,52464
train,2644,12,9216,73,10512,19728
train,2645,16,12288,131,18864,31152
train,2646,19,14592,184,26496,41088
train,2647,26,19968,345,49680,69648
train,2648,15,11520,115,16560,28080
train,2649,15,11520,115,16560,28080
train,2650,32,24576,522,75168,99744
train,2651,26,19968,345,49680,69648
train,2652,28,21504,400,57600,79104
train,2653,21,16128,225,32400,48528
train,2654,18,13824,165,23760,37584
train,2655,50,38400,1275,183600,222000
train,2656,16,12288,131,18864,31152
train,2657,16,12288,131,18864,31152
train,2658,29,22272,429,61776,84048
train,2659,16,12288,131,18864,31152
train,2660,22,16896,247,35568,52464
train,2661,12,9216,73,10512,19728
train,2662,31,23808,490,70560,94368
train,2663,36,27648,661,95184,122832
train,2664,17,13056,147,21168,34224
train,2665,12,9216,73,10512,19728
train,2666,44,33792,988,142272,176064
train,2667,10,7680,51,7344,15024
train,2668,11,8448,62,8928,17376
train,2669,5,3840,13,1872,5712
train,2670,21,16128,225,32400,48528
train,2671,26,19968,345,49680,69648
train,2672,23,17664,270,38880,56544
train,2673,33,25344,556,80064,105408
train,2674,14,10752,100,14400,25152
train,2675,32,24576,522,75168,99744
train,2676,22,16896,247,35568,52464
train,2677,20,15360,204,29376,44736
train,2678,20,15360,204,29376,44736
train,2679,22,16896,247,35568,52464
train,2680,10,7680,51,7344,15024
train,2681,22,16896,247,35568,52464
train,2682,23,17664,270,38880,56544
train,2683,20,15360,204,29376,44736
train,2684,33,25344,556,80064,105408
train,2685,32,24576,522,75168,99744
train,2686,56,43008,1600,230400,273408
train,2687,34,26112,590,84960,111072
train,2688,19,14592,184,26496,41088
train,2689,25,19200,319,45936,65136
train,2690,17,13056,147,21168,34224
train,2691,19,14592,184,26496,41088
train,2692,35,26880,625,90000,116880
train,2693,22,16896,247,35568,52464
train,2694,17,13056,147,21168,34224
train,2695,43,33024,943,135792,168816
train,2696,37,28416,698,100512,128928
train,2697,31,23808,490,70560,94368
train,2698,20,15360,204,29376,44736
train,2699,34,26112,590,84960,111072
train,2700,16,12288,131,18864,31152
train,2701,20,15360,204,29376,44736
train,2702,5,3840,13,1872,5712
train,2703,28,21504,400,57600,79104
train,2704,27,20736,372,53568,74304
train,2705,34,26112,590,84960,111072
train,2706,19,14592,184,26496,41088
train,2707,33,25344,556,80064,105408
train,2708,27,20736,372,53568,74304
train,2709,22,16896,247,35568,52464
train,2710,19,14592,184,26496,41088
train,2711,33,25344,556,80064,105408
train,2712,11,8448,62,8928,17376
train,2713,12,9216,73,10512,19728
train,2714,28,21504,400,57600,79104
train,2715,9,6912,41,5904,12816
train,2716,56,43008,1600,230400,273408
train,2717,14,10752,100,14400,25152
train,2718,23,17664,270,38880,56544
train,2719,27,20736,372,53568,74304
train,2720,50,38400,1275,183600,222000
train,2721,22,16896,247,35568,52464
train,2722,43,33024,943,135792,168816
train,2723,25,19200,319,45936,65136
train,2724,22,16896,247,35568,52464
train,2725,21,16128,225,32400,48528
train,2726,20,15360,204,29376,44736
train,2727,23,17664,270,38880,56544
train,2728,42,32256,900,129600,161856
train,2729,35,26880,625,90000,116880
train,2730,15,11520,115,16560,28080
train,2731,24,18432,294,42336,60768
train,2732,15,11520,115,16560,28080
train,2733,34,26112,590,84960,111072
train,2734,16,12288,131,18864,31152
train,2735,13,9984,86,12384,22368
train,2736,10,7680,51,7344,15024
train,2737,29,22272,429,61776,84048
train,2738,9,6912,41,5904,12816
train,2739,41,31488,858,123552,155040
train,2740,20,15360,204,29376,44736
train,2741,12,9216,73,10512,19728
train,2742,27,20736,372,53568,74304
train,2743,17,13056,147,21168,34224
train,2744,28,21504,400,57600,79104
train,2745,12,9216,73,10512,19728
train,2746,28,21504,400,57600,79104
train,2747,26,19968,345,49680,69648
train,2748,19,14592,184,26496,41088
train,2749,18,13824,165,23760,37584
train,2750,4,3072,8,1152,4224
train,2751,20,15360,204,29376,44736
train,2752,19,14592,184,26496,41088
train,2753,12,9216,73,10512,19728
train,2754,21,16128,225,32400,48528
train,2755,34,26112,590,84960,111072
train,2756,21,16128,225,32400,48528
train,2757,24,18432,294,42336,60768
train,2758,31,23808,490,70560,94368
train,2759,37,28416,698,100512,128928
train,2760,13,9984,86,12384,22368
train,2761,4,3072,8,1152,4224
train,2762,19,14592,184,26496,41088
train,2763,29,22272,429,61776,84048
train,2764,18,13824,165,23760,37584
train,2765,45,34560,1033,148752,183312
train,2766,12,9216,73,10512,19728
train,2767,27,20736,372,53568,74304
train,2768,26,19968,345,49680,69648
train,2769,18,13824,165,23760,37584
train,2770,7,5376,25,3600,8976
train,2771,5,3840,13,1872,5712
train,2772,12,9216,73,10512,19728
train,2773,24,18432,294,42336,60768
train,2774,32,24576,522,75168,99744
train,2775,22,16896,247,35568,52464
train,2776,19,14592,184,26496,41088
train,2777,20,15360,204,29376,44736
train,2778,20,15360,204,29376,44736
train,2779,21,16128,225,32400,48528
train,2780,31,23808,490,70560,94368
train,2781,22,16896,247,35568,52464
train,2782,21,16128,225,32400,48528
train,2783,29,22272,429,61776,84048
train,2784,13,9984,86,12384,22368
train,2785,32,24576,522,75168,99744
train,2786,14,10752,100,14400,25152
train,2787,15,11520,115,16560,28080
train,2788,55,42240,1543,222192,264432
train,2789,26,19968,345,49680,69648
train,2790,12,9216,73,10512,19728
train,2791,23,17664,270,38880,56544
train,2792,21,16128,225,32400,48528
train,2793,3,2304,5,720,3024
train,2794,47,36096,1127,162288,198384
train,2795,8,6144,33,4752,10896
train,2796,18,13824,165,23760,37584
train,2797,13,9984,86,12384,22368
train,2798,5,3840,13,1872,5712
train,2799,32,24576,522,75168,99744
train,2800,12,9216,73,10512,19728
train,2801,29,22272,429,61776,84048
train,2802,17,13056,147,21168,34224
train,2803,19,14592,184,26496,41088
train,2804,28,21504,400,57600,79104
train,2805,20,15360,204,29376,44736
train,2806,9,6912,41,5904,12816
train,2807,19,14592,184,26496,41088
train,2808,8,6144,33,4752,10896
train,2809,36,27648,661,95184,122832
train,2810,12,9216,73,10512,19728
train,2811,24,18432,294,42336,60768
train,2812,22,16896,247,35568,52464
train,2813,19,14592,184,26496,41088
train,2814,8,6144,33,4752,10896
train,2815,20,15360,204,29376,44736
train,2816,12,9216,73,10512,19728
train,2817,32,24576,522,75168,99744
train,2818,22,16896,247,35568,52464
train,2819,30,23040,459,66096,89136
train,2820,15,11520,115,16560,28080
train,2821,13,9984,86,12384,22368
train,2822,20,15360,204,29376,44736
train,2823,14,10752,100,14400,25152
train,2824,21,16128,225,32400,48528
train,2825,23,17664,270,38880,56544
train,2826,24,18432,294,42336,60768
train,2827,20,15360,204,29376,44736
train,2828,9,6912,41,5904,12816
train,2829,29,22272,429,61776,84048
train,2830,24,18432,294,42336,60768
train,2831,33,25344,556,80064,105408
train,2832,17,13056,147,21168,34224
train,2833,11,8448,62,8928,17376
train,2834,18,13824,165,23760,37584
train,2835,34,26112,590,84960,111072
train,2836,19,14592,184,26496,41088
train,2837,16,12288,131,18864,31152
train,2838,32,24576,522,75168,99744
train,2839,13,9984,86,12384,22368
train,2840,23,17664,270,38880,56544
train,2841,28,21504,400,57600,79104
train,2842,10,7680,51,7344,15024
train,2843,21,16128,225,32400,48528
train,2844,20,15360,204,29376,44736
train,2845,15,11520,115,16560,28080
train,2846,10,7680,51,7344,15024
train,2847,11,8448,62,8928,17376
train,2848,14,10752,100,14400,25152
train,2849,21,16128,225,32400,48528
train,2850,28,21504,400,57600,79104
train,2851,27,20736,372,53568,74304
train,2852,25,19200,319,45936,65136
train,2853,19,14592,184,26496,41088
train,2854,24,18432,294,42336,60768
train,2855,26,19968,345,49680,69648
train,2856,35,26880,625,90000,116880
train,2857,30,23040,459,66096,89136
train,2858,10,7680,51,7344,15024
train,2859,17,13056,147,21168,34224
train,2860,39,29952,776,111744,141696
train,2861,52,39936,1379,198576,238512
train,2862,46,35328,1079,155376,190704
train,2863,31,23808,490,70560,94368
train,2864,23,17664,270,38880,56544
train,2865,26,19968,345,49680,69648
train,2866,13,9984,86,12384,22368
train,2867,50,38400,1275,183600,222000
train,2868,22,16896,247,35568,52464
train,2869,32,24576,522,75168,99744
train,2870,23,17664,270,38880,56544
train,2871,23,17664,270,38880,56544
train,2872,19,14592,184,26496,41088
train,2873,7,5376,25,3600,8976
train,2874,28,21504,400,57600,79104
train,2875,14,10752,100,14400,25152
train,2876,12,9216,73,10512,19728
train,2877,17,13056,147,21168,34224
train,2878,30,23040,459,66096,89136
train,2879,25,19200,319,45936,65136
train,2880,31,23808,490,70560,94368
train,2881,41,31488,858,123552,155040
train,2882,5,3840,13,1872,5712
train,2883,16,12288,131,18864,31152
train,2884,40,30720,816,117504,148224
train,2885,11,8448,62,8928,17376
train,2886,17,13056,147,21168,34224
train,2887,20,15360,204,29376,44736
train,2888,22,16896,247,35568,52464
train,2889,42,32256,900,129600,161856
train,2890,11,8448,62,8928,17376
train,2891,18,13824,165,23760,37584
train,2892,14,10752,100,14400,25152
train,2893,23,17664,270,38880,56544
train,2894,37,28416,698,100512,128928
train,2895,44,33792,988,142272,176064
train,2896,14,10752,100,14400,25152
train,2897,12,9216,73,10512,19728
train,2898,16,12288,131,18864,31152
train,2899,31,23808,490,70560,94368
train,2900,4,3072,8,1152,4224
train,2901,14,10752,100,14400,25152
train,2902,12,9216,73,10512,19728
train,2903,21,16128,225,32400,48528
train,2904,28,21504,400,57600,79104
train,2905,12,9216,73,10512,19728
train,2906,16,12288,131,18864,31152
train,2907,18,13824,165,23760,37584
train,2908,18,13824,165,23760,37584
train,2909,25,19200,319,45936,65136
train,2910,24,18432,294,42336,60768
train,2911,23,17664,270,38880,56544
train,2912,11,8448,62,8928,17376
train,2913,17,13056,147,21168,34224
train,2914,29,22272,429,61776,84048
train,2915,13,9984,86,12384,22368
train,2916,28,21504,400,57600,79104
train,2917,14,10752,100,14400,25152
train,2918,5,3840,13,1872,5712
train,2919,26,19968,345,49680,69648
train,2920,7,5376,25,3600,8976
train,2921,35,26880,625,90000,116880
train,2922,26,19968,345,49680,69648
train,2923,25,19200,319,45936,65136
train,2924,18,13824,165,23760,37584
train,2925,16,12288,131,18864,31152
train,2926,28,21504,400,57600,79104
train,2927,10,7680,51,7344,15024
train,2928,40,30720,816,117504,148224
train,2929,7,5376,25,3600,8976
train,2930,26,19968,345,49680,69648
train,2931,16,12288,131,18864,31152
train,2932,24,18432,294,42336,60768
train,2933,13,9984,86,12384,22368
train,2934,41,31488,858,123552,155040
train,2935,47,36096,1127,162288,198384
train,2936,32,24576,522,75168,99744
train,2937,16,12288,131,18864,31152
train,2938,48,36864,1175,169200,206064
train,2939,22,16896,247,35568,52464
train,2940,15,11520,115,16560,28080
train,2941,24,18432,294,42336,60768
train,2942,16,12288,131,18864,31152
train,2943,11,8448,62,8928,17376
train,2944,9,6912,41,5904,12816
train,2945,44,33792,988,142272,176064
train,2946,35,26880,625,90000,116880
train,2947,26,19968,345,49680,69648
train,2948,18,13824,165,23760,37584
train,2949,27,20736,372,53568,74304
train,2950,6,4608,18,2592,7200
train,2951,18,13824,165,23760,37584
train,2952,16,12288,131,18864,31152
train,2953,31,23808,490,70560,94368
train,2954,17,13056,147,21168,34224
train,2955,40,30720,816,117504,148224
train,2956,30,23040,459,66096,89136
train,2957,41,31488,858,123552,155040
train,2958,27,20736,372,53568,74304
train,2959,29,22272,429,61776,84048
train,2960,3,2304,5,720,3024
train,2961,16,12288,131,18864,31152
train,2962,33,25344,556,80064,105408
train,2963,13,9984,86,12384,22368
train,2964,4,3072,8,1152,4224
train,2965,31,23808,490,70560,94368
train,2966,27,20736,372,53568,74304
train,2967,21,16128,225,32400,48528
train,2968,30,23040,459,66096,89136
train,2969,23,17664,270,38880,56544
train,2970,18,13824,165,23760,37584
train,2971,19,14592,184,26496,41088
train,2972,15,11520,115,16560,28080
train,2973,22,16896,247,35568,52464
train,2974,29,22272,429,61776,84048
train,2975,22,16896,247,35568,52464
train,2976,33,25344,556,80064,105408
train,2977,45,34560,1033,148752,183312
train,2978,38,29184,737,106128,135312
train,2979,33,25344,556,80064,105408
train,2980,25,19200,319,45936,65136
train,2981,11,8448,62,8928,17376
train,2982,17,13056,147,21168,34224
train,2983,35,26880,625,90000,116880
train,2984,17,13056,147,21168,34224
train,2985,14,10752,100,14400,25152
train,2986,23,17664,270,38880,56544
train,2987,36,27648,661,95184,122832
train,2988,18,13824,165,23760,37584
train,2989,21,16128,225,32400,48528
train,2990,30,23040,459,66096,89136
train,2991,17,13056,147,21168,34224
train,2992,11,8448,62,8928,17376
train,2993,7,5376,25,3600,8976
train,2994,17,13056,147,21168,34224
train,2995,31,23808,490,70560,94368
train,2996,23,17664,270,38880,56544
train,2997,15,11520,115,16560,28080
train,2998,3,2304,5,720,3024
train,2999,24,18432,294,42336,60768
train,3000,3,2304,5,720,3024
train,3001,45,34560,1033,148752,183312
train,3002,31,23808,490,70560,94368
train,3003,37,28416,698,100512,128928
train,3004,7,5376,25,3600,8976
train,3005,13,9984,86,12384,22368
train,3006,40,30720,816,117504,148224
train,3007,16,12288,131,18864,31152
train,3008,25,19200,319,45936,65136
train,3009,12,9216,73,10512,19728
train,3010,36,27648,661,95184,122832
train,3011,4,3072,8,1152,4224
train,3012,12,9216,73,10512,19728
train,3013,14,10752,100,14400,25152
train,3014,11,8448,62,8928,17376
train,3015,6,4608,18,2592,7200
train,3016,16,12288,131,18864,31152
train,3017,6,4608,18,2592,7200
train,3018,17,13056,147,21168,34224
train,3019,2,1536,2,288,1824
train,3020,21,16128,225,32400,48528
train,3021,20,15360,204,29376,44736
train,3022,5,3840,13,1872,5712
train,3023,15,11520,115,16560,28080
train,3024,19,14592,184,26496,41088
train,3025,31,23808,490,70560,94368
train,3026,30,23040,459,66096,89136
train,3027,6,4608,18,2592,7200
train,3028,23,17664,270,38880,56544
train,3029,39,29952,776,111744,141696
train,3030,6,4608,18,2592,7200
train,3031,29,22272,429,61776,84048
train,3032,22,16896,247,35568,52464
train,3033,54,41472,1488,214272,255744
train,3034,33,25344,556,80064,105408
train,3035,26,19968,345,49680,69648
train,3036,10,7680,51,7344,15024
train,3037,27,20736,372,53568,74304
train,3038,27,20736,372,53568,74304
train,3039,14,10752,100,14400,25152
train,3040,22,16896,247,35568,52464
train,3041,12,9216,73,10512,19728
train,3042,29,22272,429,61776,84048
train,3043,15,11520,115,16560,28080
train,3044,21,16128,225,32400,48528
train,3045,8,6144,33,4752,10896
train,3046,27,20736,372,53568,74304
train,3047,46,35328,1079,155376,190704
train,3048,14,10752,100,14400,25152
train,3049,17,13056,147,21168,34224
train,3050,14,10752,100,14400,25152
train,3051,38,29184,737,106128,135312
train,3052,37,28416,698,100512,128928
train,3053,51,39168,1327,191088,230256
train,3054,38,29184,737,106128,135312
train,3055,32,24576,522,75168,99744
train,3056,24,18432,294,42336,60768
train,3057,12,9216,73,10512,19728
train,3058,27,20736,372,53568,74304
train,3059,22,16896,247,35568,52464
train,3060,5,3840,13,1872,5712
train,3061,14,10752,100,14400,25152
train,3062,17,13056,147,21168,34224
train,3063,54,41472,1488,214272,255744
train,3064,21,16128,225,32400,48528
train,3065,37,28416,698,100512,128928
train,3066,25,19200,319,45936,65136
train,3067,35,26880,625,90000,116880
train,3068,24,18432,294,42336,60768
train,3069,27,20736,372,53568,74304
train,3070,33,25344,556,80064,105408
train,3071,15,11520,115,16560,28080
train,3072,50,38400,1275,183600,222000
train,3073,10,7680,51,7344,15024
train,3074,31,23808,490,70560,94368
train,3075,21,16128,225,32400,48528
train,3076,15,11520,115,16560,28080
train,3077,15,11520,115,16560,28080
train,3078,3,2304,5,720,3024
train,3079,19,14592,184,26496,41088
train,3080,10,7680,51,7344,15024
train,3081,11,8448,62,8928,17376
train,3082,14,10752,100,14400,25152
train,3083,35,26880,625,90000,116880
train,3084,14,10752,100,14400,25152
train,3085,14,10752,100,14400,25152
train,3086,13,9984,86,12384,22368
train,3087,22,16896,247,35568,52464
train,3088,33,25344,556,80064,105408
train,3089,12,9216,73,10512,19728
train,3090,18,13824,165,23760,37584
train,3091,28,21504,400,57600,79104
train,3092,55,42240,1543,222192,264432
train,3093,16,12288,131,18864,31152
train,3094,17,13056,147,21168,34224
train,3095,7,5376,25,3600,8976
train,3096,9,6912,41,5904,12816
train,3097,30,23040,459,66096,89136
train,3098,37,28416,698,100512,128928
train,3099,19,14592,184,26496,41088
train,3100,8,6144,33,4752,10896
train,3101,29,22272,429,61776,84048
train,3102,37,28416,698,100512,128928
train,3103,44,33792,988,142272,176064
train,3104,34,26112,590,84960,111072
train,3105,24,18432,294,42336,60768
train,3106,24,18432,294,42336,60768
train,3107,31,23808,490,70560,94368
train,3108,9,6912,41,5904,12816
train,3109,10,7680,51,7344,15024
train,3110,27,20736,372,53568,74304
train,3111,38,29184,737,106128,135312
train,3112,19,14592,184,26496,41088
train,3113,15,11520,115,16560,28080
train,3114,18,13824,165,23760,37584
train,3115,25,19200,319,45936,65136
train,3116,21,16128,225,32400,48528
train,3117,42,32256,900,129600,161856
train,3118,23,17664,270,38880,56544
train,3119,10,7680,51,7344,15024
train,3120,3,2304,5,720,3024
train,3121,22,16896,247,35568,52464
train,3122,34,26112,590,84960,111072
train,3123,6,4608,18,2592,7200
train,3124,39,29952,776,111744,141696
train,3125,18,13824,165,23760,37584
train,3126,16,12288,131,18864,31152
train,3127,26,19968,345,49680,69648
train,3128,28,21504,400,57600,79104
train,3129,31,23808,490,70560,94368
train,3130,29,22272,429,61776,84048
train,3131,20,15360,204,29376,44736
train,3132,51,39168,1327,191088,230256
train,3133,16,12288,131,18864,31152
train,3134,26,19968,345,49680,69648
train,3135,27,20736,372,53568,74304
train,3136,17,13056,147,21168,34224
train,3137,36,27648,661,95184,122832
train,3138,22,16896,247,35568,52464
train,3139,19,14592,184,26496,41088
train,3140,51,39168,1327,191088,230256
train,3141,32,24576,522,75168,99744
train,3142,26,19968,345,49680,69648
train,3143,17,13056,147,21168,34224
train,3144,36,27648,661,95184,122832
train,3145,38,29184,737,106128,135312
train,3146,17,13056,147,21168,34224
train,3147,30,23040,459,66096,89136
train,3148,5,3840,13,1872,5712
train,3149,36,27648,661,95184,122832
train,3150,13,9984,86,12384,22368
train,3151,12,9216,73,10512,19728
train,3152,19,14592,184,26496,41088
train,3153,19,14592,184,26496,41088
train,3154,18,13824,165,23760,37584
train,3155,22,16896,247,35568,52464
train,3156,41,31488,858,123552,155040
train,3157,23,17664,270,38880,56544
train,3158,29,22272,429,61776,84048
train,3159,21,16128,225,32400,48528
train,3160,36,27648,661,95184,122832
train,3161,29,22272,429,61776,84048
train,3162,12,9216,73,10512,19728
train,3163,11,8448,62,8928,17376
train,3164,24,18432,294,42336,60768
train,3165,9,6912,41,5904,12816
train,3166,44,33792,988,142272,176064
train,3167,25,19200,319,45936,65136
train,3168,26,19968,345,49680,69648
train,3169,22,16896,247,35568,52464
train,3170,45,34560,1033,148752,183312
train,3171,16,12288,131,18864,31152
train,3172,12,9216,73,10512,19728
train,3173,27,20736,372,53568,74304
train,3174,12,9216,73,10512,19728
train,3175,11,8448,62,8928,17376
train,3176,25,19200,319,45936,65136
train,3177,61,46848,1898,273312,320160
train,3178,34,26112,590,84960,111072
train,3179,16,12288,131,18864,31152
train,3180,25,19200,319,45936,65136
train,3181,17,13056,147,21168,34224
train,3182,24,18432,294,42336,60768
train,3183,34,26112,590,84960,111072
train,3184,14,10752,100,14400,25152
train,3185,17,13056,147,21168,34224
train,3186,31,23808,490,70560,94368
train,3187,23,17664,270,38880,56544
train,3188,6,4608,18,2592,7200
train,3189,29,22272,429,61776,84048
train,3190,20,15360,204,29376,44736
train,3191,28,21504,400,57600,79104
train,3192,16,12288,131,18864,31152
train,3193,17,13056,147,21168,34224
train,3194,35,26880,625,90000,116880
train,3195,6,4608,18,2592,7200
train,3196,14,10752,100,14400,25152
train,3197,15,11520,115,16560,28080
train,3198,28,21504,400,57600,79104
train,3199,10,7680,51,7344,15024
train,3200,26,19968,345,49680,69648
train,3201,9,6912,41,5904,12816
train,3202,29,22272,429,61776,84048
train,3203,13,9984,86,12384,22368
train,3204,56,43008,1600,230400,273408
train,3205,12,9216,73,10512,19728
train,3206,18,13824,165,23760,37584
train,3207,39,29952,776,111744,141696
train,3208,24,18432,294,42336,60768
train,3209,5,3840,13,1872,5712
train,3210,45,34560,1033,148752,183312
train,3211,27,20736,372,53568,74304
train,3212,7,5376,25,3600,8976
train,3213,13,9984,86,12384,22368
train,3214,28,21504,400,57600,79104
train,3215,26,19968,345,49680,69648
train,3216,20,15360,204,29376,44736
train,3217,27,20736,372,53568,74304
train,3218,25,19200,319,45936,65136
train,3219,17,13056,147,21168,34224
train,3220,11,8448,62,8928,17376
train,3221,23,17664,270,38880,56544
train,3222,4,3072,8,1152,4224
train,3223,43,33024,943,135792,168816
train,3224,8,6144,33,4752,10896
train,3225,41,31488,858,123552,155040
train,3226,10,7680,51,7344,15024
train,3227,21,16128,225,32400,48528
train,3228,21,16128,225,32400,48528
train,3229,21,16128,225,32400,48528
train,3230,21,16128,225,32400,48528
train,3231,7,5376,25,3600,8976
train,3232,21,16128,225,32400,48528
train,3233,12,9216,73,10512,19728
train,3234,17,13056,147,21168,34224
train,3235,15,11520,115,16560,28080
train,3236,15,11520,115,16560,28080
train,3237,32,24576,522,75168,99744
train,3238,8,6144,33,4752,10896
train,3239,30,23040,459,66096,89136
train,3240,10,7680,51,7344,15024
train,3241,10,7680,51,7344,15024
train,3242,17,13056,147,21168,34224
train,3243,25,19200,319,45936,65136
train,3244,21,16128,225,32400,48528
train,3245,11,8448,62,8928,17376
train,3246,32,24576,522,75168,99744
train,3247,22,16896,247,35568,52464
train,3248,16,12288,131,18864,31152
train,3249,19,14592,184,26496,41088
train,3250,17,13056,147,21168,34224
train,3251,36,27648,661,95184,122832
train,3252,6,4608,18,2592,7200
train,3253,46,35328,1079,155376,190704
train,3254,42,32256,900,129600,161856
train,3255,44,33792,988,142272,176064
train,3256,33,25344,556,80064,105408
train,3257,34,26112,590,84960,111072
train,3258,15,11520,115,16560,28080
train,3259,38,29184,737,106128,135312
train,3260,34,26112,590,84960,111072
train,3261,18,13824,165,23760,37584
train,3262,37,28416,698,100512,128928
train,3263,20,15360,204,29376,44736
train,3264,21,16128,225,32400,48528
train,3265,19,14592,184,26496,41088
train,3266,30,23040,459,66096,89136
train,3267,14,10752,100,14400,25152
train,3268,22,16896,247,35568,52464
train,3269,36,27648,661,95184,122832
train,3270,28,21504,400,57600,79104
train,3271,26,19968,345,49680,69648
train,3272,15,11520,115,16560,28080
train,3273,14,10752,100,14400,25152
train,3274,19,14592,184,26496,41088
train,3275,17,13056,147,21168,34224
train,3276,4,3072,8,1152,4224
train,3277,48,36864,1175,169200,206064
train,3278,32,24576,522,75168,99744
train,3279,39,29952,776,111744,141696
train,3280,26,19968,345,49680,69648
train,3281,22,16896,247,35568,52464
train,3282,8,6144,33,4752,10896
train,3283,31,23808,490,70560,94368
train,3284,8,6144,33,4752,10896
train,3285,15,11520,115,16560,28080
train,3286,15,11520,115,16560,28080
train,3287,21,16128,225,32400,48528
train,3288,17,13056,147,21168,34224
train,3289,27,20736,372,53568,74304
train,3290,16,12288,131,18864,31152
train,3291,40,30720,816,117504,148224
train,3292,30,23040,459,66096,89136
train,3293,7,5376,25,3600,8976
train,3294,18,13824,165,23760,37584
train,3295,52,39936,1379,198576,238512
train,3296,5,3840,13,1872,5712
train,3297,16,12288,131,18864,31152
train,3298,13,9984,86,12384,22368
train,3299,9,6912,41,5904,12816
train,3300,56,43008,1600,230400,273408
train,3301,24,18432,294,42336,60768
train,3302,17,13056,147,21168,34224
train,3303,21,16128,225,32400,48528
train,3304,21,16128,225,32400,48528
train,3305,30,23040,459,66096,89136
train,3306,19,14592,184,26496,41088
train,3307,28,21504,400,57600,79104
train,3308,5,3840,13,1872,5712
train,3309,8,6144,33,4752,10896
train,3310,7,5376,25,3600,8976
train,3311,11,8448,62,8928,17376
train,3312,7,5376,25,3600,8976
train,3313,36,27648,661,95184,122832
train,3314,10,7680,51,7344,15024
train,3315,4,3072,8,1152,4224
train,3316,17,13056,147,21168,34224
train,3317,35,26880,625,90000,116880
train,3318,12,9216,73,10512,19728
train,3319,31,23808,490,70560,94368
train,3320,30,23040,459,66096,89136
train,3321,25,19200,319,45936,65136
train,3322,30,23040,459,66096,89136
train,3323,13,9984,86,12384,22368
train,3324,26,19968,345,49680,69648
train,3325,19,14592,184,26496,41088
train,3326,26,19968,345,49680,69648
train,3327,50,38400,1275,183600,222000
train,3328,36,27648,661,95184,122832
train,3329,18,13824,165,23760,37584
train,3330,13,9984,86,12384,22368
train,3331,12,9216,73,10512,19728
train,3332,28,21504,400,57600,79104
train,3333,22,16896,247,35568,52464
train,3334,35,26880,625,90000,116880
train,3335,24,18432,294,42336,60768
train,3336,26,19968,345,49680,69648
train,3337,26,19968,345,49680,69648
train,3338,33,25344,556,80064,105408
train,3339,41,31488,858,123552,155040
train,3340,21,16128,225,32400,48528
train,3341,14,10752,100,14400,25152
train,3342,23,17664,270,38880,56544
train,3343,21,16128,225,32400,48528
train,3344,15,11520,115,16560,28080
train,3345,17,13056,147,21168,34224
train,3346,11,8448,62,8928,17376
train,3347,20,15360,204,29376,44736
train,3348,10,7680,51,7344,15024
train,3349,40,30720,816,117504,148224
train,3350,4,3072,8,1152,4224
train,3351,36,27648,661,95184,122832
train,3352,6,4608,18,2592,7200
train,3353,50,38400,1275,183600,222000
train,3354,14,10752,100,14400,25152
train,3355,17,13056,147,21168,34224
train,3356,20,15360,204,29376,44736
train,3357,18,13824,165,23760,37584
train,3358,39,29952,776,111744,141696
train,3359,11,8448,62,8928,17376
train,3360,21,16128,225,32400,48528
train,3361,24,18432,294,42336,60768
train,3362,7,5376,25,3600,8976
train,3363,42,32256,900,129600,161856
train,3364,20,15360,204,29376,44736
train,3365,17,13056,147,21168,34224
train,3366,4,3072,8,1152,4224
train,3367,17,13056,147,21168,34224
train,3368,37,28416,698,100512,128928
train,3369,32,24576,522,75168,99744
train,3370,13,9984,86,12384,22368
train,3371,55,42240,1543,222192,264432
train,3372,13,9984,86,12384,22368
train,3373,36,27648,661,95184,122832
train,3374,21,16128,225,32400,48528
train,3375,30,23040,459,66096,89136
train,3376,41,31488,858,123552,155040
train,3377,8,6144,33,4752,10896
train,3378,42,32256,900,129600,161856
train,3379,30,23040,459,66096,89136
train,3380,15,11520,115,16560,28080
train,3381,8,6144,33,4752,10896
train,3382,21,16128,225,32400,48528
train,3383,27,20736,372,53568,74304
train,3384,28,21504,400,57600,79104
train,3385,36,27648,661,95184,122832
train,3386,6,4608,18,2592,7200
train,3387,24,18432,294,42336,60768
train,3388,24,18432,294,42336,60768
train,3389,22,16896,247,35568,52464
train,3390,18,13824,165,23760,37584
train,3391,37,28416,698,100512,128928
train,3392,19,14592,184,26496,41088
train,3393,18,13824,165,23760,37584
train,3394,15,11520,115,16560,28080
train,3395,21,16128,225,32400,48528
train,3396,20,15360,204,29376,44736
train,3397,42,32256,900,129600,161856
train,3398,20,15360,204,29376,44736
train,3399,30,23040,459,66096,89136
train,3400,21,16128,225,32400,48528
train,3401,18,13824,165,23760,37584
train,3402,19,14592,184,26496,41088
train,3403,35,26880,625,90000,116880
train,3404,22,16896,247,35568,52464
train,3405,21,16128,225,32400,48528
train,3406,3,2304,5,720,3024
train,3407,8,6144,33,4752,10896
train,3408,27,20736,372,53568,74304
train,3409,24,18432,294,42336,60768
train,3410,32,24576,522,75168,99744
train,3411,47,36096,1127,162288,198384
train,3412,14,10752,100,14400,25152
train,3413,12,9216,73,10512,19728
train,3414,43,33024,943,135792,168816
train,3415,22,16896,247,35568,52464
train,3416,19,14592,184,26496,41088
train,3417,44,33792,988,142272,176064
train,3418,38,29184,737,106128,135312
train,3419,7,5376,25,3600,8976
train,3420,27,20736,372,53568,74304
train,3421,4,3072,8,1152,4224
train,3422,31,23808,490,70560,94368
train,3423,38,29184,737,106128,135312
train,3424,43,33024,943,135792,168816
train,3425,26,19968,345,49680,69648
train,3426,34,26112,590,84960,111072
train,3427,13,9984,86,12384,22368
train,3428,17,13056,147,21168,34224
train,3429,6,4608,18,2592,7200
train,3430,22,16896,247,35568,52464
train,3431,4,3072,8,1152,4224
train,3432,32,24576,522,75168,99744
train,3433,35,26880,625,90000,116880
train,3434,16,12288,131,18864,31152
train,3435,16,12288,131,18864,31152
train,3436,28,21504,400,57600,79104
train,3437,31,23808,490,70560,94368
train,3438,18,13824,165,23760,37584
train,3439,7,5376,25,3600,8976
train,3440,18,13824,165,23760,37584
train,3441,33,25344,556,80064,105408
train,3442,19,14592,184,26496,41088
train,3443,19,14592,184,26496,41088
train,3444,14,10752,100,14400,25152
train,3445,23,17664,270,38880,56544
train,3446,22,16896,247,35568,52464
train,3447,40,30720,816,117504,148224
train,3448,27,20736,372,53568,74304
train,3449,2,1536,2,288,1824
train,3450,16,12288,131,18864,31152
train,3451,41,31488,858,123552,155040
train,3452,19,14592,184,26496,41088
train,3453,9,6912,41,5904,12816
train,3454,32,24576,522,75168,99744
train,3455,30,23040,459,66096,89136
train,3456,10,7680,51,7344,15024
train,3457,16,12288,131,18864,31152
train,3458,8,6144,33,4752,10896
train,3459,37,28416,698,100512,128928
train,3460,44,33792,988,142272,176064
train,3461,28,21504,400,57600,79104
train,3462,27,20736,372,53568,74304
train,3463,17,13056,147,21168,34224
train,3464,13,9984,86,12384,22368
train,3465,38,29184,737,106128,135312
train,3466,30,23040,459,66096,89136
train,3467,31,23808,490,70560,94368
train,3468,17,13056,147,21168,34224
train,3469,14,10752,100,14400,25152
train,3470,13,9984,86,12384,22368
train,3471,23,17664,270,38880,56544
train,3472,34,26112,590,84960,111072
train,3473,6,4608,18,2592,7200
train,3474,39,29952,776,111744,141696
train,3475,12,9216,73,10512,19728
train,3476,10,7680,51,7344,15024
train,3477,29,22272,429,61776,84048
train,3478,32,24576,522,75168,99744
train,3479,21,16128,225,32400,48528
train,3480,10,7680,51,7344,15024
train,3481,40,30720,816,117504,148224
train,3482,27,20736,372,53568,74304
train,3483,32,24576,522,75168,99744
train,3484,18,13824,165,23760,37584
train,3485,32,24576,522,75168,99744
train,3486,32,24576,522,75168,99744
train,3487,17,13056,147,21168,34224
train,3488,36,27648,661,95184,122832
train,3489,15,11520,115,16560,28080
train,3490,39,29952,776,111744,141696
train,3491,39,29952,776,111744,141696
train,3492,8,6144,33,4752,10896
train,3493,42,32256,900,129600,161856
train,3494,14,10752,100,14400,25152
train,3495,5,3840,13,1872,5712
train,3496,13,9984,86,12384,22368
train,3497,24,18432,294,42336,60768
train,3498,19,14592,184,26496,41088
train,3499,18,13824,165,23760,37584
train,3500,20,15360,204,29376,44736
train,3501,24,18432,294,42336,60768
train,3502,17,13056,147,21168,34224
train,3503,31,23808,490,70560,94368
train,3504,38,29184,737,106128,135312
train,3505,20,15360,204,29376,44736
train,3506,26,19968,345,49680,69648
train,3507,43,33024,943,135792,168816
train,3508,9,6912,41,5904,12816
train,3509,16,12288,131,18864,31152
train,3510,19,14592,184,26496,41088
train,3511,19,14592,184,26496,41088
train,3512,28,21504,400,57600,79104
train,3513,22,16896,247,35568,52464
train,3514,30,23040,459,66096,89136
train,3515,8,6144,33,4752,10896
train,3516,34,26112,590,84960,111072
train,3517,31,23808,490,70560,94368
train,3518,8,6144,33,4752,10896
train,3519,9,6912,41,5904,12816
train,3520,16,12288,131,18864,31152
train,3521,24,18432,294,42336,60768
train,3522,9,6912,41,5904,12816
train,3523,9,6912,41,5904,12816
train,3524,12,9216,73,10512,19728
train,3525,21,16128,225,32400,48528
train,3526,31,23808,490,70560,94368
train,3527,8,6144,33,4752,10896
train,3528,8,6144,33,4752,10896
train,3529,28,21504,400,57600,79104
train,3530,21,16128,225,32400,48528
train,3531,6,4608,18,2592,7200
train,3532,22,16896,247,35568,52464
train,3533,18,13824,165,23760,37584
train,3534,7,5376,25,3600,8976
train,3535,6,4608,18,2592,7200
train,3536,23,17664,270,38880,56544
train,3537,23,17664,270,38880,56544
train,3538,29,22272,429,61776,84048
train,3539,16,12288,131,18864,31152
train,3540,49,37632,1225,176400,214032
train,3541,22,16896,247,35568,52464
train,3542,19,14592,184,26496,41088
train,3543,34,26112,590,84960,111072
train,3544,7,5376,25,3600,8976
train,3545,23,17664,270,38880,56544
train,3546,14,10752,100,14400,25152
train,3547,5,3840,13,1872,5712
train,3548,23,17664,270,38880,56544
train,3549,17,13056,147,21168,34224
train,3550,38,29184,737,106128,135312
train,3551,26,19968,345,49680,69648
train,3552,13,9984,86,12384,22368
train,3553,28,21504,400,57600,79104
train,3554,33,25344,556,80064,105408
train,3555,37,28416,698,100512,128928
train,3556,14,10752,100,14400,25152
train,3557,25,19200,319,45936,65136
train,3558,19,14592,184,26496,41088
train,3559,6,4608,18,2592,7200
train,3560,28,21504,400,57600,79104
train,3561,10,7680,51,7344,15024
train,3562,22,16896,247,35568,52464
train,3563,33,25344,556,80064,105408
train,3564,22,16896,247,35568,52464
train,3565,25,19200,319,45936,65136
train,3566,23,17664,270,38880,56544
train,3567,18,13824,165,23760,37584
train,3568,6,4608,18,2592,7200
train,3569,31,23808,490,70560,94368
train,3570,23,17664,270,38880,56544
train,3571,17,13056,147,21168,34224
train,3572,15,11520,115,16560,28080
train,3573,30,23040,459,66096,89136
train,3574,12,9216,73,10512,19728
train,3575,25,19200,319,45936,65136
train,3576,36,27648,661,95184,122832
train,3577,29,22272,429,61776,84048
train,3578,8,6144,33,4752,10896
train,3579,14,10752,100,14400,25152
train,3580,27,20736,372,53568,74304
train,3581,18,13824,165,23760,37584
train,3582,23,17664,270,38880,56544
train,3583,8,6144,33,4752,10896
train,3584,18,13824,165,23760,37584
train,3585,14,10752,100,14400,25152
train,3586,21,16128,225,32400,48528
train,3587,14,10752,100,14400,25152
train,3588,25,19200,319,45936,65136
train,3589,19,14592,184,26496,41088
train,3590,10,7680,51,7344,15024
train,3591,6,4608,18,2592,7200
train,3592,44,33792,988,142272,176064
train,3593,38,29184,737,106128,135312
train,3594,35,26880,625,90000,116880
train,3595,19,14592,184,26496,41088
train,3596,16,12288,131,18864,31152
train,3597,16,12288,131,18864,31152
train,3598,30,23040,459,66096,89136
train,3599,8,6144,33,4752,10896
train,3600,23,17664,270,38880,56544
train,3601,24,18432,294,42336,60768
train,3602,10,7680,51,7344,15024
train,3603,31,23808,490,70560,94368
train,3604,50,38400,1275,183600,222000
train,3605,15,11520,115,16560,28080
train,3606,42,32256,900,129600,161856
train,3607,55,42240,1543,222192,264432
train,3608,20,15360,204,29376,44736
train,3609,10,7680,51,7344,15024
train,3610,19,14592,184,26496,41088
train,3611,19,14592,184,26496,41088
train,3612,26,19968,345,49680,69648
train,3613,33,25344,556,80064,105408
train,3614,34,26112,590,84960,111072
train,3615,23,17664,270,38880,56544
train,3616,23,17664,270,38880,56544
train,3617,24,18432,294,42336,60768
train,3618,30,23040,459,66096,89136
train,3619,40,30720,816,117504,148224
train,3620,26,19968,345,49680,69648
train,3621,15,11520,115,16560,28080
train,3622,30,23040,459,66096,89136
train,3623,30,23040,459,66096,89136
train,3624,13,9984,86,12384,22368
train,3625,15,11520,115,16560,28080
train,3626,20,15360,204,29376,44736
train,3627,36,27648,661,95184,122832
train,3628,27,20736,372,53568,74304
train,3629,22,16896,247,35568,52464
train,3630,11,8448,62,8928,17376
train,3631,11,8448,62,8928,17376
train,3632,12,9216,73,10512,19728
train,3633,9,6912,41,5904,12816
train,3634,22,16896,247,35568,52464
train,3635,13,9984,86,12384,22368
train,3636,21,16128,225,32400,48528
train,3637,39,29952,776,111744,141696
train,3638,19,14592,184,26496,41088
train,3639,26,19968,345,49680,69648
train,3640,13,9984,86,12384,22368
train,3641,31,23808,490,70560,94368
train,3642,31,23808,490,70560,94368
train,3643,28,21504,400,57600,79104
train,3644,34,26112,590,84960,111072
train,3645,7,5376,25,3600,8976
train,3646,16,12288,131,18864,31152
train,3647,38,29184,737,106128,135312
train,3648,10,7680,51,7344,15024
train,3649,21,16128,225,32400,48528
train,3650,8,6144,33,4752,10896
train,3651,20,15360,204,29376,44736
train,3652,24,18432,294,42336,60768
train,3653,32,24576,522,75168,99744
train,3654,10,7680,51,7344,15024
train,3655,21,16128,225,32400,48528
train,3656,27,20736,372,53568,74304
train,3657,24,18432,294,42336,60768
train,3658,34,26112,590,84960,111072
train,3659,26,19968,345,49680,69648
train,3660,22,16896,247,35568,52464
train,3661,3,2304,5,720,3024
train,3662,32,24576,522,75168,99744
train,3663,21,16128,225,32400,48528
train,3664,12,9216,73,10512,19728
train,3665,18,13824,165,23760,37584
train,3666,27,20736,372,53568,74304
train,3667,46,35328,1079,155376,190704
train,3668,24,18432,294,42336,60768
train,3669,22,16896,247,35568,52464
train,3670,22,16896,247,35568,52464
train,3671,18,13824,165,23760,37584
train,3672,31,23808,490,70560,94368
train,3673,32,24576,522,75168,99744
train,3674,43,33024,943,135792,168816
train,3675,20,15360,204,29376,44736
train,3676,27,20736,372,53568,74304
train,3677,6,4608,18,2592,7200
train,3678,7,5376,25,3600,8976
train,3679,14,10752,100,14400,25152
train,3680,34,26112,590,84960,111072
train,3681,17,13056,147,21168,34224
train,3682,10,7680,51,7344,15024
train,3683,14,10752,100,14400,25152
train,3684,24,18432,294,42336,60768
train,3685,24,18432,294,42336,60768
train,3686,10,7680,51,7344,15024
train,3687,28,21504,400,57600,79104
train,3688,36,27648,661,95184,122832
train,3689,20,15360,204,29376,44736
train,3690,29,22272,429,61776,84048
train,3691,35,26880,625,90000,116880
train,3692,16,12288,131,18864,31152
train,3693,47,36096,1127,162288,198384
train,3694,14,10752,100,14400,25152
train,3695,25,19200,319,45936,65136
train,3696,32,24576,522,75168,99744
train,3697,29,22272,429,61776,84048
train,3698,13,9984,86,12384,22368
train,3699,19,14592,184,26496,41088
train,3700,19,14592,184,26496,41088
train,3701,30,23040,459,66096,89136
train,3702,39,29952,776,111744,141696
train,3703,41,31488,858,123552,155040
train,3704,19,14592,184,26496,41088
train,3705,38,29184,737,106128,135312
train,3706,17,13056,147,21168,34224
train,3707,32,24576,522,75168,99744
train,3708,14,10752,100,14400,25152
train,3709,35,26880,625,90000,116880
train,3710,34,26112,590,84960,111072
train,3711,19,14592,184,26496,41088
train,3712,14,10752,100,14400,25152
train,3713,39,29952,776,111744,141696
train,3714,27,20736,372,53568,74304
train,3715,30,23040,459,66096,89136
train,3716,18,13824,165,23760,37584
train,3717,54,41472,1488,214272,255744
train,3718,24,18432,294,42336,60768
train,3719,18,13824,165,23760,37584
train,3720,23,17664,270,38880,56544
train,3721,25,19200,319,45936,65136
train,3722,15,11520,115,16560,28080
train,3723,17,13056,147,21168,34224
train,3724,21,16128,225,32400,48528
train,3725,38,29184,737,106128,135312
train,3726,31,23808,490,70560,94368
train,3727,4,3072,8,1152,4224
train,3728,9,6912,41,5904,12816
train,3729,18,13824,165,23760,37584
train,3730,53,40704,1433,206352,247056
train,3731,21,16128,225,32400,48528
train,3732,20,15360,204,29376,44736
train,3733,22,16896,247,35568,52464
train,3734,34,26112,590,84960,111072
train,3735,19,14592,184,26496,41088
train,3736,51,39168,1327,191088,230256
train,3737,24,18432,294,42336,60768
train,3738,25,19200,319,45936,65136
train,3739,22,16896,247,35568,52464
train,3740,20,15360,204,29376,44736
train,3741,31,23808,490,70560,94368
train,3742,30,23040,459,66096,89136
train,3743,31,23808,490,70560,94368
train,3744,47,36096,1127,162288,198384
train,3745,23,17664,270,38880,56544
train,3746,26,19968,345,49680,69648
train,3747,42,32256,900,129600,161856
train,3748,9,6912,41,5904,12816
train,3749,26,19968,345,49680,69648
train,3750,10,7680,51,7344,15024
train,3751,34,26112,590,84960,111072
train,3752,39,29952,776,111744,141696
train,3753,17,13056,147,21168,34224
train,3754,24,18432,294,42336,60768
train,3755,20,15360,204,29376,44736
train,3756,19,14592,184,26496,41088
train,3757,8,6144,33,4752,10896
train,3758,9,6912,41,5904,12816
train,3759,50,38400,1275,183600,222000
train,3760,13,9984,86,12384,22368
train,3761,21,16128,225,32400,48528
train,3762,9,6912,41,5904,12816
train,3763,25,19200,319,45936,65136
train,3764,9,6912,41,5904,12816
train,3765,36,27648,661,95184,122832
train,3766,34,26112,590,84960,111072
train,3767,31,23808,490,70560,94368
train,3768,20,15360,204,29376,44736
train,3769,26,19968,345,49680,69648
train,3770,10,7680,51,7344,15024
train,3771,17,13056,147,21168,34224
train,3772,31,23808,490,70560,94368
train,3773,11,8448,62,8928,17376
train,3774,12,9216,73,10512,19728
train,3775,36,27648,661,95184,122832
train,3776,24,18432,294,42336,60768
train,3777,53,40704,1433,206352,247056
train,3778,57,43776,1658,238752,282528
train,3779,27,20736,372,53568,74304
train,3780,27,20736,372,53568,74304
train,3781,33,25344,556,80064,105408
train,3782,33,25344,556,80064,105408
train,3783,26,19968,345,49680,69648
train,3784,47,36096,1127,162288,198384
train,3785,12,9216,73,10512,19728
train,3786,17,13056,147,21168,34224
train,3787,17,13056,147,21168,34224
train,3788,33,25344,556,80064,105408
train,3789,45,34560,1033,148752,183312
train,3790,17,13056,147,21168,34224
train,3791,21,16128,225,32400,48528
train,3792,13,9984,86,12384,22368
train,3793,43,33024,943,135792,168816
train,3794,30,23040,459,66096,89136
train,3795,38,29184,737,106128,135312
train,3796,24,18432,294,42336,60768
train,3797,8,6144,33,4752,10896
train,3798,16,12288,131,18864,31152
train,3799,36,27648,661,95184,122832
train,3800,16,12288,131,18864,31152
train,3801,20,15360,204,29376,44736
train,3802,18,13824,165,23760,37584
train,3803,55,42240,1543,222192,264432
train,3804,22,16896,247,35568,52464
train,3805,4,3072,8,1152,4224
train,3806,21,16128,225,32400,48528
train,3807,13,9984,86,12384,22368
train,3808,12,9216,73,10512,19728
train,3809,20,15360,204,29376,44736
train,3810,28,21504,400,57600,79104
train,3811,45,34560,1033,148752,183312
train,3812,21,16128,225,32400,48528
train,3813,16,12288,131,18864,31152
train,3814,18,13824,165,23760,37584
train,3815,43,33024,943,135792,168816
train,3816,34,26112,590,84960,111072
train,3817,9,6912,41,5904,12816
train,3818,9,6912,41,5904,12816
train,3819,38,29184,737,106128,135312
train,3820,27,20736,372,53568,74304
train,3821,16,12288,131,18864,31152
train,3822,14,10752,100,14400,25152
train,3823,28,21504,400,57600,79104
train,3824,22,16896,247,35568,52464
train,3825,22,16896,247,35568,52464
train,3826,18,13824,165,23760,37584
train,3827,26,19968,345,49680,69648
train,3828,22,16896,247,35568,52464
train,3829,30,23040,459,66096,89136
train,3830,17,13056,147,21168,34224
train,3831,11,8448,62,8928,17376
train,3832,16,12288,131,18864,31152
train,3833,39,29952,776,111744,141696
train,3834,17,13056,147,21168,34224
train,3835,4,3072,8,1152,4224
train,3836,13,9984,86,12384,22368
train,3837,13,9984,86,12384,22368
train,3838,52,39936,1379,198576,238512
train,3839,21,16128,225,32400,48528
train,3840,27,20736,372,53568,74304
train,3841,33,25344,556,80064,105408
train,3842,29,22272,429,61776,84048
train,3843,25,19200,319,45936,65136
train,3844,45,34560,1033,148752,183312
train,3845,10,7680,51,7344,15024
train,3846,29,22272,429,61776,84048
train,3847,22,16896,247,35568,52464
train,3848,60,46080,1837,264528,310608
train,3849,12,9216,73,10512,19728
train,3850,26,19968,345,49680,69648
train,3851,23,17664,270,38880,56544
train,3852,23,17664,270,38880,56544
train,3853,27,20736,372,53568,74304
train,3854,11,8448,62,8928,17376
train,3855,12,9216,73,10512,19728
train,3856,25,19200,319,45936,65136
train,3857,31,23808,490,70560,94368
train,3858,23,17664,270,38880,56544
train,3859,14,10752,100,14400,25152
train,3860,24,18432,294,42336,60768
train,3861,43,33024,943,135792,168816
train,3862,27,20736,372,53568,74304
train,3863,35,26880,625,90000,116880
train,3864,15,11520,115,16560,28080
train,3865,24,18432,294,42336,60768
train,3866,39,29952,776,111744,141696
train,3867,40,30720,816,117504,148224
train,3868,29,22272,429,61776,84048
train,3869,17,13056,147,21168,34224
train,3870,36,27648,661,95184,122832
train,3871,20,15360,204,29376,44736
train,3872,12,9216,73,10512,19728
train,3873,3,2304,5,720,3024
train,3874,6,4608,18,2592,7200
train,3875,8,6144,33,4752,10896
train,3876,18,13824,165,23760,37584
train,3877,23,17664,270,38880,56544
train,3878,10,7680,51,7344,15024
train,3879,27,20736,372,53568,74304
train,3880,7,5376,25,3600,8976
train,3881,14,10752,100,14400,25152
train,3882,3,2304,5,720,3024
train,3883,22,16896,247,35568,52464
train,3884,40,30720,816,117504,148224
train,3885,29,22272,429,61776,84048
train,3886,17,13056,147,21168,34224
train,3887,37,28416,698,100512,128928
train,3888,34,26112,590,84960,111072
train,3889,19,14592,184,26496,41088
train,3890,20,15360,204,29376,44736
train,3891,12,9216,73,10512,19728
train,3892,19,14592,184,26496,41088
train,3893,6,4608,18,2592,7200
train,3894,20,15360,204,29376,44736
train,3895,38,29184,737,106128,135312
train,3896,51,39168,1327,191088,230256
train,3897,11,8448,62,8928,17376
train,3898,29,22272,429,61776,84048
train,3899,21,16128,225,32400,48528
train,3900,5,3840,13,1872,5712
train,3901,25,19200,319,45936,65136
train,3902,22,16896,247,35568,52464
train,3903,17,13056,147,21168,34224
train,3904,21,16128,225,32400,48528
train,3905,10,7680,51,7344,15024
train,3906,24,18432,294,42336,60768
train,3907,9,6912,41,5904,12816
train,3908,28,21504,400,57600,79104
train,3909,6,4608,18,2592,7200
train,3910,20,15360,204,29376,44736
train,3911,13,9984,86,12384,22368
train,3912,28,21504,400,57600,79104
train,3913,6,4608,18,2592,7200
train,3914,19,14592,184,26496,41088
train,3915,28,21504,400,57600,79104
train,3916,11,8448,62,8928,17376
train,3917,32,24576,522,75168,99744
train,3918,13,9984,86,12384,22368
train,3919,30,23040,459,66096,89136
train,3920,7,5376,25,3600,8976
train,3921,33,25344,556,80064,105408
train,3922,15,11520,115,16560,28080
train,3923,35,26880,625,90000,116880
train,3924,19,14592,184,26496,41088
train,3925,35,26880,625,90000,116880
train,3926,41,31488,858,123552,155040
train,3927,13,9984,86,12384,22368
train,3928,21,16128,225,32400,48528
train,3929,10,7680,51,7344,15024
train,3930,31,23808,490,70560,94368
train,3931,30,23040,459,66096,89136
train,3932,7,5376,25,3600,8976
train,3933,19,14592,184,26496,41088
train,3934,30,23040,459,66096,89136
train,3935,29,22272,429,61776,84048
train,3936,30,23040,459,66096,89136
train,3937,32,24576,522,75168,99744
train,3938,17,13056,147,21168,34224
train,3939,11,8448,62,8928,17376
train,3940,34,26112,590,84960,111072
train,3941,33,25344,556,80064,105408
train,3942,21,16128,225,32400,48528
train,3943,13,9984,86,12384,22368
train,3944,35,26880,625,90000,116880
train,3945,24,18432,294,42336,60768
train,3946,27,20736,372,53568,74304
train,3947,9,6912,41,5904,12816
train,3948,9,6912,41,5904,12816
train,3949,45,34560,1033,148752,183312
train,3950,33,25344,556,80064,105408
train,3951,19,14592,184,26496,41088
train,3952,22,16896,247,35568,52464
train,3953,13,9984,86,12384,22368
train,3954,22,16896,247,35568,52464
train,3955,14,10752,100,14400,25152
train,3956,18,13824,165,23760,37584
train,3957,28,21504,400,57600,79104
train,3958,42,32256,900,129600,161856
train,3959,21,16128,225,32400,48528
train,3960,27,20736,372,53568,74304
train,3961,13,9984,86,12384,22368
train,3962,20,15360,204,29376,44736
train,3963,7,5376,25,3600,8976
train,3964,34,26112,590,84960,111072
train,3965,21,16128,225,32400,48528
train,3966,37,28416,698,100512,128928
train,3967,25,19200,319,45936,65136
train,3968,14,10752,100,14400,25152
train,3969,11,8448,62,8928,17376
train,3970,39,29952,776,111744,141696
train,3971,11,8448,62,8928,17376
train,3972,31,23808,490,70560,94368
train,3973,15,11520,115,16560,28080
train,3974,30,23040,459,66096,89136
train,3975,21,16128,225,32400,48528
train,3976,48,36864,1175,169200,206064
train,3977,35,26880,625,90000,116880
train,3978,29,22272,429,61776,84048
train,3979,8,6144,33,4752,10896
train,3980,24,18432,294,42336,60768
train,3981,14,10752,100,14400,25152
train,3982,33,25344,556,80064,105408
train,3983,42,32256,900,129600,161856
train,3984,31,23808,490,70560,94368
train,3985,18,13824,165,23760,37584
train,3986,38,29184,737,106128,135312
train,3987,23,17664,270,38880,56544
train,3988,37,28416,698,100512,128928
train,3989,20,15360,204,29376,44736
train,3990,33,25344,556,80064,105408
train,3991,28,21504,400,57600,79104
train,3992,37,28416,698,100512,128928
train,3993,21,16128,225,32400,48528
train,3994,23,17664,270,38880,56544
train,3995,32,24576,522,75168,99744
train,3996,44,33792,988,142272,176064
train,3997,17,13056,147,21168,34224
train,3998,24,18432,294,42336,60768
train,3999,31,23808,490,70560,94368
train,4000,12,9216,73,10512,19728
train,4001,23,17664,270,38880,56544
train,4002,34,26112,590,84960,111072
train,4003,31,23808,490,70560,94368
train,4004,14,10752,100,14400,25152
train,4005,9,6912,41,5904,12816
train,4006,24,18432,294,42336,60768
train,4007,25,19200,319,45936,65136
train,4008,32,24576,522,75168,99744
train,4009,20,15360,204,29376,44736
train,4010,24,18432,294,42336,60768
train,4011,10,7680,51,7344,15024
train,4012,5,3840,13,1872,5712
train,4013,26,19968,345,49680,69648
train,4014,30,23040,459,66096,89136
train,4015,33,25344,556,80064,105408
train,4016,27,20736,372,53568,74304
train,4017,11,8448,62,8928,17376
train,4018,13,9984,86,12384,22368
train,4019,35,26880,625,90000,116880
train,4020,42,32256,900,129600,161856
train,4021,38,29184,737,106128,135312
train,4022,36,27648,661,95184,122832
train,4023,21,16128,225,32400,48528
train,4024,39,29952,776,111744,141696
train,4025,35,26880,625,90000,116880
train,4026,35,26880,625,90000,116880
train,4027,21,16128,225,32400,48528
train,4028,25,19200,319,45936,65136
train,4029,43,33024,943,135792,168816
train,4030,13,9984,86,12384,22368
train,4031,2,1536,2,288,1824
train,4032,13,9984,86,12384,22368
train,4033,8,6144,33,4752,10896
train,4034,57,43776,1658,238752,282528
train,4035,19,14592,184,26496,41088
train,4036,37,28416,698,100512,128928
train,4037,19,14592,184,26496,41088
train,4038,27,20736,372,53568,74304
train,4039,31,23808,490,70560,94368
train,4040,21,16128,225,32400,48528
train,4041,32,24576,522,75168,99744
train,4042,5,3840,13,1872,5712
train,4043,27,20736,372,53568,74304
train,4044,21,16128,225,32400,48528
train,4045,14,10752,100,14400,25152
train,4046,19,14592,184,26496,41088
train,4047,5,3840,13,1872,5712
train,4048,8,6144,33,4752,10896
train,4049,28,21504,400,57600,79104
train,4050,21,16128,225,32400,48528
train,4051,24,18432,294,42336,60768
train,4052,7,5376,25,3600,8976
train,4053,16,12288,131,18864,31152
train,4054,26,19968,345,49680,69648
train,4055,23,17664,270,38880,56544
train,4056,9,6912,41,5904,12816
train,4057,32,24576,522,75168,99744
train,4058,21,16128,225,32400,48528
train,4059,25,19200,319,45936,65136
train,4060,7,5376,25,3600,8976
train,4061,32,24576,522,75168,99744
train,4062,27,20736,372,53568,74304
train,4063,11,8448,62,8928,17376
train,4064,21,16128,225,32400,48528
train,4065,26,19968,345,49680,69648
train,4066,11,8448,62,8928,17376
train,4067,7,5376,25,3600,8976
train,4068,51,39168,1327,191088,230256
train,4069,9,6912,41,5904,12816
train,4070,11,8448,62,8928,17376
train,4071,5,3840,13,1872,5712
train,4072,20,15360,204,29376,44736
train,4073,13,9984,86,12384,22368
train,4074,28,21504,400,57600,79104
train,4075,10,7680,51,7344,15024
train,4076,30,23040,459,66096,89136
train,4077,38,29184,737,106128,135312
train,4078,12,9216,73,10512,19728
train,4079,21,16128,225,32400,48528
train,4080,15,11520,115,16560,28080
train,4081,33,25344,556,80064,105408
train,4082,35,26880,625,90000,116880
train,4083,25,19200,319,45936,65136
train,4084,20,15360,204,29376,44736
train,4085,55,42240,1543,222192,264432
train,4086,36,27648,661,95184,122832
train,4087,27,20736,372,53568,74304
train,4088,30,23040,459,66096,89136
train,4089,10,7680,51,7344,15024
train,4090,12,9216,73,10512,19728
train,4091,23,17664,270,38880,56544
train,4092,21,16128,225,32400,48528
train,4093,9,6912,41,5904,12816
train,4094,33,25344,556,80064,105408
train,4095,27,20736,372,53568,74304
train,4096,8,6144,33,4752,10896
train,4097,13,9984,86,12384,22368
train,4098,30,23040,459,66096,89136
train,4099,48,36864,1175,169200,206064
train,4100,35,26880,625,90000,116880
train,4101,40,30720,816,117504,148224
train,4102,3,2304,5,720,3024
train,4103,24,18432,294,42336,60768
train,4104,38,29184,737,106128,135312
train,4105,16,12288,131,18864,31152
train,4106,2,1536,2,288,1824
train,4107,21,16128,225,32400,48528
train,4108,15,11520,115,16560,28080
train,4109,51,39168,1327,191088,230256
train,4110,26,19968,345,49680,69648
train,4111,36,27648,661,95184,122832
train,4112,28,21504,400,57600,79104
train,4113,30,23040,459,66096,89136
train,4114,9,6912,41,5904,12816
train,4115,17,13056,147,21168,34224
train,4116,32,24576,522,75168,99744
train,4117,12,9216,73,10512,19728
train,4118,42,32256,900,129600,161856
train,4119,27,20736,372,53568,74304
train,4120,12,9216,73,10512,19728
train,4121,25,19200,319,45936,65136
train,4122,41,31488,858,123552,155040
train,4123,20,15360,204,29376,44736
train,4124,21,16128,225,32400,48528
train,4125,39,29952,776,111744,141696
train,4126,14,10752,100,14400,25152
train,4127,9,6912,41,5904,12816
train,4128,31,23808,490,70560,94368
train,4129,44,33792,988,142272,176064
train,4130,42,32256,900,129600,161856
train,4131,28,21504,400,57600,79104
train,4132,12,9216,73,10512,19728
train,4133,21,16128,225,32400,48528
train,4134,26,19968,345,49680,69648
train,4135,14,10752,100,14400,25152
train,4136,30,23040,459,66096,89136
train,4137,36,27648,661,95184,122832
train,4138,26,19968,345,49680,69648
train,4139,41,31488,858,123552,155040
train,4140,11,8448,62,8928,17376
train,4141,19,14592,184,26496,41088
train,4142,34,26112,590,84960,111072
train,4143,42,32256,900,129600,161856
train,4144,9,6912,41,5904,12816
train,4145,40,30720,816,117504,148224
train,4146,11,8448,62,8928,17376
train,4147,46,35328,1079,155376,190704
train,4148,31,23808,490,70560,94368
train,4149,10,7680,51,7344,15024
train,4150,28,21504,400,57600,79104
train,4151,27,20736,372,53568,74304
train,4152,32,24576,522,75168,99744
train,4153,32,24576,522,75168,99744
train,4154,40,30720,816,117504,148224
train,4155,26,19968,345,49680,69648
train,4156,18,13824,165,23760,37584
train,4157,6,4608,18,2592,7200
train,4158,9,6912,41,5904,12816
train,4159,17,13056,147,21168,34224
train,4160,12,9216,73,10512,19728
train,4161,25,19200,319,45936,65136
train,4162,17,13056,147,21168,34224
train,4163,47,36096,1127,162288,198384
train,4164,24,18432,294,42336,60768
train,4165,13,9984,86,12384,22368
train,4166,14,10752,100,14400,25152
train,4167,19,14592,184,26496,41088
train,4168,24,18432,294,42336,60768
train,4169,30,23040,459,66096,89136
train,4170,33,25344,556,80064,105408
train,4171,17,13056,147,21168,34224
train,4172,38,29184,737,106128,135312
train,4173,29,22272,429,61776,84048
train,4174,31,23808,490,70560,94368
train,4175,28,21504,400,57600,79104
train,4176,39,29952,776,111744,141696
train,4177,17,13056,147,21168,34224
train,4178,29,22272,429,61776,84048
train,4179,24,18432,294,42336,60768
train,4180,22,16896,247,35568,52464
train,4181,31,23808,490,70560,94368
train,4182,20,15360,204,29376,44736
train,4183,16,12288,131,18864,31152
train,4184,12,9216,73,10512,19728
train,4185,34,26112,590,84960,111072
train,4186,32,24576,522,75168,99744
train,4187,15,11520,115,16560,28080
train,4188,18,13824,165,23760,37584
train,4189,44,33792,988,142272,176064
train,4190,37,28416,698,100512,128928
train,4191,26,19968,345,49680,69648
train,4192,23,17664,270,38880,56544
train,4193,33,25344,556,80064,105408
train,4194,36,27648,661,95184,122832
train,4195,14,10752,100,14400,25152
train,4196,22,16896,247,35568,52464
train,4197,35,26880,625,90000,116880
train,4198,48,36864,1175,169200,206064
train,4199,18,13824,165,23760,37584
train,4200,11,8448,62,8928,17376
train,4201,21,16128,225,32400,48528
train,4202,16,12288,131,18864,31152
train,4203,27,20736,372,53568,74304
train,4204,35,26880,625,90000,116880
train,4205,11,8448,62,8928,17376
train,4206,16,12288,131,18864,31152
train,4207,32,24576,522,75168,99744
train,4208,50,38400,1275,183600,222000
train,4209,14,10752,100,14400,25152
train,4210,45,34560,1033,148752,183312
train,4211,10,7680,51,7344,15024
train,4212,34,26112,590,84960,111072
train,4213,19,14592,184,26496,41088
train,4214,31,23808,490,70560,94368
train,4215,12,9216,73,10512,19728
train,4216,28,21504,400,57600,79104
train,4217,35,26880,625,90000,116880
train,4218,8,6144,33,4752,10896
train,4219,39,29952,776,111744,141696
train,4220,29,22272,429,61776,84048
train,4221,8,6144,33,4752,10896
train,4222,26,19968,345,49680,69648
train,4223,42,32256,900,129600,161856
train,4224,21,16128,225,32400,48528
train,4225,10,7680,51,7344,15024
train,4226,47,36096,1127,162288,198384
train,4227,11,8448,62,8928,17376
train,4228,17,13056,147,21168,34224
train,4229,35,26880,625,90000,116880
train,4230,28,21504,400,57600,79104
train,4231,23,17664,270,38880,56544
train,4232,16,12288,131,18864,31152
train,4233,15,11520,115,16560,28080
train,4234,18,13824,165,23760,37584
train,4235,37,28416,698,100512,128928
train,4236,20,15360,204,29376,44736
train,4237,14,10752,100,14400,25152
train,4238,25,19200,319,45936,65136
train,4239,38,29184,737,106128,135312
train,4240,18,13824,165,23760,37584
train,4241,6,4608,18,2592,7200
train,4242,13,9984,86,12384,22368
train,4243,18,13824,165,23760,37584
train,4244,23,17664,270,38880,56544
train,4245,4,3072,8,1152,4224
train,4246,27,20736,372,53568,74304
train,4247,30,23040,459,66096,89136
train,4248,7,5376,25,3600,8976
train,4249,18,13824,165,23760,37584
train,4250,27,20736,372,53568,74304
train,4251,16,12288,131,18864,31152
train,4252,27,20736,372,53568,74304
train,4253,16,12288,131,18864,31152
train,4254,7,5376,25,3600,8976
train,4255,11,8448,62,8928,17376
train,4256,25,19200,319,45936,65136
train,4257,20,15360,204,29376,44736
train,4258,29,22272,429,61776,84048
train,4259,36,27648,661,95184,122832
train,4260,8,6144,33,4752,10896
train,4261,13,9984,86,12384,22368
train,4262,9,6912,41,5904,12816
train,4263,15,11520,115,16560,28080
train,4264,9,6912,41,5904,12816
train,4265,17,13056,147,21168,34224
train,4266,18,13824,165,23760,37584
train,4267,9,6912,41,5904,12816
train,4268,19,14592,184,26496,41088
train,4269,25,19200,319,45936,65136
train,4270,23,17664,270,38880,56544
train,4271,42,32256,900,129600,161856
train,4272,14,10752,100,14400,25152
train,4273,23,17664,270,38880,56544
train,4274,20,15360,204,29376,44736
train,4275,10,7680,51,7344,15024
train,4276,31,23808,490,70560,94368
train,4277,15,11520,115,16560,28080
train,4278,49,37632,1225,176400,214032
train,4279,20,15360,204,29376,44736
train,4280,14,10752,100,14400,25152
train,4281,25,19200,319,45936,65136
train,4282,3,2304,5,720,3024
train,4283,32,24576,522,75168,99744
train,4284,18,13824,165,23760,37584
train,4285,20,15360,204,29376,44736
train,4286,19,14592,184,26496,41088
train,4287,32,24576,522,75168,99744
train,4288,18,13824,165,23760,37584
train,4289,14,10752,100,14400,25152
train,4290,26,19968,345,49680,69648
train,4291,9,6912,41,5904,12816
train,4292,3,2304,5,720,3024
train,4293,30,23040,459,66096,89136
train,4294,35,26880,625,90000,116880
train,4295,6,4608,18,2592,7200
train,4296,18,13824,165,23760,37584
train,4297,11,8448,62,8928,17376
train,4298,30,23040,459,66096,89136
train,4299,18,13824,165,23760,37584
train,4300,2,1536,2,288,1824
train,4301,24,18432,294,42336,60768
train,4302,45,34560,1033,148752,183312
train,4303,25,19200,319,45936,65136
train,4304,14,10752,100,14400,25152
train,4305,26,19968,345,49680,69648
train,4306,47,36096,1127,162288,198384
train,4307,5,3840,13,1872,5712
train,4308,13,9984,86,12384,22368
train,4309,46,35328,1079,155376,190704
train,4310,26,19968,345,49680,69648
train,4311,32,24576,522,75168,99744
train,4312,33,25344,556,80064,105408
train,4313,17,13056,147,21168,34224
train,4314,28,21504,400,57600,79104
train,4315,30,23040,459,66096,89136
train,4316,16,12288,131,18864,31152
train,4317,14,10752,100,14400,25152
train,4318,16,12288,131,18864,31152
train,4319,25,19200,319,45936,65136
train,4320,39,29952,776,111744,141696
train,4321,15,11520,115,16560,28080
train,4322,4,3072,8,1152,4224
train,4323,17,13056,147,21168,34224
train,4324,17,13056,147,21168,34224
train,4325,8,6144,33,4752,10896
train,4326,11,8448,62,8928,17376
train,4327,16,12288,131,18864,31152
train,4328,42,32256,900,129600,161856
train,4329,28,21504,400,57600,79104
train,4330,8,6144,33,4752,10896
train,4331,22,16896,247,35568,52464
train,4332,42,32256,900,129600,161856
train,4333,32,24576,522,75168,99744
train,4334,8,6144,33,4752,10896
train,4335,19,14592,184,26496,41088
train,4336,6,4608,18,2592,7200
train,4337,41,31488,858,123552,155040
train,4338,39,29952,776,111744,141696
train,4339,37,28416,698,100512,128928
train,4340,11,8448,62,8928,17376
train,4341,19,14592,184,26496,41088
train,4342,27,20736,372,53568,74304
train,4343,10,7680,51,7344,15024
train,4344,33,25344,556,80064,105408
train,4345,9,6912,41,5904,12816
train,4346,32,24576,522,75168,99744
train,4347,22,16896,247,35568,52464
train,4348,51,39168,1327,191088,230256
train,4349,18,13824,165,23760,37584
train,4350,39,29952,776,111744,141696
train,4351,27,20736,372,53568,74304
train,4352,20,15360,204,29376,44736
train,4353,34,26112,590,84960,111072
train,4354,51,39168,1327,191088,230256
train,4355,15,11520,115,16560,28080
train,4356,14,10752,100,14400,25152
train,4357,33,25344,556,80064,105408
train,4358,21,16128,225,32400,48528
train,4359,27,20736,372,53568,74304
train,4360,32,24576,522,75168,99744
train,4361,8,6144,33,4752,10896
train,4362,16,12288,131,18864,31152
train,4363,33,25344,556,80064,105408
train,4364,25,19200,319,45936,65136
train,4365,14,10752,100,14400,25152
train,4366,26,19968,345,49680,69648
train,4367,9,6912,41,5904,12816
train,4368,41,31488,858,123552,155040
train,4369,17,13056,147,21168,34224
train,4370,2,1536,2,288,1824
train,4371,18,13824,165,23760,37584
train,4372,11,8448,62,8928,17376
train,4373,34,26112,590,84960,111072
train,4374,13,9984,86,12384,22368
train,4375,33,25344,556,80064,105408
train,4376,29,22272,429,61776,84048
train,4377,31,23808,490,70560,94368
train,4378,29,22272,429,61776,84048
train,4379,7,5376,25,3600,8976
train,4380,26,19968,345,49680,69648
train,4381,7,5376,25,3600,8976
train,4382,15,11520,115,16560,28080
train,4383,13,9984,86,12384,22368
train,4384,22,16896,247,35568,52464
train,4385,24,18432,294,42336,60768
train,4386,26,19968,345,49680,69648
train,4387,31,23808,490,70560,94368
train,4388,8,6144,33,4752,10896
train,4389,18,13824,165,23760,37584
train,4390,28,21504,400,57600,79104
train,4391,45,34560,1033,148752,183312
train,4392,40,30720,816,117504,148224
train,4393,25,19200,319,45936,65136
train,4394,26,19968,345,49680,69648
train,4395,13,9984,86,12384,22368
train,4396,15,11520,115,16560,28080
train,4397,20,15360,204,29376,44736
train,4398,32,24576,522,75168,99744
train,4399,39,29952,776,111744,141696
train,4400,30,23040,459,66096,89136
train,4401,15,11520,115,16560,28080
train,4402,13,9984,86,12384,22368
train,4403,4,3072,8,1152,4224
train,4404,36,27648,661,95184,122832
train,4405,12,9216,73,10512,19728
train,4406,32,24576,522,75168,99744
train,4407,14,10752,100,14400,25152
train,4408,33,25344,556,80064,105408
train,4409,18,13824,165,23760,37584
train,4410,21,16128,225,32400,48528
train,4411,18,13824,165,23760,37584
train,4412,26,19968,345,49680,69648
train,4413,20,15360,204,29376,44736
train,4414,17,13056,147,21168,34224
train,4415,37,28416,698,100512,128928
train,4416,16,12288,131,18864,31152
train,4417,29,22272,429,61776,84048
train,4418,9,6912,41,5904,12816
train,4419,9,6912,41,5904,12816
train,4420,56,43008,1600,230400,273408
train,4421,46,35328,1079,155376,190704
train,4422,36,27648,661,95184,122832
train,4423,28,21504,400,57600,79104
train,4424,10,7680,51,7344,15024
train,4425,16,12288,131,18864,31152
train,4426,27,20736,372,53568,74304
train,4427,13,9984,86,12384,22368
train,4428,15,11520,115,16560,28080
train,4429,20,15360,204,29376,44736
train,4430,14,10752,100,14400,25152
train,4431,27,20736,372,53568,74304
train,4432,31,23808,490,70560,94368
train,4433,24,18432,294,42336,60768
train,4434,14,10752,100,14400,25152
train,4435,18,13824,165,23760,37584
train,4436,12,9216,73,10512,19728
train,4437,31,23808,490,70560,94368
train,4438,26,19968,345,49680,69648
train,4439,20,15360,204,29376,44736
train,4440,63,48384,2025,291600,339984
train,4441,19,14592,184,26496,41088
train,4442,19,14592,184,26496,41088
train,4443,34,26112,590,84960,111072
train,4444,23,17664,270,38880,56544
train,4445,33,25344,556,80064,105408
train,4446,23,17664,270,38880,56544
train,4447,24,18432,294,42336,60768
train,4448,9,6912,41,5904,12816
train,4449,46,35328,1079,155376,190704
train,4450,16,12288,131,18864,31152
train,4451,28,21504,400,57600,79104
train,4452,25,19200,319,45936,65136
train,4453,23,17664,270,38880,56544
train,4454,14,10752,100,14400,25152
train,4455,53,40704,1433,206352,247056
train,4456,25,19200,319,45936,65136
train,4457,22,16896,247,35568,52464
train,4458,27,20736,372,53568,74304
train,4459,24,18432,294,42336,60768
train,4460,19,14592,184,26496,41088
train,4461,57,43776,1658,238752,282528
train,4462,20,15360,204,29376,44736
train,4463,26,19968,345,49680,69648
train,4464,13,9984,86,12384,22368
train,4465,8,6144,33,4752,10896
train,4466,30,23040,459,66096,89136
train,4467,33,25344,556,80064,105408
train,4468,17,13056,147,21168,34224
train,4469,26,19968,345,49680,69648
train,4470,25,19200,319,45936,65136
train,4471,24,18432,294,42336,60768
train,4472,14,10752,100,14400,25152
train,4473,24,18432,294,42336,60768
train,4474,9,6912,41,5904,12816
train,4475,18,13824,165,23760,37584
train,4476,30,23040,459,66096,89136
train,4477,10,7680,51,7344,15024
train,4478,30,23040,459,66096,89136
train,4479,20,15360,204,29376,44736
train,4480,10,7680,51,7344,15024
train,4481,14,10752,100,14400,25152
train,4482,34,26112,590,84960,111072
train,4483,12,9216,73,10512,19728
train,4484,11,8448,62,8928,17376
train,4485,25,19200,319,45936,65136
train,4486,23,17664,270,38880,56544
train,4487,33,25344,556,80064,105408
train,4488,17,13056,147,21168,34224
train,4489,26,19968,345,49680,69648
train,4490,31,23808,490,70560,94368
train,4491,12,9216,73,10512,19728
train,4492,24,18432,294,42336,60768
train,4493,17,13056,147,21168,34224
train,4494,7,5376,25,3600,8976
train,4495,24,18432,294,42336,60768
train,4496,22,16896,247,35568,52464
train,4497,21,16128,225,32400,48528
train,4498,37,28416,698,100512,128928
train,4499,25,19200,319,45936,65136
train,4500,16,12288,131,18864,31152
train,4501,25,19200,319,45936,65136
train,4502,4,3072,8,1152,4224
train,4503,42,32256,900,129600,161856
train,4504,9,6912,41,5904,12816
train,4505,29,22272,429,61776,84048
train,4506,5,3840,13,1872,5712
train,4507,15,11520,115,16560,28080
train,4508,15,11520,115,16560,28080
train,4509,18,13824,165,23760,37584
train,4510,6,4608,18,2592,7200
train,4511,33,25344,556,80064,105408
train,4512,42,32256,900,129600,161856
train,4513,18,13824,165,23760,37584
train,4514,25,19200,319,45936,65136
train,4515,8,6144,33,4752,10896
train,4516,7,5376,25,3600,8976
train,4517,17,13056,147,21168,34224
train,4518,11,8448,62,8928,17376
train,4519,33,25344,556,80064,105408
train,4520,43,33024,943,135792,168816
train,4521,31,23808,490,70560,94368
train,4522,20,15360,204,29376,44736
train,4523,30,23040,459,66096,89136
train,4524,28,21504,400,57600,79104
train,4525,19,14592,184,26496,41088
train,4526,23,17664,270,38880,56544
train,4527,20,15360,204,29376,44736
train,4528,44,33792,988,142272,176064
train,4529,10,7680,51,7344,15024
train,4530,23,17664,270,38880,56544
train,4531,17,13056,147,21168,34224
train,4532,35,26880,625,90000,116880
train,4533,19,14592,184,26496,41088
train,4534,39,29952,776,111744,141696
train,4535,7,5376,25,3600,8976
train,4536,5,3840,13,1872,5712
train,4537,11,8448,62,8928,17376
train,4538,16,12288,131,18864,31152
train,4539,25,19200,319,45936,65136
train,4540,20,15360,204,29376,44736
train,4541,28,21504,400,57600,79104
train,4542,52,39936,1379,198576,238512
train,4543,23,17664,270,38880,56544
train,4544,26,19968,345,49680,69648
train,4545,14,10752,100,14400,25152
train,4546,27,20736,372,53568,74304
train,4547,29,22272,429,61776,84048
train,4548,27,20736,372,53568,74304
train,4549,23,17664,270,38880,56544
train,4550,20,15360,204,29376,44736
train,4551,41,31488,858,123552,155040
train,4552,17,13056,147,21168,34224
train,4553,28,21504,400,57600,79104
train,4554,20,15360,204,29376,44736
train,4555,40,30720,816,117504,148224
train,4556,25,19200,319,45936,65136
train,4557,28,21504,400,57600,79104
train,4558,39,29952,776,111744,141696
train,4559,15,11520,115,16560,28080
train,4560,35,26880,625,90000,116880
train,4561,19,14592,184,26496,41088
train,4562,35,26880,625,90000,116880
train,4563,3,2304,5,720,3024
train,4564,41,31488,858,123552,155040
train,4565,7,5376,25,3600,8976
train,4566,33,25344,556,80064,105408
train,4567,26,19968,345,49680,69648
train,4568,21,16128,225,32400,48528
train,4569,26,19968,345,49680,69648
train,4570,28,21504,400,57600,79104
train,4571,14,10752,100,14400,25152
train,4572,18,13824,165,23760,37584
train,4573,20,15360,204,29376,44736
train,4574,29,22272,429,61776,84048
train,4575,34,26112,590,84960,111072
train,4576,25,19200,319,45936,65136
train,4577,34,26112,590,84960,111072
train,4578,42,32256,900,129600,161856
train,4579,27,20736,372,53568,74304
train,4580,15,11520,115,16560,28080
train,4581,33,25344,556,80064,105408
train,4582,22,16896,247,35568,52464
train,4583,17,13056,147,21168,34224
train,4584,24,18432,294,42336,60768
train,4585,28,21504,400,57600,79104
train,4586,11,8448,62,8928,17376
train,4587,33,25344,556,80064,105408
train,4588,42,32256,900,129600,161856
train,4589,32,24576,522,75168,99744
train,4590,24,18432,294,42336,60768
train,4591,8,6144,33,4752,10896
train,4592,9,6912,41,5904,12816
train,4593,29,22272,429,61776,84048
train,4594,25,19200,319,45936,65136
train,4595,20,15360,204,29376,44736
train,4596,11,8448,62,8928,17376
train,4597,20,15360,204,29376,44736
train,4598,4,3072,8,1152,4224
train,4599,10,7680,51,7344,15024
train,4600,37,28416,698,100512,128928
train,4601,5,3840,13,1872,5712
train,4602,38,29184,737,106128,135312
train,4603,13,9984,86,12384,22368
train,4604,19,14592,184,26496,41088
train,4605,11,8448,62,8928,17376
train,4606,23,17664,270,38880,56544
train,4607,36,27648,661,95184,122832
train,4608,39,29952,776,111744,141696
train,4609,2,1536,2,288,1824
train,4610,24,18432,294,42336,60768
train,4611,8,6144,33,4752,10896
train,4612,21,16128,225,32400,48528
train,4613,36,27648,661,95184,122832
train,4614,15,11520,115,16560,28080
train,4615,21,16128,225,32400,48528
train,4616,24,18432,294,42336,60768
train,4617,39,29952,776,111744,141696
train,4618,23,17664,270,38880,56544
train,4619,29,22272,429,61776,84048
train,4620,31,23808,490,70560,94368
train,4621,12,9216,73,10512,19728
train,4622,19,14592,184,26496,41088
train,4623,5,3840,13,1872,5712
train,4624,40,30720,816,117504,148224
train,4625,31,23808,490,70560,94368
train,4626,22,16896,247,35568,52464
train,4627,19,14592,184,26496,41088
train,4628,36,27648,661,95184,122832
train,4629,42,32256,900,129600,161856
train,4630,19,14592,184,26496,41088
train,4631,31,23808,490,70560,94368
train,4632,44,33792,988,142272,176064
train,4633,25,19200,319,45936,65136
train,4634,22,16896,247,35568,52464
train,4635,15,11520,115,16560,28080
train,4636,29,22272,429,61776,84048
train,4637,13,9984,86,12384,22368
train,4638,8,6144,33,4752,10896
train,4639,35,26880,625,90000,116880
train,4640,6,4608,18,2592,7200
train,4641,23,17664,270,38880,56544
train,4642,6,4608,18,2592,7200
train,4643,23,17664,270,38880,56544
train,4644,9,6912,41,5904,12816
train,4645,25,19200,319,45936,65136
train,4646,16,12288,131,18864,31152
train,4647,12,9216,73,10512,19728
train,4648,22,16896,247,35568,52464
train,4649,21,16128,225,32400,48528
train,4650,20,15360,204,29376,44736
train,4651,32,24576,522,75168,99744
train,4652,44,33792,988,142272,176064
train,4653,7,5376,25,3600,8976
train,4654,12,9216,73,10512,19728
train,4655,36,27648,661,95184,122832
train,4656,26,19968,345,49680,69648
train,4657,10,7680,51,7344,15024
train,4658,30,23040,459,66096,89136
train,4659,16,12288,131,18864,31152
train,4660,23,17664,270,38880,56544
train,4661,17,13056,147,21168,34224
train,4662,17,13056,147,21168,34224
train,4663,22,16896,247,35568,52464
train,4664,37,28416,698,100512,128928
train,4665,26,19968,345,49680,69648
train,4666,16,12288,131,18864,31152
train,4667,13,9984,86,12384,22368
train,4668,25,19200,319,45936,65136
train,4669,41,31488,858,123552,155040
train,4670,20,15360,204,29376,44736
train,4671,18,13824,165,23760,37584
train,4672,20,15360,204,29376,44736
train,4673,29,22272,429,61776,84048
train,4674,9,6912,41,5904,12816
train,4675,31,23808,490,70560,94368
train,4676,4,3072,8,1152,4224
train,4677,35,26880,625,90000,116880
train,4678,11,8448,62,8928,17376
train,4679,48,36864,1175,169200,206064
train,4680,25,19200,319,45936,65136
train,4681,16,12288,131,18864,31152
train,4682,22,16896,247,35568,52464
train,4683,8,6144,33,4752,10896
train,4684,11,8448,62,8928,17376
train,4685,23,17664,270,38880,56544
train,4686,11,8448,62,8928,17376
train,4687,25,19200,319,45936,65136
train,4688,11,8448,62,8928,17376
train,4689,16,12288,131,18864,31152
train,4690,29,22272,429,61776,84048
train,4691,25,19200,319,45936,65136
train,4692,25,19200,319,45936,65136
train,4693,41,31488,858,123552,155040
train,4694,21,16128,225,32400,48528
train,4695,23,17664,270,38880,56544
train,4696,24,18432,294,42336,60768
train,4697,39,29952,776,111744,141696
train,4698,21,16128,225,32400,48528
train,4699,25,19200,319,45936,65136
train,4700,22,16896,247,35568,52464
train,4701,29,22272,429,61776,84048
train,4702,9,6912,41,5904,12816
train,4703,12,9216,73,10512,19728
train,4704,41,31488,858,123552,155040
train,4705,20,15360,204,29376,44736
train,4706,22,16896,247,35568,52464
train,4707,40,30720,816,117504,148224
train,4708,39,29952,776,111744,141696
train,4709,19,14592,184,26496,41088
train,4710,11,8448,62,8928,17376
train,4711,23,17664,270,38880,56544
train,4712,25,19200,319,45936,65136
train,4713,14,10752,100,14400,25152
train,4714,22,16896,247,35568,52464
train,4715,32,24576,522,75168,99744
train,4716,11,8448,62,8928,17376
train,4717,15,11520,115,16560,28080
train,4718,30,23040,459,66096,89136
train,4719,21,16128,225,32400,48528
train,4720,44,33792,988,142272,176064
train,4721,6,4608,18,2592,7200
train,4722,21,16128,225,32400,48528
train,4723,13,9984,86,12384,22368
train,4724,35,26880,625,90000,116880
train,4725,37,28416,698,100512,128928
train,4726,2,1536,2,288,1824
train,4727,8,6144,33,4752,10896
train,4728,25,19200,319,45936,65136
train,4729,23,17664,270,38880,56544
train,4730,20,15360,204,29376,44736
train,4731,23,17664,270,38880,56544
train,4732,29,22272,429,61776,84048
train,4733,33,25344,556,80064,105408
train,4734,19,14592,184,26496,41088
train,4735,13,9984,86,12384,22368
train,4736,10,7680,51,7344,15024
train,4737,31,23808,490,70560,94368
train,4738,52,39936,1379,198576,238512
train,4739,40,30720,816,117504,148224
train,4740,11,8448,62,8928,17376
train,4741,17,13056,147,21168,34224
train,4742,40,30720,816,117504,148224
train,4743,28,21504,400,57600,79104
train,4744,25,19200,319,45936,65136
train,4745,20,15360,204,29376,44736
train,4746,19,14592,184,26496,41088
train,4747,50,38400,1275,183600,222000
train,4748,23,17664,270,38880,56544
train,4749,35,26880,625,90000,116880
train,4750,46,35328,1079,155376,190704
train,4751,12,9216,73,10512,19728
train,4752,17,13056,147,21168,34224
train,4753,7,5376,25,3600,8976
train,4754,23,17664,270,38880,56544
train,4755,49,37632,1225,176400,214032
train,4756,25,19200,319,45936,65136
train,4757,42,32256,900,129600,161856
train,4758,16,12288,131,18864,31152
train,4759,14,10752,100,14400,25152
train,4760,22,16896,247,35568,52464
train,4761,35,26880,625,90000,116880
train,4762,14,10752,100,14400,25152
train,4763,15,11520,115,16560,28080
train,4764,24,18432,294,42336,60768
train,4765,37,28416,698,100512,128928
train,4766,20,15360,204,29376,44736
train,4767,24,18432,294,42336,60768
train,4768,26,19968,345,49680,69648
train,4769,41,31488,858,123552,155040
train,4770,17,13056,147,21168,34224
train,4771,15,11520,115,16560,28080
train,4772,9,6912,41,5904,12816
train,4773,47,36096,1127,162288,198384
train,4774,17,13056,147,21168,34224
train,4775,42,32256,900,129600,161856
train,4776,38,29184,737,106128,135312
train,4777,18,13824,165,23760,37584
train,4778,15,11520,115,16560,28080
train,4779,21,16128,225,32400,48528
train,4780,10,7680,51,7344,15024
train,4781,18,13824,165,23760,37584
train,4782,13,9984,86,12384,22368
train,4783,14,10752,100,14400,25152
train,4784,17,13056,147,21168,34224
train,4785,13,9984,86,12384,22368
train,4786,15,11520,115,16560,28080
train,4787,24,18432,294,42336,60768
train,4788,54,41472,1488,214272,255744
train,4789,26,19968,345,49680,69648
train,4790,28,21504,400,57600,79104
train,4791,32,24576,522,75168,99744
train,4792,33,25344,556,80064,105408
train,4793,25,19200,319,45936,65136
train,4794,39,29952,776,111744,141696
train,4795,24,18432,294,42336,60768
train,4796,23,17664,270,38880,56544
train,4797,13,9984,86,12384,22368
train,4798,23,17664,270,38880,56544
train,4799,22,16896,247,35568,52464
train,4800,25,19200,319,45936,65136
train,4801,9,6912,41,5904,12816
train,4802,35,26880,625,90000,116880
train,4803,5,3840,13,1872,5712
train,4804,6,4608,18,2592,7200
train,4805,16,12288,131,18864,31152
train,4806,33,25344,556,80064,105408
train,4807,6,4608,18,2592,7200
train,4808,15,11520,115,16560,28080
train,4809,24,18432,294,42336,60768
train,4810,18,13824,165,23760,37584
train,4811,30,23040,459,66096,89136
train,4812,41,31488,858,123552,155040
train,4813,15,11520,115,16560,28080
train,4814,8,6144,33,4752,10896
train,4815,24,18432,294,42336,60768
train,4816,28,21504,400,57600,79104
train,4817,30,23040,459,66096,89136
train,4818,30,23040,459,66096,89136
train,4819,20,15360,204,29376,44736
train,4820,12,9216,73,10512,19728
train,4821,26,19968,345,49680,69648
train,4822,26,19968,345,49680,69648
train,4823,38,29184,737,106128,135312
train,4824,12,9216,73,10512,19728
train,4825,35,26880,625,90000,116880
train,4826,18,13824,165,23760,37584
train,4827,23,17664,270,38880,56544
train,4828,28,21504,400,57600,79104
train,4829,55,42240,1543,222192,264432
train,4830,20,15360,204,29376,44736
train,4831,29,22272,429,61776,84048
train,4832,36,27648,661,95184,122832
train,4833,15,11520,115,16560,28080
train,4834,22,16896,247,35568,52464
train,4835,7,5376,25,3600,8976
train,4836,14,10752,100,14400,25152
train,4837,25,19200,319,45936,65136
train,4838,15,11520,115,16560,28080
train,4839,16,12288,131,18864,31152
train,4840,8,6144,33,4752,10896
train,4841,7,5376,25,3600,8976
train,4842,14,10752,100,14400,25152
train,4843,27,20736,372,53568,74304
train,4844,25,19200,319,45936,65136
train,4845,29,22272,429,61776,84048
train,4846,36,27648,661,95184,122832
train,4847,20,15360,204,29376,44736
train,4848,28,21504,400,57600,79104
train,4849,13,9984,86,12384,22368
train,4850,36,27648,661,95184,122832
train,4851,16,12288,131,18864,31152
train,4852,29,22272,429,61776,84048
train,4853,48,36864,1175,169200,206064
train,4854,26,19968,345,49680,69648
train,4855,18,13824,165,23760,37584
train,4856,33,25344,556,80064,105408
train,4857,17,13056,147,21168,34224
train,4858,34,26112,590,84960,111072
train,4859,11,8448,62,8928,17376
train,4860,14,10752,100,14400,25152
train,4861,16,12288,131,18864,31152
train,4862,28,21504,400,57600,79104
train,4863,17,13056,147,21168,34224
train,4864,18,13824,165,23760,37584
train,4865,26,19968,345,49680,69648
train,4866,9,6912,41,5904,12816
train,4867,38,29184,737,106128,135312
train,4868,20,15360,204,29376,44736
train,4869,53,40704,1433,206352,247056
train,4870,32,24576,522,75168,99744
train,4871,15,11520,115,16560,28080
train,4872,11,8448,62,8928,17376
train,4873,27,20736,372,53568,74304
train,4874,11,8448,62,8928,17376
train,4875,8,6144,33,4752,10896
train,4876,23,17664,270,38880,56544
train,4877,15,11520,115,16560,28080
train,4878,17,13056,147,21168,34224
train,4879,24,18432,294,42336,60768
train,4880,32,24576,522,75168,99744
train,4881,28,21504,400,57600,79104
train,4882,20,15360,204,29376,44736
train,4883,48,36864,1175,169200,206064
train,4884,18,13824,165,23760,37584
train,4885,11,8448,62,8928,17376
train,4886,27,20736,372,53568,74304
train,4887,16,12288,131,18864,31152
train,4888,23,17664,270,38880,56544
train,4889,25,19200,319,45936,65136
train,4890,8,6144,33,4752,10896
train,4891,23,17664,270,38880,56544
train,4892,28,21504,400,57600,79104
train,4893,7,5376,25,3600,8976
train,4894,34,26112,590,84960,111072
train,4895,33,25344,556,80064,105408
train,4896,16,12288,131,18864,31152
train,4897,25,19200,319,45936,65136
train,4898,34,26112,590,84960,111072
train,4899,42,32256,900,129600,161856
train,4900,30,23040,459,66096,89136
train,4901,20,15360,204,29376,44736
train,4902,20,15360,204,29376,44736
train,4903,16,12288,131,18864,31152
train,4904,13,9984,86,12384,22368
train,4905,11,8448,62,8928,17376
train,4906,28,21504,400,57600,79104
train,4907,16,12288,131,18864,31152
train,4908,32,24576,522,75168,99744
train,4909,47,36096,1127,162288,198384
train,4910,27,20736,372,53568,74304
train,4911,22,16896,247,35568,52464
train,4912,36,27648,661,95184,122832
train,4913,51,39168,1327,191088,230256
train,4914,4,3072,8,1152,4224
train,4915,30,23040,459,66096,89136
train,4916,8,6144,33,4752,10896
train,4917,2,1536,2,288,1824
train,4918,31,23808,490,70560,94368
train,4919,26,19968,345,49680,69648
train,4920,59,45312,1776,255744,301056
train,4921,28,21504,400,57600,79104
train,4922,27,20736,372,53568,74304
train,4923,26,19968,345,49680,69648
train,4924,42,32256,900,129600,161856
train,4925,16,12288,131,18864,31152
train,4926,9,6912,41,5904,12816
train,4927,38,29184,737,106128,135312
train,4928,19,14592,184,26496,41088
train,4929,20,15360,204,29376,44736
train,4930,18,13824,165,23760,37584
train,4931,29,22272,429,61776,84048
train,4932,8,6144,33,4752,10896
train,4933,23,17664,270,38880,56544
train,4934,11,8448,62,8928,17376
train,4935,17,13056,147,21168,34224
train,4936,38,29184,737,106128,135312
train,4937,2,1536,2,288,1824
train,4938,12,9216,73,10512,19728
train,4939,23,17664,270,38880,56544
train,4940,21,16128,225,32400,48528
train,4941,35,26880,625,90000,116880
train,4942,20,15360,204,29376,44736
train,4943,34,26112,590,84960,111072
train,4944,20,15360,204,29376,44736
train,4945,21,16128,225,32400,48528
train,4946,25,19200,319,45936,65136
train,4947,20,15360,204,29376,44736
train,4948,21,16128,225,32400,48528
train,4949,17,13056,147,21168,34224
train,4950,29,22272,429,61776,84048
train,4951,10,7680,51,7344,15024
train,4952,15,11520,115,16560,28080
train,4953,18,13824,165,23760,37584
train,4954,20,15360,204,29376,44736
train,4955,13,9984,86,12384,22368
train,4956,28,21504,400,57600,79104
train,4957,23,17664,270,38880,56544
train,4958,26,19968,345,49680,69648
train,4959,7,5376,25,3600,8976
train,4960,9,6912,41,5904,12816
train,4961,10,7680,51,7344,15024
train,4962,23,17664,270,38880,56544
train,4963,30,23040,459,66096,89136
train,4964,24,18432,294,42336,60768
train,4965,25,19200,319,45936,65136
train,4966,21,16128,225,32400,48528
train,4967,31,23808,490,70560,94368
train,4968,26,19968,345,49680,69648
train,4969,25,19200,319,45936,65136
train,4970,42,32256,900,129600,161856
train,4971,20,15360,204,29376,44736
train,4972,32,24576,522,75168,99744
train,4973,34,26112,590,84960,111072
train,4974,25,19200,319,45936,65136
train,4975,8,6144,33,4752,10896
train,4976,34,26112,590,84960,111072
train,4977,16,12288,131,18864,31152
train,4978,22,16896,247,35568,52464
train,4979,22,16896,247,35568,52464
train,4980,30,23040,459,66096,89136
train,4981,10,7680,51,7344,15024
train,4982,32,24576,522,75168,99744
train,4983,7,5376,25,3600,8976
train,4984,16,12288,131,18864,31152
train,4985,20,15360,204,29376,44736
train,4986,20,15360,204,29376,44736
train,4987,29,22272,429,61776,84048
train,4988,33,25344,556,80064,105408
train,4989,18,13824,165,23760,37584
train,4990,29,22272,429,61776,84048
train,4991,25,19200,319,45936,65136
train,4992,25,19200,319,45936,65136
train,4993,42,32256,900,129600,161856
train,4994,18,13824,165,23760,37584
train,4995,30,23040,459,66096,89136
train,4996,26,19968,345,49680,69648
train,4997,27,20736,372,53568,74304
train,4998,12,9216,73,10512,19728
train,4999,53,40704,1433,206352,247056
train,5000,41,31488,858,123552,155040
train,5001,4,3072,8,1152,4224
train,5002,29,22272,429,61776,84048
train,5003,13,9984,86,12384,22368
train,5004,14,10752,100,14400,25152
train,5005,45,34560,1033,148752,183312
train,5006,6,4608,18,2592,7200
train,5007,4,3072,8,1152,4224
train,5008,28,21504,400,57600,79104
train,5009,13,9984,86,12384,22368
train,5010,30,23040,459,66096,89136
train,5011,13,9984,86,12384,22368
train,5012,21,16128,225,32400,48528
train,5013,32,24576,522,75168,99744
train,5014,15,11520,115,16560,28080
train,5015,21,16128,225,32400,48528
train,5016,9,6912,41,5904,12816
train,5017,6,4608,18,2592,7200
train,5018,18,13824,165,23760,37584
train,5019,35,26880,625,90000,116880
train,5020,9,6912,41,5904,12816
train,5021,39,29952,776,111744,141696
train,5022,29,22272,429,61776,84048
train,5023,27,20736,372,53568,74304
train,5024,16,12288,131,18864,31152
train,5025,16,12288,131,18864,31152
train,5026,31,23808,490,70560,94368
train,5027,9,6912,41,5904,12816
train,5028,24,18432,294,42336,60768
train,5029,19,14592,184,26496,41088
train,5030,21,16128,225,32400,48528
train,5031,21,16128,225,32400,48528
train,5032,23,17664,270,38880,56544
train,5033,14,10752,100,14400,25152
train,5034,47,36096,1127,162288,198384
train,5035,33,25344,556,80064,105408
train,5036,23,17664,270,38880,56544
train,5037,33,25344,556,80064,105408
train,5038,13,9984,86,12384,22368
train,5039,19,14592,184,26496,41088
train,5040,34,26112,590,84960,111072
train,5041,28,21504,400,57600,79104
train,5042,24,18432,294,42336,60768
train,5043,54,41472,1488,214272,255744
train,5044,8,6144,33,4752,10896
train,5045,34,26112,590,84960,111072
train,5046,38,29184,737,106128,135312
train,5047,9,6912,41,5904,12816
train,5048,16,12288,131,18864,31152
train,5049,14,10752,100,14400,25152
train,5050,7,5376,25,3600,8976
train,5051,24,18432,294,42336,60768
train,5052,15,11520,115,16560,28080
train,5053,16,12288,131,18864,31152
train,5054,23,17664,270,38880,56544
train,5055,27,20736,372,53568,74304
train,5056,42,32256,900,129600,161856
train,5057,38,29184,737,106128,135312
train,5058,18,13824,165,23760,37584
train,5059,19,14592,184,26496,41088
train,5060,15,11520,115,16560,28080
train,5061,42,32256,900,129600,161856
train,5062,32,24576,522,75168,99744
train,5063,11,8448,62,8928,17376
train,5064,50,38400,1275,183600,222000
train,5065,31,23808,490,70560,94368
train,5066,14,10752,100,14400,25152
train,5067,32,24576,522,75168,99744
train,5068,17,13056,147,21168,34224
train,5069,21,16128,225,32400,48528
train,5070,21,16128,225,32400,48528
train,5071,34,26112,590,84960,111072
train,5072,27,20736,372,53568,74304
train,5073,35,26880,625,90000,116880
train,5074,8,6144,33,4752,10896
train,5075,20,15360,204,29376,44736
train,5076,16,12288,131,18864,31152
train,5077,15,11520,115,16560,28080
train,5078,25,19200,319,45936,65136
train,5079,35,26880,625,90000,116880
train,5080,16,12288,131,18864,31152
train,5081,7,5376,25,3600,8976
train,5082,15,11520,115,16560,28080
train,5083,37,28416,698,100512,128928
train,5084,28,21504,400,57600,79104
train,5085,32,24576,522,75168,99744
train,5086,9,6912,41,5904,12816
train,5087,18,13824,165,23760,37584
train,5088,30,23040,459,66096,89136
train,5089,21,16128,225,32400,48528
train,5090,40,30720,816,117504,148224
train,5091,31,23808,490,70560,94368
train,5092,6,4608,18,2592,7200
train,5093,19,14592,184,26496,41088
train,5094,17,13056,147,21168,34224
train,5095,13,9984,86,12384,22368
train,5096,30,23040,459,66096,89136
train,5097,27,20736,372,53568,74304
train,5098,19,14592,184,26496,41088
train,5099,22,16896,247,35568,52464
train,5100,8,6144,33,4752,10896
train,5101,38,29184,737,106128,135312
train,5102,12,9216,73,10512,19728
train,5103,15,11520,115,16560,28080
train,5104,7,5376,25,3600,8976
train,5105,14,10752,100,14400,25152
train,5106,22,16896,247,35568,52464
train,5107,34,26112,590,84960,111072
train,5108,21,16128,225,32400,48528
train,5109,50,38400,1275,183600,222000
train,5110,42,32256,900,129600,161856
train,5111,46,35328,1079,155376,190704
train,5112,10,7680,51,7344,15024
train,5113,27,20736,372,53568,74304
train,5114,39,29952,776,111744,141696
train,5115,8,6144,33,4752,10896
train,5116,34,26112,590,84960,111072
train,5117,25,19200,319,45936,65136
train,5118,16,12288,131,18864,31152
train,5119,18,13824,165,23760,37584
train,5120,51,39168,1327,191088,230256
train,5121,49,37632,1225,176400,214032
train,5122,23,17664,270,38880,56544
train,5123,17,13056,147,21168,34224
train,5124,12,9216,73,10512,19728
train,5125,12,9216,73,10512,19728
train,5126,21,16128,225,32400,48528
train,5127,12,9216,73,10512,19728
train,5128,33,25344,556,80064,105408
train,5129,19,14592,184,26496,41088
train,5130,21,16128,225,32400,48528
train,5131,27,20736,372,53568,74304
train,5132,9,6912,41,5904,12816
train,5133,32,24576,522,75168,99744
train,5134,45,34560,1033,148752,183312
train,5135,15,11520,115,16560,28080
train,5136,22,16896,247,35568,52464
train,5137,11,8448,62,8928,17376
train,5138,23,17664,270,38880,56544
train,5139,10,7680,51,7344,15024
train,5140,22,16896,247,35568,52464
train,5141,10,7680,51,7344,15024
train,5142,37,28416,698,100512,128928
train,5143,15,11520,115,16560,28080
train,5144,26,19968,345,49680,69648
train,5145,37,28416,698,100512,128928
train,5146,20,15360,204,29376,44736
train,5147,34,26112,590,84960,111072
train,5148,24,18432,294,42336,60768
train,5149,50,38400,1275,183600,222000
train,5150,16,12288,131,18864,31152
train,5151,18,13824,165,23760,37584
train,5152,30,23040,459,66096,89136
train,5153,24,18432,294,42336,60768
train,5154,18,13824,165,23760,37584
train,5155,24,18432,294,42336,60768
train,5156,31,23808,490,70560,94368
train,5157,23,17664,270,38880,56544
train,5158,22,16896,247,35568,52464
train,5159,16,12288,131,18864,31152
train,5160,37,28416,698,100512,128928
train,5161,28,21504,400,57600,79104
train,5162,40,30720,816,117504,148224
train,5163,25,19200,319,45936,65136
train,5164,26,19968,345,49680,69648
train,5165,12,9216,73,10512,19728
train,5166,18,13824,165,23760,37584
train,5167,24,18432,294,42336,60768
train,5168,12,9216,73,10512,19728
train,5169,18,13824,165,23760,37584
train,5170,36,27648,661,95184,122832
train,5171,8,6144,33,4752,10896
train,5172,12,9216,73,10512,19728
train,5173,12,9216,73,10512,19728
train,5174,20,15360,204,29376,44736
train,5175,20,15360,204,29376,44736
train,5176,16,12288,131,18864,31152
train,5177,13,9984,86,12384,22368
train,5178,9,6912,41,5904,12816
train,5179,18,13824,165,23760,37584
train,5180,46,35328,1079,155376,190704
train,5181,30,23040,459,66096,89136
train,5182,32,24576,522,75168,99744
train,5183,26,19968,345,49680,69648
train,5184,32,24576,522,75168,99744
train,5185,52,39936,1379,198576,238512
train,5186,34,26112,590,84960,111072
train,5187,29,22272,429,61776,84048
train,5188,29,22272,429,61776,84048
train,5189,33,25344,556,80064,105408
train,5190,13,9984,86,12384,22368
train,5191,13,9984,86,12384,22368
train,5192,34,26112,590,84960,111072
train,5193,8,6144,33,4752,10896
train,5194,3,2304,5,720,3024
train,5195,51,39168,1327,191088,230256
train,5196,11,8448,62,8928,17376
train,5197,24,18432,294,42336,60768
train,5198,40,30720,816,117504,148224
train,5199,16,12288,131,18864,31152
train,5200,9,6912,41,5904,12816
train,5201,14,10752,100,14400,25152
train,5202,9,6912,41,5904,12816
train,5203,36,27648,661,95184,122832
train,5204,3,2304,5,720,3024
train,5205,33,25344,556,80064,105408
train,5206,42,32256,900,129600,161856
train,5207,39,29952,776,111744,141696
train,5208,27,20736,372,53568,74304
train,5209,34,26112,590,84960,111072
train,5210,28,21504,400,57600,79104
train,5211,10,7680,51,7344,15024
train,5212,15,11520,115,16560,28080
train,5213,10,7680,51,7344,15024
train,5214,14,10752,100,14400,25152
train,5215,12,9216,73,10512,19728
train,5216,33,25344,556,80064,105408
train,5217,26,19968,345,49680,69648
train,5218,16,12288,131,18864,31152
train,5219,40,30720,816,117504,148224
train,5220,14,10752,100,14400,25152
train,5221,8,6144,33,4752,10896
train,5222,26,19968,345,49680,69648
train,5223,6,4608,18,2592,7200
train,5224,24,18432,294,42336,60768
train,5225,50,38400,1275,183600,222000
train,5226,21,16128,225,32400,48528
train,5227,40,30720,816,117504,148224
train,5228,32,24576,522,75168,99744
train,5229,30,23040,459,66096,89136
train,5230,25,19200,319,45936,65136
train,5231,21,16128,225,32400,48528
train,5232,27,20736,372,53568,74304
train,5233,15,11520,115,16560,28080
train,5234,44,33792,988,142272,176064
train,5235,14,10752,100,14400,25152
train,5236,8,6144,33,4752,10896
train,5237,20,15360,204,29376,44736
train,5238,29,22272,429,61776,84048
train,5239,34,26112,590,84960,111072
train,5240,46,35328,1079,155376,190704
train,5241,15,11520,115,16560,28080
train,5242,24,18432,294,42336,60768
train,5243,28,21504,400,57600,79104
train,5244,23,17664,270,38880,56544
train,5245,20,15360,204,29376,44736
train,5246,13,9984,86,12384,22368
train,5247,11,8448,62,8928,17376
train,5248,17,13056,147,21168,34224
train,5249,31,23808,490,70560,94368
train,5250,16,12288,131,18864,31152
train,5251,22,16896,247,35568,52464
train,5252,21,16128,225,32400,48528
train,5253,24,18432,294,42336,60768
train,5254,15,11520,115,16560,28080
train,5255,33,25344,556,80064,105408
train,5256,14,10752,100,14400,25152
train,5257,15,11520,115,16560,28080
train,5258,8,6144,33,4752,10896
train,5259,10,7680,51,7344,15024
train,5260,38,29184,737,106128,135312
train,5261,11,8448,62,8928,17376
train,5262,36,27648,661,95184,122832
train,5263,42,32256,900,129600,161856
train,5264,27,20736,372,53568,74304
train,5265,16,12288,131,18864,31152
train,5266,22,16896,247,35568,52464
train,5267,20,15360,204,29376,44736
train,5268,53,40704,1433,206352,247056
train,5269,8,6144,33,4752,10896
train,5270,9,6912,41,5904,12816
train,5271,35,26880,625,90000,116880
train,5272,17,13056,147,21168,34224
train,5273,25,19200,319,45936,65136
train,5274,47,36096,1127,162288,198384
train,5275,19,14592,184,26496,41088
train,5276,42,32256,900,129600,161856
train,5277,26,19968,345,49680,69648
train,5278,14,10752,100,14400,25152
train,5279,21,16128,225,32400,48528
train,5280,26,19968,345,49680,69648
train,5281,38,29184,737,106128,135312
train,5282,27,20736,372,53568,74304
train,5283,15,11520,115,16560,28080
train,5284,27,20736,372,53568,74304
train,5285,16,12288,131,18864,31152
train,5286,21,16128,225,32400,48528
train,5287,41,31488,858,123552,155040
train,5288,23,17664,270,38880,56544
train,5289,22,16896,247,35568,52464
train,5290,18,13824,165,23760,37584
train,5291,26,19968,345,49680,69648
train,5292,13,9984,86,12384,22368
train,5293,14,10752,100,14400,25152
train,5294,28,21504,400,57600,79104
train,5295,37,28416,698,100512,128928
train,5296,28,21504,400,57600,79104
train,5297,16,12288,131,18864,31152
train,5298,23,17664,270,38880,56544
train,5299,23,17664,270,38880,56544
train,5300,13,9984,86,12384,22368
train,5301,11,8448,62,8928,17376
train,5302,7,5376,25,3600,8976
train,5303,14,10752,100,14400,25152
train,5304,18,13824,165,23760,37584
train,5305,28,21504,400,57600,79104
train,5306,29,22272,429,61776,84048
train,5307,30,23040,459,66096,89136
train,5308,13,9984,86,12384,22368
train,5309,8,6144,33,4752,10896
train,5310,28,21504,400,57600,79104
train,5311,3,2304,5,720,3024
train,5312,16,12288,131,18864,31152
train,5313,16,12288,131,18864,31152
train,5314,42,32256,900,129600,161856
train,5315,14,10752,100,14400,25152
train,5316,24,18432,294,42336,60768
train,5317,20,15360,204,29376,44736
train,5318,30,23040,459,66096,89136
train,5319,36,27648,661,95184,122832
train,5320,43,33024,943,135792,168816
train,5321,20,15360,204,29376,44736
train,5322,24,18432,294,42336,60768
train,5323,35,26880,625,90000,116880
train,5324,13,9984,86,12384,22368
train,5325,15,11520,115,16560,28080
train,5326,18,13824,165,23760,37584
train,5327,18,13824,165,23760,37584
train,5328,5,3840,13,1872,5712
train,5329,36,27648,661,95184,122832
train,5330,5,3840,13,1872,5712
train,5331,40,30720,816,117504,148224
train,5332,23,17664,270,38880,56544
train,5333,9,6912,41,5904,12816
train,5334,18,13824,165,23760,37584
train,5335,13,9984,86,12384,22368
train,5336,15,11520,115,16560,28080
train,5337,23,17664,270,38880,56544
train,5338,8,6144,33,4752,10896
train,5339,19,14592,184,26496,41088
train,5340,10,7680,51,7344,15024
train,5341,43,33024,943,135792,168816
train,5342,27,20736,372,53568,74304
train,5343,13,9984,86,12384,22368
train,5344,26,19968,345,49680,69648
train,5345,18,13824,165,23760,37584
train,5346,25,19200,319,45936,65136
train,5347,4,3072,8,1152,4224
train,5348,13,9984,86,12384,22368
train,5349,20,15360,204,29376,44736
train,5350,25,19200,319,45936,65136
train,5351,32,24576,522,75168,99744
train,5352,26,19968,345,49680,69648
train,5353,20,15360,204,29376,44736
train,5354,28,21504,400,57600,79104
train,5355,40,30720,816,117504,148224
train,5356,6,4608,18,2592,7200
train,5357,10,7680,51,7344,15024
train,5358,6,4608,18,2592,7200
train,5359,19,14592,184,26496,41088
train,5360,24,18432,294,42336,60768
train,5361,28,21504,400,57600,79104
train,5362,37,28416,698,100512,128928
train,5363,16,12288,131,18864,31152
train,5364,24,18432,294,42336,60768
train,5365,19,14592,184,26496,41088
train,5366,18,13824,165,23760,37584
train,5367,14,10752,100,14400,25152
train,5368,28,21504,400,57600,79104
train,5369,12,9216,73,10512,19728
train,5370,21,16128,225,32400,48528
train,5371,19,14592,184,26496,41088
train,5372,20,15360,204,29376,44736
train,5373,23,17664,270,38880,56544
train,5374,22,16896,247,35568,52464
train,5375,7,5376,25,3600,8976
train,5376,46,35328,1079,155376,190704
train,5377,17,13056,147,21168,34224
train,5378,48,36864,1175,169200,206064
train,5379,5,3840,13,1872,5712
train,5380,33,25344,556,80064,105408
train,5381,24,18432,294,42336,60768
train,5382,19,14592,184,26496,41088
train,5383,35,26880,625,90000,116880
train,5384,21,16128,225,32400,48528
train,5385,9,6912,41,5904,12816
train,5386,20,15360,204,29376,44736
train,5387,19,14592,184,26496,41088
train,5388,36,27648,661,95184,122832
train,5389,35,26880,625,90000,116880
train,5390,17,13056,147,21168,34224
train,5391,28,21504,400,57600,79104
train,5392,16,12288,131,18864,31152
train,5393,25,19200,319,45936,65136
train,5394,11,8448,62,8928,17376
train,5395,8,6144,33,4752,10896
train,5396,12,9216,73,10512,19728
train,5397,29,22272,429,61776,84048
train,5398,14,10752,100,14400,25152
train,5399,13,9984,86,12384,22368
train,5400,10,7680,51,7344,15024
train,5401,27,20736,372,53568,74304
train,5402,8,6144,33,4752,10896
train,5403,3,2304,5,720,3024
train,5404,28,21504,400,57600,79104
train,5405,12,9216,73,10512,19728
train,5406,37,28416,698,100512,128928
train,5407,28,21504,400,57600,79104
train,5408,22,16896,247,35568,52464
train,5409,6,4608,18,2592,7200
train,5410,32,24576,522,75168,99744
train,5411,26,19968,345,49680,69648
train,5412,19,14592,184,26496,41088
train,5413,14,10752,100,14400,25152
train,5414,19,14592,184,26496,41088
train,5415,23,17664,270,38880,56544
train,5416,52,39936,1379,198576,238512
train,5417,42,32256,900,129600,161856
train,5418,31,23808,490,70560,94368
train,5419,27,20736,372,53568,74304
train,5420,23,17664,270,38880,56544
train,5421,39,29952,776,111744,141696
train,5422,22,16896,247,35568,52464
train,5423,9,6912,41,5904,12816
train,5424,20,15360,204,29376,44736
train,5425,18,13824,165,23760,37584
train,5426,22,16896,247,35568,52464
train,5427,7,5376,25,3600,8976
train,5428,32,24576,522,75168,99744
train,5429,15,11520,115,16560,28080
train,5430,12,9216,73,10512,19728
train,5431,45,34560,1033,148752,183312
train,5432,15,11520,115,16560,28080
train,5433,18,13824,165,23760,37584
train,5434,18,13824,165,23760,37584
train,5435,10,7680,51,7344,15024
train,5436,20,15360,204,29376,44736
train,5437,30,23040,459,66096,89136
train,5438,15,11520,115,16560,28080
train,5439,40,30720,816,117504,148224
train,5440,18,13824,165,23760,37584
train,5441,37,28416,698,100512,128928
train,5442,47,36096,1127,162288,198384
train,5443,13,9984,86,12384,22368
train,5444,31,23808,490,70560,94368
train,5445,20,15360,204,29376,44736
train,5446,26,19968,345,49680,69648
train,5447,6,4608,18,2592,7200
train,5448,14,10752,100,14400,25152
train,5449,24,18432,294,42336,60768
train,5450,34,26112,590,84960,111072
train,5451,20,15360,204,29376,44736
train,5452,44,33792,988,142272,176064
train,5453,34,26112,590,84960,111072
train,5454,28,21504,400,57600,79104
train,5455,45,34560,1033,148752,183312
train,5456,12,9216,73,10512,19728
train,5457,27,20736,372,53568,74304
train,5458,27,20736,372,53568,74304
train,5459,35,26880,625,90000,116880
train,5460,29,22272,429,61776,84048
train,5461,20,15360,204,29376,44736
train,5462,21,16128,225,32400,48528
train,5463,28,21504,400,57600,79104
train,5464,31,23808,490,70560,94368
train,5465,9,6912,41,5904,12816
train,5466,26,19968,345,49680,69648
train,5467,4,3072,8,1152,4224
train,5468,14,10752,100,14400,25152
train,5469,18,13824,165,23760,37584
train,5470,28,21504,400,57600,79104
train,5471,10,7680,51,7344,15024
train,5472,39,29952,776,111744,141696
train,5473,20,15360,204,29376,44736
train,5474,28,21504,400,57600,79104
train,5475,9,6912,41,5904,12816
train,5476,35,26880,625,90000,116880
train,5477,45,34560,1033,148752,183312
train,5478,18,13824,165,23760,37584
train,5479,2,1536,2,288,1824
train,5480,35,26880,625,90000,116880
train,5481,9,6912,41,5904,12816
train,5482,26,19968,345,49680,69648
train,5483,14,10752,100,14400,25152
train,5484,18,13824,165,23760,37584
train,5485,23,17664,270,38880,56544
train,5486,44,33792,988,142272,176064
train,5487,13,9984,86,12384,22368
train,5488,8,6144,33,4752,10896
train,5489,38,29184,737,106128,135312
train,5490,15,11520,115,16560,28080
train,5491,34,26112,590,84960,111072
train,5492,21,16128,225,32400,48528
train,5493,30,23040,459,66096,89136
train,5494,44,33792,988,142272,176064
train,5495,25,19200,319,45936,65136
train,5496,12,9216,73,10512,19728
train,5497,36,27648,661,95184,122832
train,5498,20,15360,204,29376,44736
train,5499,14,10752,100,14400,25152
train,5500,16,12288,131,18864,31152
train,5501,26,19968,345,49680,69648
train,5502,21,16128,225,32400,48528
train,5503,34,26112,590,84960,111072
train,5504,4,3072,8,1152,4224
train,5505,15,11520,115,16560,28080
train,5506,8,6144,33,4752,10896
train,5507,49,37632,1225,176400,214032
train,5508,31,23808,490,70560,94368
train,5509,23,17664,270,38880,56544
train,5510,31,23808,490,70560,94368
train,5511,32,24576,522,75168,99744
train,5512,27,20736,372,53568,74304
train,5513,27,20736,372,53568,74304
train,5514,24,18432,294,42336,60768
train,5515,14,10752,100,14400,25152
train,5516,13,9984,86,12384,22368
train,5517,18,13824,165,23760,37584
train,5518,14,10752,100,14400,25152
train,5519,40,30720,816,117504,148224
train,5520,46,35328,1079,155376,190704
train,5521,32,24576,522,75168,99744
train,5522,26,19968,345,49680,69648
train,5523,24,18432,294,42336,60768
train,5524,22,16896,247,35568,52464
train,5525,17,13056,147,21168,34224
train,5526,19,14592,184,26496,41088
train,5527,25,19200,319,45936,65136
train,5528,19,14592,184,26496,41088
train,5529,29,22272,429,61776,84048
train,5530,30,23040,459,66096,89136
train,5531,19,14592,184,26496,41088
train,5532,12,9216,73,10512,19728
train,5533,13,9984,86,12384,22368
train,5534,7,5376,25,3600,8976
train,5535,13,9984,86,12384,22368
train,5536,41,31488,858,123552,155040
train,5537,4,3072,8,1152,4224
train,5538,8,6144,33,4752,10896
train,5539,14,10752,100,14400,25152
train,5540,33,25344,556,80064,105408
train,5541,36,27648,661,95184,122832
train,5542,38,29184,737,106128,135312
train,5543,26,19968,345,49680,69648
train,5544,31,23808,490,70560,94368
train,5545,9,6912,41,5904,12816
train,5546,34,26112,590,84960,111072
train,5547,41,31488,858,123552,155040
train,5548,24,18432,294,42336,60768
train,5549,13,9984,86,12384,22368
train,5550,27,20736,372,53568,74304
train,5551,42,32256,900,129600,161856
train,5552,46,35328,1079,155376,190704
train,5553,10,7680,51,7344,15024
train,5554,24,18432,294,42336,60768
train,5555,10,7680,51,7344,15024
train,5556,17,13056,147,21168,34224
train,5557,28,21504,400,57600,79104
train,5558,32,24576,522,75168,99744
train,5559,42,32256,900,129600,161856
train,5560,13,9984,86,12384,22368
train,5561,38,29184,737,106128,135312
train,5562,43,33024,943,135792,168816
train,5563,16,12288,131,18864,31152
train,5564,14,10752,100,14400,25152
train,5565,23,17664,270,38880,56544
train,5566,10,7680,51,7344,15024
train,5567,27,20736,372,53568,74304
train,5568,11,8448,62,8928,17376
train,5569,18,13824,165,23760,37584
train,5570,25,19200,319,45936,65136
train,5571,11,8448,62,8928,17376
train,5572,34,26112,590,84960,111072
train,5573,42,32256,900,129600,161856
train,5574,40,30720,816,117504,148224
train,5575,17,13056,147,21168,34224
train,5576,8,6144,33,4752,10896
train,5577,19,14592,184,26496,41088
train,5578,10,7680,51,7344,15024
train,5579,32,24576,522,75168,99744
train,5580,7,5376,25,3600,8976
train,5581,24,18432,294,42336,60768
train,5582,24,18432,294,42336,60768
train,5583,37,28416,698,100512,128928
train,5584,15,11520,115,16560,28080
train,5585,27,20736,372,53568,74304
train,5586,13,9984,86,12384,22368
train,5587,13,9984,86,12384,22368
train,5588,31,23808,490,70560,94368
train,5589,32,24576,522,75168,99744
train,5590,40,30720,816,117504,148224
train,5591,17,13056,147,21168,34224
train,5592,29,22272,429,61776,84048
train,5593,29,22272,429,61776,84048
train,5594,11,8448,62,8928,17376
train,5595,43,33024,943,135792,168816
train,5596,21,16128,225,32400,48528
train,5597,15,11520,115,16560,28080
train,5598,24,18432,294,42336,60768
train,5599,10,7680,51,7344,15024
train,5600,17,13056,147,21168,34224
train,5601,19,14592,184,26496,41088
train,5602,26,19968,345,49680,69648
train,5603,26,19968,345,49680,69648
train,5604,16,12288,131,18864,31152
train,5605,29,22272,429,61776,84048
train,5606,10,7680,51,7344,15024
train,5607,17,13056,147,21168,34224
train,5608,28,21504,400,57600,79104
train,5609,20,15360,204,29376,44736
train,5610,22,16896,247,35568,52464
train,5611,17,13056,147,21168,34224
train,5612,18,13824,165,23760,37584
train,5613,34,26112,590,84960,111072
train,5614,31,23808,490,70560,94368
train,5615,17,13056,147,21168,34224
train,5616,12,9216,73,10512,19728
train,5617,21,16128,225,32400,48528
train,5618,15,11520,115,16560,28080
train,5619,9,6912,41,5904,12816
train,5620,6,4608,18,2592,7200
train,5621,5,3840,13,1872,5712
train,5622,13,9984,86,12384,22368
train,5623,27,20736,372,53568,74304
train,5624,25,19200,319,45936,65136
train,5625,41,31488,858,123552,155040
train,5626,21,16128,225,32400,48528
train,5627,38,29184,737,106128,135312
train,5628,18,13824,165,23760,37584
train,5629,26,19968,345,49680,69648
train,5630,36,27648,661,95184,122832
train,5631,15,11520,115,16560,28080
train,5632,11,8448,62,8928,17376
train,5633,8,6144,33,4752,10896
train,5634,26,19968,345,49680,69648
train,5635,27,20736,372,53568,74304
train,5636,31,23808,490,70560,94368
train,5637,18,13824,165,23760,37584
train,5638,19,14592,184,26496,41088
train,5639,24,18432,294,42336,60768
train,5640,26,19968,345,49680,69648
train,5641,31,23808,490,70560,94368
train,5642,11,8448,62,8928,17376
train,5643,11,8448,62,8928,17376
train,5644,21,16128,225,32400,48528
train,5645,17,13056,147,21168,34224
train,5646,8,6144,33,4752,10896
train,5647,30,23040,459,66096,89136
train,5648,22,16896,247,35568,52464
train,5649,34,26112,590,84960,111072
train,5650,22,16896,247,35568,52464
train,5651,24,18432,294,42336,60768
train,5652,16,12288,131,18864,31152
train,5653,24,18432,294,42336,60768
train,5654,25,19200,319,45936,65136
train,5655,2,1536,2,288,1824
train,5656,6,4608,18,2592,7200
train,5657,43,33024,943,135792,168816
train,5658,39,29952,776,111744,141696
train,5659,31,23808,490,70560,94368
train,5660,26,19968,345,49680,69648
train,5661,31,23808,490,70560,94368
train,5662,19,14592,184,26496,41088
train,5663,17,13056,147,21168,34224
train,5664,29,22272,429,61776,84048
train,5665,45,34560,1033,148752,183312
train,5666,33,25344,556,80064,105408
train,5667,14,10752,100,14400,25152
train,5668,11,8448,62,8928,17376
train,5669,12,9216,73,10512,19728
train,5670,19,14592,184,26496,41088
train,5671,7,5376,25,3600,8976
train,5672,18,13824,165,23760,37584
train,5673,24,18432,294,42336,60768
train,5674,27,20736,372,53568,74304
train,5675,14,10752,100,14400,25152
train,5676,20,15360,204,29376,44736
train,5677,22,16896,247,35568,52464
train,5678,25,19200,319,45936,65136
train,5679,27,20736,372,53568,74304
train,5680,20,15360,204,29376,44736
train,5681,26,19968,345,49680,69648
train,5682,11,8448,62,8928,17376
train,5683,45,34560,1033,148752,183312
train,5684,22,16896,247,35568,52464
train,5685,11,8448,62,8928,17376
train,5686,29,22272,429,61776,84048
train,5687,16,12288,131,18864,31152
train,5688,24,18432,294,42336,60768
train,5689,42,32256,900,129600,161856
train,5690,37,28416,698,100512,128928
train,5691,21,16128,225,32400,48528
train,5692,5,3840,13,1872,5712
train,5693,24,18432,294,42336,60768
train,5694,33,25344,556,80064,105408
train,5695,32,24576,522,75168,99744
train,5696,44,33792,988,142272,176064
train,5697,13,9984,86,12384,22368
train,5698,36,27648,661,95184,122832
train,5699,30,23040,459,66096,89136
train,5700,27,20736,372,53568,74304
train,5701,3,2304,5,720,3024
train,5702,11,8448,62,8928,17376
train,5703,16,12288,131,18864,31152
train,5704,19,14592,184,26496,41088
train,5705,3,2304,5,720,3024
train,5706,22,16896,247,35568,52464
train,5707,20,15360,204,29376,44736
train,5708,27,20736,372,53568,74304
train,5709,36,27648,661,95184,122832
train,5710,35,26880,625,90000,116880
train,5711,2,1536,2,288,1824
train,5712,15,11520,115,16560,28080
train,5713,33,25344,556,80064,105408
train,5714,26,19968,345,49680,69648
train,5715,7,5376,25,3600,8976
train,5716,30,23040,459,66096,89136
train,5717,14,10752,100,14400,25152
train,5718,23,17664,270,38880,56544
train,5719,13,9984,86,12384,22368
train,5720,38,29184,737,106128,135312
train,5721,26,19968,345,49680,69648
train,5722,11,8448,62,8928,17376
train,5723,24,18432,294,42336,60768
train,5724,20,15360,204,29376,44736
train,5725,15,11520,115,16560,28080
train,5726,18,13824,165,23760,37584
train,5727,9,6912,41,5904,12816
train,5728,35,26880,625,90000,116880
train,5729,24,18432,294,42336,60768
train,5730,33,25344,556,80064,105408
train,5731,7,5376,25,3600,8976
train,5732,7,5376,25,3600,8976
train,5733,37,28416,698,100512,128928
train,5734,18,13824,165,23760,37584
train,5735,15,11520,115,16560,28080
train,5736,21,16128,225,32400,48528
train,5737,31,23808,490,70560,94368
train,5738,24,18432,294,42336,60768
train,5739,33,25344,556,80064,105408
train,5740,7,5376,25,3600,8976
train,5741,22,16896,247,35568,52464
train,5742,19,14592,184,26496,41088
train,5743,5,3840,13,1872,5712
train,5744,15,11520,115,16560,28080
train,5745,18,13824,165,23760,37584
train,5746,9,6912,41,5904,12816
train,5747,22,16896,247,35568,52464
train,5748,55,42240,1543,222192,264432
train,5749,29,22272,429,61776,84048
train,5750,15,11520,115,16560,28080
train,5751,42,32256,900,129600,161856
train,5752,41,31488,858,123552,155040
train,5753,5,3840,13,1872,5712
train,5754,43,33024,943,135792,168816
train,5755,19,14592,184,26496,41088
train,5756,32,24576,522,75168,99744
train,5757,35,26880,625,90000,116880
train,5758,14,10752,100,14400,25152
train,5759,26,19968,345,49680,69648
train,5760,18,13824,165,23760,37584
train,5761,41,31488,858,123552,155040
train,5762,37,28416,698,100512,128928
train,5763,16,12288,131,18864,31152
train,5764,17,13056,147,21168,34224
train,5765,12,9216,73,10512,19728
train,5766,32,24576,522,75168,99744
train,5767,3,2304,5,720,3024
train,5768,32,24576,522,75168,99744
train,5769,33,25344,556,80064,105408
train,5770,25,19200,319,45936,65136
train,5771,13,9984,86,12384,22368
train,5772,22,16896,247,35568,52464
train,5773,22,16896,247,35568,52464
train,5774,27,20736,372,53568,74304
train,5775,19,14592,184,26496,41088
train,5776,33,25344,556,80064,105408
train,5777,40,30720,816,117504,148224
train,5778,16,12288,131,18864,31152
train,5779,21,16128,225,32400,48528
train,5780,48,36864,1175,169200,206064
train,5781,8,6144,33,4752,10896
train,5782,11,8448,62,8928,17376
train,5783,30,23040,459,66096,89136
train,5784,18,13824,165,23760,37584
train,5785,15,11520,115,16560,28080
train,5786,9,6912,41,5904,12816
train,5787,52,39936,1379,198576,238512
train,5788,31,23808,490,70560,94368
train,5789,40,30720,816,117504,148224
train,5790,36,27648,661,95184,122832
train,5791,11,8448,62,8928,17376
train,5792,6,4608,18,2592,7200
train,5793,13,9984,86,12384,22368
train,5794,9,6912,41,5904,12816
train,5795,12,9216,73,10512,19728
train,5796,28,21504,400,57600,79104
train,5797,42,32256,900,129600,161856
train,5798,33,25344,556,80064,105408
train,5799,22,16896,247,35568,52464
train,5800,35,26880,625,90000,116880
train,5801,3,2304,5,720,3024
train,5802,35,26880,625,90000,116880
train,5803,15,11520,115,16560,28080
train,5804,29,22272,429,61776,84048
train,5805,23,17664,270,38880,56544
train,5806,23,17664,270,38880,56544
train,5807,15,11520,115,16560,28080
train,5808,25,19200,319,45936,65136
train,5809,9,6912,41,5904,12816
train,5810,33,25344,556,80064,105408
train,5811,27,20736,372,53568,74304
train,5812,19,14592,184,26496,41088
train,5813,30,23040,459,66096,89136
train,5814,16,12288,131,18864,31152
train,5815,6,4608,18,2592,7200
train,5816,33,25344,556,80064,105408
train,5817,36,27648,661,95184,122832
train,5818,7,5376,25,3600,8976
train,5819,27,20736,372,53568,74304
train,5820,28,21504,400,57600,79104
train,5821,4,3072,8,1152,4224
train,5822,20,15360,204,29376,44736
train,5823,18,13824,165,23760,37584
train,5824,23,17664,270,38880,56544
train,5825,8,6144,33,4752,10896
train,5826,22,16896,247,35568,52464
train,5827,18,13824,165,23760,37584
train,5828,28,21504,400,57600,79104
train,5829,19,14592,184,26496,41088
train,5830,23,17664,270,38880,56544
train,5831,21,16128,225,32400,48528
train,5832,26,19968,345,49680,69648
train,5833,29,22272,429,61776,84048
train,5834,25,19200,319,45936,65136
train,5835,49,37632,1225,176400,214032
train,5836,43,33024,943,135792,168816
train,5837,39,29952,776,111744,141696
train,5838,29,22272,429,61776,84048
train,5839,31,23808,490,70560,94368
train,5840,38,29184,737,106128,135312
train,5841,23,17664,270,38880,56544
train,5842,22,16896,247,35568,52464
train,5843,23,17664,270,38880,56544
train,5844,3,2304,5,720,3024
train,5845,18,13824,165,23760,37584
train,5846,21,16128,225,32400,48528
train,5847,12,9216,73,10512,19728
train,5848,17,13056,147,21168,34224
train,5849,6,4608,18,2592,7200
train,5850,46,35328,1079,155376,190704
train,5851,26,19968,345,49680,69648
train,5852,23,17664,270,38880,56544
train,5853,12,9216,73,10512,19728
train,5854,9,6912,41,5904,12816
train,5855,15,11520,115,16560,28080
train,5856,19,14592,184,26496,41088
train,5857,19,14592,184,26496,41088
train,5858,30,23040,459,66096,89136
train,5859,34,26112,590,84960,111072
train,5860,14,10752,100,14400,25152
train,5861,33,25344,556,80064,105408
train,5862,31,23808,490,70560,94368
train,5863,16,12288,131,18864,31152
train,5864,7,5376,25,3600,8976
train,5865,8,6144,33,4752,10896
train,5866,10,7680,51,7344,15024
train,5867,54,41472,1488,214272,255744
train,5868,15,11520,115,16560,28080
train,5869,26,19968,345,49680,69648
train,5870,29,22272,429,61776,84048
train,5871,32,24576,522,75168,99744
train,5872,16,12288,131,18864,31152
train,5873,11,8448,62,8928,17376
train,5874,26,19968,345,49680,69648
train,5875,18,13824,165,23760,37584
train,5876,35,26880,625,90000,116880
train,5877,47,36096,1127,162288,198384
train,5878,25,19200,319,45936,65136
train,5879,36,27648,661,95184,122832
train,5880,12,9216,73,10512,19728
train,5881,43,33024,943,135792,168816
train,5882,9,6912,41,5904,12816
train,5883,18,13824,165,23760,37584
train,5884,19,14592,184,26496,41088
train,5885,21,16128,225,32400,48528
train,5886,24,18432,294,42336,60768
train,5887,24,18432,294,42336,60768
train,5888,43,33024,943,135792,168816
train,5889,26,19968,345,49680,69648
train,5890,16,12288,131,18864,31152
train,5891,43,33024,943,135792,168816
train,5892,15,11520,115,16560,28080
train,5893,11,8448,62,8928,17376
train,5894,13,9984,86,12384,22368
train,5895,33,25344,556,80064,105408
train,5896,19,14592,184,26496,41088
train,5897,41,31488,858,123552,155040
train,5898,24,18432,294,42336,60768
train,5899,28,21504,400,57600,79104
train,5900,27,20736,372,53568,74304
train,5901,25,19200,319,45936,65136
train,5902,9,6912,41,5904,12816
train,5903,31,23808,490,70560,94368
train,5904,16,12288,131,18864,31152
train,5905,39,29952,776,111744,141696
train,5906,27,20736,372,53568,74304
train,5907,22,16896,247,35568,52464
train,5908,9,6912,41,5904,12816
train,5909,17,13056,147,21168,34224
train,5910,14,10752,100,14400,25152
train,5911,30,23040,459,66096,89136
train,5912,10,7680,51,7344,15024
train,5913,41,31488,858,123552,155040
train,5914,26,19968,345,49680,69648
train,5915,14,10752,100,14400,25152
train,5916,18,13824,165,23760,37584
train,5917,26,19968,345,49680,69648
train,5918,11,8448,62,8928,17376
train,5919,11,8448,62,8928,17376
train,5920,17,13056,147,21168,34224
train,5921,33,25344,556,80064,105408
train,5922,32,24576,522,75168,99744
train,5923,6,4608,18,2592,7200
train,5924,6,4608,18,2592,7200
train,5925,40,30720,816,117504,148224
train,5926,21,16128,225,32400,48528
train,5927,3,2304,5,720,3024
train,5928,28,21504,400,57600,79104
train,5929,29,22272,429,61776,84048
train,5930,33,25344,556,80064,105408
train,5931,11,8448,62,8928,17376
train,5932,23,17664,270,38880,56544
train,5933,8,6144,33,4752,10896
train,5934,22,16896,247,35568,52464
train,5935,24,18432,294,42336,60768
train,5936,20,15360,204,29376,44736
train,5937,9,6912,41,5904,12816
train,5938,22,16896,247,35568,52464
train,5939,24,18432,294,42336,60768
train,5940,42,32256,900,129600,161856
train,5941,26,19968,345,49680,69648
train,5942,25,19200,319,45936,65136
train,5943,19,14592,184,26496,41088
train,5944,34,26112,590,84960,111072
train,5945,8,6144,33,4752,10896
train,5946,17,13056,147,21168,34224
train,5947,29,22272,429,61776,84048
train,5948,16,12288,131,18864,31152
train,5949,23,17664,270,38880,56544
train,5950,11,8448,62,8928,17376
train,5951,28,21504,400,57600,79104
train,5952,18,13824,165,23760,37584
train,5953,22,16896,247,35568,52464
train,5954,34,26112,590,84960,111072
train,5955,35,26880,625,90000,116880
train,5956,41,31488,858,123552,155040
train,5957,25,19200,319,45936,65136
train,5958,20,15360,204,29376,44736
train,5959,28,21504,400,57600,79104
train,5960,18,13824,165,23760,37584
train,5961,22,16896,247,35568,52464
train,5962,30,23040,459,66096,89136
train,5963,51,39168,1327,191088,230256
train,5964,14,10752,100,14400,25152
train,5965,23,17664,270,38880,56544
train,5966,16,12288,131,18864,31152
train,5967,34,26112,590,84960,111072
train,5968,19,14592,184,26496,41088
train,5969,22,16896,247,35568,52464
train,5970,48,36864,1175,169200,206064
train,5971,27,20736,372,53568,74304
train,5972,11,8448,62,8928,17376
train,5973,28,21504,400,57600,79104
train,5974,22,16896,247,35568,52464
train,5975,18,13824,165,23760,37584
train,5976,21,16128,225,32400,48528
train,5977,24,18432,294,42336,60768
train,5978,27,20736,372,53568,74304
train,5979,46,35328,1079,155376,190704
train,5980,23,17664,270,38880,56544
train,5981,40,30720,816,117504,148224
train,5982,36,27648,661,95184,122832
train,5983,10,7680,51,7344,15024
train,5984,27,20736,372,53568,74304
train,5985,29,22272,429,61776,84048
train,5986,20,15360,204,29376,44736
train,5987,38,29184,737,106128,135312
train,5988,26,19968,345,49680,69648
train,5989,31,23808,490,70560,94368
train,5990,27,20736,372,53568,74304
train,5991,24,18432,294,42336,60768
train,5992,7,5376,25,3600,8976
train,5993,14,10752,100,14400,25152
train,5994,36,27648,661,95184,122832
train,5995,19,14592,184,26496,41088
train,5996,19,14592,184,26496,41088
train,5997,10,7680,51,7344,15024
train,5998,34,26112,590,84960,111072
train,5999,33,25344,556,80064,105408
train,6000,46,35328,1079,155376,190704
train,6001,17,13056,147,21168,34224
train,6002,35,26880,625,90000,116880
train,6003,25,19200,319,45936,65136
train,6004,21,16128,225,32400,48528
train,6005,39,29952,776,111744,141696
train,6006,26,19968,345,49680,69648
train,6007,19,14592,184,26496,41088
train,6008,16,12288,131,18864,31152
train,6009,33,25344,556,80064,105408
train,6010,38,29184,737,106128,135312
train,6011,36,27648,661,95184,122832
train,6012,25,19200,319,45936,65136
train,6013,7,5376,25,3600,8976
train,6014,51,39168,1327,191088,230256
train,6015,24,18432,294,42336,60768
train,6016,22,16896,247,35568,52464
train,6017,26,19968,345,49680,69648
train,6018,24,18432,294,42336,60768
train,6019,27,20736,372,53568,74304
train,6020,33,25344,556,80064,105408
train,6021,13,9984,86,12384,22368
train,6022,23,17664,270,38880,56544
train,6023,11,8448,62,8928,17376
train,6024,21,16128,225,32400,48528
train,6025,22,16896,247,35568,52464
train,6026,36,27648,661,95184,122832
train,6027,10,7680,51,7344,15024
train,6028,20,15360,204,29376,44736
train,6029,25,19200,319,45936,65136
train,6030,5,3840,13,1872,5712
train,6031,21,16128,225,32400,48528
train,6032,11,8448,62,8928,17376
train,6033,26,19968,345,49680,69648
train,6034,16,12288,131,18864,31152
train,6035,32,24576,522,75168,99744
train,6036,20,15360,204,29376,44736
train,6037,47,36096,1127,162288,198384
train,6038,8,6144,33,4752,10896
train,6039,15,11520,115,16560,28080
train,6040,37,28416,698,100512,128928
train,6041,11,8448,62,8928,17376
train,6042,27,20736,372,53568,74304
train,6043,17,13056,147,21168,34224
train,6044,23,17664,270,38880,56544
train,6045,47,36096,1127,162288,198384
train,6046,49,37632,1225,176400,214032
train,6047,17,13056,147,21168,34224
train,6048,34,26112,590,84960,111072
train,6049,23,17664,270,38880,56544
train,6050,28,21504,400,57600,79104
train,6051,15,11520,115,16560,28080
train,6052,11,8448,62,8928,17376
train,6053,27,20736,372,53568,74304
train,6054,22,16896,247,35568,52464
train,6055,12,9216,73,10512,19728
train,6056,35,26880,625,90000,116880
train,6057,10,7680,51,7344,15024
train,6058,24,18432,294,42336,60768
train,6059,9,6912,41,5904,12816
train,6060,25,19200,319,45936,65136
train,6061,19,14592,184,26496,41088
train,6062,30,23040,459,66096,89136
train,6063,31,23808,490,70560,94368
train,6064,25,19200,319,45936,65136
train,6065,22,16896,247,35568,52464
train,6066,32,24576,522,75168,99744
train,6067,15,11520,115,16560,28080
train,6068,19,14592,184,26496,41088
train,6069,29,22272,429,61776,84048
train,6070,12,9216,73,10512,19728
train,6071,12,9216,73,10512,19728
train,6072,32,24576,522,75168,99744
train,6073,22,16896,247,35568,52464
train,6074,34,26112,590,84960,111072
train,6075,21,16128,225,32400,48528
train,6076,50,38400,1275,183600,222000
train,6077,5,3840,13,1872,5712
train,6078,8,6144,33,4752,10896
train,6079,21,16128,225,32400,48528
train,6080,16,12288,131,18864,31152
train,6081,13,9984,86,12384,22368
train,6082,31,23808,490,70560,94368
train,6083,22,16896,247,35568,52464
train,6084,14,10752,100,14400,25152
train,6085,6,4608,18,2592,7200
train,6086,25,19200,319,45936,65136
train,6087,30,23040,459,66096,89136
train,6088,25,19200,319,45936,65136
train,6089,9,6912,41,5904,12816
train,6090,9,6912,41,5904,12816
train,6091,24,18432,294,42336,60768
train,6092,14,10752,100,14400,25152
train,6093,21,16128,225,32400,48528
train,6094,17,13056,147,21168,34224
train,6095,32,24576,522,75168,99744
train,6096,18,13824,165,23760,37584
train,6097,22,16896,247,35568,52464
train,6098,34,26112,590,84960,111072
train,6099,13,9984,86,12384,22368
train,6100,6,4608,18,2592,7200
train,6101,19,14592,184,26496,41088
train,6102,25,19200,319,45936,65136
train,6103,9,6912,41,5904,12816
train,6104,18,13824,165,23760,37584
train,6105,23,17664,270,38880,56544
train,6106,29,22272,429,61776,84048
train,6107,17,13056,147,21168,34224
train,6108,11,8448,62,8928,17376
train,6109,40,30720,816,117504,148224
train,6110,26,19968,345,49680,69648
train,6111,7,5376,25,3600,8976
train,6112,33,25344,556,80064,105408
train,6113,11,8448,62,8928,17376
train,6114,15,11520,115,16560,28080
train,6115,24,18432,294,42336,60768
train,6116,23,17664,270,38880,56544
train,6117,22,16896,247,35568,52464
train,6118,42,32256,900,129600,161856
train,6119,35,26880,625,90000,116880
train,6120,24,18432,294,42336,60768
train,6121,5,3840,13,1872,5712
train,6122,23,17664,270,38880,56544
train,6123,32,24576,522,75168,99744
train,6124,41,31488,858,123552,155040
train,6125,32,24576,522,75168,99744
train,6126,16,12288,131,18864,31152
train,6127,12,9216,73,10512,19728
train,6128,25,19200,319,45936,65136
train,6129,13,9984,86,12384,22368
train,6130,17,13056,147,21168,34224
train,6131,21,16128,225,32400,48528
train,6132,8,6144,33,4752,10896
train,6133,26,19968,345,49680,69648
train,6134,13,9984,86,12384,22368
train,6135,17,13056,147,21168,34224
train,6136,20,15360,204,29376,44736
train,6137,27,20736,372,53568,74304
train,6138,24,18432,294,42336,60768
train,6139,23,17664,270,38880,56544
train,6140,20,15360,204,29376,44736
train,6141,16,12288,131,18864,31152
train,6142,15,11520,115,16560,28080
train,6143,26,19968,345,49680,69648
train,6144,17,13056,147,21168,34224
train,6145,14,10752,100,14400,25152
train,6146,20,15360,204,29376,44736
train,6147,30,23040,459,66096,89136
train,6148,31,23808,490,70560,94368
train,6149,14,10752,100,14400,25152
train,6150,36,27648,661,95184,122832
train,6151,8,6144,33,4752,10896
train,6152,24,18432,294,42336,60768
train,6153,19,14592,184,26496,41088
train,6154,21,16128,225,32400,48528
train,6155,41,31488,858,123552,155040
train,6156,26,19968,345,49680,69648
train,6157,27,20736,372,53568,74304
train,6158,35,26880,625,90000,116880
train,6159,30,23040,459,66096,89136
train,6160,40,30720,816,117504,148224
train,6161,24,18432,294,42336,60768
train,6162,41,31488,858,123552,155040
train,6163,17,13056,147,21168,34224
train,6164,24,18432,294,42336,60768
train,6165,35,26880,625,90000,116880
train,6166,8,6144,33,4752,10896
train,6167,7,5376,25,3600,8976
train,6168,12,9216,73,10512,19728
train,6169,24,18432,294,42336,60768
train,6170,28,21504,400,57600,79104
train,6171,16,12288,131,18864,31152
train,6172,29,22272,429,61776,84048
train,6173,10,7680,51,7344,15024
train,6174,18,13824,165,23760,37584
train,6175,29,22272,429,61776,84048
train,6176,17,13056,147,21168,34224
train,6177,8,6144,33,4752,10896
train,6178,28,21504,400,57600,79104
train,6179,20,15360,204,29376,44736
train,6180,15,11520,115,16560,28080
train,6181,31,23808,490,70560,94368
train,6182,13,9984,86,12384,22368
train,6183,14,10752,100,14400,25152
train,6184,31,23808,490,70560,94368
train,6185,40,30720,816,117504,148224
train,6186,49,37632,1225,176400,214032
train,6187,22,16896,247,35568,52464
train,6188,3,2304,5,720,3024
train,6189,18,13824,165,23760,37584
train,6190,20,15360,204,29376,44736
train,6191,31,23808,490,70560,94368
train,6192,18,13824,165,23760,37584
train,6193,10,7680,51,7344,15024
train,6194,20,15360,204,29376,44736
train,6195,18,13824,165,23760,37584
train,6196,5,3840,13,1872,5712
train,6197,15,11520,115,16560,28080
train,6198,48,36864,1175,169200,206064
train,6199,29,22272,429,61776,84048
train,6200,38,29184,737,106128,135312
train,6201,22,16896,247,35568,52464
train,6202,30,23040,459,66096,89136
train,6203,51,39168,1327,191088,230256
train,6204,23,17664,270,38880,56544
train,6205,20,15360,204,29376,44736
train,6206,32,24576,522,75168,99744
train,6207,25,19200,319,45936,65136
train,6208,38,29184,737,106128,135312
train,6209,21,16128,225,32400,48528
train,6210,20,15360,204,29376,44736
train,6211,23,17664,270,38880,56544
train,6212,26,19968,345,49680,69648
train,6213,11,8448,62,8928,17376
train,6214,14,10752,100,14400,25152
train,6215,29,22272,429,61776,84048
train,6216,45,34560,1033,148752,183312
train,6217,25,19200,319,45936,65136
train,6218,32,24576,522,75168,99744
train,6219,29,22272,429,61776,84048
train,6220,26,19968,345,49680,69648
train,6221,29,22272,429,61776,84048
train,6222,20,15360,204,29376,44736
train,6223,17,13056,147,21168,34224
train,6224,31,23808,490,70560,94368
train,6225,30,23040,459,66096,89136
train,6226,34,26112,590,84960,111072
train,6227,27,20736,372,53568,74304
train,6228,21,16128,225,32400,48528
train,6229,21,16128,225,32400,48528
train,6230,42,32256,900,129600,161856
train,6231,11,8448,62,8928,17376
train,6232,6,4608,18,2592,7200
train,6233,11,8448,62,8928,17376
train,6234,10,7680,51,7344,15024
train,6235,36,27648,661,95184,122832
train,6236,32,24576,522,75168,99744
train,6237,7,5376,25,3600,8976
train,6238,18,13824,165,23760,37584
train,6239,37,28416,698,100512,128928
train,6240,24,18432,294,42336,60768
train,6241,45,34560,1033,148752,183312
train,6242,27,20736,372,53568,74304
train,6243,14,10752,100,14400,25152
train,6244,16,12288,131,18864,31152
train,6245,22,16896,247,35568,52464
train,6246,10,7680,51,7344,15024
train,6247,27,20736,372,53568,74304
train,6248,36,27648,661,95184,122832
train,6249,31,23808,490,70560,94368
train,6250,33,25344,556,80064,105408
train,6251,6,4608,18,2592,7200
train,6252,33,25344,556,80064,105408
train,6253,6,4608,18,2592,7200
train,6254,18,13824,165,23760,37584
train,6255,20,15360,204,29376,44736
train,6256,8,6144,33,4752,10896
train,6257,11,8448,62,8928,17376
train,6258,22,16896,247,35568,52464
train,6259,23,17664,270,38880,56544
train,6260,7,5376,25,3600,8976
train,6261,32,24576,522,75168,99744
train,6262,26,19968,345,49680,69648
train,6263,41,31488,858,123552,155040
train,6264,37,28416,698,100512,128928
train,6265,5,3840,13,1872,5712
train,6266,14,10752,100,14400,25152
train,6267,28,21504,400,57600,79104
train,6268,52,39936,1379,198576,238512
train,6269,22,16896,247,35568,52464
train,6270,31,23808,490,70560,94368
train,6271,20,15360,204,29376,44736
train,6272,26,19968,345,49680,69648
train,6273,21,16128,225,32400,48528
train,6274,11,8448,62,8928,17376
train,6275,31,23808,490,70560,94368
train,6276,12,9216,73,10512,19728
train,6277,21,16128,225,32400,48528
train,6278,12,9216,73,10512,19728
train,6279,10,7680,51,7344,15024
train,6280,28,21504,400,57600,79104
train,6281,17,13056,147,21168,34224
train,6282,44,33792,988,142272,176064
train,6283,27,20736,372,53568,74304
train,6284,26,19968,345,49680,69648
train,6285,6,4608,18,2592,7200
train,6286,39,29952,776,111744,141696
train,6287,38,29184,737,106128,135312
train,6288,46,35328,1079,155376,190704
train,6289,44,33792,988,142272,176064
train,6290,29,22272,429,61776,84048
train,6291,36,27648,661,95184,122832
train,6292,6,4608,18,2592,7200
train,6293,30,23040,459,66096,89136
train,6294,24,18432,294,42336,60768
train,6295,28,21504,400,57600,79104
train,6296,25,19200,319,45936,65136
train,6297,11,8448,62,8928,17376
train,6298,18,13824,165,23760,37584
train,6299,28,21504,400,57600,79104
train,6300,28,21504,400,57600,79104
train,6301,8,6144,33,4752,10896
train,6302,22,16896,247,35568,52464
train,6303,23,17664,270,38880,56544
train,6304,26,19968,345,49680,69648
train,6305,13,9984,86,12384,22368
train,6306,27,20736,372,53568,74304
train,6307,32,24576,522,75168,99744
train,6308,16,12288,131,18864,31152
train,6309,27,20736,372,53568,74304
train,6310,45,34560,1033,148752,183312
train,6311,35,26880,625,90000,116880
train,6312,27,20736,372,53568,74304
train,6313,6,4608,18,2592,7200
train,6314,28,21504,400,57600,79104
train,6315,40,30720,816,117504,148224
train,6316,23,17664,270,38880,56544
train,6317,32,24576,522,75168,99744
train,6318,11,8448,62,8928,17376
train,6319,13,9984,86,12384,22368
train,6320,10,7680,51,7344,15024
train,6321,34,26112,590,84960,111072
train,6322,43,33024,943,135792,168816
train,6323,12,9216,73,10512,19728
train,6324,23,17664,270,38880,56544
train,6325,24,18432,294,42336,60768
train,6326,17,13056,147,21168,34224
train,6327,21,16128,225,32400,48528
train,6328,11,8448,62,8928,17376
train,6329,13,9984,86,12384,22368
train,6330,25,19200,319,45936,65136
train,6331,49,37632,1225,176400,214032
train,6332,42,32256,900,129600,161856
train,6333,31,23808,490,70560,94368
train,6334,36,27648,661,95184,122832
train,6335,11,8448,62,8928,17376
train,6336,16,12288,131,18864,31152
train,6337,26,19968,345,49680,69648
train,6338,17,13056,147,21168,34224
train,6339,28,21504,400,57600,79104
train,6340,46,35328,1079,155376,190704
train,6341,29,22272,429,61776,84048
train,6342,26,19968,345,49680,69648
train,6343,13,9984,86,12384,22368
train,6344,12,9216,73,10512,19728
train,6345,21,16128,225,32400,48528
train,6346,17,13056,147,21168,34224
train,6347,23,17664,270,38880,56544
train,6348,11,8448,62,8928,17376
train,6349,33,25344,556,80064,105408
train,6350,44,33792,988,142272,176064
train,6351,32,24576,522,75168,99744
train,6352,22,16896,247,35568,52464
train,6353,16,12288,131,18864,31152
train,6354,26,19968,345,49680,69648
train,6355,39,29952,776,111744,141696
train,6356,31,23808,490,70560,94368
train,6357,23,17664,270,38880,56544
train,6358,29,22272,429,61776,84048
train,6359,15,11520,115,16560,28080
train,6360,31,23808,490,70560,94368
train,6361,38,29184,737,106128,135312
train,6362,21,16128,225,32400,48528
train,6363,3,2304,5,720,3024
train,6364,10,7680,51,7344,15024
train,6365,35,26880,625,90000,116880
train,6366,14,10752,100,14400,25152
train,6367,10,7680,51,7344,15024
train,6368,8,6144,33,4752,10896
train,6369,42,32256,900,129600,161856
train,6370,7,5376,25,3600,8976
train,6371,22,16896,247,35568,52464
train,6372,37,28416,698,100512,128928
train,6373,18,13824,165,23760,37584
train,6374,24,18432,294,42336,60768
train,6375,27,20736,372,53568,74304
train,6376,29,22272,429,61776,84048
train,6377,11,8448,62,8928,17376
train,6378,16,12288,131,18864,31152
train,6379,15,11520,115,16560,28080
train,6380,40,30720,816,117504,148224
train,6381,15,11520,115,16560,28080
train,6382,20,15360,204,29376,44736
train,6383,24,18432,294,42336,60768
train,6384,6,4608,18,2592,7200
train,6385,20,15360,204,29376,44736
train,6386,24,18432,294,42336,60768
train,6387,42,32256,900,129600,161856
train,6388,38,29184,737,106128,135312
train,6389,15,11520,115,16560,28080
train,6390,28,21504,400,57600,79104
train,6391,33,25344,556,80064,105408
train,6392,15,11520,115,16560,28080
train,6393,48,36864,1175,169200,206064
train,6394,8,6144,33,4752,10896
train,6395,29,22272,429,61776,84048
train,6396,11,8448,62,8928,17376
train,6397,29,22272,429,61776,84048
train,6398,18,13824,165,23760,37584
train,6399,12,9216,73,10512,19728
train,6400,40,30720,816,117504,148224
train,6401,31,23808,490,70560,94368
train,6402,10,7680,51,7344,15024
train,6403,9,6912,41,5904,12816
train,6404,13,9984,86,12384,22368
train,6405,13,9984,86,12384,22368
train,6406,7,5376,25,3600,8976
train,6407,11,8448,62,8928,17376
train,6408,8,6144,33,4752,10896
train,6409,27,20736,372,53568,74304
train,6410,38,29184,737,106128,135312
train,6411,15,11520,115,16560,28080
train,6412,37,28416,698,100512,128928
train,6413,26,19968,345,49680,69648
train,6414,18,13824,165,23760,37584
train,6415,36,27648,661,95184,122832
train,6416,35,26880,625,90000,116880
train,6417,25,19200,319,45936,65136
train,6418,19,14592,184,26496,41088
train,6419,17,13056,147,21168,34224
train,6420,23,17664,270,38880,56544
train,6421,18,13824,165,23760,37584
train,6422,19,14592,184,26496,41088
train,6423,8,6144,33,4752,10896
train,6424,14,10752,100,14400,25152
train,6425,19,14592,184,26496,41088
train,6426,31,23808,490,70560,94368
train,6427,35,26880,625,90000,116880
train,6428,22,16896,247,35568,52464
train,6429,7,5376,25,3600,8976
train,6430,18,13824,165,23760,37584
train,6431,22,16896,247,35568,52464
train,6432,7,5376,25,3600,8976
train,6433,46,35328,1079,155376,190704
train,6434,13,9984,86,12384,22368
train,6435,23,17664,270,38880,56544
train,6436,27,20736,372,53568,74304
train,6437,22,16896,247,35568,52464
train,6438,44,33792,988,142272,176064
train,6439,44,33792,988,142272,176064
train,6440,33,25344,556,80064,105408
train,6441,26,19968,345,49680,69648
train,6442,17,13056,147,21168,34224
train,6443,45,34560,1033,148752,183312
train,6444,12,9216,73,10512,19728
train,6445,7,5376,25,3600,8976
train,6446,5,3840,13,1872,5712
train,6447,8,6144,33,4752,10896
train,6448,27,20736,372,53568,74304
train,6449,24,18432,294,42336,60768
train,6450,25,19200,319,45936,65136
train,6451,10,7680,51,7344,15024
train,6452,29,22272,429,61776,84048
train,6453,13,9984,86,12384,22368
train,6454,5,3840,13,1872,5712
train,6455,14,10752,100,14400,25152
train,6456,21,16128,225,32400,48528
train,6457,21,16128,225,32400,48528
train,6458,38,29184,737,106128,135312
train,6459,26,19968,345,49680,69648
train,6460,16,12288,131,18864,31152
train,6461,12,9216,73,10512,19728
train,6462,24,18432,294,42336,60768
train,6463,6,4608,18,2592,7200
train,6464,19,14592,184,26496,41088
train,6465,14,10752,100,14400,25152
train,6466,15,11520,115,16560,28080
train,6467,49,37632,1225,176400,214032
train,6468,10,7680,51,7344,15024
train,6469,25,19200,319,45936,65136
train,6470,30,23040,459,66096,89136
train,6471,25,19200,319,45936,65136
train,6472,13,9984,86,12384,22368
train,6473,9,6912,41,5904,12816
train,6474,10,7680,51,7344,15024
train,6475,49,37632,1225,176400,214032
train,6476,13,9984,86,12384,22368
train,6477,30,23040,459,66096,89136
train,6478,24,18432,294,42336,60768
train,6479,26,19968,345,49680,69648
train,6480,11,8448,62,8928,17376
train,6481,38,29184,737,106128,135312
train,6482,23,17664,270,38880,56544
train,6483,13,9984,86,12384,22368
train,6484,51,39168,1327,191088,230256
train,6485,23,17664,270,38880,56544
train,6486,24,18432,294,42336,60768
train,6487,42,32256,900,129600,161856
train,6488,16,12288,131,18864,31152
train,6489,4,3072,8,1152,4224
train,6490,24,18432,294,42336,60768
train,6491,40,30720,816,117504,148224
train,6492,29,22272,429,61776,84048
train,6493,45,34560,1033,148752,183312
train,6494,20,15360,204,29376,44736
train,6495,24,18432,294,42336,60768
train,6496,37,28416,698,100512,128928
train,6497,26,19968,345,49680,69648
train,6498,17,13056,147,21168,34224
train,6499,51,39168,1327,191088,230256
train,6500,23,17664,270,38880,56544
train,6501,35,26880,625,90000,116880
train,6502,4,3072,8,1152,4224
train,6503,29,22272,429,61776,84048
train,6504,26,19968,345,49680,69648
train,6505,21,16128,225,32400,48528
train,6506,32,24576,522,75168,99744
train,6507,12,9216,73,10512,19728
train,6508,11,8448,62,8928,17376
train,6509,29,22272,429,61776,84048
train,6510,15,11520,115,16560,28080
train,6511,21,16128,225,32400,48528
train,6512,17,13056,147,21168,34224
train,6513,25,19200,319,45936,65136
train,6514,27,20736,372,53568,74304
train,6515,7,5376,25,3600,8976
train,6516,26,19968,345,49680,69648
train,6517,23,17664,270,38880,56544
train,6518,9,6912,41,5904,12816
train,6519,5,3840,13,1872,5712
train,6520,9,6912,41,5904,12816
train,6521,3,2304,5,720,3024
train,6522,22,16896,247,35568,52464
train,6523,20,15360,204,29376,44736
train,6524,20,15360,204,29376,44736
train,6525,16,12288,131,18864,31152
train,6526,7,5376,25,3600,8976
train,6527,18,13824,165,23760,37584
train,6528,2,1536,2,288,1824
train,6529,17,13056,147,21168,34224
train,6530,18,13824,165,23760,37584
train,6531,25,19200,319,45936,65136
train,6532,19,14592,184,26496,41088
train,6533,16,12288,131,18864,31152
train,6534,35,26880,625,90000,116880
train,6535,28,21504,400,57600,79104
train,6536,18,13824,165,23760,37584
train,6537,33,25344,556,80064,105408
train,6538,48,36864,1175,169200,206064
train,6539,7,5376,25,3600,8976
train,6540,28,21504,400,57600,79104
train,6541,23,17664,270,38880,56544
train,6542,9,6912,41,5904,12816
train,6543,22,16896,247,35568,52464
train,6544,34,26112,590,84960,111072
train,6545,39,29952,776,111744,141696
train,6546,15,11520,115,16560,28080
train,6547,29,22272,429,61776,84048
train,6548,37,28416,698,100512,128928
train,6549,14,10752,100,14400,25152
train,6550,12,9216,73,10512,19728
train,6551,11,8448,62,8928,17376
train,6552,4,3072,8,1152,4224
train,6553,20,15360,204,29376,44736
train,6554,21,16128,225,32400,48528
train,6555,12,9216,73,10512,19728
train,6556,18,13824,165,23760,37584
train,6557,14,10752,100,14400,25152
train,6558,24,18432,294,42336,60768
train,6559,38,29184,737,106128,135312
train,6560,10,7680,51,7344,15024
train,6561,9,6912,41,5904,12816
train,6562,6,4608,18,2592,7200
train,6563,4,3072,8,1152,4224
train,6564,7,5376,25,3600,8976
train,6565,5,3840,13,1872,5712
train,6566,42,32256,900,129600,161856
train,6567,32,24576,522,75168,99744
train,6568,30,23040,459,66096,89136
train,6569,20,15360,204,29376,44736
train,6570,53,40704,1433,206352,247056
train,6571,12,9216,73,10512,19728
train,6572,19,14592,184,26496,41088
train,6573,29,22272,429,61776,84048
train,6574,37,28416,698,100512,128928
train,6575,32,24576,522,75168,99744
train,6576,11,8448,62,8928,17376
train,6577,11,8448,62,8928,17376
train,6578,16,12288,131,18864,31152
train,6579,26,19968,345,49680,69648
train,6580,13,9984,86,12384,22368
train,6581,46,35328,1079,155376,190704
train,6582,5,3840,13,1872,5712
train,6583,16,12288,131,18864,31152
train,6584,17,13056,147,21168,34224
train,6585,30,23040,459,66096,89136
train,6586,23,17664,270,38880,56544
train,6587,31,23808,490,70560,94368
train,6588,30,23040,459,66096,89136
train,6589,14,10752,100,14400,25152
train,6590,13,9984,86,12384,22368
train,6591,16,12288,131,18864,31152
train,6592,26,19968,345,49680,69648
train,6593,12,9216,73,10512,19728
train,6594,14,10752,100,14400,25152
train,6595,29,22272,429,61776,84048
train,6596,50,38400,1275,183600,222000
train,6597,12,9216,73,10512,19728
train,6598,19,14592,184,26496,41088
train,6599,27,20736,372,53568,74304
train,6600,16,12288,131,18864,31152
train,6601,7,5376,25,3600,8976
train,6602,11,8448,62,8928,17376
train,6603,20,15360,204,29376,44736
train,6604,26,19968,345,49680,69648
train,6605,4,3072,8,1152,4224
train,6606,12,9216,73,10512,19728
train,6607,35,26880,625,90000,116880
train,6608,17,13056,147,21168,34224
train,6609,17,13056,147,21168,34224
train,6610,21,16128,225,32400,48528
train,6611,19,14592,184,26496,41088
train,6612,27,20736,372,53568,74304
train,6613,27,20736,372,53568,74304
train,6614,3,2304,5,720,3024
train,6615,18,13824,165,23760,37584
train,6616,17,13056,147,21168,34224
train,6617,19,14592,184,26496,41088
train,6618,41,31488,858,123552,155040
train,6619,27,20736,372,53568,74304
train,6620,28,21504,400,57600,79104
train,6621,21,16128,225,32400,48528
train,6622,27,20736,372,53568,74304
train,6623,32,24576,522,75168,99744
train,6624,8,6144,33,4752,10896
train,6625,19,14592,184,26496,41088
train,6626,18,13824,165,23760,37584
train,6627,40,30720,816,117504,148224
train,6628,20,15360,204,29376,44736
train,6629,6,4608,18,2592,7200
train,6630,33,25344,556,80064,105408
train,6631,14,10752,100,14400,25152
train,6632,25,19200,319,45936,65136
train,6633,18,13824,165,23760,37584
train,6634,19,14592,184,26496,41088
train,6635,28,21504,400,57600,79104
train,6636,24,18432,294,42336,60768
train,6637,19,14592,184,26496,41088
train,6638,4,3072,8,1152,4224
train,6639,15,11520,115,16560,28080
train,6640,6,4608,18,2592,7200
train,6641,17,13056,147,21168,34224
train,6642,43,33024,943,135792,168816
train,6643,10,7680,51,7344,15024
train,6644,23,17664,270,38880,56544
train,6645,8,6144,33,4752,10896
train,6646,40,30720,816,117504,148224
train,6647,42,32256,900,129600,161856
train,6648,32,24576,522,75168,99744
train,6649,23,17664,270,38880,56544
train,6650,25,19200,319,45936,65136
train,6651,13,9984,86,12384,22368
train,6652,30,23040,459,66096,89136
train,6653,29,22272,429,61776,84048
train,6654,12,9216,73,10512,19728
train,6655,25,19200,319,45936,65136
train,6656,32,24576,522,75168,99744
train,6657,23,17664,270,38880,56544
train,6658,14,10752,100,14400,25152
train,6659,25,19200,319,45936,65136
train,6660,29,22272,429,61776,84048
train,6661,11,8448,62,8928,17376
train,6662,11,8448,62,8928,17376
train,6663,30,23040,459,66096,89136
train,6664,21,16128,225,32400,48528
train,6665,11,8448,62,8928,17376
train,6666,13,9984,86,12384,22368
train,6667,6,4608,18,2592,7200
train,6668,37,28416,698,100512,128928
train,6669,29,22272,429,61776,84048
train,6670,27,20736,372,53568,74304
train,6671,33,25344,556,80064,105408
train,6672,17,13056,147,21168,34224
train,6673,42,32256,900,129600,161856
train,6674,13,9984,86,12384,22368
train,6675,13,9984,86,12384,22368
train,6676,7,5376,25,3600,8976
train,6677,17,13056,147,21168,34224
train,6678,30,23040,459,66096,89136
train,6679,24,18432,294,42336,60768
train,6680,28,21504,400,57600,79104
train,6681,21,16128,225,32400,48528
train,6682,25,19200,319,45936,65136
train,6683,58,44544,1716,247104,291648
train,6684,29,22272,429,61776,84048
train,6685,23,17664,270,38880,56544
train,6686,13,9984,86,12384,22368
train,6687,3,2304,5,720,3024
train,6688,14,10752,100,14400,25152
train,6689,12,9216,73,10512,19728
train,6690,17,13056,147,21168,34224
train,6691,33,25344,556,80064,105408
train,6692,26,19968,345,49680,69648
train,6693,15,11520,115,16560,28080
train,6694,22,16896,247,35568,52464
train,6695,46,35328,1079,155376,190704
train,6696,42,32256,900,129600,161856
train,6697,35,26880,625,90000,116880
train,6698,39,29952,776,111744,141696
train,6699,12,9216,73,10512,19728
train,6700,26,19968,345,49680,69648
train,6701,5,3840,13,1872,5712
train,6702,28,21504,400,57600,79104
train,6703,14,10752,100,14400,25152
train,6704,26,19968,345,49680,69648
train,6705,4,3072,8,1152,4224
train,6706,16,12288,131,18864,31152
train,6707,22,16896,247,35568,52464
train,6708,12,9216,73,10512,19728
train,6709,17,13056,147,21168,34224
train,6710,24,18432,294,42336,60768
train,6711,36,27648,661,95184,122832
train,6712,46,35328,1079,155376,190704
train,6713,35,26880,625,90000,116880
train,6714,24,18432,294,42336,60768
train,6715,26,19968,345,49680,69648
train,6716,21,16128,225,32400,48528
train,6717,33,25344,556,80064,105408
train,6718,9,6912,41,5904,12816
train,6719,18,13824,165,23760,37584
train,6720,9,6912,41,5904,12816
train,6721,14,10752,100,14400,25152
train,6722,35,26880,625,90000,116880
train,6723,9,6912,41,5904,12816
train,6724,20,15360,204,29376,44736
train,6725,18,13824,165,23760,37584
train,6726,28,21504,400,57600,79104
train,6727,38,29184,737,106128,135312
train,6728,14,10752,100,14400,25152
train,6729,13,9984,86,12384,22368
train,6730,4,3072,8,1152,4224
train,6731,5,3840,13,1872,5712
train,6732,41,31488,858,123552,155040
train,6733,20,15360,204,29376,44736
train,6734,31,23808,490,70560,94368
train,6735,42,32256,900,129600,161856
train,6736,23,17664,270,38880,56544
train,6737,14,10752,100,14400,25152
train,6738,13,9984,86,12384,22368
train,6739,19,14592,184,26496,41088
train,6740,40,30720,816,117504,148224
train,6741,34,26112,590,84960,111072
train,6742,14,10752,100,14400,25152
train,6743,31,23808,490,70560,94368
train,6744,19,14592,184,26496,41088
train,6745,16,12288,131,18864,31152
train,6746,27,20736,372,53568,74304
train,6747,9,6912,41,5904,12816
train,6748,5,3840,13,1872,5712
train,6749,16,12288,131,18864,31152
train,6750,39,29952,776,111744,141696
train,6751,20,15360,204,29376,44736
train,6752,28,21504,400,57600,79104
train,6753,30,23040,459,66096,89136
train,6754,26,19968,345,49680,69648
train,6755,4,3072,8,1152,4224
train,6756,17,13056,147,21168,34224
train,6757,25,19200,319,45936,65136
train,6758,21,16128,225,32400,48528
train,6759,22,16896,247,35568,52464
train,6760,19,14592,184,26496,41088
train,6761,10,7680,51,7344,15024
train,6762,40,30720,816,117504,148224
train,6763,24,18432,294,42336,60768
train,6764,35,26880,625,90000,116880
train,6765,45,34560,1033,148752,183312
train,6766,40,30720,816,117504,148224
train,6767,20,15360,204,29376,44736
train,6768,30,23040,459,66096,89136
train,6769,6,4608,18,2592,7200
train,6770,9,6912,41,5904,12816
train,6771,7,5376,25,3600,8976
train,6772,12,9216,73,10512,19728
train,6773,7,5376,25,3600,8976
train,6774,4,3072,8,1152,4224
train,6775,37,28416,698,100512,128928
train,6776,5,3840,13,1872,5712
train,6777,15,11520,115,16560,28080
train,6778,28,21504,400,57600,79104
train,6779,31,23808,490,70560,94368
train,6780,32,24576,522,75168,99744
train,6781,24,18432,294,42336,60768
train,6782,39,29952,776,111744,141696
train,6783,31,23808,490,70560,94368
train,6784,42,32256,900,129600,161856
train,6785,32,24576,522,75168,99744
train,6786,12,9216,73,10512,19728
train,6787,12,9216,73,10512,19728
train,6788,32,24576,522,75168,99744
train,6789,23,17664,270,38880,56544
train,6790,8,6144,33,4752,10896
train,6791,41,31488,858,123552,155040
train,6792,28,21504,400,57600,79104
train,6793,41,31488,858,123552,155040
train,6794,21,16128,225,32400,48528
train,6795,22,16896,247,35568,52464
train,6796,11,8448,62,8928,17376
train,6797,20,15360,204,29376,44736
train,6798,9,6912,41,5904,12816
train,6799,27,20736,372,53568,74304
train,6800,6,4608,18,2592,7200
train,6801,13,9984,86,12384,22368
train,6802,14,10752,100,14400,25152
train,6803,16,12288,131,18864,31152
train,6804,25,19200,319,45936,65136
train,6805,10,7680,51,7344,15024
train,6806,41,31488,858,123552,155040
train,6807,10,7680,51,7344,15024
train,6808,19,14592,184,26496,41088
train,6809,11,8448,62,8928,17376
train,6810,21,16128,225,32400,48528
train,6811,27,20736,372,53568,74304
train,6812,23,17664,270,38880,56544
train,6813,25,19200,319,45936,65136
train,6814,8,6144,33,4752,10896
train,6815,41,31488,858,123552,155040
train,6816,25,19200,319,45936,65136
train,6817,33,25344,556,80064,105408
train,6818,20,15360,204,29376,44736
train,6819,18,13824,165,23760,37584
train,6820,33,25344,556,80064,105408
train,6821,24,18432,294,42336,60768
train,6822,7,5376,25,3600,8976
train,6823,18,13824,165,23760,37584
train,6824,11,8448,62,8928,17376
train,6825,40,30720,816,117504,148224
train,6826,50,38400,1275,183600,222000
train,6827,28,21504,400,57600,79104
train,6828,9,6912,41,5904,12816
train,6829,32,24576,522,75168,99744
train,6830,31,23808,490,70560,94368
train,6831,11,8448,62,8928,17376
train,6832,29,22272,429,61776,84048
train,6833,43,33024,943,135792,168816
train,6834,46,35328,1079,155376,190704
train,6835,21,16128,225,32400,48528
train,6836,25,19200,319,45936,65136
train,6837,16,12288,131,18864,31152
train,6838,22,16896,247,35568,52464
train,6839,24,18432,294,42336,60768
train,6840,6,4608,18,2592,7200
train,6841,13,9984,86,12384,22368
train,6842,29,22272,429,61776,84048
train,6843,8,6144,33,4752,10896
train,6844,24,18432,294,42336,60768
train,6845,31,23808,490,70560,94368
train,6846,25,19200,319,45936,65136
train,6847,34,26112,590,84960,111072
train,6848,16,12288,131,18864,31152
train,6849,31,23808,490,70560,94368
train,6850,49,37632,1225,176400,214032
train,6851,37,28416,698,100512,128928
train,6852,23,17664,270,38880,56544
train,6853,19,14592,184,26496,41088
train,6854,17,13056,147,21168,34224
train,6855,26,19968,345,49680,69648
train,6856,20,15360,204,29376,44736
train,6857,23,17664,270,38880,56544
train,6858,17,13056,147,21168,34224
train,6859,18,13824,165,23760,37584
train,6860,28,21504,400,57600,79104
train,6861,23,17664,270,38880,56544
train,6862,21,16128,225,32400,48528
train,6863,16,12288,131,18864,31152
train,6864,34,26112,590,84960,111072
train,6865,39,29952,776,111744,141696
train,6866,28,21504,400,57600,79104
train,6867,34,26112,590,84960,111072
train,6868,49,37632,1225,176400,214032
train,6869,22,16896,247,35568,52464
train,6870,25,19200,319,45936,65136
train,6871,17,13056,147,21168,34224
train,6872,22,16896,247,35568,52464
train,6873,19,14592,184,26496,41088
train,6874,16,12288,131,18864,31152
train,6875,28,21504,400,57600,79104
train,6876,44,33792,988,142272,176064
train,6877,19,14592,184,26496,41088
train,6878,28,21504,400,57600,79104
train,6879,7,5376,25,3600,8976
train,6880,16,12288,131,18864,31152
train,6881,41,31488,858,123552,155040
train,6882,13,9984,86,12384,22368
train,6883,17,13056,147,21168,34224
train,6884,23,17664,270,38880,56544
train,6885,27,20736,372,53568,74304
train,6886,31,23808,490,70560,94368
train,6887,31,23808,490,70560,94368
train,6888,35,26880,625,90000,116880
train,6889,46,35328,1079,155376,190704
train,6890,18,13824,165,23760,37584
train,6891,34,26112,590,84960,111072
train,6892,14,10752,100,14400,25152
train,6893,19,14592,184,26496,41088
train,6894,22,16896,247,35568,52464
train,6895,9,6912,41,5904,12816
train,6896,21,16128,225,32400,48528
train,6897,28,21504,400,57600,79104
train,6898,35,26880,625,90000,116880
train,6899,28,21504,400,57600,79104
train,6900,22,16896,247,35568,52464
train,6901,10,7680,51,7344,15024
train,6902,12,9216,73,10512,19728
train,6903,20,15360,204,29376,44736
train,6904,28,21504,400,57600,79104
train,6905,18,13824,165,23760,37584
train,6906,8,6144,33,4752,10896
train,6907,26,19968,345,49680,69648
train,6908,17,13056,147,21168,34224
train,6909,15,11520,115,16560,28080
train,6910,11,8448,62,8928,17376
train,6911,20,15360,204,29376,44736
train,6912,22,16896,247,35568,52464
train,6913,20,15360,204,29376,44736
train,6914,20,15360,204,29376,44736
train,6915,30,23040,459,66096,89136
train,6916,23,17664,270,38880,56544
train,6917,12,9216,73,10512,19728
train,6918,21,16128,225,32400,48528
train,6919,35,26880,625,90000,116880
validation,0,24,18432,294,42336,60768
validation,1,33,25344,556,80064,105408
validation,2,33,25344,556,80064,105408
validation,3,34,26112,590,84960,111072
validation,4,27,20736,372,53568,74304
validation,5,24,18432,294,42336,60768
validation,6,19,14592,184,26496,41088
validation,7,24,18432,294,42336,60768
validation,8,20,15360,204,29376,44736
validation,9,33,25344,556,80064,105408
validation,10,27,20736,372,53568,74304
validation,11,15,11520,115,16560,28080
validation,12,23,17664,270,38880,56544
validation,13,52,39936,1379,198576,238512
validation,14,23,17664,270,38880,56544
validation,15,14,10752,100,14400,25152
validation,16,10,7680,51,7344,15024
validation,17,12,9216,73,10512,19728
validation,18,22,16896,247,35568,52464
validation,19,12,9216,73,10512,19728
validation,20,36,27648,661,95184,122832
validation,21,30,23040,459,66096,89136
validation,22,10,7680,51,7344,15024
validation,23,7,5376,25,3600,8976
validation,24,28,21504,400,57600,79104
validation,25,51,39168,1327,191088,230256
validation,26,13,9984,86,12384,22368
validation,27,13,9984,86,12384,22368
validation,28,43,33024,943,135792,168816
validation,29,16,12288,131,18864,31152
validation,30,16,12288,131,18864,31152
validation,31,47,36096,1127,162288,198384
validation,32,21,16128,225,32400,48528
validation,33,37,28416,698,100512,128928
validation,34,18,13824,165,23760,37584
validation,35,38,29184,737,106128,135312
validation,36,31,23808,490,70560,94368
validation,37,23,17664,270,38880,56544
validation,38,22,16896,247,35568,52464
validation,39,31,23808,490,70560,94368
validation,40,35,26880,625,90000,116880
validation,41,12,9216,73,10512,19728
validation,42,32,24576,522,75168,99744
validation,43,12,9216,73,10512,19728
validation,44,30,23040,459,66096,89136
validation,45,34,26112,590,84960,111072
validation,46,18,13824,165,23760,37584
validation,47,13,9984,86,12384,22368
validation,48,7,5376,25,3600,8976
validation,49,12,9216,73,10512,19728
validation,50,25,19200,319,45936,65136
validation,51,32,24576,522,75168,99744
validation,52,18,13824,165,23760,37584
validation,53,10,7680,51,7344,15024
validation,54,21,16128,225,32400,48528
validation,55,28,21504,400,57600,79104
validation,56,19,14592,184,26496,41088
validation,57,19,14592,184,26496,41088
validation,58,16,12288,131,18864,31152
validation,59,19,14592,184,26496,41088
validation,60,5,3840,13,1872,5712
validation,61,14,10752,100,14400,25152
validation,62,12,9216,73,10512,19728
validation,63,20,15360,204,29376,44736
validation,64,11,8448,62,8928,17376
validation,65,25,19200,319,45936,65136
validation,66,32,24576,522,75168,99744
validation,67,7,5376,25,3600,8976
validation,68,13,9984,86,12384,22368
validation,69,30,23040,459,66096,89136
validation,70,18,13824,165,23760,37584
validation,71,29,22272,429,61776,84048
validation,72,16,12288,131,18864,31152
validation,73,25,19200,319,45936,65136
validation,74,28,21504,400,57600,79104
validation,75,17,13056,147,21168,34224
validation,76,32,24576,522,75168,99744
validation,77,27,20736,372,53568,74304
validation,78,17,13056,147,21168,34224
validation,79,28,21504,400,57600,79104
validation,80,46,35328,1079,155376,190704
validation,81,15,11520,115,16560,28080
validation,82,23,17664,270,38880,56544
validation,83,42,32256,900,129600,161856
validation,84,33,25344,556,80064,105408
validation,85,22,16896,247,35568,52464
validation,86,14,10752,100,14400,25152
validation,87,20,15360,204,29376,44736
validation,88,17,13056,147,21168,34224
validation,89,32,24576,522,75168,99744
validation,90,15,11520,115,16560,28080
validation,91,26,19968,345,49680,69648
validation,92,26,19968,345,49680,69648
validation,93,18,13824,165,23760,37584
validation,94,25,19200,319,45936,65136
validation,95,32,24576,522,75168,99744
validation,96,50,38400,1275,183600,222000
validation,97,36,27648,661,95184,122832
validation,98,21,16128,225,32400,48528
validation,99,19,14592,184,26496,41088
validation,100,42,32256,900,129600,161856
validation,101,18,13824,165,23760,37584
validation,102,20,15360,204,29376,44736
validation,103,47,36096,1127,162288,198384
validation,104,22,16896,247,35568,52464
validation,105,18,13824,165,23760,37584
validation,106,27,20736,372,53568,74304
validation,107,45,34560,1033,148752,183312
validation,108,12,9216,73,10512,19728
validation,109,19,14592,184,26496,41088
validation,110,33,25344,556,80064,105408
validation,111,39,29952,776,111744,141696
validation,112,32,24576,522,75168,99744
validation,113,25,19200,319,45936,65136
validation,114,32,24576,522,75168,99744
validation,115,6,4608,18,2592,7200
validation,116,41,31488,858,123552,155040
validation,117,31,23808,490,70560,94368
validation,118,19,14592,184,26496,41088
validation,119,19,14592,184,26496,41088
validation,120,27,20736,372,53568,74304
validation,121,36,27648,661,95184,122832
validation,122,27,20736,372,53568,74304
validation,123,10,7680,51,7344,15024
validation,124,34,26112,590,84960,111072
validation,125,12,9216,73,10512,19728
validation,126,22,16896,247,35568,52464
validation,127,25,19200,319,45936,65136
validation,128,45,34560,1033,148752,183312
validation,129,34,26112,590,84960,111072
validation,130,32,24576,522,75168,99744
validation,131,28,21504,400,57600,79104
validation,132,39,29952,776,111744,141696
validation,133,44,33792,988,142272,176064
validation,134,30,23040,459,66096,89136
validation,135,28,21504,400,57600,79104
validation,136,21,16128,225,32400,48528
validation,137,42,32256,900,129600,161856
validation,138,28,21504,400,57600,79104
validation,139,15,11520,115,16560,28080
validation,140,34,26112,590,84960,111072
validation,141,43,33024,943,135792,168816
validation,142,31,23808,490,70560,94368
validation,143,20,15360,204,29376,44736
validation,144,20,15360,204,29376,44736
validation,145,37,28416,698,100512,128928
validation,146,37,28416,698,100512,128928
validation,147,28,21504,400,57600,79104
validation,148,37,28416,698,100512,128928
validation,149,18,13824,165,23760,37584
validation,150,42,32256,900,129600,161856
validation,151,26,19968,345,49680,69648
validation,152,9,6912,41,5904,12816
validation,153,12,9216,73,10512,19728
validation,154,21,16128,225,32400,48528
validation,155,7,5376,25,3600,8976
validation,156,11,8448,62,8928,17376
validation,157,23,17664,270,38880,56544
validation,158,25,19200,319,45936,65136
validation,159,12,9216,73,10512,19728
validation,160,16,12288,131,18864,31152
validation,161,19,14592,184,26496,41088
validation,162,20,15360,204,29376,44736
validation,163,35,26880,625,90000,116880
validation,164,9,6912,41,5904,12816
validation,165,20,15360,204,29376,44736
validation,166,30,23040,459,66096,89136
validation,167,31,23808,490,70560,94368
validation,168,14,10752,100,14400,25152
validation,169,10,7680,51,7344,15024
validation,170,21,16128,225,32400,48528
validation,171,22,16896,247,35568,52464
validation,172,24,18432,294,42336,60768
validation,173,25,19200,319,45936,65136
validation,174,25,19200,319,45936,65136
validation,175,42,32256,900,129600,161856
validation,176,11,8448,62,8928,17376
validation,177,25,19200,319,45936,65136
validation,178,33,25344,556,80064,105408
validation,179,21,16128,225,32400,48528
validation,180,25,19200,319,45936,65136
validation,181,37,28416,698,100512,128928
validation,182,23,17664,270,38880,56544
validation,183,19,14592,184,26496,41088
validation,184,27,20736,372,53568,74304
validation,185,9,6912,41,5904,12816
validation,186,24,18432,294,42336,60768
validation,187,32,24576,522,75168,99744
validation,188,20,15360,204,29376,44736
validation,189,14,10752,100,14400,25152
validation,190,37,28416,698,100512,128928
validation,191,27,20736,372,53568,74304
validation,192,32,24576,522,75168,99744
validation,193,16,12288,131,18864,31152
validation,194,15,11520,115,16560,28080
validation,195,12,9216,73,10512,19728
validation,196,11,8448,62,8928,17376
validation,197,18,13824,165,23760,37584
validation,198,40,30720,816,117504,148224
validation,199,17,13056,147,21168,34224
validation,200,38,29184,737,106128,135312
validation,201,34,26112,590,84960,111072
validation,202,8,6144,33,4752,10896
validation,203,10,7680,51,7344,15024
validation,204,28,21504,400,57600,79104
validation,205,17,13056,147,21168,34224
validation,206,15,11520,115,16560,28080
validation,207,31,23808,490,70560,94368
validation,208,51,39168,1327,191088,230256
validation,209,3,2304,5,720,3024
validation,210,20,15360,204,29376,44736
validation,211,10,7680,51,7344,15024
validation,212,12,9216,73,10512,19728
validation,213,29,22272,429,61776,84048
validation,214,20,15360,204,29376,44736
validation,215,10,7680,51,7344,15024
validation,216,35,26880,625,90000,116880
validation,217,38,29184,737,106128,135312
validation,218,28,21504,400,57600,79104
validation,219,26,19968,345,49680,69648
validation,220,24,18432,294,42336,60768
validation,221,17,13056,147,21168,34224
validation,222,20,15360,204,29376,44736
validation,223,41,31488,858,123552,155040
validation,224,45,34560,1033,148752,183312
validation,225,26,19968,345,49680,69648
validation,226,25,19200,319,45936,65136
validation,227,22,16896,247,35568,52464
validation,228,35,26880,625,90000,116880
validation,229,16,12288,131,18864,31152
validation,230,23,17664,270,38880,56544
validation,231,12,9216,73,10512,19728
validation,232,5,3840,13,1872,5712
validation,233,26,19968,345,49680,69648
validation,234,11,8448,62,8928,17376
validation,235,23,17664,270,38880,56544
validation,236,26,19968,345,49680,69648
validation,237,25,19200,319,45936,65136
validation,238,13,9984,86,12384,22368
validation,239,19,14592,184,26496,41088
validation,240,16,12288,131,18864,31152
validation,241,17,13056,147,21168,34224
validation,242,13,9984,86,12384,22368
validation,243,7,5376,25,3600,8976
validation,244,10,7680,51,7344,15024
validation,245,25,19200,319,45936,65136
validation,246,8,6144,33,4752,10896
validation,247,18,13824,165,23760,37584
validation,248,17,13056,147,21168,34224
validation,249,49,37632,1225,176400,214032
validation,250,18,13824,165,23760,37584
validation,251,37,28416,698,100512,128928
validation,252,23,17664,270,38880,56544
validation,253,35,26880,625,90000,116880
validation,254,23,17664,270,38880,56544
validation,255,16,12288,131,18864,31152
validation,256,13,9984,86,12384,22368
validation,257,45,34560,1033,148752,183312
validation,258,16,12288,131,18864,31152
validation,259,24,18432,294,42336,60768
validation,260,36,27648,661,95184,122832
validation,261,18,13824,165,23760,37584
validation,262,27,20736,372,53568,74304
validation,263,18,13824,165,23760,37584
validation,264,17,13056,147,21168,34224
validation,265,8,6144,33,4752,10896
validation,266,33,25344,556,80064,105408
validation,267,23,17664,270,38880,56544
validation,268,23,17664,270,38880,56544
validation,269,25,19200,319,45936,65136
validation,270,23,17664,270,38880,56544
validation,271,12,9216,73,10512,19728
validation,272,18,13824,165,23760,37584
validation,273,19,14592,184,26496,41088
validation,274,6,4608,18,2592,7200
validation,275,8,6144,33,4752,10896
validation,276,27,20736,372,53568,74304
validation,277,29,22272,429,61776,84048
validation,278,39,29952,776,111744,141696
validation,279,22,16896,247,35568,52464
validation,280,18,13824,165,23760,37584
validation,281,39,29952,776,111744,141696
validation,282,26,19968,345,49680,69648
validation,283,9,6912,41,5904,12816
validation,284,17,13056,147,21168,34224
validation,285,39,29952,776,111744,141696
validation,286,12,9216,73,10512,19728
validation,287,20,15360,204,29376,44736
validation,288,27,20736,372,53568,74304
validation,289,27,20736,372,53568,74304
validation,290,24,18432,294,42336,60768
validation,291,19,14592,184,26496,41088
validation,292,8,6144,33,4752,10896
validation,293,13,9984,86,12384,22368
validation,294,27,20736,372,53568,74304
validation,295,33,25344,556,80064,105408
validation,296,28,21504,400,57600,79104
validation,297,10,7680,51,7344,15024
validation,298,16,12288,131,18864,31152
validation,299,23,17664,270,38880,56544
validation,300,12,9216,73,10512,19728
validation,301,23,17664,270,38880,56544
validation,302,11,8448,62,8928,17376
validation,303,30,23040,459,66096,89136
validation,304,26,19968,345,49680,69648
validation,305,7,5376,25,3600,8976
validation,306,18,13824,165,23760,37584
validation,307,22,16896,247,35568,52464
validation,308,34,26112,590,84960,111072
validation,309,14,10752,100,14400,25152
validation,310,14,10752,100,14400,25152
validation,311,22,16896,247,35568,52464
validation,312,24,18432,294,42336,60768
validation,313,17,13056,147,21168,34224
validation,314,22,16896,247,35568,52464
validation,315,19,14592,184,26496,41088
validation,316,15,11520,115,16560,28080
validation,317,25,19200,319,45936,65136
validation,318,26,19968,345,49680,69648
validation,319,24,18432,294,42336,60768
validation,320,35,26880,625,90000,116880
validation,321,14,10752,100,14400,25152
validation,322,9,6912,41,5904,12816
validation,323,18,13824,165,23760,37584
validation,324,16,12288,131,18864,31152
validation,325,29,22272,429,61776,84048
validation,326,35,26880,625,90000,116880
validation,327,14,10752,100,14400,25152
validation,328,13,9984,86,12384,22368
validation,329,15,11520,115,16560,28080
validation,330,18,13824,165,23760,37584
validation,331,29,22272,429,61776,84048
validation,332,23,17664,270,38880,56544
validation,333,18,13824,165,23760,37584
validation,334,28,21504,400,57600,79104
validation,335,25,19200,319,45936,65136
validation,336,30,23040,459,66096,89136
validation,337,16,12288,131,18864,31152
validation,338,38,29184,737,106128,135312
validation,339,40,30720,816,117504,148224
validation,340,5,3840,13,1872,5712
validation,341,23,17664,270,38880,56544
validation,342,26,19968,345,49680,69648
validation,343,27,20736,372,53568,74304
validation,344,9,6912,41,5904,12816
validation,345,20,15360,204,29376,44736
validation,346,10,7680,51,7344,15024
validation,347,14,10752,100,14400,25152
validation,348,8,6144,33,4752,10896
validation,349,20,15360,204,29376,44736
validation,350,23,17664,270,38880,56544
validation,351,19,14592,184,26496,41088
validation,352,26,19968,345,49680,69648
validation,353,13,9984,86,12384,22368
validation,354,12,9216,73,10512,19728
validation,355,2,1536,2,288,1824
validation,356,6,4608,18,2592,7200
validation,357,37,28416,698,100512,128928
validation,358,15,11520,115,16560,28080
validation,359,33,25344,556,80064,105408
validation,360,23,17664,270,38880,56544
validation,361,8,6144,33,4752,10896
validation,362,41,31488,858,123552,155040
validation,363,22,16896,247,35568,52464
validation,364,17,13056,147,21168,34224
validation,365,44,33792,988,142272,176064
validation,366,8,6144,33,4752,10896
validation,367,52,39936,1379,198576,238512
validation,368,8,6144,33,4752,10896
validation,369,28,21504,400,57600,79104
validation,370,16,12288,131,18864,31152
validation,371,26,19968,345,49680,69648
validation,372,28,21504,400,57600,79104
validation,373,34,26112,590,84960,111072
validation,374,23,17664,270,38880,56544
validation,375,39,29952,776,111744,141696
validation,376,25,19200,319,45936,65136
validation,377,29,22272,429,61776,84048
validation,378,5,3840,13,1872,5712
validation,379,21,16128,225,32400,48528
validation,380,34,26112,590,84960,111072
validation,381,24,18432,294,42336,60768
validation,382,41,31488,858,123552,155040
validation,383,19,14592,184,26496,41088
validation,384,18,13824,165,23760,37584
validation,385,48,36864,1175,169200,206064
validation,386,14,10752,100,14400,25152
validation,387,14,10752,100,14400,25152
validation,388,6,4608,18,2592,7200
validation,389,20,15360,204,29376,44736
validation,390,12,9216,73,10512,19728
validation,391,23,17664,270,38880,56544
validation,392,6,4608,18,2592,7200
validation,393,33,25344,556,80064,105408
validation,394,26,19968,345,49680,69648
validation,395,38,29184,737,106128,135312
validation,396,19,14592,184,26496,41088
validation,397,17,13056,147,21168,34224
validation,398,30,23040,459,66096,89136
validation,399,8,6144,33,4752,10896
validation,400,6,4608,18,2592,7200
validation,401,39,29952,776,111744,141696
validation,402,31,23808,490,70560,94368
validation,403,29,22272,429,61776,84048
validation,404,26,19968,345,49680,69648
validation,405,21,16128,225,32400,48528
validation,406,12,9216,73,10512,19728
validation,407,18,13824,165,23760,37584
validation,408,27,20736,372,53568,74304
validation,409,5,3840,13,1872,5712
validation,410,17,13056,147,21168,34224
validation,411,32,24576,522,75168,99744
validation,412,22,16896,247,35568,52464
validation,413,6,4608,18,2592,7200
validation,414,13,9984,86,12384,22368
validation,415,37,28416,698,100512,128928
validation,416,36,27648,661,95184,122832
validation,417,12,9216,73,10512,19728
validation,418,30,23040,459,66096,89136
validation,419,20,15360,204,29376,44736
validation,420,34,26112,590,84960,111072
validation,421,23,17664,270,38880,56544
validation,422,38,29184,737,106128,135312
validation,423,33,25344,556,80064,105408
validation,424,32,24576,522,75168,99744
validation,425,14,10752,100,14400,25152
validation,426,31,23808,490,70560,94368
validation,427,26,19968,345,49680,69648
validation,428,52,39936,1379,198576,238512
validation,429,18,13824,165,23760,37584
validation,430,38,29184,737,106128,135312
validation,431,23,17664,270,38880,56544
validation,432,9,6912,41,5904,12816
validation,433,20,15360,204,29376,44736
validation,434,16,12288,131,18864,31152
validation,435,25,19200,319,45936,65136
validation,436,14,10752,100,14400,25152
validation,437,24,18432,294,42336,60768
validation,438,15,11520,115,16560,28080
validation,439,16,12288,131,18864,31152
validation,440,10,7680,51,7344,15024
validation,441,21,16128,225,32400,48528
validation,442,8,6144,33,4752,10896
validation,443,22,16896,247,35568,52464
validation,444,39,29952,776,111744,141696
validation,445,39,29952,776,111744,141696
validation,446,17,13056,147,21168,34224
validation,447,13,9984,86,12384,22368
validation,448,14,10752,100,14400,25152
validation,449,8,6144,33,4752,10896
validation,450,39,29952,776,111744,141696
validation,451,32,24576,522,75168,99744
validation,452,34,26112,590,84960,111072
validation,453,37,28416,698,100512,128928
validation,454,20,15360,204,29376,44736
validation,455,14,10752,100,14400,25152
validation,456,25,19200,319,45936,65136
validation,457,10,7680,51,7344,15024
validation,458,29,22272,429,61776,84048
validation,459,34,26112,590,84960,111072
validation,460,15,11520,115,16560,28080
validation,461,16,12288,131,18864,31152
validation,462,37,28416,698,100512,128928
validation,463,20,15360,204,29376,44736
validation,464,18,13824,165,23760,37584
validation,465,21,16128,225,32400,48528
validation,466,22,16896,247,35568,52464
validation,467,13,9984,86,12384,22368
validation,468,9,6912,41,5904,12816
validation,469,32,24576,522,75168,99744
validation,470,36,27648,661,95184,122832
validation,471,28,21504,400,57600,79104
validation,472,9,6912,41,5904,12816
validation,473,23,17664,270,38880,56544
validation,474,31,23808,490,70560,94368
validation,475,22,16896,247,35568,52464
validation,476,30,23040,459,66096,89136
validation,477,35,26880,625,90000,116880
validation,478,26,19968,345,49680,69648
validation,479,21,16128,225,32400,48528
validation,480,27,20736,372,53568,74304
validation,481,35,26880,625,90000,116880
validation,482,8,6144,33,4752,10896
validation,483,23,17664,270,38880,56544
validation,484,42,32256,900,129600,161856
validation,485,22,16896,247,35568,52464
validation,486,7,5376,25,3600,8976
validation,487,32,24576,522,75168,99744
validation,488,11,8448,62,8928,17376
validation,489,23,17664,270,38880,56544
validation,490,17,13056,147,21168,34224
validation,491,8,6144,33,4752,10896
validation,492,26,19968,345,49680,69648
validation,493,19,14592,184,26496,41088
validation,494,22,16896,247,35568,52464
validation,495,17,13056,147,21168,34224
validation,496,35,26880,625,90000,116880
validation,497,17,13056,147,21168,34224
validation,498,39,29952,776,111744,141696
validation,499,35,26880,625,90000,116880
validation,500,24,18432,294,42336,60768
validation,501,26,19968,345,49680,69648
validation,502,10,7680,51,7344,15024
validation,503,21,16128,225,32400,48528
validation,504,24,18432,294,42336,60768
validation,505,23,17664,270,38880,56544
validation,506,10,7680,51,7344,15024
validation,507,28,21504,400,57600,79104
validation,508,20,15360,204,29376,44736
validation,509,40,30720,816,117504,148224
validation,510,23,17664,270,38880,56544
validation,511,25,19200,319,45936,65136
validation,512,21,16128,225,32400,48528
validation,513,14,10752,100,14400,25152
validation,514,28,21504,400,57600,79104
validation,515,9,6912,41,5904,12816
validation,516,15,11520,115,16560,28080
validation,517,15,11520,115,16560,28080
validation,518,19,14592,184,26496,41088
validation,519,50,38400,1275,183600,222000
validation,520,38,29184,737,106128,135312
validation,521,11,8448,62,8928,17376
validation,522,32,24576,522,75168,99744
validation,523,33,25344,556,80064,105408
validation,524,30,23040,459,66096,89136
validation,525,22,16896,247,35568,52464
validation,526,28,21504,400,57600,79104
validation,527,8,6144,33,4752,10896
validation,528,20,15360,204,29376,44736
validation,529,18,13824,165,23760,37584
validation,530,27,20736,372,53568,74304
validation,531,23,17664,270,38880,56544
validation,532,46,35328,1079,155376,190704
validation,533,39,29952,776,111744,141696
validation,534,24,18432,294,42336,60768
validation,535,32,24576,522,75168,99744
validation,536,27,20736,372,53568,74304
validation,537,31,23808,490,70560,94368
validation,538,17,13056,147,21168,34224
validation,539,19,14592,184,26496,41088
validation,540,25,19200,319,45936,65136
validation,541,18,13824,165,23760,37584
validation,542,16,12288,131,18864,31152
validation,543,13,9984,86,12384,22368
validation,544,18,13824,165,23760,37584
validation,545,19,14592,184,26496,41088
validation,546,23,17664,270,38880,56544
validation,547,15,11520,115,16560,28080
validation,548,10,7680,51,7344,15024
validation,549,38,29184,737,106128,135312
validation,550,19,14592,184,26496,41088
validation,551,36,27648,661,95184,122832
validation,552,20,15360,204,29376,44736
validation,553,33,25344,556,80064,105408
validation,554,26,19968,345,49680,69648
validation,555,37,28416,698,100512,128928
validation,556,40,30720,816,117504,148224
validation,557,36,27648,661,95184,122832
validation,558,23,17664,270,38880,56544
validation,559,16,12288,131,18864,31152
validation,560,30,23040,459,66096,89136
validation,561,21,16128,225,32400,48528
validation,562,31,23808,490,70560,94368
validation,563,20,15360,204,29376,44736
validation,564,2,1536,2,288,1824
validation,565,10,7680,51,7344,15024
validation,566,15,11520,115,16560,28080
validation,567,12,9216,73,10512,19728
validation,568,19,14592,184,26496,41088
validation,569,39,29952,776,111744,141696
validation,570,17,13056,147,21168,34224
validation,571,17,13056,147,21168,34224
validation,572,12,9216,73,10512,19728
validation,573,28,21504,400,57600,79104
validation,574,20,15360,204,29376,44736
validation,575,27,20736,372,53568,74304
validation,576,28,21504,400,57600,79104
validation,577,5,3840,13,1872,5712
validation,578,28,21504,400,57600,79104
validation,579,21,16128,225,32400,48528
validation,580,27,20736,372,53568,74304
validation,581,6,4608,18,2592,7200
validation,582,47,36096,1127,162288,198384
validation,583,23,17664,270,38880,56544
validation,584,29,22272,429,61776,84048
validation,585,12,9216,73,10512,19728
validation,586,24,18432,294,42336,60768
validation,587,42,32256,900,129600,161856
validation,588,13,9984,86,12384,22368
validation,589,6,4608,18,2592,7200
validation,590,24,18432,294,42336,60768
validation,591,18,13824,165,23760,37584
validation,592,22,16896,247,35568,52464
validation,593,14,10752,100,14400,25152
validation,594,20,15360,204,29376,44736
validation,595,11,8448,62,8928,17376
validation,596,9,6912,41,5904,12816
validation,597,18,13824,165,23760,37584
validation,598,19,14592,184,26496,41088
validation,599,5,3840,13,1872,5712
validation,600,29,22272,429,61776,84048
validation,601,35,26880,625,90000,116880
validation,602,10,7680,51,7344,15024
validation,603,25,19200,319,45936,65136
validation,604,26,19968,345,49680,69648
validation,605,19,14592,184,26496,41088
validation,606,14,10752,100,14400,25152
validation,607,27,20736,372,53568,74304
validation,608,30,23040,459,66096,89136
validation,609,38,29184,737,106128,135312
validation,610,25,19200,319,45936,65136
validation,611,29,22272,429,61776,84048
validation,612,38,29184,737,106128,135312
validation,613,15,11520,115,16560,28080
validation,614,11,8448,62,8928,17376
validation,615,38,29184,737,106128,135312
validation,616,25,19200,319,45936,65136
validation,617,32,24576,522,75168,99744
validation,618,15,11520,115,16560,28080
validation,619,11,8448,62,8928,17376
validation,620,24,18432,294,42336,60768
validation,621,11,8448,62,8928,17376
validation,622,25,19200,319,45936,65136
validation,623,26,19968,345,49680,69648
validation,624,24,18432,294,42336,60768
validation,625,13,9984,86,12384,22368
validation,626,46,35328,1079,155376,190704
validation,627,27,20736,372,53568,74304
validation,628,10,7680,51,7344,15024
validation,629,29,22272,429,61776,84048
validation,630,12,9216,73,10512,19728
validation,631,33,25344,556,80064,105408
validation,632,33,25344,556,80064,105408
validation,633,16,12288,131,18864,31152
validation,634,20,15360,204,29376,44736
validation,635,8,6144,33,4752,10896
validation,636,8,6144,33,4752,10896
validation,637,24,18432,294,42336,60768
validation,638,28,21504,400,57600,79104
validation,639,38,29184,737,106128,135312
validation,640,35,26880,625,90000,116880
validation,641,23,17664,270,38880,56544
validation,642,29,22272,429,61776,84048
validation,643,12,9216,73,10512,19728
validation,644,30,23040,459,66096,89136
validation,645,20,15360,204,29376,44736
validation,646,40,30720,816,117504,148224
validation,647,16,12288,131,18864,31152
validation,648,10,7680,51,7344,15024
validation,649,38,29184,737,106128,135312
validation,650,33,25344,556,80064,105408
validation,651,31,23808,490,70560,94368
validation,652,45,34560,1033,148752,183312
validation,653,7,5376,25,3600,8976
validation,654,32,24576,522,75168,99744
validation,655,31,23808,490,70560,94368
validation,656,22,16896,247,35568,52464
validation,657,53,40704,1433,206352,247056
validation,658,16,12288,131,18864,31152
validation,659,42,32256,900,129600,161856
validation,660,36,27648,661,95184,122832
validation,661,51,39168,1327,191088,230256
validation,662,30,23040,459,66096,89136
validation,663,29,22272,429,61776,84048
validation,664,33,25344,556,80064,105408
validation,665,30,23040,459,66096,89136
validation,666,19,14592,184,26496,41088
validation,667,13,9984,86,12384,22368
validation,668,26,19968,345,49680,69648
validation,669,34,26112,590,84960,111072
validation,670,17,13056,147,21168,34224
validation,671,22,16896,247,35568,52464
validation,672,7,5376,25,3600,8976
validation,673,7,5376,25,3600,8976
validation,674,22,16896,247,35568,52464
validation,675,38,29184,737,106128,135312
validation,676,24,18432,294,42336,60768
validation,677,43,33024,943,135792,168816
validation,678,26,19968,345,49680,69648
validation,679,14,10752,100,14400,25152
validation,680,11,8448,62,8928,17376
validation,681,30,23040,459,66096,89136
validation,682,38,29184,737,106128,135312
validation,683,32,24576,522,75168,99744
validation,684,33,25344,556,80064,105408
validation,685,34,26112,590,84960,111072
validation,686,23,17664,270,38880,56544
validation,687,13,9984,86,12384,22368
validation,688,11,8448,62,8928,17376
validation,689,10,7680,51,7344,15024
validation,690,20,15360,204,29376,44736
validation,691,16,12288,131,18864,31152
validation,692,15,11520,115,16560,28080
validation,693,24,18432,294,42336,60768
validation,694,8,6144,33,4752,10896
validation,695,29,22272,429,61776,84048
validation,696,30,23040,459,66096,89136
validation,697,27,20736,372,53568,74304
validation,698,27,20736,372,53568,74304
validation,699,15,11520,115,16560,28080
validation,700,4,3072,8,1152,4224
validation,701,40,30720,816,117504,148224
validation,702,17,13056,147,21168,34224
validation,703,23,17664,270,38880,56544
validation,704,18,13824,165,23760,37584
validation,705,10,7680,51,7344,15024
validation,706,18,13824,165,23760,37584
validation,707,26,19968,345,49680,69648
validation,708,25,19200,319,45936,65136
validation,709,15,11520,115,16560,28080
validation,710,9,6912,41,5904,12816
validation,711,17,13056,147,21168,34224
validation,712,25,19200,319,45936,65136
validation,713,30,23040,459,66096,89136
validation,714,12,9216,73,10512,19728
validation,715,24,18432,294,42336,60768
validation,716,18,13824,165,23760,37584
validation,717,30,23040,459,66096,89136
validation,718,21,16128,225,32400,48528
validation,719,39,29952,776,111744,141696
validation,720,19,14592,184,26496,41088
validation,721,21,16128,225,32400,48528
validation,722,23,17664,270,38880,56544
validation,723,11,8448,62,8928,17376
validation,724,20,15360,204,29376,44736
validation,725,11,8448,62,8928,17376
validation,726,42,32256,900,129600,161856
validation,727,29,22272,429,61776,84048
validation,728,9,6912,41,5904,12816
validation,729,25,19200,319,45936,65136
validation,730,21,16128,225,32400,48528
validation,731,22,16896,247,35568,52464
validation,732,24,18432,294,42336,60768
validation,733,37,28416,698,100512,128928
validation,734,4,3072,8,1152,4224
validation,735,29,22272,429,61776,84048
validation,736,6,4608,18,2592,7200
validation,737,17,13056,147,21168,34224
validation,738,21,16128,225,32400,48528
validation,739,16,12288,131,18864,31152
validation,740,18,13824,165,23760,37584
validation,741,42,32256,900,129600,161856
validation,742,25,19200,319,45936,65136
validation,743,7,5376,25,3600,8976
validation,744,42,32256,900,129600,161856
validation,745,47,36096,1127,162288,198384
validation,746,36,27648,661,95184,122832
validation,747,28,21504,400,57600,79104
validation,748,31,23808,490,70560,94368
validation,749,31,23808,490,70560,94368
validation,750,23,17664,270,38880,56544
validation,751,29,22272,429,61776,84048
validation,752,8,6144,33,4752,10896
validation,753,33,25344,556,80064,105408
validation,754,24,18432,294,42336,60768
validation,755,39,29952,776,111744,141696
validation,756,21,16128,225,32400,48528
validation,757,16,12288,131,18864,31152
validation,758,24,18432,294,42336,60768
validation,759,16,12288,131,18864,31152
validation,760,18,13824,165,23760,37584
validation,761,26,19968,345,49680,69648
validation,762,13,9984,86,12384,22368
validation,763,36,27648,661,95184,122832
validation,764,30,23040,459,66096,89136
validation,765,9,6912,41,5904,12816
validation,766,39,29952,776,111744,141696
validation,767,44,33792,988,142272,176064
validation,768,15,11520,115,16560,28080
validation,769,10,7680,51,7344,15024
validation,770,39,29952,776,111744,141696
validation,771,29,22272,429,61776,84048
validation,772,15,11520,115,16560,28080
validation,773,19,14592,184,26496,41088
validation,774,38,29184,737,106128,135312
validation,775,13,9984,86,12384,22368
validation,776,20,15360,204,29376,44736
validation,777,12,9216,73,10512,19728
validation,778,21,16128,225,32400,48528
validation,779,16,12288,131,18864,31152
validation,780,23,17664,270,38880,56544
validation,781,19,14592,184,26496,41088
validation,782,24,18432,294,42336,60768
validation,783,47,36096,1127,162288,198384
validation,784,22,16896,247,35568,52464
validation,785,30,23040,459,66096,89136
validation,786,21,16128,225,32400,48528
validation,787,6,4608,18,2592,7200
validation,788,29,22272,429,61776,84048
validation,789,8,6144,33,4752,10896
validation,790,14,10752,100,14400,25152
validation,791,30,23040,459,66096,89136
validation,792,48,36864,1175,169200,206064
validation,793,20,15360,204,29376,44736
validation,794,9,6912,41,5904,12816
validation,795,26,19968,345,49680,69648
validation,796,22,16896,247,35568,52464
validation,797,21,16128,225,32400,48528
validation,798,13,9984,86,12384,22368
validation,799,16,12288,131,18864,31152
validation,800,36,27648,661,95184,122832
validation,801,11,8448,62,8928,17376
validation,802,37,28416,698,100512,128928
validation,803,18,13824,165,23760,37584
validation,804,9,6912,41,5904,12816
validation,805,11,8448,62,8928,17376
validation,806,42,32256,900,129600,161856
validation,807,10,7680,51,7344,15024
validation,808,16,12288,131,18864,31152
validation,809,24,18432,294,42336,60768
validation,810,28,21504,400,57600,79104
validation,811,28,21504,400,57600,79104
validation,812,25,19200,319,45936,65136
validation,813,30,23040,459,66096,89136
validation,814,16,12288,131,18864,31152
validation,815,22,16896,247,35568,52464
validation,816,16,12288,131,18864,31152
validation,817,13,9984,86,12384,22368
validation,818,27,20736,372,53568,74304
validation,819,17,13056,147,21168,34224
validation,820,29,22272,429,61776,84048
validation,821,10,7680,51,7344,15024
validation,822,24,18432,294,42336,60768
validation,823,15,11520,115,16560,28080
validation,824,17,13056,147,21168,34224
validation,825,10,7680,51,7344,15024
validation,826,42,32256,900,129600,161856
validation,827,18,13824,165,23760,37584
validation,828,18,13824,165,23760,37584
validation,829,33,25344,556,80064,105408
validation,830,41,31488,858,123552,155040
validation,831,31,23808,490,70560,94368
validation,832,24,18432,294,42336,60768
validation,833,37,28416,698,100512,128928
validation,834,16,12288,131,18864,31152
validation,835,17,13056,147,21168,34224
validation,836,34,26112,590,84960,111072
validation,837,37,28416,698,100512,128928
validation,838,10,7680,51,7344,15024
validation,839,6,4608,18,2592,7200
validation,840,11,8448,62,8928,17376
validation,841,7,5376,25,3600,8976
validation,842,25,19200,319,45936,65136
validation,843,14,10752,100,14400,25152
validation,844,28,21504,400,57600,79104
validation,845,13,9984,86,12384,22368
validation,846,32,24576,522,75168,99744
validation,847,37,28416,698,100512,128928
validation,848,21,16128,225,32400,48528
validation,849,25,19200,319,45936,65136
validation,850,33,25344,556,80064,105408
validation,851,9,6912,41,5904,12816
validation,852,11,8448,62,8928,17376
validation,853,17,13056,147,21168,34224
validation,854,8,6144,33,4752,10896
validation,855,12,9216,73,10512,19728
validation,856,24,18432,294,42336,60768
validation,857,16,12288,131,18864,31152
validation,858,17,13056,147,21168,34224
validation,859,22,16896,247,35568,52464
validation,860,24,18432,294,42336,60768
validation,861,8,6144,33,4752,10896
validation,862,29,22272,429,61776,84048
validation,863,10,7680,51,7344,15024
validation,864,40,30720,816,117504,148224
validation,865,42,32256,900,129600,161856
validation,866,14,10752,100,14400,25152
validation,867,18,13824,165,23760,37584
validation,868,28,21504,400,57600,79104
validation,869,39,29952,776,111744,141696
validation,870,46,35328,1079,155376,190704
validation,871,28,21504,400,57600,79104
test,0,19,14592,184,26496,41088
test,1,13,9984,86,12384,22368
test,2,41,31488,858,123552,155040
test,3,26,19968,345,49680,69648
test,4,22,16896,247,35568,52464
test,5,32,24576,522,75168,99744
test,6,29,22272,429,61776,84048
test,7,8,6144,33,4752,10896
test,8,10,7680,51,7344,15024
test,9,26,19968,345,49680,69648
test,10,20,15360,204,29376,44736
test,11,21,16128,225,32400,48528
test,12,5,3840,13,1872,5712
test,13,23,17664,270,38880,56544
test,14,37,28416,698,100512,128928
test,15,38,29184,737,106128,135312
test,16,11,8448,62,8928,17376
test,17,5,3840,13,1872,5712
test,18,42,32256,900,129600,161856
test,19,27,20736,372,53568,74304
test,20,27,20736,372,53568,74304
test,21,16,12288,131,18864,31152
test,22,16,12288,131,18864,31152
test,23,14,10752,100,14400,25152
test,24,29,22272,429,61776,84048
test,25,22,16896,247,35568,52464
test,26,26,19968,345,49680,69648
test,27,10,7680,51,7344,15024
test,28,7,5376,25,3600,8976
test,29,14,10752,100,14400,25152
test,30,15,11520,115,16560,28080
test,31,15,11520,115,16560,28080
test,32,10,7680,51,7344,15024
test,33,25,19200,319,45936,65136
test,34,19,14592,184,26496,41088
test,35,24,18432,294,42336,60768
test,36,10,7680,51,7344,15024
test,37,15,11520,115,16560,28080
test,38,39,29952,776,111744,141696
test,39,15,11520,115,16560,28080
test,40,31,23808,490,70560,94368
test,41,8,6144,33,4752,10896
test,42,40,30720,816,117504,148224
test,43,28,21504,400,57600,79104
test,44,28,21504,400,57600,79104
test,45,30,23040,459,66096,89136
test,46,33,25344,556,80064,105408
test,47,16,12288,131,18864,31152
test,48,22,16896,247,35568,52464
test,49,33,25344,556,80064,105408
test,50,14,10752,100,14400,25152
test,51,20,15360,204,29376,44736
test,52,40,30720,816,117504,148224
test,53,22,16896,247,35568,52464
test,54,31,23808,490,70560,94368
test,55,25,19200,319,45936,65136
test,56,28,21504,400,57600,79104
test,57,10,7680,51,7344,15024
test,58,30,23040,459,66096,89136
test,59,8,6144,33,4752,10896
test,60,18,13824,165,23760,37584
test,61,23,17664,270,38880,56544
test,62,26,19968,345,49680,69648
test,63,16,12288,131,18864,31152
test,64,31,23808,490,70560,94368
test,65,38,29184,737,106128,135312
test,66,20,15360,204,29376,44736
test,67,25,19200,319,45936,65136
test,68,22,16896,247,35568,52464
test,69,11,8448,62,8928,17376
test,70,41,31488,858,123552,155040
test,71,27,20736,372,53568,74304
test,72,10,7680,51,7344,15024
test,73,12,9216,73,10512,19728
test,74,16,12288,131,18864,31152
test,75,25,19200,319,45936,65136
test,76,26,19968,345,49680,69648
test,77,17,13056,147,21168,34224
test,78,8,6144,33,4752,10896
test,79,7,5376,25,3600,8976
test,80,26,19968,345,49680,69648
test,81,30,23040,459,66096,89136
test,82,25,19200,319,45936,65136
test,83,37,28416,698,100512,128928
test,84,7,5376,25,3600,8976
test,85,34,26112,590,84960,111072
test,86,31,23808,490,70560,94368
test,87,22,16896,247,35568,52464
test,88,12,9216,73,10512,19728
test,89,24,18432,294,42336,60768
test,90,34,26112,590,84960,111072
test,91,29,22272,429,61776,84048
test,92,35,26880,625,90000,116880
test,93,14,10752,100,14400,25152
test,94,15,11520,115,16560,28080
test,95,19,14592,184,26496,41088
test,96,33,25344,556,80064,105408
test,97,32,24576,522,75168,99744
test,98,33,25344,556,80064,105408
test,99,16,12288,131,18864,31152
test,100,28,21504,400,57600,79104
test,101,26,19968,345,49680,69648
test,102,33,25344,556,80064,105408
test,103,23,17664,270,38880,56544
test,104,24,18432,294,42336,60768
test,105,33,25344,556,80064,105408
test,106,36,27648,661,95184,122832
test,107,10,7680,51,7344,15024
test,108,22,16896,247,35568,52464
test,109,20,15360,204,29376,44736
test,110,36,27648,661,95184,122832
test,111,41,31488,858,123552,155040
test,112,23,17664,270,38880,56544
test,113,48,36864,1175,169200,206064
test,114,18,13824,165,23760,37584
test,115,14,10752,100,14400,25152
test,116,7,5376,25,3600,8976
test,117,12,9216,73,10512,19728
test,118,30,23040,459,66096,89136
test,119,14,10752,100,14400,25152
test,120,26,19968,345,49680,69648
test,121,20,15360,204,29376,44736
test,122,12,9216,73,10512,19728
test,123,32,24576,522,75168,99744
test,124,16,12288,131,18864,31152
test,125,49,37632,1225,176400,214032
test,126,31,23808,490,70560,94368
test,127,21,16128,225,32400,48528
test,128,16,12288,131,18864,31152
test,129,16,12288,131,18864,31152
test,130,9,6912,41,5904,12816
test,131,12,9216,73,10512,19728
test,132,11,8448,62,8928,17376
test,133,18,13824,165,23760,37584
test,134,37,28416,698,100512,128928
test,135,25,19200,319,45936,65136
test,136,10,7680,51,7344,15024
test,137,29,22272,429,61776,84048
test,138,35,26880,625,90000,116880
test,139,22,16896,247,35568,52464
test,140,12,9216,73,10512,19728
test,141,38,29184,737,106128,135312
test,142,15,11520,115,16560,28080
test,143,23,17664,270,38880,56544
test,144,18,13824,165,23760,37584
test,145,8,6144,33,4752,10896
test,146,21,16128,225,32400,48528
test,147,26,19968,345,49680,69648
test,148,48,36864,1175,169200,206064
test,149,23,17664,270,38880,56544
test,150,22,16896,247,35568,52464
test,151,39,29952,776,111744,141696
test,152,20,15360,204,29376,44736
test,153,24,18432,294,42336,60768
test,154,12,9216,73,10512,19728
test,155,21,16128,225,32400,48528
test,156,25,19200,319,45936,65136
test,157,13,9984,86,12384,22368
test,158,32,24576,522,75168,99744
test,159,32,24576,522,75168,99744
test,160,14,10752,100,14400,25152
test,161,37,28416,698,100512,128928
test,162,29,22272,429,61776,84048
test,163,12,9216,73,10512,19728
test,164,27,20736,372,53568,74304
test,165,56,43008,1600,230400,273408
test,166,16,12288,131,18864,31152
test,167,5,3840,13,1872,5712
test,168,16,12288,131,18864,31152
test,169,9,6912,41,5904,12816
test,170,14,10752,100,14400,25152
test,171,12,9216,73,10512,19728
test,172,46,35328,1079,155376,190704
test,173,25,19200,319,45936,65136
test,174,20,15360,204,29376,44736
test,175,31,23808,490,70560,94368
test,176,13,9984,86,12384,22368
test,177,45,34560,1033,148752,183312
test,178,26,19968,345,49680,69648
test,179,29,22272,429,61776,84048
test,180,24,18432,294,42336,60768
test,181,43,33024,943,135792,168816
test,182,24,18432,294,42336,60768
test,183,29,22272,429,61776,84048
test,184,26,19968,345,49680,69648
test,185,37,28416,698,100512,128928
test,186,24,18432,294,42336,60768
test,187,27,20736,372,53568,74304
test,188,12,9216,73,10512,19728
test,189,17,13056,147,21168,34224
test,190,30,23040,459,66096,89136
test,191,51,39168,1327,191088,230256
test,192,31,23808,490,70560,94368
test,193,11,8448,62,8928,17376
test,194,44,33792,988,142272,176064
test,195,13,9984,86,12384,22368
test,196,12,9216,73,10512,19728
test,197,27,20736,372,53568,74304
test,198,11,8448,62,8928,17376
test,199,39,29952,776,111744,141696
test,200,25,19200,319,45936,65136
test,201,12,9216,73,10512,19728
test,202,10,7680,51,7344,15024
test,203,12,9216,73,10512,19728
test,204,32,24576,522,75168,99744
test,205,29,22272,429,61776,84048
test,206,14,10752,100,14400,25152
test,207,35,26880,625,90000,116880
test,208,19,14592,184,26496,41088
test,209,10,7680,51,7344,15024
test,210,5,3840,13,1872,5712
test,211,28,21504,400,57600,79104
test,212,40,30720,816,117504,148224
test,213,18,13824,165,23760,37584
test,214,34,26112,590,84960,111072
test,215,9,6912,41,5904,12816
test,216,39,29952,776,111744,141696
test,217,7,5376,25,3600,8976
test,218,33,25344,556,80064,105408
test,219,7,5376,25,3600,8976
test,220,19,14592,184,26496,41088
test,221,20,15360,204,29376,44736
test,222,10,7680,51,7344,15024
test,223,39,29952,776,111744,141696
test,224,6,4608,18,2592,7200
test,225,39,29952,776,111744,141696
test,226,11,8448,62,8928,17376
test,227,26,19968,345,49680,69648
test,228,21,16128,225,32400,48528
test,229,16,12288,131,18864,31152
test,230,29,22272,429,61776,84048
test,231,13,9984,86,12384,22368
test,232,14,10752,100,14400,25152
test,233,29,22272,429,61776,84048
test,234,11,8448,62,8928,17376
test,235,15,11520,115,16560,28080
test,236,30,23040,459,66096,89136
test,237,12,9216,73,10512,19728
test,238,7,5376,25,3600,8976
test,239,22,16896,247,35568,52464
test,240,23,17664,270,38880,56544
test,241,39,29952,776,111744,141696
test,242,15,11520,115,16560,28080
test,243,38,29184,737,106128,135312
test,244,9,6912,41,5904,12816
test,245,22,16896,247,35568,52464
test,246,27,20736,372,53568,74304
test,247,32,24576,522,75168,99744
test,248,19,14592,184,26496,41088
test,249,4,3072,8,1152,4224
test,250,19,14592,184,26496,41088
test,251,16,12288,131,18864,31152
test,252,33,25344,556,80064,105408
test,253,33,25344,556,80064,105408
test,254,22,16896,247,35568,52464
test,255,7,5376,25,3600,8976
test,256,7,5376,25,3600,8976
test,257,24,18432,294,42336,60768
test,258,31,23808,490,70560,94368
test,259,32,24576,522,75168,99744
test,260,23,17664,270,38880,56544
test,261,26,19968,345,49680,69648
test,262,29,22272,429,61776,84048
test,263,9,6912,41,5904,12816
test,264,24,18432,294,42336,60768
test,265,43,33024,943,135792,168816
test,266,26,19968,345,49680,69648
test,267,24,18432,294,42336,60768
test,268,15,11520,115,16560,28080
test,269,19,14592,184,26496,41088
test,270,22,16896,247,35568,52464
test,271,24,18432,294,42336,60768
test,272,42,32256,900,129600,161856
test,273,26,19968,345,49680,69648
test,274,20,15360,204,29376,44736
test,275,17,13056,147,21168,34224
test,276,28,21504,400,57600,79104
test,277,9,6912,41,5904,12816
test,278,15,11520,115,16560,28080
test,279,41,31488,858,123552,155040
test,280,18,13824,165,23760,37584
test,281,34,26112,590,84960,111072
test,282,20,15360,204,29376,44736
test,283,35,26880,625,90000,116880
test,284,9,6912,41,5904,12816
test,285,38,29184,737,106128,135312
test,286,36,27648,661,95184,122832
test,287,16,12288,131,18864,31152
test,288,10,7680,51,7344,15024
test,289,20,15360,204,29376,44736
test,290,13,9984,86,12384,22368
test,291,13,9984,86,12384,22368
test,292,19,14592,184,26496,41088
test,293,7,5376,25,3600,8976
test,294,39,29952,776,111744,141696
test,295,26,19968,345,49680,69648
test,296,36,27648,661,95184,122832
test,297,36,27648,661,95184,122832
test,298,39,29952,776,111744,141696
test,299,23,17664,270,38880,56544
test,300,26,19968,345,49680,69648
test,301,55,42240,1543,222192,264432
test,302,30,23040,459,66096,89136
test,303,9,6912,41,5904,12816
test,304,26,19968,345,49680,69648
test,305,28,21504,400,57600,79104
test,306,30,23040,459,66096,89136
test,307,27,20736,372,53568,74304
test,308,22,16896,247,35568,52464
test,309,17,13056,147,21168,34224
test,310,10,7680,51,7344,15024
test,311,17,13056,147,21168,34224
test,312,29,22272,429,61776,84048
test,313,18,13824,165,23760,37584
test,314,19,14592,184,26496,41088
test,315,23,17664,270,38880,56544
test,316,23,17664,270,38880,56544
test,317,33,25344,556,80064,105408
test,318,29,22272,429,61776,84048
test,319,18,13824,165,23760,37584
test,320,20,15360,204,29376,44736
test,321,15,11520,115,16560,28080
test,322,30,23040,459,66096,89136
test,323,16,12288,131,18864,31152
test,324,28,21504,400,57600,79104
test,325,26,19968,345,49680,69648
test,326,26,19968,345,49680,69648
test,327,7,5376,25,3600,8976
test,328,26,19968,345,49680,69648
test,329,22,16896,247,35568,52464
test,330,29,22272,429,61776,84048
test,331,18,13824,165,23760,37584
test,332,10,7680,51,7344,15024
test,333,10,7680,51,7344,15024
test,334,18,13824,165,23760,37584
test,335,22,16896,247,35568,52464
test,336,15,11520,115,16560,28080
test,337,17,13056,147,21168,34224
test,338,41,31488,858,123552,155040
test,339,46,35328,1079,155376,190704
test,340,19,14592,184,26496,41088
test,341,12,9216,73,10512,19728
test,342,32,24576,522,75168,99744
test,343,54,41472,1488,214272,255744
test,344,30,23040,459,66096,89136
test,345,17,13056,147,21168,34224
test,346,35,26880,625,90000,116880
test,347,14,10752,100,14400,25152
test,348,24,18432,294,42336,60768
test,349,37,28416,698,100512,128928
test,350,27,20736,372,53568,74304
test,351,34,26112,590,84960,111072
test,352,36,27648,661,95184,122832
test,353,31,23808,490,70560,94368
test,354,16,12288,131,18864,31152
test,355,16,12288,131,18864,31152
test,356,27,20736,372,53568,74304
test,357,40,30720,816,117504,148224
test,358,24,18432,294,42336,60768
test,359,18,13824,165,23760,37584
test,360,41,31488,858,123552,155040
test,361,18,13824,165,23760,37584
test,362,30,23040,459,66096,89136
test,363,24,18432,294,42336,60768
test,364,10,7680,51,7344,15024
test,365,15,11520,115,16560,28080
test,366,36,27648,661,95184,122832
test,367,8,6144,33,4752,10896
test,368,17,13056,147,21168,34224
test,369,23,17664,270,38880,56544
test,370,39,29952,776,111744,141696
test,371,17,13056,147,21168,34224
test,372,20,15360,204,29376,44736
test,373,22,16896,247,35568,52464
test,374,29,22272,429,61776,84048
test,375,30,23040,459,66096,89136
test,376,24,18432,294,42336,60768
test,377,29,22272,429,61776,84048
test,378,26,19968,345,49680,69648
test,379,12,9216,73,10512,19728
test,380,19,14592,184,26496,41088
test,381,22,16896,247,35568,52464
test,382,18,13824,165,23760,37584
test,383,12,9216,73,10512,19728
test,384,12,9216,73,10512,19728
test,385,19,14592,184,26496,41088
test,386,19,14592,184,26496,41088
test,387,33,25344,556,80064,105408
test,388,17,13056,147,21168,34224
test,389,16,12288,131,18864,31152
test,390,34,26112,590,84960,111072
test,391,30,23040,459,66096,89136
test,392,11,8448,62,8928,17376
test,393,31,23808,490,70560,94368
test,394,21,16128,225,32400,48528
test,395,23,17664,270,38880,56544
test,396,13,9984,86,12384,22368
test,397,21,16128,225,32400,48528
test,398,39,29952,776,111744,141696
test,399,12,9216,73,10512,19728
test,400,31,23808,490,70560,94368
test,401,20,15360,204,29376,44736
test,402,20,15360,204,29376,44736
test,403,4,3072,8,1152,4224
test,404,20,15360,204,29376,44736
test,405,35,26880,625,90000,116880
test,406,25,19200,319,45936,65136
test,407,4,3072,8,1152,4224
test,408,26,19968,345,49680,69648
test,409,12,9216,73,10512,19728
test,410,22,16896,247,35568,52464
test,411,13,9984,86,12384,22368
test,412,21,16128,225,32400,48528
test,413,25,19200,319,45936,65136
test,414,10,7680,51,7344,15024
test,415,12,9216,73,10512,19728
test,416,39,29952,776,111744,141696
test,417,28,21504,400,57600,79104
test,418,19,14592,184,26496,41088
test,419,10,7680,51,7344,15024
test,420,29,22272,429,61776,84048
test,421,15,11520,115,16560,28080
test,422,33,25344,556,80064,105408
test,423,19,14592,184,26496,41088
test,424,37,28416,698,100512,128928
test,425,22,16896,247,35568,52464
test,426,19,14592,184,26496,41088
test,427,8,6144,33,4752,10896
test,428,24,18432,294,42336,60768
test,429,37,28416,698,100512,128928
test,430,18,13824,165,23760,37584
test,431,10,7680,51,7344,15024
test,432,25,19200,319,45936,65136
test,433,9,6912,41,5904,12816
test,434,35,26880,625,90000,116880
test,435,7,5376,25,3600,8976
test,436,16,12288,131,18864,31152
test,437,10,7680,51,7344,15024
test,438,33,25344,556,80064,105408
test,439,33,25344,556,80064,105408
test,440,8,6144,33,4752,10896
test,441,20,15360,204,29376,44736
test,442,32,24576,522,75168,99744
test,443,15,11520,115,16560,28080
test,444,20,15360,204,29376,44736
test,445,13,9984,86,12384,22368
test,446,18,13824,165,23760,37584
test,447,34,26112,590,84960,111072
test,448,8,6144,33,4752,10896
test,449,31,23808,490,70560,94368
test,450,17,13056,147,21168,34224
test,451,9,6912,41,5904,12816
test,452,53,40704,1433,206352,247056
test,453,43,33024,943,135792,168816
test,454,24,18432,294,42336,60768
test,455,19,14592,184,26496,41088
test,456,23,17664,270,38880,56544
test,457,15,11520,115,16560,28080
test,458,17,13056,147,21168,34224
test,459,34,26112,590,84960,111072
test,460,12,9216,73,10512,19728
test,461,18,13824,165,23760,37584
test,462,25,19200,319,45936,65136
test,463,23,17664,270,38880,56544
test,464,11,8448,62,8928,17376
test,465,14,10752,100,14400,25152
test,466,23,17664,270,38880,56544
test,467,8,6144,33,4752,10896
test,468,22,16896,247,35568,52464
test,469,19,14592,184,26496,41088
test,470,21,16128,225,32400,48528
test,471,42,32256,900,129600,161856
test,472,36,27648,661,95184,122832
test,473,29,22272,429,61776,84048
test,474,19,14592,184,26496,41088
test,475,39,29952,776,111744,141696
test,476,8,6144,33,4752,10896
test,477,33,25344,556,80064,105408
test,478,29,22272,429,61776,84048
test,479,22,16896,247,35568,52464
test,480,16,12288,131,18864,31152
test,481,40,30720,816,117504,148224
test,482,24,18432,294,42336,60768
test,483,44,33792,988,142272,176064
test,484,23,17664,270,38880,56544
test,485,24,18432,294,42336,60768
test,486,22,16896,247,35568,52464
test,487,9,6912,41,5904,12816
test,488,17,13056,147,21168,34224
test,489,27,20736,372,53568,74304
test,490,19,14592,184,26496,41088
test,491,13,9984,86,12384,22368
test,492,13,9984,86,12384,22368
test,493,41,31488,858,123552,155040
test,494,9,6912,41,5904,12816
test,495,42,32256,900,129600,161856
test,496,12,9216,73,10512,19728
test,497,16,12288,131,18864,31152
test,498,23,17664,270,38880,56544
test,499,29,22272,429,61776,84048
test,500,18,13824,165,23760,37584
test,501,37,28416,698,100512,128928
test,502,28,21504,400,57600,79104
test,503,13,9984,86,12384,22368
test,504,12,9216,73,10512,19728
test,505,17,13056,147,21168,34224
test,506,41,31488,858,123552,155040
test,507,7,5376,25,3600,8976
test,508,22,16896,247,35568,52464
test,509,30,23040,459,66096,89136
test,510,34,26112,590,84960,111072
test,511,12,9216,73,10512,19728
test,512,15,11520,115,16560,28080
test,513,26,19968,345,49680,69648
test,514,33,25344,556,80064,105408
test,515,11,8448,62,8928,17376
test,516,36,27648,661,95184,122832
test,517,18,13824,165,23760,37584
test,518,35,26880,625,90000,116880
test,519,13,9984,86,12384,22368
test,520,11,8448,62,8928,17376
test,521,34,26112,590,84960,111072
test,522,16,12288,131,18864,31152
test,523,18,13824,165,23760,37584
test,524,25,19200,319,45936,65136
test,525,10,7680,51,7344,15024
test,526,28,21504,400,57600,79104
test,527,14,10752,100,14400,25152
test,528,17,13056,147,21168,34224
test,529,18,13824,165,23760,37584
test,530,31,23808,490,70560,94368
test,531,28,21504,400,57600,79104
test,532,40,30720,816,117504,148224
test,533,11,8448,62,8928,17376
test,534,55,42240,1543,222192,264432
test,535,22,16896,247,35568,52464
test,536,29,22272,429,61776,84048
test,537,8,6144,33,4752,10896
test,538,23,17664,270,38880,56544
test,539,15,11520,115,16560,28080
test,540,41,31488,858,123552,155040
test,541,25,19200,319,45936,65136
test,542,18,13824,165,23760,37584
test,543,19,14592,184,26496,41088
test,544,24,18432,294,42336,60768
test,545,33,25344,556,80064,105408
test,546,41,31488,858,123552,155040
test,547,23,17664,270,38880,56544
test,548,12,9216,73,10512,19728
test,549,42,32256,900,129600,161856
test,550,37,28416,698,100512,128928
test,551,8,6144,33,4752,10896
test,552,12,9216,73,10512,19728
test,553,27,20736,372,53568,74304
test,554,23,17664,270,38880,56544
test,555,30,23040,459,66096,89136
test,556,28,21504,400,57600,79104
test,557,43,33024,943,135792,168816
test,558,32,24576,522,75168,99744
test,559,18,13824,165,23760,37584
test,560,16,12288,131,18864,31152
test,561,14,10752,100,14400,25152
test,562,36,27648,661,95184,122832
test,563,10,7680,51,7344,15024
test,564,5,3840,13,1872,5712
test,565,15,11520,115,16560,28080
test,566,7,5376,25,3600,8976
test,567,7,5376,25,3600,8976
test,568,32,24576,522,75168,99744
test,569,21,16128,225,32400,48528
test,570,10,7680,51,7344,15024
test,571,12,9216,73,10512,19728
test,572,7,5376,25,3600,8976
test,573,14,10752,100,14400,25152
test,574,23,17664,270,38880,56544
test,575,23,17664,270,38880,56544
test,576,28,21504,400,57600,79104
test,577,8,6144,33,4752,10896
test,578,7,5376,25,3600,8976
test,579,23,17664,270,38880,56544
test,580,8,6144,33,4752,10896
test,581,27,20736,372,53568,74304
test,582,18,13824,165,23760,37584
test,583,31,23808,490,70560,94368
test,584,7,5376,25,3600,8976
test,585,19,14592,184,26496,41088
test,586,6,4608,18,2592,7200
test,587,43,33024,943,135792,168816
test,588,24,18432,294,42336,60768
test,589,25,19200,319,45936,65136
test,590,20,15360,204,29376,44736
test,591,51,39168,1327,191088,230256
test,592,50,38400,1275,183600,222000
test,593,29,22272,429,61776,84048
test,594,19,14592,184,26496,41088
test,595,27,20736,372,53568,74304
test,596,21,16128,225,32400,48528
test,597,11,8448,62,8928,17376
test,598,12,9216,73,10512,19728
test,599,7,5376,25,3600,8976
test,600,34,26112,590,84960,111072
test,601,28,21504,400,57600,79104
test,602,9,6912,41,5904,12816
test,603,37,28416,698,100512,128928
test,604,10,7680,51,7344,15024
test,605,10,7680,51,7344,15024
test,606,19,14592,184,26496,41088
test,607,22,16896,247,35568,52464
test,608,26,19968,345,49680,69648
test,609,28,21504,400,57600,79104
test,610,14,10752,100,14400,25152
test,611,12,9216,73,10512,19728
test,612,10,7680,51,7344,15024
test,613,22,16896,247,35568,52464
test,614,52,39936,1379,198576,238512
test,615,8,6144,33,4752,10896
test,616,31,23808,490,70560,94368
test,617,12,9216,73,10512,19728
test,618,9,6912,41,5904,12816
test,619,8,6144,33,4752,10896
test,620,14,10752,100,14400,25152
test,621,8,6144,33,4752,10896
test,622,23,17664,270,38880,56544
test,623,25,19200,319,45936,65136
test,624,25,19200,319,45936,65136
test,625,34,26112,590,84960,111072
test,626,12,9216,73,10512,19728
test,627,18,13824,165,23760,37584
test,628,23,17664,270,38880,56544
test,629,17,13056,147,21168,34224
test,630,30,23040,459,66096,89136
test,631,28,21504,400,57600,79104
test,632,17,13056,147,21168,34224
test,633,31,23808,490,70560,94368
test,634,25,19200,319,45936,65136
test,635,29,22272,429,61776,84048
test,636,32,24576,522,75168,99744
test,637,7,5376,25,3600,8976
test,638,10,7680,51,7344,15024
test,639,27,20736,372,53568,74304
test,640,12,9216,73,10512,19728
test,641,38,29184,737,106128,135312
test,642,15,11520,115,16560,28080
test,643,13,9984,86,12384,22368
test,644,18,13824,165,23760,37584
test,645,14,10752,100,14400,25152
test,646,19,14592,184,26496,41088
test,647,12,9216,73,10512,19728
test,648,40,30720,816,117504,148224
test,649,12,9216,73,10512,19728
test,650,24,18432,294,42336,60768
test,651,19,14592,184,26496,41088
test,652,32,24576,522,75168,99744
test,653,18,13824,165,23760,37584
test,654,19,14592,184,26496,41088
test,655,40,30720,816,117504,148224
test,656,41,31488,858,123552,155040
test,657,11,8448,62,8928,17376
test,658,19,14592,184,26496,41088
test,659,15,11520,115,16560,28080
test,660,14,10752,100,14400,25152
test,661,27,20736,372,53568,74304
test,662,27,20736,372,53568,74304
test,663,50,38400,1275,183600,222000
test,664,18,13824,165,23760,37584
test,665,34,26112,590,84960,111072
test,666,26,19968,345,49680,69648
test,667,27,20736,372,53568,74304
test,668,32,24576,522,75168,99744
test,669,17,13056,147,21168,34224
test,670,11,8448,62,8928,17376
test,671,24,18432,294,42336,60768
test,672,23,17664,270,38880,56544
test,673,8,6144,33,4752,10896
test,674,21,16128,225,32400,48528
test,675,22,16896,247,35568,52464
test,676,28,21504,400,57600,79104
test,677,15,11520,115,16560,28080
test,678,22,16896,247,35568,52464
test,679,32,24576,522,75168,99744
test,680,25,19200,319,45936,65136
test,681,26,19968,345,49680,69648
test,682,30,23040,459,66096,89136
test,683,5,3840,13,1872,5712
test,684,14,10752,100,14400,25152
test,685,13,9984,86,12384,22368
test,686,29,22272,429,61776,84048
test,687,60,46080,1837,264528,310608
test,688,25,19200,319,45936,65136
test,689,13,9984,86,12384,22368
test,690,36,27648,661,95184,122832
test,691,27,20736,372,53568,74304
test,692,22,16896,247,35568,52464
test,693,37,28416,698,100512,128928
test,694,23,17664,270,38880,56544
test,695,30,23040,459,66096,89136
test,696,14,10752,100,14400,25152
test,697,14,10752,100,14400,25152
test,698,23,17664,270,38880,56544
test,699,31,23808,490,70560,94368
test,700,16,12288,131,18864,31152
test,701,22,16896,247,35568,52464
test,702,11,8448,62,8928,17376
test,703,23,17664,270,38880,56544
test,704,14,10752,100,14400,25152
test,705,28,21504,400,57600,79104
test,706,57,43776,1658,238752,282528
test,707,8,6144,33,4752,10896
test,708,11,8448,62,8928,17376
test,709,22,16896,247,35568,52464
test,710,48,36864,1175,169200,206064
test,711,34,26112,590,84960,111072
test,712,11,8448,62,8928,17376
test,713,9,6912,41,5904,12816
test,714,32,24576,522,75168,99744
test,715,26,19968,345,49680,69648
test,716,19,14592,184,26496,41088
test,717,5,3840,13,1872,5712
test,718,20,15360,204,29376,44736
test,719,19,14592,184,26496,41088
test,720,22,16896,247,35568,52464
test,721,23,17664,270,38880,56544
test,722,12,9216,73,10512,19728
test,723,9,6912,41,5904,12816
test,724,22,16896,247,35568,52464
test,725,33,25344,556,80064,105408
test,726,37,28416,698,100512,128928
test,727,25,19200,319,45936,65136
test,728,15,11520,115,16560,28080
test,729,20,15360,204,29376,44736
test,730,18,13824,165,23760,37584
test,731,10,7680,51,7344,15024
test,732,22,16896,247,35568,52464
test,733,17,13056,147,21168,34224
test,734,22,16896,247,35568,52464
test,735,9,6912,41,5904,12816
test,736,16,12288,131,18864,31152
test,737,8,6144,33,4752,10896
test,738,16,12288,131,18864,31152
test,739,26,19968,345,49680,69648
test,740,9,6912,41,5904,12816
test,741,25,19200,319,45936,65136
test,742,36,27648,661,95184,122832
test,743,21,16128,225,32400,48528
test,744,34,26112,590,84960,111072
test,745,22,16896,247,35568,52464
test,746,36,27648,661,95184,122832
test,747,17,13056,147,21168,34224
test,748,19,14592,184,26496,41088
test,749,12,9216,73,10512,19728
test,750,26,19968,345,49680,69648
test,751,44,33792,988,142272,176064
test,752,48,36864,1175,169200,206064
test,753,8,6144,33,4752,10896
test,754,15,11520,115,16560,28080
test,755,46,35328,1079,155376,190704
test,756,14,10752,100,14400,25152
test,757,36,27648,661,95184,122832
test,758,29,22272,429,61776,84048
test,759,17,13056,147,21168,34224
test,760,32,24576,522,75168,99744
test,761,35,26880,625,90000,116880
test,762,25,19200,319,45936,65136
test,763,29,22272,429,61776,84048
test,764,21,16128,225,32400,48528
test,765,47,36096,1127,162288,198384
test,766,10,7680,51,7344,15024
test,767,20,15360,204,29376,44736
test,768,25,19200,319,45936,65136
test,769,12,9216,73,10512,19728
test,770,23,17664,270,38880,56544
test,771,5,3840,13,1872,5712
test,772,23,17664,270,38880,56544
test,773,12,9216,73,10512,19728
test,774,33,25344,556,80064,105408
test,775,14,10752,100,14400,25152
test,776,14,10752,100,14400,25152
test,777,35,26880,625,90000,116880
test,778,11,8448,62,8928,17376
test,779,31,23808,490,70560,94368
test,780,11,8448,62,8928,17376
test,781,28,21504,400,57600,79104
test,782,17,13056,147,21168,34224
test,783,27,20736,372,53568,74304
test,784,13,9984,86,12384,22368
test,785,48,36864,1175,169200,206064
test,786,15,11520,115,16560,28080
test,787,21,16128,225,32400,48528
test,788,23,17664,270,38880,56544
test,789,26,19968,345,49680,69648
test,790,15,11520,115,16560,28080
test,791,17,13056,147,21168,34224
test,792,13,9984,86,12384,22368
test,793,25,19200,319,45936,65136
test,794,20,15360,204,29376,44736
test,795,14,10752,100,14400,25152
test,796,21,16128,225,32400,48528
test,797,7,5376,25,3600,8976
test,798,9,6912,41,5904,12816
test,799,17,13056,147,21168,34224
test,800,36,27648,661,95184,122832
test,801,24,18432,294,42336,60768
test,802,43,33024,943,135792,168816
test,803,16,12288,131,18864,31152
test,804,11,8448,62,8928,17376
test,805,8,6144,33,4752,10896
test,806,19,14592,184,26496,41088
test,807,8,6144,33,4752,10896
test,808,19,14592,184,26496,41088
test,809,16,12288,131,18864,31152
test,810,20,15360,204,29376,44736
test,811,33,25344,556,80064,105408
test,812,31,23808,490,70560,94368
test,813,18,13824,165,23760,37584
test,814,24,18432,294,42336,60768
test,815,4,3072,8,1152,4224
test,816,19,14592,184,26496,41088
test,817,35,26880,625,90000,116880
test,818,20,15360,204,29376,44736
test,819,9,6912,41,5904,12816
test,820,2,1536,2,288,1824
test,821,19,14592,184,26496,41088
test,822,12,9216,73,10512,19728
test,823,14,10752,100,14400,25152
test,824,21,16128,225,32400,48528
test,825,23,17664,270,38880,56544
test,826,25,19200,319,45936,65136
test,827,28,21504,400,57600,79104
test,828,20,15360,204,29376,44736
test,829,23,17664,270,38880,56544
test,830,10,7680,51,7344,15024
test,831,29,22272,429,61776,84048
test,832,19,14592,184,26496,41088
test,833,11,8448,62,8928,17376
test,834,45,34560,1033,148752,183312
test,835,22,16896,247,35568,52464
test,836,37,28416,698,100512,128928
test,837,16,12288,131,18864,31152
test,838,7,5376,25,3600,8976
test,839,14,10752,100,14400,25152
test,840,16,12288,131,18864,31152
test,841,25,19200,319,45936,65136
test,842,33,25344,556,80064,105408
test,843,41,31488,858,123552,155040
test,844,22,16896,247,35568,52464
test,845,32,24576,522,75168,99744
test,846,12,9216,73,10512,19728
test,847,13,9984,86,12384,22368
test,848,20,15360,204,29376,44736
test,849,18,13824,165,23760,37584
test,850,38,29184,737,106128,135312
test,851,43,33024,943,135792,168816
test,852,22,16896,247,35568,52464
test,853,7,5376,25,3600,8976
test,854,24,18432,294,42336,60768
test,855,39,29952,776,111744,141696
test,856,39,29952,776,111744,141696
test,857,26,19968,345,49680,69648
test,858,14,10752,100,14400,25152
test,859,18,13824,165,23760,37584
test,860,23,17664,270,38880,56544
test,861,23,17664,270,38880,56544
test,862,42,32256,900,129600,161856
test,863,27,20736,372,53568,74304
test,864,31,23808,490,70560,94368
test,865,24,18432,294,42336,60768
test,866,35,26880,625,90000,116880
test,867,57,43776,1658,238752,282528
test,868,16,12288,131,18864,31152
test,869,22,16896,247,35568,52464
test,870,10,7680,51,7344,15024
test,871,35,26880,625,90000,116880
test,872,8,6144,33,4752,10896
test,873,20,15360,204,29376,44736
test,874,39,29952,776,111744,141696
test,875,21,16128,225,32400,48528
test,876,16,12288,131,18864,31152
test,877,41,31488,858,123552,155040
test,878,38,29184,737,106128,135312
test,879,27,20736,372,53568,74304
test,880,35,26880,625,90000,116880
test,881,5,3840,13,1872,5712
test,882,38,29184,737,106128,135312
test,883,32,24576,522,75168,99744
test,884,9,6912,41,5904,12816
test,885,30,23040,459,66096,89136
test,886,9,6912,41,5904,12816
test,887,11,8448,62,8928,17376
test,888,20,15360,204,29376,44736
test,889,27,20736,372,53568,74304
test,890,16,12288,131,18864,31152
test,891,31,23808,490,70560,94368
test,892,29,22272,429,61776,84048
test,893,35,26880,625,90000,116880
test,894,27,20736,372,53568,74304
test,895,5,3840,13,1872,5712
test,896,24,18432,294,42336,60768
test,897,30,23040,459,66096,89136
test,898,18,13824,165,23760,37584
test,899,12,9216,73,10512,19728
test,900,17,13056,147,21168,34224
test,901,29,22272,429,61776,84048
test,902,37,28416,698,100512,128928
test,903,40,30720,816,117504,148224
test,904,16,12288,131,18864,31152
test,905,25,19200,319,45936,65136
test,906,19,14592,184,26496,41088
test,907,14,10752,100,14400,25152
test,908,13,9984,86,12384,22368
test,909,15,11520,115,16560,28080
test,910,27,20736,372,53568,74304
test,911,42,32256,900,129600,161856
test,912,8,6144,33,4752,10896
test,913,18,13824,165,23760,37584
test,914,22,16896,247,35568,52464
test,915,27,20736,372,53568,74304
test,916,27,20736,372,53568,74304
test,917,32,24576,522,75168,99744
test,918,18,13824,165,23760,37584
test,919,16,12288,131,18864,31152
test,920,16,12288,131,18864,31152
test,921,30,23040,459,66096,89136
test,922,36,27648,661,95184,122832
test,923,11,8448,62,8928,17376
test,924,35,26880,625,90000,116880
test,925,42,32256,900,129600,161856
test,926,42,32256,900,129600,161856
test,927,38,29184,737,106128,135312
test,928,9,6912,41,5904,12816
test,929,21,16128,225,32400,48528
test,930,45,34560,1033,148752,183312
test,931,20,15360,204,29376,44736
test,932,18,13824,165,23760,37584
test,933,8,6144,33,4752,10896
test,934,50,38400,1275,183600,222000
test,935,15,11520,115,16560,28080
test,936,20,15360,204,29376,44736
test,937,9,6912,41,5904,12816
test,938,15,11520,115,16560,28080
test,939,54,41472,1488,214272,255744
test,940,26,19968,345,49680,69648
test,941,41,31488,858,123552,155040
test,942,33,25344,556,80064,105408
test,943,20,15360,204,29376,44736
test,944,24,18432,294,42336,60768
test,945,24,18432,294,42336,60768
test,946,49,37632,1225,176400,214032
test,947,42,32256,900,129600,161856
test,948,36,27648,661,95184,122832
test,949,16,12288,131,18864,31152
test,950,33,25344,556,80064,105408
test,951,26,19968,345,49680,69648
test,952,23,17664,270,38880,56544
test,953,20,15360,204,29376,44736
test,954,11,8448,62,8928,17376
test,955,35,26880,625,90000,116880
test,956,17,13056,147,21168,34224
test,957,30,23040,459,66096,89136
test,958,30,23040,459,66096,89136
test,959,34,26112,590,84960,111072
test,960,15,11520,115,16560,28080
test,961,9,6912,41,5904,12816
test,962,20,15360,204,29376,44736
test,963,25,19200,319,45936,65136
test,964,15,11520,115,16560,28080
test,965,12,9216,73,10512,19728
test,966,28,21504,400,57600,79104
test,967,24,18432,294,42336,60768
test,968,24,18432,294,42336,60768
test,969,8,6144,33,4752,10896
test,970,7,5376,25,3600,8976
test,971,39,29952,776,111744,141696
test,972,35,26880,625,90000,116880
test,973,23,17664,270,38880,56544
test,974,9,6912,41,5904,12816
test,975,10,7680,51,7344,15024
test,976,6,4608,18,2592,7200
test,977,21,16128,225,32400,48528
test,978,17,13056,147,21168,34224
test,979,20,15360,204,29376,44736
test,980,27,20736,372,53568,74304
test,981,45,34560,1033,148752,183312
test,982,34,26112,590,84960,111072
test,983,7,5376,25,3600,8976
test,984,12,9216,73,10512,19728
test,985,9,6912,41,5904,12816
test,986,12,9216,73,10512,19728
test,987,34,26112,590,84960,111072
test,988,12,9216,73,10512,19728
test,989,25,19200,319,45936,65136
test,990,36,27648,661,95184,122832
test,991,16,12288,131,18864,31152
test,992,25,19200,319,45936,65136
test,993,47,36096,1127,162288,198384
test,994,14,10752,100,14400,25152
test,995,37,28416,698,100512,128928
test,996,18,13824,165,23760,37584
test,997,13,9984,86,12384,22368
test,998,18,13824,165,23760,37584
test,999,37,28416,698,100512,128928
test,1000,14,10752,100,14400,25152
test,1001,22,16896,247,35568,52464
test,1002,10,7680,51,7344,15024
test,1003,13,9984,86,12384,22368
test,1004,32,24576,522,75168,99744
test,1005,40,30720,816,117504,148224
test,1006,30,23040,459,66096,89136
test,1007,20,15360,204,29376,44736
test,1008,26,19968,345,49680,69648
test,1009,34,26112,590,84960,111072
test,1010,9,6912,41,5904,12816
test,1011,22,16896,247,35568,52464
test,1012,7,5376,25,3600,8976
test,1013,9,6912,41,5904,12816
test,1014,12,9216,73,10512,19728
test,1015,12,9216,73,10512,19728
test,1016,26,19968,345,49680,69648
test,1017,10,7680,51,7344,15024
test,1018,9,6912,41,5904,12816
test,1019,43,33024,943,135792,168816
test,1020,39,29952,776,111744,141696
test,1021,30,23040,459,66096,89136
test,1022,25,19200,319,45936,65136
test,1023,3,2304,5,720,3024
test,1024,23,17664,270,38880,56544
test,1025,10,7680,51,7344,15024
test,1026,21,16128,225,32400,48528
test,1027,13,9984,86,12384,22368
test,1028,13,9984,86,12384,22368
test,1029,15,11520,115,16560,28080
test,1030,19,14592,184,26496,41088
test,1031,41,31488,858,123552,155040
test,1032,29,22272,429,61776,84048
test,1033,24,18432,294,42336,60768
test,1034,22,16896,247,35568,52464
test,1035,16,12288,131,18864,31152
test,1036,25,19200,319,45936,65136
test,1037,28,21504,400,57600,79104
test,1038,26,19968,345,49680,69648
test,1039,17,13056,147,21168,34224
test,1040,20,15360,204,29376,44736
test,1041,9,6912,41,5904,12816
test,1042,27,20736,372,53568,74304
test,1043,34,26112,590,84960,111072
test,1044,17,13056,147,21168,34224
test,1045,22,16896,247,35568,52464
test,1046,25,19200,319,45936,65136
test,1047,17,13056,147,21168,34224
test,1048,10,7680,51,7344,15024
test,1049,40,30720,816,117504,148224
test,1050,15,11520,115,16560,28080
test,1051,28,21504,400,57600,79104
test,1052,39,29952,776,111744,141696
test,1053,51,39168,1327,191088,230256
test,1054,30,23040,459,66096,89136
test,1055,9,6912,41,5904,12816
test,1056,12,9216,73,10512,19728
test,1057,6,4608,18,2592,7200
test,1058,7,5376,25,3600,8976
test,1059,3,2304,5,720,3024
test,1060,30,23040,459,66096,89136
test,1061,21,16128,225,32400,48528
test,1062,14,10752,100,14400,25152
test,1063,23,17664,270,38880,56544
test,1064,22,16896,247,35568,52464
test,1065,23,17664,270,38880,56544
test,1066,17,13056,147,21168,34224
test,1067,28,21504,400,57600,79104
test,1068,25,19200,319,45936,65136
test,1069,32,24576,522,75168,99744
test,1070,21,16128,225,32400,48528
test,1071,38,29184,737,106128,135312
test,1072,28,21504,400,57600,79104
test,1073,44,33792,988,142272,176064
test,1074,23,17664,270,38880,56544
test,1075,11,8448,62,8928,17376
test,1076,19,14592,184,26496,41088
test,1077,15,11520,115,16560,28080
test,1078,18,13824,165,23760,37584
test,1079,30,23040,459,66096,89136
test,1080,14,10752,100,14400,25152
test,1081,22,16896,247,35568,52464
test,1082,3,2304,5,720,3024
test,1083,11,8448,62,8928,17376
test,1084,27,20736,372,53568,74304
test,1085,3,2304,5,720,3024
test,1086,19,14592,184,26496,41088
test,1087,35,26880,625,90000,116880
test,1088,27,20736,372,53568,74304
test,1089,25,19200,319,45936,65136
test,1090,22,16896,247,35568,52464
test,1091,9,6912,41,5904,12816
test,1092,20,15360,204,29376,44736
test,1093,6,4608,18,2592,7200
test,1094,21,16128,225,32400,48528
test,1095,10,7680,51,7344,15024
test,1096,20,15360,204,29376,44736
test,1097,19,14592,184,26496,41088
test,1098,51,39168,1327,191088,230256
test,1099,13,9984,86,12384,22368
test,1100,14,10752,100,14400,25152
test,1101,23,17664,270,38880,56544
test,1102,25,19200,319,45936,65136
test,1103,37,28416,698,100512,128928
test,1104,18,13824,165,23760,37584
test,1105,12,9216,73,10512,19728
test,1106,28,21504,400,57600,79104
test,1107,34,26112,590,84960,111072
test,1108,25,19200,319,45936,65136
test,1109,12,9216,73,10512,19728
test,1110,18,13824,165,23760,37584
test,1111,29,22272,429,61776,84048
test,1112,26,19968,345,49680,69648
test,1113,36,27648,661,95184,122832
test,1114,26,19968,345,49680,69648
test,1115,8,6144,33,4752,10896
test,1116,25,19200,319,45936,65136
test,1117,22,16896,247,35568,52464
test,1118,9,6912,41,5904,12816
test,1119,30,23040,459,66096,89136
test,1120,8,6144,33,4752,10896
test,1121,16,12288,131,18864,31152
test,1122,32,24576,522,75168,99744
test,1123,31,23808,490,70560,94368
test,1124,35,26880,625,90000,116880
test,1125,28,21504,400,57600,79104
test,1126,10,7680,51,7344,15024
test,1127,17,13056,147,21168,34224
test,1128,10,7680,51,7344,15024
test,1129,22,16896,247,35568,52464
test,1130,26,19968,345,49680,69648
test,1131,14,10752,100,14400,25152
test,1132,21,16128,225,32400,48528
test,1133,3,2304,5,720,3024
test,1134,17,13056,147,21168,34224
test,1135,31,23808,490,70560,94368
test,1136,40,30720,816,117504,148224
test,1137,16,12288,131,18864,31152
test,1138,25,19200,319,45936,65136
test,1139,38,29184,737,106128,135312
test,1140,12,9216,73,10512,19728
test,1141,20,15360,204,29376,44736
test,1142,23,17664,270,38880,56544
test,1143,29,22272,429,61776,84048
test,1144,53,40704,1433,206352,247056
test,1145,45,34560,1033,148752,183312
test,1146,17,13056,147,21168,34224
test,1147,44,33792,988,142272,176064
test,1148,19,14592,184,26496,41088
test,1149,10,7680,51,7344,15024
test,1150,26,19968,345,49680,69648
test,1151,22,16896,247,35568,52464
test,1152,27,20736,372,53568,74304
test,1153,13,9984,86,12384,22368
test,1154,34,26112,590,84960,111072
test,1155,20,15360,204,29376,44736
test,1156,7,5376,25,3600,8976
test,1157,12,9216,73,10512,19728
test,1158,38,29184,737,106128,135312
test,1159,41,31488,858,123552,155040
test,1160,12,9216,73,10512,19728
test,1161,19,14592,184,26496,41088
test,1162,23,17664,270,38880,56544
test,1163,8,6144,33,4752,10896
test,1164,34,26112,590,84960,111072
test,1165,33,25344,556,80064,105408
test,1166,31,23808,490,70560,94368
test,1167,34,26112,590,84960,111072
test,1168,14,10752,100,14400,25152
test,1169,28,21504,400,57600,79104
test,1170,45,34560,1033,148752,183312
test,1171,35,26880,625,90000,116880
test,1172,37,28416,698,100512,128928
test,1173,27,20736,372,53568,74304
test,1174,19,14592,184,26496,41088
test,1175,14,10752,100,14400,25152
test,1176,28,21504,400,57600,79104
test,1177,33,25344,556,80064,105408
test,1178,25,19200,319,45936,65136
test,1179,13,9984,86,12384,22368
test,1180,10,7680,51,7344,15024
test,1181,21,16128,225,32400,48528
test,1182,18,13824,165,23760,37584
test,1183,25,19200,319,45936,65136
test,1184,16,12288,131,18864,31152
test,1185,29,22272,429,61776,84048
test,1186,18,13824,165,23760,37584
test,1187,18,13824,165,23760,37584
test,1188,26,19968,345,49680,69648
test,1189,24,18432,294,42336,60768
test,1190,27,20736,372,53568,74304
test,1191,7,5376,25,3600,8976
test,1192,14,10752,100,14400,25152
test,1193,23,17664,270,38880,56544
test,1194,15,11520,115,16560,28080
test,1195,25,19200,319,45936,65136
test,1196,27,20736,372,53568,74304
test,1197,10,7680,51,7344,15024
test,1198,14,10752,100,14400,25152
test,1199,24,18432,294,42336,60768
test,1200,14,10752,100,14400,25152
test,1201,18,13824,165,23760,37584
test,1202,17,13056,147,21168,34224
test,1203,32,24576,522,75168,99744
test,1204,46,35328,1079,155376,190704
test,1205,13,9984,86,12384,22368
test,1206,35,26880,625,90000,116880
test,1207,20,15360,204,29376,44736
test,1208,33,25344,556,80064,105408
test,1209,40,30720,816,117504,148224
test,1210,27,20736,372,53568,74304
test,1211,31,23808,490,70560,94368
test,1212,7,5376,25,3600,8976
test,1213,44,33792,988,142272,176064
test,1214,28,21504,400,57600,79104
test,1215,27,20736,372,53568,74304
test,1216,28,21504,400,57600,79104
test,1217,6,4608,18,2592,7200
test,1218,44,33792,988,142272,176064
test,1219,16,12288,131,18864,31152
test,1220,15,11520,115,16560,28080
test,1221,10,7680,51,7344,15024
test,1222,53,40704,1433,206352,247056
test,1223,9,6912,41,5904,12816
test,1224,21,16128,225,32400,48528
test,1225,26,19968,345,49680,69648
test,1226,35,26880,625,90000,116880
test,1227,46,35328,1079,155376,190704
test,1228,35,26880,625,90000,116880
test,1229,5,3840,13,1872,5712
test,1230,21,16128,225,32400,48528
test,1231,26,19968,345,49680,69648
test,1232,18,13824,165,23760,37584
test,1233,29,22272,429,61776,84048
test,1234,14,10752,100,14400,25152
test,1235,13,9984,86,12384,22368
test,1236,27,20736,372,53568,74304
test,1237,31,23808,490,70560,94368
test,1238,14,10752,100,14400,25152
test,1239,29,22272,429,61776,84048
test,1240,13,9984,86,12384,22368
test,1241,19,14592,184,26496,41088
test,1242,27,20736,372,53568,74304
test,1243,39,29952,776,111744,141696
test,1244,29,22272,429,61776,84048
test,1245,45,34560,1033,148752,183312
test,1246,20,15360,204,29376,44736
test,1247,14,10752,100,14400,25152
test,1248,38,29184,737,106128,135312
test,1249,20,15360,204,29376,44736
test,1250,20,15360,204,29376,44736
test,1251,25,19200,319,45936,65136
test,1252,12,9216,73,10512,19728
test,1253,28,21504,400,57600,79104
test,1254,36,27648,661,95184,122832
test,1255,22,16896,247,35568,52464
test,1256,23,17664,270,38880,56544
test,1257,8,6144,33,4752,10896
test,1258,36,27648,661,95184,122832
test,1259,18,13824,165,23760,37584
test,1260,16,12288,131,18864,31152
test,1261,9,6912,41,5904,12816
test,1262,18,13824,165,23760,37584
test,1263,36,27648,661,95184,122832
test,1264,33,25344,556,80064,105408
test,1265,30,23040,459,66096,89136
test,1266,31,23808,490,70560,94368
test,1267,16,12288,131,18864,31152
test,1268,17,13056,147,21168,34224
test,1269,31,23808,490,70560,94368
test,1270,12,9216,73,10512,19728
test,1271,16,12288,131,18864,31152
test,1272,12,9216,73,10512,19728
test,1273,24,18432,294,42336,60768
test,1274,29,22272,429,61776,84048
test,1275,30,23040,459,66096,89136
test,1276,28,21504,400,57600,79104
test,1277,35,26880,625,90000,116880
test,1278,6,4608,18,2592,7200
test,1279,15,11520,115,16560,28080
test,1280,23,17664,270,38880,56544
test,1281,16,12288,131,18864,31152
test,1282,15,11520,115,16560,28080
test,1283,18,13824,165,23760,37584
test,1284,13,9984,86,12384,22368
test,1285,36,27648,661,95184,122832
test,1286,19,14592,184,26496,41088
test,1287,36,27648,661,95184,122832
test,1288,36,27648,661,95184,122832
test,1289,7,5376,25,3600,8976
test,1290,38,29184,737,106128,135312
test,1291,21,16128,225,32400,48528
test,1292,26,19968,345,49680,69648
test,1293,22,16896,247,35568,52464
test,1294,3,2304,5,720,3024
test,1295,21,16128,225,32400,48528
test,1296,10,7680,51,7344,15024
test,1297,30,23040,459,66096,89136
test,1298,17,13056,147,21168,34224
test,1299,43,33024,943,135792,168816
test,1300,25,19200,319,45936,65136
test,1301,24,18432,294,42336,60768
test,1302,19,14592,184,26496,41088
test,1303,18,13824,165,23760,37584
test,1304,9,6912,41,5904,12816
test,1305,32,24576,522,75168,99744
test,1306,25,19200,319,45936,65136
test,1307,18,13824,165,23760,37584
test,1308,8,6144,33,4752,10896
test,1309,13,9984,86,12384,22368
test,1310,8,6144,33,4752,10896
test,1311,37,28416,698,100512,128928
test,1312,19,14592,184,26496,41088
test,1313,13,9984,86,12384,22368
test,1314,24,18432,294,42336,60768
test,1315,29,22272,429,61776,84048
test,1316,36,27648,661,95184,122832
test,1317,24,18432,294,42336,60768
test,1318,11,8448,62,8928,17376
test,1319,25,19200,319,45936,65136
test,1320,31,23808,490,70560,94368
test,1321,16,12288,131,18864,31152
test,1322,15,11520,115,16560,28080
test,1323,36,27648,661,95184,122832
test,1324,18,13824,165,23760,37584
test,1325,7,5376,25,3600,8976
test,1326,47,36096,1127,162288,198384
test,1327,5,3840,13,1872,5712
test,1328,18,13824,165,23760,37584
test,1329,19,14592,184,26496,41088
test,1330,21,16128,225,32400,48528
test,1331,10,7680,51,7344,15024
test,1332,13,9984,86,12384,22368
test,1333,40,30720,816,117504,148224
test,1334,19,14592,184,26496,41088
test,1335,26,19968,345,49680,69648
test,1336,43,33024,943,135792,168816
test,1337,10,7680,51,7344,15024
test,1338,23,17664,270,38880,56544
test,1339,20,15360,204,29376,44736
test,1340,16,12288,131,18864,31152
test,1341,28,21504,400,57600,79104
test,1342,10,7680,51,7344,15024
test,1343,26,19968,345,49680,69648
test,1344,12,9216,73,10512,19728
test,1345,21,16128,225,32400,48528
test,1346,40,30720,816,117504,148224
test,1347,22,16896,247,35568,52464
test,1348,26,19968,345,49680,69648
test,1349,31,23808,490,70560,94368
test,1350,17,13056,147,21168,34224
test,1351,30,23040,459,66096,89136
test,1352,22,16896,247,35568,52464
test,1353,21,16128,225,32400,48528
test,1354,16,12288,131,18864,31152
test,1355,8,6144,33,4752,10896
test,1356,16,12288,131,18864,31152
test,1357,23,17664,270,38880,56544
test,1358,29,22272,429,61776,84048
test,1359,55,42240,1543,222192,264432
test,1360,20,15360,204,29376,44736
test,1361,21,16128,225,32400,48528
test,1362,5,3840,13,1872,5712
test,1363,33,25344,556,80064,105408
test,1364,9,6912,41,5904,12816
test,1365,25,19200,319,45936,65136
test,1366,12,9216,73,10512,19728
test,1367,23,17664,270,38880,56544
test,1368,23,17664,270,38880,56544
test,1369,15,11520,115,16560,28080
test,1370,21,16128,225,32400,48528
test,1371,32,24576,522,75168,99744
test,1372,26,19968,345,49680,69648
test,1373,23,17664,270,38880,56544
test,1374,25,19200,319,45936,65136
test,1375,11,8448,62,8928,17376
test,1376,11,8448,62,8928,17376
test,1377,44,33792,988,142272,176064
test,1378,31,23808,490,70560,94368
test,1379,28,21504,400,57600,79104
test,1380,19,14592,184,26496,41088
test,1381,23,17664,270,38880,56544
test,1382,31,23808,490,70560,94368
test,1383,32,24576,522,75168,99744
test,1384,15,11520,115,16560,28080
test,1385,19,14592,184,26496,41088
test,1386,21,16128,225,32400,48528
test,1387,26,19968,345,49680,69648
test,1388,16,12288,131,18864,31152
test,1389,6,4608,18,2592,7200
test,1390,22,16896,247,35568,52464
test,1391,6,4608,18,2592,7200
test,1392,16,12288,131,18864,31152
test,1393,47,36096,1127,162288,198384
test,1394,32,24576,522,75168,99744
test,1395,14,10752,100,14400,25152
test,1396,12,9216,73,10512,19728
test,1397,13,9984,86,12384,22368
test,1398,22,16896,247,35568,52464
test,1399,15,11520,115,16560,28080
test,1400,12,9216,73,10512,19728
test,1401,14,10752,100,14400,25152
test,1402,27,20736,372,53568,74304
test,1403,30,23040,459,66096,89136
test,1404,30,23040,459,66096,89136
test,1405,30,23040,459,66096,89136
test,1406,27,20736,372,53568,74304
test,1407,10,7680,51,7344,15024
test,1408,26,19968,345,49680,69648
test,1409,27,20736,372,53568,74304
test,1410,20,15360,204,29376,44736
test,1411,19,14592,184,26496,41088
test,1412,30,23040,459,66096,89136
test,1413,8,6144,33,4752,10896
test,1414,16,12288,131,18864,31152
test,1415,7,5376,25,3600,8976
test,1416,24,18432,294,42336,60768
test,1417,26,19968,345,49680,69648
test,1418,27,20736,372,53568,74304
test,1419,17,13056,147,21168,34224
test,1420,12,9216,73,10512,19728
test,1421,43,33024,943,135792,168816
test,1422,12,9216,73,10512,19728
test,1423,25,19200,319,45936,65136
test,1424,25,19200,319,45936,65136
test,1425,16,12288,131,18864,31152
test,1426,19,14592,184,26496,41088
test,1427,25,19200,319,45936,65136
test,1428,11,8448,62,8928,17376
test,1429,23,17664,270,38880,56544
test,1430,27,20736,372,53568,74304
test,1431,13,9984,86,12384,22368
test,1432,39,29952,776,111744,141696
test,1433,20,15360,204,29376,44736
test,1434,51,39168,1327,191088,230256
test,1435,22,16896,247,35568,52464
test,1436,36,27648,661,95184,122832
test,1437,30,23040,459,66096,89136
test,1438,31,23808,490,70560,94368
test,1439,23,17664,270,38880,56544
test,1440,33,25344,556,80064,105408
test,1441,19,14592,184,26496,41088
test,1442,14,10752,100,14400,25152
test,1443,9,6912,41,5904,12816
test,1444,25,19200,319,45936,65136
test,1445,62,47616,1961,282384,330000
test,1446,48,36864,1175,169200,206064
test,1447,21,16128,225,32400,48528
test,1448,15,11520,115,16560,28080
test,1449,32,24576,522,75168,99744
test,1450,26,19968,345,49680,69648
test,1451,40,30720,816,117504,148224
test,1452,40,30720,816,117504,148224
test,1453,33,25344,556,80064,105408
test,1454,34,26112,590,84960,111072
test,1455,18,13824,165,23760,37584
test,1456,31,23808,490,70560,94368
test,1457,7,5376,25,3600,8976
test,1458,25,19200,319,45936,65136
test,1459,7,5376,25,3600,8976
test,1460,38,29184,737,106128,135312
test,1461,12,9216,73,10512,19728
test,1462,26,19968,345,49680,69648
test,1463,19,14592,184,26496,41088
test,1464,16,12288,131,18864,31152
test,1465,33,25344,556,80064,105408
test,1466,47,36096,1127,162288,198384
test,1467,25,19200,319,45936,65136
test,1468,30,23040,459,66096,89136
test,1469,37,28416,698,100512,128928
test,1470,15,11520,115,16560,28080
test,1471,18,13824,165,23760,37584
test,1472,8,6144,33,4752,10896
test,1473,29,22272,429,61776,84048
test,1474,16,12288,131,18864,31152
test,1475,15,11520,115,16560,28080
test,1476,21,16128,225,32400,48528
test,1477,22,16896,247,35568,52464
test,1478,14,10752,100,14400,25152
test,1479,27,20736,372,53568,74304
test,1480,21,16128,225,32400,48528
test,1481,14,10752,100,14400,25152
test,1482,29,22272,429,61776,84048
test,1483,20,15360,204,29376,44736
test,1484,25,19200,319,45936,65136
test,1485,11,8448,62,8928,17376
test,1486,12,9216,73,10512,19728
test,1487,21,16128,225,32400,48528
test,1488,32,24576,522,75168,99744
test,1489,20,15360,204,29376,44736
test,1490,15,11520,115,16560,28080
test,1491,35,26880,625,90000,116880
test,1492,37,28416,698,100512,128928
test,1493,28,21504,400,57600,79104
test,1494,29,22272,429,61776,84048
test,1495,7,5376,25,3600,8976
test,1496,9,6912,41,5904,12816
test,1497,5,3840,13,1872,5712
test,1498,24,18432,294,42336,60768
test,1499,9,6912,41,5904,12816
test,1500,9,6912,41,5904,12816
test,1501,56,43008,1600,230400,273408
test,1502,25,19200,319,45936,65136
test,1503,25,19200,319,45936,65136
test,1504,49,37632,1225,176400,214032
test,1505,16,12288,131,18864,31152
test,1506,4,3072,8,1152,4224
test,1507,37,28416,698,100512,128928
test,1508,26,19968,345,49680,69648
test,1509,28,21504,400,57600,79104
test,1510,21,16128,225,32400,48528
test,1511,29,22272,429,61776,84048
test,1512,12,9216,73,10512,19728
test,1513,16,12288,131,18864,31152
test,1514,10,7680,51,7344,15024
test,1515,27,20736,372,53568,74304
test,1516,18,13824,165,23760,37584
test,1517,17,13056,147,21168,34224
test,1518,53,40704,1433,206352,247056
test,1519,30,23040,459,66096,89136
test,1520,38,29184,737,106128,135312
test,1521,38,29184,737,106128,135312
test,1522,30,23040,459,66096,89136
test,1523,9,6912,41,5904,12816
test,1524,31,23808,490,70560,94368
test,1525,7,5376,25,3600,8976
test,1526,32,24576,522,75168,99744
test,1527,14,10752,100,14400,25152
test,1528,28,21504,400,57600,79104
test,1529,15,11520,115,16560,28080
test,1530,30,23040,459,66096,89136
test,1531,8,6144,33,4752,10896
test,1532,47,36096,1127,162288,198384
test,1533,25,19200,319,45936,65136
test,1534,19,14592,184,26496,41088
test,1535,28,21504,400,57600,79104
test,1536,17,13056,147,21168,34224
test,1537,17,13056,147,21168,34224
test,1538,21,16128,225,32400,48528
test,1539,27,20736,372,53568,74304
test,1540,11,8448,62,8928,17376
test,1541,26,19968,345,49680,69648
test,1542,22,16896,247,35568,52464
test,1543,18,13824,165,23760,37584
test,1544,23,17664,270,38880,56544
test,1545,12,9216,73,10512,19728
test,1546,17,13056,147,21168,34224
test,1547,17,13056,147,21168,34224
test,1548,29,22272,429,61776,84048
test,1549,22,16896,247,35568,52464
test,1550,11,8448,62,8928,17376
test,1551,26,19968,345,49680,69648
test,1552,22,16896,247,35568,52464
test,1553,26,19968,345,49680,69648
test,1554,13,9984,86,12384,22368
test,1555,38,29184,737,106128,135312
test,1556,10,7680,51,7344,15024
test,1557,16,12288,131,18864,31152
test,1558,57,43776,1658,238752,282528
test,1559,21,16128,225,32400,48528
test,1560,7,5376,25,3600,8976
test,1561,19,14592,184,26496,41088
test,1562,12,9216,73,10512,19728
test,1563,52,39936,1379,198576,238512
test,1564,9,6912,41,5904,12816
test,1565,18,13824,165,23760,37584
test,1566,19,14592,184,26496,41088
test,1567,13,9984,86,12384,22368
test,1568,13,9984,86,12384,22368
test,1569,11,8448,62,8928,17376
test,1570,16,12288,131,18864,31152
test,1571,10,7680,51,7344,15024
test,1572,22,16896,247,35568,52464
test,1573,33,25344,556,80064,105408
test,1574,40,30720,816,117504,148224
test,1575,11,8448,62,8928,17376
test,1576,31,23808,490,70560,94368
test,1577,12,9216,73,10512,19728
test,1578,18,13824,165,23760,37584
test,1579,31,23808,490,70560,94368
test,1580,7,5376,25,3600,8976
test,1581,22,16896,247,35568,52464
test,1582,21,16128,225,32400,48528
test,1583,24,18432,294,42336,60768
test,1584,27,20736,372,53568,74304
test,1585,8,6144,33,4752,10896
test,1586,24,18432,294,42336,60768
test,1587,17,13056,147,21168,34224
test,1588,19,14592,184,26496,41088
test,1589,27,20736,372,53568,74304
test,1590,20,15360,204,29376,44736
test,1591,15,11520,115,16560,28080
test,1592,35,26880,625,90000,116880
test,1593,13,9984,86,12384,22368
test,1594,28,21504,400,57600,79104
test,1595,28,21504,400,57600,79104
test,1596,13,9984,86,12384,22368
test,1597,10,7680,51,7344,15024
test,1598,42,32256,900,129600,161856
test,1599,30,23040,459,66096,89136
test,1600,18,13824,165,23760,37584
test,1601,18,13824,165,23760,37584
test,1602,16,12288,131,18864,31152
test,1603,6,4608,18,2592,7200
test,1604,7,5376,25,3600,8976
test,1605,21,16128,225,32400,48528
test,1606,9,6912,41,5904,12816
test,1607,17,13056,147,21168,34224
test,1608,13,9984,86,12384,22368
test,1609,14,10752,100,14400,25152
test,1610,18,13824,165,23760,37584
test,1611,12,9216,73,10512,19728
test,1612,28,21504,400,57600,79104
test,1613,24,18432,294,42336,60768
test,1614,20,15360,204,29376,44736
test,1615,19,14592,184,26496,41088
test,1616,28,21504,400,57600,79104
test,1617,14,10752,100,14400,25152
test,1618,36,27648,661,95184,122832
test,1619,29,22272,429,61776,84048
test,1620,21,16128,225,32400,48528
test,1621,7,5376,25,3600,8976
test,1622,26,19968,345,49680,69648
test,1623,37,28416,698,100512,128928
test,1624,10,7680,51,7344,15024
test,1625,22,16896,247,35568,52464
test,1626,27,20736,372,53568,74304
test,1627,22,16896,247,35568,52464
test,1628,31,23808,490,70560,94368
test,1629,44,33792,988,142272,176064
test,1630,25,19200,319,45936,65136
test,1631,21,16128,225,32400,48528
test,1632,31,23808,490,70560,94368
test,1633,18,13824,165,23760,37584
test,1634,39,29952,776,111744,141696
test,1635,24,18432,294,42336,60768
test,1636,52,39936,1379,198576,238512
test,1637,13,9984,86,12384,22368
test,1638,27,20736,372,53568,74304
test,1639,12,9216,73,10512,19728
test,1640,27,20736,372,53568,74304
test,1641,9,6912,41,5904,12816
test,1642,46,35328,1079,155376,190704
test,1643,19,14592,184,26496,41088
test,1644,36,27648,661,95184,122832
test,1645,18,13824,165,23760,37584
test,1646,16,12288,131,18864,31152
test,1647,32,24576,522,75168,99744
test,1648,25,19200,319,45936,65136
test,1649,21,16128,225,32400,48528
test,1650,36,27648,661,95184,122832
test,1651,28,21504,400,57600,79104
test,1652,25,19200,319,45936,65136
test,1653,26,19968,345,49680,69648
test,1654,13,9984,86,12384,22368
test,1655,36,27648,661,95184,122832
test,1656,38,29184,737,106128,135312
test,1657,5,3840,13,1872,5712
test,1658,10,7680,51,7344,15024
test,1659,34,26112,590,84960,111072
test,1660,27,20736,372,53568,74304
test,1661,38,29184,737,106128,135312
test,1662,26,19968,345,49680,69648
test,1663,15,11520,115,16560,28080
test,1664,24,18432,294,42336,60768
test,1665,19,14592,184,26496,41088
test,1666,19,14592,184,26496,41088
test,1667,42,32256,900,129600,161856
test,1668,46,35328,1079,155376,190704
test,1669,19,14592,184,26496,41088
test,1670,32,24576,522,75168,99744
test,1671,18,13824,165,23760,37584
test,1672,33,25344,556,80064,105408
test,1673,28,21504,400,57600,79104
test,1674,37,28416,698,100512,128928
test,1675,22,16896,247,35568,52464
test,1676,28,21504,400,57600,79104
test,1677,37,28416,698,100512,128928
test,1678,10,7680,51,7344,15024
test,1679,29,22272,429,61776,84048
test,1680,3,2304,5,720,3024
test,1681,19,14592,184,26496,41088
test,1682,42,32256,900,129600,161856
test,1683,34,26112,590,84960,111072
test,1684,18,13824,165,23760,37584
test,1685,9,6912,41,5904,12816
test,1686,35,26880,625,90000,116880
test,1687,41,31488,858,123552,155040
test,1688,15,11520,115,16560,28080
test,1689,32,24576,522,75168,99744
test,1690,17,13056,147,21168,34224
test,1691,7,5376,25,3600,8976
test,1692,33,25344,556,80064,105408
test,1693,41,31488,858,123552,155040
test,1694,21,16128,225,32400,48528
test,1695,9,6912,41,5904,12816
test,1696,38,29184,737,106128,135312
test,1697,25,19200,319,45936,65136
test,1698,19,14592,184,26496,41088
test,1699,15,11520,115,16560,28080
test,1700,21,16128,225,32400,48528
test,1701,26,19968,345,49680,69648
test,1702,26,19968,345,49680,69648
test,1703,14,10752,100,14400,25152
test,1704,24,18432,294,42336,60768
test,1705,27,20736,372,53568,74304
test,1706,30,23040,459,66096,89136
test,1707,23,17664,270,38880,56544
test,1708,18,13824,165,23760,37584
test,1709,38,29184,737,106128,135312
test,1710,7,5376,25,3600,8976
test,1711,30,23040,459,66096,89136
test,1712,23,17664,270,38880,56544
test,1713,14,10752,100,14400,25152
test,1714,27,20736,372,53568,74304
test,1715,22,16896,247,35568,52464
test,1716,31,23808,490,70560,94368
test,1717,23,17664,270,38880,56544
test,1718,7,5376,25,3600,8976
test,1719,15,11520,115,16560,28080
test,1720,37,28416,698,100512,128928
test,1721,8,6144,33,4752,10896
test,1722,26,19968,345,49680,69648
test,1723,20,15360,204,29376,44736
test,1724,6,4608,18,2592,7200
test,1725,33,25344,556,80064,105408
test,1726,10,7680,51,7344,15024
test,1727,6,4608,18,2592,7200
test,1728,37,28416,698,100512,128928
test,1729,26,19968,345,49680,69648
test,1730,18,13824,165,23760,37584
test,1731,20,15360,204,29376,44736
test,1732,25,19200,319,45936,65136
test,1733,3,2304,5,720,3024
test,1734,16,12288,131,18864,31152
test,1735,22,16896,247,35568,52464
test,1736,13,9984,86,12384,22368
test,1737,33,25344,556,80064,105408
test,1738,18,13824,165,23760,37584
test,1739,24,18432,294,42336,60768
test,1740,46,35328,1079,155376,190704
test,1741,25,19200,319,45936,65136
test,1742,33,25344,556,80064,105408
test,1743,15,11520,115,16560,28080
test,1744,30,23040,459,66096,89136
test,1745,24,18432,294,42336,60768
test,1746,51,39168,1327,191088,230256
test,1747,34,26112,590,84960,111072
test,1748,24,18432,294,42336,60768
test,1749,35,26880,625,90000,116880
test,1750,24,18432,294,42336,60768
test,1751,3,2304,5,720,3024
test,1752,40,30720,816,117504,148224
test,1753,38,29184,737,106128,135312
test,1754,7,5376,25,3600,8976
test,1755,24,18432,294,42336,60768
test,1756,6,4608,18,2592,7200
test,1757,10,7680,51,7344,15024
test,1758,16,12288,131,18864,31152
test,1759,23,17664,270,38880,56544
test,1760,6,4608,18,2592,7200
test,1761,36,27648,661,95184,122832
test,1762,20,15360,204,29376,44736
test,1763,13,9984,86,12384,22368
test,1764,17,13056,147,21168,34224
test,1765,24,18432,294,42336,60768
test,1766,21,16128,225,32400,48528
test,1767,18,13824,165,23760,37584
test,1768,34,26112,590,84960,111072
test,1769,37,28416,698,100512,128928
test,1770,20,15360,204,29376,44736
test,1771,13,9984,86,12384,22368
test,1772,27,20736,372,53568,74304
test,1773,20,15360,204,29376,44736
test,1774,27,20736,372,53568,74304
test,1775,37,28416,698,100512,128928
test,1776,6,4608,18,2592,7200
test,1777,37,28416,698,100512,128928
test,1778,20,15360,204,29376,44736
test,1779,29,22272,429,61776,84048
test,1780,30,23040,459,66096,89136
test,1781,16,12288,131,18864,31152
test,1782,18,13824,165,23760,37584
test,1783,8,6144,33,4752,10896
test,1784,14,10752,100,14400,25152
test,1785,14,10752,100,14400,25152
test,1786,19,14592,184,26496,41088
test,1787,47,36096,1127,162288,198384
test,1788,22,16896,247,35568,52464
test,1789,40,30720,816,117504,148224
test,1790,32,24576,522,75168,99744
test,1791,37,28416,698,100512,128928
test,1792,15,11520,115,16560,28080
test,1793,33,25344,556,80064,105408
test,1794,9,6912,41,5904,12816
test,1795,43,33024,943,135792,168816
test,1796,40,30720,816,117504,148224
test,1797,36,27648,661,95184,122832
test,1798,27,20736,372,53568,74304
test,1799,14,10752,100,14400,25152
test,1800,9,6912,41,5904,12816
test,1801,19,14592,184,26496,41088
test,1802,7,5376,25,3600,8976
test,1803,34,26112,590,84960,111072
test,1804,42,32256,900,129600,161856
test,1805,15,11520,115,16560,28080
test,1806,29,22272,429,61776,84048
test,1807,30,23040,459,66096,89136
test,1808,6,4608,18,2592,7200
test,1809,9,6912,41,5904,12816
test,1810,21,16128,225,32400,48528
test,1811,36,27648,661,95184,122832
test,1812,41,31488,858,123552,155040
test,1813,29,22272,429,61776,84048
test,1814,14,10752,100,14400,25152
test,1815,34,26112,590,84960,111072
test,1816,39,29952,776,111744,141696
test,1817,19,14592,184,26496,41088
test,1818,31,23808,490,70560,94368
test,1819,4,3072,8,1152,4224
test,1820,29,22272,429,61776,84048
