split,index,nodes,total_values_for_nodes,edges,total_values_for_edges,total_values_for_graph
train,0,1111,1137664,19206,3687552,4825216
train,1,1261,1291264,21570,4141440,5432704
train,2,1013,1037312,17854,3427968,4465280
train,3,1236,1265664,21122,4055424,5321088
train,4,1318,1349632,22674,4353408,5703040
train,5,972,995328,16438,3156096,4151424
train,6,1052,1077248,18490,3550080,4627328
train,7,1310,1341440,22512,4322304,5663744
train,8,1342,1374208,23172,4449024,5823232
train,9,962,985088,16135,3097920,4083008
train,10,1764,1806336,34984,6716928,8523264
train,11,1195,1223680,20433,3923136,5146816
train,12,1048,1073152,18446,3541632,4614784
train,13,1357,1389568,23494,4510848,5900416
train,14,1156,1183744,19833,3807936,4991680
train,15,1095,1121280,19000,3648000,4769280
train,16,1029,1053696,18244,3502848,4556544
train,17,1461,1496064,25940,4980480,6476544
train,18,1165,1192960,19967,3833664,5026624
train,19,927,949248,14984,2876928,3826176
train,20,1053,1078272,18501,3552192,4630464
train,21,981,1004544,16744,3214848,4219392
train,22,1118,1144832,19299,3705408,4850240
train,23,1129,1156096,19448,3734016,4890112
train,24,1171,1199104,20057,3850944,5050048
train,25,1021,1045504,18137,3482304,4527808
train,26,1010,1034240,17819,3421248,4455488
train,27,1275,1305600,21831,4191552,5497152
train,28,1370,1402880,23779,4565568,5968448
train,29,1135,1162240,19531,3749952,4912192
train,30,984,1007616,16847,3234624,4242240
train,31,1060,1085440,18580,3567360,4652800
train,32,1126,1153024,19407,3726144,4879168
train,33,1181,1209344,20212,3880704,5090048
train,34,2350,2406400,47035,9030720,11437120
train,35,1180,1208320,20196,3877632,5085952
train,36,1029,1053696,18244,3502848,4556544
train,37,1283,1313792,21983,4220736,5534528
train,38,1197,1225728,20465,3929280,5155008
train,39,1360,1392640,23559,4523328,5915968
train,40,1111,1137664,19206,3687552,4825216
train,41,1282,1312768,21964,4217088,5529856
train,42,940,962560,15374,2951808,3914368
train,43,1150,1177600,19745,3791040,4968640
train,44,1224,1253376,20914,4015488,5268864
train,45,1192,1220608,20385,3913920,5134528
train,46,3097,3171328,64188,12324096,15495424
train,47,1559,1596416,28590,5489280,7085696
train,48,1019,1043456,18102,3475584,4519040
train,49,1319,1350656,22694,4357248,5707904
train,50,1266,1296384,21662,4159104,5455488
train,51,1119,1145856,19312,3707904,4853760
train,52,1257,1287168,21497,4127424,5414592
train,53,1076,1101824,18767,3603264,4705088
train,54,1199,1227776,20498,3935616,5163392
train,55,1403,1436672,24530,4709760,6146432
train,56,1276,1306624,21850,4195200,5501824
train,57,1518,1554432,27441,5268672,6823104
train,58,1167,1195008,19997,3839424,5034432
train,59,1243,1272832,21245,4079040,5351872
train,60,951,973824,15736,3021312,3995136
train,61,1150,1177600,19745,3791040,4968640
train,62,1170,1198080,20042,3848064,5046144
train,63,1065,1090560,18637,3578304,4668864
train,64,1336,1368064,23046,4424832,5792896
train,65,1311,1342464,22532,4326144,5668608
train,66,1030,1054720,18254,3504768,4559488
train,67,1432,1466368,25220,4842240,6308608
train,68,1174,1202176,20103,3859776,5061952
train,69,1072,1097728,18719,3594048,4691776
train,70,1010,1034240,17784,3414528,4448768
train,71,1116,1142784,19272,3700224,4843008
train,72,1169,1197056,20027,3845184,5042240
train,73,1143,1170432,19644,3771648,4942080
train,74,1032,1056768,18275,3508800,4565568
train,75,1090,1116160,18937,3635904,4752064
train,76,1172,1200128,20073,3854016,5054144
train,77,1311,1342464,22532,4326144,5668608
train,78,1051,1076224,18479,3547968,4624192
train,79,1018,1042432,18102,3475584,4518016
train,80,1360,1392640,23559,4523328,5915968
train,81,1272,1302528,21774,4180608,5483136
train,82,980,1003520,16710,3208320,4211840
train,83,1252,1282048,21407,4110144,5392192
train,84,1184,1212416,20258,3889536,5101952
train,85,1177,1205248,20149,3868608,5073856
train,86,1215,1244160,20762,3986304,5230464
train,87,992,1015808,17260,3313920,4329728
train,88,1107,1133568,19153,3677376,4810944
train,89,1171,1199104,20057,3850944,5050048
train,90,1105,1131520,19127,3672384,4803904
train,91,988,1011712,16984,3260928,4272640
train,92,1050,1075200,18468,3545856,4621056
train,93,1096,1122304,19012,3650304,4772608
train,94,1001,1025024,17434,3347328,4372352
train,95,1065,1090560,18637,3578304,4668864
train,96,1227,1256448,20965,4025280,5281728
train,97,1285,1315840,22021,4228032,5543872
train,98,1034,1058816,18296,3512832,4571648
train,99,1452,1486848,25714,4937088,6423936
train,100,1125,1152000,19393,3723456,4875456
train,101,1032,1056768,18275,3508800,4565568
train,102,1471,1506304,26196,5029632,6535936
train,103,1060,1085440,18580,3567360,4652800
train,104,1143,1170432,19644,3771648,4942080
train,105,1333,1364992,22983,4412736,5777728
train,106,1077,1102848,18779,3605568,4708416
train,107,1192,1220608,20385,3913920,5134528
train,108,1104,1130496,19114,3669888,4800384
train,109,1367,1399808,23713,4552896,5952704
train,110,1351,1383424,23364,4485888,5869312
train,111,977,1000448,16608,3188736,4189184
train,112,1151,1178624,19760,3793920,4972544
train,113,1383,1416192,24070,4621440,6037632
train,114,1000,1024000,17434,3347328,4371328
train,115,1254,1284096,21442,4116864,5400960
train,116,1099,1125376,19050,3657600,4782976
train,117,1194,1222656,20417,3920064,5142720
train,118,1186,1214464,20290,3895680,5110144
train,119,1314,1345536,22593,4337856,5683392
train,120,1128,1155072,19434,3731328,4886400
train,121,1275,1305600,21831,4191552,5497152
train,122,1159,1186816,19877,3816384,5003200
train,123,1158,1185792,19862,3813504,4999296
train,124,1199,1227776,20498,3935616,5163392
train,125,1232,1261568,21052,4041984,5303552
train,126,1047,1072128,18435,3539520,4611648
train,127,1175,1203200,20119,3862848,5066048
train,128,1231,1260544,21035,4038720,5299264
train,129,1063,1088512,18614,3573888,4662400
train,130,1414,1447936,24788,4759296,6207232
train,131,1332,1363968,22962,4408704,5772672
train,132,1011,1035264,17819,3421248,4456512
train,133,1080,1105920,18815,3612480,4718400
train,134,1176,1204224,20134,3865728,5069952
train,135,1337,1369088,23067,4428864,5797952
train,136,1221,1250304,20863,4005696,5256000
train,137,1424,1458176,25027,4805184,6263360
train,138,1579,1616896,29172,5601024,7217920
train,139,1132,1159168,19489,3741888,4901056
train,140,1212,1241088,20712,3976704,5217792
train,141,1154,1181696,19803,3802176,4983872
train,142,965,988160,16202,3110784,4098944
train,143,1264,1294336,21625,4152000,5446336
train,144,1304,1335296,22392,4299264,5634560
train,145,1162,1189888,19922,3825024,5014912
train,146,1274,1304576,21812,4187904,5492480
train,147,1183,1211392,20243,3886656,5098048
train,148,1220,1249280,20846,4002432,5251712
train,149,1004,1028096,17538,3367296,4395392
train,150,2072,2121728,39828,7646976,9768704
train,151,1326,1357824,22838,4384896,5742720
train,152,1235,1264640,21104,4051968,5316608
train,153,1633,1672192,30812,5915904,7588096
train,154,1024,1048576,18193,3493056,4541632
train,155,1067,1092608,18661,3582912,4675520
train,156,2140,2191360,41342,7937664,10129024
train,157,1216,1245184,20778,3989376,5234560
train,158,1108,1134592,19166,3679872,4814464
train,159,1433,1467392,25245,4847040,6314432
train,160,1134,1161216,19517,3747264,4908480
train,161,1164,1191936,19952,3830784,5022720
train,162,1054,1079296,18512,3554304,4633600
train,163,1321,1352704,22735,4365120,5717824
train,164,970,993280,16371,3143232,4136512
train,165,1032,1056768,18275,3508800,4565568
train,166,1426,1460224,25075,4814400,6274624
train,167,2002,2050048,38437,7379904,9429952
train,168,1016,1040384,18066,3468672,4509056
train,169,1363,1395712,23625,4536000,5931712
train,170,1413,1446912,24765,4754880,6201792
train,171,1240,1269760,21192,4068864,5338624
train,172,1041,1065984,18370,3527040,4593024
train,173,1279,1309696,21906,4205952,5515648
train,174,1204,1232896,20579,3951168,5184064
train,175,1217,1246208,20795,3992640,5238848
train,176,1139,1166336,19588,3760896,4927232
train,177,1172,1200128,20073,3854016,5054144
train,178,1302,1333248,22353,4291776,5625024
train,179,1075,1100800,18755,3600960,4701760
train,180,1063,1088512,18614,3573888,4662400
train,181,1166,1193984,19982,3836544,5030528
train,182,1153,1180672,19789,3799488,4980160
train,183,1086,1112064,18888,3626496,4738560
train,184,1016,1040384,17960,3448320,4488704
train,185,1352,1384448,23386,4490112,5874560
train,186,1046,1071104,18424,3537408,4608512
train,187,1401,1434624,24483,4700736,6135360
train,188,1422,1456128,24979,4795968,6252096
train,189,1219,1248256,20829,3999168,5247424
train,190,993,1016832,17156,3293952,4310784
train,191,1132,1159168,19489,3741888,4901056
train,192,1063,1088512,18614,3573888,4662400
train,193,1059,1084416,18569,3565248,4649664
train,194,1283,1313792,21983,4220736,5534528
train,195,1087,1113088,18900,3628800,4741888
train,196,1312,1343488,22552,4329984,5673472
train,197,1316,1347584,22633,4345536,5693120
train,198,1256,1286144,21479,4123968,5410112
train,199,1035,1059840,18306,3514752,4574592
train,200,1116,1142784,19272,3700224,4843008
train,201,1295,1326080,22215,4265280,5591360
train,202,1110,1136640,19192,3684864,4821504
train,203,1175,1203200,20119,3862848,5066048
train,204,1341,1373184,23151,4444992,5818176
train,205,1255,1285120,21460,4120320,5405440
train,206,1180,1208320,20196,3877632,5085952
train,207,1330,1361920,22921,4400832,5762752
train,208,1042,1067008,18381,3529152,4596160
train,209,1143,1170432,19644,3771648,4942080
train,210,1150,1177600,19745,3791040,4968640
train,211,1356,1388544,23472,4506624,5895168
train,212,1128,1155072,19434,3731328,4886400
train,213,1111,1137664,19206,3687552,4825216
train,214,1160,1187840,19892,3819264,5007104
train,215,1064,1089536,18626,3576192,4665728
train,216,1037,1061888,18328,3518976,4580864
train,217,1154,1181696,19803,3802176,4983872
train,218,1111,1137664,19206,3687552,4825216
train,219,1288,1318912,22079,4239168,5558080
train,220,1106,1132544,19140,3674880,4807424
train,221,1137,1164288,19559,3755328,4919616
train,222,1220,1249280,20846,4002432,5251712
train,223,1202,1230848,20547,3945024,5175872
train,224,1370,1402880,23779,4565568,5968448
train,225,1043,1068032,18392,3531264,4599296
train,226,1112,1138688,19219,3690048,4828736
train,227,1117,1143808,19285,3702720,4846528
train,228,1130,1157120,19462,3736704,4893824
train,229,1214,1243136,20745,3983040,5226176
train,230,1199,1227776,20498,3935616,5163392
train,231,1268,1298432,21699,4166208,5464640
train,232,1038,1062912,18338,3520896,4583808
train,233,1862,1906688,36167,6944064,8850752
train,234,1159,1186816,19877,3816384,5003200
train,235,1161,1188864,19907,3822144,5011008
train,236,1084,1110016,18863,3621696,4731712
train,237,1199,1227776,20498,3935616,5163392
train,238,1282,1312768,21964,4217088,5529856
train,239,1182,1210368,20227,3883584,5093952
train,240,1050,1075200,18468,3545856,4621056
train,241,1253,1283072,21424,4113408,5396480
train,242,1005,1029120,17643,3387456,4416576
train,243,1788,1830912,35243,6766656,8597568
train,244,1094,1120256,18987,3645504,4765760
train,245,1288,1318912,22079,4239168,5558080
train,246,1318,1349632,22674,4353408,5703040
train,247,1540,1576960,28050,5385600,6962560
train,248,1078,1103872,18790,3607680,4711552
train,249,1178,1206272,20165,3871680,5077952
train,250,1029,1053696,18244,3502848,4556544
train,251,1145,1172480,19673,3777216,4949696
train,252,1139,1166336,19588,3760896,4927232
train,253,1158,1185792,19862,3813504,4999296
train,254,1175,1203200,20119,3862848,5066048
train,255,1079,1104896,18803,3610176,4715072
train,256,1300,1331200,22313,4284096,5615296
train,257,1072,1097728,18719,3594048,4691776
train,258,1237,1266688,21139,4058688,5325376
train,259,984,1007616,16881,3241152,4248768
train,260,1117,1143808,19285,3702720,4846528
train,261,1333,1364992,22983,4412736,5777728
train,262,1025,1049600,18203,3494976,4544576
train,263,1304,1335296,22392,4299264,5634560
train,264,1321,1352704,22735,4365120,5717824
train,265,1151,1178624,19760,3793920,4972544
train,266,1171,1199104,20057,3850944,5050048
train,267,1219,1248256,20829,3999168,5247424
train,268,1041,1065984,18370,3527040,4593024
train,269,1320,1351680,22715,4361280,5712960
train,270,1214,1243136,20745,3983040,5226176
train,271,1139,1166336,19588,3760896,4927232
train,272,1193,1221632,20401,3916992,5138624
train,273,1085,1111040,18875,3624000,4735040
train,274,1158,1185792,19862,3813504,4999296
train,275,1031,1055744,18265,3506880,4562624
train,276,1065,1090560,18637,3578304,4668864
train,277,1094,1120256,18987,3645504,4765760
train,278,1090,1116160,18937,3635904,4752064
train,279,1374,1406976,23868,4582656,5989632
train,280,1140,1167360,19602,3763584,4930944
train,281,1151,1178624,19760,3793920,4972544
train,282,1062,1087488,18603,3571776,4659264
train,283,1107,1133568,19153,3677376,4810944
train,284,1283,1313792,21983,4220736,5534528
train,285,1085,1111040,18875,3624000,4735040
train,286,1112,1138688,19219,3690048,4828736
train,287,1032,1056768,18275,3508800,4565568
train,288,1042,1067008,18381,3529152,4596160
train,289,1058,1083392,18557,3562944,4646336
train,290,1148,1175552,19716,3785472,4961024
train,291,1156,1183744,19833,3807936,4991680
train,292,1019,1043456,18173,3489216,4532672
train,293,1057,1082368,18546,3560832,4643200
train,294,1357,1389568,23494,4510848,5900416
train,295,1292,1323008,22156,4253952,5576960
train,296,1115,1141760,19258,3697536,4839296
train,297,1102,1128448,19089,3665088,4793536
train,298,974,997376,16506,3169152,4166528
train,299,986,1009664,16949,3254208,4263872
train,300,1054,1079296,18512,3554304,4633600
train,301,1147,1174528,19702,3782784,4957312
train,302,1105,1131520,19127,3672384,4803904
train,303,1197,1225728,20465,3929280,5155008
train,304,1212,1241088,20712,3976704,5217792
train,305,1229,1258496,21000,4032000,5290496
train,306,1118,1144832,19299,3705408,4850240
train,307,1260,1290240,21552,4137984,5428224
train,308,1159,1186816,19877,3816384,5003200
train,309,1259,1289216,21533,4134336,5423552
train,310,1012,1036288,17819,3421248,4457536
train,311,1160,1187840,19892,3819264,5007104
train,312,985,1008640,16881,3241152,4249792
train,313,1085,1111040,18875,3624000,4735040
train,314,1274,1304576,21812,4187904,5492480
train,315,1118,1144832,19299,3705408,4850240
train,316,1113,1139712,19232,3692544,4832256
train,317,1291,1321984,22137,4250304,5572288
train,318,1114,1140736,19245,3695040,4835776
train,319,1132,1159168,19489,3741888,4901056
train,320,1198,1226752,20482,3932544,5159296
train,321,1004,1028096,17538,3367296,4395392
train,322,1257,1287168,21497,4127424,5414592
train,323,1049,1074176,18457,3543744,4617920
train,324,1263,1293312,21607,4148544,5441856
train,325,1158,1185792,19862,3813504,4999296
train,326,1283,1313792,21983,4220736,5534528
train,327,1172,1200128,20073,3854016,5054144
train,328,1213,1242112,20728,3979776,5221888
train,329,1059,1084416,18569,3565248,4649664
train,330,1276,1306624,21850,4195200,5501824
train,331,1659,1698816,31638,6074496,7773312
train,332,1413,1446912,24765,4754880,6201792
train,333,1349,1381376,23322,4477824,5859200
train,334,1264,1294336,21625,4152000,5446336
train,335,1293,1324032,22176,4257792,5581824
train,336,1047,1072128,18435,3539520,4611648
train,337,1086,1112064,18888,3626496,4738560
train,338,1216,1245184,20778,3989376,5234560
train,339,1218,1247232,20812,3995904,5243136
train,340,1335,1367040,23025,4420800,5787840
train,341,1125,1152000,19393,3723456,4875456
train,342,1040,1064960,18359,3524928,4589888
train,343,1118,1144832,19299,3705408,4850240
train,344,1225,1254400,20931,4018752,5273152
train,345,1376,1409024,23913,4591296,6000320
train,346,1032,1056768,18275,3508800,4565568
train,347,1082,1107968,18839,3617088,4725056
train,348,1316,1347584,22633,4345536,5693120
train,349,1105,1131520,19127,3672384,4803904
train,350,1224,1253376,20914,4015488,5268864
train,351,1042,1067008,18381,3529152,4596160
train,352,2174,2226176,42160,8094720,10320896
train,353,1147,1174528,19702,3782784,4957312
train,354,998,1021952,17329,3327168,4349120
train,355,1331,1362944,22941,4404672,5767616
train,356,1160,1187840,19892,3819264,5007104
train,357,1007,1031168,17678,3394176,4425344
train,358,1201,1229824,20530,3941760,5171584
train,359,1235,1264640,21104,4051968,5316608
train,360,1268,1298432,21699,4166208,5464640
train,361,1073,1098752,18731,3596352,4695104
train,362,1261,1291264,21570,4141440,5432704
train,363,1337,1369088,23067,4428864,5797952
train,364,1440,1474560,25416,4879872,6354432
train,365,1293,1324032,22176,4257792,5581824
train,366,1061,1086464,18591,3569472,4655936
train,367,1128,1155072,19434,3731328,4886400
train,368,1118,1144832,19299,3705408,4850240
train,369,1026,1050624,18213,3496896,4547520
train,370,1630,1669120,30718,5897856,7566976
train,371,1002,1026048,17503,3360576,4386624
train,372,1280,1310720,21925,4209600,5520320
train,373,1125,1152000,19393,3723456,4875456
train,374,1081,1106944,18827,3614784,4721728
train,375,1149,1176576,19731,3788352,4964928
train,376,971,994304,16404,3149568,4143872
train,377,1277,1307648,21868,4198656,5506304
train,378,1276,1306624,21850,4195200,5501824
train,379,1261,1291264,21570,4141440,5432704
train,380,1427,1461248,25099,4819008,6280256
train,381,1043,1068032,18392,3531264,4599296
train,382,1646,1685504,31222,5994624,7680128
train,383,1120,1146880,19325,3710400,4857280
train,384,1065,1090560,18637,3578304,4668864
train,385,1300,1331200,22313,4284096,5615296
train,386,1141,1168384,19616,3766272,4934656
train,387,1486,1521664,26585,5104320,6625984
train,388,1200,1228800,20514,3938688,5167488
train,389,1293,1324032,22176,4257792,5581824
train,390,1048,1073152,18446,3541632,4614784
train,391,1043,1068032,18392,3531264,4599296
train,392,1070,1095680,18696,3589632,4685312
train,393,1176,1204224,20134,3865728,5069952
train,394,1132,1159168,19489,3741888,4901056
train,395,1023,1047552,18183,3491136,4538688
train,396,1053,1078272,18501,3552192,4630464
train,397,1064,1089536,18626,3576192,4665728
train,398,1117,1143808,19285,3702720,4846528
train,399,1305,1336320,22412,4303104,5639424
train,400,1143,1170432,19644,3771648,4942080
train,401,1172,1200128,20073,3854016,5054144
train,402,1003,1027072,17503,3360576,4387648
train,403,1176,1204224,20134,3865728,5069952
train,404,932,954368,15113,2901696,3856064
train,405,956,978944,15901,3052992,4031936
train,406,1139,1166336,19588,3760896,4927232
train,407,1130,1157120,19462,3736704,4893824
train,408,1069,1094656,18684,3587328,4681984
train,409,1204,1232896,20579,3951168,5184064
train,410,1236,1265664,21122,4055424,5321088
train,411,1385,1418240,24116,4630272,6048512
train,412,1303,1334272,22372,4295424,5629696
train,413,1043,1068032,18392,3531264,4599296
train,414,1289,1319936,22098,4242816,5562752
train,415,1111,1137664,19206,3687552,4825216
train,416,1168,1196032,20012,3842304,5038336
train,417,1194,1222656,20417,3920064,5142720
train,418,1276,1306624,21850,4195200,5501824
train,419,1179,1207296,20180,3874560,5081856
train,420,2116,2166784,40790,7831680,9998464
train,421,1027,1051648,18223,3498816,4550464
train,422,983,1006592,16847,3234624,4241216
train,423,1392,1425408,24276,4660992,6086400
train,424,1119,1145856,19312,3707904,4853760
train,425,1236,1265664,21122,4055424,5321088
train,426,1113,1139712,19232,3692544,4832256
train,427,1312,1343488,22552,4329984,5673472
train,428,1153,1180672,19789,3799488,4980160
train,429,1037,1061888,18328,3518976,4580864
train,430,1115,1141760,19258,3697536,4839296
train,431,1277,1307648,21868,4198656,5506304
train,432,1045,1070080,18413,3535296,4605376
train,433,1097,1123328,19025,3652800,4776128
train,434,1319,1350656,22694,4357248,5707904
train,435,1130,1157120,19462,3736704,4893824
train,436,1173,1201152,20088,3856896,5058048
train,437,1175,1203200,20119,3862848,5066048
train,438,1586,1624064,29379,5640768,7264832
train,439,1081,1106944,18827,3614784,4721728
train,440,1218,1247232,20812,3995904,5243136
train,441,1082,1107968,18839,3617088,4725056
train,442,1176,1204224,20134,3865728,5069952
train,443,1224,1253376,20914,4015488,5268864
train,444,1127,1154048,19421,3728832,4882880
train,445,1033,1057792,18285,3510720,4568512
train,446,1420,1454080,24931,4786752,6240832
train,447,1041,1065984,18370,3527040,4593024
train,448,1125,1152000,19393,3723456,4875456
train,449,1164,1191936,19952,3830784,5022720
train,450,1170,1198080,20042,3848064,5046144
train,451,1426,1460224,25075,4814400,6274624
train,452,1216,1245184,20778,3989376,5234560
train,453,1283,1313792,21983,4220736,5534528
train,454,1107,1133568,19153,3677376,4810944
train,455,1229,1258496,21000,4032000,5290496
train,456,1100,1126400,19063,3660096,4786496
train,457,1159,1186816,19877,3816384,5003200
train,458,904,925696,14219,2730048,3655744
train,459,1209,1238016,20662,3967104,5205120
train,460,1260,1290240,21552,4137984,5428224
train,461,1313,1344512,22572,4333824,5678336
train,462,1353,1385472,23408,4494336,5879808
train,463,1065,1090560,18637,3578304,4668864
train,464,1196,1224704,20449,3926208,5150912
train,465,1151,1178624,19760,3793920,4972544
train,466,1306,1337344,22432,4306944,5644288
train,467,1087,1113088,18900,3628800,4741888
train,468,1095,1121280,19000,3648000,4769280
train,469,1183,1211392,20243,3886656,5098048
train,470,1094,1120256,18987,3645504,4765760
train,471,1083,1108992,18851,3619392,4728384
train,472,1229,1258496,21000,4032000,5290496
train,473,1001,1025024,17434,3347328,4372352
train,474,1172,1200128,20073,3854016,5054144
train,475,1014,1038336,17925,3441600,4479936
train,476,1157,1184768,19847,3810624,4995392
train,477,1195,1223680,20433,3923136,5146816
train,478,1130,1157120,19462,3736704,4893824
train,479,1280,1310720,21925,4209600,5520320
train,480,1243,1272832,21245,4079040,5351872
train,481,1254,1284096,21442,4116864,5400960
train,482,1416,1449984,24836,4768512,6218496
train,483,1340,1372160,23130,4440960,5813120
train,484,960,983040,16035,3078720,4061760
train,485,1325,1356800,22817,4380864,5737664
train,486,1069,1094656,18684,3587328,4681984
train,487,1101,1127424,19076,3662592,4790016
train,488,1193,1221632,20401,3916992,5138624
train,489,971,994304,16438,3156096,4150400
train,490,1220,1249280,20846,4002432,5251712
train,491,930,952320,15048,2889216,3841536
train,492,1460,1495040,25915,4975680,6470720
train,493,1184,1212416,20258,3889536,5101952
train,494,1206,1234944,20612,3957504,5192448
train,495,1215,1244160,20762,3986304,5230464
train,496,1250,1280000,21370,4103040,5383040
train,497,1070,1095680,18696,3589632,4685312
train,498,1044,1069056,18402,3533184,4602240
train,499,1243,1272832,21245,4079040,5351872
validation,0,1273,1303552,21793,4184256,5487808
validation,1,1041,1065984,18370,3527040,4593024
validation,2,993,1016832,17191,3300672,4317504
validation,3,1268,1298432,21699,4166208,5464640
validation,4,1062,1087488,18603,3571776,4659264
validation,5,1168,1196032,20012,3842304,5038336
validation,6,1263,1293312,21607,4148544,5441856
validation,7,1178,1206272,20165,3871680,5077952
validation,8,1088,1114112,18912,3631104,4745216
validation,9,1086,1112064,18888,3626496,4738560
validation,10,1165,1192960,19967,3833664,5026624
validation,11,1188,1216512,20322,3901824,5118336
validation,12,1054,1079296,18512,3554304,4633600
validation,13,994,1017856,17225,3307200,4325056
validation,14,1405,1438720,24576,4718592,6157312
validation,15,1298,1329152,22274,4276608,5605760
validation,16,1222,1251328,20880,4008960,5260288
validation,17,1002,1026048,17468,3353856,4379904
validation,18,973,996352,16472,3162624,4158976
validation,19,1146,1173504,19687,3779904,4953408
validation,20,1119,1145856,19312,3707904,4853760
validation,21,1064,1089536,18626,3576192,4665728
validation,22,1118,1144832,19299,3705408,4850240
validation,23,1208,1236992,20645,3963840,5200832
validation,24,1060,1085440,18580,3567360,4652800
validation,25,1229,1258496,21000,4032000,5290496
validation,26,1252,1282048,21406,4109952,5392000
validation,27,1305,1336320,22412,4303104,5639424
validation,28,1355,1387520,23451,4502592,5890112
validation,29,1375,1408000,23891,4587072,5995072
validation,30,1275,1305600,21831,4191552,5497152
validation,31,1183,1211392,20243,3886656,5098048
validation,32,1053,1078272,18501,3552192,4630464
validation,33,1122,1148928,19352,3715584,4864512
validation,34,992,1015808,17122,3287424,4303232
validation,35,1286,1316864,22040,4231680,5548544
validation,36,916,937984,14599,2803008,3740992
validation,37,1140,1167360,19602,3763584,4930944
validation,38,1001,1025024,17434,3347328,4372352
validation,39,1234,1263616,21087,4048704,5312320
validation,40,1221,1250304,20863,4005696,5256000
validation,41,1299,1330176,22293,4280256,5610432
validation,42,1059,1084416,18569,3565248,4649664
validation,43,1141,1168384,19616,3766272,4934656
validation,44,995,1018880,17225,3307200,4326080
validation,45,962,985088,16102,3091584,4076672
validation,46,1210,1239040,20678,3970176,5209216
validation,47,1181,1209344,20212,3880704,5090048
validation,48,999,1022976,17364,3333888,4356864
validation,49,988,1011712,16984,3260928,4272640
validation,50,1362,1394688,23603,4531776,5926464
validation,51,1168,1196032,20012,3842304,5038336
validation,52,1353,1385472,23408,4494336,5879808
validation,53,1062,1087488,18603,3571776,4659264
validation,54,1059,1084416,18569,3565248,4649664
validation,55,1189,1217536,20337,3904704,5122240
validation,56,1133,1160192,19503,3744576,4904768
validation,57,1093,1119232,18974,3643008,4762240
validation,58,1069,1094656,18684,3587328,4681984
validation,59,1244,1273856,21263,4082496,5356352
validation,60,1130,1157120,19462,3736704,4893824
validation,61,1026,1050624,18213,3496896,4547520
validation,62,1288,1318912,22079,4239168,5558080
validation,63,1199,1227776,20498,3935616,5163392
validation,64,1347,1379328,23279,4469568,5848896
validation,65,1241,1270784,21210,4072320,5343104
validation,66,1251,1281024,21388,4106496,5387520
validation,67,1139,1166336,19588,3760896,4927232
validation,68,1306,1337344,22432,4306944,5644288
validation,69,1151,1178624,19760,3793920,4972544
validation,70,1262,1292288,21588,4144896,5437184
validation,71,992,1015808,17122,3287424,4303232
validation,72,934,956416,15178,2914176,3870592
validation,73,1287,1317888,22059,4235328,5553216
validation,74,1021,1045504,18173,3489216,4534720
validation,75,1327,1358848,22858,4388736,5747584
validation,76,1268,1298432,21699,4166208,5464640
validation,77,1077,1102848,18779,3605568,4708416
validation,78,1138,1165312,19573,3758016,4923328
validation,79,1116,1142784,19272,3700224,4843008
validation,80,1077,1102848,18779,3605568,4708416
validation,81,1177,1205248,20149,3868608,5073856
validation,82,1270,1300480,21737,4173504,5473984
validation,83,1033,1057792,18285,3510720,4568512
validation,84,1001,1025024,17434,3347328,4372352
validation,85,1054,1079296,18512,3554304,4633600
validation,86,1268,1298432,21699,4166208,5464640
validation,87,1075,1100800,18755,3600960,4701760
validation,88,1026,1050624,18213,3496896,4547520
validation,89,1185,1213440,20274,3892608,5106048
validation,90,1321,1352704,22735,4365120,5717824
validation,91,1227,1256448,20965,4025280,5281728
validation,92,1170,1198080,20042,3848064,5046144
validation,93,1095,1121280,19000,3648000,4769280
validation,94,1302,1333248,22353,4291776,5625024
validation,95,1047,1072128,18435,3539520,4611648
validation,96,1298,1329152,22274,4276608,5605760
validation,97,1040,1064960,18359,3524928,4589888
validation,98,1143,1170432,19644,3771648,4942080
validation,99,1034,1058816,18296,3512832,4571648
validation,100,1230,1259520,21017,4035264,5294784
validation,101,1212,1241088,20712,3976704,5217792
validation,102,1072,1097728,18719,3594048,4691776
validation,103,1010,1034240,17749,3407808,4442048
validation,104,1225,1254400,20931,4018752,5273152
validation,105,1116,1142784,19272,3700224,4843008
validation,106,1016,1040384,17960,3448320,4488704
validation,107,1277,1307648,21868,4198656,5506304
validation,108,1171,1199104,20057,3850944,5050048
validation,109,1026,1050624,18213,3496896,4547520
validation,110,967,990208,16269,3123648,4113856
validation,111,957,979968,15968,3065856,4045824
validation,112,1292,1323008,22156,4253952,5576960
validation,113,975,998400,16540,3175680,4174080
validation,114,1238,1267712,21157,4062144,5329856
validation,115,1227,1256448,20965,4025280,5281728
validation,116,1111,1137664,19206,3687552,4825216
validation,117,1230,1259520,21017,4035264,5294784
validation,118,956,978944,15901,3052992,4031936
validation,119,1144,1171456,19659,3774528,4945984
validation,120,1043,1068032,18392,3531264,4599296
validation,121,1308,1339392,22472,4314624,5654016
validation,122,1212,1241088,20712,3976704,5217792
validation,123,1159,1186816,19877,3816384,5003200
validation,124,1259,1289216,21533,4134336,5423552
validation,125,1075,1100800,18755,3600960,4701760
validation,126,1215,1244160,20762,3986304,5230464
validation,127,1342,1374208,23172,4449024,5823232
validation,128,1040,1064960,18359,3524928,4589888
validation,129,1235,1264640,21104,4051968,5316608
validation,130,990,1013760,17053,3274176,4287936
validation,131,1192,1220608,20385,3913920,5134528
validation,132,1069,1094656,18684,3587328,4681984
validation,133,1256,1286144,21479,4123968,5410112
validation,134,1065,1090560,18637,3578304,4668864
validation,135,1307,1338368,22452,4310784,5649152
validation,136,1053,1078272,18501,3552192,4630464
validation,137,1041,1065984,18370,3527040,4593024
validation,138,1215,1244160,20762,3986304,5230464
validation,139,1250,1280000,21370,4103040,5383040
validation,140,1294,1325056,22195,4261440,5586496
validation,141,1123,1149952,19366,3718272,4868224
validation,142,1194,1222656,20417,3920064,5142720
validation,143,1021,1045504,18173,3489216,4534720
validation,144,1324,1355776,22797,4377024,5732800
validation,145,1157,1184768,19847,3810624,4995392
validation,146,1261,1291264,21570,4141440,5432704
validation,147,1092,1118208,18962,3640704,4758912
validation,148,1098,1124352,19038,3655296,4779648
validation,149,1060,1085440,18580,3567360,4652800
validation,150,1080,1105920,18815,3612480,4718400
validation,151,1012,1036288,17819,3421248,4457536
validation,152,1519,1555456,27468,5273856,6829312
validation,153,1155,1182720,19818,3805056,4987776
validation,154,1192,1220608,20385,3913920,5134528
validation,155,962,985088,16102,3091584,4076672
validation,156,1144,1171456,19659,3774528,4945984
validation,157,1289,1319936,22098,4242816,5562752
validation,158,1110,1136640,19192,3684864,4821504
validation,159,997,1020928,17295,3320640,4341568
validation,160,1028,1052672,18234,3500928,4553600
validation,161,1045,1070080,18413,3535296,4605376
validation,162,1059,1084416,18569,3565248,4649664
validation,163,1074,1099776,18743,3598656,4698432
validation,164,1105,1131520,19127,3672384,4803904
test,0,1196,1224704,20449,3926208,5150912
test,1,1105,1131520,19127,3672384,4803904
test,2,1231,1260544,21035,4038720,5299264
test,3,1058,1083392,18557,3562944,4646336
test,4,1190,1218560,20353,3907776,5126336
test,5,1343,1375232,23194,4453248,5828480
test,6,1184,1212416,20258,3889536,5101952
test,7,1027,1051648,18223,3498816,4550464
test,8,1215,1244160,20762,3986304,5230464
test,9,1091,1117184,18950,3638400,4755584
test,10,1349,1381376,23322,4477824,5859200
test,11,1148,1175552,19716,3785472,4961024
test,12,1305,1336320,22412,4303104,5639424
test,13,1245,1274880,21281,4085952,5360832
test,14,1268,1298432,21699,4166208,5464640
test,15,1364,1396736,23647,4540224,5936960
test,16,1085,1111040,18875,3624000,4735040
test,17,1207,1235968,20629,3960768,5196736
test,18,1144,1171456,19659,3774528,4945984
test,19,1026,1050624,18213,3496896,4547520
test,20,1408,1441792,24647,4732224,6174016
test,21,997,1020928,17329,3327168,4348096
test,22,1317,1348608,22653,4349376,5697984
test,23,1145,1172480,19673,3777216,4949696
test,24,1232,1261568,21052,4041984,5303552
test,25,1043,1068032,18392,3531264,4599296
test,26,1190,1218560,20353,3907776,5126336
test,27,1355,1387520,23451,4502592,5890112
test,28,1169,1197056,20027,3845184,5042240
test,29,1188,1216512,20322,3901824,5118336
test,30,1088,1114112,18912,3631104,4745216
test,31,1217,1246208,20795,3992640,5238848
test,32,2875,2944000,58109,11156928,14100928
test,33,962,985088,16102,3091584,4076672
test,34,1132,1159168,19489,3741888,4901056
test,35,1111,1137664,19206,3687552,4825216
test,36,1196,1224704,20449,3926208,5150912
test,37,1128,1155072,19434,3731328,4886400
test,38,987,1010688,16984,3260928,4271616
test,39,1016,1040384,17995,3455040,4495424
test,40,923,945152,14855,2852160,3797312
test,41,1074,1099776,18743,3598656,4698432
test,42,1117,1143808,19285,3702720,4846528
test,43,1523,1559552,27578,5294976,6854528
test,44,1085,1111040,18875,3624000,4735040
test,45,1205,1233920,20596,3954432,5188352
test,46,1403,1436672,24530,4709760,6146432
test,47,1037,1061888,18328,3518976,4580864
test,48,1300,1331200,22313,4284096,5615296
test,49,1134,1161216,19517,3747264,4908480
test,50,1026,1050624,18213,3496896,4547520
test,51,1049,1074176,18457,3543744,4617920
test,52,1077,1102848,18779,3605568,4708416
test,53,1179,1207296,20180,3874560,5081856
test,54,1025,1049600,18203,3494976,4544576
test,55,1539,1575936,28022,5380224,6956160
test,56,1147,1174528,19702,3782784,4957312
test,57,1321,1352704,22735,4365120,5717824
test,58,1199,1227776,20498,3935616,5163392
test,59,1127,1154048,19421,3728832,4882880
test,60,1195,1223680,20433,3923136,5146816
test,61,1339,1371136,23109,4436928,5808064
test,62,1311,1342464,22532,4326144,5668608
test,63,1204,1232896,20579,3951168,5184064
test,64,1318,1349632,22674,4353408,5703040
test,65,1194,1222656,20417,3920064,5142720
test,66,1004,1028096,17573,3374016,4402112
test,67,913,934912,14503,2784576,3719488
test,68,1145,1172480,19673,3777216,4949696
test,69,1231,1260544,21035,4038720,5299264
test,70,1023,1047552,18183,3491136,4538688
test,71,1330,1361920,22921,4400832,5762752
test,72,1070,1095680,18696,3589632,4685312
test,73,1120,1146880,19325,3710400,4857280
test,74,959,982016,16001,3072192,4054208
test,75,1296,1327104,22234,4268928,5596032
test,76,1105,1131520,19127,3672384,4803904
test,77,1160,1187840,19892,3819264,5007104
test,78,1039,1063936,18349,3523008,4586944
test,79,1109,1135616,19179,3682368,4817984
test,80,1279,1309696,21906,4205952,5515648
test,81,1213,1242112,20728,3979776,5221888
test,82,1106,1132544,19140,3674880,4807424
test,83,1133,1160192,19503,3744576,4904768
test,84,1165,1192960,19967,3833664,5026624
test,85,1369,1401856,23757,4561344,5963200
test,86,1066,1091584,18649,3580608,4672192
test,87,1058,1083392,18557,3562944,4646336
test,88,1163,1190912,19937,3827904,5018816
test,89,1139,1166336,19588,3760896,4927232
test,90,1077,1102848,18779,3605568,4708416
test,91,1132,1159168,19489,3741888,4901056
test,92,1011,1035264,17784,3414528,4449792
test,93,1319,1350656,22694,4357248,5707904
test,94,1013,1037312,17854,3427968,4465280
test,95,1608,1646592,30040,5767680,7414272
test,96,1337,1369088,23067,4428864,5797952
test,97,933,955392,15146,2908032,3863424
test,98,1195,1223680,20433,3923136,5146816
test,99,1318,1349632,22674,4353408,5703040
test,100,1166,1193984,19982,3836544,5030528
test,101,1075,1100800,18755,3600960,4701760
test,102,1047,1072128,18435,3539520,4611648
test,103,1240,1269760,21192,4068864,5338624
test,104,956,978944,15901,3052992,4031936
test,105,1198,1226752,20482,3932544,5159296
test,106,1047,1072128,18435,3539520,4611648
test,107,1086,1112064,18888,3626496,4738560
test,108,1333,1364992,22983,4412736,5777728
test,109,958,980992,15968,3065856,4046848
test,110,1033,1057792,18285,3510720,4568512
test,111,1146,1173504,19687,3779904,4953408
test,112,1356,1388544,23473,4506816,5895360
test,113,1158,1185792,19862,3813504,4999296
test,114,1012,1036288,17819,3421248,4457536
test,115,1067,1092608,18661,3582912,4675520
test,116,954,976896,15868,3046656,4023552
test,117,951,973824,15736,3021312,3995136
test,118,1045,1070080,18413,3535296,4605376
test,119,1218,1247232,20812,3995904,5243136
test,120,1176,1204224,20134,3865728,5069952
test,121,1128,1155072,19434,3731328,4886400
test,122,1113,1139712,19232,3692544,4832256
test,123,1010,1034240,17784,3414528,4448768
test,124,1348,1380352,23300,4473600,5853952
test,125,1290,1320960,22117,4246464,5567424
test,126,1015,1039360,17925,3441600,4480960
test,127,1223,1252352,20897,4012224,5264576
test,128,1223,1252352,20897,4012224,5264576
test,129,1299,1330176,22293,4280256,5610432
test,130,1115,1141760,19258,3697536,4839296
test,131,1119,1145856,19312,3707904,4853760
test,132,1115,1141760,19258,3697536,4839296
test,133,1231,1260544,21035,4038720,5299264
test,134,1298,1329152,22274,4276608,5605760
test,135,1185,1213440,20274,3892608,5106048
test,136,1142,1169408,19630,3768960,4938368
test,137,1267,1297408,21681,4162752,5460160
test,138,1201,1229824,20530,3941760,5171584
test,139,1132,1159168,19489,3741888,4901056
test,140,1235,1264640,21104,4051968,5316608
test,141,1033,1057792,18285,3510720,4568512
test,142,994,1017856,17191,3300672,4318528
test,143,1021,1045504,18137,3482304,4527808
test,144,1033,1057792,18285,3510720,4568512
test,145,1176,1204224,20134,3865728,5069952
test,146,1058,1083392,18557,3562944,4646336
test,147,1075,1100800,18755,3600960,4701760
test,148,1293,1324032,22176,4257792,5581824
test,149,996,1019904,17295,3320640,4340544
test,150,1099,1125376,19050,3657600,4782976
test,151,1308,1339392,22472,4314624,5654016
test,152,1043,1068032,18392,3531264,4599296
test,153,1340,1372160,23130,4440960,5813120
test,154,1289,1319936,22098,4242816,5562752
test,155,1156,1183744,19833,3807936,4991680
test,156,1240,1269760,21192,4068864,5338624
test,157,1308,1339392,22472,4314624,5654016
test,158,1008,1032192,17678,3394176,4426368
test,159,1282,1312768,21964,4217088,5529856
test,160,1308,1339392,22472,4314624,5654016
test,161,1017,1041408,17995,3455040,4496448
test,162,1332,1363968,22962,4408704,5772672
test,163,1310,1341440,22512,4322304,5663744
test,164,1013,1037312,17854,3427968,4465280
test,165,1108,1134592,19166,3679872,4814464
test,166,1014,1038336,17925,3441600,4479936
test,167,1216,1245184,20778,3989376,5234560
test,168,1153,1180672,19789,3799488,4980160
test,169,932,954368,15113,2901696,3856064
test,170,1174,1202176,20104,3859968,5062144
test,171,1346,1378304,23257,4465344,5843648
test,172,1144,1171456,19659,3774528,4945984
test,173,1290,1320960,22117,4246464,5567424
test,174,1130,1157120,19462,3736704,4893824
test,175,1279,1309696,21906,4205952,5515648
test,176,1039,1063936,18349,3523008,4586944
test,177,1003,1027072,17503,3360576,4387648
test,178,1176,1204224,20134,3865728,5069952
test,179,1260,1290240,21552,4137984,5428224
test,180,1081,1106944,18827,3614784,4721728
test,181,1092,1118208,18962,3640704,4758912
test,182,1211,1240064,20695,3973440,5213504
test,183,1265,1295360,21644,4155648,5451008
test,184,1239,1268736,21174,4065408,5334144
test,185,994,1017856,17191,3300672,4318528
test,186,1225,1254400,20931,4018752,5273152
test,187,1012,1036288,17854,3427968,4464256
test,188,1165,1192960,19967,3833664,5026624
test,189,1154,1181696,19803,3802176,4983872
test,190,1140,1167360,19602,3763584,4930944
test,191,1163,1190912,19937,3827904,5018816
test,192,1114,1140736,19245,3695040,4835776
test,193,1161,1188864,19907,3822144,5011008
test,194,1279,1309696,21906,4205952,5515648
test,195,1101,1127424,19076,3662592,4790016
test,196,1136,1163264,19545,3752640,4915904
test,197,1309,1340416,22492,4318464,5658880
test,198,1250,1280000,21370,4103040,5383040
test,199,962,985088,16102,3091584,4076672
test,200,1248,1277952,21334,4096128,5374080
test,201,1150,1177600,19745,3791040,4968640
test,202,1117,1143808,19285,3702720,4846528
test,203,1051,1076224,18479,3547968,4624192
test,204,973,996352,16506,3169152,4165504
test,205,1183,1211392,20243,3886656,5098048
test,206,1194,1222656,20417,3920064,5142720
test,207,1192,1220608,20385,3913920,5134528
test,208,1007,1031168,17643,3387456,4418624
test,209,1113,1139712,19232,3692544,4832256
test,210,1183,1211392,20243,3886656,5098048
test,211,911,932864,14440,2772480,3705344
test,212,1221,1250304,20863,4005696,5256000
test,213,1276,1306624,21850,4195200,5501824
test,214,1201,1229824,20530,3941760,5171584
test,215,966,989184,16236,3117312,4106496
test,216,1262,1292288,21588,4144896,5437184
test,217,1064,1089536,18626,3576192,4665728
test,218,1218,1247232,20812,3995904,5243136
test,219,1336,1368064,23046,4424832,5792896
test,220,1008,1032192,17713,3400896,4433088
test,221,1035,1059840,18306,3514752,4574592
test,222,927,949248,14951,2870592,3819840
test,223,1061,1086464,18591,3569472,4655936
test,224,1132,1159168,19489,3741888,4901056
test,225,1091,1117184,18950,3638400,4755584
test,226,1067,1092608,18661,3582912,4675520
test,227,1178,1206272,20165,3871680,5077952
test,228,1217,1246208,20795,3992640,5238848
test,229,1078,1103872,18790,3607680,4711552
test,230,1041,1065984,18370,3527040,4593024
test,231,1278,1308672,21887,4202304,5510976
test,232,970,993280,16371,3143232,4136512
test,233,961,984064,16068,3085056,4069120
test,234,980,1003520,16744,3214848,4218368
test,235,1085,1111040,18875,3624000,4735040
test,236,1061,1086464,18591,3569472,4655936
test,237,1320,1351680,22715,4361280,5712960
test,238,1297,1328128,22254,4272768,5600896
test,239,1246,1275904,21298,4089216,5365120
test,240,1157,1184768,19847,3810624,4995392
test,241,1195,1223680,20433,3923136,5146816
test,242,1211,1240064,20695,3973440,5213504
test,243,1141,1168384,19616,3766272,4934656
test,244,941,963584,15439,2964288,3927872
test,245,2972,3043328,60554,11626368,14669696
test,246,985,1008640,16915,3247680,4256320
test,247,1290,1320960,22117,4246464,5567424
test,248,1093,1119232,18974,3643008,4762240
test,249,1026,1050624,18214,3497088,4547712
test,250,1386,1419264,24138,4634496,6053760
test,251,2228,2281472,43541,8359872,10641344
test,252,1151,1178624,19760,3793920,4972544
test,253,1238,1267712,21157,4062144,5329856
test,254,1134,1161216,19517,3747264,4908480
test,255,1228,1257472,20983,4028736,5286208
test,256,2817,2884608,56803,10906176,13790784
test,257,1089,1115136,18925,3633600,4748736
test,258,1191,1219584,20369,3910848,5130432
test,259,1287,1317888,22059,4235328,5553216
test,260,1106,1132544,19140,3674880,4807424
test,261,1174,1202176,20103,3859776,5061952
test,262,1183,1211392,20243,3886656,5098048
test,263,1020,1044480,18137,3482304,4526784
test,264,1424,1458176,25027,4805184,6263360
test,265,1081,1106944,18827,3614784,4721728
test,266,1071,1096704,18707,3591744,4688448
test,267,1079,1104896,18803,3610176,4715072
test,268,1310,1341440,22512,4322304,5663744
test,269,1033,1057792,18285,3510720,4568512
test,270,1075,1100800,18755,3600960,4701760
test,271,1282,1312768,21964,4217088,5529856
test,272,1175,1203200,20119,3862848,5066048
test,273,1189,1217536,20337,3904704,5122240
test,274,1150,1177600,19745,3791040,4968640
test,275,1333,1364992,22983,4412736,5777728
test,276,1099,1125376,19050,3657600,4782976
test,277,981,1004544,16812,3227904,4232448
test,278,1114,1140736,19245,3695040,4835776
test,279,1092,1118208,18962,3640704,4758912
test,280,1180,1208320,20196,3877632,5085952
test,281,1148,1175552,19716,3785472,4961024
test,282,1101,1127424,19076,3662592,4790016
test,283,1035,1059840,18306,3514752,4574592
test,284,1227,1256448,20965,4025280,5281728
test,285,1076,1101824,18767,3603264,4705088
test,286,1366,1398784,23691,4548672,5947456
test,287,1144,1171456,19659,3774528,4945984
test,288,1279,1309696,21906,4205952,5515648
test,289,967,990208,16269,3123648,4113856
test,290,1215,1244160,20762,3986304,5230464
test,291,1135,1162240,19531,3749952,4912192
test,292,1183,1211392,20243,3886656,5098048
test,293,1081,1106944,18827,3614784,4721728
test,294,1291,1321984,22137,4250304,5572288
test,295,1262,1292288,21588,4144896,5437184
test,296,1487,1522688,26611,5109312,6632000
test,297,1017,1041408,17995,3455040,4496448
test,298,1228,1257472,20983,4028736,5286208
test,299,1232,1261568,21052,4041984,5303552
test,300,1052,1077248,18490,3550080,4627328
test,301,997,1020928,17364,3333888,4354816
test,302,1176,1204224,20134,3865728,5069952
test,303,1007,1031168,17643,3387456,4418624
test,304,1356,1388544,23472,4506624,5895168
test,305,1064,1089536,18626,3576192,4665728
test,306,1336,1368064,23046,4424832,5792896
test,307,1243,1272832,21245,4079040,5351872
test,308,1209,1238016,20662,3967104,5205120
test,309,1060,1085440,18580,3567360,4652800
test,310,1199,1227776,20498,3935616,5163392
test,311,1361,1393664,23581,4527552,5921216
test,312,1313,1344512,22572,4333824,5678336
test,313,1267,1297408,21681,4162752,5460160
test,314,1182,1210368,20227,3883584,5093952
test,315,1228,1257472,20983,4028736,5286208
test,316,1787,1829888,35232,6764544,8594432
test,317,950,972800,15702,3014784,3987584
test,318,1170,1198080,20042,3848064,5046144
test,319,1278,1308672,21887,4202304,5510976
test,320,1207,1235968,20629,3960768,5196736
test,321,1317,1348608,22653,4349376,5697984
test,322,1195,1223680,20433,3923136,5146816
test,323,1013,1037312,17854,3427968,4465280
test,324,1137,1164288,19559,3755328,4919616
test,325,1015,1039360,17925,3441600,4480960
test,326,1042,1067008,18381,3529152,4596160
test,327,1011,1035264,17784,3414528,4449792
test,328,1247,1276928,21316,4092672,5369600
test,329,985,1008640,16881,3241152,4249792
test,330,1102,1128448,19089,3665088,4793536
test,331,1250,1280000,21370,4103040,5383040
test,332,1337,1369088,23067,4428864,5797952
test,333,1170,1198080,20042,3848064,5046144
test,334,1040,1064960,18359,3524928,4589888
