split,index,nodes,total_values_for_nodes,edges,total_values_for_edges,total_values_for_graph
train,0,410,419840,7992,1534464,1954304
train,1,329,336896,5146,988032,1324928
train,2,373,381952,6615,1270080,1652032
train,3,286,292864,3889,746688,1039552
train,4,126,129024,755,144960,273984
train,5,339,347136,5464,1049088,1396224
train,6,123,125952,720,138240,264192
train,7,592,606208,16662,3199104,3805312
train,8,202,206848,1940,372480,579328
train,9,235,240640,2626,504192,744832
train,10,345,353280,5659,1086528,1439808
train,11,115,117760,629,120768,238528
train,12,261,267264,3239,621888,889152
train,13,289,295936,3971,762432,1058368
train,14,303,310272,4365,838080,1148352
train,15,171,175104,1391,267072,442176
train,16,374,382976,6650,1276800,1659776
train,17,243,248832,2808,539136,787968
train,18,396,405504,7456,1431552,1837056
train,19,98,100352,457,87744,188096
train,20,210,215040,2097,402624,617664
train,21,159,162816,1202,230784,393600
train,22,216,221184,2219,426048,647232
train,23,249,254976,2948,566016,820992
train,24,425,435200,8588,1648896,2084096
train,25,397,406528,7493,1438656,1845184
train,26,287,293888,3916,751872,1045760
train,27,414,423936,8149,1564608,1988544
train,28,219,224256,2281,437952,662208
train,29,150,153600,1070,205440,359040
train,30,166,169984,1310,251520,421504
train,31,289,295936,3971,762432,1058368
train,32,406,415744,7837,1504704,1920448
train,33,567,580608,15284,2934528,3515136
train,34,393,402432,7343,1409856,1812288
train,35,313,320512,4658,894336,1214848
train,36,308,315392,4510,865920,1181312
train,37,267,273408,3390,650880,924288
train,38,179,183296,1524,292608,475904
train,39,418,428032,8307,1594944,2022976
train,40,390,399360,7231,1388352,1787712
train,41,353,361472,5924,1137408,1498880
train,42,178,182272,1507,289344,471616
train,43,300,307200,4279,821568,1128768
train,44,202,206848,1940,372480,579328
train,45,268,274432,3415,655680,930112
train,46,366,374784,6369,1222848,1597632
train,47,434,444416,8955,1719360,2163776
train,48,241,246784,2762,530304,777088
train,49,251,257024,2996,575232,832256
train,50,459,470016,10016,1923072,2393088
train,51,213,218112,2157,414144,632256
train,52,303,310272,4365,838080,1148352
train,53,401,410624,7645,1467840,1878464
train,54,97,99328,448,86016,185344
train,55,179,183296,1524,292608,475904
train,56,167,171008,1326,254592,425600
train,57,379,388096,6829,1311168,1699264
train,58,437,447488,9079,1743168,2190656
train,59,530,542720,13355,2564160,3106880
train,60,212,217088,2137,410304,627392
train,61,209,214016,2077,398784,612800
train,62,349,357376,5791,1111872,1469248
train,63,348,356352,5758,1105536,1461888
train,64,346,354304,5692,1092864,1447168
train,65,219,224256,2281,437952,662208
train,66,100,102400,476,91392,193792
train,67,87,89088,369,70848,159936
train,68,239,244736,2716,521472,766208
train,69,362,370688,6230,1196160,1566848
train,70,237,242688,2671,512832,755520
train,71,189,193536,1699,326208,519744
train,72,96,98304,439,84288,182592
train,73,267,273408,3390,650880,924288
train,74,158,161792,1187,227904,389696
train,75,85,87040,344,66048,153088
train,76,363,371712,6265,1202880,1574592
train,77,270,276480,3466,665472,941952
train,78,385,394240,7047,1353024,1747264
train,79,265,271360,3339,641088,912448
train,80,403,412672,7722,1482624,1895296
train,81,287,293888,3916,751872,1045760
train,82,257,263168,3140,602880,866048
train,83,376,385024,6722,1290624,1675648
train,84,401,410624,7645,1467840,1878464
train,85,139,142336,919,176448,318784
train,86,436,446464,9038,1735296,2181760
train,87,233,238592,2581,495552,734144
train,88,312,319488,4628,888576,1208064
train,89,399,408576,7569,1453248,1861824
train,90,360,368640,6162,1183104,1551744
train,91,428,438272,8709,1672128,2110400
train,92,553,566272,14539,2791488,3357760
train,93,207,211968,2038,391296,603264
train,94,202,206848,1940,372480,579328
train,95,347,355328,5725,1099200,1454528
train,96,404,413696,7760,1489920,1903616
train,97,153,156672,1113,213696,370368
train,98,340,348160,5496,1055232,1403392
train,99,171,175104,1391,267072,442176
train,100,340,348160,5496,1055232,1403392
train,101,295,302080,4138,794496,1096576
train,102,251,257024,2996,575232,832256
train,103,299,306176,4251,816192,1122368
train,104,384,393216,7011,1346112,1739328
train,105,435,445440,8996,1727232,2172672
train,106,124,126976,731,140352,267328
train,107,208,212992,2057,394944,607936
train,108,230,235520,2515,482880,718400
train,109,255,261120,3092,593664,854784
train,110,277,283648,3648,700416,984064
train,111,193,197632,1771,340032,537664
train,112,295,302080,4138,794496,1096576
train,113,357,365568,6059,1163328,1528896
train,114,192,196608,1753,336576,533184
train,115,487,498688,11276,2164992,2663680
train,116,399,408576,7569,1453248,1861824
train,117,366,374784,6369,1222848,1597632
train,118,159,162816,1202,230784,393600
train,119,406,415744,7837,1504704,1920448
train,120,650,665600,20086,3856512,4522112
train,121,307,314368,4481,860352,1174720
train,122,202,206848,1940,372480,579328
train,123,342,350208,5561,1067712,1417920
train,124,279,285696,3701,710592,996288
train,125,178,182272,1507,289344,471616
train,126,119,121856,674,129408,251264
train,127,210,215040,2097,402624,617664
train,128,238,243712,2693,517056,760768
train,129,427,437248,8669,1664448,2101696
train,130,219,224256,2281,437952,662208
train,131,398,407552,7531,1445952,1853504
train,132,198,202752,1864,357888,560640
train,133,241,246784,2762,530304,777088
train,134,158,161792,1187,227904,389696
train,135,126,129024,755,144960,273984
train,136,173,177152,1423,273216,450368
train,137,322,329728,4930,946560,1276288
train,138,660,675840,20709,3976128,4651968
train,139,438,448512,9121,1751232,2199744
train,140,310,317440,4569,877248,1194688
train,141,199,203776,1883,361536,565312
train,142,213,218112,2157,414144,632256
train,143,281,287744,3754,720768,1008512
train,144,365,373760,6334,1216128,1589888
train,145,262,268288,3264,626688,894976
train,146,101,103424,485,93120,196544
train,147,157,160768,1172,225024,385792
train,148,307,314368,4481,860352,1174720
train,149,217,222208,2239,429888,652096
train,150,305,312320,4423,849216,1161536
train,151,96,98304,439,84288,182592
train,152,166,169984,1310,251520,421504
train,153,350,358400,5824,1118208,1476608
train,154,293,300032,4082,783744,1083776
train,155,216,221184,2219,426048,647232
train,156,333,340992,5272,1012224,1353216
train,157,434,444416,8955,1719360,2163776
train,158,368,376832,6439,1236288,1613120
train,159,278,284672,3675,705600,990272
train,160,108,110592,555,106560,217152
train,161,168,172032,1342,257664,429696
train,162,181,185344,1558,299136,484480
train,163,155,158720,1143,219456,378176
train,164,416,425984,8228,1579776,2005760
train,165,357,365568,6059,1163328,1528896
train,166,345,353280,5659,1086528,1439808
train,167,139,142336,919,176448,318784
train,168,122,124928,708,135936,260864
train,169,84,86016,336,64512,150528
train,170,135,138240,867,166464,304704
train,171,470,481280,10502,2016384,2497664
train,172,188,192512,1681,322752,515264
train,173,420,430080,8387,1610304,2040384
train,174,347,355328,5725,1099200,1454528
train,175,306,313344,4452,854784,1168128
train,176,237,242688,2671,512832,755520
train,177,330,337920,5178,994176,1332096
train,178,371,379904,6544,1256448,1636352
train,179,368,376832,6439,1236288,1613120
train,180,363,371712,6265,1202880,1574592
train,181,95,97280,430,82560,179840
train,182,130,133120,804,154368,287488
train,183,358,366592,6093,1169856,1536448
train,184,260,266240,3214,617088,883328
train,185,381,390144,6902,1325184,1715328
train,186,237,242688,2671,512832,755520
train,187,293,300032,4082,783744,1083776
train,188,296,303104,4166,799872,1102976
train,189,317,324608,4778,917376,1241984
train,190,459,470016,10016,1923072,2393088
train,191,371,379904,6544,1256448,1636352
train,192,256,262144,3116,598272,860416
train,193,339,347136,5464,1049088,1396224
train,194,235,240640,2626,504192,744832
train,195,270,276480,3466,665472,941952
train,196,422,432128,8467,1625664,2057792
train,197,110,112640,576,110592,223232
train,198,233,238592,2581,495552,734144
train,199,314,321536,4688,900096,1221632
train,200,474,485376,10682,2050944,2536320
train,201,326,333824,5053,970176,1304000
train,202,472,483328,10592,2033664,2516992
train,203,394,403456,7381,1417152,1820608
train,204,222,227328,2343,449856,677184
train,205,264,270336,3314,636288,906624
train,206,270,276480,3466,665472,941952
train,207,553,566272,14539,2791488,3357760
train,208,283,289792,3808,731136,1020928
train,209,340,348160,5496,1055232,1403392
train,210,341,349184,5529,1061568,1410752
train,211,372,380928,6579,1263168,1644096
train,212,160,163840,1217,233664,397504
train,213,400,409600,7607,1460544,1870144
train,214,200,204800,1902,365184,569984
train,215,423,433152,8507,1633344,2066496
train,216,251,257024,2996,575232,832256
train,217,229,234496,2494,478848,713344
train,218,190,194560,1717,329664,524224
train,219,88,90112,369,70848,160960
train,220,259,265216,3190,612480,877696
train,221,416,425984,8228,1579776,2005760
train,222,278,284672,3675,705600,990272
train,223,102,104448,495,95040,199488
train,224,235,240640,2626,504192,744832
train,225,354,362496,5958,1143936,1506432
train,226,257,263168,3140,602880,866048
train,227,344,352256,5626,1080192,1432448
train,228,308,315392,4510,865920,1181312
train,229,166,169984,1310,251520,421504
train,230,134,137216,854,163968,301184
train,231,613,627712,17865,3430080,4057792
train,232,408,417792,7914,1519488,1937280
train,233,281,287744,3754,720768,1008512
train,234,180,184320,1541,295872,480192
train,235,214,219136,2178,418176,637312
train,236,347,355328,5725,1099200,1454528
train,237,250,256000,2972,570624,826624
train,238,364,372736,6299,1209408,1582144
train,239,483,494592,11091,2129472,2624064
train,240,274,280576,3570,685440,966016
train,241,561,574464,14963,2872896,3447360
train,242,250,256000,2972,570624,826624
train,243,268,274432,3415,655680,930112
train,244,247,252928,2901,556992,809920
train,245,230,235520,2515,482880,718400
train,246,290,296960,3999,767808,1064768
train,247,110,112640,576,110592,223232
train,248,411,420864,8031,1541952,1962816
train,249,161,164864,1233,236736,401600
train,250,289,295936,3971,762432,1058368
train,251,372,380928,6579,1263168,1644096
train,252,149,152576,1056,202752,355328
train,253,273,279552,3544,680448,960000
train,254,274,280576,3570,685440,966016
train,255,212,217088,2137,410304,627392
train,256,285,291840,3862,741504,1033344
train,257,337,345088,5400,1036800,1381888
train,258,262,268288,3264,626688,894976
train,259,314,321536,4688,900096,1221632
train,260,107,109568,545,104640,214208
train,261,305,312320,4423,849216,1161536
train,262,281,287744,3754,720768,1008512
train,263,317,324608,4778,917376,1241984
train,264,213,218112,2157,414144,632256
train,265,131,134144,816,156672,290816
train,266,391,400384,7269,1395648,1796032
train,267,226,231424,2429,466368,697792
train,268,331,338944,5209,1000128,1339072
train,269,372,380928,6579,1263168,1644096
train,270,401,410624,7645,1467840,1878464
train,271,234,239616,2604,499968,739584
train,272,416,425984,8228,1579776,2005760
train,273,309,316416,4540,871680,1188096
train,274,164,167936,1279,245568,413504
train,275,330,337920,5178,994176,1332096
train,276,181,185344,1558,299136,484480
train,277,185,189440,1628,312576,502016
train,278,287,293888,3916,751872,1045760
train,279,566,579584,15230,2924160,3503744
train,280,335,343040,5336,1024512,1367552
train,281,219,224256,2281,437952,662208
train,282,240,245760,2739,525888,771648
train,283,262,268288,3264,626688,894976
train,284,218,223232,2260,433920,657152
train,285,371,379904,6544,1256448,1636352
train,286,351,359424,5858,1124736,1484160
train,287,434,444416,8955,1719360,2163776
train,288,344,352256,5626,1080192,1432448
train,289,76,77824,275,52800,130624
train,290,489,500736,11368,2182656,2683392
train,291,213,218112,2157,414144,632256
train,292,328,335872,5115,982080,1317952
train,293,295,302080,4138,794496,1096576
train,294,367,375808,6404,1229568,1605376
train,295,412,421888,8070,1549440,1971328
train,296,302,309248,4336,832512,1141760
train,297,262,268288,3264,626688,894976
train,298,202,206848,1940,372480,579328
train,299,305,312320,4423,849216,1161536
train,300,149,152576,1056,202752,355328
train,301,140,143360,932,178944,322304
train,302,301,308224,4308,827136,1135360
train,303,156,159744,1157,222144,381888
train,304,239,244736,2716,521472,766208
train,305,356,364544,6026,1156992,1521536
train,306,481,492544,11000,2112000,2604544
train,307,357,365568,6059,1163328,1528896
train,308,264,270336,3314,636288,906624
train,309,100,102400,476,91392,193792
train,310,240,245760,2739,525888,771648
train,311,294,301056,4110,789120,1090176
train,312,425,435200,8588,1648896,2084096
train,313,370,378880,6509,1249728,1628608
train,314,696,712704,23030,4421760,5134464
train,315,216,221184,2219,426048,647232
train,316,288,294912,3944,757248,1052160
train,317,233,238592,2581,495552,734144
train,318,367,375808,6404,1229568,1605376
train,319,210,215040,2097,402624,617664
train,320,146,149504,1014,194688,344192
train,321,469,480256,10458,2007936,2488192
train,322,384,393216,7011,1346112,1739328
train,323,388,397312,7157,1374144,1771456
train,324,180,184320,1541,295872,480192
train,325,365,373760,6334,1216128,1589888
train,326,124,126976,731,140352,267328
train,327,144,147456,986,189312,336768
train,328,360,368640,6162,1183104,1551744
train,329,183,187392,1593,305856,493248
train,330,202,206848,1940,372480,579328
train,331,160,163840,1217,233664,397504
train,332,408,417792,7914,1519488,1937280
train,333,423,433152,8507,1633344,2066496
train,334,219,224256,2281,437952,662208
train,335,156,159744,1157,222144,381888
train,336,201,205824,1921,368832,574656
train,337,82,83968,320,61440,145408
train,338,313,320512,4658,894336,1214848
train,339,573,586752,15609,2996928,3583680
train,340,253,259072,3043,584256,843328
train,341,419,429056,8347,1602624,2031680
train,342,353,361472,5924,1137408,1498880
train,343,104,106496,515,98880,205376
train,344,264,270336,3314,636288,906624
train,345,560,573440,14909,2862528,3435968
train,346,461,472064,10104,1939968,2412032
train,347,330,337920,5178,994176,1332096
train,348,156,159744,1157,222144,381888
train,349,309,316416,4540,871680,1188096
train,350,332,339968,5241,1006272,1346240
train,351,398,407552,7531,1445952,1853504
train,352,246,251904,2877,552384,804288
train,353,244,249856,2831,543552,793408
train,354,332,339968,5241,1006272,1346240
train,355,189,193536,1699,326208,519744
train,356,547,560128,14225,2731200,3291328
train,357,229,234496,2494,478848,713344
train,358,201,205824,1921,368832,574656
train,359,300,307200,4279,821568,1128768
train,360,229,234496,2494,478848,713344
train,361,197,201728,1845,354240,555968
train,362,185,189440,1628,312576,502016
train,363,207,211968,2038,391296,603264
train,364,130,133120,804,154368,287488
train,365,381,390144,6902,1325184,1715328
train,366,340,348160,5496,1055232,1403392
train,367,622,636928,18393,3531456,4168384
train,368,236,241664,2648,508416,750080
train,369,253,259072,3043,584256,843328
train,370,232,237568,2559,491328,728896
train,371,321,328704,4899,940608,1269312
train,372,192,196608,1753,336576,533184
train,373,392,401408,7306,1402752,1804160
train,374,297,304128,4194,805248,1109376
train,375,379,388096,6829,1311168,1699264
train,376,303,310272,4365,838080,1148352
train,377,507,519168,12221,2346432,2865600
train,378,158,161792,1187,227904,389696
train,379,311,318464,4599,883008,1201472
train,380,205,209920,1998,383616,593536
train,381,454,464896,9799,1881408,2346304
train,382,370,378880,6509,1249728,1628608
train,383,158,161792,1187,227904,389696
train,384,160,163840,1217,233664,397504
train,385,145,148480,1000,192000,340480
train,386,123,125952,720,138240,264192
train,387,417,427008,8267,1587264,2014272
train,388,482,493568,11045,2120640,2614208
train,389,136,139264,880,168960,308224
train,390,235,240640,2626,504192,744832
train,391,224,229376,2386,458112,687488
train,392,194,198656,1790,343680,542336
train,393,55,56320,144,27648,83968
train,394,165,168960,1295,248640,417600
train,395,157,160768,1172,225024,385792
train,396,237,242688,2671,512832,755520
train,397,226,231424,2429,466368,697792
train,398,87,89088,360,69120,158208
train,399,446,456704,9457,1815744,2272448
train,400,356,364544,6026,1156992,1521536
train,401,225,230400,2407,462144,692544
train,402,168,172032,1342,257664,429696
train,403,323,330752,4960,952320,1283072
train,404,210,215040,2097,402624,617664
train,405,302,309248,4336,832512,1141760
train,406,321,328704,4899,940608,1269312
train,407,248,253952,2924,561408,815360
train,408,375,384000,6686,1283712,1667712
train,409,385,394240,7047,1353024,1747264
train,410,312,319488,4628,888576,1208064
train,411,344,352256,5626,1080192,1432448
train,412,214,219136,2178,418176,637312
train,413,104,106496,515,98880,205376
train,414,297,304128,4194,805248,1109376
train,415,410,419840,7992,1534464,1954304
train,416,245,250880,2854,547968,798848
train,417,108,110592,555,106560,217152
train,418,310,317440,4569,877248,1194688
train,419,416,425984,8228,1579776,2005760
train,420,134,137216,854,163968,301184
train,421,381,390144,6902,1325184,1715328
train,422,255,261120,3092,593664,854784
train,423,233,238592,2581,495552,734144
train,424,173,177152,1423,273216,450368
train,425,287,293888,3916,751872,1045760
train,426,737,754688,25823,4958016,5712704
train,427,385,394240,7047,1353024,1747264
train,428,141,144384,946,181632,326016
train,429,271,277504,3492,670464,947968
train,430,386,395264,7084,1360128,1755392
train,431,173,177152,1423,273216,450368
train,432,78,79872,297,57024,136896
train,433,361,369664,6196,1189632,1559296
train,434,188,192512,1681,322752,515264
train,435,606,620544,17459,3352128,3972672
train,436,92,94208,403,77376,171584
train,437,115,117760,629,120768,238528
train,438,299,306176,4251,816192,1122368
train,439,256,262144,3116,598272,860416
train,440,430,440320,8791,1687872,2128192
train,441,383,392192,6974,1339008,1731200
train,442,239,244736,2716,521472,766208
train,443,119,121856,674,129408,251264
train,444,477,488448,10817,2076864,2565312
train,445,281,287744,3754,720768,1008512
train,446,359,367616,6128,1176576,1544192
train,447,271,277504,3492,670464,947968
train,448,163,166912,1264,242688,409600
train,449,342,350208,5561,1067712,1417920
train,450,160,163840,1217,233664,397504
train,451,431,441344,8832,1695744,2137088
train,452,194,198656,1790,343680,542336
train,453,364,372736,6299,1209408,1582144
train,454,291,297984,4026,772992,1070976
train,455,98,100352,457,87744,188096
train,456,347,355328,5725,1099200,1454528
train,457,228,233472,2472,474624,708096
train,458,331,338944,5209,1000128,1339072
train,459,85,87040,344,66048,153088
train,460,310,317440,4569,877248,1194688
train,461,222,227328,2343,449856,677184
train,462,251,257024,2996,575232,832256
train,463,364,372736,6299,1209408,1582144
train,464,126,129024,755,144960,273984
train,465,270,276480,3466,665472,941952
train,466,312,319488,4628,888576,1208064
train,467,397,406528,7493,1438656,1845184
train,468,337,345088,5400,1036800,1381888
train,469,387,396288,7121,1367232,1763520
train,470,85,87040,344,66048,153088
train,471,207,211968,2038,391296,603264
train,472,273,279552,3544,680448,960000
train,473,180,184320,1541,295872,480192
train,474,310,317440,4569,877248,1194688
train,475,398,407552,7531,1445952,1853504
train,476,343,351232,5594,1074048,1425280
train,477,219,224256,2281,437952,662208
train,478,227,232448,2450,470400,702848
train,479,131,134144,816,156672,290816
train,480,177,181248,1490,286080,467328
train,481,317,324608,4778,917376,1241984
train,482,299,306176,4251,816192,1122368
train,483,93,95232,412,79104,174336
train,484,240,245760,2739,525888,771648
train,485,473,484352,10637,2042304,2526656
train,486,300,307200,4279,821568,1128768
train,487,364,372736,6299,1209408,1582144
train,488,373,381952,6615,1270080,1652032
train,489,385,394240,7047,1353024,1747264
train,490,156,159744,1157,222144,381888
train,491,319,326656,4838,928896,1255552
train,492,416,425984,8228,1579776,2005760
train,493,291,297984,4026,772992,1070976
train,494,424,434176,8547,1641024,2075200
train,495,461,472064,10104,1939968,2412032
train,496,376,385024,6722,1290624,1675648
train,497,140,143360,932,178944,322304
train,498,210,215040,2097,402624,617664
train,499,396,405504,7456,1431552,1837056
train,500,263,269312,3289,631488,900800
train,501,222,227328,2343,449856,677184
train,502,227,232448,2450,470400,702848
train,503,438,448512,9121,1751232,2199744
train,504,586,600064,16326,3134592,3734656
train,505,340,348160,5496,1055232,1403392
train,506,300,307200,4279,821568,1128768
train,507,312,319488,4628,888576,1208064
train,508,404,413696,7760,1489920,1903616
train,509,150,153600,1070,205440,359040
train,510,112,114688,597,114624,229312
train,511,161,164864,1233,236736,401600
train,512,431,441344,8832,1695744,2137088
train,513,297,304128,4194,805248,1109376
train,514,116,118784,640,122880,241664
train,515,398,407552,7531,1445952,1853504
train,516,183,187392,1593,305856,493248
train,517,232,237568,2559,491328,728896
train,518,195,199680,1808,347136,546816
train,519,388,397312,7157,1374144,1771456
train,520,62,63488,183,35136,98624
train,521,286,292864,3889,746688,1039552
train,522,418,428032,8307,1594944,2022976
train,523,353,361472,5924,1137408,1498880
train,524,140,143360,932,178944,322304
train,525,415,424960,8188,1572096,1997056
train,526,154,157696,1128,216576,374272
train,527,340,348160,5496,1055232,1403392
train,528,81,82944,312,59904,142848
train,529,229,234496,2494,478848,713344
train,530,222,227328,2343,449856,677184
train,531,227,232448,2450,470400,702848
train,532,349,357376,5791,1111872,1469248
train,533,312,319488,4628,888576,1208064
train,534,352,360448,5891,1131072,1491520
train,535,402,411648,7683,1475136,1886784
train,536,397,406528,7493,1438656,1845184
train,537,132,135168,829,159168,294336
train,538,187,191488,1663,319296,510784
train,539,277,283648,3648,700416,984064
train,540,341,349184,5529,1061568,1410752
train,541,344,352256,5626,1080192,1432448
train,542,331,338944,5209,1000128,1339072
train,543,94,96256,421,80832,177088
train,544,453,463872,9756,1873152,2337024
train,545,372,380928,6579,1263168,1644096
train,546,709,726016,23898,4588416,5314432
train,547,232,237568,2559,491328,728896
train,548,178,182272,1507,289344,471616
train,549,153,156672,1113,213696,370368
train,550,216,221184,2219,426048,647232
train,551,278,284672,3675,705600,990272
train,552,236,241664,2648,508416,750080
train,553,320,327680,4869,934848,1262528
train,554,92,94208,403,77376,171584
train,555,101,103424,485,93120,196544
train,556,362,370688,6230,1196160,1566848
train,557,367,375808,6404,1229568,1605376
train,558,238,243712,2693,517056,760768
train,559,257,263168,3140,602880,866048
train,560,517,529408,12708,2439936,2969344
train,561,169,173056,1358,260736,433792
train,562,327,334848,5084,976128,1310976
train,563,329,336896,5146,988032,1324928
train,564,272,278528,3518,675456,953984
train,565,343,351232,5594,1074048,1425280
train,566,347,355328,5725,1099200,1454528
train,567,477,488448,10817,2076864,2565312
train,568,159,162816,1202,230784,393600
train,569,195,199680,1808,347136,546816
train,570,326,333824,5053,970176,1304000
train,571,126,129024,755,144960,273984
train,572,201,205824,1921,368832,574656
train,573,347,355328,5725,1099200,1454528
train,574,374,382976,6650,1276800,1659776
train,575,343,351232,5594,1074048,1425280
train,576,425,435200,8588,1648896,2084096
train,577,260,266240,3214,617088,883328
train,578,586,600064,16326,3134592,3734656
train,579,408,417792,7914,1519488,1937280
train,580,239,244736,2716,521472,766208
train,581,319,326656,4838,928896,1255552
train,582,349,357376,5791,1111872,1469248
train,583,428,438272,8709,1672128,2110400
train,584,190,194560,1717,329664,524224
train,585,222,227328,2343,449856,677184
train,586,485,496640,11183,2147136,2643776
train,587,114,116736,618,118656,235392
train,588,191,195584,1735,333120,528704
train,589,78,79872,290,55680,135552
train,590,314,321536,4688,900096,1221632
train,591,111,113664,586,112512,226176
train,592,170,174080,1374,263808,437888
train,593,290,296960,3999,767808,1064768
train,594,308,315392,4510,865920,1181312
train,595,348,356352,5758,1105536,1461888
train,596,169,173056,1358,260736,433792
train,597,331,338944,5209,1000128,1339072
train,598,365,373760,6334,1216128,1589888
train,599,334,342016,5304,1018368,1360384
train,600,306,313344,4452,854784,1168128
train,601,258,264192,3165,607680,871872
train,602,198,202752,1864,357888,560640
train,603,466,477184,10324,1982208,2459392
train,604,158,161792,1187,227904,389696
train,605,388,397312,7157,1374144,1771456
train,606,161,164864,1233,236736,401600
train,607,441,451584,9246,1775232,2226816
train,608,243,248832,2808,539136,787968
train,609,93,95232,412,79104,174336
train,610,84,86016,336,64512,150528
train,611,387,396288,7121,1367232,1763520
train,612,368,376832,6439,1236288,1613120
train,613,158,161792,1187,227904,389696
train,614,313,320512,4658,894336,1214848
train,615,213,218112,2157,414144,632256
train,616,302,309248,4336,832512,1141760
train,617,205,209920,1998,383616,593536
train,618,501,513024,11933,2291136,2804160
train,619,166,169984,1310,251520,421504
train,620,397,406528,7493,1438656,1845184
train,621,273,279552,3544,680448,960000
train,622,109,111616,565,108480,220096
train,623,156,159744,1157,222144,381888
train,624,332,339968,5241,1006272,1346240
train,625,420,430080,8387,1610304,2040384
train,626,273,279552,3544,680448,960000
train,627,181,185344,1558,299136,484480
train,628,229,234496,2494,478848,713344
train,629,414,423936,8149,1564608,1988544
train,630,231,236544,2537,487104,723648
train,631,246,251904,2877,552384,804288
train,632,283,289792,3808,731136,1020928
train,633,354,362496,5958,1143936,1506432
train,634,193,197632,1771,340032,537664
train,635,243,248832,2808,539136,787968
train,636,414,423936,8149,1564608,1988544
train,637,140,143360,932,178944,322304
train,638,359,367616,6128,1176576,1544192
train,639,93,95232,412,79104,174336
train,640,308,315392,4510,865920,1181312
train,641,379,388096,6829,1311168,1699264
train,642,167,171008,1326,254592,425600
train,643,271,277504,3492,670464,947968
train,644,238,243712,2693,517056,760768
train,645,377,386048,6757,1297344,1683392
train,646,191,195584,1735,333120,528704
train,647,177,181248,1490,286080,467328
train,648,307,314368,4481,860352,1174720
train,649,197,201728,1845,354240,555968
train,650,174,178176,1440,276480,454656
train,651,133,136192,841,161472,297664
train,652,233,238592,2581,495552,734144
train,653,240,245760,2739,525888,771648
train,654,152,155648,1099,211008,366656
train,655,337,345088,5400,1036800,1381888
train,656,208,212992,2057,394944,607936
train,657,437,447488,9079,1743168,2190656
train,658,310,317440,4569,877248,1194688
train,659,265,271360,3339,641088,912448
train,660,339,347136,5464,1049088,1396224
train,661,132,135168,829,159168,294336
train,662,284,290816,3835,736320,1027136
train,663,234,239616,2604,499968,739584
train,664,237,242688,2671,512832,755520
train,665,203,207872,1960,376320,584192
train,666,252,258048,3019,579648,837696
train,667,196,200704,1827,350784,551488
train,668,275,281600,3596,690432,972032
train,669,103,105472,505,96960,202432
train,670,81,82944,312,59904,142848
train,671,288,294912,3944,757248,1052160
train,672,155,158720,1143,219456,378176
train,673,313,320512,4658,894336,1214848
train,674,297,304128,4194,805248,1109376
train,675,322,329728,4930,946560,1276288
train,676,177,181248,1490,286080,467328
train,677,462,473088,10148,1948416,2421504
train,678,279,285696,3701,710592,996288
train,679,341,349184,5529,1061568,1410752
train,680,297,304128,4194,805248,1109376
train,681,250,256000,2972,570624,826624
train,682,137,140288,893,171456,311744
train,683,163,166912,1264,242688,409600
train,684,377,386048,6757,1297344,1683392
train,685,152,155648,1099,211008,366656
train,686,328,335872,5115,982080,1317952
train,687,463,474112,10192,1956864,2430976
train,688,326,333824,5053,970176,1304000
train,689,317,324608,4778,917376,1241984
train,690,310,317440,4569,877248,1194688
train,691,268,274432,3415,655680,930112
train,692,328,335872,5115,982080,1317952
train,693,311,318464,4599,883008,1201472
train,694,75,76800,268,51456,128256
train,695,278,284672,3675,705600,990272
train,696,148,151552,1042,200064,351616
train,697,290,296960,3999,767808,1064768
train,698,269,275456,3441,660672,936128
train,699,458,468992,9973,1914816,2383808
train,700,420,430080,8387,1610304,2040384
train,701,321,328704,4899,940608,1269312
train,702,118,120832,662,127104,247936
train,703,163,166912,1264,242688,409600
train,704,267,273408,3390,650880,924288
train,705,258,264192,3165,607680,871872
train,706,170,174080,1374,263808,437888
train,707,395,404480,7418,1424256,1828736
train,708,168,172032,1342,257664,429696
train,709,324,331776,4991,958272,1290048
train,710,363,371712,6265,1202880,1574592
train,711,263,269312,3289,631488,900800
train,712,211,216064,2117,406464,622528
train,713,214,219136,2178,418176,637312
train,714,386,395264,7084,1360128,1755392
train,715,220,225280,2301,441792,667072
train,716,156,159744,1157,222144,381888
train,717,275,281600,3596,690432,972032
train,718,330,337920,5178,994176,1332096
train,719,422,432128,8467,1625664,2057792
train,720,211,216064,2117,406464,622528
train,721,324,331776,4991,958272,1290048
train,722,221,226304,2322,445824,672128
train,723,150,153600,1070,205440,359040
train,724,389,398336,7194,1381248,1779584
train,725,185,189440,1628,312576,502016
train,726,219,224256,2281,437952,662208
train,727,269,275456,3441,660672,936128
train,728,225,230400,2407,462144,692544
train,729,234,239616,2604,499968,739584
train,730,193,197632,1771,340032,537664
train,731,182,186368,1575,302400,488768
train,732,290,296960,3999,767808,1064768
train,733,340,348160,5496,1055232,1403392
train,734,371,379904,6544,1256448,1636352
train,735,454,464896,9799,1881408,2346304
train,736,354,362496,5958,1143936,1506432
train,737,120,122880,685,131520,254400
train,738,307,314368,4481,860352,1174720
train,739,201,205824,1921,368832,574656
train,740,279,285696,3701,710592,996288
train,741,187,191488,1663,319296,510784
train,742,503,515072,12029,2309568,2824640
train,743,294,301056,4110,789120,1090176
train,744,147,150528,1028,197376,347904
train,745,195,199680,1808,347136,546816
train,746,302,309248,4336,832512,1141760
train,747,154,157696,1128,216576,374272
train,748,184,188416,1610,309120,497536
train,749,315,322560,4718,905856,1228416
train,750,262,268288,3264,626688,894976
train,751,300,307200,4279,821568,1128768
train,752,144,147456,986,189312,336768
train,753,249,254976,2948,566016,820992
train,754,222,227328,2343,449856,677184
train,755,203,207872,1960,376320,584192
train,756,259,265216,3190,612480,877696
train,757,290,296960,3999,767808,1064768
train,758,281,287744,3754,720768,1008512
train,759,285,291840,3862,741504,1033344
train,760,265,271360,3339,641088,912448
train,761,435,445440,8996,1727232,2172672
train,762,99,101376,466,89472,190848
train,763,157,160768,1172,225024,385792
train,764,80,81920,305,58560,140480
train,765,256,262144,3116,598272,860416
train,766,312,319488,4628,888576,1208064
train,767,429,439296,8750,1680000,2119296
train,768,404,413696,7760,1489920,1903616
train,769,144,147456,986,189312,336768
train,770,144,147456,986,189312,336768
train,771,245,250880,2854,547968,798848
train,772,334,342016,5304,1018368,1360384
train,773,339,347136,5464,1049088,1396224
train,774,283,289792,3808,731136,1020928
train,775,398,407552,7531,1445952,1853504
train,776,222,227328,2343,449856,677184
train,777,240,245760,2739,525888,771648
train,778,163,166912,1264,242688,409600
train,779,167,171008,1326,254592,425600
train,780,294,301056,4110,789120,1090176
train,781,166,169984,1310,251520,421504
train,782,240,245760,2739,525888,771648
train,783,260,266240,3214,617088,883328
train,784,238,243712,2693,517056,760768
train,785,98,100352,457,87744,188096
train,786,222,227328,2343,449856,677184
train,787,427,437248,8669,1664448,2101696
train,788,82,83968,320,61440,145408
train,789,340,348160,5496,1055232,1403392
train,790,404,413696,7760,1489920,1903616
train,791,314,321536,4688,900096,1221632
train,792,99,101376,476,91392,192768
train,793,414,423936,8149,1564608,1988544
train,794,343,351232,5594,1074048,1425280
train,795,137,140288,893,171456,311744
train,796,285,291840,3862,741504,1033344
train,797,190,194560,1717,329664,524224
train,798,158,161792,1187,227904,389696
train,799,313,320512,4658,894336,1214848
train,800,227,232448,2450,470400,702848
train,801,332,339968,5241,1006272,1346240
train,802,188,192512,1681,322752,515264
train,803,270,276480,3466,665472,941952
train,804,392,401408,7306,1402752,1804160
train,805,342,350208,5561,1067712,1417920
train,806,356,364544,6026,1156992,1521536
train,807,426,436224,8628,1656576,2092800
train,808,318,325632,4808,923136,1248768
train,809,79,80896,297,57024,137920
train,810,268,274432,3415,655680,930112
train,811,363,371712,6265,1202880,1574592
train,812,133,136192,841,161472,297664
train,813,68,69632,220,42240,111872
train,814,381,390144,6902,1325184,1715328
train,815,371,379904,6544,1256448,1636352
train,816,418,428032,8307,1594944,2022976
train,817,361,369664,6196,1189632,1559296
train,818,87,89088,360,69120,158208
train,819,491,502784,11462,2200704,2703488
train,820,445,455680,9415,1807680,2263360
train,821,298,305152,4222,810624,1115776
train,822,250,256000,2972,570624,826624
train,823,298,305152,4222,810624,1115776
train,824,320,327680,4869,934848,1262528
train,825,354,362496,5958,1143936,1506432
train,826,176,180224,1473,282816,463040
train,827,462,473088,10148,1948416,2421504
train,828,367,375808,6404,1229568,1605376
train,829,193,197632,1771,340032,537664
train,830,393,402432,7343,1409856,1812288
train,831,121,123904,696,133632,257536
train,832,306,313344,4452,854784,1168128
train,833,342,350208,5561,1067712,1417920
train,834,274,280576,3570,685440,966016
train,835,368,376832,6439,1236288,1613120
train,836,296,303104,4166,799872,1102976
train,837,220,225280,2301,441792,667072
train,838,150,153600,1070,205440,359040
train,839,415,424960,8188,1572096,1997056
train,840,103,105472,505,96960,202432
train,841,255,261120,3092,593664,854784
train,842,196,200704,1827,350784,551488
train,843,176,180224,1473,282816,463040
train,844,137,140288,893,171456,311744
train,845,208,212992,2057,394944,607936
train,846,368,376832,6439,1236288,1613120
train,847,263,269312,3289,631488,900800
train,848,413,422912,8109,1556928,1979840
train,849,377,386048,6757,1297344,1683392
train,850,275,281600,3596,690432,972032
train,851,260,266240,3214,617088,883328
train,852,154,157696,1128,216576,374272
train,853,274,280576,3570,685440,966016
train,854,302,309248,4336,832512,1141760
train,855,206,210944,2018,387456,598400
train,856,345,353280,5659,1086528,1439808
train,857,122,124928,708,135936,260864
train,858,188,192512,1681,322752,515264
train,859,479,490496,10908,2094336,2584832
train,860,408,417792,7914,1519488,1937280
train,861,198,202752,1864,357888,560640
train,862,278,284672,3675,705600,990272
train,863,510,522240,12366,2374272,2896512
train,864,342,350208,5561,1067712,1417920
train,865,271,277504,3492,670464,947968
train,866,97,99328,448,86016,185344
train,867,184,188416,1610,309120,497536
train,868,135,138240,867,166464,304704
train,869,413,422912,8109,1556928,1979840
train,870,223,228352,2365,454080,682432
train,871,190,194560,1717,329664,524224
train,872,227,232448,2450,470400,702848
train,873,196,200704,1827,350784,551488
train,874,344,352256,5626,1080192,1432448
train,875,141,144384,946,181632,326016
train,876,476,487424,10772,2068224,2555648
train,877,399,408576,7569,1453248,1861824
train,878,323,330752,4960,952320,1283072
train,879,269,275456,3441,660672,936128
train,880,264,270336,3314,636288,906624
train,881,136,139264,880,168960,308224
train,882,211,216064,2117,406464,622528
train,883,269,275456,3441,660672,936128
train,884,250,256000,2972,570624,826624
train,885,176,180224,1473,282816,463040
train,886,407,416768,7876,1512192,1928960
train,887,199,203776,1883,361536,565312
train,888,195,199680,1808,347136,546816
train,889,262,268288,3264,626688,894976
train,890,447,457728,9500,1824000,2281728
train,891,106,108544,535,102720,211264
train,892,337,345088,5400,1036800,1381888
train,893,286,292864,3889,746688,1039552
train,894,391,400384,7269,1395648,1796032
train,895,403,412672,7722,1482624,1895296
train,896,123,125952,720,138240,264192
train,897,342,350208,5561,1067712,1417920
train,898,340,348160,5496,1055232,1403392
train,899,207,211968,2038,391296,603264
train,900,434,444416,8955,1719360,2163776
train,901,184,188416,1610,309120,497536
train,902,218,223232,2260,433920,657152
train,903,188,192512,1681,322752,515264
train,904,75,76800,268,51456,128256
train,905,162,165888,1248,239616,405504
train,906,378,387072,6793,1304256,1691328
train,907,316,323584,4748,911616,1235200
train,908,393,402432,7343,1409856,1812288
train,909,275,281600,3596,690432,972032
train,910,397,406528,7493,1438656,1845184
train,911,237,242688,2671,512832,755520
train,912,98,100352,457,87744,188096
train,913,247,252928,2901,556992,809920
train,914,295,302080,4138,794496,1096576
train,915,212,217088,2137,410304,627392
train,916,287,293888,3916,751872,1045760
train,917,214,219136,2178,418176,637312
train,918,163,166912,1264,242688,409600
train,919,327,334848,5084,976128,1310976
train,920,379,388096,6829,1311168,1699264
train,921,235,240640,2626,504192,744832
train,922,220,225280,2301,441792,667072
train,923,242,247808,2785,534720,782528
train,924,407,416768,7876,1512192,1928960
train,925,378,387072,6793,1304256,1691328
train,926,230,235520,2515,482880,718400
train,927,174,178176,1440,276480,454656
train,928,117,119808,651,124992,244800
train,929,226,231424,2429,466368,697792
train,930,66,67584,208,39936,107520
train,931,272,278528,3518,675456,953984
train,932,376,385024,6722,1290624,1675648
train,933,285,291840,3862,741504,1033344
train,934,218,223232,2260,433920,657152
train,935,116,118784,640,122880,241664
train,936,330,337920,5178,994176,1332096
train,937,239,244736,2716,521472,766208
train,938,260,266240,3214,617088,883328
train,939,318,325632,4808,923136,1248768
train,940,254,260096,3068,589056,849152
train,941,400,409600,7607,1460544,1870144
train,942,313,320512,4658,894336,1214848
train,943,264,270336,3314,636288,906624
train,944,166,169984,1310,251520,421504
train,945,221,226304,2322,445824,672128
train,946,242,247808,2785,534720,782528
train,947,211,216064,2117,406464,622528
train,948,237,242688,2671,512832,755520
train,949,163,166912,1264,242688,409600
train,950,503,515072,12029,2309568,2824640
train,951,313,320512,4658,894336,1214848
train,952,356,364544,6026,1156992,1521536
train,953,255,261120,3092,593664,854784
train,954,316,323584,4748,911616,1235200
train,955,234,239616,2604,499968,739584
train,956,105,107520,525,100800,208320
train,957,240,245760,2739,525888,771648
train,958,361,369664,6196,1189632,1559296
train,959,91,93184,394,75648,168832
train,960,226,231424,2429,466368,697792
train,961,175,179200,1456,279552,458752
train,962,231,236544,2537,487104,723648
train,963,284,290816,3835,736320,1027136
train,964,170,174080,1374,263808,437888
train,965,184,188416,1610,309120,497536
train,966,464,475136,10236,1965312,2440448
train,967,272,278528,3518,675456,953984
train,968,428,438272,8709,1672128,2110400
train,969,198,202752,1864,357888,560640
train,970,427,437248,8669,1664448,2101696
train,971,445,455680,9415,1807680,2263360
train,972,158,161792,1187,227904,389696
train,973,492,503808,11508,2209536,2713344
train,974,213,218112,2157,414144,632256
train,975,384,393216,7011,1346112,1739328
train,976,195,199680,1808,347136,546816
train,977,283,289792,3808,731136,1020928
train,978,226,231424,2429,466368,697792
train,979,363,371712,6265,1202880,1574592
train,980,526,538624,13154,2525568,3064192
train,981,265,271360,3339,641088,912448
train,982,93,95232,412,79104,174336
train,983,150,153600,1070,205440,359040
train,984,282,288768,3781,725952,1014720
train,985,411,420864,8031,1541952,1962816
train,986,146,149504,1014,194688,344192
train,987,291,297984,4026,772992,1070976
train,988,401,410624,7645,1467840,1878464
train,989,231,236544,2537,487104,723648
train,990,166,169984,1310,251520,421504
train,991,233,238592,2581,495552,734144
train,992,217,222208,2239,429888,652096
train,993,99,101376,466,89472,190848
train,994,264,270336,3314,636288,906624
train,995,252,258048,3019,579648,837696
train,996,330,337920,5178,994176,1332096
train,997,182,186368,1575,302400,488768
train,998,381,390144,6902,1325184,1715328
train,999,222,227328,2343,449856,677184
train,1000,109,111616,565,108480,220096
train,1001,128,131072,779,149568,280640
train,1002,241,246784,2762,530304,777088
train,1003,281,287744,3754,720768,1008512
train,1004,193,197632,1771,340032,537664
train,1005,329,336896,5146,988032,1324928
train,1006,181,185344,1558,299136,484480
train,1007,367,375808,6404,1229568,1605376
train,1008,349,357376,5791,1111872,1469248
train,1009,195,199680,1808,347136,546816
train,1010,242,247808,2785,534720,782528
train,1011,170,174080,1374,263808,437888
train,1012,251,257024,2996,575232,832256
train,1013,190,194560,1717,329664,524224
train,1014,309,316416,4540,871680,1188096
train,1015,188,192512,1681,322752,515264
train,1016,173,177152,1423,273216,450368
train,1017,188,192512,1681,322752,515264
train,1018,408,417792,7914,1519488,1937280
train,1019,280,286720,3728,715776,1002496
train,1020,389,398336,7194,1381248,1779584
train,1021,391,400384,7269,1395648,1796032
train,1022,245,250880,2854,547968,798848
train,1023,510,522240,12366,2374272,2896512
train,1024,216,221184,2219,426048,647232
train,1025,210,215040,2097,402624,617664
train,1026,348,356352,5758,1105536,1461888
train,1027,280,286720,3728,715776,1002496
train,1028,143,146432,973,186816,333248
train,1029,175,179200,1456,279552,458752
train,1030,102,104448,495,95040,199488
train,1031,202,206848,1940,372480,579328
train,1032,410,419840,7992,1534464,1954304
train,1033,273,279552,3544,680448,960000
train,1034,348,356352,5758,1105536,1461888
train,1035,295,302080,4138,794496,1096576
train,1036,211,216064,2117,406464,622528
train,1037,348,356352,5758,1105536,1461888
train,1038,235,240640,2626,504192,744832
train,1039,295,302080,4138,794496,1096576
train,1040,330,337920,5178,994176,1332096
train,1041,186,190464,1645,315840,506304
train,1042,117,119808,651,124992,244800
train,1043,200,204800,1902,365184,569984
train,1044,192,196608,1753,336576,533184
train,1045,115,117760,629,120768,238528
train,1046,224,229376,2386,458112,687488
train,1047,170,174080,1374,263808,437888
train,1048,194,198656,1790,343680,542336
train,1049,324,331776,4991,958272,1290048
train,1050,238,243712,2693,517056,760768
train,1051,389,398336,7194,1381248,1779584
train,1052,207,211968,2038,391296,603264
train,1053,247,252928,2901,556992,809920
train,1054,282,288768,3781,725952,1014720
train,1055,211,216064,2117,406464,622528
train,1056,149,152576,1056,202752,355328
train,1057,221,226304,2322,445824,672128
train,1058,138,141312,906,173952,315264
train,1059,181,185344,1558,299136,484480
train,1060,117,119808,651,124992,244800
train,1061,296,303104,4166,799872,1102976
train,1062,241,246784,2762,530304,777088
train,1063,311,318464,4599,883008,1201472
train,1064,294,301056,4110,789120,1090176
train,1065,118,120832,662,127104,247936
train,1066,259,265216,3190,612480,877696
train,1067,215,220160,2198,422016,642176
train,1068,258,264192,3165,607680,871872
train,1069,233,238592,2581,495552,734144
train,1070,364,372736,6299,1209408,1582144
train,1071,333,340992,5272,1012224,1353216
train,1072,239,244736,2716,521472,766208
train,1073,204,208896,1979,379968,588864
train,1074,129,132096,792,152064,284160
train,1075,251,257024,2996,575232,832256
train,1076,343,351232,5594,1074048,1425280
train,1077,330,337920,5178,994176,1332096
train,1078,180,184320,1541,295872,480192
train,1079,344,352256,5626,1080192,1432448
train,1080,297,304128,4194,805248,1109376
train,1081,247,252928,2901,556992,809920
train,1082,172,176128,1407,270144,446272
train,1083,144,147456,986,189312,336768
train,1084,196,200704,1827,350784,551488
train,1085,165,168960,1295,248640,417600
train,1086,178,182272,1507,289344,471616
train,1087,96,98304,439,84288,182592
train,1088,103,105472,505,96960,202432
train,1089,311,318464,4599,883008,1201472
train,1090,409,418816,7953,1526976,1945792
train,1091,277,283648,3648,700416,984064
train,1092,206,210944,2018,387456,598400
train,1093,536,548864,13659,2622528,3171392
train,1094,209,214016,2077,398784,612800
train,1095,137,140288,893,171456,311744
train,1096,257,263168,3140,602880,866048
train,1097,430,440320,8791,1687872,2128192
train,1098,389,398336,7194,1381248,1779584
train,1099,327,334848,5084,976128,1310976
train,1100,312,319488,4628,888576,1208064
train,1101,188,192512,1681,322752,515264
train,1102,263,269312,3289,631488,900800
train,1103,460,471040,10060,1931520,2402560
train,1104,139,142336,919,176448,318784
train,1105,80,81920,305,58560,140480
train,1106,331,338944,5209,1000128,1339072
train,1107,325,332800,5022,964224,1297024
train,1108,81,82944,312,59904,142848
train,1109,484,495616,11137,2138304,2633920
train,1110,273,279552,3544,680448,960000
train,1111,158,161792,1187,227904,389696
train,1112,304,311296,4394,843648,1154944
train,1113,242,247808,2785,534720,782528
train,1114,289,295936,3971,762432,1058368
train,1115,300,307200,4279,821568,1128768
train,1116,106,108544,535,102720,211264
train,1117,421,431104,8427,1617984,2049088
train,1118,201,205824,1921,368832,574656
train,1119,217,222208,2239,429888,652096
train,1120,287,293888,3916,751872,1045760
train,1121,124,126976,731,140352,267328
train,1122,252,258048,3019,579648,837696
train,1123,132,135168,829,159168,294336
train,1124,76,77824,275,52800,130624
train,1125,285,291840,3862,741504,1033344
train,1126,466,477184,10324,1982208,2459392
train,1127,506,518144,12173,2337216,2855360
train,1128,88,90112,369,70848,160960
train,1129,112,114688,597,114624,229312
train,1130,288,294912,3944,757248,1052160
train,1131,288,294912,3944,757248,1052160
train,1132,252,258048,3019,579648,837696
train,1133,521,533504,12905,2477760,3011264
train,1134,116,118784,640,122880,241664
train,1135,111,113664,586,112512,226176
train,1136,312,319488,4628,888576,1208064
train,1137,334,342016,5304,1018368,1360384
train,1138,390,399360,7231,1388352,1787712
train,1139,103,105472,505,96960,202432
train,1140,391,400384,7269,1395648,1796032
train,1141,131,134144,816,156672,290816
train,1142,155,158720,1143,219456,378176
train,1143,321,328704,4899,940608,1269312
train,1144,270,276480,3466,665472,941952
train,1145,427,437248,8669,1664448,2101696
train,1146,181,185344,1558,299136,484480
train,1147,254,260096,3068,589056,849152
train,1148,190,194560,1717,329664,524224
train,1149,334,342016,5304,1018368,1360384
train,1150,429,439296,8750,1680000,2119296
train,1151,332,339968,5241,1006272,1346240
train,1152,290,296960,3999,767808,1064768
train,1153,245,250880,2854,547968,798848
train,1154,228,233472,2472,474624,708096
train,1155,472,483328,10592,2033664,2516992
train,1156,245,250880,2854,547968,798848
train,1157,311,318464,4599,883008,1201472
train,1158,290,296960,3999,767808,1064768
train,1159,168,172032,1342,257664,429696
train,1160,106,108544,535,102720,211264
train,1161,367,375808,6404,1229568,1605376
train,1162,324,331776,4991,958272,1290048
train,1163,374,382976,6650,1276800,1659776
train,1164,614,628736,17923,3441216,4069952
train,1165,191,195584,1735,333120,528704
train,1166,267,273408,3390,650880,924288
train,1167,185,189440,1628,312576,502016
train,1168,89,91136,377,72384,163520
train,1169,170,174080,1374,263808,437888
train,1170,279,285696,3701,710592,996288
train,1171,214,219136,2178,418176,637312
train,1172,160,163840,1217,233664,397504
train,1173,541,553984,13915,2671680,3225664
train,1174,153,156672,1113,213696,370368
train,1175,367,375808,6404,1229568,1605376
train,1176,287,293888,3916,751872,1045760
train,1177,313,320512,4658,894336,1214848
train,1178,172,176128,1407,270144,446272
train,1179,436,446464,9038,1735296,2181760
train,1180,91,93184,394,75648,168832
train,1181,56,57344,150,28800,86144
train,1182,136,139264,880,168960,308224
train,1183,537,549888,13710,2632320,3182208
train,1184,192,196608,1753,336576,533184
train,1185,268,274432,3415,655680,930112
train,1186,533,545792,13506,2593152,3138944
train,1187,439,449536,9163,1759296,2208832
train,1188,491,502784,11462,2200704,2703488
train,1189,177,181248,1490,286080,467328
train,1190,406,415744,7837,1504704,1920448
train,1191,316,323584,4748,911616,1235200
train,1192,158,161792,1187,227904,389696
train,1193,335,343040,5336,1024512,1367552
train,1194,259,265216,3190,612480,877696
train,1195,236,241664,2648,508416,750080
train,1196,203,207872,1960,376320,584192
train,1197,249,254976,2948,566016,820992
train,1198,248,253952,2924,561408,815360
train,1199,346,354304,5692,1092864,1447168
train,1200,176,180224,1473,282816,463040
train,1201,335,343040,5336,1024512,1367552
train,1202,240,245760,2739,525888,771648
train,1203,408,417792,7914,1519488,1937280
train,1204,271,277504,3492,670464,947968
train,1205,61,62464,177,33984,96448
train,1206,188,192512,1681,322752,515264
train,1207,162,165888,1248,239616,405504
train,1208,266,272384,3364,645888,918272
train,1209,351,359424,5858,1124736,1484160
train,1210,245,250880,2854,547968,798848
train,1211,173,177152,1423,273216,450368
train,1212,269,275456,3441,660672,936128
train,1213,541,553984,13915,2671680,3225664
train,1214,351,359424,5858,1124736,1484160
train,1215,197,201728,1845,354240,555968
train,1216,206,210944,2018,387456,598400
train,1217,358,366592,6093,1169856,1536448
train,1218,393,402432,7343,1409856,1812288
train,1219,236,241664,2648,508416,750080
train,1220,267,273408,3390,650880,924288
train,1221,599,613376,17058,3275136,3888512
train,1222,199,203776,1883,361536,565312
train,1223,216,221184,2219,426048,647232
train,1224,322,329728,4930,946560,1276288
train,1225,81,82944,312,59904,142848
train,1226,364,372736,6299,1209408,1582144
train,1227,321,328704,4899,940608,1269312
train,1228,536,548864,13659,2622528,3171392
train,1229,117,119808,651,124992,244800
train,1230,301,308224,4308,827136,1135360
train,1231,113,115712,608,116736,232448
train,1232,298,305152,4222,810624,1115776
train,1233,333,340992,5272,1012224,1353216
train,1234,263,269312,3289,631488,900800
train,1235,313,320512,4658,894336,1214848
train,1236,95,97280,430,82560,179840
train,1237,356,364544,6026,1156992,1521536
train,1238,198,202752,1864,357888,560640
train,1239,172,176128,1407,270144,446272
train,1240,299,306176,4251,816192,1122368
train,1241,240,245760,2739,525888,771648
train,1242,200,204800,1902,365184,569984
train,1243,147,150528,1028,197376,347904
train,1244,157,160768,1172,225024,385792
train,1245,356,364544,6026,1156992,1521536
train,1246,179,183296,1524,292608,475904
train,1247,331,338944,5209,1000128,1339072
train,1248,58,59392,160,30720,90112
train,1249,260,266240,3214,617088,883328
train,1250,275,281600,3596,690432,972032
train,1251,82,83968,320,61440,145408
train,1252,553,566272,14539,2791488,3357760
train,1253,368,376832,6439,1236288,1613120
train,1254,128,131072,779,149568,280640
train,1255,344,352256,5626,1080192,1432448
train,1256,50,51200,119,22848,74048
train,1257,185,189440,1628,312576,502016
train,1258,152,155648,1099,211008,366656
train,1259,333,340992,5272,1012224,1353216
train,1260,332,339968,5241,1006272,1346240
train,1261,308,315392,4510,865920,1181312
train,1262,335,343040,5336,1024512,1367552
train,1263,303,310272,4365,838080,1148352
train,1264,241,246784,2762,530304,777088
train,1265,270,276480,3466,665472,941952
train,1266,230,235520,2515,482880,718400
train,1267,233,238592,2581,495552,734144
train,1268,320,327680,4869,934848,1262528
train,1269,296,303104,4166,799872,1102976
train,1270,133,136192,841,161472,297664
train,1271,173,177152,1423,273216,450368
train,1272,157,160768,1172,225024,385792
train,1273,266,272384,3364,645888,918272
train,1274,157,160768,1172,225024,385792
train,1275,276,282624,3622,695424,978048
train,1276,137,140288,893,171456,311744
train,1277,258,264192,3165,607680,871872
train,1278,326,333824,5053,970176,1304000
train,1279,242,247808,2785,534720,782528
train,1280,413,422912,8109,1556928,1979840
train,1281,306,313344,4452,854784,1168128
train,1282,223,228352,2365,454080,682432
train,1283,220,225280,2301,441792,667072
train,1284,194,198656,1790,343680,542336
train,1285,187,191488,1663,319296,510784
train,1286,398,407552,7531,1445952,1853504
train,1287,293,300032,4082,783744,1083776
train,1288,104,106496,515,98880,205376
train,1289,219,224256,2281,437952,662208
train,1290,534,546816,13557,2602944,3149760
train,1291,359,367616,6128,1176576,1544192
train,1292,83,84992,328,62976,147968
train,1293,229,234496,2494,478848,713344
train,1294,197,201728,1845,354240,555968
train,1295,226,231424,2429,466368,697792
train,1296,167,171008,1326,254592,425600
train,1297,280,286720,3728,715776,1002496
train,1298,159,162816,1202,230784,393600
train,1299,232,237568,2559,491328,728896
train,1300,315,322560,4718,905856,1228416
train,1301,190,194560,1717,329664,524224
train,1302,315,322560,4718,905856,1228416
train,1303,229,234496,2494,478848,713344
train,1304,155,158720,1143,219456,378176
train,1305,367,375808,6404,1229568,1605376
train,1306,314,321536,4688,900096,1221632
train,1307,161,164864,1233,236736,401600
train,1308,145,148480,1000,192000,340480
train,1309,188,192512,1681,322752,515264
train,1310,191,195584,1735,333120,528704
train,1311,470,481280,10502,2016384,2497664
train,1312,615,629760,17982,3452544,4082304
train,1313,225,230400,2407,462144,692544
train,1314,318,325632,4808,923136,1248768
train,1315,431,441344,8832,1695744,2137088
train,1316,166,169984,1310,251520,421504
train,1317,605,619520,17402,3341184,3960704
train,1318,407,416768,7876,1512192,1928960
train,1319,598,612352,17001,3264192,3876544
train,1320,164,167936,1279,245568,413504
train,1321,374,382976,6650,1276800,1659776
train,1322,213,218112,2157,414144,632256
train,1323,192,196608,1753,336576,533184
train,1324,398,407552,7531,1445952,1853504
train,1325,159,162816,1202,230784,393600
train,1326,394,403456,7381,1417152,1820608
train,1327,272,278528,3518,675456,953984
train,1328,490,501760,11415,2191680,2693440
train,1329,339,347136,5464,1049088,1396224
train,1330,284,290816,3835,736320,1027136
train,1331,105,107520,525,100800,208320
train,1332,271,277504,3492,670464,947968
train,1333,451,461824,9670,1856640,2318464
train,1334,243,248832,2808,539136,787968
train,1335,257,263168,3140,602880,866048
train,1336,301,308224,4308,827136,1135360
train,1337,357,365568,6059,1163328,1528896
train,1338,159,162816,1202,230784,393600
train,1339,395,404480,7418,1424256,1828736
train,1340,464,475136,10236,1965312,2440448
train,1341,335,343040,5336,1024512,1367552
train,1342,206,210944,2018,387456,598400
train,1343,50,51200,119,22848,74048
train,1344,328,335872,5115,982080,1317952
train,1345,248,253952,2924,561408,815360
train,1346,107,109568,545,104640,214208
train,1347,291,297984,4026,772992,1070976
train,1348,247,252928,2901,556992,809920
train,1349,119,121856,674,129408,251264
train,1350,354,362496,5958,1143936,1506432
train,1351,192,196608,1753,336576,533184
train,1352,392,401408,7306,1402752,1804160
train,1353,63,64512,189,36288,100800
train,1354,284,290816,3835,736320,1027136
train,1355,178,182272,1507,289344,471616
train,1356,399,408576,7569,1453248,1861824
train,1357,380,389120,6865,1318080,1707200
train,1358,128,131072,779,149568,280640
train,1359,103,105472,505,96960,202432
train,1360,346,354304,5692,1092864,1447168
train,1361,283,289792,3808,731136,1020928
train,1362,125,128000,743,142656,270656
train,1363,92,94208,403,77376,171584
train,1364,558,571392,14803,2842176,3413568
train,1365,249,254976,2948,566016,820992
train,1366,273,279552,3544,680448,960000
train,1367,214,219136,2178,418176,637312
train,1368,270,276480,3466,665472,941952
train,1369,74,75776,261,50112,125888
train,1370,227,232448,2450,470400,702848
train,1371,218,223232,2260,433920,657152
train,1372,442,452608,9288,1783296,2235904
train,1373,542,555008,13966,2681472,3236480
train,1374,178,182272,1507,289344,471616
train,1375,229,234496,2494,478848,713344
train,1376,357,365568,6059,1163328,1528896
train,1377,357,365568,6059,1163328,1528896
train,1378,340,348160,5496,1055232,1403392
train,1379,223,228352,2365,454080,682432
train,1380,311,318464,4599,883008,1201472
train,1381,270,276480,3466,665472,941952
train,1382,184,188416,1610,309120,497536
train,1383,369,377856,6474,1243008,1620864
train,1384,169,173056,1358,260736,433792
train,1385,208,212992,2057,394944,607936
train,1386,202,206848,1940,372480,579328
train,1387,49,50176,115,22080,72256
train,1388,160,163840,1217,233664,397504
train,1389,307,314368,4481,860352,1174720
train,1390,233,238592,2581,495552,734144
train,1391,414,423936,8149,1564608,1988544
train,1392,431,441344,8832,1695744,2137088
train,1393,101,103424,485,93120,196544
train,1394,280,286720,3728,715776,1002496
train,1395,329,336896,5146,988032,1324928
train,1396,177,181248,1490,286080,467328
train,1397,401,410624,7645,1467840,1878464
train,1398,108,110592,555,106560,217152
train,1399,127,130048,767,147264,277312
train,1400,544,557056,14069,2701248,3258304
train,1401,113,115712,618,118656,234368
train,1402,481,492544,11000,2112000,2604544
train,1403,417,427008,8267,1587264,2014272
train,1404,84,86016,336,64512,150528
train,1405,338,346112,5432,1042944,1389056
train,1406,235,240640,2626,504192,744832
train,1407,384,393216,7011,1346112,1739328
train,1408,356,364544,6026,1156992,1521536
train,1409,323,330752,4960,952320,1283072
train,1410,319,326656,4838,928896,1255552
train,1411,240,245760,2739,525888,771648
train,1412,118,120832,662,127104,247936
train,1413,150,153600,1070,205440,359040
train,1414,260,266240,3214,617088,883328
train,1415,367,375808,6404,1229568,1605376
train,1416,567,580608,15284,2934528,3515136
train,1417,271,277504,3492,670464,947968
train,1418,375,384000,6686,1283712,1667712
train,1419,251,257024,2996,575232,832256
train,1420,439,449536,9163,1759296,2208832
train,1421,291,297984,4026,772992,1070976
train,1422,540,552960,13863,2661696,3214656
train,1423,257,263168,3140,602880,866048
train,1424,339,347136,5464,1049088,1396224
train,1425,337,345088,5400,1036800,1381888
train,1426,483,494592,11091,2129472,2624064
train,1427,304,311296,4394,843648,1154944
train,1428,194,198656,1790,343680,542336
train,1429,200,204800,1902,365184,569984
train,1430,310,317440,4569,877248,1194688
train,1431,261,267264,3239,621888,889152
train,1432,295,302080,4138,794496,1096576
train,1433,400,409600,7607,1460544,1870144
train,1434,360,368640,6162,1183104,1551744
train,1435,230,235520,2515,482880,718400
train,1436,441,451584,9246,1775232,2226816
train,1437,422,432128,8467,1625664,2057792
train,1438,263,269312,3289,631488,900800
train,1439,347,355328,5725,1099200,1454528
train,1440,146,149504,1014,194688,344192
train,1441,325,332800,5022,964224,1297024
train,1442,353,361472,5924,1137408,1498880
train,1443,312,319488,4628,888576,1208064
train,1444,309,316416,4540,871680,1188096
train,1445,79,80896,297,57024,137920
train,1446,344,352256,5626,1080192,1432448
train,1447,259,265216,3190,612480,877696
train,1448,174,178176,1440,276480,454656
train,1449,502,514048,11981,2300352,2814400
train,1450,414,423936,8149,1564608,1988544
train,1451,316,323584,4748,911616,1235200
train,1452,320,327680,4869,934848,1262528
train,1453,358,366592,6093,1169856,1536448
train,1454,292,299008,4054,778368,1077376
train,1455,425,435200,8588,1648896,2084096
train,1456,281,287744,3754,720768,1008512
train,1457,496,507904,11696,2245632,2753536
train,1458,315,322560,4718,905856,1228416
train,1459,225,230400,2407,462144,692544
train,1460,434,444416,8955,1719360,2163776
train,1461,286,292864,3889,746688,1039552
train,1462,436,446464,9038,1735296,2181760
train,1463,184,188416,1610,309120,497536
train,1464,164,167936,1279,245568,413504
train,1465,308,315392,4510,865920,1181312
train,1466,464,475136,10236,1965312,2440448
train,1467,329,336896,5146,988032,1324928
train,1468,313,320512,4658,894336,1214848
train,1469,395,404480,7418,1424256,1828736
train,1470,178,182272,1507,289344,471616
train,1471,74,75776,261,50112,125888
train,1472,391,400384,7269,1395648,1796032
train,1473,593,607232,16718,3209856,3817088
train,1474,392,401408,7306,1402752,1804160
train,1475,269,275456,3441,660672,936128
train,1476,353,361472,5924,1137408,1498880
train,1477,303,310272,4365,838080,1148352
train,1478,182,186368,1575,302400,488768
train,1479,348,356352,5758,1105536,1461888
train,1480,169,173056,1358,260736,433792
train,1481,460,471040,10060,1931520,2402560
train,1482,461,472064,10104,1939968,2412032
train,1483,295,302080,4138,794496,1096576
train,1484,264,270336,3314,636288,906624
train,1485,283,289792,3808,731136,1020928
train,1486,199,203776,1883,361536,565312
train,1487,242,247808,2785,534720,782528
train,1488,456,466944,9886,1898112,2365056
train,1489,193,197632,1771,340032,537664
train,1490,155,158720,1143,219456,378176
train,1491,253,259072,3043,584256,843328
train,1492,360,368640,6162,1183104,1551744
train,1493,178,182272,1507,289344,471616
train,1494,270,276480,3466,665472,941952
train,1495,82,83968,320,61440,145408
train,1496,307,314368,4481,860352,1174720
train,1497,405,414720,7798,1497216,1911936
train,1498,434,444416,8955,1719360,2163776
train,1499,359,367616,6128,1176576,1544192
train,1500,269,275456,3441,660672,936128
train,1501,260,266240,3214,617088,883328
train,1502,359,367616,6128,1176576,1544192
train,1503,428,438272,8709,1672128,2110400
train,1504,141,144384,946,181632,326016
train,1505,99,101376,466,89472,190848
train,1506,469,480256,10458,2007936,2488192
train,1507,357,365568,6059,1163328,1528896
train,1508,458,468992,9973,1914816,2383808
train,1509,378,387072,6793,1304256,1691328
train,1510,534,546816,13557,2602944,3149760
train,1511,381,390144,6902,1325184,1715328
train,1512,384,393216,7011,1346112,1739328
train,1513,432,442368,8873,1703616,2145984
train,1514,204,208896,1979,379968,588864
train,1515,357,365568,6059,1163328,1528896
train,1516,224,229376,2386,458112,687488
train,1517,527,539648,13204,2535168,3074816
train,1518,117,119808,651,124992,244800
train,1519,96,98304,439,84288,182592
train,1520,258,264192,3165,607680,871872
train,1521,433,443392,8914,1711488,2154880
train,1522,300,307200,4279,821568,1128768
train,1523,219,224256,2281,437952,662208
train,1524,252,258048,3019,579648,837696
train,1525,211,216064,2117,406464,622528
train,1526,110,112640,576,110592,223232
train,1527,367,375808,6404,1229568,1605376
train,1528,236,241664,2648,508416,750080
train,1529,288,294912,3944,757248,1052160
train,1530,416,425984,8228,1579776,2005760
train,1531,327,334848,5084,976128,1310976
train,1532,398,407552,7531,1445952,1853504
train,1533,236,241664,2648,508416,750080
train,1534,368,376832,6439,1236288,1613120
train,1535,362,370688,6230,1196160,1566848
train,1536,247,252928,2901,556992,809920
train,1537,380,389120,6865,1318080,1707200
train,1538,368,376832,6439,1236288,1613120
train,1539,217,222208,2239,429888,652096
train,1540,213,218112,2157,414144,632256
train,1541,124,126976,731,140352,267328
train,1542,264,270336,3314,636288,906624
train,1543,172,176128,1407,270144,446272
train,1544,372,380928,6579,1263168,1644096
train,1545,264,270336,3314,636288,906624
train,1546,443,453632,9330,1791360,2244992
train,1547,305,312320,4423,849216,1161536
train,1548,414,423936,8149,1564608,1988544
train,1549,296,303104,4166,799872,1102976
train,1550,476,487424,10772,2068224,2555648
train,1551,543,556032,14018,2691456,3247488
train,1552,486,497664,11229,2155968,2653632
train,1553,223,228352,2365,454080,682432
train,1554,125,128000,743,142656,270656
train,1555,478,489472,10863,2085696,2575168
train,1556,351,359424,5858,1124736,1484160
train,1557,520,532480,12855,2468160,3000640
train,1558,258,264192,3165,607680,871872
train,1559,285,291840,3862,741504,1033344
train,1560,368,376832,6439,1236288,1613120
train,1561,279,285696,3701,710592,996288
train,1562,317,324608,4778,917376,1241984
train,1563,241,246784,2762,530304,777088
train,1564,115,117760,629,120768,238528
train,1565,319,326656,4838,928896,1255552
train,1566,73,74752,254,48768,123520
train,1567,520,532480,12855,2468160,3000640
train,1568,288,294912,3944,757248,1052160
train,1569,321,328704,4899,940608,1269312
train,1570,407,416768,7876,1512192,1928960
train,1571,325,332800,5022,964224,1297024
train,1572,222,227328,2343,449856,677184
train,1573,276,282624,3622,695424,978048
train,1574,206,210944,2018,387456,598400
train,1575,176,180224,1473,282816,463040
train,1576,299,306176,4251,816192,1122368
train,1577,328,335872,5115,982080,1317952
train,1578,221,226304,2322,445824,672128
train,1579,104,106496,515,98880,205376
train,1580,181,185344,1558,299136,484480
train,1581,363,371712,6265,1202880,1574592
train,1582,193,197632,1771,340032,537664
train,1583,214,219136,2178,418176,637312
train,1584,89,91136,377,72384,163520
train,1585,307,314368,4481,860352,1174720
train,1586,237,242688,2671,512832,755520
train,1587,184,188416,1610,309120,497536
train,1588,469,480256,10458,2007936,2488192
train,1589,147,150528,1028,197376,347904
train,1590,419,429056,8347,1602624,2031680
train,1591,371,379904,6544,1256448,1636352
train,1592,364,372736,6299,1209408,1582144
train,1593,220,225280,2301,441792,667072
train,1594,358,366592,6093,1169856,1536448
train,1595,220,225280,2301,441792,667072
train,1596,171,175104,1391,267072,442176
train,1597,161,164864,1233,236736,401600
train,1598,210,215040,2097,402624,617664
train,1599,191,195584,1735,333120,528704
train,1600,316,323584,4748,911616,1235200
train,1601,309,316416,4540,871680,1188096
train,1602,127,130048,767,147264,277312
train,1603,422,432128,8467,1625664,2057792
train,1604,334,342016,5304,1018368,1360384
train,1605,289,295936,3971,762432,1058368
train,1606,459,470016,10016,1923072,2393088
train,1607,342,350208,5561,1067712,1417920
train,1608,446,456704,9457,1815744,2272448
train,1609,238,243712,2693,517056,760768
train,1610,200,204800,1902,365184,569984
train,1611,192,196608,1753,336576,533184
train,1612,99,101376,466,89472,190848
train,1613,156,159744,1157,222144,381888
train,1614,556,569344,14697,2821824,3391168
train,1615,256,262144,3116,598272,860416
train,1616,114,116736,618,118656,235392
train,1617,675,691200,21661,4158912,4850112
train,1618,437,447488,9079,1743168,2190656
train,1619,280,286720,3728,715776,1002496
train,1620,278,284672,3675,705600,990272
train,1621,347,355328,5725,1099200,1454528
train,1622,292,299008,4054,778368,1077376
train,1623,226,231424,2429,466368,697792
train,1624,298,305152,4222,810624,1115776
train,1625,300,307200,4279,821568,1128768
train,1626,356,364544,6026,1156992,1521536
train,1627,286,292864,3889,746688,1039552
train,1628,176,180224,1473,282816,463040
train,1629,215,220160,2198,422016,642176
train,1630,425,435200,8588,1648896,2084096
train,1631,132,135168,829,159168,294336
train,1632,284,290816,3835,736320,1027136
train,1633,190,194560,1717,329664,524224
train,1634,487,498688,11276,2164992,2663680
train,1635,70,71680,233,44736,116416
train,1636,238,243712,2693,517056,760768
train,1637,378,387072,6793,1304256,1691328
train,1638,340,348160,5496,1055232,1403392
train,1639,377,386048,6757,1297344,1683392
train,1640,247,252928,2901,556992,809920
train,1641,291,297984,4026,772992,1070976
train,1642,188,192512,1681,322752,515264
train,1643,362,370688,6230,1196160,1566848
train,1644,246,251904,2877,552384,804288
train,1645,290,296960,3999,767808,1064768
train,1646,419,429056,8347,1602624,2031680
train,1647,113,115712,608,116736,232448
train,1648,306,313344,4452,854784,1168128
train,1649,398,407552,7531,1445952,1853504
train,1650,158,161792,1187,227904,389696
train,1651,380,389120,6865,1318080,1707200
train,1652,165,168960,1295,248640,417600
train,1653,343,351232,5594,1074048,1425280
train,1654,418,428032,8307,1594944,2022976
train,1655,247,252928,2901,556992,809920
train,1656,241,246784,2762,530304,777088
train,1657,384,393216,7011,1346112,1739328
train,1658,201,205824,1921,368832,574656
train,1659,169,173056,1358,260736,433792
train,1660,368,376832,6439,1236288,1613120
train,1661,96,98304,439,84288,182592
train,1662,167,171008,1326,254592,425600
train,1663,410,419840,7992,1534464,1954304
train,1664,317,324608,4778,917376,1241984
train,1665,381,390144,6902,1325184,1715328
train,1666,401,410624,7645,1467840,1878464
train,1667,337,345088,5400,1036800,1381888
train,1668,236,241664,2648,508416,750080
train,1669,466,477184,10324,1982208,2459392
train,1670,116,118784,640,122880,241664
train,1671,216,221184,2219,426048,647232
train,1672,239,244736,2716,521472,766208
train,1673,256,262144,3116,598272,860416
train,1674,215,220160,2198,422016,642176
train,1675,266,272384,3364,645888,918272
train,1676,333,340992,5272,1012224,1353216
train,1677,347,355328,5725,1099200,1454528
train,1678,362,370688,6230,1196160,1566848
train,1679,55,56320,144,27648,83968
train,1680,88,90112,369,70848,160960
train,1681,77,78848,290,55680,134528
train,1682,239,244736,2716,521472,766208
train,1683,373,381952,6615,1270080,1652032
train,1684,276,282624,3622,695424,978048
train,1685,320,327680,4869,934848,1262528
train,1686,485,496640,11183,2147136,2643776
train,1687,236,241664,2648,508416,750080
train,1688,305,312320,4423,849216,1161536
train,1689,401,410624,7645,1467840,1878464
train,1690,290,296960,3999,767808,1064768
train,1691,405,414720,7798,1497216,1911936
train,1692,241,246784,2762,530304,777088
train,1693,296,303104,4166,799872,1102976
train,1694,207,211968,2038,391296,603264
train,1695,69,70656,227,43584,114240
train,1696,67,68608,214,41088,109696
train,1697,217,222208,2239,429888,652096
train,1698,491,502784,11462,2200704,2703488
train,1699,329,336896,5146,988032,1324928
train,1700,268,274432,3415,655680,930112
train,1701,343,351232,5594,1074048,1425280
train,1702,302,309248,4336,832512,1141760
train,1703,341,349184,5529,1061568,1410752
train,1704,469,480256,10458,2007936,2488192
train,1705,385,394240,7047,1353024,1747264
train,1706,86,88064,352,67584,155648
train,1707,209,214016,2077,398784,612800
train,1708,100,102400,476,91392,193792
train,1709,329,336896,5146,988032,1324928
train,1710,428,438272,8709,1672128,2110400
train,1711,224,229376,2386,458112,687488
train,1712,135,138240,867,166464,304704
train,1713,424,434176,8547,1641024,2075200
train,1714,441,451584,9246,1775232,2226816
train,1715,128,131072,779,149568,280640
train,1716,426,436224,8628,1656576,2092800
train,1717,171,175104,1391,267072,442176
train,1718,167,171008,1326,254592,425600
train,1719,397,406528,7493,1438656,1845184
train,1720,566,579584,15230,2924160,3503744
train,1721,311,318464,4599,883008,1201472
train,1722,271,277504,3492,670464,947968
train,1723,406,415744,7837,1504704,1920448
train,1724,382,391168,6938,1332096,1723264
train,1725,434,444416,8955,1719360,2163776
train,1726,317,324608,4778,917376,1241984
train,1727,392,401408,7306,1402752,1804160
train,1728,207,211968,2038,391296,603264
train,1729,174,178176,1440,276480,454656
train,1730,252,258048,3019,579648,837696
train,1731,91,93184,403,77376,170560
train,1732,367,375808,6404,1229568,1605376
train,1733,370,378880,6509,1249728,1628608
train,1734,209,214016,2077,398784,612800
train,1735,109,111616,565,108480,220096
train,1736,348,356352,5758,1105536,1461888
train,1737,627,642048,18690,3588480,4230528
train,1738,377,386048,6757,1297344,1683392
train,1739,133,136192,841,161472,297664
train,1740,294,301056,4110,789120,1090176
train,1741,348,356352,5758,1105536,1461888
train,1742,249,254976,2948,566016,820992
train,1743,528,540672,13254,2544768,3085440
train,1744,203,207872,1960,376320,584192
train,1745,253,259072,3043,584256,843328
train,1746,110,112640,576,110592,223232
train,1747,273,279552,3544,680448,960000
train,1748,366,374784,6369,1222848,1597632
train,1749,190,194560,1717,329664,524224
train,1750,510,522240,12366,2374272,2896512
train,1751,220,225280,2301,441792,667072
train,1752,51,52224,124,23808,76032
train,1753,214,219136,2178,418176,637312
train,1754,302,309248,4336,832512,1141760
train,1755,146,149504,1014,194688,344192
train,1756,122,124928,708,135936,260864
train,1757,344,352256,5626,1080192,1432448
train,1758,172,176128,1407,270144,446272
train,1759,165,168960,1295,248640,417600
train,1760,369,377856,6474,1243008,1620864
train,1761,204,208896,1979,379968,588864
train,1762,148,151552,1042,200064,351616
train,1763,199,203776,1883,361536,565312
train,1764,246,251904,2877,552384,804288
train,1765,106,108544,535,102720,211264
train,1766,285,291840,3862,741504,1033344
train,1767,231,236544,2537,487104,723648
train,1768,416,425984,8228,1579776,2005760
train,1769,225,230400,2407,462144,692544
train,1770,335,343040,5336,1024512,1367552
train,1771,350,358400,5824,1118208,1476608
train,1772,475,486400,10727,2059584,2545984
train,1773,651,666624,20148,3868416,4535040
train,1774,251,257024,2996,575232,832256
train,1775,154,157696,1128,216576,374272
train,1776,277,283648,3648,700416,984064
train,1777,420,430080,8387,1610304,2040384
train,1778,174,178176,1440,276480,454656
train,1779,364,372736,6299,1209408,1582144
train,1780,156,159744,1157,222144,381888
train,1781,253,259072,3043,584256,843328
train,1782,579,592896,15938,3060096,3652992
train,1783,417,427008,8267,1587264,2014272
train,1784,163,166912,1264,242688,409600
train,1785,327,334848,5084,976128,1310976
train,1786,607,621568,17517,3363264,3984832
train,1787,152,155648,1099,211008,366656
train,1788,378,387072,6793,1304256,1691328
train,1789,377,386048,6757,1297344,1683392
train,1790,239,244736,2716,521472,766208
train,1791,225,230400,2407,462144,692544
train,1792,314,321536,4688,900096,1221632
train,1793,269,275456,3441,660672,936128
train,1794,260,266240,3214,617088,883328
train,1795,174,178176,1440,276480,454656
train,1796,134,137216,854,163968,301184
train,1797,108,110592,555,106560,217152
train,1798,236,241664,2648,508416,750080
train,1799,423,433152,8507,1633344,2066496
train,1800,321,328704,4899,940608,1269312
train,1801,413,422912,8109,1556928,1979840
train,1802,364,372736,6299,1209408,1582144
train,1803,412,421888,8070,1549440,1971328
train,1804,452,462848,9713,1864896,2327744
train,1805,282,288768,3781,725952,1014720
train,1806,216,221184,2219,426048,647232
train,1807,296,303104,4166,799872,1102976
train,1808,497,508928,11743,2254656,2763584
train,1809,82,83968,320,61440,145408
train,1810,394,403456,7381,1417152,1820608
train,1811,212,217088,2137,410304,627392
train,1812,397,406528,7493,1438656,1845184
train,1813,220,225280,2301,441792,667072
train,1814,134,137216,854,163968,301184
train,1815,253,259072,3043,584256,843328
train,1816,244,249856,2831,543552,793408
train,1817,163,166912,1264,242688,409600
train,1818,87,89088,360,69120,158208
train,1819,202,206848,1940,372480,579328
train,1820,74,75776,261,50112,125888
train,1821,445,455680,9415,1807680,2263360
train,1822,123,125952,720,138240,264192
train,1823,257,263168,3140,602880,866048
train,1824,323,330752,4960,952320,1283072
train,1825,266,272384,3364,645888,918272
train,1826,375,384000,6686,1283712,1667712
train,1827,280,286720,3728,715776,1002496
train,1828,122,124928,708,135936,260864
train,1829,413,422912,8109,1556928,1979840
train,1830,431,441344,8832,1695744,2137088
train,1831,424,434176,8547,1641024,2075200
train,1832,401,410624,7645,1467840,1878464
train,1833,214,219136,2178,418176,637312
train,1834,137,140288,893,171456,311744
train,1835,454,464896,9799,1881408,2346304
train,1836,419,429056,8347,1602624,2031680
train,1837,387,396288,7121,1367232,1763520
train,1838,514,526336,12561,2411712,2938048
train,1839,409,418816,7953,1526976,1945792
train,1840,140,143360,932,178944,322304
train,1841,252,258048,3019,579648,837696
train,1842,371,379904,6544,1256448,1636352
train,1843,388,397312,7157,1374144,1771456
train,1844,196,200704,1827,350784,551488
train,1845,311,318464,4599,883008,1201472
train,1846,264,270336,3314,636288,906624
train,1847,245,250880,2854,547968,798848
train,1848,434,444416,8955,1719360,2163776
train,1849,387,396288,7121,1367232,1763520
train,1850,252,258048,3019,579648,837696
train,1851,291,297984,4026,772992,1070976
train,1852,297,304128,4194,805248,1109376
train,1853,326,333824,5053,970176,1304000
train,1854,279,285696,3701,710592,996288
train,1855,263,269312,3289,631488,900800
train,1856,355,363520,5992,1150464,1513984
train,1857,102,104448,495,95040,199488
train,1858,435,445440,8996,1727232,2172672
train,1859,233,238592,2581,495552,734144
train,1860,160,163840,1217,233664,397504
train,1861,426,436224,8628,1656576,2092800
train,1862,275,281600,3596,690432,972032
train,1863,235,240640,2626,504192,744832
train,1864,378,387072,6793,1304256,1691328
train,1865,209,214016,2077,398784,612800
train,1866,191,195584,1735,333120,528704
train,1867,380,389120,6865,1318080,1707200
train,1868,214,219136,2178,418176,637312
train,1869,343,351232,5594,1074048,1425280
train,1870,81,82944,312,59904,142848
train,1871,224,229376,2386,458112,687488
train,1872,395,404480,7418,1424256,1828736
train,1873,673,689152,21533,4134336,4823488
train,1874,343,351232,5594,1074048,1425280
train,1875,430,440320,8791,1687872,2128192
train,1876,236,241664,2648,508416,750080
train,1877,216,221184,2219,426048,647232
train,1878,152,155648,1099,211008,366656
train,1879,45,46080,97,18624,64704
train,1880,284,290816,3835,736320,1027136
train,1881,149,152576,1056,202752,355328
train,1882,159,162816,1202,230784,393600
train,1883,187,191488,1663,319296,510784
train,1884,181,185344,1558,299136,484480
train,1885,111,113664,586,112512,226176
train,1886,163,166912,1264,242688,409600
train,1887,166,169984,1310,251520,421504
train,1888,617,631808,18099,3475008,4106816
train,1889,75,76800,268,51456,128256
train,1890,273,279552,3544,680448,960000
train,1891,160,163840,1217,233664,397504
train,1892,337,345088,5400,1036800,1381888
train,1893,229,234496,2494,478848,713344
train,1894,226,231424,2429,466368,697792
train,1895,148,151552,1042,200064,351616
train,1896,168,172032,1342,257664,429696
train,1897,408,417792,7914,1519488,1937280
train,1898,388,397312,7157,1374144,1771456
train,1899,395,404480,7418,1424256,1828736
train,1900,552,565248,14486,2781312,3346560
train,1901,334,342016,5304,1018368,1360384
train,1902,260,266240,3214,617088,883328
train,1903,315,322560,4718,905856,1228416
train,1904,310,317440,4569,877248,1194688
train,1905,200,204800,1902,365184,569984
train,1906,406,415744,7837,1504704,1920448
train,1907,436,446464,9038,1735296,2181760
train,1908,315,322560,4718,905856,1228416
train,1909,311,318464,4599,883008,1201472
train,1910,419,429056,8347,1602624,2031680
train,1911,317,324608,4778,917376,1241984
train,1912,430,440320,8791,1687872,2128192
train,1913,375,384000,6686,1283712,1667712
train,1914,456,466944,9886,1898112,2365056
train,1915,554,567296,14591,2801472,3368768
train,1916,488,499712,11322,2173824,2673536
train,1917,449,459776,9585,1840320,2300096
train,1918,226,231424,2429,466368,697792
train,1919,120,122880,685,131520,254400
train,1920,253,259072,3043,584256,843328
train,1921,289,295936,3971,762432,1058368
train,1922,170,174080,1374,263808,437888
train,1923,458,468992,9973,1914816,2383808
train,1924,181,185344,1558,299136,484480
train,1925,200,204800,1902,365184,569984
train,1926,361,369664,6196,1189632,1559296
train,1927,369,377856,6474,1243008,1620864
train,1928,353,361472,5924,1137408,1498880
train,1929,411,420864,8031,1541952,1962816
train,1930,242,247808,2785,534720,782528
train,1931,219,224256,2281,437952,662208
train,1932,501,513024,11933,2291136,2804160
train,1933,324,331776,4991,958272,1290048
train,1934,373,381952,6615,1270080,1652032
train,1935,122,124928,708,135936,260864
train,1936,321,328704,4899,940608,1269312
train,1937,233,238592,2581,495552,734144
train,1938,234,239616,2604,499968,739584
train,1939,142,145408,959,184128,329536
train,1940,422,432128,8467,1625664,2057792
train,1941,148,151552,1042,200064,351616
train,1942,328,335872,5115,982080,1317952
train,1943,458,468992,9973,1914816,2383808
train,1944,86,88064,352,67584,155648
train,1945,255,261120,3092,593664,854784
train,1946,66,67584,208,39936,107520
train,1947,112,114688,597,114624,229312
train,1948,398,407552,7531,1445952,1853504
train,1949,403,412672,7722,1482624,1895296
train,1950,377,386048,6757,1297344,1683392
train,1951,116,118784,640,122880,241664
train,1952,272,278528,3518,675456,953984
train,1953,330,337920,5178,994176,1332096
train,1954,467,478208,10369,1990848,2469056
train,1955,71,72704,240,46080,118784
train,1956,391,400384,7269,1395648,1796032
train,1957,139,142336,919,176448,318784
train,1958,322,329728,4930,946560,1276288
train,1959,237,242688,2671,512832,755520
train,1960,174,178176,1440,276480,454656
train,1961,496,507904,11696,2245632,2753536
train,1962,175,179200,1456,279552,458752
train,1963,209,214016,2077,398784,612800
train,1964,227,232448,2450,470400,702848
train,1965,172,176128,1407,270144,446272
train,1966,457,467968,9929,1906368,2374336
train,1967,706,722944,23697,4549824,5272768
train,1968,223,228352,2365,454080,682432
train,1969,243,248832,2808,539136,787968
train,1970,274,280576,3570,685440,966016
train,1971,231,236544,2537,487104,723648
train,1972,333,340992,5272,1012224,1353216
train,1973,104,106496,515,98880,205376
train,1974,117,119808,651,124992,244800
train,1975,171,175104,1391,267072,442176
train,1976,244,249856,2831,543552,793408
train,1977,102,104448,495,95040,199488
train,1978,467,478208,10369,1990848,2469056
train,1979,402,411648,7683,1475136,1886784
train,1980,400,409600,7607,1460544,1870144
train,1981,288,294912,3944,757248,1052160
train,1982,638,653312,19352,3715584,4368896
train,1983,159,162816,1202,230784,393600
train,1984,318,325632,4808,923136,1248768
train,1985,427,437248,8669,1664448,2101696
train,1986,350,358400,5824,1118208,1476608
train,1987,212,217088,2137,410304,627392
train,1988,164,167936,1279,245568,413504
train,1989,155,158720,1143,219456,378176
train,1990,220,225280,2301,441792,667072
train,1991,118,120832,662,127104,247936
train,1992,376,385024,6722,1290624,1675648
train,1993,180,184320,1541,295872,480192
train,1994,325,332800,5022,964224,1297024
train,1995,231,236544,2537,487104,723648
train,1996,274,280576,3570,685440,966016
train,1997,153,156672,1113,213696,370368
train,1998,279,285696,3701,710592,996288
train,1999,383,392192,6974,1339008,1731200
train,2000,211,216064,2117,406464,622528
train,2001,207,211968,2038,391296,603264
train,2002,519,531456,12806,2458752,2990208
train,2003,261,267264,3239,621888,889152
train,2004,371,379904,6544,1256448,1636352
train,2005,227,232448,2450,470400,702848
train,2006,304,311296,4394,843648,1154944
train,2007,175,179200,1456,279552,458752
train,2008,109,111616,565,108480,220096
train,2009,507,519168,12221,2346432,2865600
train,2010,354,362496,5958,1143936,1506432
train,2011,373,381952,6615,1270080,1652032
train,2012,181,185344,1558,299136,484480
train,2013,384,393216,7011,1346112,1739328
train,2014,200,204800,1902,365184,569984
train,2015,157,160768,1172,225024,385792
train,2016,372,380928,6579,1263168,1644096
train,2017,83,84992,328,62976,147968
train,2018,63,64512,189,36288,100800
train,2019,265,271360,3339,641088,912448
train,2020,373,381952,6615,1270080,1652032
train,2021,380,389120,6865,1318080,1707200
train,2022,234,239616,2604,499968,739584
train,2023,344,352256,5626,1080192,1432448
train,2024,256,262144,3116,598272,860416
train,2025,362,370688,6230,1196160,1566848
train,2026,478,489472,10863,2085696,2575168
train,2027,155,158720,1143,219456,378176
train,2028,402,411648,7683,1475136,1886784
train,2029,583,596992,16159,3102528,3699520
train,2030,340,348160,5496,1055232,1403392
train,2031,385,394240,7047,1353024,1747264
train,2032,46,47104,101,19392,66496
train,2033,87,89088,360,69120,158208
train,2034,561,574464,14963,2872896,3447360
train,2035,218,223232,2260,433920,657152
train,2036,431,441344,8832,1695744,2137088
train,2037,298,305152,4222,810624,1115776
train,2038,305,312320,4423,849216,1161536
train,2039,333,340992,5272,1012224,1353216
train,2040,247,252928,2901,556992,809920
train,2041,253,259072,3043,584256,843328
train,2042,233,238592,2581,495552,734144
train,2043,189,193536,1699,326208,519744
train,2044,227,232448,2450,470400,702848
train,2045,99,101376,466,89472,190848
train,2046,190,194560,1717,329664,524224
train,2047,549,562176,14329,2751168,3313344
train,2048,361,369664,6196,1189632,1559296
train,2049,371,379904,6544,1256448,1636352
train,2050,277,283648,3648,700416,984064
train,2051,354,362496,5958,1143936,1506432
train,2052,242,247808,2785,534720,782528
train,2053,375,384000,6686,1283712,1667712
train,2054,358,366592,6093,1169856,1536448
train,2055,92,94208,403,77376,171584
train,2056,377,386048,6757,1297344,1683392
train,2057,374,382976,6650,1276800,1659776
train,2058,222,227328,2343,449856,677184
train,2059,264,270336,3314,636288,906624
train,2060,352,360448,5891,1131072,1491520
train,2061,239,244736,2716,521472,766208
train,2062,231,236544,2537,487104,723648
train,2063,324,331776,4991,958272,1290048
train,2064,213,218112,2157,414144,632256
train,2065,125,128000,743,142656,270656
train,2066,218,223232,2260,433920,657152
train,2067,221,226304,2322,445824,672128
train,2068,414,423936,8149,1564608,1988544
train,2069,418,428032,8307,1594944,2022976
train,2070,340,348160,5496,1055232,1403392
train,2071,529,541696,13304,2554368,3096064
train,2072,247,252928,2901,556992,809920
train,2073,324,331776,4991,958272,1290048
train,2074,248,253952,2924,561408,815360
train,2075,94,96256,421,80832,177088
train,2076,132,135168,829,159168,294336
train,2077,356,364544,6026,1156992,1521536
train,2078,512,524288,12463,2392896,2917184
train,2079,151,154624,1084,208128,362752
train,2080,146,149504,1014,194688,344192
train,2081,453,463872,9756,1873152,2337024
train,2082,418,428032,8307,1594944,2022976
train,2083,181,185344,1558,299136,484480
train,2084,340,348160,5496,1055232,1403392
train,2085,408,417792,7914,1519488,1937280
train,2086,132,135168,829,159168,294336
train,2087,190,194560,1717,329664,524224
train,2088,287,293888,3916,751872,1045760
train,2089,557,570368,14750,2832000,3402368
train,2090,280,286720,3728,715776,1002496
train,2091,436,446464,9038,1735296,2181760
train,2092,144,147456,986,189312,336768
train,2093,246,251904,2877,552384,804288
train,2094,450,460800,9627,1848384,2309184
train,2095,438,448512,9121,1751232,2199744
train,2096,301,308224,4308,827136,1135360
train,2097,372,380928,6579,1263168,1644096
train,2098,372,380928,6579,1263168,1644096
train,2099,393,402432,7343,1409856,1812288
train,2100,253,259072,3043,584256,843328
train,2101,119,121856,674,129408,251264
train,2102,238,243712,2693,517056,760768
train,2103,156,159744,1157,222144,381888
train,2104,408,417792,7914,1519488,1937280
train,2105,271,277504,3492,670464,947968
train,2106,350,358400,5824,1118208,1476608
train,2107,213,218112,2157,414144,632256
train,2108,225,230400,2407,462144,692544
train,2109,344,352256,5626,1080192,1432448
train,2110,204,208896,1979,379968,588864
train,2111,151,154624,1084,208128,362752
train,2112,417,427008,8267,1587264,2014272
train,2113,206,210944,2018,387456,598400
train,2114,272,278528,3518,675456,953984
train,2115,283,289792,3808,731136,1020928
train,2116,150,153600,1070,205440,359040
train,2117,472,483328,10592,2033664,2516992
train,2118,330,337920,5178,994176,1332096
train,2119,380,389120,6865,1318080,1707200
train,2120,383,392192,6974,1339008,1731200
train,2121,470,481280,10502,2016384,2497664
train,2122,315,322560,4718,905856,1228416
train,2123,85,87040,344,66048,153088
train,2124,181,185344,1558,299136,484480
train,2125,318,325632,4808,923136,1248768
train,2126,427,437248,8669,1664448,2101696
train,2127,95,97280,430,82560,179840
train,2128,131,134144,816,156672,290816
train,2129,251,257024,2996,575232,832256
train,2130,173,177152,1423,273216,450368
train,2131,140,143360,932,178944,322304
train,2132,359,367616,6128,1176576,1544192
train,2133,353,361472,5924,1137408,1498880
train,2134,127,130048,767,147264,277312
train,2135,340,348160,5496,1055232,1403392
train,2136,205,209920,1998,383616,593536
train,2137,408,417792,7914,1519488,1937280
train,2138,532,544768,13456,2583552,3128320
train,2139,208,212992,2057,394944,607936
train,2140,281,287744,3754,720768,1008512
train,2141,132,135168,829,159168,294336
train,2142,123,125952,720,138240,264192
train,2143,329,336896,5146,988032,1324928
train,2144,286,292864,3889,746688,1039552
train,2145,339,347136,5464,1049088,1396224
train,2146,430,440320,8791,1687872,2128192
train,2147,140,143360,932,178944,322304
train,2148,145,148480,1000,192000,340480
train,2149,479,490496,10908,2094336,2584832
train,2150,171,175104,1391,267072,442176
train,2151,76,77824,275,52800,130624
train,2152,110,112640,576,110592,223232
train,2153,222,227328,2343,449856,677184
train,2154,293,300032,4082,783744,1083776
train,2155,550,563200,14382,2761344,3324544
train,2156,115,117760,629,120768,238528
train,2157,122,124928,708,135936,260864
train,2158,386,395264,7084,1360128,1755392
train,2159,271,277504,3492,670464,947968
train,2160,175,179200,1456,279552,458752
train,2161,289,295936,3971,762432,1058368
train,2162,311,318464,4599,883008,1201472
train,2163,231,236544,2537,487104,723648
train,2164,223,228352,2365,454080,682432
train,2165,102,104448,495,95040,199488
train,2166,83,84992,328,62976,147968
train,2167,217,222208,2239,429888,652096
train,2168,190,194560,1717,329664,524224
train,2169,292,299008,4054,778368,1077376
train,2170,182,186368,1575,302400,488768
train,2171,371,379904,6544,1256448,1636352
train,2172,197,201728,1845,354240,555968
train,2173,221,226304,2322,445824,672128
train,2174,156,159744,1157,222144,381888
train,2175,300,307200,4279,821568,1128768
train,2176,249,254976,2948,566016,820992
train,2177,716,733184,24373,4679616,5412800
train,2178,335,343040,5336,1024512,1367552
train,2179,231,236544,2537,487104,723648
train,2180,280,286720,3728,715776,1002496
train,2181,226,231424,2429,466368,697792
train,2182,268,274432,3415,655680,930112
train,2183,297,304128,4194,805248,1109376
train,2184,243,248832,2808,539136,787968
train,2185,124,126976,731,140352,267328
train,2186,367,375808,6404,1229568,1605376
train,2187,316,323584,4748,911616,1235200
train,2188,112,114688,597,114624,229312
train,2189,436,446464,9038,1735296,2181760
train,2190,202,206848,1940,372480,579328
train,2191,275,281600,3596,690432,972032
train,2192,248,253952,2924,561408,815360
train,2193,412,421888,8070,1549440,1971328
train,2194,456,466944,9886,1898112,2365056
train,2195,473,484352,10637,2042304,2526656
train,2196,396,405504,7456,1431552,1837056
train,2197,134,137216,854,163968,301184
train,2198,178,182272,1507,289344,471616
train,2199,306,313344,4452,854784,1168128
train,2200,291,297984,4026,772992,1070976
train,2201,466,477184,10324,1982208,2459392
train,2202,252,258048,3019,579648,837696
train,2203,412,421888,8070,1549440,1971328
train,2204,299,306176,4251,816192,1122368
train,2205,322,329728,4930,946560,1276288
train,2206,268,274432,3415,655680,930112
train,2207,105,107520,525,100800,208320
train,2208,259,265216,3190,612480,877696
train,2209,395,404480,7418,1424256,1828736
train,2210,234,239616,2604,499968,739584
train,2211,309,316416,4540,871680,1188096
train,2212,176,180224,1473,282816,463040
train,2213,249,254976,2948,566016,820992
train,2214,234,239616,2604,499968,739584
train,2215,198,202752,1864,357888,560640
train,2216,406,415744,7837,1504704,1920448
train,2217,199,203776,1883,361536,565312
train,2218,413,422912,8109,1556928,1979840
train,2219,381,390144,6902,1325184,1715328
train,2220,365,373760,6334,1216128,1589888
train,2221,462,473088,10148,1948416,2421504
train,2222,71,72704,240,46080,118784
train,2223,220,225280,2301,441792,667072
train,2224,434,444416,8955,1719360,2163776
train,2225,375,384000,6686,1283712,1667712
train,2226,292,299008,4054,778368,1077376
train,2227,88,90112,369,70848,160960
train,2228,270,276480,3466,665472,941952
train,2229,246,251904,2877,552384,804288
train,2230,304,311296,4394,843648,1154944
train,2231,219,224256,2281,437952,662208
train,2232,69,70656,227,43584,114240
train,2233,405,414720,7798,1497216,1911936
train,2234,389,398336,7194,1381248,1779584
train,2235,106,108544,535,102720,211264
train,2236,405,414720,7798,1497216,1911936
train,2237,139,142336,919,176448,318784
train,2238,228,233472,2472,474624,708096
train,2239,163,166912,1264,242688,409600
train,2240,189,193536,1699,326208,519744
train,2241,193,197632,1771,340032,537664
train,2242,239,244736,2716,521472,766208
train,2243,268,274432,3415,655680,930112
train,2244,230,235520,2515,482880,718400
train,2245,403,412672,7722,1482624,1895296
train,2246,230,235520,2515,482880,718400
train,2247,226,231424,2429,466368,697792
train,2248,418,428032,8307,1594944,2022976
train,2249,319,326656,4838,928896,1255552
train,2250,495,506880,11649,2236608,2743488
train,2251,92,94208,403,77376,171584
train,2252,242,247808,2785,534720,782528
train,2253,194,198656,1790,343680,542336
train,2254,419,429056,8347,1602624,2031680
train,2255,478,489472,10863,2085696,2575168
train,2256,260,266240,3214,617088,883328
train,2257,360,368640,6162,1183104,1551744
train,2258,284,290816,3835,736320,1027136
train,2259,432,442368,8873,1703616,2145984
train,2260,208,212992,2057,394944,607936
train,2261,447,457728,9500,1824000,2281728
train,2262,383,392192,6974,1339008,1731200
train,2263,139,142336,919,176448,318784
train,2264,313,320512,4658,894336,1214848
train,2265,363,371712,6265,1202880,1574592
train,2266,558,571392,14803,2842176,3413568
train,2267,239,244736,2716,521472,766208
train,2268,136,139264,880,168960,308224
train,2269,162,165888,1248,239616,405504
train,2270,269,275456,3441,660672,936128
train,2271,261,267264,3239,621888,889152
train,2272,240,245760,2739,525888,771648
train,2273,98,100352,457,87744,188096
train,2274,302,309248,4336,832512,1141760
train,2275,290,296960,3999,767808,1064768
train,2276,407,416768,7876,1512192,1928960
train,2277,342,350208,5561,1067712,1417920
train,2278,557,570368,14750,2832000,3402368
train,2279,329,336896,5146,988032,1324928
train,2280,293,300032,4082,783744,1083776
train,2281,445,455680,9415,1807680,2263360
train,2282,377,386048,6757,1297344,1683392
train,2283,454,464896,9799,1881408,2346304
train,2284,219,224256,2281,437952,662208
train,2285,564,577536,15123,2903616,3481152
train,2286,236,241664,2648,508416,750080
train,2287,332,339968,5241,1006272,1346240
train,2288,260,266240,3214,617088,883328
train,2289,230,235520,2515,482880,718400
train,2290,53,54272,134,25728,80000
train,2291,357,365568,6059,1163328,1528896
train,2292,106,108544,535,102720,211264
train,2293,266,272384,3364,645888,918272
train,2294,345,353280,5659,1086528,1439808
train,2295,117,119808,651,124992,244800
train,2296,366,374784,6369,1222848,1597632
train,2297,190,194560,1717,329664,524224
train,2298,308,315392,4510,865920,1181312
train,2299,287,293888,3916,751872,1045760
train,2300,238,243712,2693,517056,760768
train,2301,263,269312,3289,631488,900800
train,2302,229,234496,2494,478848,713344
train,2303,268,274432,3415,655680,930112
train,2304,365,373760,6334,1216128,1589888
train,2305,428,438272,8709,1672128,2110400
train,2306,579,592896,15938,3060096,3652992
train,2307,116,118784,640,122880,241664
train,2308,253,259072,3043,584256,843328
train,2309,281,287744,3754,720768,1008512
train,2310,360,368640,6162,1183104,1551744
train,2311,207,211968,2038,391296,603264
train,2312,376,385024,6722,1290624,1675648
train,2313,354,362496,5958,1143936,1506432
train,2314,390,399360,7231,1388352,1787712
train,2315,324,331776,4991,958272,1290048
train,2316,310,317440,4569,877248,1194688
train,2317,260,266240,3214,617088,883328
train,2318,210,215040,2097,402624,617664
train,2319,254,260096,3068,589056,849152
train,2320,147,150528,1028,197376,347904
train,2321,396,405504,7456,1431552,1837056
train,2322,434,444416,8955,1719360,2163776
train,2323,342,350208,5561,1067712,1417920
train,2324,246,251904,2877,552384,804288
train,2325,228,233472,2472,474624,708096
train,2326,418,428032,8307,1594944,2022976
train,2327,295,302080,4138,794496,1096576
train,2328,240,245760,2739,525888,771648
train,2329,273,279552,3544,680448,960000
train,2330,186,190464,1645,315840,506304
train,2331,147,150528,1028,197376,347904
train,2332,313,320512,4658,894336,1214848
train,2333,246,251904,2877,552384,804288
train,2334,395,404480,7418,1424256,1828736
train,2335,274,280576,3570,685440,966016
train,2336,380,389120,6865,1318080,1707200
train,2337,422,432128,8467,1625664,2057792
train,2338,429,439296,8750,1680000,2119296
train,2339,211,216064,2117,406464,622528
train,2340,242,247808,2785,534720,782528
train,2341,405,414720,7798,1497216,1911936
train,2342,268,274432,3415,655680,930112
train,2343,376,385024,6722,1290624,1675648
train,2344,172,176128,1407,270144,446272
train,2345,206,210944,2018,387456,598400
train,2346,227,232448,2450,470400,702848
train,2347,399,408576,7569,1453248,1861824
train,2348,137,140288,893,171456,311744
train,2349,170,174080,1374,263808,437888
train,2350,307,314368,4481,860352,1174720
train,2351,361,369664,6196,1189632,1559296
train,2352,502,514048,11981,2300352,2814400
train,2353,104,106496,515,98880,205376
train,2354,226,231424,2429,466368,697792
train,2355,156,159744,1157,222144,381888
train,2356,161,164864,1233,236736,401600
train,2357,345,353280,5659,1086528,1439808
train,2358,239,244736,2716,521472,766208
train,2359,222,227328,2343,449856,677184
train,2360,139,142336,919,176448,318784
train,2361,368,376832,6439,1236288,1613120
train,2362,281,287744,3754,720768,1008512
train,2363,192,196608,1753,336576,533184
train,2364,540,552960,13863,2661696,3214656
train,2365,166,169984,1310,251520,421504
train,2366,409,418816,7953,1526976,1945792
train,2367,379,388096,6829,1311168,1699264
train,2368,247,252928,2901,556992,809920
train,2369,407,416768,7876,1512192,1928960
train,2370,337,345088,5400,1036800,1381888
train,2371,271,277504,3492,670464,947968
train,2372,173,177152,1423,273216,450368
train,2373,353,361472,5924,1137408,1498880
train,2374,426,436224,8628,1656576,2092800
train,2375,393,402432,7343,1409856,1812288
train,2376,186,190464,1645,315840,506304
train,2377,246,251904,2877,552384,804288
train,2378,132,135168,829,159168,294336
train,2379,250,256000,2972,570624,826624
train,2380,349,357376,5791,1111872,1469248
train,2381,256,262144,3116,598272,860416
train,2382,121,123904,696,133632,257536
train,2383,404,413696,7760,1489920,1903616
train,2384,168,172032,1342,257664,429696
train,2385,421,431104,8427,1617984,2049088
train,2386,242,247808,2785,534720,782528
train,2387,90,92160,386,74112,166272
train,2388,117,119808,651,124992,244800
train,2389,192,196608,1753,336576,533184
train,2390,329,336896,5146,988032,1324928
train,2391,52,53248,129,24768,78016
train,2392,199,203776,1883,361536,565312
train,2393,271,277504,3492,670464,947968
train,2394,196,200704,1827,350784,551488
train,2395,248,253952,2924,561408,815360
train,2396,160,163840,1217,233664,397504
train,2397,257,263168,3140,602880,866048
train,2398,179,183296,1524,292608,475904
train,2399,295,302080,4138,794496,1096576
train,2400,218,223232,2260,433920,657152
train,2401,217,222208,2239,429888,652096
train,2402,311,318464,4599,883008,1201472
train,2403,303,310272,4365,838080,1148352
train,2404,348,356352,5758,1105536,1461888
train,2405,293,300032,4082,783744,1083776
train,2406,97,99328,448,86016,185344
train,2407,264,270336,3314,636288,906624
train,2408,153,156672,1113,213696,370368
train,2409,340,348160,5496,1055232,1403392
train,2410,131,134144,816,156672,290816
train,2411,177,181248,1490,286080,467328
train,2412,288,294912,3944,757248,1052160
train,2413,309,316416,4540,871680,1188096
train,2414,247,252928,2901,556992,809920
train,2415,310,317440,4569,877248,1194688
train,2416,232,237568,2559,491328,728896
train,2417,300,307200,4279,821568,1128768
train,2418,430,440320,8791,1687872,2128192
train,2419,306,313344,4452,854784,1168128
train,2420,425,435200,8588,1648896,2084096
train,2421,238,243712,2693,517056,760768
train,2422,269,275456,3441,660672,936128
train,2423,539,551936,13812,2651904,3203840
train,2424,369,377856,6474,1243008,1620864
train,2425,185,189440,1628,312576,502016
train,2426,385,394240,7047,1353024,1747264
train,2427,254,260096,3068,589056,849152
train,2428,230,235520,2515,482880,718400
train,2429,47,48128,105,20160,68288
train,2430,368,376832,6439,1236288,1613120
train,2431,151,154624,1084,208128,362752
train,2432,516,528384,12658,2430336,2958720
train,2433,428,438272,8709,1672128,2110400
train,2434,393,402432,7343,1409856,1812288
train,2435,135,138240,867,166464,304704
train,2436,351,359424,5858,1124736,1484160
train,2437,250,256000,2972,570624,826624
train,2438,232,237568,2559,491328,728896
train,2439,163,166912,1264,242688,409600
train,2440,308,315392,4510,865920,1181312
train,2441,331,338944,5209,1000128,1339072
train,2442,210,215040,2097,402624,617664
train,2443,309,316416,4540,871680,1188096
train,2444,239,244736,2716,521472,766208
train,2445,83,84992,328,62976,147968
train,2446,193,197632,1771,340032,537664
train,2447,275,281600,3596,690432,972032
train,2448,189,193536,1699,326208,519744
train,2449,419,429056,8347,1602624,2031680
train,2450,236,241664,2648,508416,750080
train,2451,272,278528,3518,675456,953984
train,2452,197,201728,1845,354240,555968
train,2453,422,432128,8467,1625664,2057792
train,2454,305,312320,4423,849216,1161536
train,2455,273,279552,3544,680448,960000
train,2456,246,251904,2877,552384,804288
train,2457,336,344064,5368,1030656,1374720
train,2458,212,217088,2137,410304,627392
train,2459,413,422912,8109,1556928,1979840
train,2460,141,144384,946,181632,326016
train,2461,236,241664,2648,508416,750080
train,2462,276,282624,3622,695424,978048
train,2463,431,441344,8832,1695744,2137088
train,2464,216,221184,2219,426048,647232
train,2465,160,163840,1217,233664,397504
train,2466,384,393216,7011,1346112,1739328
train,2467,313,320512,4658,894336,1214848
train,2468,82,83968,320,61440,145408
train,2469,390,399360,7231,1388352,1787712
train,2470,175,179200,1456,279552,458752
train,2471,170,174080,1374,263808,437888
train,2472,156,159744,1157,222144,381888
train,2473,69,70656,227,43584,114240
train,2474,339,347136,5464,1049088,1396224
train,2475,218,223232,2260,433920,657152
train,2476,439,449536,9163,1759296,2208832
train,2477,257,263168,3140,602880,866048
train,2478,219,224256,2281,437952,662208
train,2479,221,226304,2322,445824,672128
train,2480,361,369664,6196,1189632,1559296
train,2481,233,238592,2581,495552,734144
train,2482,319,326656,4838,928896,1255552
train,2483,199,203776,1883,361536,565312
train,2484,276,282624,3622,695424,978048
train,2485,141,144384,946,181632,326016
train,2486,95,97280,430,82560,179840
train,2487,249,254976,2948,566016,820992
train,2488,308,315392,4510,865920,1181312
train,2489,325,332800,5022,964224,1297024
train,2490,208,212992,2057,394944,607936
train,2491,453,463872,9756,1873152,2337024
train,2492,145,148480,1000,192000,340480
train,2493,86,88064,352,67584,155648
train,2494,159,162816,1202,230784,393600
train,2495,252,258048,3019,579648,837696
train,2496,287,293888,3916,751872,1045760
train,2497,100,102400,476,91392,193792
train,2498,275,281600,3596,690432,972032
train,2499,402,411648,7683,1475136,1886784
train,2500,366,374784,6369,1222848,1597632
train,2501,122,124928,708,135936,260864
train,2502,273,279552,3544,680448,960000
train,2503,213,218112,2157,414144,632256
train,2504,281,287744,3754,720768,1008512
train,2505,249,254976,2948,566016,820992
train,2506,284,290816,3835,736320,1027136
train,2507,200,204800,1902,365184,569984
train,2508,251,257024,2996,575232,832256
train,2509,108,110592,555,106560,217152
train,2510,194,198656,1790,343680,542336
train,2511,478,489472,10863,2085696,2575168
train,2512,208,212992,2057,394944,607936
train,2513,149,152576,1056,202752,355328
train,2514,602,616448,17229,3307968,3924416
train,2515,354,362496,5958,1143936,1506432
train,2516,379,388096,6829,1311168,1699264
train,2517,551,564224,14434,2771328,3335552
train,2518,305,312320,4423,849216,1161536
train,2519,104,106496,515,98880,205376
train,2520,105,107520,525,100800,208320
train,2521,329,336896,5146,988032,1324928
train,2522,431,441344,8832,1695744,2137088
train,2523,154,157696,1128,216576,374272
train,2524,196,200704,1827,350784,551488
train,2525,403,412672,7722,1482624,1895296
train,2526,112,114688,597,114624,229312
train,2527,435,445440,8996,1727232,2172672
train,2528,145,148480,1000,192000,340480
train,2529,170,174080,1374,263808,437888
train,2530,254,260096,3068,589056,849152
train,2531,231,236544,2537,487104,723648
train,2532,304,311296,4394,843648,1154944
train,2533,120,122880,685,131520,254400
train,2534,240,245760,2739,525888,771648
train,2535,77,78848,282,54144,132992
train,2536,130,133120,804,154368,287488
train,2537,189,193536,1699,326208,519744
train,2538,297,304128,4194,805248,1109376
train,2539,88,90112,369,70848,160960
train,2540,66,67584,214,41088,108672
train,2541,190,194560,1717,329664,524224
train,2542,239,244736,2716,521472,766208
train,2543,346,354304,5692,1092864,1447168
train,2544,320,327680,4869,934848,1262528
train,2545,198,202752,1864,357888,560640
train,2546,332,339968,5241,1006272,1346240
train,2547,281,287744,3754,720768,1008512
train,2548,327,334848,5084,976128,1310976
train,2549,100,102400,476,91392,193792
train,2550,327,334848,5084,976128,1310976
train,2551,389,398336,7194,1381248,1779584
train,2552,118,120832,662,127104,247936
train,2553,339,347136,5464,1049088,1396224
train,2554,179,183296,1524,292608,475904
train,2555,489,500736,11368,2182656,2683392
train,2556,220,225280,2301,441792,667072
train,2557,154,157696,1128,216576,374272
train,2558,307,314368,4481,860352,1174720
train,2559,131,134144,816,156672,290816
train,2560,156,159744,1157,222144,381888
train,2561,364,372736,6299,1209408,1582144
train,2562,244,249856,2831,543552,793408
train,2563,245,250880,2854,547968,798848
train,2564,63,64512,189,36288,100800
train,2565,150,153600,1070,205440,359040
train,2566,92,94208,403,77376,171584
train,2567,313,320512,4658,894336,1214848
train,2568,243,248832,2808,539136,787968
train,2569,204,208896,1979,379968,588864
train,2570,373,381952,6615,1270080,1652032
train,2571,439,449536,9163,1759296,2208832
train,2572,219,224256,2281,437952,662208
train,2573,423,433152,8507,1633344,2066496
train,2574,275,281600,3596,690432,972032
train,2575,446,456704,9457,1815744,2272448
train,2576,361,369664,6196,1189632,1559296
train,2577,226,231424,2429,466368,697792
train,2578,137,140288,893,171456,311744
train,2579,257,263168,3140,602880,866048
train,2580,204,208896,1979,379968,588864
train,2581,256,262144,3116,598272,860416
train,2582,295,302080,4138,794496,1096576
train,2583,346,354304,5692,1092864,1447168
train,2584,269,275456,3441,660672,936128
train,2585,297,304128,4194,805248,1109376
train,2586,313,320512,4658,894336,1214848
train,2587,385,394240,7047,1353024,1747264
train,2588,390,399360,7231,1388352,1787712
train,2589,140,143360,932,178944,322304
train,2590,170,174080,1374,263808,437888
train,2591,284,290816,3835,736320,1027136
train,2592,390,399360,7231,1388352,1787712
train,2593,235,240640,2626,504192,744832
train,2594,491,502784,11462,2200704,2703488
train,2595,385,394240,7047,1353024,1747264
train,2596,570,583680,15446,2965632,3549312
train,2597,437,447488,9079,1743168,2190656
train,2598,246,251904,2877,552384,804288
train,2599,345,353280,5659,1086528,1439808
train,2600,214,219136,2178,418176,637312
train,2601,256,262144,3116,598272,860416
train,2602,249,254976,2948,566016,820992
train,2603,139,142336,919,176448,318784
train,2604,509,521216,12317,2364864,2886080
train,2605,312,319488,4628,888576,1208064
train,2606,331,338944,5209,1000128,1339072
train,2607,235,240640,2626,504192,744832
train,2608,138,141312,906,173952,315264
train,2609,268,274432,3415,655680,930112
train,2610,197,201728,1845,354240,555968
train,2611,159,162816,1202,230784,393600
train,2612,299,306176,4251,816192,1122368
train,2613,204,208896,1979,379968,588864
train,2614,396,405504,7456,1431552,1837056
train,2615,394,403456,7381,1417152,1820608
train,2616,435,445440,8996,1727232,2172672
train,2617,88,90112,369,70848,160960
train,2618,189,193536,1699,326208,519744
train,2619,267,273408,3390,650880,924288
train,2620,481,492544,11000,2112000,2604544
train,2621,312,319488,4628,888576,1208064
train,2622,218,223232,2260,433920,657152
train,2623,486,497664,11229,2155968,2653632
train,2624,245,250880,2854,547968,798848
train,2625,349,357376,5791,1111872,1469248
train,2626,266,272384,3364,645888,918272
train,2627,231,236544,2537,487104,723648
train,2628,451,461824,9670,1856640,2318464
train,2629,502,514048,11981,2300352,2814400
train,2630,301,308224,4308,827136,1135360
train,2631,309,316416,4540,871680,1188096
train,2632,394,403456,7381,1417152,1820608
train,2633,194,198656,1790,343680,542336
train,2634,209,214016,2077,398784,612800
train,2635,289,295936,3971,762432,1058368
train,2636,266,272384,3364,645888,918272
train,2637,322,329728,4930,946560,1276288
train,2638,548,561152,14277,2741184,3302336
train,2639,117,119808,651,124992,244800
train,2640,253,259072,3043,584256,843328
train,2641,411,420864,8031,1541952,1962816
train,2642,74,75776,268,51456,127232
train,2643,316,323584,4748,911616,1235200
train,2644,379,388096,6829,1311168,1699264
train,2645,399,408576,7569,1453248,1861824
train,2646,115,117760,629,120768,238528
train,2647,205,209920,1998,383616,593536
train,2648,204,208896,1979,379968,588864
train,2649,369,377856,6474,1243008,1620864
train,2650,240,245760,2739,525888,771648
train,2651,273,279552,3544,680448,960000
train,2652,250,256000,2972,570624,826624
train,2653,172,176128,1407,270144,446272
train,2654,328,335872,5115,982080,1317952
train,2655,297,304128,4194,805248,1109376
train,2656,408,417792,7914,1519488,1937280
train,2657,174,178176,1440,276480,454656
train,2658,183,187392,1593,305856,493248
train,2659,77,78848,282,54144,132992
train,2660,189,193536,1699,326208,519744
train,2661,281,287744,3754,720768,1008512
train,2662,229,234496,2494,478848,713344
train,2663,289,295936,3971,762432,1058368
train,2664,423,433152,8507,1633344,2066496
train,2665,164,167936,1279,245568,413504
train,2666,149,152576,1056,202752,355328
train,2667,343,351232,5594,1074048,1425280
train,2668,270,276480,3466,665472,941952
train,2669,212,217088,2137,410304,627392
train,2670,366,374784,6369,1222848,1597632
train,2671,361,369664,6196,1189632,1559296
train,2672,204,208896,1979,379968,588864
train,2673,167,171008,1326,254592,425600
train,2674,302,309248,4336,832512,1141760
train,2675,160,163840,1217,233664,397504
train,2676,362,370688,6230,1196160,1566848
train,2677,145,148480,1000,192000,340480
train,2678,271,277504,3492,670464,947968
train,2679,228,233472,2472,474624,708096
train,2680,220,225280,2301,441792,667072
train,2681,210,215040,2097,402624,617664
train,2682,289,295936,3971,762432,1058368
train,2683,361,369664,6196,1189632,1559296
train,2684,332,339968,5241,1006272,1346240
validation,0,148,151552,1042,200064,351616
validation,1,125,128000,743,142656,270656
validation,2,138,141312,906,173952,315264
validation,3,197,201728,1845,354240,555968
validation,4,298,305152,4222,810624,1115776
validation,5,456,466944,9886,1898112,2365056
validation,6,621,635904,18334,3520128,4156032
validation,7,490,501760,11415,2191680,2693440
validation,8,271,277504,3492,670464,947968
validation,9,321,328704,4899,940608,1269312
validation,10,279,285696,3701,710592,996288
validation,11,284,290816,3835,736320,1027136
validation,12,112,114688,597,114624,229312
validation,13,241,246784,2762,530304,777088
validation,14,363,371712,6265,1202880,1574592
validation,15,429,439296,8750,1680000,2119296
validation,16,315,322560,4718,905856,1228416
validation,17,273,279552,3544,680448,960000
validation,18,445,455680,9415,1807680,2263360
validation,19,291,297984,4026,772992,1070976
validation,20,186,190464,1645,315840,506304
validation,21,330,337920,5178,994176,1332096
validation,22,479,490496,10908,2094336,2584832
validation,23,248,253952,2924,561408,815360
validation,24,187,191488,1663,319296,510784
validation,25,359,367616,6128,1176576,1544192
validation,26,202,206848,1940,372480,579328
validation,27,69,70656,227,43584,114240
validation,28,183,187392,1593,305856,493248
validation,29,197,201728,1845,354240,555968
validation,30,368,376832,6439,1236288,1613120
validation,31,414,423936,8149,1564608,1988544
validation,32,318,325632,4808,923136,1248768
validation,33,395,404480,7418,1424256,1828736
validation,34,442,452608,9288,1783296,2235904
validation,35,79,80896,297,57024,137920
validation,36,160,163840,1217,233664,397504
validation,37,208,212992,2057,394944,607936
validation,38,228,233472,2472,474624,708096
validation,39,350,358400,5824,1118208,1476608
validation,40,362,370688,6230,1196160,1566848
validation,41,310,317440,4569,877248,1194688
validation,42,446,456704,9457,1815744,2272448
validation,43,124,126976,731,140352,267328
validation,44,197,201728,1845,354240,555968
validation,45,430,440320,8791,1687872,2128192
validation,46,378,387072,6793,1304256,1691328
validation,47,198,202752,1864,357888,560640
validation,48,405,414720,7798,1497216,1911936
validation,49,203,207872,1960,376320,584192
validation,50,264,270336,3314,636288,906624
validation,51,246,251904,2877,552384,804288
validation,52,259,265216,3190,612480,877696
validation,53,151,154624,1084,208128,362752
validation,54,371,379904,6544,1256448,1636352
validation,55,320,327680,4869,934848,1262528
validation,56,417,427008,8267,1587264,2014272
validation,57,212,217088,2137,410304,627392
validation,58,141,144384,946,181632,326016
validation,59,191,195584,1735,333120,528704
validation,60,370,378880,6509,1249728,1628608
validation,61,391,400384,7269,1395648,1796032
validation,62,430,440320,8791,1687872,2128192
validation,63,337,345088,5400,1036800,1381888
validation,64,618,632832,18157,3486144,4118976
validation,65,494,505856,11602,2227584,2733440
validation,66,184,188416,1610,309120,497536
validation,67,193,197632,1771,340032,537664
validation,68,323,330752,4960,952320,1283072
validation,69,186,190464,1645,315840,506304
validation,70,266,272384,3364,645888,918272
validation,71,110,112640,576,110592,223232
validation,72,391,400384,7269,1395648,1796032
validation,73,230,235520,2515,482880,718400
validation,74,199,203776,1883,361536,565312
validation,75,381,390144,6902,1325184,1715328
validation,76,158,161792,1187,227904,389696
validation,77,223,228352,2365,454080,682432
validation,78,489,500736,11368,2182656,2683392
validation,79,189,193536,1699,326208,519744
validation,80,48,49152,110,21120,70272
validation,81,434,444416,8955,1719360,2163776
validation,82,362,370688,6230,1196160,1566848
validation,83,256,262144,3116,598272,860416
validation,84,267,273408,3390,650880,924288
validation,85,267,273408,3390,650880,924288
validation,86,358,366592,6093,1169856,1536448
validation,87,210,215040,2097,402624,617664
validation,88,325,332800,5022,964224,1297024
validation,89,217,222208,2239,429888,652096
validation,90,88,90112,369,70848,160960
validation,91,320,327680,4869,934848,1262528
validation,92,163,166912,1264,242688,409600
validation,93,285,291840,3862,741504,1033344
validation,94,272,278528,3518,675456,953984
validation,95,212,217088,2137,410304,627392
validation,96,94,96256,421,80832,177088
validation,97,128,131072,779,149568,280640
validation,98,114,116736,618,118656,235392
validation,99,423,433152,8507,1633344,2066496
validation,100,300,307200,4279,821568,1128768
validation,101,214,219136,2178,418176,637312
validation,102,348,356352,5758,1105536,1461888
validation,103,70,71680,233,44736,116416
validation,104,279,285696,3701,710592,996288
validation,105,470,481280,10502,2016384,2497664
validation,106,306,313344,4452,854784,1168128
validation,107,117,119808,651,124992,244800
validation,108,368,376832,6439,1236288,1613120
validation,109,287,293888,3916,751872,1045760
validation,110,277,283648,3648,700416,984064
validation,111,240,245760,2739,525888,771648
validation,112,167,171008,1326,254592,425600
validation,113,78,79872,290,55680,135552
validation,114,453,463872,9756,1873152,2337024
validation,115,180,184320,1541,295872,480192
validation,116,350,358400,5824,1118208,1476608
validation,117,190,194560,1717,329664,524224
validation,118,274,280576,3570,685440,966016
validation,119,273,279552,3544,680448,960000
validation,120,278,284672,3675,705600,990272
validation,121,257,263168,3140,602880,866048
validation,122,322,329728,4930,946560,1276288
validation,123,85,87040,344,66048,153088
validation,124,322,329728,4930,946560,1276288
validation,125,366,374784,6369,1222848,1597632
validation,126,196,200704,1827,350784,551488
validation,127,383,392192,6974,1339008,1731200
validation,128,455,465920,9843,1889856,2355776
validation,129,289,295936,3971,762432,1058368
validation,130,264,270336,3314,636288,906624
validation,131,291,297984,4026,772992,1070976
validation,132,335,343040,5336,1024512,1367552
validation,133,310,317440,4569,877248,1194688
validation,134,250,256000,2972,570624,826624
validation,135,363,371712,6265,1202880,1574592
validation,136,110,112640,576,110592,223232
validation,137,291,297984,4026,772992,1070976
validation,138,130,133120,804,154368,287488
validation,139,250,256000,2972,570624,826624
validation,140,253,259072,3043,584256,843328
validation,141,377,386048,6757,1297344,1683392
validation,142,213,218112,2157,414144,632256
validation,143,347,355328,5725,1099200,1454528
validation,144,140,143360,932,178944,322304
validation,145,241,246784,2762,530304,777088
validation,146,442,452608,9288,1783296,2235904
validation,147,406,415744,7837,1504704,1920448
validation,148,170,174080,1374,263808,437888
validation,149,208,212992,2057,394944,607936
validation,150,256,262144,3116,598272,860416
validation,151,221,226304,2322,445824,672128
validation,152,243,248832,2808,539136,787968
validation,153,441,451584,9246,1775232,2226816
validation,154,114,116736,618,118656,235392
validation,155,248,253952,2924,561408,815360
validation,156,317,324608,4778,917376,1241984
validation,157,291,297984,4026,772992,1070976
validation,158,325,332800,5022,964224,1297024
validation,159,248,253952,2924,561408,815360
validation,160,176,180224,1473,282816,463040
validation,161,168,172032,1342,257664,429696
validation,162,252,258048,3019,579648,837696
validation,163,178,182272,1507,289344,471616
validation,164,397,406528,7493,1438656,1845184
validation,165,582,595968,16104,3091968,3687936
validation,166,185,189440,1628,312576,502016
validation,167,243,248832,2808,539136,787968
validation,168,395,404480,7418,1424256,1828736
validation,169,126,129024,755,144960,273984
validation,170,319,326656,4838,928896,1255552
validation,171,116,118784,640,122880,241664
validation,172,285,291840,3862,741504,1033344
validation,173,317,324608,4778,917376,1241984
validation,174,391,400384,7269,1395648,1796032
validation,175,419,429056,8347,1602624,2031680
validation,176,295,302080,4138,794496,1096576
validation,177,63,64512,189,36288,100800
validation,178,70,71680,233,44736,116416
validation,179,368,376832,6439,1236288,1613120
validation,180,488,499712,11322,2173824,2673536
validation,181,242,247808,2785,534720,782528
validation,182,350,358400,5824,1118208,1476608
validation,183,408,417792,7914,1519488,1937280
validation,184,184,188416,1610,309120,497536
validation,185,251,257024,2996,575232,832256
validation,186,363,371712,6265,1202880,1574592
validation,187,420,430080,8387,1610304,2040384
validation,188,191,195584,1735,333120,528704
validation,189,321,328704,4899,940608,1269312
validation,190,229,234496,2494,478848,713344
validation,191,286,292864,3889,746688,1039552
validation,192,276,282624,3622,695424,978048
validation,193,364,372736,6299,1209408,1582144
validation,194,208,212992,2057,394944,607936
validation,195,422,432128,8467,1625664,2057792
validation,196,284,290816,3835,736320,1027136
validation,197,218,223232,2260,433920,657152
validation,198,275,281600,3596,690432,972032
validation,199,403,412672,7722,1482624,1895296
validation,200,175,179200,1456,279552,458752
validation,201,465,476160,10280,1973760,2449920
validation,202,103,105472,505,96960,202432
validation,203,102,104448,495,95040,199488
validation,204,429,439296,8750,1680000,2119296
validation,205,247,252928,2901,556992,809920
validation,206,477,488448,10817,2076864,2565312
validation,207,360,368640,6162,1183104,1551744
validation,208,250,256000,2972,570624,826624
validation,209,184,188416,1610,309120,497536
validation,210,239,244736,2716,521472,766208
validation,211,276,282624,3622,695424,978048
validation,212,317,324608,4778,917376,1241984
validation,213,270,276480,3466,665472,941952
validation,214,277,283648,3648,700416,984064
validation,215,155,158720,1143,219456,378176
validation,216,284,290816,3835,736320,1027136
validation,217,477,488448,10817,2076864,2565312
validation,218,306,313344,4452,854784,1168128
validation,219,388,397312,7157,1374144,1771456
validation,220,203,207872,1960,376320,584192
validation,221,305,312320,4423,849216,1161536
validation,222,323,330752,4960,952320,1283072
validation,223,229,234496,2494,478848,713344
validation,224,473,484352,10637,2042304,2526656
validation,225,144,147456,986,189312,336768
validation,226,62,63488,183,35136,98624
validation,227,218,223232,2260,433920,657152
validation,228,228,233472,2472,474624,708096
validation,229,388,397312,7157,1374144,1771456
validation,230,298,305152,4222,810624,1115776
validation,231,208,212992,2057,394944,607936
validation,232,146,149504,1014,194688,344192
validation,233,229,234496,2494,478848,713344
validation,234,98,100352,457,87744,188096
validation,235,374,382976,6650,1276800,1659776
validation,236,219,224256,2281,437952,662208
validation,237,356,364544,6026,1156992,1521536
validation,238,239,244736,2716,521472,766208
validation,239,377,386048,6757,1297344,1683392
validation,240,305,312320,4423,849216,1161536
validation,241,273,279552,3544,680448,960000
validation,242,102,104448,495,95040,199488
validation,243,179,183296,1524,292608,475904
validation,244,392,401408,7306,1402752,1804160
validation,245,90,92160,386,74112,166272
validation,246,169,173056,1358,260736,433792
validation,247,216,221184,2219,426048,647232
validation,248,365,373760,6334,1216128,1589888
validation,249,215,220160,2198,422016,642176
validation,250,410,419840,7992,1534464,1954304
validation,251,224,229376,2386,458112,687488
validation,252,224,229376,2386,458112,687488
validation,253,397,406528,7493,1438656,1845184
validation,254,276,282624,3622,695424,978048
validation,255,409,418816,7953,1526976,1945792
validation,256,412,421888,8070,1549440,1971328
validation,257,363,371712,6265,1202880,1574592
validation,258,445,455680,9415,1807680,2263360
validation,259,104,106496,515,98880,205376
validation,260,243,248832,2808,539136,787968
validation,261,326,333824,5053,970176,1304000
validation,262,320,327680,4869,934848,1262528
validation,263,316,323584,4748,911616,1235200
validation,264,268,274432,3415,655680,930112
validation,265,138,141312,906,173952,315264
validation,266,421,431104,8427,1617984,2049088
validation,267,364,372736,6299,1209408,1582144
validation,268,103,105472,505,96960,202432
validation,269,298,305152,4222,810624,1115776
validation,270,348,356352,5758,1105536,1461888
validation,271,201,205824,1921,368832,574656
validation,272,106,108544,535,102720,211264
validation,273,290,296960,3999,767808,1064768
validation,274,99,101376,466,89472,190848
validation,275,184,188416,1610,309120,497536
validation,276,126,129024,755,144960,273984
validation,277,78,79872,290,55680,135552
validation,278,332,339968,5241,1006272,1346240
validation,279,247,252928,2901,556992,809920
validation,280,124,126976,731,140352,267328
validation,281,81,82944,312,59904,142848
validation,282,276,282624,3622,695424,978048
validation,283,295,302080,4138,794496,1096576
validation,284,360,368640,6162,1183104,1551744
validation,285,276,282624,3622,695424,978048
validation,286,294,301056,4110,789120,1090176
validation,287,102,104448,495,95040,199488
validation,288,197,201728,1845,354240,555968
validation,289,231,236544,2537,487104,723648
validation,290,190,194560,1717,329664,524224
validation,291,188,192512,1681,322752,515264
validation,292,60,61440,172,33024,94464
validation,293,350,358400,5824,1118208,1476608
validation,294,277,283648,3648,700416,984064
validation,295,493,504832,11555,2218560,2723392
validation,296,445,455680,9415,1807680,2263360
validation,297,345,353280,5659,1086528,1439808
validation,298,281,287744,3754,720768,1008512
validation,299,302,309248,4336,832512,1141760
validation,300,377,386048,6757,1297344,1683392
validation,301,347,355328,5725,1099200,1454528
validation,302,417,427008,8267,1587264,2014272
validation,303,399,408576,7569,1453248,1861824
validation,304,199,203776,1883,361536,565312
validation,305,220,225280,2301,441792,667072
validation,306,209,214016,2077,398784,612800
validation,307,240,245760,2739,525888,771648
validation,308,208,212992,2057,394944,607936
validation,309,95,97280,430,82560,179840
validation,310,432,442368,8873,1703616,2145984
validation,311,194,198656,1790,343680,542336
validation,312,210,215040,2097,402624,617664
validation,313,348,356352,5758,1105536,1461888
validation,314,368,376832,6439,1236288,1613120
validation,315,215,220160,2198,422016,642176
validation,316,142,145408,959,184128,329536
validation,317,149,152576,1056,202752,355328
validation,318,259,265216,3190,612480,877696
validation,319,528,540672,13254,2544768,3085440
validation,320,160,163840,1217,233664,397504
validation,321,127,130048,767,147264,277312
validation,322,353,361472,5924,1137408,1498880
validation,323,289,295936,3971,762432,1058368
validation,324,191,195584,1735,333120,528704
validation,325,669,685056,21278,4085376,4770432
validation,326,142,145408,959,184128,329536
validation,327,287,293888,3916,751872,1045760
validation,328,405,414720,7798,1497216,1911936
validation,329,394,403456,7381,1417152,1820608
validation,330,216,221184,2219,426048,647232
validation,331,374,382976,6650,1276800,1659776
validation,332,628,643072,18750,3600000,4243072
validation,333,219,224256,2281,437952,662208
validation,334,341,349184,5529,1061568,1410752
validation,335,121,123904,696,133632,257536
validation,336,385,394240,7047,1353024,1747264
validation,337,180,184320,1541,295872,480192
validation,338,386,395264,7084,1360128,1755392
validation,339,319,326656,4838,928896,1255552
validation,340,348,356352,5758,1105536,1461888
validation,341,238,243712,2693,517056,760768
validation,342,200,204800,1902,365184,569984
validation,343,223,228352,2365,454080,682432
validation,344,308,315392,4510,865920,1181312
validation,345,334,342016,5304,1018368,1360384
validation,346,425,435200,8588,1648896,2084096
validation,347,243,248832,2808,539136,787968
validation,348,222,227328,2343,449856,677184
validation,349,403,412672,7722,1482624,1895296
validation,350,92,94208,403,77376,171584
validation,351,228,233472,2472,474624,708096
validation,352,312,319488,4628,888576,1208064
validation,353,351,359424,5858,1124736,1484160
validation,354,260,266240,3214,617088,883328
validation,355,369,377856,6474,1243008,1620864
validation,356,131,134144,816,156672,290816
validation,357,146,149504,1014,194688,344192
validation,358,305,312320,4423,849216,1161536
validation,359,247,252928,2901,556992,809920
validation,360,207,211968,2038,391296,603264
validation,361,423,433152,8507,1633344,2066496
validation,362,316,323584,4748,911616,1235200
validation,363,219,224256,2281,437952,662208
validation,364,240,245760,2739,525888,771648
validation,365,374,382976,6650,1276800,1659776
validation,366,259,265216,3190,612480,877696
validation,367,166,169984,1310,251520,421504
validation,368,333,340992,5272,1012224,1353216
validation,369,268,274432,3415,655680,930112
validation,370,239,244736,2716,521472,766208
validation,371,73,74752,254,48768,123520
validation,372,253,259072,3043,584256,843328
validation,373,400,409600,7607,1460544,1870144
validation,374,423,433152,8507,1633344,2066496
validation,375,232,237568,2559,491328,728896
validation,376,321,328704,4899,940608,1269312
validation,377,237,242688,2671,512832,755520
validation,378,384,393216,7011,1346112,1739328
validation,379,251,257024,2996,575232,832256
validation,380,618,632832,18157,3486144,4118976
validation,381,431,441344,8832,1695744,2137088
validation,382,385,394240,7047,1353024,1747264
validation,383,560,573440,14909,2862528,3435968
validation,384,389,398336,7194,1381248,1779584
validation,385,291,297984,4026,772992,1070976
validation,386,223,228352,2365,454080,682432
validation,387,283,289792,3808,731136,1020928
validation,388,261,267264,3239,621888,889152
validation,389,117,119808,651,124992,244800
validation,390,258,264192,3165,607680,871872
validation,391,224,229376,2386,458112,687488
validation,392,428,438272,8709,1672128,2110400
validation,393,287,293888,3916,751872,1045760
validation,394,583,596992,16159,3102528,3699520
validation,395,428,438272,8709,1672128,2110400
validation,396,154,157696,1128,216576,374272
validation,397,282,288768,3781,725952,1014720
validation,398,226,231424,2429,466368,697792
validation,399,315,322560,4718,905856,1228416
validation,400,400,409600,7607,1460544,1870144
validation,401,170,174080,1374,263808,437888
validation,402,335,343040,5336,1024512,1367552
validation,403,90,92160,386,74112,166272
validation,404,218,223232,2260,433920,657152
validation,405,366,374784,6369,1222848,1597632
validation,406,250,256000,2972,570624,826624
validation,407,165,168960,1295,248640,417600
validation,408,160,163840,1217,233664,397504
validation,409,341,349184,5529,1061568,1410752
validation,410,188,192512,1681,322752,515264
validation,411,586,600064,16326,3134592,3734656
validation,412,323,330752,4960,952320,1283072
validation,413,269,275456,3441,660672,936128
validation,414,246,251904,2877,552384,804288
validation,415,208,212992,2057,394944,607936
validation,416,261,267264,3239,621888,889152
validation,417,196,200704,1827,350784,551488
validation,418,136,139264,880,168960,308224
validation,419,394,403456,7381,1417152,1820608
validation,420,427,437248,8669,1664448,2101696
validation,421,93,95232,412,79104,174336
validation,422,434,444416,8955,1719360,2163776
validation,423,313,320512,4658,894336,1214848
validation,424,181,185344,1558,299136,484480
validation,425,109,111616,565,108480,220096
validation,426,299,306176,4251,816192,1122368
validation,427,205,209920,1998,383616,593536
validation,428,373,381952,6615,1270080,1652032
validation,429,117,119808,651,124992,244800
validation,430,160,163840,1217,233664,397504
validation,431,294,301056,4110,789120,1090176
validation,432,295,302080,4138,794496,1096576
validation,433,197,201728,1845,354240,555968
validation,434,327,334848,5084,976128,1310976
validation,435,409,418816,7953,1526976,1945792
validation,436,512,524288,12463,2392896,2917184
validation,437,106,108544,535,102720,211264
validation,438,221,226304,2322,445824,672128
validation,439,161,164864,1233,236736,401600
validation,440,194,198656,1790,343680,542336
validation,441,66,67584,208,39936,107520
validation,442,361,369664,6196,1189632,1559296
validation,443,371,379904,6544,1256448,1636352
validation,444,162,165888,1248,239616,405504
validation,445,228,233472,2472,474624,708096
validation,446,325,332800,5022,964224,1297024
validation,447,99,101376,466,89472,190848
validation,448,376,385024,6722,1290624,1675648
validation,449,362,370688,6230,1196160,1566848
validation,450,211,216064,2117,406464,622528
validation,451,226,231424,2429,466368,697792
validation,452,194,198656,1790,343680,542336
validation,453,226,231424,2429,466368,697792
validation,454,242,247808,2785,534720,782528
validation,455,280,286720,3728,715776,1002496
validation,456,125,128000,743,142656,270656
validation,457,331,338944,5209,1000128,1339072
validation,458,184,188416,1610,309120,497536
validation,459,211,216064,2117,406464,622528
validation,460,208,212992,2057,394944,607936
validation,461,114,116736,618,118656,235392
validation,462,290,296960,3999,767808,1064768
validation,463,210,215040,2097,402624,617664
validation,464,301,308224,4308,827136,1135360
validation,465,371,379904,6544,1256448,1636352
validation,466,331,338944,5209,1000128,1339072
validation,467,313,320512,4658,894336,1214848
validation,468,121,123904,696,133632,257536
validation,469,402,411648,7683,1475136,1886784
validation,470,157,160768,1172,225024,385792
validation,471,185,189440,1628,312576,502016
validation,472,430,440320,8791,1687872,2128192
validation,473,273,279552,3544,680448,960000
validation,474,284,290816,3835,736320,1027136
validation,475,346,354304,5692,1092864,1447168
validation,476,442,452608,9288,1783296,2235904
validation,477,126,129024,755,144960,273984
validation,478,258,264192,3165,607680,871872
validation,479,397,406528,7493,1438656,1845184
validation,480,354,362496,5958,1143936,1506432
validation,481,353,361472,5924,1137408,1498880
validation,482,400,409600,7607,1460544,1870144
validation,483,210,215040,2097,402624,617664
validation,484,122,124928,708,135936,260864
validation,485,210,215040,2097,402624,617664
validation,486,209,214016,2077,398784,612800
validation,487,401,410624,7645,1467840,1878464
validation,488,408,417792,7914,1519488,1937280
validation,489,186,190464,1645,315840,506304
validation,490,168,172032,1342,257664,429696
validation,491,452,462848,9713,1864896,2327744
validation,492,411,420864,8031,1541952,1962816
validation,493,354,362496,5958,1143936,1506432
validation,494,257,263168,3140,602880,866048
validation,495,260,266240,3214,617088,883328
validation,496,288,294912,3944,757248,1052160
validation,497,370,378880,6509,1249728,1628608
validation,498,222,227328,2343,449856,677184
validation,499,407,416768,7876,1512192,1928960
validation,500,318,325632,4808,923136,1248768
validation,501,525,537600,13104,2515968,3053568
validation,502,262,268288,3264,626688,894976
validation,503,411,420864,8031,1541952,1962816
validation,504,300,307200,4279,821568,1128768
validation,505,182,186368,1575,302400,488768
validation,506,264,270336,3314,636288,906624
validation,507,286,292864,3889,746688,1039552
validation,508,220,225280,2301,441792,667072
validation,509,333,340992,5272,1012224,1353216
validation,510,391,400384,7269,1395648,1796032
validation,511,161,164864,1233,236736,401600
validation,512,195,199680,1808,347136,546816
validation,513,296,303104,4166,799872,1102976
validation,514,228,233472,2472,474624,708096
validation,515,427,437248,8669,1664448,2101696
validation,516,337,345088,5400,1036800,1381888
validation,517,284,290816,3835,736320,1027136
validation,518,297,304128,4194,805248,1109376
validation,519,105,107520,525,100800,208320
validation,520,246,251904,2877,552384,804288
validation,521,280,286720,3728,715776,1002496
validation,522,117,119808,651,124992,244800
validation,523,404,413696,7760,1489920,1903616
validation,524,204,208896,1979,379968,588864
validation,525,296,303104,4166,799872,1102976
validation,526,180,184320,1541,295872,480192
validation,527,482,493568,11045,2120640,2614208
validation,528,138,141312,906,173952,315264
validation,529,176,180224,1473,282816,463040
validation,530,208,212992,2057,394944,607936
validation,531,239,244736,2716,521472,766208
validation,532,363,371712,6265,1202880,1574592
validation,533,447,457728,9500,1824000,2281728
validation,534,326,333824,5053,970176,1304000
validation,535,233,238592,2581,495552,734144
validation,536,279,285696,3701,710592,996288
validation,537,434,444416,8955,1719360,2163776
validation,538,397,406528,7493,1438656,1845184
validation,539,411,420864,8031,1541952,1962816
validation,540,311,318464,4599,883008,1201472
validation,541,218,223232,2260,433920,657152
validation,542,375,384000,6686,1283712,1667712
validation,543,219,224256,2281,437952,662208
validation,544,226,231424,2429,466368,697792
validation,545,348,356352,5758,1105536,1461888
validation,546,225,230400,2407,462144,692544
validation,547,331,338944,5209,1000128,1339072
validation,548,267,273408,3390,650880,924288
validation,549,748,765952,26600,5107200,5873152
validation,550,266,272384,3364,645888,918272
validation,551,408,417792,7914,1519488,1937280
validation,552,140,143360,932,178944,322304
validation,553,439,449536,9163,1759296,2208832
validation,554,229,234496,2494,478848,713344
validation,555,209,214016,2077,398784,612800
validation,556,100,102400,476,91392,193792
validation,557,222,227328,2343,449856,677184
validation,558,135,138240,867,166464,304704
validation,559,328,335872,5115,982080,1317952
validation,560,410,419840,7992,1534464,1954304
validation,561,244,249856,2831,543552,793408
validation,562,109,111616,565,108480,220096
validation,563,333,340992,5272,1012224,1353216
validation,564,498,509952,11791,2263872,2773824
validation,565,325,332800,5022,964224,1297024
validation,566,374,382976,6650,1276800,1659776
validation,567,666,681984,21087,4048704,4730688
validation,568,285,291840,3862,741504,1033344
validation,569,276,282624,3622,695424,978048
validation,570,552,565248,14486,2781312,3346560
validation,571,144,147456,986,189312,336768
validation,572,559,572416,14856,2852352,3424768
validation,573,270,276480,3466,665472,941952
validation,574,395,404480,7418,1424256,1828736
validation,575,50,51200,124,23808,75008
validation,576,221,226304,2322,445824,672128
validation,577,325,332800,5022,964224,1297024
validation,578,252,258048,3019,579648,837696
validation,579,156,159744,1157,222144,381888
validation,580,167,171008,1326,254592,425600
validation,581,440,450560,9204,1767168,2217728
validation,582,382,391168,6938,1332096,1723264
validation,583,134,137216,854,163968,301184
validation,584,247,252928,2901,556992,809920
validation,585,311,318464,4599,883008,1201472
validation,586,305,312320,4423,849216,1161536
validation,587,271,277504,3492,670464,947968
validation,588,226,231424,2429,466368,697792
validation,589,205,209920,1998,383616,593536
validation,590,276,282624,3622,695424,978048
validation,591,242,247808,2785,534720,782528
validation,592,148,151552,1042,200064,351616
validation,593,287,293888,3916,751872,1045760
validation,594,390,399360,7231,1388352,1787712
validation,595,213,218112,2157,414144,632256
validation,596,384,393216,7011,1346112,1739328
validation,597,263,269312,3289,631488,900800
validation,598,84,86016,336,64512,150528
validation,599,94,96256,421,80832,177088
validation,600,103,105472,505,96960,202432
validation,601,206,210944,2018,387456,598400
validation,602,111,113664,586,112512,226176
validation,603,427,437248,8669,1664448,2101696
validation,604,359,367616,6128,1176576,1544192
validation,605,161,164864,1233,236736,401600
validation,606,324,331776,4991,958272,1290048
validation,607,337,345088,5400,1036800,1381888
validation,608,250,256000,2972,570624,826624
validation,609,252,258048,3019,579648,837696
validation,610,432,442368,8873,1703616,2145984
validation,611,454,464896,9799,1881408,2346304
validation,612,345,353280,5659,1086528,1439808
validation,613,140,143360,932,178944,322304
validation,614,339,347136,5464,1049088,1396224
validation,615,222,227328,2343,449856,677184
validation,616,289,295936,3971,762432,1058368
validation,617,120,122880,685,131520,254400
validation,618,213,218112,2157,414144,632256
validation,619,179,183296,1524,292608,475904
validation,620,372,380928,6579,1263168,1644096
validation,621,323,330752,4960,952320,1283072
validation,622,217,222208,2239,429888,652096
validation,623,87,89088,360,69120,158208
validation,624,285,291840,3862,741504,1033344
validation,625,441,451584,9246,1775232,2226816
validation,626,101,103424,485,93120,196544
validation,627,371,379904,6544,1256448,1636352
validation,628,197,201728,1845,354240,555968
validation,629,398,407552,7531,1445952,1853504
validation,630,229,234496,2494,478848,713344
validation,631,226,231424,2429,466368,697792
validation,632,269,275456,3441,660672,936128
validation,633,486,497664,11229,2155968,2653632
validation,634,349,357376,5791,1111872,1469248
validation,635,237,242688,2671,512832,755520
validation,636,81,82944,312,59904,142848
validation,637,548,561152,14277,2741184,3302336
validation,638,361,369664,6196,1189632,1559296
validation,639,594,608256,16775,3220800,3829056
validation,640,108,110592,555,106560,217152
validation,641,514,526336,12561,2411712,2938048
validation,642,382,391168,6938,1332096,1723264
validation,643,146,149504,1014,194688,344192
validation,644,264,270336,3314,636288,906624
validation,645,132,135168,829,159168,294336
validation,646,296,303104,4166,799872,1102976
validation,647,314,321536,4688,900096,1221632
validation,648,245,250880,2854,547968,798848
validation,649,473,484352,10637,2042304,2526656
validation,650,342,350208,5561,1067712,1417920
validation,651,404,413696,7760,1489920,1903616
validation,652,86,88064,352,67584,155648
validation,653,324,331776,4991,958272,1290048
validation,654,286,292864,3889,746688,1039552
validation,655,413,422912,8109,1556928,1979840
validation,656,242,247808,2785,534720,782528
validation,657,349,357376,5791,1111872,1469248
validation,658,253,259072,3043,584256,843328
validation,659,368,376832,6439,1236288,1613120
validation,660,391,400384,7269,1395648,1796032
validation,661,298,305152,4222,810624,1115776
validation,662,339,347136,5464,1049088,1396224
validation,663,165,168960,1295,248640,417600
validation,664,176,180224,1473,282816,463040
validation,665,127,130048,767,147264,277312
validation,666,202,206848,1940,372480,579328
validation,667,391,400384,7269,1395648,1796032
validation,668,185,189440,1628,312576,502016
validation,669,339,347136,5464,1049088,1396224
validation,670,237,242688,2671,512832,755520
validation,671,289,295936,3971,762432,1058368
test,0,210,215040,2097,402624,617664
test,1,291,297984,4026,772992,1070976
test,2,203,207872,1960,376320,584192
test,3,229,234496,2494,478848,713344
test,4,227,232448,2450,470400,702848
test,5,485,496640,11183,2147136,2643776
test,6,445,455680,9415,1807680,2263360
test,7,359,367616,6128,1176576,1544192
test,8,662,677888,20835,4000320,4678208
test,9,503,515072,12029,2309568,2824640
test,10,251,257024,2996,575232,832256
test,11,336,344064,5368,1030656,1374720
test,12,224,229376,2386,458112,687488
test,13,137,140288,893,171456,311744
test,14,105,107520,525,100800,208320
test,15,228,233472,2472,474624,708096
test,16,218,223232,2260,433920,657152
test,17,173,177152,1423,273216,450368
test,18,232,237568,2559,491328,728896
test,19,418,428032,8307,1594944,2022976
test,20,266,272384,3364,645888,918272
test,21,163,166912,1264,242688,409600
test,22,343,351232,5594,1074048,1425280
test,23,653,668672,20272,3892224,4560896
test,24,386,395264,7084,1360128,1755392
test,25,385,394240,7047,1353024,1747264
test,26,404,413696,7760,1489920,1903616
test,27,227,232448,2450,470400,702848
test,28,157,160768,1172,225024,385792
test,29,71,72704,240,46080,118784
test,30,459,470016,10016,1923072,2393088
test,31,101,103424,485,93120,196544
test,32,184,188416,1610,309120,497536
test,33,330,337920,5178,994176,1332096
test,34,179,183296,1524,292608,475904
test,35,284,290816,3835,736320,1027136
test,36,131,134144,816,156672,290816
test,37,134,137216,854,163968,301184
test,38,169,173056,1358,260736,433792
test,39,216,221184,2219,426048,647232
test,40,405,414720,7798,1497216,1911936
test,41,131,134144,816,156672,290816
test,42,364,372736,6299,1209408,1582144
test,43,186,190464,1645,315840,506304
test,44,106,108544,535,102720,211264
test,45,277,283648,3648,700416,984064
test,46,367,375808,6404,1229568,1605376
test,47,349,357376,5791,1111872,1469248
test,48,376,385024,6722,1290624,1675648
test,49,254,260096,3068,589056,849152
test,50,263,269312,3289,631488,900800
test,51,177,181248,1490,286080,467328
test,52,276,282624,3622,695424,978048
test,53,211,216064,2117,406464,622528
test,54,266,272384,3364,645888,918272
test,55,192,196608,1753,336576,533184
test,56,269,275456,3441,660672,936128
test,57,450,460800,9627,1848384,2309184
test,58,217,222208,2239,429888,652096
test,59,189,193536,1699,326208,519744
test,60,355,363520,5992,1150464,1513984
test,61,237,242688,2671,512832,755520
test,62,228,233472,2472,474624,708096
test,63,278,284672,3675,705600,990272
test,64,461,472064,10104,1939968,2412032
test,65,410,419840,7992,1534464,1954304
test,66,222,227328,2343,449856,677184
test,67,124,126976,731,140352,267328
test,68,511,523264,12414,2383488,2906752
test,69,196,200704,1827,350784,551488
test,70,221,226304,2322,445824,672128
test,71,248,253952,2924,561408,815360
test,72,357,365568,6059,1163328,1528896
test,73,116,118784,640,122880,241664
test,74,306,313344,4452,854784,1168128
test,75,314,321536,4688,900096,1221632
test,76,353,361472,5924,1137408,1498880
test,77,344,352256,5626,1080192,1432448
test,78,330,337920,5178,994176,1332096
test,79,220,225280,2301,441792,667072
test,80,162,165888,1248,239616,405504
test,81,103,105472,505,96960,202432
test,82,363,371712,6265,1202880,1574592
test,83,314,321536,4688,900096,1221632
test,84,398,407552,7531,1445952,1853504
test,85,196,200704,1827,350784,551488
test,86,190,194560,1717,329664,524224
test,87,311,318464,4599,883008,1201472
test,88,447,457728,9500,1824000,2281728
test,89,157,160768,1172,225024,385792
test,90,320,327680,4869,934848,1262528
test,91,426,436224,8628,1656576,2092800
test,92,435,445440,8996,1727232,2172672
test,93,471,482304,10547,2025024,2507328
test,94,290,296960,3999,767808,1064768
test,95,482,493568,11045,2120640,2614208
test,96,135,138240,867,166464,304704
test,97,160,163840,1217,233664,397504
test,98,422,432128,8467,1625664,2057792
test,99,310,317440,4569,877248,1194688
test,100,365,373760,6334,1216128,1589888
test,101,246,251904,2877,552384,804288
test,102,324,331776,4991,958272,1290048
test,103,220,225280,2301,441792,667072
test,104,64,65536,195,37440,102976
test,105,351,359424,5858,1124736,1484160
test,106,324,331776,4991,958272,1290048
test,107,303,310272,4365,838080,1148352
test,108,289,295936,3971,762432,1058368
test,109,456,466944,9886,1898112,2365056
test,110,252,258048,3019,579648,837696
test,111,416,425984,8228,1579776,2005760
test,112,388,397312,7157,1374144,1771456
test,113,355,363520,5992,1150464,1513984
test,114,423,433152,8507,1633344,2066496
test,115,326,333824,5053,970176,1304000
test,116,390,399360,7231,1388352,1787712
test,117,205,209920,1998,383616,593536
test,118,683,699392,22178,4258176,4957568
test,119,211,216064,2117,406464,622528
test,120,238,243712,2693,517056,760768
test,121,307,314368,4481,860352,1174720
test,122,336,344064,5368,1030656,1374720
test,123,395,404480,7418,1424256,1828736
test,124,166,169984,1310,251520,421504
test,125,375,384000,6686,1283712,1667712
test,126,83,84992,328,62976,147968
test,127,274,280576,3570,685440,966016
test,128,262,268288,3264,626688,894976
test,129,362,370688,6230,1196160,1566848
test,130,221,226304,2322,445824,672128
test,131,85,87040,344,66048,153088
test,132,153,156672,1113,213696,370368
test,133,143,146432,973,186816,333248
test,134,391,400384,7269,1395648,1796032
test,135,234,239616,2604,499968,739584
test,136,382,391168,6938,1332096,1723264
test,137,450,460800,9627,1848384,2309184
test,138,270,276480,3466,665472,941952
test,139,236,241664,2648,508416,750080
test,140,363,371712,6265,1202880,1574592
test,141,103,105472,505,96960,202432
test,142,147,150528,1028,197376,347904
test,143,103,105472,505,96960,202432
test,144,388,397312,7157,1374144,1771456
test,145,232,237568,2559,491328,728896
test,146,280,286720,3728,715776,1002496
test,147,163,166912,1264,242688,409600
test,148,232,237568,2559,491328,728896
test,149,307,314368,4481,860352,1174720
test,150,87,89088,360,69120,158208
test,151,298,305152,4222,810624,1115776
test,152,331,338944,5209,1000128,1339072
test,153,382,391168,6938,1332096,1723264
test,154,449,459776,9585,1840320,2300096
test,155,422,432128,8467,1625664,2057792
test,156,652,667648,20210,3880320,4547968
test,157,232,237568,2559,491328,728896
test,158,267,273408,3390,650880,924288
test,159,221,226304,2322,445824,672128
test,160,279,285696,3701,710592,996288
test,161,500,512000,11886,2282112,2794112
test,162,388,397312,7157,1374144,1771456
test,163,262,268288,3264,626688,894976
test,164,322,329728,4930,946560,1276288
test,165,153,156672,1113,213696,370368
test,166,169,173056,1358,260736,433792
test,167,86,88064,352,67584,155648
test,168,348,356352,5758,1105536,1461888
test,169,231,236544,2537,487104,723648
test,170,297,304128,4194,805248,1109376
test,171,148,151552,1042,200064,351616
test,172,179,183296,1524,292608,475904
test,173,368,376832,6439,1236288,1613120
test,174,264,270336,3314,636288,906624
test,175,136,139264,880,168960,308224
test,176,415,424960,8188,1572096,1997056
test,177,324,331776,4991,958272,1290048
test,178,179,183296,1524,292608,475904
test,179,153,156672,1113,213696,370368
test,180,399,408576,7569,1453248,1861824
test,181,394,403456,7381,1417152,1820608
test,182,64,65536,195,37440,102976
test,183,203,207872,1960,376320,584192
test,184,288,294912,3944,757248,1052160
test,185,245,250880,2854,547968,798848
test,186,253,259072,3043,584256,843328
test,187,134,137216,854,163968,301184
test,188,418,428032,8307,1594944,2022976
test,189,280,286720,3728,715776,1002496
test,190,149,152576,1056,202752,355328
test,191,330,337920,5178,994176,1332096
test,192,334,342016,5304,1018368,1360384
test,193,295,302080,4138,794496,1096576
test,194,202,206848,1940,372480,579328
test,195,260,266240,3214,617088,883328
test,196,98,100352,457,87744,188096
test,197,246,251904,2877,552384,804288
test,198,269,275456,3441,660672,936128
test,199,346,354304,5692,1092864,1447168
test,200,377,386048,6757,1297344,1683392
test,201,362,370688,6230,1196160,1566848
test,202,239,244736,2716,521472,766208
test,203,425,435200,8588,1648896,2084096
test,204,209,214016,2077,398784,612800
test,205,328,335872,5115,982080,1317952
test,206,233,238592,2581,495552,734144
test,207,111,113664,586,112512,226176
test,208,387,396288,7121,1367232,1763520
test,209,195,199680,1808,347136,546816
test,210,336,344064,5368,1030656,1374720
test,211,328,335872,5115,982080,1317952
test,212,191,195584,1735,333120,528704
test,213,352,360448,5891,1131072,1491520
test,214,260,266240,3214,617088,883328
test,215,256,262144,3116,598272,860416
test,216,229,234496,2494,478848,713344
test,217,517,529408,12708,2439936,2969344
test,218,297,304128,4194,805248,1109376
test,219,512,524288,12463,2392896,2917184
test,220,259,265216,3190,612480,877696
test,221,459,470016,10016,1923072,2393088
test,222,108,110592,555,106560,217152
test,223,462,473088,10148,1948416,2421504
test,224,276,282624,3622,695424,978048
test,225,293,300032,4082,783744,1083776
test,226,178,182272,1507,289344,471616
test,227,455,465920,9843,1889856,2355776
test,228,272,278528,3518,675456,953984
test,229,166,169984,1310,251520,421504
test,230,223,228352,2365,454080,682432
test,231,339,347136,5464,1049088,1396224
test,232,307,314368,4481,860352,1174720
test,233,266,272384,3364,645888,918272
test,234,189,193536,1699,326208,519744
test,235,147,150528,1028,197376,347904
test,236,262,268288,3264,626688,894976
test,237,174,178176,1440,276480,454656
test,238,295,302080,4138,794496,1096576
test,239,390,399360,7231,1388352,1787712
test,240,212,217088,2137,410304,627392
test,241,291,297984,4026,772992,1070976
test,242,162,165888,1248,239616,405504
test,243,286,292864,3889,746688,1039552
test,244,263,269312,3289,631488,900800
test,245,260,266240,3214,617088,883328
test,246,457,467968,9929,1906368,2374336
test,247,238,243712,2693,517056,760768
test,248,463,474112,10192,1956864,2430976
test,249,176,180224,1473,282816,463040
test,250,256,262144,3116,598272,860416
test,251,156,159744,1157,222144,381888
test,252,232,237568,2559,491328,728896
test,253,316,323584,4748,911616,1235200
test,254,251,257024,2996,575232,832256
test,255,279,285696,3701,710592,996288
test,256,230,235520,2515,482880,718400
test,257,322,329728,4930,946560,1276288
test,258,402,411648,7683,1475136,1886784
test,259,309,316416,4540,871680,1188096
test,260,220,225280,2301,441792,667072
test,261,319,326656,4838,928896,1255552
test,262,336,344064,5368,1030656,1374720
test,263,234,239616,2604,499968,739584
test,264,180,184320,1541,295872,480192
test,265,297,304128,4194,805248,1109376
test,266,380,389120,6865,1318080,1707200
test,267,304,311296,4394,843648,1154944
test,268,262,268288,3264,626688,894976
test,269,260,266240,3214,617088,883328
test,270,188,192512,1681,322752,515264
test,271,330,337920,5178,994176,1332096
test,272,496,507904,11696,2245632,2753536
test,273,162,165888,1248,239616,405504
test,274,272,278528,3518,675456,953984
test,275,201,205824,1921,368832,574656
test,276,154,157696,1128,216576,374272
test,277,163,166912,1264,242688,409600
test,278,257,263168,3140,602880,866048
test,279,124,126976,731,140352,267328
test,280,195,199680,1808,347136,546816
test,281,241,246784,2762,530304,777088
test,282,103,105472,505,96960,202432
test,283,193,197632,1771,340032,537664
test,284,393,402432,7343,1409856,1812288
test,285,269,275456,3441,660672,936128
test,286,239,244736,2716,521472,766208
test,287,412,421888,8070,1549440,1971328
test,288,242,247808,2785,534720,782528
test,289,224,229376,2386,458112,687488
test,290,377,386048,6757,1297344,1683392
test,291,153,156672,1113,213696,370368
test,292,323,330752,4960,952320,1283072
test,293,346,354304,5692,1092864,1447168
test,294,405,414720,7798,1497216,1911936
test,295,303,310272,4365,838080,1148352
test,296,129,132096,792,152064,284160
test,297,378,387072,6793,1304256,1691328
test,298,468,479232,10413,1999296,2478528
test,299,470,481280,10502,2016384,2497664
test,300,306,313344,4452,854784,1168128
test,301,86,88064,352,67584,155648
test,302,236,241664,2648,508416,750080
test,303,455,465920,9843,1889856,2355776
test,304,449,459776,9585,1840320,2300096
test,305,387,396288,7121,1367232,1763520
test,306,320,327680,4869,934848,1262528
test,307,307,314368,4481,860352,1174720
test,308,157,160768,1172,225024,385792
test,309,267,273408,3390,650880,924288
test,310,109,111616,565,108480,220096
test,311,122,124928,708,135936,260864
test,312,184,188416,1610,309120,497536
test,313,100,102400,476,91392,193792
test,314,236,241664,2648,508416,750080
test,315,148,151552,1042,200064,351616
test,316,418,428032,8307,1594944,2022976
test,317,132,135168,829,159168,294336
test,318,308,315392,4510,865920,1181312
test,319,67,68608,214,41088,109696
test,320,296,303104,4166,799872,1102976
test,321,261,267264,3239,621888,889152
test,322,411,420864,8031,1541952,1962816
test,323,253,259072,3043,584256,843328
test,324,246,251904,2877,552384,804288
test,325,110,112640,576,110592,223232
test,326,310,317440,4569,877248,1194688
test,327,286,292864,3889,746688,1039552
test,328,144,147456,986,189312,336768
test,329,418,428032,8307,1594944,2022976
test,330,170,174080,1374,263808,437888
test,331,184,188416,1610,309120,497536
test,332,173,177152,1423,273216,450368
test,333,373,381952,6615,1270080,1652032
test,334,144,147456,986,189312,336768
test,335,504,516096,12077,2318784,2834880
test,336,117,119808,651,124992,244800
test,337,232,237568,2559,491328,728896
test,338,299,306176,4251,816192,1122368
test,339,60,61440,172,33024,94464
test,340,80,81920,305,58560,140480
test,341,200,204800,1902,365184,569984
test,342,212,217088,2137,410304,627392
test,343,319,326656,4838,928896,1255552
test,344,315,322560,4718,905856,1228416
test,345,241,246784,2762,530304,777088
test,346,289,295936,3971,762432,1058368
test,347,417,427008,8267,1587264,2014272
test,348,327,334848,5084,976128,1310976
test,349,222,227328,2343,449856,677184
test,350,246,251904,2877,552384,804288
test,351,192,196608,1753,336576,533184
test,352,339,347136,5464,1049088,1396224
test,353,368,376832,6439,1236288,1613120
test,354,168,172032,1342,257664,429696
test,355,715,732160,24305,4666560,5398720
test,356,335,343040,5336,1024512,1367552
test,357,165,168960,1295,248640,417600
test,358,265,271360,3339,641088,912448
test,359,401,410624,7645,1467840,1878464
test,360,272,278528,3518,675456,953984
test,361,338,346112,5432,1042944,1389056
test,362,87,89088,360,69120,158208
test,363,264,270336,3314,636288,906624
test,364,64,65536,195,37440,102976
test,365,168,172032,1342,257664,429696
test,366,105,107520,525,100800,208320
test,367,279,285696,3701,710592,996288
test,368,410,419840,7992,1534464,1954304
test,369,122,124928,708,135936,260864
test,370,359,367616,6128,1176576,1544192
test,371,255,261120,3092,593664,854784
test,372,115,117760,629,120768,238528
test,373,298,305152,4222,810624,1115776
test,374,361,369664,6196,1189632,1559296
test,375,629,644096,18810,3611520,4255616
test,376,263,269312,3289,631488,900800
test,377,245,250880,2854,547968,798848
test,378,208,212992,2057,394944,607936
test,379,177,181248,1490,286080,467328
test,380,128,131072,779,149568,280640
test,381,384,393216,7011,1346112,1739328
test,382,289,295936,3971,762432,1058368
test,383,114,116736,618,118656,235392
test,384,159,162816,1202,230784,393600
test,385,224,229376,2386,458112,687488
test,386,208,212992,2057,394944,607936
test,387,361,369664,6196,1189632,1559296
test,388,288,294912,3944,757248,1052160
test,389,133,136192,841,161472,297664
test,390,224,229376,2386,458112,687488
test,391,93,95232,412,79104,174336
test,392,388,397312,7157,1374144,1771456
test,393,396,405504,7456,1431552,1837056
test,394,455,465920,9843,1889856,2355776
test,395,308,315392,4510,865920,1181312
test,396,392,401408,7306,1402752,1804160
test,397,146,149504,1014,194688,344192
test,398,301,308224,4308,827136,1135360
test,399,219,224256,2281,437952,662208
test,400,415,424960,8188,1572096,1997056
test,401,161,164864,1233,236736,401600
test,402,316,323584,4748,911616,1235200
test,403,398,407552,7531,1445952,1853504
test,404,235,240640,2626,504192,744832
test,405,229,234496,2494,478848,713344
test,406,177,181248,1490,286080,467328
test,407,407,416768,7876,1512192,1928960
test,408,380,389120,6865,1318080,1707200
test,409,422,432128,8467,1625664,2057792
test,410,274,280576,3570,685440,966016
test,411,261,267264,3239,621888,889152
test,412,106,108544,535,102720,211264
test,413,412,421888,8070,1549440,1971328
test,414,231,236544,2537,487104,723648
test,415,381,390144,6902,1325184,1715328
test,416,493,504832,11555,2218560,2723392
test,417,424,434176,8547,1641024,2075200
test,418,455,465920,9843,1889856,2355776
test,419,185,189440,1628,312576,502016
test,420,190,194560,1717,329664,524224
test,421,137,140288,893,171456,311744
test,422,181,185344,1558,299136,484480
test,423,176,180224,1473,282816,463040
test,424,489,500736,11368,2182656,2683392
test,425,156,159744,1157,222144,381888
test,426,317,324608,4778,917376,1241984
test,427,197,201728,1845,354240,555968
test,428,293,300032,4082,783744,1083776
test,429,159,162816,1202,230784,393600
test,430,207,211968,2038,391296,603264
test,431,172,176128,1407,270144,446272
test,432,380,389120,6865,1318080,1707200
test,433,330,337920,5178,994176,1332096
test,434,269,275456,3441,660672,936128
test,435,262,268288,3264,626688,894976
test,436,267,273408,3390,650880,924288
test,437,567,580608,15284,2934528,3515136
test,438,414,423936,8149,1564608,1988544
test,439,342,350208,5561,1067712,1417920
test,440,623,637952,18452,3542784,4180736
test,441,301,308224,4308,827136,1135360
test,442,262,268288,3264,626688,894976
test,443,265,271360,3339,641088,912448
test,444,103,105472,505,96960,202432
test,445,298,305152,4222,810624,1115776
test,446,331,338944,5209,1000128,1339072
test,447,226,231424,2429,466368,697792
test,448,384,393216,7011,1346112,1739328
test,449,245,250880,2854,547968,798848
test,450,497,508928,11743,2254656,2763584
test,451,429,439296,8750,1680000,2119296
test,452,490,501760,11415,2191680,2693440
test,453,427,437248,8669,1664448,2101696
test,454,255,261120,3092,593664,854784
test,455,278,284672,3675,705600,990272
test,456,460,471040,10060,1931520,2402560
test,457,397,406528,7493,1438656,1845184
test,458,398,407552,7531,1445952,1853504
test,459,238,243712,2693,517056,760768
test,460,403,412672,7722,1482624,1895296
test,461,332,339968,5241,1006272,1346240
test,462,239,244736,2716,521472,766208
test,463,234,239616,2604,499968,739584
test,464,136,139264,880,168960,308224
test,465,355,363520,5992,1150464,1513984
test,466,156,159744,1157,222144,381888
test,467,351,359424,5858,1124736,1484160
test,468,268,274432,3415,655680,930112
test,469,384,393216,7011,1346112,1739328
test,470,342,350208,5561,1067712,1417920
test,471,285,291840,3862,741504,1033344
test,472,132,135168,829,159168,294336
test,473,383,392192,6974,1339008,1731200
test,474,228,233472,2472,474624,708096
test,475,652,667648,20210,3880320,4547968
test,476,152,155648,1099,211008,366656
test,477,396,405504,7456,1431552,1837056
test,478,125,128000,743,142656,270656
test,479,189,193536,1699,326208,519744
test,480,412,421888,8070,1549440,1971328
test,481,397,406528,7493,1438656,1845184
test,482,258,264192,3165,607680,871872
test,483,143,146432,973,186816,333248
test,484,404,413696,7760,1489920,1903616
test,485,144,147456,986,189312,336768
test,486,124,126976,731,140352,267328
test,487,291,297984,4026,772992,1070976
test,488,407,416768,7876,1512192,1928960
test,489,466,477184,10324,1982208,2459392
test,490,211,216064,2117,406464,622528
test,491,375,384000,6686,1283712,1667712
test,492,264,270336,3314,636288,906624
test,493,326,333824,5053,970176,1304000
test,494,108,110592,555,106560,217152
test,495,209,214016,2077,398784,612800
test,496,298,305152,4222,810624,1115776
test,497,550,563200,14382,2761344,3324544
test,498,299,306176,4251,816192,1122368
test,499,419,429056,8347,1602624,2031680
test,500,131,134144,816,156672,290816
test,501,258,264192,3165,607680,871872
test,502,218,223232,2260,433920,657152
test,503,201,205824,1921,368832,574656
test,504,200,204800,1902,365184,569984
test,505,357,365568,6059,1163328,1528896
test,506,174,178176,1440,276480,454656
test,507,353,361472,5924,1137408,1498880
test,508,396,405504,7456,1431552,1837056
test,509,585,599040,16270,3123840,3722880
test,510,245,250880,2854,547968,798848
test,511,215,220160,2198,422016,642176
test,512,252,258048,3019,579648,837696
test,513,396,405504,7456,1431552,1837056
test,514,129,132096,792,152064,284160
test,515,337,345088,5400,1036800,1381888
test,516,215,220160,2198,422016,642176
test,517,194,198656,1790,343680,542336
test,518,443,453632,9330,1791360,2244992
test,519,334,342016,5304,1018368,1360384
test,520,99,101376,466,89472,190848
test,521,148,151552,1042,200064,351616
test,522,119,121856,674,129408,251264
test,523,290,296960,3999,767808,1064768
test,524,535,547840,13608,2612736,3160576
test,525,230,235520,2515,482880,718400
test,526,635,650240,19170,3680640,4330880
test,527,256,262144,3116,598272,860416
test,528,83,84992,328,62976,147968
test,529,56,57344,150,28800,86144
test,530,422,432128,8467,1625664,2057792
test,531,195,199680,1808,347136,546816
test,532,139,142336,919,176448,318784
test,533,178,182272,1507,289344,471616
test,534,357,365568,6059,1163328,1528896
test,535,568,581632,15338,2944896,3526528
test,536,137,140288,893,171456,311744
test,537,142,145408,959,184128,329536
test,538,364,372736,6299,1209408,1582144
test,539,278,284672,3675,705600,990272
test,540,299,306176,4251,816192,1122368
test,541,189,193536,1699,326208,519744
test,542,235,240640,2626,504192,744832
test,543,309,316416,4540,871680,1188096
test,544,117,119808,651,124992,244800
test,545,326,333824,5053,970176,1304000
test,546,326,333824,5053,970176,1304000
test,547,312,319488,4628,888576,1208064
test,548,550,563200,14382,2761344,3324544
test,549,132,135168,829,159168,294336
test,550,240,245760,2739,525888,771648
test,551,351,359424,5858,1124736,1484160
test,552,211,216064,2117,406464,622528
test,553,165,168960,1295,248640,417600
test,554,215,220160,2198,422016,642176
test,555,115,117760,629,120768,238528
test,556,229,234496,2494,478848,713344
test,557,460,471040,10060,1931520,2402560
test,558,514,526336,12561,2411712,2938048
test,559,288,294912,3944,757248,1052160
test,560,347,355328,5725,1099200,1454528
test,561,223,228352,2365,454080,682432
test,562,125,128000,743,142656,270656
test,563,482,493568,11045,2120640,2614208
test,564,236,241664,2648,508416,750080
test,565,349,357376,5791,1111872,1469248
test,566,644,659456,19717,3785664,4445120
test,567,386,395264,7084,1360128,1755392
test,568,381,390144,6902,1325184,1715328
test,569,205,209920,1998,383616,593536
test,570,193,197632,1771,340032,537664
test,571,256,262144,3116,598272,860416
test,572,224,229376,2386,458112,687488
test,573,237,242688,2671,512832,755520
test,574,164,167936,1279,245568,413504
test,575,187,191488,1663,319296,510784
test,576,430,440320,8791,1687872,2128192
test,577,119,121856,674,129408,251264
test,578,372,380928,6579,1263168,1644096
test,579,154,157696,1128,216576,374272
test,580,379,388096,6829,1311168,1699264
test,581,137,140288,893,171456,311744
test,582,327,334848,5084,976128,1310976
test,583,233,238592,2581,495552,734144
test,584,596,610304,16888,3242496,3852800
test,585,423,433152,8507,1633344,2066496
test,586,359,367616,6128,1176576,1544192
test,587,170,174080,1374,263808,437888
test,588,70,71680,240,46080,117760
test,589,330,337920,5178,994176,1332096
test,590,366,374784,6369,1222848,1597632
test,591,233,238592,2581,495552,734144
test,592,357,365568,6059,1163328,1528896
test,593,324,331776,4991,958272,1290048
test,594,271,277504,3492,670464,947968
test,595,231,236544,2537,487104,723648
test,596,502,514048,11981,2300352,2814400
test,597,290,296960,3999,767808,1064768
test,598,106,108544,535,102720,211264
test,599,213,218112,2157,414144,632256
test,600,110,112640,576,110592,223232
test,601,251,257024,2996,575232,832256
test,602,168,172032,1342,257664,429696
test,603,231,236544,2537,487104,723648
test,604,295,302080,4138,794496,1096576
test,605,474,485376,10682,2050944,2536320
test,606,510,522240,12366,2374272,2896512
test,607,305,312320,4423,849216,1161536
test,608,224,229376,2386,458112,687488
test,609,126,129024,755,144960,273984
test,610,301,308224,4308,827136,1135360
test,611,290,296960,3999,767808,1064768
test,612,447,457728,9500,1824000,2281728
test,613,410,419840,7992,1534464,1954304
test,614,491,502784,11462,2200704,2703488
test,615,365,373760,6334,1216128,1589888
test,616,191,195584,1735,333120,528704
test,617,145,148480,1000,192000,340480
test,618,232,237568,2559,491328,728896
test,619,258,264192,3165,607680,871872
test,620,213,218112,2157,414144,632256
test,621,284,290816,3835,736320,1027136
test,622,515,527360,12609,2420928,2948288
test,623,367,375808,6404,1229568,1605376
test,624,74,75776,261,50112,125888
test,625,286,292864,3889,746688,1039552
test,626,307,314368,4481,860352,1174720
test,627,169,173056,1358,260736,433792
test,628,222,227328,2343,449856,677184
test,629,266,272384,3364,645888,918272
test,630,408,417792,7914,1519488,1937280
test,631,348,356352,5758,1105536,1461888
test,632,144,147456,986,189312,336768
test,633,347,355328,5725,1099200,1454528
test,634,274,280576,3570,685440,966016
test,635,253,259072,3043,584256,843328
test,636,343,351232,5594,1074048,1425280
test,637,324,331776,4991,958272,1290048
test,638,313,320512,4658,894336,1214848
test,639,247,252928,2901,556992,809920
test,640,290,296960,3999,767808,1064768
test,641,441,451584,9246,1775232,2226816
test,642,108,110592,555,106560,217152
test,643,308,315392,4510,865920,1181312
test,644,384,393216,7011,1346112,1739328
test,645,293,300032,4082,783744,1083776
test,646,536,548864,13659,2622528,3171392
test,647,92,94208,403,77376,171584
test,648,429,439296,8750,1680000,2119296
test,649,81,82944,312,59904,142848
test,650,145,148480,1000,192000,340480
test,651,435,445440,8996,1727232,2172672
test,652,290,296960,3999,767808,1064768
test,653,176,180224,1473,282816,463040
test,654,180,184320,1541,295872,480192
test,655,427,437248,8669,1664448,2101696
test,656,423,433152,8507,1633344,2066496
test,657,460,471040,10060,1931520,2402560
test,658,329,336896,5146,988032,1324928
test,659,228,233472,2472,474624,708096
test,660,334,342016,5304,1018368,1360384
test,661,263,269312,3289,631488,900800
test,662,291,297984,4026,772992,1070976
test,663,325,332800,5022,964224,1297024
test,664,301,308224,4308,827136,1135360
test,665,313,320512,4658,894336,1214848
test,666,373,381952,6615,1270080,1652032
test,667,237,242688,2671,512832,755520
test,668,636,651264,19231,3692352,4343616
test,669,253,259072,3043,584256,843328
test,670,283,289792,3808,731136,1020928
test,671,307,314368,4481,860352,1174720
test,672,390,399360,7231,1388352,1787712
test,673,368,376832,6439,1236288,1613120
test,674,467,478208,10369,1990848,2469056
test,675,228,233472,2472,474624,708096
test,676,266,272384,3364,645888,918272
test,677,266,272384,3364,645888,918272
test,678,398,407552,7531,1445952,1853504
test,679,201,205824,1921,368832,574656
test,680,155,158720,1143,219456,378176
test,681,244,249856,2831,543552,793408
test,682,382,391168,6938,1332096,1723264
test,683,336,344064,5368,1030656,1374720
test,684,249,254976,2948,566016,820992
test,685,556,569344,14697,2821824,3391168
test,686,201,205824,1921,368832,574656
test,687,247,252928,2901,556992,809920
test,688,197,201728,1845,354240,555968
test,689,211,216064,2117,406464,622528
test,690,433,443392,8914,1711488,2154880
test,691,222,227328,2343,449856,677184
test,692,373,381952,6615,1270080,1652032
test,693,269,275456,3441,660672,936128
test,694,213,218112,2157,414144,632256
test,695,363,371712,6265,1202880,1574592
test,696,439,449536,9163,1759296,2208832
test,697,222,227328,2343,449856,677184
test,698,476,487424,10772,2068224,2555648
test,699,415,424960,8188,1572096,1997056
test,700,356,364544,6026,1156992,1521536
test,701,240,245760,2739,525888,771648
test,702,264,270336,3314,636288,906624
test,703,252,258048,3019,579648,837696
test,704,432,442368,8873,1703616,2145984
test,705,272,278528,3518,675456,953984
test,706,300,307200,4279,821568,1128768
test,707,126,129024,755,144960,273984
test,708,147,150528,1028,197376,347904
test,709,206,210944,2018,387456,598400
test,710,170,174080,1374,263808,437888
test,711,188,192512,1681,322752,515264
test,712,465,476160,10280,1973760,2449920
test,713,100,102400,476,91392,193792
test,714,358,366592,6093,1169856,1536448
test,715,125,128000,743,142656,270656
test,716,210,215040,2097,402624,617664
test,717,82,83968,320,61440,145408
test,718,149,152576,1056,202752,355328
test,719,85,87040,344,66048,153088
test,720,168,172032,1342,257664,429696
test,721,261,267264,3239,621888,889152
test,722,126,129024,755,144960,273984
test,723,249,254976,2948,566016,820992
test,724,306,313344,4452,854784,1168128
test,725,238,243712,2693,517056,760768
test,726,326,333824,5053,970176,1304000
test,727,406,415744,7837,1504704,1920448
test,728,134,137216,854,163968,301184
test,729,320,327680,4869,934848,1262528
test,730,396,405504,7456,1431552,1837056
test,731,303,310272,4365,838080,1148352
test,732,536,548864,13659,2622528,3171392
test,733,221,226304,2322,445824,672128
test,734,215,220160,2198,422016,642176
test,735,136,139264,880,168960,308224
test,736,94,96256,421,80832,177088
test,737,269,275456,3441,660672,936128
test,738,128,131072,779,149568,280640
test,739,478,489472,10863,2085696,2575168
test,740,102,104448,495,95040,199488
test,741,503,515072,12029,2309568,2824640
test,742,415,424960,8188,1572096,1997056
test,743,190,194560,1717,329664,524224
test,744,93,95232,412,79104,174336
test,745,301,308224,4308,827136,1135360
test,746,109,111616,565,108480,220096
test,747,201,205824,1921,368832,574656
test,748,261,267264,3239,621888,889152
test,749,152,155648,1099,211008,366656
test,750,615,629760,17982,3452544,4082304
test,751,329,336896,5146,988032,1324928
test,752,287,293888,3916,751872,1045760
test,753,301,308224,4308,827136,1135360
test,754,164,167936,1279,245568,413504
test,755,486,497664,11229,2155968,2653632
test,756,268,274432,3415,655680,930112
test,757,323,330752,4960,952320,1283072
test,758,175,179200,1456,279552,458752
test,759,154,157696,1128,216576,374272
test,760,276,282624,3622,695424,978048
test,761,171,175104,1391,267072,442176
test,762,292,299008,4054,778368,1077376
test,763,304,311296,4394,843648,1154944
test,764,400,409600,7607,1460544,1870144
test,765,199,203776,1883,361536,565312
test,766,178,182272,1507,289344,471616
test,767,85,87040,344,66048,153088
test,768,108,110592,555,106560,217152
test,769,254,260096,3068,589056,849152
test,770,211,216064,2117,406464,622528
test,771,195,199680,1808,347136,546816
test,772,398,407552,7531,1445952,1853504
test,773,495,506880,11649,2236608,2743488
test,774,261,267264,3239,621888,889152
test,775,107,109568,545,104640,214208
test,776,120,122880,685,131520,254400
test,777,276,282624,3622,695424,978048
test,778,309,316416,4540,871680,1188096
test,779,92,94208,403,77376,171584
test,780,397,406528,7493,1438656,1845184
test,781,563,576512,15069,2893248,3469760
test,782,307,314368,4481,860352,1174720
test,783,92,94208,403,77376,171584
test,784,340,348160,5496,1055232,1403392
test,785,313,320512,4658,894336,1214848
test,786,281,287744,3754,720768,1008512
test,787,226,231424,2429,466368,697792
test,788,505,517120,12125,2328000,2845120
test,789,311,318464,4599,883008,1201472
test,790,172,176128,1407,270144,446272
test,791,116,118784,640,122880,241664
test,792,292,299008,4054,778368,1077376
test,793,398,407552,7531,1445952,1853504
test,794,510,522240,12366,2374272,2896512
test,795,89,91136,377,72384,163520
test,796,207,211968,2038,391296,603264
test,797,142,145408,959,184128,329536
test,798,302,309248,4336,832512,1141760
test,799,190,194560,1717,329664,524224
test,800,164,167936,1279,245568,413504
test,801,673,689152,21533,4134336,4823488
test,802,276,282624,3622,695424,978048
test,803,240,245760,2739,525888,771648
test,804,210,215040,2097,402624,617664
test,805,241,246784,2762,530304,777088
test,806,372,380928,6579,1263168,1644096
test,807,336,344064,5368,1030656,1374720
test,808,389,398336,7194,1381248,1779584
test,809,278,284672,3675,705600,990272
test,810,239,244736,2716,521472,766208
test,811,51,52224,124,23808,76032
test,812,120,122880,685,131520,254400
test,813,331,338944,5209,1000128,1339072
test,814,405,414720,7798,1497216,1911936
test,815,82,83968,320,61440,145408
test,816,280,286720,3728,715776,1002496
test,817,103,105472,505,96960,202432
test,818,209,214016,2077,398784,612800
test,819,409,418816,7953,1526976,1945792
test,820,517,529408,12708,2439936,2969344
test,821,217,222208,2239,429888,652096
test,822,577,590848,15828,3038976,3629824
test,823,216,221184,2219,426048,647232
test,824,520,532480,12855,2468160,3000640
test,825,277,283648,3648,700416,984064
test,826,388,397312,7157,1374144,1771456
test,827,411,420864,8031,1541952,1962816
test,828,362,370688,6230,1196160,1566848
test,829,113,115712,608,116736,232448
test,830,260,266240,3214,617088,883328
test,831,317,324608,4778,917376,1241984
test,832,224,229376,2386,458112,687488
test,833,111,113664,586,112512,226176
test,834,79,80896,297,57024,137920
test,835,166,169984,1310,251520,421504
test,836,480,491520,10954,2103168,2594688
test,837,568,581632,15338,2944896,3526528
test,838,382,391168,6938,1332096,1723264
test,839,190,194560,1717,329664,524224
test,840,163,166912,1264,242688,409600
test,841,374,382976,6650,1276800,1659776
test,842,154,157696,1128,216576,374272
test,843,336,344064,5368,1030656,1374720
test,844,100,102400,476,91392,193792
test,845,84,86016,336,64512,150528
test,846,481,492544,11000,2112000,2604544
test,847,251,257024,2996,575232,832256
test,848,348,356352,5758,1105536,1461888
test,849,283,289792,3808,731136,1020928
test,850,283,289792,3808,731136,1020928
test,851,345,353280,5659,1086528,1439808
test,852,197,201728,1845,354240,555968
test,853,234,239616,2604,499968,739584
test,854,237,242688,2671,512832,755520
test,855,330,337920,5178,994176,1332096
test,856,238,243712,2693,517056,760768
test,857,203,207872,1960,376320,584192
test,858,399,408576,7569,1453248,1861824
test,859,252,258048,3019,579648,837696
test,860,245,250880,2854,547968,798848
test,861,238,243712,2693,517056,760768
test,862,390,399360,7231,1388352,1787712
test,863,622,636928,18393,3531456,4168384
test,864,110,112640,576,110592,223232
test,865,347,355328,5725,1099200,1454528
test,866,439,449536,9163,1759296,2208832
test,867,486,497664,11229,2155968,2653632
test,868,108,110592,555,106560,217152
test,869,313,320512,4658,894336,1214848
test,870,173,177152,1423,273216,450368
test,871,145,148480,1000,192000,340480
test,872,209,214016,2077,398784,612800
test,873,489,500736,11368,2182656,2683392
test,874,269,275456,3441,660672,936128
test,875,69,70656,227,43584,114240
test,876,427,437248,8669,1664448,2101696
test,877,116,118784,640,122880,241664
test,878,306,313344,4452,854784,1168128
test,879,174,178176,1440,276480,454656
test,880,436,446464,9038,1735296,2181760
test,881,257,263168,3140,602880,866048
test,882,161,164864,1233,236736,401600
test,883,418,428032,8307,1594944,2022976
test,884,296,303104,4166,799872,1102976
test,885,370,378880,6509,1249728,1628608
test,886,269,275456,3441,660672,936128
test,887,441,451584,9246,1775232,2226816
test,888,104,106496,515,98880,205376
test,889,312,319488,4628,888576,1208064
test,890,114,116736,618,118656,235392
test,891,253,259072,3043,584256,843328
test,892,430,440320,8791,1687872,2128192
test,893,361,369664,6196,1189632,1559296
test,894,308,315392,4510,865920,1181312
test,895,138,141312,906,173952,315264
test,896,363,371712,6265,1202880,1574592
test,897,367,375808,6404,1229568,1605376
test,898,122,124928,708,135936,260864
test,899,400,409600,7607,1460544,1870144
test,900,427,437248,8669,1664448,2101696
test,901,223,228352,2365,454080,682432
test,902,225,230400,2407,462144,692544
test,903,388,397312,7157,1374144,1771456
test,904,160,163840,1217,233664,397504
test,905,390,399360,7231,1388352,1787712
test,906,174,178176,1440,276480,454656
test,907,143,146432,973,186816,333248
test,908,166,169984,1310,251520,421504
test,909,84,86016,336,64512,150528
test,910,350,358400,5824,1118208,1476608
test,911,221,226304,2322,445824,672128
test,912,179,183296,1524,292608,475904
test,913,239,244736,2716,521472,766208
test,914,238,243712,2693,517056,760768
test,915,296,303104,4166,799872,1102976
test,916,293,300032,4082,783744,1083776
test,917,91,93184,394,75648,168832
test,918,347,355328,5725,1099200,1454528
test,919,286,292864,3889,746688,1039552
test,920,301,308224,4308,827136,1135360
test,921,169,173056,1358,260736,433792
test,922,336,344064,5368,1030656,1374720
test,923,171,175104,1391,267072,442176
test,924,265,271360,3339,641088,912448
test,925,85,87040,344,66048,153088
test,926,256,262144,3116,598272,860416
test,927,395,404480,7418,1424256,1828736
test,928,238,243712,2693,517056,760768
test,929,114,116736,618,118656,235392
test,930,286,292864,3889,746688,1039552
test,931,170,174080,1374,263808,437888
test,932,267,273408,3390,650880,924288
test,933,388,397312,7157,1374144,1771456
test,934,199,203776,1883,361536,565312
test,935,229,234496,2494,478848,713344
test,936,257,263168,3140,602880,866048
test,937,557,570368,14750,2832000,3402368
test,938,389,398336,7194,1381248,1779584
test,939,205,209920,1998,383616,593536
test,940,239,244736,2716,521472,766208
test,941,306,313344,4452,854784,1168128
test,942,88,90112,369,70848,160960
test,943,530,542720,13355,2564160,3106880
test,944,461,472064,10104,1939968,2412032
test,945,398,407552,7531,1445952,1853504
test,946,175,179200,1456,279552,458752
test,947,267,273408,3390,650880,924288
test,948,347,355328,5725,1099200,1454528
test,949,265,271360,3339,641088,912448
test,950,220,225280,2301,441792,667072
test,951,228,233472,2472,474624,708096
test,952,446,456704,9457,1815744,2272448
test,953,357,365568,6059,1163328,1528896
test,954,281,287744,3754,720768,1008512
test,955,379,388096,6829,1311168,1699264
test,956,195,199680,1808,347136,546816
test,957,325,332800,5022,964224,1297024
test,958,291,297984,4026,772992,1070976
test,959,153,156672,1113,213696,370368
test,960,278,284672,3675,705600,990272
test,961,149,152576,1056,202752,355328
test,962,260,266240,3214,617088,883328
test,963,245,250880,2854,547968,798848
test,964,203,207872,1960,376320,584192
test,965,211,216064,2117,406464,622528
test,966,165,168960,1295,248640,417600
test,967,424,434176,8547,1641024,2075200
test,968,344,352256,5626,1080192,1432448
test,969,257,263168,3140,602880,866048
test,970,176,180224,1473,282816,463040
test,971,298,305152,4222,810624,1115776
test,972,221,226304,2322,445824,672128
test,973,148,151552,1042,200064,351616
test,974,201,205824,1921,368832,574656
test,975,507,519168,12221,2346432,2865600
test,976,180,184320,1541,295872,480192
test,977,166,169984,1310,251520,421504
test,978,357,365568,6059,1163328,1528896
test,979,444,454656,9372,1799424,2254080
test,980,293,300032,4082,783744,1083776
test,981,273,279552,3544,680448,960000
test,982,418,428032,8307,1594944,2022976
test,983,391,400384,7269,1395648,1796032
test,984,380,389120,6865,1318080,1707200
test,985,72,73728,247,47424,121152
test,986,161,164864,1233,236736,401600
test,987,270,276480,3466,665472,941952
test,988,338,346112,5432,1042944,1389056
test,989,408,417792,7914,1519488,1937280
test,990,179,183296,1524,292608,475904
test,991,111,113664,586,112512,226176
test,992,263,269312,3289,631488,900800
test,993,342,350208,5561,1067712,1417920
test,994,272,278528,3518,675456,953984
test,995,120,122880,685,131520,254400
test,996,537,549888,13710,2632320,3182208
test,997,322,329728,4930,946560,1276288
test,998,166,169984,1310,251520,421504
test,999,345,353280,5659,1086528,1439808
test,1000,282,288768,3781,725952,1014720
test,1001,211,216064,2117,406464,622528
test,1002,194,198656,1790,343680,542336
test,1003,286,292864,3889,746688,1039552
test,1004,402,411648,7683,1475136,1886784
test,1005,192,196608,1753,336576,533184
test,1006,179,183296,1524,292608,475904
test,1007,470,481280,10502,2016384,2497664
test,1008,185,189440,1628,312576,502016
test,1009,313,320512,4658,894336,1214848
test,1010,169,173056,1358,260736,433792
test,1011,325,332800,5022,964224,1297024
test,1012,430,440320,8791,1687872,2128192
test,1013,268,274432,3415,655680,930112
test,1014,289,295936,3971,762432,1058368
test,1015,210,215040,2097,402624,617664
test,1016,179,183296,1524,292608,475904
test,1017,330,337920,5178,994176,1332096
test,1018,145,148480,1000,192000,340480
test,1019,260,266240,3214,617088,883328
test,1020,301,308224,4308,827136,1135360
test,1021,256,262144,3116,598272,860416
test,1022,99,101376,466,89472,190848
test,1023,170,174080,1374,263808,437888
test,1024,344,352256,5626,1080192,1432448
test,1025,403,412672,7722,1482624,1895296
test,1026,72,73728,247,47424,121152
test,1027,239,244736,2716,521472,766208
test,1028,287,293888,3916,751872,1045760
test,1029,212,217088,2137,410304,627392
test,1030,199,203776,1883,361536,565312
test,1031,90,92160,386,74112,166272
test,1032,245,250880,2854,547968,798848
test,1033,310,317440,4569,877248,1194688
test,1034,250,256000,2972,570624,826624
test,1035,195,199680,1808,347136,546816
test,1036,99,101376,466,89472,190848
test,1037,253,259072,3043,584256,843328
test,1038,267,273408,3390,650880,924288
test,1039,85,87040,344,66048,153088
test,1040,78,79872,290,55680,135552
test,1041,390,399360,7231,1388352,1787712
test,1042,217,222208,2239,429888,652096
test,1043,198,202752,1864,357888,560640
test,1044,325,332800,5022,964224,1297024
test,1045,361,369664,6196,1189632,1559296
test,1046,442,452608,9288,1783296,2235904
test,1047,451,461824,9670,1856640,2318464
test,1048,249,254976,2948,566016,820992
test,1049,387,396288,7121,1367232,1763520
test,1050,284,290816,3835,736320,1027136
test,1051,233,238592,2581,495552,734144
test,1052,171,175104,1391,267072,442176
test,1053,205,209920,1998,383616,593536
test,1054,311,318464,4599,883008,1201472
test,1055,326,333824,5053,970176,1304000
test,1056,265,271360,3339,641088,912448
test,1057,536,548864,13659,2622528,3171392
test,1058,115,117760,629,120768,238528
test,1059,112,114688,597,114624,229312
test,1060,174,178176,1440,276480,454656
test,1061,618,632832,18157,3486144,4118976
test,1062,214,219136,2178,418176,637312
test,1063,603,617472,17287,3319104,3936576
test,1064,218,223232,2260,433920,657152
test,1065,422,432128,8467,1625664,2057792
test,1066,228,233472,2472,474624,708096
test,1067,191,195584,1735,333120,528704
test,1068,199,203776,1883,361536,565312
test,1069,338,346112,5432,1042944,1389056
test,1070,383,392192,6974,1339008,1731200
test,1071,235,240640,2626,504192,744832
test,1072,274,280576,3570,685440,966016
test,1073,198,202752,1864,357888,560640
test,1074,339,347136,5464,1049088,1396224
test,1075,529,541696,13304,2554368,3096064
test,1076,251,257024,2996,575232,832256
test,1077,435,445440,8996,1727232,2172672
test,1078,351,359424,5858,1124736,1484160
test,1079,573,586752,15609,2996928,3583680
test,1080,442,452608,9288,1783296,2235904
test,1081,279,285696,3701,710592,996288
test,1082,219,224256,2281,437952,662208
test,1083,375,384000,6686,1283712,1667712
test,1084,416,425984,8228,1579776,2005760
test,1085,380,389120,6865,1318080,1707200
test,1086,405,414720,7798,1497216,1911936
test,1087,462,473088,10148,1948416,2421504
test,1088,273,279552,3544,680448,960000
test,1089,289,295936,3971,762432,1058368
test,1090,60,61440,172,33024,94464
test,1091,321,328704,4899,940608,1269312
test,1092,272,278528,3518,675456,953984
test,1093,86,88064,352,67584,155648
test,1094,335,343040,5336,1024512,1367552
test,1095,354,362496,5958,1143936,1506432
test,1096,502,514048,11981,2300352,2814400
test,1097,477,488448,10817,2076864,2565312
test,1098,355,363520,5992,1150464,1513984
test,1099,564,577536,15123,2903616,3481152
test,1100,336,344064,5368,1030656,1374720
test,1101,431,441344,8832,1695744,2137088
test,1102,124,126976,731,140352,267328
test,1103,113,115712,608,116736,232448
test,1104,290,296960,3999,767808,1064768
test,1105,544,557056,14069,2701248,3258304
test,1106,290,296960,3999,767808,1064768
test,1107,475,486400,10727,2059584,2545984
test,1108,273,279552,3544,680448,960000
test,1109,293,300032,4082,783744,1083776
test,1110,401,410624,7645,1467840,1878464
test,1111,261,267264,3239,621888,889152
test,1112,273,279552,3544,680448,960000
test,1113,191,195584,1735,333120,528704
test,1114,425,435200,8588,1648896,2084096
test,1115,225,230400,2407,462144,692544
test,1116,330,337920,5178,994176,1332096
test,1117,138,141312,906,173952,315264
test,1118,388,397312,7157,1374144,1771456
test,1119,210,215040,2097,402624,617664
test,1120,290,296960,3999,767808,1064768
test,1121,290,296960,3999,767808,1064768
test,1122,300,307200,4279,821568,1128768
test,1123,96,98304,439,84288,182592
test,1124,226,231424,2429,466368,697792
test,1125,449,459776,9585,1840320,2300096
test,1126,184,188416,1610,309120,497536
test,1127,310,317440,4569,877248,1194688
test,1128,213,218112,2157,414144,632256
test,1129,396,405504,7456,1431552,1837056
test,1130,390,399360,7231,1388352,1787712
test,1131,318,325632,4808,923136,1248768
test,1132,321,328704,4899,940608,1269312
test,1133,238,243712,2693,517056,760768
test,1134,383,392192,6974,1339008,1731200
test,1135,328,335872,5115,982080,1317952
test,1136,405,414720,7798,1497216,1911936
test,1137,309,316416,4540,871680,1188096
test,1138,356,364544,6026,1156992,1521536
test,1139,207,211968,2038,391296,603264
test,1140,229,234496,2494,478848,713344
test,1141,180,184320,1541,295872,480192
test,1142,302,309248,4336,832512,1141760
test,1143,368,376832,6439,1236288,1613120
test,1144,427,437248,8669,1664448,2101696
test,1145,290,296960,3999,767808,1064768
test,1146,612,626688,17807,3418944,4045632
test,1147,205,209920,1998,383616,593536
test,1148,470,481280,10502,2016384,2497664
test,1149,362,370688,6230,1196160,1566848
test,1150,416,425984,8228,1579776,2005760
test,1151,86,88064,352,67584,155648
test,1152,71,72704,240,46080,118784
test,1153,115,117760,629,120768,238528
test,1154,322,329728,4930,946560,1276288
test,1155,359,367616,6128,1176576,1544192
test,1156,340,348160,5496,1055232,1403392
test,1157,98,100352,457,87744,188096
test,1158,220,225280,2301,441792,667072
test,1159,451,461824,9670,1856640,2318464
test,1160,380,389120,6865,1318080,1707200
test,1161,405,414720,7798,1497216,1911936
test,1162,95,97280,430,82560,179840
test,1163,98,100352,457,87744,188096
test,1164,209,214016,2077,398784,612800
test,1165,207,211968,2038,391296,603264
test,1166,215,220160,2198,422016,642176
test,1167,332,339968,5241,1006272,1346240
test,1168,146,149504,1014,194688,344192
test,1169,114,116736,618,118656,235392
test,1170,468,479232,10413,1999296,2478528
test,1171,239,244736,2716,521472,766208
test,1172,191,195584,1735,333120,528704
test,1173,380,389120,6865,1318080,1707200
test,1174,292,299008,4054,778368,1077376
test,1175,180,184320,1541,295872,480192
test,1176,381,390144,6902,1325184,1715328
test,1177,115,117760,629,120768,238528
test,1178,299,306176,4251,816192,1122368
test,1179,271,277504,3492,670464,947968
test,1180,202,206848,1940,372480,579328
test,1181,373,381952,6615,1270080,1652032
test,1182,180,184320,1541,295872,480192
test,1183,215,220160,2198,422016,642176
test,1184,166,169984,1310,251520,421504
test,1185,339,347136,5464,1049088,1396224
test,1186,338,346112,5432,1042944,1389056
test,1187,261,267264,3239,621888,889152
test,1188,203,207872,1960,376320,584192
test,1189,89,91136,377,72384,163520
test,1190,219,224256,2281,437952,662208
test,1191,349,357376,5791,1111872,1469248
test,1192,344,352256,5626,1080192,1432448
test,1193,296,303104,4166,799872,1102976
test,1194,349,357376,5791,1111872,1469248
test,1195,360,368640,6162,1183104,1551744
test,1196,295,302080,4138,794496,1096576
test,1197,358,366592,6093,1169856,1536448
test,1198,167,171008,1326,254592,425600
test,1199,358,366592,6093,1169856,1536448
test,1200,357,365568,6059,1163328,1528896
test,1201,208,212992,2057,394944,607936
test,1202,87,89088,360,69120,158208
test,1203,356,364544,6026,1156992,1521536
test,1204,290,296960,3999,767808,1064768
test,1205,197,201728,1845,354240,555968
test,1206,396,405504,7456,1431552,1837056
test,1207,301,308224,4308,827136,1135360
test,1208,351,359424,5858,1124736,1484160
test,1209,443,453632,9330,1791360,2244992
test,1210,160,163840,1217,233664,397504
test,1211,172,176128,1407,270144,446272
test,1212,536,548864,13659,2622528,3171392
test,1213,62,63488,183,35136,98624
test,1214,381,390144,6902,1325184,1715328
test,1215,302,309248,4336,832512,1141760
test,1216,265,271360,3339,641088,912448
test,1217,246,251904,2877,552384,804288
test,1218,260,266240,3214,617088,883328
test,1219,453,463872,9756,1873152,2337024
test,1220,428,438272,8709,1672128,2110400
test,1221,354,362496,5958,1143936,1506432
test,1222,228,233472,2472,474624,708096
test,1223,151,154624,1084,208128,362752
test,1224,484,495616,11137,2138304,2633920
test,1225,337,345088,5400,1036800,1381888
test,1226,411,420864,8031,1541952,1962816
test,1227,265,271360,3339,641088,912448
test,1228,310,317440,4569,877248,1194688
test,1229,345,353280,5659,1086528,1439808
test,1230,541,553984,13915,2671680,3225664
test,1231,283,289792,3808,731136,1020928
test,1232,82,83968,320,61440,145408
test,1233,320,327680,4869,934848,1262528
test,1234,452,462848,9713,1864896,2327744
test,1235,44,45056,97,18624,63680
test,1236,126,129024,755,144960,273984
test,1237,84,86016,336,64512,150528
test,1238,168,172032,1342,257664,429696
test,1239,364,372736,6299,1209408,1582144
test,1240,414,423936,8149,1564608,1988544
test,1241,465,476160,10280,1973760,2449920
test,1242,336,344064,5368,1030656,1374720
test,1243,314,321536,4688,900096,1221632
test,1244,124,126976,731,140352,267328
test,1245,85,87040,344,66048,153088
test,1246,235,240640,2626,504192,744832
test,1247,294,301056,4110,789120,1090176
test,1248,134,137216,854,163968,301184
test,1249,456,466944,9886,1898112,2365056
test,1250,231,236544,2537,487104,723648
test,1251,476,487424,10772,2068224,2555648
test,1252,233,238592,2581,495552,734144
test,1253,361,369664,6196,1189632,1559296
test,1254,367,375808,6404,1229568,1605376
test,1255,246,251904,2877,552384,804288
test,1256,323,330752,4960,952320,1283072
test,1257,205,209920,1998,383616,593536
test,1258,271,277504,3492,670464,947968
test,1259,399,408576,7569,1453248,1861824
test,1260,114,116736,618,118656,235392
test,1261,188,192512,1681,322752,515264
test,1262,375,384000,6686,1283712,1667712
test,1263,450,460800,9627,1848384,2309184
test,1264,182,186368,1575,302400,488768
test,1265,276,282624,3622,695424,978048
test,1266,217,222208,2239,429888,652096
test,1267,282,288768,3781,725952,1014720
test,1268,463,474112,10192,1956864,2430976
test,1269,307,314368,4481,860352,1174720
test,1270,342,350208,5561,1067712,1417920
test,1271,198,202752,1864,357888,560640
test,1272,74,75776,261,50112,125888
test,1273,236,241664,2648,508416,750080
test,1274,224,229376,2386,458112,687488
test,1275,303,310272,4365,838080,1148352
test,1276,337,345088,5400,1036800,1381888
test,1277,449,459776,9585,1840320,2300096
test,1278,420,430080,8387,1610304,2040384
test,1279,360,368640,6162,1183104,1551744
test,1280,213,218112,2157,414144,632256
test,1281,214,219136,2178,418176,637312
test,1282,369,377856,6474,1243008,1620864
test,1283,249,254976,2948,566016,820992
test,1284,289,295936,3971,762432,1058368
test,1285,197,201728,1845,354240,555968
test,1286,658,673792,20584,3952128,4625920
test,1287,98,100352,457,87744,188096
test,1288,67,68608,214,41088,109696
test,1289,279,285696,3701,710592,996288
test,1290,317,324608,4778,917376,1241984
test,1291,217,222208,2239,429888,652096
test,1292,168,172032,1342,257664,429696
test,1293,354,362496,5958,1143936,1506432
test,1294,64,65536,195,37440,102976
test,1295,203,207872,1960,376320,584192
test,1296,261,267264,3239,621888,889152
test,1297,492,503808,11508,2209536,2713344
test,1298,222,227328,2343,449856,677184
test,1299,291,297984,4026,772992,1070976
test,1300,144,147456,986,189312,336768
test,1301,147,150528,1028,197376,347904
test,1302,197,201728,1845,354240,555968
test,1303,84,86016,336,64512,150528
test,1304,469,480256,10458,2007936,2488192
test,1305,239,244736,2716,521472,766208
test,1306,272,278528,3518,675456,953984
test,1307,67,68608,220,42240,110848
test,1308,384,393216,7011,1346112,1739328
test,1309,303,310272,4365,838080,1148352
test,1310,94,96256,421,80832,177088
test,1311,266,272384,3364,645888,918272
test,1312,202,206848,1940,372480,579328
test,1313,322,329728,4930,946560,1276288
test,1314,265,271360,3339,641088,912448
test,1315,392,401408,7306,1402752,1804160
test,1316,384,393216,7011,1346112,1739328
test,1317,361,369664,6196,1189632,1559296
test,1318,171,175104,1391,267072,442176
test,1319,82,83968,320,61440,145408
test,1320,104,106496,515,98880,205376
test,1321,394,403456,7381,1417152,1820608
test,1322,157,160768,1172,225024,385792
test,1323,405,414720,7798,1497216,1911936
test,1324,259,265216,3190,612480,877696
test,1325,365,373760,6334,1216128,1589888
test,1326,193,197632,1771,340032,537664
test,1327,189,193536,1699,326208,519744
test,1328,397,406528,7493,1438656,1845184
test,1329,131,134144,816,156672,290816
test,1330,565,578560,15177,2913984,3492544
test,1331,455,465920,9843,1889856,2355776
test,1332,180,184320,1541,295872,480192
test,1333,304,311296,4394,843648,1154944
test,1334,383,392192,6974,1339008,1731200
test,1335,252,258048,3019,579648,837696
test,1336,363,371712,6265,1202880,1574592
test,1337,258,264192,3165,607680,871872
test,1338,313,320512,4658,894336,1214848
test,1339,341,349184,5529,1061568,1410752
test,1340,115,117760,629,120768,238528
test,1341,362,370688,6230,1196160,1566848
test,1342,253,259072,3043,584256,843328
test,1343,365,373760,6334,1216128,1589888
test,1344,210,215040,2097,402624,617664
test,1345,345,353280,5659,1086528,1439808
test,1346,245,250880,2854,547968,798848
test,1347,140,143360,932,178944,322304
test,1348,219,224256,2281,437952,662208
test,1349,106,108544,535,102720,211264
test,1350,321,328704,4899,940608,1269312
test,1351,225,230400,2407,462144,692544
test,1352,113,115712,608,116736,232448
test,1353,166,169984,1310,251520,421504
test,1354,194,198656,1790,343680,542336
test,1355,527,539648,13204,2535168,3074816
test,1356,243,248832,2808,539136,787968
test,1357,79,80896,297,57024,137920
test,1358,307,314368,4481,860352,1174720
test,1359,217,222208,2239,429888,652096
test,1360,274,280576,3570,685440,966016
test,1361,167,171008,1326,254592,425600
test,1362,207,211968,2038,391296,603264
test,1363,196,200704,1827,350784,551488
test,1364,490,501760,11415,2191680,2693440
test,1365,445,455680,9415,1807680,2263360
test,1366,376,385024,6722,1290624,1675648
test,1367,344,352256,5626,1080192,1432448
test,1368,220,225280,2301,441792,667072
test,1369,253,259072,3043,584256,843328
test,1370,210,215040,2097,402624,617664
test,1371,222,227328,2343,449856,677184
test,1372,223,228352,2365,454080,682432
test,1373,212,217088,2137,410304,627392
test,1374,493,504832,11555,2218560,2723392
test,1375,262,268288,3264,626688,894976
test,1376,51,52224,124,23808,76032
test,1377,605,619520,17402,3341184,3960704
test,1378,327,334848,5084,976128,1310976
test,1379,52,53248,129,24768,78016
test,1380,234,239616,2604,499968,739584
test,1381,160,163840,1217,233664,397504
test,1382,219,224256,2281,437952,662208
test,1383,117,119808,651,124992,244800
test,1384,233,238592,2581,495552,734144
test,1385,184,188416,1610,309120,497536
test,1386,363,371712,6265,1202880,1574592
test,1387,171,175104,1391,267072,442176
test,1388,279,285696,3701,710592,996288
test,1389,206,210944,2018,387456,598400
test,1390,340,348160,5496,1055232,1403392
test,1391,368,376832,6439,1236288,1613120
test,1392,270,276480,3466,665472,941952
test,1393,346,354304,5692,1092864,1447168
test,1394,84,86016,344,66048,152064
test,1395,416,425984,8228,1579776,2005760
test,1396,191,195584,1735,333120,528704
test,1397,504,516096,12077,2318784,2834880
test,1398,106,108544,535,102720,211264
test,1399,323,330752,4960,952320,1283072
test,1400,241,246784,2762,530304,777088
test,1401,184,188416,1610,309120,497536
test,1402,172,176128,1407,270144,446272
test,1403,300,307200,4279,821568,1128768
test,1404,56,57344,150,28800,86144
test,1405,189,193536,1699,326208,519744
test,1406,240,245760,2739,525888,771648
test,1407,393,402432,7343,1409856,1812288
test,1408,303,310272,4365,838080,1148352
test,1409,138,141312,906,173952,315264
test,1410,372,380928,6579,1263168,1644096
test,1411,275,281600,3596,690432,972032
test,1412,292,299008,4054,778368,1077376
test,1413,331,338944,5209,1000128,1339072
test,1414,185,189440,1628,312576,502016
test,1415,500,512000,11886,2282112,2794112
test,1416,168,172032,1342,257664,429696
test,1417,420,430080,8387,1610304,2040384
test,1418,564,577536,15123,2903616,3481152
test,1419,281,287744,3754,720768,1008512
test,1420,412,421888,8070,1549440,1971328
test,1421,253,259072,3043,584256,843328
test,1422,305,312320,4423,849216,1161536
test,1423,563,576512,15069,2893248,3469760
test,1424,160,163840,1217,233664,397504
test,1425,562,575488,15016,2883072,3458560
test,1426,498,509952,11791,2263872,2773824
test,1427,286,292864,3889,746688,1039552
test,1428,312,319488,4628,888576,1208064
test,1429,297,304128,4194,805248,1109376
test,1430,331,338944,5209,1000128,1339072
test,1431,299,306176,4251,816192,1122368
test,1432,247,252928,2901,556992,809920
test,1433,356,364544,6026,1156992,1521536
test,1434,100,102400,476,91392,193792
test,1435,319,326656,4838,928896,1255552
test,1436,340,348160,5496,1055232,1403392
test,1437,272,278528,3518,675456,953984
test,1438,210,215040,2097,402624,617664
test,1439,77,78848,282,54144,132992
test,1440,327,334848,5084,976128,1310976
test,1441,138,141312,906,173952,315264
test,1442,322,329728,4930,946560,1276288
test,1443,125,128000,743,142656,270656
test,1444,390,399360,7231,1388352,1787712
test,1445,137,140288,893,171456,311744
test,1446,118,120832,662,127104,247936
test,1447,280,286720,3728,715776,1002496
test,1448,218,223232,2260,433920,657152
test,1449,187,191488,1663,319296,510784
test,1450,273,279552,3544,680448,960000
test,1451,121,123904,696,133632,257536
test,1452,280,286720,3728,715776,1002496
test,1453,112,114688,597,114624,229312
test,1454,373,381952,6615,1270080,1652032
test,1455,621,635904,18334,3520128,4156032
test,1456,284,290816,3835,736320,1027136
test,1457,231,236544,2537,487104,723648
test,1458,103,105472,505,96960,202432
test,1459,171,175104,1391,267072,442176
test,1460,358,366592,6093,1169856,1536448
test,1461,132,135168,829,159168,294336
test,1462,304,311296,4394,843648,1154944
test,1463,542,555008,13966,2681472,3236480
test,1464,191,195584,1735,333120,528704
test,1465,248,253952,2924,561408,815360
test,1466,143,146432,973,186816,333248
test,1467,369,377856,6474,1243008,1620864
test,1468,418,428032,8307,1594944,2022976
test,1469,262,268288,3264,626688,894976
test,1470,279,285696,3701,710592,996288
test,1471,386,395264,7084,1360128,1755392
test,1472,275,281600,3596,690432,972032
test,1473,235,240640,2626,504192,744832
test,1474,478,489472,10863,2085696,2575168
test,1475,139,142336,919,176448,318784
test,1476,135,138240,867,166464,304704
test,1477,250,256000,2972,570624,826624
test,1478,314,321536,4688,900096,1221632
test,1479,255,261120,3092,593664,854784
test,1480,515,527360,12609,2420928,2948288
test,1481,232,237568,2559,491328,728896
test,1482,277,283648,3648,700416,984064
test,1483,405,414720,7798,1497216,1911936
test,1484,176,180224,1473,282816,463040
test,1485,178,182272,1507,289344,471616
test,1486,342,350208,5561,1067712,1417920
test,1487,447,457728,9500,1824000,2281728
test,1488,275,281600,3596,690432,972032
test,1489,264,270336,3314,636288,906624
test,1490,106,108544,535,102720,211264
test,1491,94,96256,421,80832,177088
test,1492,127,130048,767,147264,277312
test,1493,194,198656,1790,343680,542336
test,1494,295,302080,4138,794496,1096576
test,1495,366,374784,6369,1222848,1597632
test,1496,612,626688,17807,3418944,4045632
test,1497,294,301056,4110,789120,1090176
test,1498,399,408576,7569,1453248,1861824
test,1499,339,347136,5464,1049088,1396224
test,1500,196,200704,1827,350784,551488
test,1501,294,301056,4110,789120,1090176
test,1502,95,97280,430,82560,179840
test,1503,291,297984,4026,772992,1070976
test,1504,277,283648,3648,700416,984064
test,1505,297,304128,4194,805248,1109376
test,1506,162,165888,1248,239616,405504
test,1507,569,582656,15392,2955264,3537920
test,1508,196,200704,1827,350784,551488
test,1509,282,288768,3781,725952,1014720
test,1510,63,64512,189,36288,100800
test,1511,404,413696,7760,1489920,1903616
test,1512,90,92160,386,74112,166272
test,1513,148,151552,1042,200064,351616
test,1514,178,182272,1507,289344,471616
test,1515,262,268288,3264,626688,894976
test,1516,295,302080,4138,794496,1096576
test,1517,232,237568,2559,491328,728896
test,1518,100,102400,476,91392,193792
test,1519,180,184320,1541,295872,480192
test,1520,254,260096,3068,589056,849152
test,1521,339,347136,5464,1049088,1396224
test,1522,375,384000,6686,1283712,1667712
test,1523,372,380928,6579,1263168,1644096
test,1524,75,76800,268,51456,128256
test,1525,208,212992,2057,394944,607936
test,1526,318,325632,4808,923136,1248768
test,1527,300,307200,4279,821568,1128768
test,1528,351,359424,5858,1124736,1484160
test,1529,245,250880,2854,547968,798848
test,1530,433,443392,8914,1711488,2154880
test,1531,348,356352,5758,1105536,1461888
test,1532,294,301056,4110,789120,1090176
test,1533,246,251904,2877,552384,804288
test,1534,278,284672,3675,705600,990272
test,1535,351,359424,5858,1124736,1484160
test,1536,200,204800,1902,365184,569984
test,1537,351,359424,5858,1124736,1484160
test,1538,449,459776,9585,1840320,2300096
test,1539,310,317440,4569,877248,1194688
test,1540,380,389120,6865,1318080,1707200
test,1541,502,514048,11981,2300352,2814400
test,1542,271,277504,3492,670464,947968
test,1543,322,329728,4930,946560,1276288
test,1544,192,196608,1753,336576,533184
test,1545,223,228352,2365,454080,682432
test,1546,308,315392,4510,865920,1181312
test,1547,274,280576,3570,685440,966016
test,1548,145,148480,1000,192000,340480
test,1549,236,241664,2648,508416,750080
test,1550,122,124928,708,135936,260864
test,1551,446,456704,9457,1815744,2272448
test,1552,281,287744,3754,720768,1008512
test,1553,448,458752,9542,1832064,2290816
test,1554,221,226304,2322,445824,672128
test,1555,264,270336,3314,636288,906624
test,1556,422,432128,8467,1625664,2057792
test,1557,332,339968,5241,1006272,1346240
test,1558,385,394240,7047,1353024,1747264
test,1559,164,167936,1279,245568,413504
test,1560,444,454656,9372,1799424,2254080
test,1561,145,148480,1000,192000,340480
test,1562,259,265216,3190,612480,877696
test,1563,293,300032,4082,783744,1083776
test,1564,373,381952,6615,1270080,1652032
test,1565,371,379904,6544,1256448,1636352
test,1566,350,358400,5824,1118208,1476608
test,1567,191,195584,1735,333120,528704
test,1568,285,291840,3862,741504,1033344
test,1569,103,105472,505,96960,202432
test,1570,184,188416,1610,309120,497536
test,1571,240,245760,2739,525888,771648
test,1572,302,309248,4336,832512,1141760
test,1573,157,160768,1172,225024,385792
test,1574,216,221184,2219,426048,647232
test,1575,114,116736,618,118656,235392
test,1576,165,168960,1295,248640,417600
test,1577,354,362496,5958,1143936,1506432
test,1578,280,286720,3728,715776,1002496
test,1579,332,339968,5241,1006272,1346240
test,1580,487,498688,11276,2164992,2663680
test,1581,254,260096,3068,589056,849152
test,1582,347,355328,5725,1099200,1454528
test,1583,500,512000,11886,2282112,2794112
test,1584,157,160768,1172,225024,385792
test,1585,197,201728,1845,354240,555968
test,1586,96,98304,439,84288,182592
test,1587,271,277504,3492,670464,947968
test,1588,212,217088,2137,410304,627392
test,1589,340,348160,5496,1055232,1403392
test,1590,235,240640,2626,504192,744832
test,1591,466,477184,10324,1982208,2459392
test,1592,177,181248,1490,286080,467328
test,1593,102,104448,495,95040,199488
test,1594,367,375808,6404,1229568,1605376
test,1595,343,351232,5594,1074048,1425280
test,1596,180,184320,1541,295872,480192
test,1597,366,374784,6369,1222848,1597632
test,1598,124,126976,731,140352,267328
test,1599,214,219136,2178,418176,637312
test,1600,219,224256,2281,437952,662208
test,1601,174,178176,1440,276480,454656
test,1602,296,303104,4166,799872,1102976
test,1603,367,375808,6404,1229568,1605376
test,1604,287,293888,3916,751872,1045760
test,1605,253,259072,3043,584256,843328
test,1606,377,386048,6757,1297344,1683392
test,1607,371,379904,6544,1256448,1636352
test,1608,373,381952,6615,1270080,1652032
test,1609,342,350208,5561,1067712,1417920
test,1610,183,187392,1593,305856,493248
test,1611,215,220160,2198,422016,642176
test,1612,200,204800,1902,365184,569984
test,1613,137,140288,893,171456,311744
test,1614,327,334848,5084,976128,1310976
test,1615,137,140288,893,171456,311744
test,1616,351,359424,5858,1124736,1484160
test,1617,219,224256,2281,437952,662208
test,1618,107,109568,545,104640,214208
test,1619,248,253952,2924,561408,815360
test,1620,321,328704,4899,940608,1269312
test,1621,295,302080,4138,794496,1096576
test,1622,309,316416,4540,871680,1188096
test,1623,267,273408,3390,650880,924288
test,1624,151,154624,1084,208128,362752
test,1625,422,432128,8467,1625664,2057792
test,1626,123,125952,720,138240,264192
test,1627,282,288768,3781,725952,1014720
test,1628,246,251904,2877,552384,804288
test,1629,465,476160,10280,1973760,2449920
test,1630,112,114688,597,114624,229312
test,1631,233,238592,2581,495552,734144
test,1632,377,386048,6757,1297344,1683392
test,1633,129,132096,792,152064,284160
test,1634,366,374784,6369,1222848,1597632
test,1635,244,249856,2831,543552,793408
test,1636,219,224256,2281,437952,662208
test,1637,206,210944,2018,387456,598400
test,1638,292,299008,4054,778368,1077376
test,1639,282,288768,3781,725952,1014720
test,1640,356,364544,6026,1156992,1521536
test,1641,399,408576,7569,1453248,1861824
test,1642,486,497664,11229,2155968,2653632
test,1643,155,158720,1143,219456,378176
test,1644,333,340992,5272,1012224,1353216
test,1645,449,459776,9585,1840320,2300096
test,1646,221,226304,2322,445824,672128
test,1647,427,437248,8669,1664448,2101696
test,1648,291,297984,4026,772992,1070976
test,1649,99,101376,466,89472,190848
test,1650,254,260096,3068,589056,849152
test,1651,226,231424,2429,466368,697792
test,1652,175,179200,1456,279552,458752
test,1653,247,252928,2901,556992,809920
test,1654,61,62464,177,33984,96448
test,1655,207,211968,2038,391296,603264
test,1656,89,91136,377,72384,163520
test,1657,244,249856,2831,543552,793408
test,1658,200,204800,1902,365184,569984
test,1659,64,65536,195,37440,102976
test,1660,622,636928,18393,3531456,4168384
test,1661,349,357376,5791,1111872,1469248
test,1662,225,230400,2407,462144,692544
test,1663,396,405504,7456,1431552,1837056
test,1664,159,162816,1202,230784,393600
test,1665,126,129024,755,144960,273984
test,1666,555,568320,14644,2811648,3379968
test,1667,177,181248,1490,286080,467328
test,1668,319,326656,4838,928896,1255552
test,1669,228,233472,2472,474624,708096
test,1670,325,332800,5022,964224,1297024
test,1671,126,129024,755,144960,273984
test,1672,283,289792,3808,731136,1020928
test,1673,182,186368,1575,302400,488768
test,1674,423,433152,8507,1633344,2066496
test,1675,230,235520,2515,482880,718400
test,1676,196,200704,1827,350784,551488
test,1677,257,263168,3140,602880,866048
test,1678,483,494592,11091,2129472,2624064
test,1679,275,281600,3596,690432,972032
test,1680,192,196608,1753,336576,533184
test,1681,105,107520,525,100800,208320
test,1682,164,167936,1279,245568,413504
test,1683,198,202752,1864,357888,560640
test,1684,135,138240,867,166464,304704
test,1685,252,258048,3019,579648,837696
test,1686,271,277504,3492,670464,947968
test,1687,247,252928,2901,556992,809920
test,1688,356,364544,6026,1156992,1521536
test,1689,150,153600,1070,205440,359040
test,1690,190,194560,1717,329664,524224
test,1691,261,267264,3239,621888,889152
test,1692,281,287744,3754,720768,1008512
test,1693,530,542720,13355,2564160,3106880
test,1694,276,282624,3622,695424,978048
test,1695,443,453632,9330,1791360,2244992
test,1696,166,169984,1310,251520,421504
test,1697,491,502784,11462,2200704,2703488
test,1698,298,305152,4222,810624,1115776
test,1699,102,104448,495,95040,199488
test,1700,312,319488,4628,888576,1208064
test,1701,253,259072,3043,584256,843328
test,1702,425,435200,8588,1648896,2084096
test,1703,298,305152,4222,810624,1115776
test,1704,288,294912,3944,757248,1052160
test,1705,159,162816,1202,230784,393600
test,1706,387,396288,7121,1367232,1763520
test,1707,391,400384,7269,1395648,1796032
test,1708,463,474112,10192,1956864,2430976
test,1709,380,389120,6865,1318080,1707200
test,1710,332,339968,5241,1006272,1346240
test,1711,320,327680,4869,934848,1262528
test,1712,210,215040,2097,402624,617664
test,1713,267,273408,3390,650880,924288
test,1714,297,304128,4194,805248,1109376
test,1715,143,146432,973,186816,333248
test,1716,365,373760,6334,1216128,1589888
test,1717,314,321536,4688,900096,1221632
test,1718,83,84992,328,62976,147968
test,1719,184,188416,1610,309120,497536
test,1720,161,164864,1233,236736,401600
test,1721,350,358400,5824,1118208,1476608
test,1722,303,310272,4365,838080,1148352
test,1723,344,352256,5626,1080192,1432448
test,1724,569,582656,15392,2955264,3537920
test,1725,104,106496,515,98880,205376
test,1726,235,240640,2626,504192,744832
test,1727,222,227328,2343,449856,677184
test,1728,442,452608,9288,1783296,2235904
test,1729,407,416768,7876,1512192,1928960
test,1730,251,257024,2996,575232,832256
test,1731,128,131072,779,149568,280640
test,1732,218,223232,2260,433920,657152
test,1733,239,244736,2716,521472,766208
test,1734,162,165888,1248,239616,405504
test,1735,183,187392,1593,305856,493248
test,1736,58,59392,160,30720,90112
test,1737,729,746496,25266,4851072,5597568
test,1738,198,202752,1864,357888,560640
test,1739,352,360448,5891,1131072,1491520
test,1740,123,125952,720,138240,264192
test,1741,339,347136,5464,1049088,1396224
test,1742,307,314368,4481,860352,1174720
test,1743,159,162816,1202,230784,393600
test,1744,446,456704,9457,1815744,2272448
test,1745,251,257024,2996,575232,832256
test,1746,225,230400,2407,462144,692544
test,1747,270,276480,3466,665472,941952
test,1748,250,256000,2972,570624,826624
test,1749,221,226304,2322,445824,672128
test,1750,424,434176,8547,1641024,2075200
test,1751,436,446464,9038,1735296,2181760
test,1752,207,211968,2038,391296,603264
test,1753,296,303104,4166,799872,1102976
test,1754,113,115712,608,116736,232448
test,1755,144,147456,986,189312,336768
test,1756,257,263168,3140,602880,866048
test,1757,144,147456,986,189312,336768
test,1758,270,276480,3466,665472,941952
test,1759,128,131072,779,149568,280640
test,1760,270,276480,3466,665472,941952
test,1761,405,414720,7798,1497216,1911936
test,1762,245,250880,2854,547968,798848
test,1763,113,115712,608,116736,232448
test,1764,276,282624,3622,695424,978048
test,1765,214,219136,2178,418176,637312
test,1766,339,347136,5464,1049088,1396224
test,1767,222,227328,2343,449856,677184
test,1768,180,184320,1541,295872,480192
test,1769,181,185344,1558,299136,484480
test,1770,190,194560,1717,329664,524224
test,1771,252,258048,3019,579648,837696
test,1772,147,150528,1028,197376,347904
test,1773,342,350208,5561,1067712,1417920
test,1774,104,106496,515,98880,205376
test,1775,482,493568,11045,2120640,2614208
test,1776,327,334848,5084,976128,1310976
test,1777,465,476160,10280,1973760,2449920
test,1778,409,418816,7953,1526976,1945792
test,1779,88,90112,369,70848,160960
test,1780,392,401408,7306,1402752,1804160
test,1781,271,277504,3492,670464,947968
test,1782,180,184320,1541,295872,480192
test,1783,379,388096,6829,1311168,1699264
test,1784,429,439296,8750,1680000,2119296
test,1785,147,150528,1028,197376,347904
test,1786,308,315392,4510,865920,1181312
test,1787,350,358400,5824,1118208,1476608
test,1788,390,399360,7231,1388352,1787712
test,1789,301,308224,4308,827136,1135360
test,1790,126,129024,755,144960,273984
test,1791,107,109568,545,104640,214208
test,1792,525,537600,13104,2515968,3053568
test,1793,441,451584,9246,1775232,2226816
test,1794,152,155648,1099,211008,366656
test,1795,407,416768,7876,1512192,1928960
test,1796,332,339968,5241,1006272,1346240
test,1797,143,146432,973,186816,333248
test,1798,71,72704,240,46080,118784
test,1799,477,488448,10817,2076864,2565312
test,1800,292,299008,4054,778368,1077376
test,1801,417,427008,8267,1587264,2014272
test,1802,182,186368,1575,302400,488768
test,1803,422,432128,8467,1625664,2057792
test,1804,335,343040,5336,1024512,1367552
test,1805,237,242688,2671,512832,755520
test,1806,339,347136,5464,1049088,1396224
test,1807,471,482304,10547,2025024,2507328
test,1808,317,324608,4778,917376,1241984
test,1809,89,91136,377,72384,163520
test,1810,428,438272,8709,1672128,2110400
test,1811,454,464896,9799,1881408,2346304
test,1812,281,287744,3754,720768,1008512
test,1813,226,231424,2429,466368,697792
test,1814,187,191488,1663,319296,510784
test,1815,361,369664,6196,1189632,1559296
test,1816,174,178176,1440,276480,454656
test,1817,354,362496,5958,1143936,1506432
test,1818,403,412672,7722,1482624,1895296
test,1819,243,248832,2808,539136,787968
test,1820,141,144384,946,181632,326016
test,1821,656,671744,20459,3928128,4599872
test,1822,184,188416,1610,309120,497536
test,1823,391,400384,7269,1395648,1796032
test,1824,264,270336,3314,636288,906624
test,1825,108,110592,555,106560,217152
test,1826,259,265216,3190,612480,877696
test,1827,131,134144,816,156672,290816
test,1828,217,222208,2239,429888,652096
test,1829,127,130048,767,147264,277312
test,1830,176,180224,1473,282816,463040
test,1831,467,478208,10369,1990848,2469056
test,1832,423,433152,8507,1633344,2066496
test,1833,304,311296,4394,843648,1154944
test,1834,130,133120,804,154368,287488
test,1835,222,227328,2343,449856,677184
test,1836,385,394240,7047,1353024,1747264
test,1837,148,151552,1042,200064,351616
test,1838,381,390144,6902,1325184,1715328
test,1839,351,359424,5858,1124736,1484160
test,1840,293,300032,4082,783744,1083776
test,1841,363,371712,6265,1202880,1574592
test,1842,377,386048,6757,1297344,1683392
test,1843,458,468992,9973,1914816,2383808
test,1844,211,216064,2117,406464,622528
test,1845,280,286720,3728,715776,1002496
test,1846,159,162816,1202,230784,393600
test,1847,272,278528,3518,675456,953984
test,1848,376,385024,6722,1290624,1675648
test,1849,296,303104,4166,799872,1102976
test,1850,313,320512,4658,894336,1214848
test,1851,524,536576,13054,2506368,3042944
test,1852,378,387072,6793,1304256,1691328
test,1853,87,89088,360,69120,158208
test,1854,297,304128,4194,805248,1109376
test,1855,144,147456,986,189312,336768
test,1856,306,313344,4452,854784,1168128
test,1857,681,697344,22048,4233216,4930560
test,1858,465,476160,10280,1973760,2449920
test,1859,353,361472,5924,1137408,1498880
test,1860,197,201728,1845,354240,555968
test,1861,315,322560,4718,905856,1228416
test,1862,281,287744,3754,720768,1008512
test,1863,345,353280,5659,1086528,1439808
test,1864,109,111616,565,108480,220096
test,1865,218,223232,2260,433920,657152
test,1866,299,306176,4251,816192,1122368
test,1867,291,297984,4026,772992,1070976
test,1868,425,435200,8588,1648896,2084096
test,1869,230,235520,2515,482880,718400
test,1870,364,372736,6299,1209408,1582144
test,1871,340,348160,5496,1055232,1403392
test,1872,159,162816,1202,230784,393600
test,1873,281,287744,3754,720768,1008512
test,1874,303,310272,4365,838080,1148352
test,1875,246,251904,2877,552384,804288
test,1876,158,161792,1187,227904,389696
test,1877,262,268288,3264,626688,894976
test,1878,259,265216,3190,612480,877696
test,1879,345,353280,5659,1086528,1439808
test,1880,212,217088,2137,410304,627392
test,1881,158,161792,1187,227904,389696
test,1882,134,137216,854,163968,301184
test,1883,271,277504,3492,670464,947968
test,1884,256,262144,3116,598272,860416
test,1885,256,262144,3116,598272,860416
test,1886,489,500736,11368,2182656,2683392
test,1887,475,486400,10727,2059584,2545984
test,1888,388,397312,7157,1374144,1771456
test,1889,359,367616,6128,1176576,1544192
test,1890,347,355328,5725,1099200,1454528
test,1891,222,227328,2343,449856,677184
test,1892,192,196608,1753,336576,533184
test,1893,428,438272,8709,1672128,2110400
test,1894,259,265216,3190,612480,877696
test,1895,274,280576,3570,685440,966016
test,1896,163,166912,1264,242688,409600
test,1897,120,122880,685,131520,254400
test,1898,254,260096,3068,589056,849152
test,1899,359,367616,6128,1176576,1544192
test,1900,217,222208,2239,429888,652096
test,1901,411,420864,8031,1541952,1962816
test,1902,363,371712,6265,1202880,1574592
test,1903,470,481280,10502,2016384,2497664
test,1904,242,247808,2785,534720,782528
test,1905,136,139264,880,168960,308224
test,1906,314,321536,4688,900096,1221632
test,1907,305,312320,4423,849216,1161536
test,1908,324,331776,4991,958272,1290048
test,1909,210,215040,2097,402624,617664
test,1910,305,312320,4423,849216,1161536
test,1911,118,120832,662,127104,247936
test,1912,537,549888,13710,2632320,3182208
test,1913,232,237568,2559,491328,728896
test,1914,199,203776,1883,361536,565312
test,1915,300,307200,4279,821568,1128768
test,1916,415,424960,8188,1572096,1997056
test,1917,349,357376,5791,1111872,1469248
test,1918,289,295936,3971,762432,1058368
test,1919,588,602112,16437,3155904,3758016
test,1920,249,254976,2948,566016,820992
test,1921,411,420864,8031,1541952,1962816
test,1922,301,308224,4308,827136,1135360
test,1923,324,331776,4991,958272,1290048
test,1924,309,316416,4540,871680,1188096
test,1925,320,327680,4869,934848,1262528
test,1926,235,240640,2626,504192,744832
test,1927,288,294912,3944,757248,1052160
test,1928,153,156672,1113,213696,370368
test,1929,223,228352,2365,454080,682432
test,1930,123,125952,720,138240,264192
test,1931,87,89088,360,69120,158208
test,1932,322,329728,4930,946560,1276288
test,1933,208,212992,2057,394944,607936
test,1934,113,115712,608,116736,232448
test,1935,473,484352,10637,2042304,2526656
test,1936,276,282624,3622,695424,978048
test,1937,200,204800,1902,365184,569984
test,1938,267,273408,3390,650880,924288
test,1939,367,375808,6404,1229568,1605376
test,1940,277,283648,3648,700416,984064
test,1941,306,313344,4452,854784,1168128
test,1942,118,120832,662,127104,247936
test,1943,392,401408,7306,1402752,1804160
test,1944,376,385024,6722,1290624,1675648
test,1945,353,361472,5924,1137408,1498880
test,1946,245,250880,2854,547968,798848
test,1947,452,462848,9713,1864896,2327744
test,1948,344,352256,5626,1080192,1432448
test,1949,136,139264,880,168960,308224
test,1950,386,395264,7084,1360128,1755392
test,1951,124,126976,731,140352,267328
test,1952,322,329728,4930,946560,1276288
test,1953,191,195584,1735,333120,528704
test,1954,234,239616,2604,499968,739584
test,1955,435,445440,8996,1727232,2172672
test,1956,363,371712,6265,1202880,1574592
test,1957,179,183296,1524,292608,475904
test,1958,685,701440,22308,4283136,4984576
test,1959,273,279552,3544,680448,960000
test,1960,225,230400,2407,462144,692544
test,1961,364,372736,6299,1209408,1582144
test,1962,129,132096,792,152064,284160
test,1963,110,112640,576,110592,223232
test,1964,322,329728,4930,946560,1276288
test,1965,589,603136,16493,3166656,3769792
test,1966,268,274432,3415,655680,930112
test,1967,268,274432,3415,655680,930112
test,1968,296,303104,4166,799872,1102976
test,1969,217,222208,2239,429888,652096
test,1970,169,173056,1358,260736,433792
test,1971,127,130048,767,147264,277312
test,1972,253,259072,3043,584256,843328
test,1973,222,227328,2343,449856,677184
test,1974,104,106496,515,98880,205376
test,1975,180,184320,1541,295872,480192
test,1976,108,110592,555,106560,217152
test,1977,83,84992,328,62976,147968
test,1978,367,375808,6404,1229568,1605376
test,1979,58,59392,160,30720,90112
test,1980,280,286720,3728,715776,1002496
test,1981,161,164864,1233,236736,401600
test,1982,132,135168,829,159168,294336
test,1983,126,129024,755,144960,273984
test,1984,330,337920,5178,994176,1332096
test,1985,344,352256,5626,1080192,1432448
test,1986,407,416768,7876,1512192,1928960
test,1987,553,566272,14539,2791488,3357760
test,1988,370,378880,6509,1249728,1628608
test,1989,102,104448,495,95040,199488
test,1990,262,268288,3264,626688,894976
test,1991,322,329728,4930,946560,1276288
test,1992,241,246784,2762,530304,777088
test,1993,246,251904,2877,552384,804288
test,1994,272,278528,3518,675456,953984
test,1995,213,218112,2157,414144,632256
test,1996,514,526336,12561,2411712,2938048
test,1997,191,195584,1735,333120,528704
test,1998,333,340992,5272,1012224,1353216
test,1999,339,347136,5464,1049088,1396224
test,2000,304,311296,4394,843648,1154944
test,2001,270,276480,3466,665472,941952
test,2002,267,273408,3390,650880,924288
test,2003,319,326656,4838,928896,1255552
test,2004,168,172032,1342,257664,429696
test,2005,257,263168,3140,602880,866048
test,2006,275,281600,3596,690432,972032
test,2007,90,92160,386,74112,166272
test,2008,118,120832,662,127104,247936
test,2009,283,289792,3808,731136,1020928
test,2010,307,314368,4481,860352,1174720
test,2011,245,250880,2854,547968,798848
test,2012,224,229376,2386,458112,687488
test,2013,253,259072,3043,584256,843328
test,2014,404,413696,7760,1489920,1903616
test,2015,168,172032,1342,257664,429696
test,2016,245,250880,2854,547968,798848
test,2017,433,443392,8914,1711488,2154880
test,2018,118,120832,662,127104,247936
test,2019,327,334848,5084,976128,1310976
test,2020,283,289792,3808,731136,1020928
test,2021,230,235520,2515,482880,718400
test,2022,151,154624,1084,208128,362752
test,2023,424,434176,8547,1641024,2075200
test,2024,128,131072,779,149568,280640
test,2025,178,182272,1507,289344,471616
test,2026,180,184320,1541,295872,480192
test,2027,327,334848,5084,976128,1310976
test,2028,228,233472,2472,474624,708096
test,2029,187,191488,1663,319296,510784
test,2030,328,335872,5115,982080,1317952
test,2031,342,350208,5561,1067712,1417920
test,2032,243,248832,2808,539136,787968
test,2033,119,121856,674,129408,251264
test,2034,133,136192,841,161472,297664
test,2035,298,305152,4222,810624,1115776
test,2036,88,90112,369,70848,160960
test,2037,382,391168,6938,1332096,1723264
test,2038,453,463872,9756,1873152,2337024
test,2039,407,416768,7876,1512192,1928960
test,2040,120,122880,685,131520,254400
test,2041,281,287744,3754,720768,1008512
test,2042,305,312320,4423,849216,1161536
test,2043,103,105472,505,96960,202432
test,2044,400,409600,7607,1460544,1870144
test,2045,591,605184,16606,3188352,3793536
test,2046,192,196608,1753,336576,533184
test,2047,305,312320,4423,849216,1161536
test,2048,215,220160,2198,422016,642176
test,2049,183,187392,1593,305856,493248
test,2050,283,289792,3808,731136,1020928
test,2051,217,222208,2239,429888,652096
test,2052,391,400384,7269,1395648,1796032
test,2053,327,334848,5084,976128,1310976
test,2054,393,402432,7343,1409856,1812288
test,2055,148,151552,1042,200064,351616
test,2056,242,247808,2785,534720,782528
test,2057,220,225280,2301,441792,667072
test,2058,263,269312,3289,631488,900800
test,2059,241,246784,2762,530304,777088
test,2060,428,438272,8709,1672128,2110400
test,2061,297,304128,4194,805248,1109376
test,2062,235,240640,2626,504192,744832
test,2063,225,230400,2407,462144,692544
test,2064,495,506880,11649,2236608,2743488
test,2065,254,260096,3068,589056,849152
test,2066,169,173056,1358,260736,433792
test,2067,255,261120,3092,593664,854784
test,2068,421,431104,8427,1617984,2049088
test,2069,418,428032,8307,1594944,2022976
test,2070,460,471040,10060,1931520,2402560
test,2071,240,245760,2739,525888,771648
test,2072,161,164864,1233,236736,401600
test,2073,196,200704,1827,350784,551488
test,2074,178,182272,1507,289344,471616
test,2075,244,249856,2831,543552,793408
test,2076,370,378880,6509,1249728,1628608
test,2077,86,88064,352,67584,155648
test,2078,170,174080,1374,263808,437888
test,2079,183,187392,1593,305856,493248
test,2080,214,219136,2178,418176,637312
test,2081,173,177152,1423,273216,450368
test,2082,284,290816,3835,736320,1027136
test,2083,110,112640,576,110592,223232
test,2084,371,379904,6544,1256448,1636352
test,2085,261,267264,3239,621888,889152
test,2086,250,256000,2972,570624,826624
test,2087,323,330752,4960,952320,1283072
test,2088,157,160768,1172,225024,385792
test,2089,437,447488,9079,1743168,2190656
test,2090,82,83968,320,61440,145408
test,2091,315,322560,4718,905856,1228416
test,2092,215,220160,2198,422016,642176
test,2093,147,150528,1028,197376,347904
test,2094,166,169984,1310,251520,421504
test,2095,279,285696,3701,710592,996288
test,2096,438,448512,9121,1751232,2199744
test,2097,386,395264,7084,1360128,1755392
test,2098,365,373760,6334,1216128,1589888
test,2099,244,249856,2831,543552,793408
test,2100,168,172032,1342,257664,429696
test,2101,441,451584,9246,1775232,2226816
test,2102,373,381952,6615,1270080,1652032
test,2103,416,425984,8228,1579776,2005760
test,2104,310,317440,4569,877248,1194688
test,2105,77,78848,282,54144,132992
test,2106,212,217088,2137,410304,627392
test,2107,456,466944,9886,1898112,2365056
test,2108,518,530432,12757,2449344,2979776
test,2109,393,402432,7343,1409856,1812288
test,2110,447,457728,9500,1824000,2281728
test,2111,253,259072,3043,584256,843328
test,2112,257,263168,3140,602880,866048
test,2113,185,189440,1628,312576,502016
test,2114,472,483328,10592,2033664,2516992
test,2115,329,336896,5146,988032,1324928
test,2116,68,69632,220,42240,111872
test,2117,267,273408,3390,650880,924288
test,2118,176,180224,1473,282816,463040
test,2119,186,190464,1645,315840,506304
test,2120,91,93184,394,75648,168832
test,2121,568,581632,15338,2944896,3526528
test,2122,316,323584,4748,911616,1235200
test,2123,144,147456,986,189312,336768
test,2124,170,174080,1374,263808,437888
test,2125,419,429056,8347,1602624,2031680
test,2126,275,281600,3596,690432,972032
test,2127,108,110592,555,106560,217152
test,2128,229,234496,2494,478848,713344
test,2129,256,262144,3116,598272,860416
test,2130,374,382976,6650,1276800,1659776
test,2131,312,319488,4628,888576,1208064
test,2132,294,301056,4110,789120,1090176
test,2133,123,125952,720,138240,264192
test,2134,350,358400,5824,1118208,1476608
test,2135,225,230400,2407,462144,692544
test,2136,170,174080,1374,263808,437888
test,2137,299,306176,4251,816192,1122368
test,2138,148,151552,1042,200064,351616
test,2139,367,375808,6404,1229568,1605376
test,2140,239,244736,2716,521472,766208
test,2141,248,253952,2924,561408,815360
test,2142,285,291840,3862,741504,1033344
test,2143,381,390144,6902,1325184,1715328
test,2144,418,428032,8307,1594944,2022976
test,2145,329,336896,5146,988032,1324928
test,2146,215,220160,2198,422016,642176
test,2147,304,311296,4394,843648,1154944
test,2148,419,429056,8347,1602624,2031680
test,2149,222,227328,2343,449856,677184
test,2150,242,247808,2785,534720,782528
test,2151,421,431104,8427,1617984,2049088
test,2152,246,251904,2877,552384,804288
test,2153,275,281600,3596,690432,972032
test,2154,173,177152,1423,273216,450368
test,2155,472,483328,10592,2033664,2516992
test,2156,335,343040,5336,1024512,1367552
test,2157,505,517120,12125,2328000,2845120
test,2158,93,95232,412,79104,174336
test,2159,222,227328,2343,449856,677184
test,2160,235,240640,2626,504192,744832
test,2161,409,418816,7953,1526976,1945792
test,2162,440,450560,9204,1767168,2217728
test,2163,306,313344,4452,854784,1168128
test,2164,283,289792,3808,731136,1020928
test,2165,229,234496,2494,478848,713344
test,2166,402,411648,7683,1475136,1886784
test,2167,297,304128,4194,805248,1109376
test,2168,538,550912,13761,2642112,3193024
test,2169,264,270336,3314,636288,906624
test,2170,276,282624,3622,695424,978048
test,2171,422,432128,8467,1625664,2057792
test,2172,326,333824,5053,970176,1304000
test,2173,309,316416,4540,871680,1188096
test,2174,273,279552,3544,680448,960000
test,2175,558,571392,14803,2842176,3413568
test,2176,275,281600,3596,690432,972032
test,2177,113,115712,608,116736,232448
test,2178,438,448512,9121,1751232,2199744
test,2179,315,322560,4718,905856,1228416
test,2180,120,122880,685,131520,254400
test,2181,342,350208,5561,1067712,1417920
test,2182,188,192512,1681,322752,515264
test,2183,462,473088,10148,1948416,2421504
test,2184,347,355328,5725,1099200,1454528
test,2185,314,321536,4688,900096,1221632
test,2186,631,646144,18929,3634368,4280512
test,2187,210,215040,2097,402624,617664
test,2188,362,370688,6230,1196160,1566848
test,2189,243,248832,2808,539136,787968
test,2190,202,206848,1940,372480,579328
test,2191,160,163840,1217,233664,397504
test,2192,157,160768,1172,225024,385792
test,2193,289,295936,3971,762432,1058368
test,2194,117,119808,651,124992,244800
test,2195,431,441344,8832,1695744,2137088
test,2196,325,332800,5022,964224,1297024
test,2197,239,244736,2716,521472,766208
test,2198,407,416768,7876,1512192,1928960
test,2199,201,205824,1921,368832,574656
test,2200,228,233472,2472,474624,708096
test,2201,166,169984,1310,251520,421504
test,2202,105,107520,525,100800,208320
test,2203,92,94208,403,77376,171584
test,2204,208,212992,2057,394944,607936
test,2205,257,263168,3140,602880,866048
test,2206,248,253952,2924,561408,815360
test,2207,360,368640,6162,1183104,1551744
test,2208,390,399360,7231,1388352,1787712
test,2209,159,162816,1202,230784,393600
test,2210,267,273408,3390,650880,924288
test,2211,216,221184,2219,426048,647232
test,2212,308,315392,4510,865920,1181312
test,2213,274,280576,3570,685440,966016
test,2214,188,192512,1681,322752,515264
test,2215,100,102400,476,91392,193792
test,2216,187,191488,1663,319296,510784
test,2217,110,112640,576,110592,223232
test,2218,284,290816,3835,736320,1027136
test,2219,406,415744,7837,1504704,1920448
test,2220,402,411648,7683,1475136,1886784
test,2221,465,476160,10280,1973760,2449920
test,2222,231,236544,2537,487104,723648
test,2223,195,199680,1808,347136,546816
test,2224,296,303104,4166,799872,1102976
test,2225,46,47104,101,19392,66496
test,2226,237,242688,2671,512832,755520
test,2227,612,626688,17807,3418944,4045632
test,2228,202,206848,1940,372480,579328
test,2229,273,279552,3544,680448,960000
test,2230,340,348160,5496,1055232,1403392
test,2231,89,91136,377,72384,163520
test,2232,176,180224,1473,282816,463040
test,2233,300,307200,4279,821568,1128768
test,2234,354,362496,5958,1143936,1506432
test,2235,212,217088,2137,410304,627392
test,2236,308,315392,4510,865920,1181312
test,2237,393,402432,7343,1409856,1812288
test,2238,275,281600,3596,690432,972032
test,2239,342,350208,5561,1067712,1417920
test,2240,110,112640,576,110592,223232
test,2241,228,233472,2472,474624,708096
test,2242,326,333824,5053,970176,1304000
test,2243,325,332800,5022,964224,1297024
test,2244,134,137216,854,163968,301184
test,2245,154,157696,1128,216576,374272
test,2246,445,455680,9415,1807680,2263360
test,2247,348,356352,5758,1105536,1461888
test,2248,254,260096,3068,589056,849152
test,2249,307,314368,4481,860352,1174720
test,2250,365,373760,6334,1216128,1589888
test,2251,97,99328,448,86016,185344
test,2252,309,316416,4540,871680,1188096
test,2253,290,296960,3999,767808,1064768
test,2254,173,177152,1423,273216,450368
test,2255,462,473088,10148,1948416,2421504
test,2256,200,204800,1902,365184,569984
test,2257,188,192512,1681,322752,515264
test,2258,321,328704,4899,940608,1269312
test,2259,130,133120,804,154368,287488
test,2260,299,306176,4251,816192,1122368
test,2261,200,204800,1902,365184,569984
test,2262,207,211968,2038,391296,603264
test,2263,401,410624,7645,1467840,1878464
test,2264,394,403456,7381,1417152,1820608
test,2265,104,106496,515,98880,205376
test,2266,533,545792,13506,2593152,3138944
test,2267,167,171008,1326,254592,425600
test,2268,286,292864,3889,746688,1039552
test,2269,138,141312,906,173952,315264
test,2270,469,480256,10458,2007936,2488192
test,2271,364,372736,6299,1209408,1582144
test,2272,457,467968,9929,1906368,2374336
test,2273,213,218112,2157,414144,632256
test,2274,423,433152,8507,1633344,2066496
test,2275,249,254976,2948,566016,820992
test,2276,535,547840,13608,2612736,3160576
test,2277,404,413696,7760,1489920,1903616
test,2278,336,344064,5368,1030656,1374720
test,2279,177,181248,1490,286080,467328
test,2280,642,657408,19595,3762240,4419648
test,2281,290,296960,3999,767808,1064768
test,2282,493,504832,11555,2218560,2723392
test,2283,409,418816,7953,1526976,1945792
test,2284,227,232448,2450,470400,702848
test,2285,323,330752,4960,952320,1283072
test,2286,166,169984,1310,251520,421504
test,2287,445,455680,9415,1807680,2263360
test,2288,215,220160,2198,422016,642176
test,2289,155,158720,1143,219456,378176
test,2290,251,257024,2996,575232,832256
test,2291,309,316416,4540,871680,1188096
test,2292,229,234496,2494,478848,713344
test,2293,404,413696,7760,1489920,1903616
test,2294,325,332800,5022,964224,1297024
test,2295,206,210944,2018,387456,598400
test,2296,344,352256,5626,1080192,1432448
test,2297,263,269312,3289,631488,900800
test,2298,334,342016,5304,1018368,1360384
test,2299,232,237568,2559,491328,728896
test,2300,302,309248,4336,832512,1141760
test,2301,132,135168,829,159168,294336
test,2302,362,370688,6230,1196160,1566848
test,2303,123,125952,720,138240,264192
test,2304,359,367616,6128,1176576,1544192
test,2305,386,395264,7084,1360128,1755392
test,2306,446,456704,9457,1815744,2272448
test,2307,200,204800,1902,365184,569984
test,2308,107,109568,545,104640,214208
test,2309,492,503808,11508,2209536,2713344
test,2310,614,628736,17923,3441216,4069952
test,2311,450,460800,9627,1848384,2309184
test,2312,260,266240,3214,617088,883328
test,2313,295,302080,4138,794496,1096576
test,2314,287,293888,3916,751872,1045760
test,2315,298,305152,4222,810624,1115776
test,2316,200,204800,1902,365184,569984
test,2317,309,316416,4540,871680,1188096
test,2318,436,446464,9038,1735296,2181760
test,2319,127,130048,767,147264,277312
test,2320,373,381952,6615,1270080,1652032
test,2321,421,431104,8427,1617984,2049088
test,2322,222,227328,2343,449856,677184
test,2323,348,356352,5758,1105536,1461888
test,2324,105,107520,525,100800,208320
test,2325,434,444416,8955,1719360,2163776
test,2326,221,226304,2322,445824,672128
test,2327,195,199680,1808,347136,546816
test,2328,355,363520,5992,1150464,1513984
test,2329,236,241664,2648,508416,750080
test,2330,237,242688,2671,512832,755520
test,2331,294,301056,4110,789120,1090176
test,2332,169,173056,1358,260736,433792
test,2333,367,375808,6404,1229568,1605376
test,2334,304,311296,4394,843648,1154944
test,2335,147,150528,1028,197376,347904
test,2336,263,269312,3289,631488,900800
test,2337,121,123904,696,133632,257536
test,2338,358,366592,6093,1169856,1536448
test,2339,294,301056,4110,789120,1090176
test,2340,121,123904,696,133632,257536
test,2341,358,366592,6093,1169856,1536448
test,2342,248,253952,2924,561408,815360
test,2343,158,161792,1187,227904,389696
test,2344,196,200704,1827,350784,551488
test,2345,310,317440,4569,877248,1194688
test,2346,274,280576,3570,685440,966016
test,2347,364,372736,6299,1209408,1582144
test,2348,214,219136,2178,418176,637312
test,2349,212,217088,2137,410304,627392
test,2350,429,439296,8750,1680000,2119296
test,2351,180,184320,1541,295872,480192
test,2352,290,296960,3999,767808,1064768
test,2353,321,328704,4899,940608,1269312
test,2354,317,324608,4778,917376,1241984
test,2355,287,293888,3916,751872,1045760
test,2356,252,258048,3019,579648,837696
test,2357,440,450560,9204,1767168,2217728
test,2358,170,174080,1374,263808,437888
test,2359,189,193536,1699,326208,519744
test,2360,353,361472,5924,1137408,1498880
test,2361,325,332800,5022,964224,1297024
test,2362,311,318464,4599,883008,1201472
test,2363,565,578560,15177,2913984,3492544
test,2364,223,228352,2365,454080,682432
test,2365,194,198656,1790,343680,542336
test,2366,351,359424,5858,1124736,1484160
test,2367,265,271360,3339,641088,912448
test,2368,483,494592,11091,2129472,2624064
test,2369,215,220160,2198,422016,642176
test,2370,226,231424,2429,466368,697792
test,2371,75,76800,268,51456,128256
test,2372,275,281600,3596,690432,972032
test,2373,79,80896,297,57024,137920
test,2374,219,224256,2281,437952,662208
test,2375,197,201728,1845,354240,555968
test,2376,275,281600,3596,690432,972032
test,2377,96,98304,439,84288,182592
test,2378,387,396288,7121,1367232,1763520
test,2379,159,162816,1202,230784,393600
test,2380,241,246784,2762,530304,777088
test,2381,334,342016,5304,1018368,1360384
test,2382,426,436224,8628,1656576,2092800
test,2383,329,336896,5146,988032,1324928
test,2384,326,333824,5053,970176,1304000
test,2385,139,142336,919,176448,318784
test,2386,242,247808,2785,534720,782528
test,2387,272,278528,3518,675456,953984
test,2388,365,373760,6334,1216128,1589888
test,2389,194,198656,1790,343680,542336
test,2390,588,602112,16437,3155904,3758016
test,2391,488,499712,11322,2173824,2673536
test,2392,207,211968,2038,391296,603264
test,2393,179,183296,1524,292608,475904
test,2394,188,192512,1681,322752,515264
test,2395,280,286720,3728,715776,1002496
test,2396,235,240640,2626,504192,744832
test,2397,523,535552,13004,2496768,3032320
test,2398,369,377856,6474,1243008,1620864
test,2399,404,413696,7760,1489920,1903616
test,2400,233,238592,2581,495552,734144
test,2401,419,429056,8347,1602624,2031680
test,2402,441,451584,9246,1775232,2226816
test,2403,372,380928,6579,1263168,1644096
test,2404,200,204800,1902,365184,569984
test,2405,288,294912,3944,757248,1052160
test,2406,233,238592,2581,495552,734144
test,2407,370,378880,6509,1249728,1628608
test,2408,419,429056,8347,1602624,2031680
test,2409,364,372736,6299,1209408,1582144
test,2410,236,241664,2648,508416,750080
test,2411,174,178176,1440,276480,454656
test,2412,280,286720,3728,715776,1002496
test,2413,381,390144,6902,1325184,1715328
test,2414,475,486400,10727,2059584,2545984
test,2415,444,454656,9372,1799424,2254080
test,2416,263,269312,3289,631488,900800
test,2417,425,435200,8588,1648896,2084096
test,2418,543,556032,14018,2691456,3247488
test,2419,215,220160,2198,422016,642176
test,2420,249,254976,2948,566016,820992
test,2421,169,173056,1358,260736,433792
test,2422,317,324608,4778,917376,1241984
test,2423,183,187392,1593,305856,493248
test,2424,212,217088,2137,410304,627392
test,2425,392,401408,7306,1402752,1804160
test,2426,366,374784,6369,1222848,1597632
test,2427,426,436224,8628,1656576,2092800
test,2428,315,322560,4718,905856,1228416
test,2429,393,402432,7343,1409856,1812288
test,2430,536,548864,13659,2622528,3171392
test,2431,354,362496,5958,1143936,1506432
test,2432,551,564224,14434,2771328,3335552
test,2433,275,281600,3596,690432,972032
test,2434,203,207872,1960,376320,584192
test,2435,347,355328,5725,1099200,1454528
test,2436,250,256000,2972,570624,826624
test,2437,132,135168,829,159168,294336
test,2438,393,402432,7343,1409856,1812288
test,2439,112,114688,597,114624,229312
test,2440,441,451584,9246,1775232,2226816
test,2441,421,431104,8427,1617984,2049088
test,2442,381,390144,6902,1325184,1715328
test,2443,413,422912,8109,1556928,1979840
test,2444,207,211968,2038,391296,603264
test,2445,89,91136,377,72384,163520
test,2446,342,350208,5561,1067712,1417920
test,2447,433,443392,8914,1711488,2154880
test,2448,246,251904,2877,552384,804288
test,2449,178,182272,1507,289344,471616
test,2450,171,175104,1391,267072,442176
test,2451,412,421888,8070,1549440,1971328
test,2452,145,148480,1000,192000,340480
test,2453,80,81920,305,58560,140480
test,2454,403,412672,7722,1482624,1895296
test,2455,222,227328,2343,449856,677184
test,2456,200,204800,1902,365184,569984
test,2457,131,134144,816,156672,290816
test,2458,284,290816,3835,736320,1027136
test,2459,473,484352,10637,2042304,2526656
test,2460,220,225280,2301,441792,667072
test,2461,309,316416,4540,871680,1188096
test,2462,313,320512,4658,894336,1214848
test,2463,328,335872,5115,982080,1317952
test,2464,520,532480,12855,2468160,3000640
test,2465,249,254976,2948,566016,820992
test,2466,251,257024,2996,575232,832256
test,2467,284,290816,3835,736320,1027136
test,2468,71,72704,240,46080,118784
test,2469,822,841728,32123,6167616,7009344
test,2470,323,330752,4960,952320,1283072
test,2471,283,289792,3808,731136,1020928
test,2472,169,173056,1358,260736,433792
test,2473,137,140288,893,171456,311744
test,2474,228,233472,2472,474624,708096
test,2475,409,418816,7953,1526976,1945792
test,2476,244,249856,2831,543552,793408
test,2477,183,187392,1593,305856,493248
test,2478,291,297984,4026,772992,1070976
test,2479,141,144384,946,181632,326016
test,2480,260,266240,3214,617088,883328
test,2481,116,118784,640,122880,241664
test,2482,240,245760,2739,525888,771648
test,2483,250,256000,2972,570624,826624
test,2484,311,318464,4599,883008,1201472
test,2485,408,417792,7914,1519488,1937280
test,2486,366,374784,6369,1222848,1597632
test,2487,426,436224,8628,1656576,2092800
test,2488,311,318464,4599,883008,1201472
test,2489,188,192512,1681,322752,515264
test,2490,377,386048,6757,1297344,1683392
test,2491,336,344064,5368,1030656,1374720
test,2492,84,86016,336,64512,150528
test,2493,214,219136,2178,418176,637312
test,2494,364,372736,6299,1209408,1582144
test,2495,450,460800,9627,1848384,2309184
test,2496,438,448512,9121,1751232,2199744
test,2497,396,405504,7456,1431552,1837056
test,2498,168,172032,1342,257664,429696
test,2499,354,362496,5958,1143936,1506432
test,2500,183,187392,1593,305856,493248
test,2501,118,120832,662,127104,247936
test,2502,282,288768,3781,725952,1014720
test,2503,346,354304,5692,1092864,1447168
test,2504,168,172032,1342,257664,429696
test,2505,276,282624,3622,695424,978048
test,2506,137,140288,893,171456,311744
test,2507,252,258048,3019,579648,837696
test,2508,410,419840,7992,1534464,1954304
test,2509,55,56320,144,27648,83968
test,2510,254,260096,3068,589056,849152
test,2511,460,471040,10060,1931520,2402560
test,2512,304,311296,4394,843648,1154944
test,2513,330,337920,5178,994176,1332096
test,2514,196,200704,1827,350784,551488
test,2515,397,406528,7493,1438656,1845184
test,2516,84,86016,336,64512,150528
test,2517,380,389120,6865,1318080,1707200
test,2518,212,217088,2137,410304,627392
test,2519,114,116736,618,118656,235392
test,2520,183,187392,1593,305856,493248
test,2521,492,503808,11508,2209536,2713344
test,2522,137,140288,893,171456,311744
test,2523,238,243712,2693,517056,760768
test,2524,462,473088,10148,1948416,2421504
test,2525,242,247808,2785,534720,782528
test,2526,254,260096,3068,589056,849152
test,2527,137,140288,893,171456,311744
test,2528,806,825344,30885,5929920,6755264
test,2529,118,120832,662,127104,247936
test,2530,251,257024,2996,575232,832256
test,2531,66,67584,208,39936,107520
test,2532,234,239616,2604,499968,739584
test,2533,240,245760,2739,525888,771648
test,2534,259,265216,3190,612480,877696
test,2535,279,285696,3701,710592,996288
test,2536,123,125952,720,138240,264192
test,2537,257,263168,3140,602880,866048
test,2538,312,319488,4628,888576,1208064
test,2539,258,264192,3165,607680,871872
test,2540,217,222208,2239,429888,652096
test,2541,307,314368,4481,860352,1174720
test,2542,504,516096,12077,2318784,2834880
test,2543,277,283648,3648,700416,984064
test,2544,410,419840,7992,1534464,1954304
test,2545,457,467968,9929,1906368,2374336
test,2546,367,375808,6404,1229568,1605376
test,2547,137,140288,893,171456,311744
test,2548,317,324608,4778,917376,1241984
test,2549,310,317440,4569,877248,1194688
test,2550,415,424960,8188,1572096,1997056
test,2551,99,101376,466,89472,190848
test,2552,354,362496,5958,1143936,1506432
test,2553,162,165888,1248,239616,405504
test,2554,182,186368,1575,302400,488768
test,2555,489,500736,11368,2182656,2683392
test,2556,278,284672,3675,705600,990272
test,2557,400,409600,7607,1460544,1870144
test,2558,201,205824,1921,368832,574656
test,2559,188,192512,1681,322752,515264
test,2560,370,378880,6509,1249728,1628608
test,2561,219,224256,2281,437952,662208
test,2562,272,278528,3518,675456,953984
test,2563,150,153600,1070,205440,359040
test,2564,170,174080,1374,263808,437888
test,2565,184,188416,1610,309120,497536
test,2566,304,311296,4394,843648,1154944
test,2567,351,359424,5858,1124736,1484160
test,2568,226,231424,2429,466368,697792
test,2569,323,330752,4960,952320,1283072
test,2570,269,275456,3441,660672,936128
test,2571,157,160768,1172,225024,385792
test,2572,70,71680,233,44736,116416
test,2573,446,456704,9457,1815744,2272448
test,2574,425,435200,8588,1648896,2084096
test,2575,142,145408,959,184128,329536
test,2576,301,308224,4308,827136,1135360
test,2577,70,71680,233,44736,116416
test,2578,213,218112,2157,414144,632256
test,2579,211,216064,2117,406464,622528
test,2580,385,394240,7047,1353024,1747264
test,2581,197,201728,1845,354240,555968
test,2582,309,316416,4540,871680,1188096
test,2583,117,119808,651,124992,244800
test,2584,223,228352,2365,454080,682432
test,2585,573,586752,15609,2996928,3583680
test,2586,264,270336,3314,636288,906624
test,2587,168,172032,1342,257664,429696
test,2588,212,217088,2137,410304,627392
test,2589,454,464896,9799,1881408,2346304
test,2590,256,262144,3116,598272,860416
test,2591,162,165888,1248,239616,405504
test,2592,330,337920,5178,994176,1332096
test,2593,370,378880,6509,1249728,1628608
test,2594,341,349184,5529,1061568,1410752
test,2595,164,167936,1279,245568,413504
test,2596,260,266240,3214,617088,883328
test,2597,85,87040,344,66048,153088
test,2598,263,269312,3289,631488,900800
test,2599,240,245760,2739,525888,771648
test,2600,391,400384,7269,1395648,1796032
test,2601,348,356352,5758,1105536,1461888
test,2602,139,142336,919,176448,318784
test,2603,79,80896,297,57024,137920
test,2604,485,496640,11183,2147136,2643776
test,2605,60,61440,177,33984,95424
test,2606,269,275456,3441,660672,936128
test,2607,153,156672,1113,213696,370368
test,2608,593,607232,16718,3209856,3817088
test,2609,427,437248,8669,1664448,2101696
test,2610,148,151552,1042,200064,351616
test,2611,311,318464,4599,883008,1201472
test,2612,234,239616,2604,499968,739584
test,2613,160,163840,1217,233664,397504
test,2614,404,413696,7760,1489920,1903616
test,2615,271,277504,3492,670464,947968
test,2616,202,206848,1940,372480,579328
test,2617,496,507904,11696,2245632,2753536
test,2618,294,301056,4110,789120,1090176
test,2619,341,349184,5529,1061568,1410752
test,2620,66,67584,208,39936,107520
test,2621,86,88064,352,67584,155648
test,2622,450,460800,9627,1848384,2309184
test,2623,430,440320,8791,1687872,2128192
test,2624,426,436224,8628,1656576,2092800
test,2625,252,258048,3019,579648,837696
test,2626,460,471040,10060,1931520,2402560
test,2627,174,178176,1440,276480,454656
test,2628,133,136192,841,161472,297664
test,2629,303,310272,4365,838080,1148352
test,2630,100,102400,476,91392,193792
test,2631,180,184320,1541,295872,480192
test,2632,276,282624,3622,695424,978048
test,2633,391,400384,7269,1395648,1796032
test,2634,448,458752,9542,1832064,2290816
test,2635,185,189440,1628,312576,502016
test,2636,361,369664,6196,1189632,1559296
test,2637,111,113664,586,112512,226176
test,2638,112,114688,597,114624,229312
test,2639,429,439296,8750,1680000,2119296
test,2640,409,418816,7953,1526976,1945792
test,2641,458,468992,9973,1914816,2383808
test,2642,157,160768,1172,225024,385792
test,2643,434,444416,8955,1719360,2163776
test,2644,314,321536,4688,900096,1221632
test,2645,263,269312,3289,631488,900800
test,2646,228,233472,2472,474624,708096
test,2647,223,228352,2365,454080,682432
test,2648,445,455680,9415,1807680,2263360
test,2649,101,103424,485,93120,196544
test,2650,420,430080,8387,1610304,2040384
test,2651,294,301056,4110,789120,1090176
test,2652,138,141312,906,173952,315264
test,2653,376,385024,6722,1290624,1675648
test,2654,176,180224,1473,282816,463040
test,2655,501,513024,11933,2291136,2804160
test,2656,405,414720,7798,1497216,1911936
test,2657,254,260096,3068,589056,849152
test,2658,302,309248,4336,832512,1141760
test,2659,147,150528,1028,197376,347904
test,2660,473,484352,10637,2042304,2526656
test,2661,431,441344,8832,1695744,2137088
test,2662,285,291840,3862,741504,1033344
test,2663,109,111616,565,108480,220096
test,2664,262,268288,3264,626688,894976
test,2665,390,399360,7231,1388352,1787712
test,2666,144,147456,986,189312,336768
test,2667,254,260096,3068,589056,849152
test,2668,161,164864,1233,236736,401600
test,2669,348,356352,5758,1105536,1461888
test,2670,304,311296,4394,843648,1154944
test,2671,318,325632,4808,923136,1248768
test,2672,183,187392,1593,305856,493248
test,2673,710,727040,23966,4601472,5328512
test,2674,182,186368,1575,302400,488768
test,2675,98,100352,457,87744,188096
test,2676,170,174080,1374,263808,437888
test,2677,211,216064,2117,406464,622528
test,2678,438,448512,9121,1751232,2199744
test,2679,310,317440,4569,877248,1194688
test,2680,304,311296,4394,843648,1154944
test,2681,165,168960,1295,248640,417600
test,2682,380,389120,6865,1318080,1707200
test,2683,336,344064,5368,1030656,1374720
test,2684,201,205824,1921,368832,574656
test,2685,381,390144,6902,1325184,1715328
test,2686,156,159744,1157,222144,381888
test,2687,264,270336,3314,636288,906624
test,2688,187,191488,1663,319296,510784
test,2689,338,346112,5432,1042944,1389056
test,2690,94,96256,421,80832,177088
test,2691,369,377856,6474,1243008,1620864
test,2692,393,402432,7343,1409856,1812288
test,2693,234,239616,2604,499968,739584
test,2694,337,345088,5400,1036800,1381888
test,2695,333,340992,5272,1012224,1353216
test,2696,381,390144,6902,1325184,1715328
test,2697,315,322560,4718,905856,1228416
test,2698,269,275456,3441,660672,936128
test,2699,361,369664,6196,1189632,1559296
test,2700,256,262144,3116,598272,860416
test,2701,339,347136,5464,1049088,1396224
test,2702,529,541696,13304,2554368,3096064
test,2703,317,324608,4778,917376,1241984
test,2704,423,433152,8507,1633344,2066496
test,2705,231,236544,2537,487104,723648
test,2706,87,89088,360,69120,158208
test,2707,264,270336,3314,636288,906624
test,2708,297,304128,4194,805248,1109376
test,2709,248,253952,2924,561408,815360
test,2710,250,256000,2972,570624,826624
test,2711,250,256000,2972,570624,826624
test,2712,64,65536,195,37440,102976
test,2713,303,310272,4365,838080,1148352
test,2714,186,190464,1645,315840,506304
test,2715,298,305152,4222,810624,1115776
test,2716,259,265216,3190,612480,877696
test,2717,386,395264,7084,1360128,1755392
test,2718,449,459776,9585,1840320,2300096
test,2719,213,218112,2157,414144,632256
test,2720,421,431104,8427,1617984,2049088
test,2721,579,592896,15938,3060096,3652992
test,2722,629,644096,18810,3611520,4255616
test,2723,344,352256,5626,1080192,1432448
test,2724,326,333824,5053,970176,1304000
test,2725,133,136192,841,161472,297664
test,2726,169,173056,1358,260736,433792
test,2727,379,388096,6829,1311168,1699264
test,2728,637,652288,19291,3703872,4356160
test,2729,315,322560,4718,905856,1228416
test,2730,391,400384,7269,1395648,1796032
test,2731,245,250880,2854,547968,798848
test,2732,81,82944,312,59904,142848
test,2733,61,62464,177,33984,96448
test,2734,489,500736,11368,2182656,2683392
test,2735,237,242688,2671,512832,755520
test,2736,285,291840,3862,741504,1033344
test,2737,276,282624,3622,695424,978048
test,2738,176,180224,1473,282816,463040
test,2739,206,210944,2018,387456,598400
test,2740,416,425984,8228,1579776,2005760
test,2741,240,245760,2739,525888,771648
test,2742,321,328704,4899,940608,1269312
test,2743,349,357376,5791,1111872,1469248
test,2744,422,432128,8467,1625664,2057792
test,2745,229,234496,2494,478848,713344
test,2746,347,355328,5725,1099200,1454528
test,2747,370,378880,6509,1249728,1628608
test,2748,230,235520,2515,482880,718400
test,2749,85,87040,344,66048,153088
test,2750,188,192512,1681,322752,515264
test,2751,487,498688,11276,2164992,2663680
test,2752,376,385024,6722,1290624,1675648
test,2753,160,163840,1217,233664,397504
test,2754,105,107520,525,100800,208320
test,2755,218,223232,2260,433920,657152
test,2756,113,115712,608,116736,232448
test,2757,91,93184,394,75648,168832
test,2758,470,481280,10502,2016384,2497664
test,2759,374,382976,6650,1276800,1659776
test,2760,321,328704,4899,940608,1269312
test,2761,60,61440,172,33024,94464
test,2762,171,175104,1391,267072,442176
test,2763,448,458752,9542,1832064,2290816
test,2764,124,126976,731,140352,267328
test,2765,488,499712,11322,2173824,2673536
test,2766,565,578560,15177,2913984,3492544
test,2767,285,291840,3862,741504,1033344
test,2768,349,357376,5791,1111872,1469248
test,2769,438,448512,9121,1751232,2199744
test,2770,194,198656,1790,343680,542336
test,2771,197,201728,1845,354240,555968
test,2772,139,142336,919,176448,318784
test,2773,215,220160,2198,422016,642176
test,2774,198,202752,1864,357888,560640
test,2775,181,185344,1558,299136,484480
test,2776,504,516096,12077,2318784,2834880
test,2777,255,261120,3092,593664,854784
test,2778,174,178176,1440,276480,454656
test,2779,512,524288,12463,2392896,2917184
test,2780,358,366592,6093,1169856,1536448
test,2781,258,264192,3165,607680,871872
test,2782,128,131072,779,149568,280640
test,2783,606,620544,17459,3352128,3972672
test,2784,177,181248,1490,286080,467328
test,2785,110,112640,576,110592,223232
test,2786,210,215040,2097,402624,617664
test,2787,235,240640,2626,504192,744832
test,2788,191,195584,1735,333120,528704
test,2789,165,168960,1295,248640,417600
test,2790,293,300032,4082,783744,1083776
test,2791,177,181248,1490,286080,467328
test,2792,309,316416,4540,871680,1188096
test,2793,98,100352,457,87744,188096
test,2794,305,312320,4423,849216,1161536
test,2795,351,359424,5858,1124736,1484160
test,2796,61,62464,183,35136,97600
test,2797,272,278528,3518,675456,953984
test,2798,248,253952,2924,561408,815360
test,2799,504,516096,12077,2318784,2834880
test,2800,372,380928,6579,1263168,1644096
test,2801,303,310272,4365,838080,1148352
test,2802,99,101376,466,89472,190848
test,2803,103,105472,505,96960,202432
test,2804,193,197632,1771,340032,537664
test,2805,244,249856,2831,543552,793408
test,2806,281,287744,3754,720768,1008512
test,2807,134,137216,854,163968,301184
test,2808,158,161792,1187,227904,389696
test,2809,199,203776,1883,361536,565312
test,2810,299,306176,4251,816192,1122368
test,2811,105,107520,525,100800,208320
test,2812,249,254976,2948,566016,820992
test,2813,189,193536,1699,326208,519744
test,2814,177,181248,1490,286080,467328
test,2815,106,108544,535,102720,211264
test,2816,137,140288,893,171456,311744
test,2817,285,291840,3862,741504,1033344
test,2818,64,65536,195,37440,102976
test,2819,442,452608,9288,1783296,2235904
test,2820,381,390144,6902,1325184,1715328
test,2821,288,294912,3944,757248,1052160
test,2822,378,387072,6793,1304256,1691328
test,2823,96,98304,439,84288,182592
test,2824,209,214016,2077,398784,612800
test,2825,155,158720,1143,219456,378176
test,2826,271,277504,3492,670464,947968
test,2827,430,440320,8791,1687872,2128192
test,2828,378,387072,6793,1304256,1691328
test,2829,272,278528,3518,675456,953984
test,2830,347,355328,5725,1099200,1454528
test,2831,299,306176,4251,816192,1122368
test,2832,166,169984,1310,251520,421504
test,2833,164,167936,1279,245568,413504
test,2834,261,267264,3239,621888,889152
test,2835,268,274432,3415,655680,930112
test,2836,240,245760,2739,525888,771648
test,2837,425,435200,8588,1648896,2084096
test,2838,89,91136,377,72384,163520
test,2839,212,217088,2137,410304,627392
test,2840,343,351232,5594,1074048,1425280
test,2841,439,449536,9163,1759296,2208832
test,2842,253,259072,3043,584256,843328
test,2843,168,172032,1342,257664,429696
test,2844,489,500736,11368,2182656,2683392
test,2845,357,365568,6059,1163328,1528896
test,2846,317,324608,4778,917376,1241984
test,2847,442,452608,9288,1783296,2235904
test,2848,281,287744,3754,720768,1008512
test,2849,76,77824,275,52800,130624
test,2850,270,276480,3466,665472,941952
test,2851,246,251904,2877,552384,804288
test,2852,346,354304,5692,1092864,1447168
test,2853,156,159744,1157,222144,381888
test,2854,320,327680,4869,934848,1262528
test,2855,378,387072,6793,1304256,1691328
test,2856,143,146432,973,186816,333248
test,2857,247,252928,2901,556992,809920
test,2858,324,331776,4991,958272,1290048
test,2859,172,176128,1407,270144,446272
test,2860,401,410624,7645,1467840,1878464
test,2861,349,357376,5791,1111872,1469248
test,2862,395,404480,7418,1424256,1828736
test,2863,363,371712,6265,1202880,1574592
test,2864,276,282624,3622,695424,978048
test,2865,78,79872,290,55680,135552
test,2866,425,435200,8588,1648896,2084096
test,2867,243,248832,2808,539136,787968
test,2868,120,122880,685,131520,254400
test,2869,294,301056,4110,789120,1090176
test,2870,328,335872,5115,982080,1317952
test,2871,135,138240,867,166464,304704
test,2872,285,291840,3862,741504,1033344
test,2873,319,326656,4838,928896,1255552
test,2874,109,111616,565,108480,220096
test,2875,306,313344,4452,854784,1168128
test,2876,286,292864,3889,746688,1039552
test,2877,230,235520,2515,482880,718400
test,2878,363,371712,6265,1202880,1574592
test,2879,289,295936,3971,762432,1058368
test,2880,225,230400,2407,462144,692544
test,2881,258,264192,3165,607680,871872
test,2882,468,479232,10413,1999296,2478528
test,2883,192,196608,1753,336576,533184
test,2884,399,408576,7569,1453248,1861824
test,2885,295,302080,4138,794496,1096576
test,2886,248,253952,2924,561408,815360
test,2887,364,372736,6299,1209408,1582144
test,2888,343,351232,5594,1074048,1425280
test,2889,501,513024,11933,2291136,2804160
test,2890,233,238592,2581,495552,734144
test,2891,123,125952,720,138240,264192
test,2892,189,193536,1699,326208,519744
test,2893,282,288768,3781,725952,1014720
test,2894,166,169984,1310,251520,421504
test,2895,317,324608,4778,917376,1241984
test,2896,270,276480,3466,665472,941952
test,2897,204,208896,1979,379968,588864
test,2898,220,225280,2301,441792,667072
test,2899,323,330752,4960,952320,1283072
test,2900,322,329728,4930,946560,1276288
test,2901,101,103424,485,93120,196544
test,2902,286,292864,3889,746688,1039552
test,2903,278,284672,3675,705600,990272
test,2904,329,336896,5146,988032,1324928
test,2905,339,347136,5464,1049088,1396224
test,2906,318,325632,4808,923136,1248768
test,2907,298,305152,4222,810624,1115776
test,2908,72,73728,247,47424,121152
test,2909,156,159744,1157,222144,381888
test,2910,307,314368,4481,860352,1174720
test,2911,251,257024,2996,575232,832256
test,2912,83,84992,328,62976,147968
test,2913,483,494592,11091,2129472,2624064
test,2914,421,431104,8427,1617984,2049088
test,2915,378,387072,6793,1304256,1691328
test,2916,357,365568,6059,1163328,1528896
test,2917,377,386048,6757,1297344,1683392
test,2918,128,131072,779,149568,280640
test,2919,359,367616,6128,1176576,1544192
test,2920,151,154624,1084,208128,362752
test,2921,265,271360,3339,641088,912448
test,2922,228,233472,2472,474624,708096
test,2923,457,467968,9929,1906368,2374336
test,2924,314,321536,4688,900096,1221632
test,2925,129,132096,792,152064,284160
test,2926,465,476160,10280,1973760,2449920
test,2927,285,291840,3862,741504,1033344
test,2928,276,282624,3622,695424,978048
test,2929,257,263168,3140,602880,866048
test,2930,282,288768,3781,725952,1014720
test,2931,365,373760,6334,1216128,1589888
test,2932,331,338944,5209,1000128,1339072
test,2933,257,263168,3140,602880,866048
test,2934,297,304128,4194,805248,1109376
test,2935,355,363520,5992,1150464,1513984
test,2936,463,474112,10192,1956864,2430976
test,2937,280,286720,3728,715776,1002496
test,2938,276,282624,3622,695424,978048
test,2939,242,247808,2785,534720,782528
test,2940,148,151552,1042,200064,351616
test,2941,209,214016,2077,398784,612800
test,2942,307,314368,4481,860352,1174720
test,2943,140,143360,932,178944,322304
test,2944,320,327680,4869,934848,1262528
test,2945,422,432128,8467,1625664,2057792
test,2946,198,202752,1864,357888,560640
test,2947,106,108544,535,102720,211264
test,2948,475,486400,10727,2059584,2545984
test,2949,84,86016,336,64512,150528
test,2950,209,214016,2077,398784,612800
test,2951,586,600064,16326,3134592,3734656
test,2952,525,537600,13104,2515968,3053568
test,2953,401,410624,7645,1467840,1878464
test,2954,118,120832,662,127104,247936
test,2955,336,344064,5368,1030656,1374720
test,2956,283,289792,3808,731136,1020928
test,2957,228,233472,2472,474624,708096
test,2958,289,295936,3971,762432,1058368
test,2959,159,162816,1202,230784,393600
test,2960,340,348160,5496,1055232,1403392
test,2961,206,210944,2018,387456,598400
test,2962,328,335872,5115,982080,1317952
test,2963,209,214016,2077,398784,612800
test,2964,183,187392,1593,305856,493248
test,2965,400,409600,7607,1460544,1870144
test,2966,209,214016,2077,398784,612800
test,2967,476,487424,10772,2068224,2555648
test,2968,376,385024,6722,1290624,1675648
test,2969,319,326656,4838,928896,1255552
test,2970,167,171008,1326,254592,425600
test,2971,337,345088,5400,1036800,1381888
test,2972,321,328704,4899,940608,1269312
test,2973,355,363520,5992,1150464,1513984
test,2974,132,135168,829,159168,294336
test,2975,87,89088,360,69120,158208
test,2976,353,361472,5924,1137408,1498880
test,2977,182,186368,1575,302400,488768
test,2978,138,141312,906,173952,315264
test,2979,85,87040,344,66048,153088
test,2980,352,360448,5891,1131072,1491520
test,2981,338,346112,5432,1042944,1389056
test,2982,125,128000,743,142656,270656
test,2983,301,308224,4308,827136,1135360
test,2984,170,174080,1374,263808,437888
test,2985,227,232448,2450,470400,702848
test,2986,220,225280,2301,441792,667072
test,2987,460,471040,10060,1931520,2402560
test,2988,710,727040,23966,4601472,5328512
test,2989,217,222208,2239,429888,652096
test,2990,337,345088,5400,1036800,1381888
test,2991,80,81920,305,58560,140480
test,2992,257,263168,3140,602880,866048
test,2993,182,186368,1575,302400,488768
test,2994,302,309248,4336,832512,1141760
test,2995,605,619520,17402,3341184,3960704
test,2996,293,300032,4082,783744,1083776
test,2997,374,382976,6650,1276800,1659776
test,2998,145,148480,1000,192000,340480
test,2999,362,370688,6230,1196160,1566848
test,3000,263,269312,3289,631488,900800
test,3001,274,280576,3570,685440,966016
test,3002,286,292864,3889,746688,1039552
test,3003,342,350208,5561,1067712,1417920
test,3004,355,363520,5992,1150464,1513984
test,3005,144,147456,986,189312,336768
test,3006,195,199680,1808,347136,546816
test,3007,78,79872,290,55680,135552
test,3008,338,346112,5432,1042944,1389056
test,3009,118,120832,662,127104,247936
test,3010,85,87040,344,66048,153088
test,3011,274,280576,3570,685440,966016
test,3012,316,323584,4748,911616,1235200
test,3013,334,342016,5304,1018368,1360384
test,3014,193,197632,1771,340032,537664
test,3015,353,361472,5924,1137408,1498880
test,3016,300,307200,4279,821568,1128768
test,3017,302,309248,4336,832512,1141760
test,3018,225,230400,2407,462144,692544
test,3019,329,336896,5146,988032,1324928
test,3020,467,478208,10369,1990848,2469056
test,3021,344,352256,5626,1080192,1432448
test,3022,506,518144,12173,2337216,2855360
test,3023,274,280576,3570,685440,966016
test,3024,304,311296,4394,843648,1154944
test,3025,231,236544,2537,487104,723648
test,3026,310,317440,4569,877248,1194688
test,3027,236,241664,2648,508416,750080
test,3028,255,261120,3092,593664,854784
test,3029,415,424960,8188,1572096,1997056
test,3030,362,370688,6230,1196160,1566848
test,3031,213,218112,2157,414144,632256
test,3032,176,180224,1473,282816,463040
test,3033,182,186368,1575,302400,488768
test,3034,132,135168,829,159168,294336
test,3035,438,448512,9121,1751232,2199744
test,3036,375,384000,6686,1283712,1667712
test,3037,311,318464,4599,883008,1201472
test,3038,217,222208,2239,429888,652096
test,3039,192,196608,1753,336576,533184
test,3040,220,225280,2301,441792,667072
test,3041,231,236544,2537,487104,723648
test,3042,246,251904,2877,552384,804288
test,3043,220,225280,2301,441792,667072
test,3044,408,417792,7914,1519488,1937280
test,3045,462,473088,10148,1948416,2421504
test,3046,349,357376,5791,1111872,1469248
test,3047,272,278528,3518,675456,953984
test,3048,364,372736,6299,1209408,1582144
test,3049,424,434176,8547,1641024,2075200
test,3050,213,218112,2157,414144,632256
test,3051,303,310272,4365,838080,1148352
test,3052,238,243712,2693,517056,760768
test,3053,70,71680,233,44736,116416
test,3054,220,225280,2301,441792,667072
test,3055,508,520192,12269,2355648,2875840
test,3056,183,187392,1593,305856,493248
test,3057,528,540672,13254,2544768,3085440
test,3058,188,192512,1681,322752,515264
test,3059,66,67584,208,39936,107520
test,3060,521,533504,12905,2477760,3011264
test,3061,220,225280,2301,441792,667072
test,3062,210,215040,2097,402624,617664
test,3063,330,337920,5178,994176,1332096
test,3064,187,191488,1663,319296,510784
test,3065,270,276480,3466,665472,941952
test,3066,567,580608,15284,2934528,3515136
test,3067,200,204800,1902,365184,569984
test,3068,404,413696,7760,1489920,1903616
test,3069,93,95232,412,79104,174336
test,3070,396,405504,7456,1431552,1837056
test,3071,154,157696,1128,216576,374272
test,3072,258,264192,3165,607680,871872
test,3073,405,414720,7798,1497216,1911936
test,3074,389,398336,7194,1381248,1779584
test,3075,371,379904,6544,1256448,1636352
test,3076,223,228352,2365,454080,682432
test,3077,158,161792,1187,227904,389696
test,3078,410,419840,7992,1534464,1954304
test,3079,334,342016,5304,1018368,1360384
test,3080,451,461824,9670,1856640,2318464
test,3081,469,480256,10458,2007936,2488192
test,3082,259,265216,3190,612480,877696
test,3083,502,514048,11981,2300352,2814400
test,3084,279,285696,3701,710592,996288
test,3085,353,361472,5924,1137408,1498880
test,3086,271,277504,3492,670464,947968
test,3087,372,380928,6579,1263168,1644096
test,3088,503,515072,12029,2309568,2824640
test,3089,271,277504,3492,670464,947968
test,3090,260,266240,3214,617088,883328
test,3091,431,441344,8832,1695744,2137088
test,3092,251,257024,2996,575232,832256
test,3093,255,261120,3092,593664,854784
test,3094,349,357376,5791,1111872,1469248
test,3095,316,323584,4748,911616,1235200
test,3096,240,245760,2739,525888,771648
test,3097,401,410624,7645,1467840,1878464
test,3098,157,160768,1172,225024,385792
test,3099,414,423936,8149,1564608,1988544
test,3100,326,333824,5053,970176,1304000
test,3101,276,282624,3622,695424,978048
test,3102,363,371712,6265,1202880,1574592
test,3103,235,240640,2626,504192,744832
test,3104,180,184320,1541,295872,480192
test,3105,281,287744,3754,720768,1008512
test,3106,336,344064,5368,1030656,1374720
test,3107,291,297984,4026,772992,1070976
test,3108,209,214016,2077,398784,612800
test,3109,119,121856,674,129408,251264
test,3110,281,287744,3754,720768,1008512
test,3111,217,222208,2239,429888,652096
test,3112,382,391168,6938,1332096,1723264
test,3113,128,131072,779,149568,280640
test,3114,178,182272,1507,289344,471616
test,3115,223,228352,2365,454080,682432
test,3116,336,344064,5368,1030656,1374720
test,3117,228,233472,2472,474624,708096
test,3118,206,210944,2018,387456,598400
test,3119,62,63488,189,36288,99776
test,3120,45,46080,97,18624,64704
test,3121,130,133120,804,154368,287488
test,3122,304,311296,4394,843648,1154944
test,3123,219,224256,2281,437952,662208
test,3124,339,347136,5464,1049088,1396224
test,3125,86,88064,352,67584,155648
test,3126,257,263168,3140,602880,866048
test,3127,347,355328,5725,1099200,1454528
test,3128,151,154624,1084,208128,362752
test,3129,350,358400,5824,1118208,1476608
test,3130,309,316416,4540,871680,1188096
test,3131,344,352256,5626,1080192,1432448
test,3132,175,179200,1456,279552,458752
test,3133,394,403456,7381,1417152,1820608
test,3134,303,310272,4365,838080,1148352
test,3135,195,199680,1808,347136,546816
test,3136,310,317440,4569,877248,1194688
test,3137,333,340992,5272,1012224,1353216
test,3138,400,409600,7607,1460544,1870144
test,3139,255,261120,3092,593664,854784
test,3140,291,297984,4026,772992,1070976
test,3141,83,84992,328,62976,147968
test,3142,319,326656,4838,928896,1255552
test,3143,123,125952,720,138240,264192
test,3144,344,352256,5626,1080192,1432448
test,3145,371,379904,6544,1256448,1636352
test,3146,162,165888,1248,239616,405504
test,3147,363,371712,6265,1202880,1574592
test,3148,86,88064,352,67584,155648
test,3149,492,503808,11508,2209536,2713344
test,3150,541,553984,13915,2671680,3225664
test,3151,302,309248,4336,832512,1141760
test,3152,214,219136,2178,418176,637312
test,3153,347,355328,5725,1099200,1454528
test,3154,344,352256,5626,1080192,1432448
test,3155,156,159744,1157,222144,381888
test,3156,343,351232,5594,1074048,1425280
test,3157,372,380928,6579,1263168,1644096
test,3158,174,178176,1440,276480,454656
test,3159,78,79872,290,55680,135552
test,3160,674,690176,21597,4146624,4836800
test,3161,296,303104,4166,799872,1102976
test,3162,125,128000,743,142656,270656
test,3163,389,398336,7194,1381248,1779584
test,3164,528,540672,13254,2544768,3085440
test,3165,308,315392,4510,865920,1181312
test,3166,374,382976,6650,1276800,1659776
test,3167,309,316416,4540,871680,1188096
test,3168,346,354304,5692,1092864,1447168
test,3169,111,113664,586,112512,226176
test,3170,157,160768,1172,225024,385792
test,3171,259,265216,3190,612480,877696
test,3172,151,154624,1084,208128,362752
test,3173,129,132096,792,152064,284160
test,3174,98,100352,457,87744,188096
test,3175,384,393216,7011,1346112,1739328
test,3176,344,352256,5626,1080192,1432448
test,3177,413,422912,8109,1556928,1979840
test,3178,309,316416,4540,871680,1188096
test,3179,424,434176,8547,1641024,2075200
test,3180,197,201728,1845,354240,555968
test,3181,309,316416,4540,871680,1188096
test,3182,384,393216,7011,1346112,1739328
test,3183,298,305152,4222,810624,1115776
test,3184,207,211968,2038,391296,603264
test,3185,79,80896,297,57024,137920
test,3186,419,429056,8347,1602624,2031680
test,3187,278,284672,3675,705600,990272
test,3188,428,438272,8709,1672128,2110400
test,3189,132,135168,829,159168,294336
test,3190,111,113664,586,112512,226176
test,3191,485,496640,11183,2147136,2643776
test,3192,129,132096,792,152064,284160
test,3193,499,510976,11838,2272896,2783872
test,3194,223,228352,2365,454080,682432
test,3195,64,65536,195,37440,102976
test,3196,302,309248,4336,832512,1141760
test,3197,150,153600,1070,205440,359040
test,3198,339,347136,5464,1049088,1396224
test,3199,381,390144,6902,1325184,1715328
test,3200,346,354304,5692,1092864,1447168
test,3201,151,154624,1084,208128,362752
test,3202,281,287744,3754,720768,1008512
test,3203,312,319488,4628,888576,1208064
test,3204,222,227328,2343,449856,677184
test,3205,157,160768,1172,225024,385792
test,3206,176,180224,1473,282816,463040
test,3207,232,237568,2559,491328,728896
test,3208,255,261120,3092,593664,854784
test,3209,312,319488,4628,888576,1208064
test,3210,339,347136,5464,1049088,1396224
test,3211,195,199680,1808,347136,546816
test,3212,432,442368,8873,1703616,2145984
test,3213,246,251904,2877,552384,804288
test,3214,306,313344,4452,854784,1168128
test,3215,107,109568,545,104640,214208
test,3216,185,189440,1628,312576,502016
test,3217,433,443392,8914,1711488,2154880
test,3218,330,337920,5178,994176,1332096
test,3219,353,361472,5924,1137408,1498880
test,3220,390,399360,7231,1388352,1787712
test,3221,310,317440,4569,877248,1194688
test,3222,381,390144,6902,1325184,1715328
test,3223,264,270336,3314,636288,906624
test,3224,391,400384,7269,1395648,1796032
test,3225,127,130048,767,147264,277312
test,3226,233,238592,2581,495552,734144
test,3227,396,405504,7456,1431552,1837056
test,3228,115,117760,629,120768,238528
test,3229,478,489472,10863,2085696,2575168
test,3230,202,206848,1940,372480,579328
test,3231,264,270336,3314,636288,906624
test,3232,294,301056,4110,789120,1090176
test,3233,338,346112,5432,1042944,1389056
test,3234,294,301056,4110,789120,1090176
test,3235,231,236544,2537,487104,723648
test,3236,112,114688,597,114624,229312
test,3237,315,322560,4718,905856,1228416
test,3238,133,136192,841,161472,297664
test,3239,459,470016,10016,1923072,2393088
test,3240,62,63488,183,35136,98624
test,3241,306,313344,4452,854784,1168128
test,3242,94,96256,421,80832,177088
test,3243,271,277504,3492,670464,947968
test,3244,239,244736,2716,521472,766208
test,3245,171,175104,1391,267072,442176
test,3246,410,419840,7992,1534464,1954304
test,3247,255,261120,3092,593664,854784
test,3248,411,420864,8031,1541952,1962816
test,3249,185,189440,1628,312576,502016
test,3250,289,295936,3971,762432,1058368
test,3251,310,317440,4569,877248,1194688
test,3252,190,194560,1717,329664,524224
test,3253,216,221184,2219,426048,647232
test,3254,256,262144,3116,598272,860416
test,3255,348,356352,5758,1105536,1461888
test,3256,112,114688,597,114624,229312
test,3257,292,299008,4054,778368,1077376
test,3258,79,80896,297,57024,137920
test,3259,207,211968,2038,391296,603264
test,3260,301,308224,4308,827136,1135360
test,3261,392,401408,7306,1402752,1804160
test,3262,123,125952,720,138240,264192
test,3263,418,428032,8307,1594944,2022976
test,3264,244,249856,2831,543552,793408
test,3265,632,647168,18989,3645888,4293056
test,3266,303,310272,4365,838080,1148352
test,3267,88,90112,369,70848,160960
test,3268,270,276480,3466,665472,941952
test,3269,215,220160,2198,422016,642176
test,3270,370,378880,6509,1249728,1628608
test,3271,190,194560,1717,329664,524224
test,3272,198,202752,1864,357888,560640
test,3273,298,305152,4222,810624,1115776
test,3274,400,409600,7607,1460544,1870144
test,3275,459,470016,10016,1923072,2393088
test,3276,252,258048,3019,579648,837696
test,3277,260,266240,3214,617088,883328
test,3278,163,166912,1264,242688,409600
test,3279,142,145408,959,184128,329536
test,3280,343,351232,5594,1074048,1425280
test,3281,355,363520,5992,1150464,1513984
test,3282,206,210944,2018,387456,598400
test,3283,208,212992,2057,394944,607936
test,3284,404,413696,7760,1489920,1903616
test,3285,381,390144,6902,1325184,1715328
test,3286,256,262144,3116,598272,860416
test,3287,482,493568,11045,2120640,2614208
test,3288,515,527360,12609,2420928,2948288
test,3289,137,140288,893,171456,311744
test,3290,259,265216,3190,612480,877696
test,3291,371,379904,6544,1256448,1636352
test,3292,237,242688,2671,512832,755520
test,3293,196,200704,1827,350784,551488
test,3294,347,355328,5725,1099200,1454528
test,3295,374,382976,6650,1276800,1659776
test,3296,101,103424,485,93120,196544
test,3297,213,218112,2157,414144,632256
test,3298,357,365568,6059,1163328,1528896
test,3299,265,271360,3339,641088,912448
test,3300,402,411648,7683,1475136,1886784
test,3301,85,87040,344,66048,153088
test,3302,459,470016,10016,1923072,2393088
test,3303,383,392192,6974,1339008,1731200
test,3304,324,331776,4991,958272,1290048
test,3305,123,125952,720,138240,264192
test,3306,129,132096,792,152064,284160
test,3307,276,282624,3622,695424,978048
test,3308,298,305152,4222,810624,1115776
test,3309,304,311296,4394,843648,1154944
test,3310,385,394240,7047,1353024,1747264
test,3311,201,205824,1921,368832,574656
test,3312,405,414720,7798,1497216,1911936
test,3313,264,270336,3314,636288,906624
test,3314,371,379904,6544,1256448,1636352
test,3315,181,185344,1558,299136,484480
test,3316,195,199680,1808,347136,546816
test,3317,414,423936,8149,1564608,1988544
test,3318,200,204800,1902,365184,569984
test,3319,153,156672,1113,213696,370368
test,3320,199,203776,1883,361536,565312
test,3321,323,330752,4960,952320,1283072
test,3322,135,138240,867,166464,304704
test,3323,193,197632,1771,340032,537664
test,3324,165,168960,1295,248640,417600
test,3325,350,358400,5824,1118208,1476608
test,3326,341,349184,5529,1061568,1410752
test,3327,254,260096,3068,589056,849152
test,3328,78,79872,290,55680,135552
test,3329,118,120832,662,127104,247936
test,3330,256,262144,3116,598272,860416
test,3331,403,412672,7722,1482624,1895296
test,3332,206,210944,2018,387456,598400
test,3333,267,273408,3390,650880,924288
test,3334,257,263168,3140,602880,866048
test,3335,175,179200,1456,279552,458752
test,3336,87,89088,360,69120,158208
test,3337,284,290816,3835,736320,1027136
test,3338,425,435200,8588,1648896,2084096
test,3339,256,262144,3116,598272,860416
test,3340,168,172032,1342,257664,429696
test,3341,210,215040,2097,402624,617664
test,3342,282,288768,3781,725952,1014720
test,3343,336,344064,5368,1030656,1374720
test,3344,465,476160,10280,1973760,2449920
test,3345,139,142336,919,176448,318784
test,3346,107,109568,545,104640,214208
test,3347,139,142336,919,176448,318784
test,3348,318,325632,4808,923136,1248768
test,3349,113,115712,608,116736,232448
test,3350,201,205824,1921,368832,574656
test,3351,244,249856,2831,543552,793408
test,3352,284,290816,3835,736320,1027136
test,3353,450,460800,9627,1848384,2309184
test,3354,217,222208,2239,429888,652096
test,3355,222,227328,2343,449856,677184
test,3356,174,178176,1440,276480,454656
test,3357,180,184320,1541,295872,480192
test,3358,96,98304,439,84288,182592
test,3359,256,262144,3116,598272,860416
test,3360,204,208896,1979,379968,588864
test,3361,79,80896,297,57024,137920
test,3362,87,89088,360,69120,158208
test,3363,352,360448,5891,1131072,1491520
test,3364,413,422912,8109,1556928,1979840
test,3365,173,177152,1423,273216,450368
test,3366,187,191488,1663,319296,510784
test,3367,169,173056,1358,260736,433792
test,3368,94,96256,421,80832,177088
test,3369,255,261120,3092,593664,854784
test,3370,354,362496,5958,1143936,1506432
test,3371,228,233472,2472,474624,708096
test,3372,276,282624,3622,695424,978048
test,3373,261,267264,3239,621888,889152
test,3374,113,115712,608,116736,232448
test,3375,287,293888,3916,751872,1045760
test,3376,499,510976,11838,2272896,2783872
test,3377,541,553984,13915,2671680,3225664
test,3378,342,350208,5561,1067712,1417920
test,3379,250,256000,2972,570624,826624
test,3380,193,197632,1771,340032,537664
test,3381,308,315392,4510,865920,1181312
test,3382,255,261120,3092,593664,854784
test,3383,450,460800,9627,1848384,2309184
test,3384,245,250880,2854,547968,798848
test,3385,153,156672,1113,213696,370368
test,3386,344,352256,5626,1080192,1432448
test,3387,169,173056,1358,260736,433792
test,3388,339,347136,5464,1049088,1396224
test,3389,326,333824,5053,970176,1304000
test,3390,384,393216,7011,1346112,1739328
test,3391,134,137216,854,163968,301184
test,3392,154,157696,1128,216576,374272
test,3393,310,317440,4569,877248,1194688
test,3394,442,452608,9288,1783296,2235904
test,3395,216,221184,2219,426048,647232
test,3396,155,158720,1143,219456,378176
test,3397,202,206848,1940,372480,579328
test,3398,250,256000,2972,570624,826624
test,3399,167,171008,1326,254592,425600
test,3400,89,91136,377,72384,163520
test,3401,364,372736,6299,1209408,1582144
test,3402,230,235520,2515,482880,718400
test,3403,285,291840,3862,741504,1033344
test,3404,78,79872,290,55680,135552
test,3405,346,354304,5692,1092864,1447168
test,3406,633,648192,19050,3657600,4305792
test,3407,265,271360,3339,641088,912448
test,3408,196,200704,1827,350784,551488
test,3409,427,437248,8669,1664448,2101696
test,3410,306,313344,4452,854784,1168128
test,3411,270,276480,3466,665472,941952
test,3412,383,392192,6974,1339008,1731200
test,3413,497,508928,11743,2254656,2763584
test,3414,271,277504,3492,670464,947968
test,3415,155,158720,1143,219456,378176
test,3416,157,160768,1172,225024,385792
test,3417,265,271360,3339,641088,912448
test,3418,397,406528,7493,1438656,1845184
test,3419,350,358400,5824,1118208,1476608
test,3420,414,423936,8149,1564608,1988544
test,3421,462,473088,10148,1948416,2421504
test,3422,133,136192,841,161472,297664
test,3423,612,626688,17807,3418944,4045632
test,3424,195,199680,1808,347136,546816
test,3425,229,234496,2494,478848,713344
test,3426,355,363520,5992,1150464,1513984
test,3427,131,134144,816,156672,290816
test,3428,375,384000,6686,1283712,1667712
test,3429,258,264192,3165,607680,871872
test,3430,385,394240,7047,1353024,1747264
test,3431,143,146432,973,186816,333248
test,3432,142,145408,959,184128,329536
test,3433,59,60416,166,31872,92288
test,3434,300,307200,4279,821568,1128768
test,3435,268,274432,3415,655680,930112
test,3436,375,384000,6686,1283712,1667712
test,3437,311,318464,4599,883008,1201472
test,3438,203,207872,1960,376320,584192
test,3439,341,349184,5529,1061568,1410752
test,3440,706,722944,23697,4549824,5272768
test,3441,218,223232,2260,433920,657152
test,3442,278,284672,3675,705600,990272
test,3443,385,394240,7047,1353024,1747264
test,3444,197,201728,1845,354240,555968
test,3445,453,463872,9756,1873152,2337024
test,3446,300,307200,4279,821568,1128768
test,3447,190,194560,1717,329664,524224
test,3448,246,251904,2877,552384,804288
test,3449,193,197632,1771,340032,537664
test,3450,367,375808,6404,1229568,1605376
test,3451,307,314368,4481,860352,1174720
test,3452,194,198656,1790,343680,542336
test,3453,448,458752,9542,1832064,2290816
test,3454,135,138240,867,166464,304704
test,3455,284,290816,3835,736320,1027136
test,3456,412,421888,8070,1549440,1971328
test,3457,212,217088,2137,410304,627392
test,3458,441,451584,9246,1775232,2226816
test,3459,339,347136,5464,1049088,1396224
test,3460,133,136192,841,161472,297664
test,3461,303,310272,4365,838080,1148352
test,3462,337,345088,5400,1036800,1381888
test,3463,195,199680,1808,347136,546816
test,3464,597,611328,16944,3253248,3864576
test,3465,243,248832,2808,539136,787968
test,3466,417,427008,8267,1587264,2014272
test,3467,485,496640,11183,2147136,2643776
test,3468,217,222208,2239,429888,652096
test,3469,303,310272,4365,838080,1148352
test,3470,238,243712,2693,517056,760768
test,3471,317,324608,4778,917376,1241984
test,3472,274,280576,3570,685440,966016
test,3473,451,461824,9670,1856640,2318464
test,3474,198,202752,1864,357888,560640
test,3475,462,473088,10148,1948416,2421504
test,3476,231,236544,2537,487104,723648
test,3477,261,267264,3239,621888,889152
test,3478,140,143360,932,178944,322304
test,3479,70,71680,240,46080,117760
test,3480,324,331776,4991,958272,1290048
test,3481,285,291840,3862,741504,1033344
test,3482,263,269312,3289,631488,900800
test,3483,305,312320,4423,849216,1161536
test,3484,216,221184,2219,426048,647232
test,3485,133,136192,841,161472,297664
test,3486,341,349184,5529,1061568,1410752
test,3487,229,234496,2494,478848,713344
test,3488,666,681984,21087,4048704,4730688
test,3489,137,140288,893,171456,311744
test,3490,413,422912,8109,1556928,1979840
test,3491,225,230400,2407,462144,692544
test,3492,285,291840,3862,741504,1033344
test,3493,249,254976,2948,566016,820992
test,3494,543,556032,14018,2691456,3247488
test,3495,247,252928,2901,556992,809920
test,3496,167,171008,1326,254592,425600
test,3497,406,415744,7837,1504704,1920448
test,3498,504,516096,12077,2318784,2834880
test,3499,372,380928,6579,1263168,1644096
test,3500,311,318464,4599,883008,1201472
test,3501,277,283648,3648,700416,984064
test,3502,147,150528,1028,197376,347904
test,3503,207,211968,2038,391296,603264
test,3504,457,467968,9929,1906368,2374336
test,3505,410,419840,7992,1534464,1954304
test,3506,133,136192,841,161472,297664
test,3507,335,343040,5336,1024512,1367552
test,3508,604,618496,17344,3330048,3948544
test,3509,410,419840,7992,1534464,1954304
test,3510,235,240640,2626,504192,744832
test,3511,281,287744,3754,720768,1008512
test,3512,322,329728,4930,946560,1276288
test,3513,266,272384,3364,645888,918272
test,3514,206,210944,2018,387456,598400
test,3515,173,177152,1423,273216,450368
test,3516,382,391168,6938,1332096,1723264
test,3517,126,129024,755,144960,273984
test,3518,92,94208,403,77376,171584
test,3519,316,323584,4748,911616,1235200
test,3520,92,94208,403,77376,171584
test,3521,329,336896,5146,988032,1324928
test,3522,602,616448,17229,3307968,3924416
test,3523,161,164864,1233,236736,401600
test,3524,292,299008,4054,778368,1077376
test,3525,134,137216,854,163968,301184
test,3526,229,234496,2494,478848,713344
test,3527,255,261120,3092,593664,854784
test,3528,486,497664,11229,2155968,2653632
test,3529,221,226304,2322,445824,672128
test,3530,353,361472,5924,1137408,1498880
test,3531,204,208896,1979,379968,588864
test,3532,229,234496,2494,478848,713344
test,3533,86,88064,352,67584,155648
test,3534,442,452608,9288,1783296,2235904
test,3535,293,300032,4082,783744,1083776
test,3536,329,336896,5146,988032,1324928
test,3537,220,225280,2301,441792,667072
test,3538,343,351232,5594,1074048,1425280
test,3539,276,282624,3622,695424,978048
test,3540,300,307200,4279,821568,1128768
test,3541,98,100352,457,87744,188096
test,3542,120,122880,685,131520,254400
test,3543,230,235520,2515,482880,718400
test,3544,447,457728,9500,1824000,2281728
test,3545,340,348160,5496,1055232,1403392
test,3546,372,380928,6579,1263168,1644096
test,3547,260,266240,3214,617088,883328
test,3548,190,194560,1717,329664,524224
test,3549,90,92160,386,74112,166272
test,3550,62,63488,183,35136,98624
test,3551,255,261120,3092,593664,854784
test,3552,431,441344,8832,1695744,2137088
test,3553,405,414720,7798,1497216,1911936
test,3554,237,242688,2671,512832,755520
test,3555,368,376832,6439,1236288,1613120
test,3556,329,336896,5146,988032,1324928
test,3557,257,263168,3140,602880,866048
test,3558,343,351232,5594,1074048,1425280
test,3559,160,163840,1217,233664,397504
test,3560,38,38912,73,14016,52928
test,3561,294,301056,4110,789120,1090176
test,3562,204,208896,1979,379968,588864
test,3563,225,230400,2407,462144,692544
test,3564,287,293888,3916,751872,1045760
test,3565,636,651264,19231,3692352,4343616
test,3566,210,215040,2097,402624,617664
test,3567,168,172032,1342,257664,429696
test,3568,111,113664,586,112512,226176
test,3569,404,413696,7760,1489920,1903616
test,3570,276,282624,3622,695424,978048
test,3571,285,291840,3862,741504,1033344
test,3572,299,306176,4251,816192,1122368
test,3573,437,447488,9079,1743168,2190656
test,3574,351,359424,5858,1124736,1484160
test,3575,146,149504,1014,194688,344192
test,3576,245,250880,2854,547968,798848
test,3577,485,496640,11183,2147136,2643776
test,3578,369,377856,6474,1243008,1620864
test,3579,119,121856,674,129408,251264
test,3580,185,189440,1628,312576,502016
test,3581,481,492544,11000,2112000,2604544
test,3582,317,324608,4778,917376,1241984
test,3583,247,252928,2901,556992,809920
test,3584,165,168960,1295,248640,417600
test,3585,386,395264,7084,1360128,1755392
test,3586,179,183296,1524,292608,475904
test,3587,454,464896,9799,1881408,2346304
test,3588,144,147456,986,189312,336768
test,3589,338,346112,5432,1042944,1389056
test,3590,199,203776,1883,361536,565312
test,3591,387,396288,7121,1367232,1763520
test,3592,450,460800,9627,1848384,2309184
test,3593,308,315392,4510,865920,1181312
test,3594,266,272384,3364,645888,918272
test,3595,292,299008,4054,778368,1077376
test,3596,166,169984,1310,251520,421504
test,3597,420,430080,8387,1610304,2040384
test,3598,184,188416,1610,309120,497536
test,3599,477,488448,10817,2076864,2565312
test,3600,166,169984,1310,251520,421504
test,3601,645,660480,19779,3797568,4458048
test,3602,276,282624,3622,695424,978048
test,3603,273,279552,3544,680448,960000
test,3604,423,433152,8507,1633344,2066496
test,3605,159,162816,1202,230784,393600
test,3606,248,253952,2924,561408,815360
test,3607,324,331776,4991,958272,1290048
test,3608,337,345088,5400,1036800,1381888
test,3609,431,441344,8832,1695744,2137088
test,3610,437,447488,9079,1743168,2190656
test,3611,171,175104,1391,267072,442176
test,3612,359,367616,6128,1176576,1544192
test,3613,314,321536,4688,900096,1221632
test,3614,269,275456,3441,660672,936128
test,3615,366,374784,6369,1222848,1597632
test,3616,165,168960,1295,248640,417600
test,3617,275,281600,3596,690432,972032
test,3618,119,121856,674,129408,251264
test,3619,292,299008,4054,778368,1077376
test,3620,113,115712,608,116736,232448
test,3621,446,456704,9457,1815744,2272448
test,3622,196,200704,1827,350784,551488
test,3623,276,282624,3622,695424,978048
test,3624,417,427008,8267,1587264,2014272
test,3625,83,84992,328,62976,147968
test,3626,176,180224,1473,282816,463040
test,3627,276,282624,3622,695424,978048
test,3628,182,186368,1575,302400,488768
test,3629,217,222208,2239,429888,652096
test,3630,426,436224,8628,1656576,2092800
test,3631,368,376832,6439,1236288,1613120
test,3632,310,317440,4569,877248,1194688
test,3633,221,226304,2322,445824,672128
test,3634,317,324608,4778,917376,1241984
test,3635,321,328704,4899,940608,1269312
test,3636,204,208896,1979,379968,588864
test,3637,190,194560,1717,329664,524224
test,3638,512,524288,12463,2392896,2917184
test,3639,377,386048,6757,1297344,1683392
test,3640,148,151552,1042,200064,351616
test,3641,229,234496,2494,478848,713344
test,3642,171,175104,1391,267072,442176
test,3643,517,529408,12708,2439936,2969344
test,3644,293,300032,4082,783744,1083776
test,3645,276,282624,3622,695424,978048
test,3646,159,162816,1202,230784,393600
test,3647,425,435200,8588,1648896,2084096
test,3648,296,303104,4166,799872,1102976
test,3649,436,446464,9038,1735296,2181760
test,3650,299,306176,4251,816192,1122368
test,3651,268,274432,3415,655680,930112
test,3652,92,94208,403,77376,171584
test,3653,358,366592,6093,1169856,1536448
test,3654,604,618496,17344,3330048,3948544
test,3655,209,214016,2077,398784,612800
test,3656,366,374784,6369,1222848,1597632
test,3657,179,183296,1524,292608,475904
test,3658,171,175104,1391,267072,442176
test,3659,266,272384,3364,645888,918272
test,3660,158,161792,1187,227904,389696
test,3661,205,209920,1998,383616,593536
test,3662,266,272384,3364,645888,918272
test,3663,312,319488,4628,888576,1208064
test,3664,160,163840,1217,233664,397504
test,3665,304,311296,4394,843648,1154944
test,3666,245,250880,2854,547968,798848
test,3667,425,435200,8588,1648896,2084096
test,3668,123,125952,720,138240,264192
test,3669,330,337920,5178,994176,1332096
test,3670,438,448512,9121,1751232,2199744
test,3671,61,62464,177,33984,96448
test,3672,229,234496,2494,478848,713344
test,3673,459,470016,10016,1923072,2393088
test,3674,456,466944,9886,1898112,2365056
test,3675,497,508928,11743,2254656,2763584
test,3676,175,179200,1456,279552,458752
test,3677,198,202752,1864,357888,560640
test,3678,219,224256,2281,437952,662208
test,3679,480,491520,10954,2103168,2594688
test,3680,372,380928,6579,1263168,1644096
test,3681,193,197632,1771,340032,537664
test,3682,360,368640,6162,1183104,1551744
test,3683,356,364544,6026,1156992,1521536
test,3684,310,317440,4569,877248,1194688
test,3685,301,308224,4308,827136,1135360
test,3686,142,145408,959,184128,329536
test,3687,256,262144,3116,598272,860416
test,3688,86,88064,352,67584,155648
test,3689,438,448512,9121,1751232,2199744
test,3690,262,268288,3264,626688,894976
test,3691,196,200704,1827,350784,551488
test,3692,310,317440,4569,877248,1194688
test,3693,258,264192,3165,607680,871872
test,3694,345,353280,5659,1086528,1439808
test,3695,124,126976,731,140352,267328
test,3696,172,176128,1407,270144,446272
test,3697,720,737280,24646,4732032,5469312
test,3698,75,76800,268,51456,128256
test,3699,220,225280,2301,441792,667072
test,3700,338,346112,5432,1042944,1389056
test,3701,238,243712,2693,517056,760768
test,3702,355,363520,5992,1150464,1513984
test,3703,186,190464,1645,315840,506304
test,3704,111,113664,586,112512,226176
test,3705,342,350208,5561,1067712,1417920
test,3706,344,352256,5626,1080192,1432448
test,3707,197,201728,1845,354240,555968
test,3708,328,335872,5115,982080,1317952
test,3709,170,174080,1374,263808,437888
test,3710,230,235520,2515,482880,718400
test,3711,323,330752,4960,952320,1283072
test,3712,259,265216,3190,612480,877696
test,3713,119,121856,674,129408,251264
test,3714,205,209920,1998,383616,593536
test,3715,573,586752,15609,2996928,3583680
test,3716,184,188416,1610,309120,497536
test,3717,300,307200,4279,821568,1128768
test,3718,231,236544,2537,487104,723648
test,3719,427,437248,8669,1664448,2101696
test,3720,352,360448,5891,1131072,1491520
test,3721,252,258048,3019,579648,837696
test,3722,556,569344,14697,2821824,3391168
test,3723,119,121856,674,129408,251264
test,3724,211,216064,2117,406464,622528
test,3725,169,173056,1358,260736,433792
test,3726,100,102400,476,91392,193792
test,3727,192,196608,1753,336576,533184
test,3728,281,287744,3754,720768,1008512
test,3729,526,538624,13154,2525568,3064192
test,3730,110,112640,576,110592,223232
test,3731,335,343040,5336,1024512,1367552
test,3732,252,258048,3019,579648,837696
test,3733,480,491520,10954,2103168,2594688
test,3734,286,292864,3889,746688,1039552
test,3735,203,207872,1960,376320,584192
test,3736,416,425984,8228,1579776,2005760
test,3737,233,238592,2581,495552,734144
test,3738,105,107520,525,100800,208320
test,3739,363,371712,6265,1202880,1574592
test,3740,295,302080,4138,794496,1096576
test,3741,278,284672,3675,705600,990272
test,3742,408,417792,7914,1519488,1937280
test,3743,148,151552,1042,200064,351616
test,3744,98,100352,457,87744,188096
test,3745,437,447488,9079,1743168,2190656
test,3746,97,99328,448,86016,185344
test,3747,153,156672,1113,213696,370368
test,3748,417,427008,8267,1587264,2014272
test,3749,177,181248,1490,286080,467328
test,3750,261,267264,3239,621888,889152
test,3751,178,182272,1507,289344,471616
test,3752,417,427008,8267,1587264,2014272
test,3753,211,216064,2117,406464,622528
test,3754,361,369664,6196,1189632,1559296
test,3755,409,418816,7953,1526976,1945792
test,3756,322,329728,4930,946560,1276288
test,3757,330,337920,5178,994176,1332096
test,3758,229,234496,2494,478848,713344
test,3759,306,313344,4452,854784,1168128
test,3760,234,239616,2604,499968,739584
test,3761,182,186368,1575,302400,488768
test,3762,257,263168,3140,602880,866048
test,3763,261,267264,3239,621888,889152
test,3764,112,114688,597,114624,229312
test,3765,228,233472,2472,474624,708096
test,3766,464,475136,10236,1965312,2440448
test,3767,265,271360,3339,641088,912448
test,3768,61,62464,183,35136,97600
test,3769,383,392192,6974,1339008,1731200
test,3770,242,247808,2785,534720,782528
test,3771,235,240640,2626,504192,744832
test,3772,120,122880,685,131520,254400
test,3773,244,249856,2831,543552,793408
test,3774,303,310272,4365,838080,1148352
test,3775,223,228352,2365,454080,682432
test,3776,261,267264,3239,621888,889152
test,3777,145,148480,1000,192000,340480
test,3778,187,191488,1663,319296,510784
test,3779,180,184320,1541,295872,480192
test,3780,297,304128,4194,805248,1109376
test,3781,94,96256,421,80832,177088
test,3782,189,193536,1699,326208,519744
test,3783,344,352256,5626,1080192,1432448
test,3784,286,292864,3889,746688,1039552
test,3785,183,187392,1593,305856,493248
test,3786,285,291840,3862,741504,1033344
test,3787,449,459776,9585,1840320,2300096
test,3788,166,169984,1310,251520,421504
test,3789,230,235520,2515,482880,718400
test,3790,96,98304,439,84288,182592
test,3791,526,538624,13154,2525568,3064192
test,3792,153,156672,1113,213696,370368
test,3793,195,199680,1808,347136,546816
test,3794,131,134144,816,156672,290816
test,3795,225,230400,2407,462144,692544
test,3796,74,75776,261,50112,125888
test,3797,217,222208,2239,429888,652096
test,3798,77,78848,282,54144,132992
test,3799,329,336896,5146,988032,1324928
test,3800,296,303104,4166,799872,1102976
test,3801,223,228352,2365,454080,682432
test,3802,95,97280,430,82560,179840
test,3803,321,328704,4899,940608,1269312
test,3804,332,339968,5241,1006272,1346240
test,3805,465,476160,10280,1973760,2449920
test,3806,191,195584,1735,333120,528704
test,3807,455,465920,9843,1889856,2355776
test,3808,452,462848,9713,1864896,2327744
test,3809,285,291840,3862,741504,1033344
test,3810,265,271360,3339,641088,912448
test,3811,330,337920,5178,994176,1332096
test,3812,272,278528,3518,675456,953984
test,3813,79,80896,297,57024,137920
test,3814,187,191488,1663,319296,510784
test,3815,183,187392,1593,305856,493248
test,3816,471,482304,10547,2025024,2507328
test,3817,182,186368,1575,302400,488768
test,3818,295,302080,4138,794496,1096576
test,3819,199,203776,1883,361536,565312
test,3820,339,347136,5464,1049088,1396224
test,3821,133,136192,841,161472,297664
test,3822,332,339968,5241,1006272,1346240
test,3823,532,544768,13456,2583552,3128320
test,3824,187,191488,1663,319296,510784
test,3825,255,261120,3092,593664,854784
test,3826,204,208896,1979,379968,588864
test,3827,436,446464,9038,1735296,2181760
test,3828,151,154624,1084,208128,362752
test,3829,236,241664,2648,508416,750080
test,3830,411,420864,8031,1541952,1962816
test,3831,396,405504,7456,1431552,1837056
test,3832,221,226304,2322,445824,672128
test,3833,379,388096,6829,1311168,1699264
test,3834,234,239616,2604,499968,739584
test,3835,268,274432,3415,655680,930112
test,3836,301,308224,4308,827136,1135360
test,3837,209,214016,2077,398784,612800
test,3838,85,87040,344,66048,153088
test,3839,342,350208,5561,1067712,1417920
test,3840,631,646144,18929,3634368,4280512
test,3841,297,304128,4194,805248,1109376
test,3842,241,246784,2762,530304,777088
test,3843,145,148480,1000,192000,340480
test,3844,205,209920,1998,383616,593536
test,3845,236,241664,2648,508416,750080
test,3846,369,377856,6474,1243008,1620864
test,3847,366,374784,6369,1222848,1597632
test,3848,228,233472,2472,474624,708096
test,3849,205,209920,1998,383616,593536
test,3850,242,247808,2785,534720,782528
test,3851,401,410624,7645,1467840,1878464
test,3852,93,95232,412,79104,174336
test,3853,373,381952,6615,1270080,1652032
test,3854,125,128000,743,142656,270656
test,3855,105,107520,525,100800,208320
test,3856,467,478208,10369,1990848,2469056
test,3857,259,265216,3190,612480,877696
test,3858,103,105472,505,96960,202432
test,3859,343,351232,5594,1074048,1425280
test,3860,121,123904,696,133632,257536
test,3861,386,395264,7084,1360128,1755392
test,3862,150,153600,1070,205440,359040
test,3863,233,238592,2581,495552,734144
test,3864,384,393216,7011,1346112,1739328
test,3865,182,186368,1575,302400,488768
test,3866,85,87040,344,66048,153088
test,3867,312,319488,4628,888576,1208064
test,3868,284,290816,3835,736320,1027136
test,3869,362,370688,6230,1196160,1566848
test,3870,320,327680,4869,934848,1262528
test,3871,418,428032,8307,1594944,2022976
test,3872,190,194560,1717,329664,524224
test,3873,299,306176,4251,816192,1122368
test,3874,441,451584,9246,1775232,2226816
test,3875,119,121856,674,129408,251264
test,3876,121,123904,696,133632,257536
test,3877,188,192512,1681,322752,515264
test,3878,106,108544,535,102720,211264
test,3879,480,491520,10954,2103168,2594688
test,3880,355,363520,5992,1150464,1513984
test,3881,338,346112,5432,1042944,1389056
test,3882,376,385024,6722,1290624,1675648
test,3883,461,472064,10104,1939968,2412032
test,3884,198,202752,1864,357888,560640
test,3885,379,388096,6829,1311168,1699264
test,3886,318,325632,4808,923136,1248768
test,3887,276,282624,3622,695424,978048
test,3888,92,94208,403,77376,171584
test,3889,364,372736,6299,1209408,1582144
test,3890,144,147456,986,189312,336768
test,3891,294,301056,4110,789120,1090176
test,3892,132,135168,829,159168,294336
test,3893,288,294912,3944,757248,1052160
test,3894,702,718848,23429,4498368,5217216
test,3895,167,171008,1326,254592,425600
test,3896,92,94208,403,77376,171584
test,3897,230,235520,2515,482880,718400
test,3898,127,130048,767,147264,277312
test,3899,253,259072,3043,584256,843328
test,3900,137,140288,893,171456,311744
test,3901,209,214016,2077,398784,612800
test,3902,174,178176,1440,276480,454656
test,3903,467,478208,10369,1990848,2469056
test,3904,395,404480,7418,1424256,1828736
test,3905,204,208896,1979,379968,588864
test,3906,229,234496,2494,478848,713344
test,3907,284,290816,3835,736320,1027136
test,3908,297,304128,4194,805248,1109376
test,3909,601,615424,17172,3297024,3912448
test,3910,671,687104,21405,4109760,4796864
test,3911,317,324608,4778,917376,1241984
test,3912,373,381952,6615,1270080,1652032
test,3913,224,229376,2386,458112,687488
test,3914,272,278528,3518,675456,953984
test,3915,290,296960,3999,767808,1064768
test,3916,492,503808,11508,2209536,2713344
test,3917,89,91136,377,72384,163520
test,3918,316,323584,4748,911616,1235200
test,3919,301,308224,4308,827136,1135360
test,3920,363,371712,6265,1202880,1574592
test,3921,397,406528,7493,1438656,1845184
test,3922,330,337920,5178,994176,1332096
test,3923,209,214016,2077,398784,612800
test,3924,409,418816,7953,1526976,1945792
test,3925,181,185344,1558,299136,484480
test,3926,250,256000,2972,570624,826624
test,3927,202,206848,1940,372480,579328
test,3928,253,259072,3043,584256,843328
test,3929,325,332800,5022,964224,1297024
test,3930,199,203776,1883,361536,565312
test,3931,498,509952,11791,2263872,2773824
test,3932,336,344064,5368,1030656,1374720
test,3933,379,388096,6829,1311168,1699264
test,3934,87,89088,360,69120,158208
test,3935,292,299008,4054,778368,1077376
test,3936,314,321536,4688,900096,1221632
test,3937,265,271360,3339,641088,912448
test,3938,207,211968,2038,391296,603264
test,3939,226,231424,2429,466368,697792
test,3940,150,153600,1070,205440,359040
test,3941,182,186368,1575,302400,488768
test,3942,276,282624,3622,695424,978048
test,3943,322,329728,4930,946560,1276288
test,3944,275,281600,3596,690432,972032
test,3945,255,261120,3092,593664,854784
test,3946,54,55296,139,26688,81984
test,3947,226,231424,2429,466368,697792
test,3948,309,316416,4540,871680,1188096
test,3949,208,212992,2057,394944,607936
test,3950,276,282624,3622,695424,978048
test,3951,446,456704,9457,1815744,2272448
test,3952,206,210944,2018,387456,598400
test,3953,215,220160,2198,422016,642176
test,3954,173,177152,1423,273216,450368
test,3955,152,155648,1099,211008,366656
test,3956,326,333824,5053,970176,1304000
test,3957,375,384000,6686,1283712,1667712
test,3958,179,183296,1524,292608,475904
test,3959,268,274432,3415,655680,930112
test,3960,377,386048,6757,1297344,1683392
test,3961,546,559104,14173,2721216,3280320
test,3962,135,138240,867,166464,304704
test,3963,312,319488,4628,888576,1208064
test,3964,306,313344,4452,854784,1168128
test,3965,92,94208,403,77376,171584
test,3966,175,179200,1456,279552,458752
test,3967,490,501760,11415,2191680,2693440
test,3968,279,285696,3701,710592,996288
test,3969,165,168960,1295,248640,417600
test,3970,401,410624,7645,1467840,1878464
test,3971,278,284672,3675,705600,990272
test,3972,493,504832,11555,2218560,2723392
test,3973,533,545792,13506,2593152,3138944
test,3974,418,428032,8307,1594944,2022976
test,3975,152,155648,1099,211008,366656
test,3976,314,321536,4688,900096,1221632
test,3977,310,317440,4569,877248,1194688
test,3978,267,273408,3390,650880,924288
test,3979,225,230400,2407,462144,692544
test,3980,564,577536,15123,2903616,3481152
test,3981,188,192512,1681,322752,515264
test,3982,290,296960,3999,767808,1064768
test,3983,284,290816,3835,736320,1027136
test,3984,138,141312,906,173952,315264
test,3985,361,369664,6196,1189632,1559296
test,3986,507,519168,12221,2346432,2865600
test,3987,250,256000,2972,570624,826624
test,3988,297,304128,4194,805248,1109376
test,3989,394,403456,7381,1417152,1820608
test,3990,221,226304,2322,445824,672128
test,3991,444,454656,9372,1799424,2254080
test,3992,567,580608,15284,2934528,3515136
test,3993,375,384000,6686,1283712,1667712
test,3994,184,188416,1610,309120,497536
test,3995,393,402432,7343,1409856,1812288
test,3996,253,259072,3043,584256,843328
test,3997,137,140288,893,171456,311744
test,3998,260,266240,3214,617088,883328
test,3999,357,365568,6059,1163328,1528896
test,4000,223,228352,2365,454080,682432
test,4001,410,419840,7992,1534464,1954304
test,4002,296,303104,4166,799872,1102976
test,4003,426,436224,8628,1656576,2092800
test,4004,332,339968,5241,1006272,1346240
test,4005,312,319488,4628,888576,1208064
test,4006,147,150528,1028,197376,347904
test,4007,432,442368,8873,1703616,2145984
test,4008,474,485376,10682,2050944,2536320
test,4009,321,328704,4899,940608,1269312
test,4010,320,327680,4869,934848,1262528
test,4011,321,328704,4899,940608,1269312
test,4012,446,456704,9457,1815744,2272448
test,4013,145,148480,1000,192000,340480
test,4014,407,416768,7876,1512192,1928960
test,4015,396,405504,7456,1431552,1837056
test,4016,214,219136,2178,418176,637312
test,4017,266,272384,3364,645888,918272
test,4018,229,234496,2494,478848,713344
test,4019,88,90112,369,70848,160960
test,4020,373,381952,6615,1270080,1652032
test,4021,340,348160,5496,1055232,1403392
test,4022,294,301056,4110,789120,1090176
test,4023,258,264192,3165,607680,871872
test,4024,311,318464,4599,883008,1201472
test,4025,201,205824,1921,368832,574656
test,4026,529,541696,13304,2554368,3096064
test,4027,115,117760,629,120768,238528
test,4028,164,167936,1279,245568,413504
test,4029,266,272384,3364,645888,918272
test,4030,307,314368,4481,860352,1174720
test,4031,245,250880,2854,547968,798848
test,4032,268,274432,3415,655680,930112
test,4033,461,472064,10104,1939968,2412032
test,4034,151,154624,1084,208128,362752
test,4035,210,215040,2097,402624,617664
test,4036,262,268288,3264,626688,894976
test,4037,158,161792,1187,227904,389696
test,4038,235,240640,2626,504192,744832
test,4039,302,309248,4336,832512,1141760
test,4040,296,303104,4166,799872,1102976
test,4041,437,447488,9079,1743168,2190656
test,4042,97,99328,448,86016,185344
