split,index,nodes,total_values_for_nodes,edges,total_values_for_edges,total_values_for_graph
train,0,22,22528,23,4416,26944
train,1,336,344064,4337,832704,1176768
train,2,11,11264,9,1728,12992
train,3,87,89088,291,55872,144960
train,4,58,59392,130,24960,84352
train,5,41,41984,68,13056,55040
train,6,653,668672,16379,3144768,3813440
train,7,44,45056,75,14400,59456
train,8,54,55296,112,21504,76800
train,9,319,326656,3909,750528,1077184
train,10,51,52224,100,19200,71424
train,11,52,53248,104,19968,73216
train,12,73,74752,205,39360,114112
train,13,203,207872,1583,303936,511808
train,14,193,197632,1431,274752,472384
train,15,41,41984,65,12480,54464
train,16,95,97280,347,66624,163904
train,17,117,119808,526,100992,220800
train,18,330,337920,4183,803136,1141056
train,19,795,814080,24277,4661184,5475264
train,20,176,180224,1190,228480,408704
train,21,271,277504,2821,541632,819136
train,22,284,290816,3098,594816,885632
train,23,55,56320,117,22464,78784
train,24,49,50176,93,17856,68032
train,25,26,26624,26,4992,31616
train,26,92,94208,326,62592,156800
train,27,18,18432,19,3648,22080
train,28,62,63488,148,28416,91904
train,29,42,43008,75,14400,57408
train,30,59,60416,139,26688,87104
train,31,433,443392,7202,1382784,1826176
train,32,27,27648,31,5952,33600
train,33,42,43008,71,13632,56640
train,34,184,188416,1301,249792,438208
train,35,71,72704,194,37248,109952
train,36,28,28672,33,6336,35008
train,37,23,23552,24,4608,28160
train,38,89,91136,305,58560,149696
train,39,415,424960,6616,1270272,1695232
train,40,28,28672,35,6720,35392
train,41,62,63488,148,28416,91904
train,42,51,52224,100,19200,71424
train,43,72,73728,200,38400,112128
train,44,47,48128,89,17088,65216
train,45,1134,1161216,42262,8114304,9275520
train,46,89,91136,305,58560,149696
train,47,85,87040,278,53376,140416
train,48,51,52224,100,19200,71424
train,49,26,26624,28,5376,32000
train,50,662,677888,16834,3232128,3910016
train,51,97,99328,362,69504,168832
train,52,158,161792,959,184128,345920
train,53,227,232448,1980,380160,612608
train,54,72,73728,200,38400,112128
train,55,347,355328,4625,888000,1243328
train,56,63,64512,153,29376,93888
train,57,62,63488,148,28416,91904
train,58,60,61440,139,26688,88128
train,59,111,113664,474,91008,204672
train,60,45,46080,78,14976,61056
train,61,94,96256,340,65280,161536
train,62,119,121856,544,104448,226304
train,63,8,8192,7,1344,9536
train,64,72,73728,200,38400,112128
train,65,198,202752,1506,289152,491904
train,66,53,54272,108,20736,75008
train,67,98,100352,369,70848,171200
train,68,167,171008,1072,205824,376832
train,69,67,68608,173,33216,101824
train,70,69,70656,183,35136,105792
train,71,22,22528,24,4608,27136
train,72,99,101376,377,72384,173760
train,73,84,86016,271,52032,138048
train,74,60,61440,139,26688,88128
train,75,16,16384,16,3072,19456
train,76,339,347136,4415,847680,1194816
train,77,25,25600,26,4992,30592
train,78,66,67584,168,32256,99840
train,79,31,31744,42,8064,39808
train,80,131,134144,660,126720,260864
train,81,68,69632,178,34176,103808
train,82,105,107520,424,81408,188928
train,83,88,90112,298,57216,147328
train,84,72,73728,200,38400,112128
train,85,75,76800,217,41664,118464
train,86,37,37888,59,11328,49216
train,87,363,371712,5062,971904,1343616
train,88,110,112640,465,89280,201920
train,89,21,21504,23,4416,25920
train,90,24,24576,24,4608,29184
train,91,12,12288,8,1536,13824
train,92,78,79872,234,44928,124800
train,93,218,223232,1826,350592,573824
train,94,49,50176,93,17856,68032
train,95,11,11264,9,1728,12992
train,96,124,126976,591,113472,240448
train,97,520,532480,10387,1994304,2526784
train,98,28,28672,35,6720,35392
train,99,60,61440,139,26688,88128
train,100,127,130048,620,119040,249088
train,101,82,83968,259,49728,133696
train,102,211,216064,1711,328512,544576
train,103,68,69632,178,34176,103808
train,104,101,103424,392,75264,178688
train,105,217,222208,1809,347328,569536
train,106,61,62464,143,27456,89920
train,107,62,63488,148,28416,91904
train,108,6,6144,6,1152,7296
train,109,43,44032,75,14400,58432
train,110,56,57344,121,23232,80576
train,111,30,30720,42,8064,38784
train,112,117,119808,526,100992,220800
train,113,22,22528,24,4608,27136
train,114,80,81920,246,47232,129152
train,115,31,31744,40,7680,39424
train,116,137,140288,721,138432,278720
train,117,242,247808,2250,432000,679808
train,118,120,122880,554,106368,229248
train,119,62,63488,148,28416,91904
train,120,624,638976,14956,2871552,3510528
train,121,95,97280,347,66624,163904
train,122,44,45056,75,14400,59456
train,123,27,27648,31,5952,33600
train,124,69,70656,183,35136,105792
train,125,115,117760,508,97536,215296
train,126,58,59392,130,24960,84352
train,127,121,123904,563,108096,232000
train,128,218,223232,1826,350592,573824
train,129,42,43008,68,13056,56064
train,130,169,173056,1097,210624,383680
train,131,41,41984,71,13632,55616
train,132,56,57344,121,23232,80576
train,133,48,49152,89,17088,66240
train,134,70,71680,189,36288,107968
train,135,97,99328,362,69504,168832
train,136,270,276480,2801,537792,814272
train,137,90,92160,312,59904,152064
train,138,194,198656,1446,277632,476288
train,139,108,110592,448,86016,196608
train,140,202,206848,1568,301056,507904
train,141,28,28672,37,7104,35776
train,142,100,102400,385,73920,176320
train,143,166,169984,1059,203328,373312
train,144,50,51200,96,18432,69632
train,145,102,104448,400,76800,181248
train,146,121,123904,563,108096,232000
train,147,252,258048,2440,468480,726528
train,148,11,11264,10,1920,13184
train,149,109,111616,457,87744,199360
train,150,238,243712,2176,417792,661504
train,151,159,162816,972,186624,349440
train,152,29,29696,33,6336,36032
train,153,37,37888,53,10176,48064
train,154,42,43008,71,13632,56640
train,155,76,77824,222,42624,120448
train,156,53,54272,108,20736,75008
train,157,78,79872,234,44928,124800
train,158,114,116736,500,96000,212736
train,159,151,154624,876,168192,322816
train,160,43,44032,75,14400,58432
train,161,13,13312,12,2304,15616
train,162,60,61440,139,26688,88128
train,163,49,50176,93,17856,68032
train,164,51,52224,100,19200,71424
train,165,645,660480,15980,3068160,3728640
train,166,75,76800,217,41664,118464
train,167,327,334848,4108,788736,1123584
train,168,225,230400,1945,373440,603840
train,169,23,23552,28,5376,28928
train,170,39,39936,62,11904,51840
train,171,169,173056,1097,210624,383680
train,172,93,95232,333,63936,159168
train,173,9,9216,8,1536,10752
train,174,38,38912,56,10752,49664
train,175,21,21504,23,4416,25920
train,176,178,182272,1217,233664,415936
train,177,295,302080,3343,641856,943936
train,178,61,62464,148,28416,90880
train,179,179,183296,1231,236352,419648
train,180,411,420864,6489,1245888,1666752
train,181,143,146432,786,150912,297344
train,182,282,288768,3055,586560,875328
train,183,379,388096,5518,1059456,1447552
train,184,50,51200,96,18432,69632
train,185,129,132096,640,122880,254976
train,186,226,231424,1962,376704,608128
train,187,27,27648,31,5952,33600
train,188,339,347136,4415,847680,1194816
train,189,235,240640,2122,407424,648064
train,190,46,47104,82,15744,62848
train,191,306,313344,3597,690624,1003968
train,192,416,425984,6648,1276416,1702400
train,193,24,24576,24,4608,29184
train,194,573,586752,12612,2421504,3008256
train,195,88,90112,298,57216,147328
train,196,117,119808,526,100992,220800
train,197,84,86016,271,52032,138048
train,198,200,204800,1537,295104,499904
train,199,123,125952,582,111744,237696
train,200,83,84992,265,50880,135872
train,201,364,372736,5090,977280,1350016
train,202,113,115712,491,94272,209984
train,203,123,125952,582,111744,237696
train,204,60,61440,139,26688,88128
train,205,228,233472,1997,383424,616896
train,206,41,41984,68,13056,55040
train,207,66,67584,168,32256,99840
train,208,121,123904,563,108096,232000
train,209,56,57344,121,23232,80576
train,210,23,23552,26,4992,28544
train,211,48,49152,89,17088,66240
train,212,71,72704,194,37248,109952
train,213,22,22528,24,4608,27136
train,214,346,354304,4599,883008,1237312
train,215,52,53248,104,19968,73216
train,216,27,27648,28,5376,33024
train,217,102,104448,400,76800,181248
train,218,117,119808,526,100992,220800
train,219,135,138240,700,134400,272640
train,220,44,45056,75,14400,59456
train,221,84,86016,271,52032,138048
train,222,102,104448,400,76800,181248
train,223,131,134144,660,126720,260864
train,224,138,141312,732,140544,281856
train,225,69,70656,183,35136,105792
train,226,51,52224,100,19200,71424
train,227,14,14336,13,2496,16832
train,228,47,48128,85,16320,64448
train,229,25,25600,31,5952,31552
train,230,96,98304,354,67968,166272
train,231,38,38912,56,10752,49664
train,232,27,27648,31,5952,33600
train,233,170,174080,1111,213312,387392
train,234,95,97280,347,66624,163904
train,235,329,336896,4158,798336,1135232
train,236,122,124928,572,109824,234752
train,237,141,144384,764,146688,291072
train,238,11,11264,9,1728,12992
train,239,67,68608,173,33216,101824
train,240,34,34816,48,9216,44032
train,241,44,45056,75,14400,59456
train,242,34,34816,50,9600,44416
train,243,763,781312,22362,4293504,5074816
train,244,100,102400,385,73920,176320
train,245,536,548864,11036,2118912,2667776
train,246,86,88064,285,54720,142784
train,247,129,132096,640,122880,254976
train,248,123,125952,582,111744,237696
train,249,70,71680,189,36288,107968
train,250,81,82944,252,48384,131328
train,251,24,24576,24,4608,29184
train,252,112,114688,482,92544,207232
train,253,32,32768,40,7680,40448
train,254,396,405504,6024,1156608,1562112
train,255,525,537600,10587,2032704,2570304
train,256,29,29696,33,6336,36032
train,257,87,89088,291,55872,144960
train,258,31,31744,37,7104,38848
train,259,78,79872,234,44928,124800
train,260,8,8192,8,1536,9728
train,261,49,50176,93,17856,68032
train,262,295,302080,3343,641856,943936
train,263,30,30720,37,7104,37824
train,264,102,104448,400,76800,181248
train,265,233,238592,2086,400512,639104
train,266,158,161792,959,184128,345920
train,267,60,61440,139,26688,88128
train,268,250,256000,2401,460992,716992
train,269,108,110592,448,86016,196608
train,270,328,335872,4133,793536,1129408
train,271,42,43008,68,13056,56064
train,272,67,68608,173,33216,101824
train,273,48,49152,89,17088,66240
train,274,110,112640,465,89280,201920
train,275,68,69632,178,34176,103808
train,276,25,25600,26,4992,30592
train,277,312,319488,3739,717888,1037376
train,278,23,23552,24,4608,28160
train,279,139,142336,743,142656,284992
train,280,40,40960,62,11904,52864
train,281,53,54272,108,20736,75008
train,282,314,321536,3788,727296,1048832
train,283,70,71680,189,36288,107968
train,284,86,88064,285,54720,142784
train,285,66,67584,168,32256,99840
train,286,140,143360,753,144576,287936
train,287,96,98304,354,67968,166272
train,288,35,35840,50,9600,45440
train,289,105,107520,424,81408,188928
train,290,68,69632,178,34176,103808
train,291,290,296960,3231,620352,917312
train,292,31,31744,37,7104,38848
train,293,110,112640,465,89280,201920
train,294,315,322560,3812,731904,1054464
train,295,24,24576,26,4992,29568
train,296,93,95232,333,63936,159168
train,297,172,176128,1137,218304,394432
train,298,72,73728,200,38400,112128
train,299,6,6144,5,960,7104
train,300,70,71680,189,36288,107968
train,301,51,52224,100,19200,71424
train,302,296,303104,3366,646272,949376
train,303,14,14336,13,2496,16832
train,304,7,7168,7,1344,8512
train,305,67,68608,178,34176,102784
train,306,50,51200,96,18432,69632
train,307,112,114688,482,92544,207232
train,308,26,26624,28,5376,32000
train,309,162,165888,1008,193536,359424
train,310,99,101376,377,72384,173760
train,311,341,349184,4467,857664,1206848
train,312,132,135168,670,128640,263808
train,313,101,103424,392,75264,178688
train,314,71,72704,194,37248,109952
train,315,6,6144,5,960,7104
train,316,29,29696,35,6720,36416
train,317,91,93184,319,61248,154432
train,318,65,66560,163,31296,97856
train,319,115,117760,508,97536,215296
train,320,24,24576,26,4992,29568
train,321,48,49152,89,17088,66240
train,322,84,86016,271,52032,138048
train,323,80,81920,246,47232,129152
train,324,211,216064,1711,328512,544576
train,325,899,920576,31044,5960448,6881024
train,326,35,35840,50,9600,45440
train,327,277,283648,2948,566016,849664
train,328,283,289792,3077,590784,880576
train,329,477,488448,8740,1678080,2166528
train,330,195,199680,1461,280512,480192
train,331,82,83968,259,49728,133696
train,332,23,23552,23,4416,27968
train,333,21,21504,24,4608,26112
train,334,82,83968,259,49728,133696
train,335,23,23552,21,4032,27584
train,336,106,108544,432,82944,191488
train,337,853,873472,27948,5366016,6239488
train,338,241,246784,2231,428352,675136
train,339,26,26624,33,6336,32960
train,340,8,8192,8,1536,9728
train,341,101,103424,392,75264,178688
train,342,140,143360,753,144576,287936
train,343,83,84992,265,50880,135872
train,344,163,166912,1021,196032,362944
train,345,133,136192,680,130560,266752
train,346,108,110592,448,86016,196608
train,347,171,175104,1124,215808,390912
train,348,30,30720,37,7104,37824
train,349,142,145408,775,148800,294208
train,350,81,82944,252,48384,131328
train,351,187,191488,1344,258048,449536
train,352,100,102400,385,73920,176320
train,353,12,12288,9,1728,14016
train,354,95,97280,347,66624,163904
train,355,96,98304,354,67968,166272
train,356,10,10240,9,1728,11968
train,357,59,60416,134,25728,86144
train,358,47,48128,85,16320,64448
train,359,149,152576,853,163776,316352
train,360,126,129024,610,117120,246144
train,361,52,53248,108,20736,73984
train,362,216,221184,1793,344256,565440
train,363,45,46080,78,14976,61056
train,364,5,5120,6,1152,6272
train,365,132,135168,670,128640,263808
train,366,611,625664,14340,2753280,3378944
train,367,105,107520,424,81408,188928
train,368,13,13312,12,2304,15616
train,369,10,10240,8,1536,11776
train,370,27,27648,28,5376,33024
train,371,349,357376,4679,898368,1255744
train,372,91,93184,319,61248,154432
train,373,122,124928,572,109824,234752
train,374,12,12288,13,2496,14784
train,375,287,293888,3164,607488,901376
train,376,37,37888,56,10752,48640
train,377,29,29696,33,6336,36032
train,378,8,8192,9,1728,9920
train,379,25,25600,28,5376,30976
train,380,24,24576,23,4416,28992
train,381,100,102400,385,73920,176320
train,382,61,62464,143,27456,89920
train,383,212,217088,1727,331584,548672
train,384,143,146432,786,150912,297344
train,385,24,24576,26,4992,29568
train,386,107,109568,440,84480,194048
train,387,96,98304,354,67968,166272
train,388,44,45056,78,14976,60032
train,389,79,80896,240,46080,126976
train,390,4,4096,3,576,4672
train,391,35,35840,48,9216,45056
train,392,202,206848,1568,301056,507904
train,393,200,204800,1537,295104,499904
train,394,105,107520,424,81408,188928
train,395,34,34816,45,8640,43456
train,396,85,87040,278,53376,140416
train,397,239,244736,2194,421248,665984
train,398,6,6144,4,768,6912
train,399,121,123904,563,108096,232000
train,400,65,66560,163,31296,97856
train,401,12,12288,9,1728,14016
train,402,95,97280,347,66624,163904
train,403,24,24576,26,4992,29568
train,404,24,24576,26,4992,29568
train,405,196,200704,1476,283392,484096
train,406,248,253952,2363,453696,707648
train,407,497,508928,9488,1821696,2330624
train,408,421,431104,6808,1307136,1738240
train,409,105,107520,424,81408,188928
train,410,113,115712,491,94272,209984
train,411,108,110592,448,86016,196608
train,412,152,155648,888,170496,326144
train,413,67,68608,173,33216,101824
train,414,69,70656,183,35136,105792
train,415,218,223232,1826,350592,573824
train,416,215,220160,1776,340992,561152
train,417,35,35840,50,9600,45440
train,418,49,50176,93,17856,68032
train,419,30,30720,35,6720,37440
train,420,54,55296,112,21504,76800
train,421,163,166912,1021,196032,362944
train,422,52,53248,104,19968,73216
train,423,114,116736,500,96000,212736
train,424,627,642048,15101,2899392,3541440
train,425,144,147456,797,153024,300480
train,426,391,400384,5873,1127616,1528000
train,427,120,122880,554,106368,229248
train,428,131,134144,660,126720,260864
train,429,81,82944,252,48384,131328
train,430,6,6144,5,960,7104
train,431,119,121856,544,104448,226304
train,432,28,28672,33,6336,35008
train,433,352,360448,4760,913920,1274368
train,434,62,63488,148,28416,91904
train,435,230,235520,2032,390144,625664
train,436,78,79872,234,44928,124800
train,437,99,101376,377,72384,173760
train,438,49,50176,93,17856,68032
train,439,103,105472,408,78336,183808
train,440,146,149504,819,157248,306752
train,441,42,43008,75,14400,57408
train,442,106,108544,432,82944,191488
train,443,146,149504,819,157248,306752
train,444,55,56320,117,22464,78784
train,445,104,106496,416,79872,186368
train,446,79,80896,240,46080,126976
train,447,64,65536,158,30336,95872
train,448,25,25600,28,5376,30976
train,449,211,216064,1711,328512,544576
train,450,107,109568,440,84480,194048
train,451,25,25600,28,5376,30976
train,452,22,22528,24,4608,27136
train,453,99,101376,392,75264,176640
train,454,128,131072,630,120960,252032
train,455,200,204800,1537,295104,499904
train,456,221,226304,1876,360192,586496
train,457,133,136192,680,130560,266752
train,458,16,16384,13,2496,18880
train,459,81,82944,252,48384,131328
train,460,117,119808,526,100992,220800
train,461,70,71680,189,36288,107968
train,462,83,84992,265,50880,135872
train,463,9,9216,7,1344,10560
train,464,28,28672,33,6336,35008
train,465,87,89088,291,55872,144960
train,466,45,46080,82,15744,61824
train,467,10,10240,7,1344,11584
train,468,85,87040,278,53376,140416
train,469,630,645120,15245,2927040,3572160
train,470,100,102400,385,73920,176320
train,471,26,26624,33,6336,32960
train,472,429,439296,7070,1357440,1796736
train,473,161,164864,996,191232,356096
train,474,56,57344,121,23232,80576
train,475,200,204800,1537,295104,499904
train,476,288,294912,3186,611712,906624
train,477,71,72704,194,37248,109952
train,478,50,51200,100,19200,70400
train,479,51,52224,100,19200,71424
train,480,485,496640,9036,1734912,2231552
train,481,290,296960,3231,620352,917312
train,482,30,30720,37,7104,37824
train,483,139,142336,743,142656,284992
train,484,99,101376,377,72384,173760
train,485,227,232448,1980,380160,612608
train,486,110,112640,465,89280,201920
train,487,58,59392,130,24960,84352
train,488,50,51200,96,18432,69632
train,489,10,10240,10,1920,12160
train,490,441,451584,7471,1434432,1886016
train,491,38,38912,56,10752,49664
train,492,51,52224,108,20736,72960
train,493,213,218112,1743,334656,552768
train,494,50,51200,100,19200,70400
train,495,126,129024,610,117120,246144
train,496,98,100352,369,70848,171200
train,497,15,15360,12,2304,17664
train,498,183,187392,1287,247104,434496
train,499,86,88064,285,54720,142784
train,500,786,804864,23730,4556160,5361024
train,501,115,117760,508,97536,215296
train,502,73,74752,205,39360,114112
train,503,113,115712,491,94272,209984
train,504,8,8192,6,1152,9344
train,505,331,338944,4209,808128,1147072
train,506,139,142336,743,142656,284992
train,507,72,73728,200,38400,112128
train,508,22,22528,24,4608,27136
train,509,120,122880,554,106368,229248
train,510,74,75776,211,40512,116288
train,511,66,67584,168,32256,99840
train,512,125,128000,601,115392,243392
train,513,161,164864,996,191232,356096
train,514,24,24576,24,4608,29184
train,515,44,45056,75,14400,59456
train,516,76,77824,222,42624,120448
train,517,25,25600,28,5376,30976
train,518,52,53248,117,22464,75712
train,519,54,55296,112,21504,76800
train,520,68,69632,178,34176,103808
train,521,35,35840,59,11328,47168
train,522,130,133120,650,124800,257920
train,523,252,258048,2440,468480,726528
train,524,81,82944,252,48384,131328
train,525,32,32768,45,8640,41408
train,526,23,23552,26,4992,28544
train,527,86,88064,285,54720,142784
train,528,116,118784,517,99264,218048
train,529,14,14336,13,2496,16832
train,530,85,87040,278,53376,140416
train,531,79,80896,240,46080,126976
train,532,23,23552,28,5376,28928
train,533,11,11264,9,1728,12992
train,534,80,81920,246,47232,129152
train,535,637,652288,15586,2992512,3644800
train,536,144,147456,797,153024,300480
train,537,115,117760,508,97536,215296
train,538,91,93184,319,61248,154432
train,539,87,89088,298,57216,146304
train,540,127,130048,620,119040,249088
train,541,79,80896,240,46080,126976
train,542,722,739328,20023,3844416,4583744
train,543,230,235520,2032,390144,625664
train,544,314,321536,3788,727296,1048832
train,545,50,51200,96,18432,69632
train,546,55,56320,117,22464,78784
train,547,73,74752,205,39360,114112
train,548,99,101376,377,72384,173760
train,549,429,439296,7070,1357440,1796736
train,550,36,36864,56,10752,47616
train,551,607,621568,14153,2717376,3338944
train,552,59,60416,134,25728,86144
train,553,270,276480,2801,537792,814272
train,554,107,109568,440,84480,194048
train,555,206,210944,1630,312960,523904
train,556,136,139264,711,136512,275776
train,557,206,210944,1630,312960,523904
train,558,65,66560,163,31296,97856
train,559,742,759808,21148,4060416,4820224
train,560,49,50176,93,17856,68032
train,561,77,78848,234,44928,123776
train,562,336,344064,4337,832704,1176768
train,563,86,88064,285,54720,142784
train,564,67,68608,178,34176,102784
train,565,110,112640,465,89280,201920
train,566,87,89088,291,55872,144960
train,567,233,238592,2086,400512,639104
train,568,96,98304,354,67968,166272
train,569,129,132096,640,122880,254976
train,570,28,28672,33,6336,35008
train,571,39,39936,59,11328,51264
train,572,77,78848,228,43776,122624
train,573,11,11264,9,1728,12992
train,574,113,115712,491,94272,209984
train,575,36,36864,53,10176,47040
train,576,6,6144,5,960,7104
train,577,34,34816,45,8640,43456
train,578,57,58368,125,24000,82368
train,579,157,160768,947,181824,342592
train,580,50,51200,96,18432,69632
train,581,33,33792,48,9216,43008
train,582,88,90112,298,57216,147328
train,583,22,22528,21,4032,26560
train,584,11,11264,12,2304,13568
train,585,128,131072,630,120960,252032
train,586,70,71680,189,36288,107968
train,587,36,36864,50,9600,46464
train,588,164,167936,1034,198528,366464
train,589,219,224256,1843,353856,578112
train,590,101,103424,392,75264,178688
train,591,67,68608,173,33216,101824
train,592,108,110592,448,86016,196608
train,593,267,273408,2739,525888,799296
train,594,15,15360,14,2688,18048
train,595,12,12288,10,1920,14208
train,596,95,97280,347,66624,163904
train,597,89,91136,305,58560,149696
train,598,45,46080,78,14976,61056
train,599,106,108544,432,82944,191488
train,600,45,46080,78,14976,61056
train,601,18,18432,17,3264,21696
train,602,4,4096,4,768,4864
train,603,348,356352,4652,893184,1249536
train,604,384,393216,5664,1087488,1480704
train,605,138,141312,732,140544,281856
train,606,55,56320,117,22464,78784
train,607,85,87040,278,53376,140416
train,608,21,21504,21,4032,25536
train,609,265,271360,2698,518016,789376
train,610,53,54272,108,20736,75008
train,611,46,47104,82,15744,62848
train,612,112,114688,482,92544,207232
train,613,50,51200,96,18432,69632
train,614,19,19456,17,3264,22720
train,615,106,108544,432,82944,191488
train,616,139,142336,743,142656,284992
train,617,161,164864,996,191232,356096
train,618,26,26624,33,6336,32960
train,619,74,75776,211,40512,116288
train,620,29,29696,35,6720,36416
train,621,49,50176,93,17856,68032
train,622,69,70656,183,35136,105792
train,623,74,75776,211,40512,116288
train,624,101,103424,392,75264,178688
train,625,91,93184,319,61248,154432
train,626,80,81920,246,47232,129152
train,627,35,35840,48,9216,45056
train,628,104,106496,416,79872,186368
train,629,82,83968,259,49728,133696
train,630,96,98304,354,67968,166272
train,631,69,70656,183,35136,105792
train,632,77,78848,228,43776,122624
train,633,70,71680,189,36288,107968
train,634,22,22528,26,4992,27520
train,635,118,120832,535,102720,223552
train,636,36,36864,53,10176,47040
train,637,230,235520,2032,390144,625664
train,638,117,119808,526,100992,220800
train,639,32,32768,45,8640,41408
train,640,177,181248,1204,231168,412416
train,641,28,28672,31,5952,34624
train,642,22,22528,24,4608,27136
train,643,47,48128,85,16320,64448
train,644,52,53248,104,19968,73216
train,645,9,9216,7,1344,10560
train,646,599,613376,13782,2646144,3259520
train,647,74,75776,217,41664,117440
train,648,26,26624,28,5376,32000
train,649,124,126976,591,113472,240448
train,650,41,41984,65,12480,54464
train,651,43,44032,71,13632,57664
train,652,23,23552,24,4608,28160
train,653,105,107520,424,81408,188928
train,654,47,48128,85,16320,64448
train,655,47,48128,85,16320,64448
train,656,22,22528,21,4032,26560
train,657,20,20480,19,3648,24128
train,658,62,63488,148,28416,91904
train,659,107,109568,440,84480,194048
train,660,36,36864,53,10176,47040
train,661,63,64512,153,29376,93888
train,662,76,77824,222,42624,120448
train,663,23,23552,26,4992,28544
train,664,117,119808,526,100992,220800
train,665,386,395264,5723,1098816,1494080
train,666,535,547840,10994,2110848,2658688
train,667,57,58368,125,24000,82368
train,668,24,24576,24,4608,29184
train,669,99,101376,377,72384,173760
train,670,35,35840,48,9216,45056
train,671,100,102400,385,73920,176320
train,672,145,148480,808,155136,303616
train,673,136,139264,711,136512,275776
train,674,9,9216,8,1536,10752
train,675,98,100352,369,70848,171200
train,676,501,513024,9641,1851072,2364096
train,677,90,92160,312,59904,152064
train,678,26,26624,26,4992,31616
train,679,46,47104,82,15744,62848
train,680,57,58368,125,24000,82368
train,681,27,27648,31,5952,33600
train,682,63,64512,153,29376,93888
train,683,24,24576,28,5376,29952
train,684,99,101376,377,72384,173760
train,685,10,10240,10,1920,12160
train,686,57,58368,125,24000,82368
train,687,55,56320,117,22464,78784
train,688,13,13312,13,2496,15808
train,689,477,488448,8740,1678080,2166528
train,690,55,56320,117,22464,78784
train,691,67,68608,173,33216,101824
train,692,72,73728,200,38400,112128
train,693,235,240640,2122,407424,648064
train,694,58,59392,130,24960,84352
train,695,188,192512,1358,260736,453248
train,696,186,190464,1329,255168,445632
train,697,52,53248,108,20736,73984
train,698,24,24576,28,5376,29952
train,699,131,134144,660,126720,260864
train,700,13,13312,10,1920,15232
train,701,84,86016,271,52032,138048
train,702,46,47104,82,15744,62848
train,703,61,62464,143,27456,89920
train,704,80,81920,246,47232,129152
train,705,450,460800,7779,1493568,1954368
train,706,27,27648,31,5952,33600
train,707,338,346112,4389,842688,1188800
train,708,110,112640,465,89280,201920
train,709,11,11264,8,1536,12800
train,710,816,835584,25576,4910592,5746176
train,711,40,40960,62,11904,52864
train,712,776,794624,23130,4440960,5235584
train,713,32,32768,40,7680,40448
train,714,121,123904,563,108096,232000
train,715,115,117760,508,97536,215296
train,716,7,7168,7,1344,8512
train,717,89,91136,305,58560,149696
train,718,118,120832,535,102720,223552
train,719,120,122880,554,106368,229248
train,720,65,66560,163,31296,97856
train,721,40,40960,62,11904,52864
train,722,42,43008,68,13056,56064
train,723,46,47104,82,15744,62848
train,724,83,84992,265,50880,135872
train,725,51,52224,100,19200,71424
train,726,30,30720,35,6720,37440
train,727,258,264192,2557,490944,755136
train,728,54,55296,112,21504,76800
train,729,22,22528,24,4608,27136
train,730,95,97280,347,66624,163904
train,731,122,124928,572,109824,234752
train,732,572,585728,12568,2413056,2998784
train,733,37,37888,53,10176,48064
train,734,79,80896,246,47232,128128
train,735,44,45056,75,14400,59456
train,736,401,410624,6177,1185984,1596608
train,737,112,114688,482,92544,207232
train,738,83,84992,265,50880,135872
train,739,207,211968,1646,316032,528000
train,740,95,97280,347,66624,163904
train,741,85,87040,278,53376,140416
train,742,141,144384,764,146688,291072
train,743,218,223232,1826,350592,573824
train,744,70,71680,189,36288,107968
train,745,209,214016,1679,322368,536384
train,746,77,78848,228,43776,122624
train,747,323,330752,4008,769536,1100288
train,748,52,53248,104,19968,73216
train,749,119,121856,544,104448,226304
train,750,92,94208,326,62592,156800
train,751,97,99328,362,69504,168832
train,752,320,327680,3934,755328,1083008
train,753,49,50176,96,18432,68608
train,754,89,91136,305,58560,149696
train,755,18,18432,16,3072,21504
train,756,57,58368,125,24000,82368
train,757,127,130048,620,119040,249088
train,758,86,88064,285,54720,142784
train,759,218,223232,1826,350592,573824
train,760,86,88064,285,54720,142784
train,761,224,229376,1928,370176,599552
train,762,108,110592,448,86016,196608
train,763,51,52224,100,19200,71424
train,764,51,52224,100,19200,71424
train,765,25,25600,24,4608,30208
train,766,640,655360,15733,3020736,3676096
train,767,49,50176,93,17856,68032
train,768,58,59392,130,24960,84352
train,769,233,238592,2086,400512,639104
train,770,115,117760,508,97536,215296
train,771,75,76800,217,41664,118464
train,772,435,445440,7269,1395648,1841088
train,773,251,257024,2420,464640,721664
train,774,109,111616,457,87744,199360
train,775,112,114688,482,92544,207232
train,776,155,158720,923,177216,335936
train,777,24,24576,26,4992,29568
train,778,4,4096,3,576,4672
train,779,9,9216,7,1344,10560
train,780,125,128000,601,115392,243392
train,781,119,121856,544,104448,226304
train,782,92,94208,326,62592,156800
train,783,93,95232,333,63936,159168
train,784,28,28672,31,5952,34624
train,785,61,62464,143,27456,89920
train,786,114,116736,500,96000,212736
train,787,106,108544,432,82944,191488
train,788,60,61440,139,26688,88128
train,789,126,129024,610,117120,246144
train,790,99,101376,377,72384,173760
train,791,235,240640,2122,407424,648064
train,792,78,79872,234,44928,124800
train,793,131,134144,660,126720,260864
train,794,208,212992,1662,319104,532096
train,795,80,81920,246,47232,129152
train,796,120,122880,554,106368,229248
train,797,96,98304,354,67968,166272
train,798,217,222208,1809,347328,569536
train,799,77,78848,228,43776,122624
train,800,70,71680,189,36288,107968
train,801,50,51200,96,18432,69632
train,802,92,94208,326,62592,156800
train,803,110,112640,465,89280,201920
train,804,50,51200,96,18432,69632
train,805,30,30720,35,6720,37440
train,806,22,22528,26,4992,27520
train,807,77,78848,228,43776,122624
train,808,70,71680,189,36288,107968
train,809,64,65536,158,30336,95872
train,810,82,83968,259,49728,133696
train,811,50,51200,96,18432,69632
train,812,6,6144,5,960,7104
train,813,143,146432,786,150912,297344
train,814,26,26624,28,5376,32000
train,815,390,399360,5843,1121856,1521216
train,816,65,66560,163,31296,97856
train,817,76,77824,222,42624,120448
train,818,6,6144,5,960,7104
train,819,50,51200,96,18432,69632
train,820,25,25600,26,4992,30592
train,821,174,178176,1163,223296,401472
train,822,11,11264,10,1920,13184
train,823,81,82944,252,48384,131328
train,824,23,23552,26,4992,28544
train,825,320,327680,3934,755328,1083008
train,826,22,22528,23,4416,26944
train,827,69,70656,183,35136,105792
train,828,63,64512,153,29376,93888
train,829,47,48128,85,16320,64448
train,830,34,34816,45,8640,43456
train,831,27,27648,33,6336,33984
train,832,72,73728,200,38400,112128
train,833,115,117760,508,97536,215296
train,834,256,262144,2518,483456,745600
train,835,118,120832,535,102720,223552
train,836,35,35840,48,9216,45056
train,837,49,50176,93,17856,68032
train,838,28,28672,33,6336,35008
train,839,131,134144,660,126720,260864
train,840,746,763904,21376,4104192,4868096
train,841,148,151552,842,161664,313216
train,842,77,78848,228,43776,122624
train,843,17,17408,14,2688,20096
train,844,54,55296,112,21504,76800
train,845,791,809984,24033,4614336,5424320
train,846,24,24576,26,4992,29568
train,847,836,856064,26845,5154240,6010304
train,848,81,82944,252,48384,131328
train,849,215,220160,1776,340992,561152
train,850,64,65536,158,30336,95872
train,851,24,24576,24,4608,29184
train,852,100,102400,385,73920,176320
train,853,192,196608,1416,271872,468480
train,854,113,115712,491,94272,209984
train,855,10,10240,9,1728,11968
train,856,57,58368,130,24960,83328
train,857,603,617472,13967,2681664,3299136
train,858,302,309248,3504,672768,982016
train,859,40,40960,62,11904,52864
train,860,86,88064,285,54720,142784
train,861,77,78848,228,43776,122624
train,862,30,30720,37,7104,37824
train,863,43,44032,71,13632,57664
train,864,96,98304,354,67968,166272
train,865,127,130048,620,119040,249088
train,866,8,8192,7,1344,9536
train,867,49,50176,93,17856,68032
train,868,73,74752,205,39360,114112
train,869,69,70656,183,35136,105792
train,870,97,99328,362,69504,168832
train,871,209,214016,1678,322176,536192
train,872,18,18432,16,3072,21504
train,873,32,32768,42,8064,40832
train,874,30,30720,40,7680,38400
train,875,41,41984,65,12480,54464
train,876,68,69632,178,34176,103808
train,877,26,26624,28,5376,32000
train,878,79,80896,240,46080,126976
train,879,399,408576,6115,1174080,1582656
train,880,6,6144,5,960,7104
train,881,221,226304,1876,360192,586496
train,882,30,30720,37,7104,37824
train,883,23,23552,28,5376,28928
train,884,116,118784,517,99264,218048
train,885,69,70656,183,35136,105792
train,886,181,185344,1259,241728,427072
train,887,44,45056,75,14400,59456
train,888,117,119808,526,100992,220800
train,889,76,77824,222,42624,120448
train,890,44,45056,75,14400,59456
train,891,76,77824,222,42624,120448
train,892,54,55296,112,21504,76800
train,893,277,283648,2948,566016,849664
train,894,242,247808,2250,432000,679808
train,895,281,287744,3033,582336,870080
train,896,284,290816,3098,594816,885632
train,897,88,90112,298,57216,147328
train,898,50,51200,100,19200,70400
train,899,81,82944,252,48384,131328
train,900,220,225280,1860,357120,582400
train,901,58,59392,134,25728,85120
train,902,216,221184,1793,344256,565440
train,903,88,90112,298,57216,147328
train,904,227,232448,1980,380160,612608
train,905,664,679936,16935,3251520,3931456
train,906,128,131072,630,120960,252032
train,907,360,368640,4978,955776,1324416
train,908,98,100352,369,70848,171200
train,909,56,57344,121,23232,80576
train,910,241,246784,2231,428352,675136
train,911,125,128000,601,115392,243392
train,912,59,60416,139,26688,87104
train,913,54,55296,112,21504,76800
train,914,124,126976,591,113472,240448
train,915,140,143360,753,144576,287936
train,916,79,80896,240,46080,126976
train,917,71,72704,194,37248,109952
train,918,361,369664,5006,961152,1330816
train,919,322,329728,3983,764736,1094464
train,920,8,8192,9,1728,9920
train,921,51,52224,108,20736,72960
train,922,113,115712,491,94272,209984
train,923,102,104448,400,76800,181248
train,924,450,460800,7779,1493568,1954368
train,925,101,103424,392,75264,178688
train,926,56,57344,121,23232,80576
train,927,28,28672,40,7680,36352
train,928,601,615424,13874,2663808,3279232
train,929,88,90112,298,57216,147328
train,930,30,30720,35,6720,37440
train,931,109,111616,457,87744,199360
train,932,250,256000,2401,460992,716992
train,933,107,109568,440,84480,194048
train,934,124,126976,591,113472,240448
train,935,104,106496,416,79872,186368
train,936,94,96256,340,65280,161536
train,937,9,9216,7,1344,10560
train,938,20,20480,24,4608,25088
train,939,58,59392,130,24960,84352
train,940,43,44032,71,13632,57664
train,941,24,24576,26,4992,29568
train,942,127,130048,620,119040,249088
train,943,54,55296,112,21504,76800
train,944,347,355328,4625,888000,1243328
train,945,195,199680,1461,280512,480192
train,946,38,38912,56,10752,49664
train,947,12,12288,9,1728,14016
train,948,161,164864,996,191232,356096
train,949,122,124928,572,109824,234752
train,950,63,64512,153,29376,93888
train,951,89,91136,305,58560,149696
train,952,11,11264,10,1920,13184
train,953,129,132096,640,122880,254976
train,954,27,27648,31,5952,33600
train,955,16,16384,17,3264,19648
train,956,66,67584,168,32256,99840
train,957,13,13312,13,2496,15808
train,958,120,122880,554,106368,229248
train,959,25,25600,28,5376,30976
train,960,109,111616,457,87744,199360
train,961,90,92160,312,59904,152064
train,962,47,48128,85,16320,64448
train,963,62,63488,153,29376,92864
train,964,225,230400,1945,373440,603840
train,965,115,117760,508,97536,215296
train,966,104,106496,416,79872,186368
train,967,19,19456,19,3648,23104
train,968,53,54272,108,20736,75008
train,969,28,28672,35,6720,35392
train,970,309,316416,3668,704256,1020672
train,971,19,19456,17,3264,22720
train,972,47,48128,93,17856,65984
train,973,96,98304,354,67968,166272
train,974,25,25600,28,5376,30976
train,975,81,82944,252,48384,131328
train,976,89,91136,305,58560,149696
train,977,9,9216,7,1344,10560
train,978,111,113664,474,91008,204672
train,979,58,59392,130,24960,84352
train,980,15,15360,12,2304,17664
train,981,58,59392,134,25728,85120
train,982,21,21504,28,5376,26880
train,983,15,15360,12,2304,17664
train,984,42,43008,68,13056,56064
train,985,366,374784,5146,988032,1362816
train,986,67,68608,173,33216,101824
train,987,362,370688,5034,966528,1337216
train,988,247,252928,2344,450048,702976
train,989,271,277504,2821,541632,819136
train,990,29,29696,33,6336,36032
train,991,61,62464,143,27456,89920
train,992,67,68608,173,33216,101824
train,993,65,66560,163,31296,97856
train,994,241,246784,2231,428352,675136
train,995,22,22528,24,4608,27136
train,996,55,56320,117,22464,78784
train,997,13,13312,10,1920,15232
train,998,26,26624,28,5376,32000
train,999,38,38912,59,11328,50240
train,1000,63,64512,153,29376,93888
train,1001,122,124928,572,109824,234752
train,1002,122,124928,572,109824,234752
train,1003,194,198656,1446,277632,476288
train,1004,170,174080,1111,213312,387392
train,1005,86,88064,291,55872,143936
train,1006,185,189440,1315,252480,441920
train,1007,71,72704,194,37248,109952
train,1008,10,10240,10,1920,12160
train,1009,122,124928,572,109824,234752
train,1010,77,78848,228,43776,122624
train,1011,520,532480,10387,1994304,2526784
train,1012,564,577536,12219,2346048,2923584
train,1013,121,123904,563,108096,232000
train,1014,95,97280,347,66624,163904
train,1015,31,31744,37,7104,38848
train,1016,102,104448,400,76800,181248
train,1017,122,124928,572,109824,234752
train,1018,11,11264,9,1728,12992
train,1019,42,43008,68,13056,56064
train,1020,185,189440,1315,252480,441920
train,1021,661,676864,16783,3222336,3899200
train,1022,16,16384,16,3072,19456
train,1023,378,387072,5489,1053888,1440960
train,1024,6,6144,4,768,6912
train,1025,50,51200,100,19200,70400
train,1026,121,123904,563,108096,232000
train,1027,74,75776,211,40512,116288
train,1028,83,84992,265,50880,135872
train,1029,136,139264,711,136512,275776
train,1030,51,52224,100,19200,71424
train,1031,23,23552,24,4608,28160
train,1032,188,192512,1358,260736,453248
train,1033,45,46080,78,14976,61056
train,1034,81,82944,252,48384,131328
train,1035,40,40960,65,12480,53440
train,1036,146,149504,819,157248,306752
train,1037,28,28672,37,7104,35776
train,1038,234,239616,2104,403968,643584
train,1039,123,125952,582,111744,237696
train,1040,14,14336,12,2304,16640
train,1041,14,14336,14,2688,17024
train,1042,76,77824,222,42624,120448
train,1043,49,50176,93,17856,68032
train,1044,121,123904,563,108096,232000
train,1045,121,123904,563,108096,232000
train,1046,50,51200,96,18432,69632
train,1047,109,111616,457,87744,199360
train,1048,102,104448,400,76800,181248
train,1049,28,28672,33,6336,35008
train,1050,109,111616,457,87744,199360
train,1051,180,184320,1245,239040,423360
train,1052,92,94208,326,62592,156800
train,1053,113,115712,491,94272,209984
train,1054,51,52224,100,19200,71424
train,1055,67,68608,178,34176,102784
train,1056,116,118784,517,99264,218048
train,1057,69,70656,194,37248,107904
train,1058,128,131072,630,120960,252032
train,1059,43,44032,71,13632,57664
train,1060,22,22528,23,4416,26944
train,1061,102,104448,400,76800,181248
train,1062,61,62464,143,27456,89920
train,1063,151,154624,876,168192,322816
train,1064,296,303104,3366,646272,949376
train,1065,30,30720,37,7104,37824
train,1066,23,23552,24,4608,28160
train,1067,552,565248,11704,2247168,2812416
train,1068,207,211968,1646,316032,528000
train,1069,67,68608,173,33216,101824
train,1070,32,32768,45,8640,41408
train,1071,25,25600,28,5376,30976
train,1072,217,222208,1809,347328,569536
train,1073,84,86016,271,52032,138048
train,1074,148,151552,842,161664,313216
train,1075,293,300032,3298,633216,933248
train,1076,7,7168,5,960,8128
train,1077,43,44032,75,14400,58432
train,1078,38,38912,56,10752,49664
train,1079,6,6144,5,960,7104
train,1080,28,28672,31,5952,34624
train,1081,22,22528,24,4608,27136
train,1082,76,77824,222,42624,120448
train,1083,78,79872,234,44928,124800
train,1084,377,386048,5460,1048320,1434368
train,1085,63,64512,153,29376,93888
train,1086,327,334848,4108,788736,1123584
train,1087,58,59392,130,24960,84352
train,1088,30,30720,35,6720,37440
train,1089,235,240640,2122,407424,648064
train,1090,47,48128,89,17088,65216
train,1091,23,23552,23,4416,27968
train,1092,146,149504,819,157248,306752
train,1093,32,32768,40,7680,40448
train,1094,64,65536,158,30336,95872
train,1095,236,241664,2140,410880,652544
train,1096,16,16384,14,2688,19072
train,1097,69,70656,183,35136,105792
train,1098,29,29696,33,6336,36032
train,1099,25,25600,26,4992,30592
train,1100,40,40960,62,11904,52864
train,1101,45,46080,82,15744,61824
train,1102,20,20480,23,4416,24896
train,1103,10,10240,9,1728,11968
train,1104,130,133120,650,124800,257920
train,1105,26,26624,28,5376,32000
train,1106,155,158720,923,177216,335936
train,1107,57,58368,125,24000,82368
train,1108,174,178176,1163,223296,401472
train,1109,86,88064,285,54720,142784
train,1110,38,38912,56,10752,49664
train,1111,32,32768,40,7680,40448
train,1112,83,84992,265,50880,135872
train,1113,76,77824,222,42624,120448
train,1114,27,27648,31,5952,33600
train,1115,286,292864,3142,603264,896128
train,1116,812,831488,25326,4862592,5694080
train,1117,13,13312,12,2304,15616
train,1118,180,184320,1245,239040,423360
train,1119,84,86016,271,52032,138048
train,1120,122,124928,572,109824,234752
train,1121,47,48128,85,16320,64448
train,1122,288,294912,3186,611712,906624
train,1123,62,63488,148,28416,91904
train,1124,708,724992,19254,3696768,4421760
train,1125,127,130048,620,119040,249088
train,1126,37,37888,53,10176,48064
train,1127,74,75776,211,40512,116288
train,1128,116,118784,517,99264,218048
train,1129,123,125952,582,111744,237696
train,1130,318,325632,3885,745920,1071552
train,1131,22,22528,21,4032,26560
train,1132,49,50176,96,18432,68608
train,1133,9,9216,9,1728,10944
train,1134,72,73728,200,38400,112128
train,1135,67,68608,173,33216,101824
train,1136,135,138240,700,134400,272640
train,1137,33,33792,42,8064,41856
train,1138,28,28672,33,6336,35008
train,1139,26,26624,26,4992,31616
train,1140,25,25600,31,5952,31552
train,1141,53,54272,108,20736,75008
train,1142,631,646144,15294,2936448,3582592
train,1143,5,5120,4,768,5888
train,1144,285,291840,3120,599040,890880
train,1145,210,215040,1694,325248,540288
train,1146,220,225280,1860,357120,582400
train,1147,98,100352,369,70848,171200
train,1148,68,69632,178,34176,103808
train,1149,52,53248,108,20736,73984
train,1150,17,17408,16,3072,20480
train,1151,116,118784,517,99264,218048
train,1152,134,137216,690,132480,269696
train,1153,358,366592,4923,945216,1311808
train,1154,113,115712,491,94272,209984
train,1155,131,134144,660,126720,260864
train,1156,161,164864,996,191232,356096
train,1157,22,22528,24,4608,27136
train,1158,67,68608,173,33216,101824
train,1159,115,117760,508,97536,215296
train,1160,75,76800,222,42624,119424
train,1161,42,43008,68,13056,56064
train,1162,364,372736,5090,977280,1350016
train,1163,48,49152,89,17088,66240
train,1164,79,80896,240,46080,126976
train,1165,116,118784,517,99264,218048
train,1166,112,114688,482,92544,207232
train,1167,36,36864,53,10176,47040
train,1168,27,27648,33,6336,33984
train,1169,36,36864,50,9600,46464
train,1170,54,55296,112,21504,76800
train,1171,159,162816,972,186624,349440
train,1172,81,82944,252,48384,131328
train,1173,145,148480,808,155136,303616
train,1174,41,41984,65,12480,54464
train,1175,92,94208,326,62592,156800
train,1176,50,51200,96,18432,69632
train,1177,83,84992,265,50880,135872
train,1178,113,115712,491,94272,209984
train,1179,48,49152,89,17088,66240
train,1180,703,719872,18983,3644736,4364608
train,1181,29,29696,33,6336,36032
train,1182,90,92160,312,59904,152064
train,1183,42,43008,68,13056,56064
train,1184,334,342016,4285,822720,1164736
train,1185,98,100352,369,70848,171200
train,1186,77,78848,228,43776,122624
train,1187,19,19456,21,4032,23488
train,1188,42,43008,71,13632,56640
train,1189,324,331776,4033,774336,1106112
train,1190,471,482304,8521,1636032,2118336
train,1191,152,155648,888,170496,326144
train,1192,6,6144,6,1152,7296
train,1193,107,109568,440,84480,194048
train,1194,89,91136,305,58560,149696
train,1195,9,9216,7,1344,10560
train,1196,216,221184,1793,344256,565440
train,1197,17,17408,13,2496,19904
train,1198,19,19456,21,4032,23488
train,1199,119,121856,544,104448,226304
train,1200,96,98304,354,67968,166272
train,1201,80,81920,246,47232,129152
train,1202,147,150528,830,159360,309888
train,1203,117,119808,526,100992,220800
train,1204,93,95232,333,63936,159168
train,1205,364,372736,5090,977280,1350016
train,1206,549,562176,11577,2222784,2784960
train,1207,46,47104,89,17088,64192
train,1208,549,562176,11577,2222784,2784960
train,1209,92,94208,326,62592,156800
train,1210,117,119808,526,100992,220800
train,1211,56,57344,121,23232,80576
train,1212,79,80896,240,46080,126976
train,1213,116,118784,517,99264,218048
train,1214,155,158720,923,177216,335936
train,1215,9,9216,7,1344,10560
train,1216,276,282624,2926,561792,844416
train,1217,45,46080,78,14976,61056
train,1218,9,9216,8,1536,10752
train,1219,9,9216,8,1536,10752
train,1220,206,210944,1630,312960,523904
train,1221,98,100352,369,70848,171200
train,1222,242,247808,2250,432000,679808
train,1223,264,270336,2678,514176,784512
train,1224,263,269312,2657,510144,779456
train,1225,47,48128,85,16320,64448
train,1226,55,56320,125,24000,80320
train,1227,323,330752,4008,769536,1100288
train,1228,111,113664,474,91008,204672
train,1229,318,325632,3885,745920,1071552
train,1230,39,39936,59,11328,51264
train,1231,334,342016,4285,822720,1164736
train,1232,220,225280,1860,357120,582400
train,1233,8,8192,7,1344,9536
train,1234,47,48128,85,16320,64448
train,1235,85,87040,278,53376,140416
train,1236,143,146432,786,150912,297344
train,1237,10,10240,9,1728,11968
train,1238,117,119808,526,100992,220800
train,1239,28,28672,35,6720,35392
train,1240,364,372736,5090,977280,1350016
train,1241,112,114688,482,92544,207232
train,1242,57,58368,125,24000,82368
train,1243,97,99328,362,69504,168832
train,1244,96,98304,354,67968,166272
train,1245,240,245760,2213,424896,670656
train,1246,118,120832,535,102720,223552
train,1247,100,102400,385,73920,176320
train,1248,782,800768,23489,4509888,5310656
train,1249,143,146432,786,150912,297344
train,1250,146,149504,819,157248,306752
train,1251,28,28672,31,5952,34624
train,1252,79,80896,246,47232,128128
train,1253,208,212992,1662,319104,532096
train,1254,24,24576,28,5376,29952
train,1255,72,73728,200,38400,112128
train,1256,152,155648,888,170496,326144
train,1257,22,22528,23,4416,26944
train,1258,56,57344,121,23232,80576
train,1259,204,208896,1599,307008,515904
train,1260,30,30720,37,7104,37824
train,1261,59,60416,134,25728,86144
train,1262,302,309248,3504,672768,982016
train,1263,31,31744,40,7680,39424
train,1264,47,48128,85,16320,64448
train,1265,107,109568,440,84480,194048
train,1266,50,51200,100,19200,70400
train,1267,75,76800,217,41664,118464
train,1268,59,60416,134,25728,86144
train,1269,47,48128,85,16320,64448
train,1270,63,64512,153,29376,93888
train,1271,172,176128,1137,218304,394432
train,1272,46,47104,82,15744,62848
train,1273,141,144384,764,146688,291072
train,1274,101,103424,392,75264,178688
train,1275,134,137216,690,132480,269696
train,1276,25,25600,26,4992,30592
train,1277,184,188416,1301,249792,438208
train,1278,379,388096,5518,1059456,1447552
train,1279,68,69632,178,34176,103808
train,1280,109,111616,457,87744,199360
train,1281,51,52224,100,19200,71424
train,1282,13,13312,12,2304,15616
train,1283,97,99328,362,69504,168832
train,1284,34,34816,48,9216,44032
train,1285,191,195584,1402,269184,464768
train,1286,48,49152,93,17856,67008
train,1287,257,263168,2537,487104,750272
train,1288,563,576512,12175,2337600,2914112
train,1289,306,313344,3597,690624,1003968
train,1290,72,73728,200,38400,112128
train,1291,42,43008,68,13056,56064
train,1292,26,26624,31,5952,32576
train,1293,144,147456,797,153024,300480
train,1294,47,48128,85,16320,64448
train,1295,50,51200,96,18432,69632
train,1296,118,120832,535,102720,223552
train,1297,29,29696,35,6720,36416
train,1298,52,53248,104,19968,73216
train,1299,10,10240,7,1344,11584
train,1300,60,61440,143,27456,88896
train,1301,164,167936,1034,198528,366464
train,1302,32,32768,40,7680,40448
train,1303,17,17408,16,3072,20480
train,1304,32,32768,40,7680,40448
train,1305,403,412672,6239,1197888,1610560
train,1306,67,68608,173,33216,101824
train,1307,322,329728,3983,764736,1094464
train,1308,66,67584,168,32256,99840
train,1309,26,26624,28,5376,32000
train,1310,35,35840,50,9600,45440
train,1311,21,21504,24,4608,26112
train,1312,779,797696,23309,4475328,5273024
train,1313,240,245760,2213,424896,670656
train,1314,23,23552,24,4608,28160
train,1315,60,61440,139,26688,88128
train,1316,69,70656,183,35136,105792
train,1317,18,18432,17,3264,21696
train,1318,131,134144,660,126720,260864
train,1319,154,157696,911,174912,332608
train,1320,229,234496,2015,386880,621376
train,1321,64,65536,163,31296,96832
train,1322,55,56320,117,22464,78784
train,1323,8,8192,8,1536,9728
train,1324,110,112640,465,89280,201920
train,1325,46,47104,82,15744,62848
train,1326,111,113664,474,91008,204672
train,1327,108,110592,448,86016,196608
train,1328,54,55296,112,21504,76800
train,1329,676,692224,17553,3370176,4062400
train,1330,227,232448,1980,380160,612608
train,1331,88,90112,298,57216,147328
train,1332,243,248832,2269,435648,684480
train,1333,5,5120,5,960,6080
train,1334,192,196608,1416,271872,468480
train,1335,120,122880,554,106368,229248
train,1336,8,8192,7,1344,9536
train,1337,259,265216,2577,494784,760000
train,1338,34,34816,48,9216,44032
train,1339,66,67584,168,32256,99840
train,1340,75,76800,217,41664,118464
train,1341,82,83968,259,49728,133696
train,1342,170,174080,1111,213312,387392
train,1343,33,33792,45,8640,42432
train,1344,85,87040,278,53376,140416
train,1345,67,68608,173,33216,101824
train,1346,51,52224,108,20736,72960
train,1347,106,108544,432,82944,191488
train,1348,28,28672,35,6720,35392
train,1349,472,483328,8558,1643136,2126464
train,1350,150,153600,865,166080,319680
train,1351,335,343040,4311,827712,1170752
train,1352,82,83968,259,49728,133696
train,1353,57,58368,125,24000,82368
train,1354,26,26624,28,5376,32000
train,1355,152,155648,888,170496,326144
train,1356,38,38912,59,11328,50240
train,1357,187,191488,1344,258048,449536
train,1358,49,50176,93,17856,68032
train,1359,210,215040,1694,325248,540288
train,1360,47,48128,85,16320,64448
train,1361,130,133120,650,124800,257920
train,1362,78,79872,234,44928,124800
train,1363,98,100352,369,70848,171200
train,1364,212,217088,1727,331584,548672
train,1365,66,67584,168,32256,99840
train,1366,125,128000,601,115392,243392
train,1367,83,84992,265,50880,135872
train,1368,318,325632,3885,745920,1071552
train,1369,56,57344,121,23232,80576
train,1370,34,34816,53,10176,44992
train,1371,605,619520,14060,2699520,3319040
train,1372,544,557056,11367,2182464,2739520
train,1373,78,79872,234,44928,124800
train,1374,48,49152,89,17088,66240
train,1375,120,122880,554,106368,229248
train,1376,101,103424,392,75264,178688
train,1377,106,108544,432,82944,191488
train,1378,82,83968,259,49728,133696
train,1379,45,46080,85,16320,62400
train,1380,64,65536,158,30336,95872
train,1381,24,24576,23,4416,28992
train,1382,35,35840,48,9216,45056
train,1383,69,70656,183,35136,105792
train,1384,10,10240,7,1344,11584
train,1385,488,499712,9148,1756416,2256128
train,1386,115,117760,508,97536,215296
train,1387,83,84992,265,50880,135872
train,1388,24,24576,28,5376,29952
train,1389,349,357376,4679,898368,1255744
train,1390,23,23552,24,4608,28160
train,1391,110,112640,465,89280,201920
train,1392,90,92160,312,59904,152064
train,1393,146,149504,819,157248,306752
train,1394,55,56320,117,22464,78784
train,1395,627,642048,15101,2899392,3541440
train,1396,48,49152,89,17088,66240
train,1397,300,307200,3457,663744,970944
train,1398,24,24576,24,4608,29184
train,1399,196,200704,1476,283392,484096
train,1400,90,92160,312,59904,152064
train,1401,37,37888,53,10176,48064
train,1402,261,267264,2617,502464,769728
train,1403,22,22528,26,4992,27520
train,1404,9,9216,8,1536,10752
train,1405,111,113664,474,91008,204672
train,1406,105,107520,424,81408,188928
train,1407,35,35840,50,9600,45440
train,1408,60,61440,139,26688,88128
train,1409,249,254976,2382,457344,712320
train,1410,65,66560,163,31296,97856
train,1411,111,113664,474,91008,204672
train,1412,400,409600,6146,1180032,1589632
train,1413,38,38912,56,10752,49664
train,1414,924,946176,32794,6296448,7242624
train,1415,85,87040,278,53376,140416
train,1416,220,225280,1860,357120,582400
train,1417,896,917504,30837,5920704,6838208
train,1418,24,24576,26,4992,29568
train,1419,86,88064,285,54720,142784
train,1420,40,40960,62,11904,52864
train,1421,68,69632,178,34176,103808
train,1422,117,119808,526,100992,220800
train,1423,67,68608,173,33216,101824
train,1424,50,51200,96,18432,69632
train,1425,117,119808,526,100992,220800
train,1426,212,217088,1727,331584,548672
train,1427,56,57344,121,23232,80576
train,1428,247,252928,2344,450048,702976
train,1429,72,73728,200,38400,112128
train,1430,59,60416,134,25728,86144
train,1431,98,100352,369,70848,171200
train,1432,180,184320,1245,239040,423360
train,1433,110,112640,465,89280,201920
train,1434,54,55296,112,21504,76800
train,1435,119,121856,544,104448,226304
train,1436,131,134144,660,126720,260864
train,1437,53,54272,112,21504,75776
train,1438,47,48128,85,16320,64448
train,1439,76,77824,222,42624,120448
train,1440,790,808960,23972,4602624,5411584
train,1441,83,84992,278,53376,138368
train,1442,309,316416,3668,704256,1020672
train,1443,14,14336,13,2496,16832
train,1444,44,45056,75,14400,59456
train,1445,42,43008,68,13056,56064
train,1446,92,94208,326,62592,156800
train,1447,101,103424,392,75264,178688
train,1448,27,27648,33,6336,33984
train,1449,404,413696,6270,1203840,1617536
train,1450,144,147456,797,153024,300480
train,1451,151,154624,876,168192,322816
train,1452,113,115712,491,94272,209984
train,1453,63,64512,153,29376,93888
train,1454,33,33792,42,8064,41856
train,1455,122,124928,572,109824,234752
train,1456,78,79872,234,44928,124800
train,1457,43,44032,71,13632,57664
train,1458,205,209920,1615,310080,520000
train,1459,43,44032,75,14400,58432
train,1460,40,40960,62,11904,52864
train,1461,151,154624,876,168192,322816
train,1462,54,55296,117,22464,77760
train,1463,57,58368,125,24000,82368
train,1464,127,130048,620,119040,249088
train,1465,23,23552,21,4032,27584
train,1466,72,73728,200,38400,112128
train,1467,36,36864,56,10752,47616
train,1468,331,338944,4209,808128,1147072
train,1469,80,81920,246,47232,129152
train,1470,53,54272,108,20736,75008
train,1471,90,92160,312,59904,152064
train,1472,130,133120,650,124800,257920
train,1473,366,374784,5146,988032,1362816
train,1474,108,110592,448,86016,196608
train,1475,635,650240,15488,2973696,3623936
train,1476,32,32768,40,7680,40448
train,1477,160,163840,984,188928,352768
train,1478,56,57344,121,23232,80576
train,1479,256,262144,2518,483456,745600
train,1480,89,91136,305,58560,149696
train,1481,20,20480,19,3648,24128
train,1482,199,203776,1522,292224,496000
train,1483,4,4096,4,768,4864
train,1484,624,638976,14956,2871552,3510528
train,1485,226,231424,1962,376704,608128
train,1486,3,3072,3,576,3648
train,1487,10,10240,9,1728,11968
train,1488,39,39936,65,12480,52416
train,1489,77,78848,228,43776,122624
train,1490,54,55296,112,21504,76800
train,1491,41,41984,65,12480,54464
train,1492,118,120832,535,102720,223552
train,1493,62,63488,148,28416,91904
train,1494,78,79872,234,44928,124800
train,1495,73,74752,205,39360,114112
train,1496,39,39936,62,11904,51840
train,1497,496,507904,9450,1814400,2322304
train,1498,109,111616,457,87744,199360
train,1499,37,37888,56,10752,48640
train,1500,103,105472,408,78336,183808
train,1501,14,14336,13,2496,16832
train,1502,46,47104,82,15744,62848
train,1503,51,52224,100,19200,71424
train,1504,175,179200,1177,225984,405184
train,1505,78,79872,234,44928,124800
train,1506,86,88064,285,54720,142784
train,1507,276,282624,2926,561792,844416
train,1508,53,54272,108,20736,75008
train,1509,101,103424,392,75264,178688
train,1510,837,857088,26909,5166528,6023616
train,1511,232,237568,2068,397056,634624
train,1512,109,111616,457,87744,199360
train,1513,63,64512,153,29376,93888
train,1514,41,41984,68,13056,55040
train,1515,113,115712,491,94272,209984
train,1516,46,47104,82,15744,62848
train,1517,100,102400,385,73920,176320
train,1518,567,580608,12349,2371008,2951616
train,1519,561,574464,12089,2321088,2895552
train,1520,41,41984,71,13632,55616
train,1521,227,232448,1980,380160,612608
train,1522,484,495616,8998,1727616,2223232
train,1523,66,67584,168,32256,99840
train,1524,147,150528,830,159360,309888
train,1525,280,286720,3012,578304,865024
train,1526,25,25600,31,5952,31552
train,1527,37,37888,62,11904,49792
train,1528,88,90112,298,57216,147328
train,1529,105,107520,424,81408,188928
train,1530,183,187392,1287,247104,434496
train,1531,286,292864,3142,603264,896128
train,1532,180,184320,1245,239040,423360
train,1533,56,57344,121,23232,80576
train,1534,108,110592,448,86016,196608
train,1535,58,59392,130,24960,84352
train,1536,84,86016,271,52032,138048
train,1537,290,296960,3231,620352,917312
train,1538,25,25600,31,5952,31552
train,1539,158,161792,959,184128,345920
train,1540,28,28672,31,5952,34624
train,1541,60,61440,139,26688,88128
train,1542,9,9216,7,1344,10560
train,1543,64,65536,158,30336,95872
train,1544,211,216064,1711,328512,544576
train,1545,196,200704,1476,283392,484096
train,1546,27,27648,31,5952,33600
train,1547,131,134144,660,126720,260864
train,1548,36,36864,50,9600,46464
train,1549,100,102400,385,73920,176320
train,1550,9,9216,7,1344,10560
train,1551,106,108544,432,82944,191488
train,1552,100,102400,385,73920,176320
train,1553,81,82944,252,48384,131328
train,1554,96,98304,354,67968,166272
train,1555,444,454656,7572,1453824,1908480
train,1556,40,40960,62,11904,52864
train,1557,80,81920,246,47232,129152
train,1558,48,49152,96,18432,67584
train,1559,101,103424,392,75264,178688
train,1560,87,89088,291,55872,144960
train,1561,107,109568,440,84480,194048
train,1562,21,21504,23,4416,25920
train,1563,534,546816,10953,2102976,2649792
train,1564,9,9216,7,1344,10560
train,1565,143,146432,786,150912,297344
train,1566,427,437248,7004,1344768,1782016
train,1567,197,201728,1491,286272,488000
train,1568,12,12288,13,2496,14784
train,1569,73,74752,205,39360,114112
train,1570,60,61440,139,26688,88128
train,1571,11,11264,9,1728,12992
train,1572,200,204800,1537,295104,499904
train,1573,50,51200,96,18432,69632
train,1574,122,124928,572,109824,234752
train,1575,128,131072,630,120960,252032
train,1576,61,62464,143,27456,89920
train,1577,332,339968,4234,812928,1152896
train,1578,251,257024,2420,464640,721664
train,1579,105,107520,424,81408,188928
train,1580,99,101376,377,72384,173760
train,1581,197,201728,1491,286272,488000
train,1582,9,9216,10,1920,11136
train,1583,113,115712,491,94272,209984
train,1584,48,49152,89,17088,66240
train,1585,54,55296,112,21504,76800
train,1586,100,102400,385,73920,176320
train,1587,254,260096,2479,475968,736064
train,1588,119,121856,544,104448,226304
train,1589,111,113664,474,91008,204672
train,1590,57,58368,125,24000,82368
train,1591,305,312320,3574,686208,998528
train,1592,96,98304,354,67968,166272
train,1593,177,181248,1204,231168,412416
train,1594,7,7168,6,1152,8320
train,1595,180,184320,1245,239040,423360
train,1596,44,45056,85,16320,61376
train,1597,53,54272,108,20736,75008
train,1598,65,66560,163,31296,97856
train,1599,147,150528,830,159360,309888
train,1600,108,110592,448,86016,196608
train,1601,334,342016,4285,822720,1164736
train,1602,187,191488,1344,258048,449536
train,1603,112,114688,482,92544,207232
train,1604,61,62464,143,27456,89920
train,1605,84,86016,271,52032,138048
train,1606,387,396288,5753,1104576,1500864
train,1607,51,52224,100,19200,71424
train,1608,60,61440,139,26688,88128
train,1609,91,93184,319,61248,154432
train,1610,67,68608,173,33216,101824
train,1611,267,273408,2739,525888,799296
train,1612,68,69632,178,34176,103808
train,1613,65,66560,163,31296,97856
train,1614,105,107520,424,81408,188928
train,1615,85,87040,278,53376,140416
train,1616,57,58368,125,24000,82368
train,1617,12,12288,13,2496,14784
train,1618,30,30720,35,6720,37440
train,1619,25,25600,26,4992,30592
train,1620,110,112640,465,89280,201920
train,1621,371,379904,5287,1015104,1395008
train,1622,27,27648,31,5952,33600
train,1623,329,336896,4158,798336,1135232
train,1624,14,14336,12,2304,16640
train,1625,95,97280,347,66624,163904
train,1626,91,93184,319,61248,154432
train,1627,44,45056,75,14400,59456
train,1628,271,277504,2821,541632,819136
train,1629,126,129024,610,117120,246144
train,1630,7,7168,7,1344,8512
train,1631,138,141312,732,140544,281856
train,1632,78,79872,234,44928,124800
train,1633,193,197632,1431,274752,472384
train,1634,74,75776,211,40512,116288
train,1635,126,129024,610,117120,246144
train,1636,55,56320,117,22464,78784
train,1637,134,137216,690,132480,269696
train,1638,25,25600,24,4608,30208
train,1639,160,163840,984,188928,352768
train,1640,93,95232,333,63936,159168
train,1641,143,146432,786,150912,297344
train,1642,124,126976,591,113472,240448
train,1643,147,150528,830,159360,309888
train,1644,108,110592,448,86016,196608
train,1645,71,72704,194,37248,109952
train,1646,7,7168,8,1536,8704
train,1647,79,80896,240,46080,126976
train,1648,73,74752,205,39360,114112
train,1649,116,118784,517,99264,218048
train,1650,79,80896,240,46080,126976
train,1651,121,123904,563,108096,232000
train,1652,25,25600,28,5376,30976
train,1653,99,101376,377,72384,173760
train,1654,104,106496,416,79872,186368
train,1655,74,75776,211,40512,116288
train,1656,659,674816,16681,3202752,3877568
train,1657,51,52224,100,19200,71424
train,1658,129,132096,640,122880,254976
train,1659,166,169984,1059,203328,373312
train,1660,385,394240,5694,1093248,1487488
train,1661,41,41984,65,12480,54464
train,1662,132,135168,670,128640,263808
train,1663,22,22528,23,4416,26944
train,1664,64,65536,163,31296,96832
train,1665,349,357376,4679,898368,1255744
train,1666,25,25600,28,5376,30976
train,1667,11,11264,10,1920,13184
train,1668,141,144384,764,146688,291072
train,1669,83,84992,265,50880,135872
train,1670,113,115712,491,94272,209984
train,1671,56,57344,121,23232,80576
train,1672,64,65536,158,30336,95872
train,1673,56,57344,121,23232,80576
train,1674,484,495616,8998,1727616,2223232
train,1675,18,18432,16,3072,21504
train,1676,148,151552,842,161664,313216
train,1677,135,138240,700,134400,272640
train,1678,460,471040,8128,1560576,2031616
train,1679,51,52224,100,19200,71424
train,1680,78,79872,234,44928,124800
train,1681,448,458752,7710,1480320,1939072
train,1682,27,27648,31,5952,33600
train,1683,23,23552,23,4416,27968
train,1684,90,92160,312,59904,152064
train,1685,38,38912,59,11328,50240
train,1686,25,25600,31,5952,31552
train,1687,63,64512,153,29376,93888
train,1688,107,109568,440,84480,194048
train,1689,88,90112,298,57216,147328
train,1690,124,126976,591,113472,240448
train,1691,55,56320,117,22464,78784
train,1692,88,90112,298,57216,147328
train,1693,14,14336,12,2304,16640
train,1694,217,222208,1809,347328,569536
train,1695,33,33792,42,8064,41856
train,1696,100,102400,385,73920,176320
train,1697,105,107520,424,81408,188928
train,1698,42,43008,68,13056,56064
train,1699,313,320512,3763,722496,1043008
train,1700,246,251904,2325,446400,698304
train,1701,218,223232,1826,350592,573824
train,1702,118,120832,535,102720,223552
train,1703,8,8192,7,1344,9536
train,1704,21,21504,21,4032,25536
train,1705,11,11264,9,1728,12992
train,1706,23,23552,26,4992,28544
train,1707,337,345088,4363,837696,1182784
train,1708,7,7168,6,1152,8320
train,1709,792,811008,24094,4626048,5437056
train,1710,59,60416,134,25728,86144
train,1711,85,87040,278,53376,140416
train,1712,82,83968,259,49728,133696
train,1713,122,124928,572,109824,234752
train,1714,125,128000,601,115392,243392
train,1715,112,114688,482,92544,207232
train,1716,177,181248,1204,231168,412416
train,1717,9,9216,9,1728,10944
train,1718,198,202752,1506,289152,491904
train,1719,57,58368,125,24000,82368
train,1720,22,22528,21,4032,26560
train,1721,37,37888,53,10176,48064
train,1722,181,185344,1259,241728,427072
train,1723,89,91136,305,58560,149696
train,1724,336,344064,4337,832704,1176768
train,1725,31,31744,40,7680,39424
train,1726,207,211968,1646,316032,528000
train,1727,205,209920,1615,310080,520000
train,1728,61,62464,143,27456,89920
train,1729,168,172032,1085,208320,380352
train,1730,75,76800,217,41664,118464
train,1731,111,113664,474,91008,204672
train,1732,124,126976,591,113472,240448
train,1733,116,118784,517,99264,218048
train,1734,21,21504,23,4416,25920
train,1735,73,74752,205,39360,114112
train,1736,196,200704,1476,283392,484096
train,1737,298,305152,3411,654912,960064
train,1738,14,14336,13,2496,16832
train,1739,84,86016,271,52032,138048
train,1740,61,62464,143,27456,89920
train,1741,115,117760,508,97536,215296
train,1742,105,107520,424,81408,188928
train,1743,135,138240,700,134400,272640
train,1744,303,310272,3527,677184,987456
train,1745,65,66560,163,31296,97856
train,1746,152,155648,888,170496,326144
train,1747,86,88064,285,54720,142784
train,1748,120,122880,554,106368,229248
train,1749,76,77824,222,42624,120448
train,1750,232,237568,2068,397056,634624
train,1751,7,7168,6,1152,8320
train,1752,92,94208,326,62592,156800
train,1753,21,21504,21,4032,25536
train,1754,141,144384,764,146688,291072
train,1755,45,46080,82,15744,61824
train,1756,48,49152,89,17088,66240
train,1757,38,38912,65,12480,51392
train,1758,213,218112,1743,334656,552768
train,1759,29,29696,35,6720,36416
train,1760,94,96256,340,65280,161536
train,1761,49,50176,93,17856,68032
train,1762,108,110592,448,86016,196608
train,1763,48,49152,89,17088,66240
train,1764,55,56320,125,24000,80320
train,1765,74,75776,211,40512,116288
train,1766,21,21504,23,4416,25920
train,1767,71,72704,194,37248,109952
train,1768,159,162816,972,186624,349440
train,1769,59,60416,134,25728,86144
train,1770,287,293888,3164,607488,901376
train,1771,396,405504,6024,1156608,1562112
train,1772,35,35840,48,9216,45056
train,1773,77,78848,228,43776,122624
train,1774,289,295936,3209,616128,912064
train,1775,9,9216,8,1536,10752
train,1776,24,24576,24,4608,29184
train,1777,65,66560,163,31296,97856
train,1778,53,54272,108,20736,75008
train,1779,100,102400,385,73920,176320
train,1780,132,135168,670,128640,263808
train,1781,703,719872,18983,3644736,4364608
train,1782,95,97280,347,66624,163904
train,1783,107,109568,440,84480,194048
train,1784,42,43008,68,13056,56064
train,1785,90,92160,312,59904,152064
train,1786,104,106496,416,79872,186368
train,1787,55,56320,117,22464,78784
train,1788,36,36864,50,9600,46464
train,1789,219,224256,1843,353856,578112
train,1790,461,472064,8163,1567296,2039360
train,1791,81,82944,252,48384,131328
train,1792,172,176128,1137,218304,394432
train,1793,53,54272,108,20736,75008
train,1794,100,102400,385,73920,176320
train,1795,246,251904,2325,446400,698304
train,1796,105,107520,424,81408,188928
train,1797,58,59392,130,24960,84352
train,1798,208,212992,1662,319104,532096
train,1799,27,27648,31,5952,33600
train,1800,314,321536,3788,727296,1048832
train,1801,24,24576,24,4608,29184
train,1802,116,118784,517,99264,218048
train,1803,46,47104,82,15744,62848
train,1804,136,139264,711,136512,275776
train,1805,218,223232,1826,350592,573824
train,1806,21,21504,24,4608,26112
train,1807,47,48128,85,16320,64448
train,1808,81,82944,252,48384,131328
train,1809,84,86016,271,52032,138048
train,1810,114,116736,500,96000,212736
train,1811,212,217088,1727,331584,548672
train,1812,89,91136,305,58560,149696
train,1813,207,211968,1646,316032,528000
train,1814,12,12288,8,1536,13824
train,1815,10,10240,10,1920,12160
train,1816,110,112640,465,89280,201920
train,1817,452,462848,7848,1506816,1969664
train,1818,357,365568,4896,940032,1305600
train,1819,103,105472,408,78336,183808
train,1820,185,189440,1315,252480,441920
train,1821,81,82944,252,48384,131328
train,1822,114,116736,500,96000,212736
train,1823,23,23552,26,4992,28544
train,1824,188,192512,1358,260736,453248
train,1825,28,28672,33,6336,35008
train,1826,17,17408,16,3072,20480
train,1827,55,56320,117,22464,78784
train,1828,60,61440,139,26688,88128
train,1829,34,34816,45,8640,43456
train,1830,118,120832,535,102720,223552
train,1831,26,26624,33,6336,32960
train,1832,64,65536,158,30336,95872
train,1833,658,673792,16631,3193152,3866944
train,1834,240,245760,2213,424896,670656
train,1835,174,178176,1163,223296,401472
train,1836,92,94208,326,62592,156800
train,1837,328,335872,4133,793536,1129408
train,1838,58,59392,130,24960,84352
train,1839,133,136192,680,130560,266752
train,1840,617,631808,14623,2807616,3439424
train,1841,31,31744,37,7104,38848
train,1842,403,412672,6239,1197888,1610560
train,1843,12,12288,10,1920,14208
train,1844,76,77824,222,42624,120448
train,1845,197,201728,1491,286272,488000
train,1846,23,23552,26,4992,28544
train,1847,77,78848,228,43776,122624
train,1848,135,138240,700,134400,272640
train,1849,807,826368,25015,4802880,5629248
train,1850,233,238592,2086,400512,639104
train,1851,616,630784,14575,2798400,3429184
train,1852,847,867328,27556,5290752,6158080
train,1853,32,32768,40,7680,40448
train,1854,151,154624,876,168192,322816
train,1855,121,123904,563,108096,232000
train,1856,80,81920,246,47232,129152
train,1857,46,47104,82,15744,62848
train,1858,31,31744,37,7104,38848
train,1859,31,31744,37,7104,38848
train,1860,76,77824,222,42624,120448
train,1861,27,27648,35,6720,34368
train,1862,60,61440,139,26688,88128
train,1863,11,11264,10,1920,13184
train,1864,14,14336,10,1920,16256
train,1865,73,74752,205,39360,114112
train,1866,40,40960,65,12480,53440
train,1867,11,11264,9,1728,12992
train,1868,150,153600,865,166080,319680
train,1869,805,824320,24891,4779072,5603392
train,1870,25,25600,26,4992,30592
train,1871,97,99328,362,69504,168832
train,1872,93,95232,333,63936,159168
train,1873,81,82944,252,48384,131328
train,1874,13,13312,10,1920,15232
train,1875,435,445440,7269,1395648,1841088
train,1876,22,22528,26,4992,27520
train,1877,475,486400,8667,1664064,2150464
train,1878,412,421888,6520,1251840,1673728
train,1879,22,22528,26,4992,27520
train,1880,142,145408,775,148800,294208
train,1881,127,130048,620,119040,249088
train,1882,104,106496,416,79872,186368
train,1883,183,187392,1287,247104,434496
train,1884,22,22528,23,4416,26944
train,1885,11,11264,12,2304,13568
train,1886,65,66560,163,31296,97856
train,1887,12,12288,10,1920,14208
train,1888,18,18432,19,3648,22080
train,1889,93,95232,333,63936,159168
train,1890,141,144384,764,146688,291072
train,1891,60,61440,139,26688,88128
train,1892,288,294912,3186,611712,906624
train,1893,50,51200,100,19200,70400
train,1894,26,26624,31,5952,32576
train,1895,56,57344,130,24960,82304
train,1896,28,28672,33,6336,35008
train,1897,115,117760,508,97536,215296
train,1898,94,96256,340,65280,161536
train,1899,191,195584,1402,269184,464768
train,1900,64,65536,168,32256,97792
train,1901,182,186368,1273,244416,430784
train,1902,151,154624,876,168192,322816
train,1903,91,93184,319,61248,154432
train,1904,27,27648,28,5376,33024
train,1905,17,17408,16,3072,20480
train,1906,91,93184,319,61248,154432
train,1907,30,30720,35,6720,37440
train,1908,27,27648,35,6720,34368
train,1909,152,155648,888,170496,326144
train,1910,80,81920,246,47232,129152
train,1911,95,97280,347,66624,163904
train,1912,55,56320,117,22464,78784
train,1913,54,55296,112,21504,76800
train,1914,60,61440,139,26688,88128
train,1915,109,111616,457,87744,199360
train,1916,102,104448,400,76800,181248
train,1917,41,41984,65,12480,54464
train,1918,35,35840,48,9216,45056
train,1919,62,63488,148,28416,91904
train,1920,298,305152,3411,654912,960064
train,1921,219,224256,1843,353856,578112
train,1922,28,28672,35,6720,35392
train,1923,221,226304,1876,360192,586496
train,1924,333,340992,4260,817920,1158912
train,1925,230,235520,2032,390144,625664
train,1926,38,38912,62,11904,50816
train,1927,478,489472,8777,1685184,2174656
train,1928,42,43008,68,13056,56064
train,1929,209,214016,1678,322176,536192
train,1930,189,193536,1373,263616,457152
train,1931,119,121856,544,104448,226304
train,1932,173,177152,1150,220800,397952
train,1933,218,223232,1826,350592,573824
train,1934,105,107520,424,81408,188928
train,1935,129,132096,640,122880,254976
train,1936,30,30720,40,7680,38400
train,1937,68,69632,183,35136,104768
train,1938,128,131072,630,120960,252032
train,1939,56,57344,121,23232,80576
train,1940,131,134144,660,126720,260864
train,1941,281,287744,3033,582336,870080
train,1942,147,150528,830,159360,309888
train,1943,13,13312,9,1728,15040
train,1944,33,33792,42,8064,41856
train,1945,58,59392,130,24960,84352
train,1946,99,101376,377,72384,173760
train,1947,18,18432,17,3264,21696
train,1948,54,55296,112,21504,76800
train,1949,80,81920,246,47232,129152
train,1950,66,67584,173,33216,100800
train,1951,113,115712,491,94272,209984
train,1952,28,28672,33,6336,35008
train,1953,44,45056,78,14976,60032
train,1954,14,14336,13,2496,16832
train,1955,95,97280,347,66624,163904
train,1956,417,427008,6680,1282560,1709568
train,1957,216,221184,1793,344256,565440
train,1958,348,356352,4652,893184,1249536
train,1959,132,135168,670,128640,263808
train,1960,24,24576,26,4992,29568
train,1961,52,53248,104,19968,73216
train,1962,222,227328,1893,363456,590784
train,1963,252,258048,2440,468480,726528
train,1964,68,69632,178,34176,103808
train,1965,18,18432,14,2688,21120
train,1966,61,62464,143,27456,89920
train,1967,56,57344,121,23232,80576
train,1968,126,129024,610,117120,246144
train,1969,39,39936,62,11904,51840
train,1970,29,29696,33,6336,36032
train,1971,227,232448,1980,380160,612608
train,1972,163,166912,1021,196032,362944
train,1973,102,104448,400,76800,181248
train,1974,746,763904,21376,4104192,4868096
train,1975,172,176128,1137,218304,394432
train,1976,50,51200,96,18432,69632
train,1977,72,73728,200,38400,112128
train,1978,61,62464,143,27456,89920
train,1979,27,27648,33,6336,33984
train,1980,113,115712,491,94272,209984
train,1981,56,57344,121,23232,80576
train,1982,41,41984,71,13632,55616
train,1983,63,64512,153,29376,93888
train,1984,12,12288,10,1920,14208
train,1985,124,126976,591,113472,240448
train,1986,23,23552,23,4416,27968
train,1987,124,126976,591,113472,240448
train,1988,27,27648,31,5952,33600
train,1989,138,141312,732,140544,281856
train,1990,26,26624,28,5376,32000
train,1991,154,157696,911,174912,332608
train,1992,124,126976,591,113472,240448
train,1993,141,144384,764,146688,291072
train,1994,57,58368,125,24000,82368
train,1995,245,250880,2306,442752,693632
train,1996,267,273408,2739,525888,799296
train,1997,81,82944,252,48384,131328
train,1998,60,61440,139,26688,88128
train,1999,208,212992,1662,319104,532096
train,2000,9,9216,7,1344,10560
train,2001,40,40960,62,11904,52864
train,2002,130,133120,650,124800,257920
train,2003,9,9216,8,1536,10752
train,2004,220,225280,1860,357120,582400
train,2005,122,124928,572,109824,234752
train,2006,133,136192,680,130560,266752
train,2007,5,5120,4,768,5888
train,2008,139,142336,743,142656,284992
train,2009,46,47104,89,17088,64192
train,2010,137,140288,721,138432,278720
train,2011,106,108544,432,82944,191488
train,2012,197,201728,1491,286272,488000
train,2013,234,239616,2104,403968,643584
train,2014,116,118784,517,99264,218048
train,2015,227,232448,1980,380160,612608
train,2016,43,44032,71,13632,57664
train,2017,275,281600,2905,557760,839360
train,2018,90,92160,312,59904,152064
train,2019,349,357376,4679,898368,1255744
train,2020,49,50176,93,17856,68032
train,2021,89,91136,305,58560,149696
train,2022,29,29696,35,6720,36416
train,2023,87,89088,291,55872,144960
train,2024,73,74752,205,39360,114112
train,2025,104,106496,416,79872,186368
train,2026,42,43008,68,13056,56064
train,2027,100,102400,385,73920,176320
train,2028,23,23552,26,4992,28544
train,2029,135,138240,700,134400,272640
train,2030,221,226304,1876,360192,586496
train,2031,67,68608,173,33216,101824
train,2032,31,31744,40,7680,39424
train,2033,189,193536,1373,263616,457152
train,2034,331,338944,4209,808128,1147072
train,2035,146,149504,819,157248,306752
train,2036,13,13312,14,2688,16000
train,2037,394,403456,5963,1144896,1548352
train,2038,133,136192,680,130560,266752
train,2039,55,56320,117,22464,78784
train,2040,212,217088,1727,331584,548672
train,2041,15,15360,14,2688,18048
train,2042,56,57344,121,23232,80576
train,2043,72,73728,200,38400,112128
train,2044,82,83968,259,49728,133696
train,2045,77,78848,228,43776,122624
train,2046,81,82944,252,48384,131328
train,2047,30,30720,37,7104,37824
train,2048,117,119808,526,100992,220800
train,2049,75,76800,217,41664,118464
train,2050,10,10240,12,2304,12544
train,2051,66,67584,168,32256,99840
train,2052,48,49152,89,17088,66240
train,2053,98,100352,369,70848,171200
train,2054,214,219136,1759,337728,556864
train,2055,100,102400,385,73920,176320
train,2056,27,27648,31,5952,33600
train,2057,243,248832,2269,435648,684480
train,2058,7,7168,5,960,8128
train,2059,94,96256,340,65280,161536
train,2060,194,198656,1446,277632,476288
train,2061,64,65536,158,30336,95872
train,2062,59,60416,134,25728,86144
train,2063,79,80896,240,46080,126976
train,2064,111,113664,474,91008,204672
train,2065,52,53248,104,19968,73216
train,2066,83,84992,265,50880,135872
train,2067,107,109568,440,84480,194048
train,2068,74,75776,211,40512,116288
train,2069,11,11264,12,2304,13568
train,2070,24,24576,26,4992,29568
train,2071,315,322560,3812,731904,1054464
train,2072,64,65536,158,30336,95872
train,2073,482,493568,8924,1713408,2206976
train,2074,838,858112,26974,5179008,6037120
train,2075,87,89088,291,55872,144960
train,2076,92,94208,326,62592,156800
train,2077,136,139264,711,136512,275776
train,2078,129,132096,640,122880,254976
train,2079,76,77824,222,42624,120448
train,2080,65,66560,163,31296,97856
train,2081,73,74752,205,39360,114112
train,2082,22,22528,24,4608,27136
train,2083,59,60416,134,25728,86144
train,2084,315,322560,3812,731904,1054464
train,2085,179,183296,1231,236352,419648
train,2086,12,12288,12,2304,14592
train,2087,12,12288,10,1920,14208
train,2088,93,95232,333,63936,159168
train,2089,104,106496,416,79872,186368
train,2090,459,470016,8093,1553856,2023872
train,2091,46,47104,82,15744,62848
train,2092,86,88064,285,54720,142784
train,2093,8,8192,7,1344,9536
train,2094,180,184320,1245,239040,423360
train,2095,64,65536,158,30336,95872
train,2096,40,40960,71,13632,54592
train,2097,236,241664,2140,410880,652544
train,2098,18,18432,19,3648,22080
train,2099,18,18432,16,3072,21504
train,2100,8,8192,7,1344,9536
train,2101,32,32768,40,7680,40448
train,2102,85,87040,278,53376,140416
train,2103,81,82944,252,48384,131328
train,2104,92,94208,326,62592,156800
train,2105,95,97280,347,66624,163904
train,2106,52,53248,104,19968,73216
train,2107,23,23552,23,4416,27968
train,2108,104,106496,416,79872,186368
train,2109,129,132096,640,122880,254976
train,2110,46,47104,82,15744,62848
train,2111,98,100352,369,70848,171200
train,2112,87,89088,291,55872,144960
train,2113,134,137216,690,132480,269696
train,2114,320,327680,3934,755328,1083008
train,2115,145,148480,808,155136,303616
train,2116,27,27648,31,5952,33600
train,2117,133,136192,680,130560,266752
train,2118,119,121856,544,104448,226304
train,2119,149,152576,853,163776,316352
train,2120,96,98304,354,67968,166272
train,2121,72,73728,200,38400,112128
train,2122,100,102400,385,73920,176320
train,2123,323,330752,4008,769536,1100288
train,2124,371,379904,5287,1015104,1395008
train,2125,148,151552,842,161664,313216
train,2126,150,153600,865,166080,319680
train,2127,132,135168,670,128640,263808
train,2128,185,189440,1315,252480,441920
train,2129,19,19456,21,4032,23488
train,2130,15,15360,13,2496,17856
train,2131,102,104448,400,76800,181248
train,2132,142,145408,775,148800,294208
train,2133,155,158720,923,177216,335936
train,2134,13,13312,10,1920,15232
train,2135,67,68608,173,33216,101824
train,2136,9,9216,7,1344,10560
train,2137,20,20480,21,4032,24512
train,2138,68,69632,178,34176,103808
train,2139,20,20480,21,4032,24512
train,2140,27,27648,31,5952,33600
train,2141,195,199680,1461,280512,480192
train,2142,53,54272,108,20736,75008
train,2143,81,82944,252,48384,131328
train,2144,58,59392,130,24960,84352
train,2145,33,33792,42,8064,41856
train,2146,9,9216,8,1536,10752
train,2147,128,131072,630,120960,252032
train,2148,17,17408,16,3072,20480
train,2149,757,775168,22011,4226112,5001280
train,2150,45,46080,78,14976,61056
train,2151,225,230400,1945,373440,603840
train,2152,46,47104,82,15744,62848
train,2153,155,158720,923,177216,335936
train,2154,49,50176,93,17856,68032
train,2155,276,282624,2926,561792,844416
train,2156,47,48128,85,16320,64448
train,2157,82,83968,259,49728,133696
train,2158,142,145408,775,148800,294208
train,2159,47,48128,85,16320,64448
train,2160,338,346112,4389,842688,1188800
train,2161,82,83968,259,49728,133696
train,2162,50,51200,96,18432,69632
train,2163,117,119808,526,100992,220800
train,2164,110,112640,465,89280,201920
train,2165,137,140288,721,138432,278720
train,2166,105,107520,424,81408,188928
train,2167,45,46080,78,14976,61056
train,2168,121,123904,563,108096,232000
train,2169,67,68608,173,33216,101824
train,2170,189,193536,1373,263616,457152
train,2171,44,45056,78,14976,60032
train,2172,97,99328,362,69504,168832
train,2173,489,500736,9185,1763520,2264256
train,2174,749,766976,21549,4137408,4904384
train,2175,154,157696,911,174912,332608
train,2176,135,138240,700,134400,272640
train,2177,87,89088,291,55872,144960
train,2178,63,64512,153,29376,93888
train,2179,109,111616,457,87744,199360
train,2180,334,342016,4285,822720,1164736
train,2181,243,248832,2269,435648,684480
train,2182,250,256000,2401,460992,716992
train,2183,220,225280,1860,357120,582400
train,2184,158,161792,959,184128,345920
train,2185,29,29696,35,6720,36416
train,2186,127,130048,620,119040,249088
train,2187,12,12288,9,1728,14016
train,2188,11,11264,9,1728,12992
train,2189,21,21504,17,3264,24768
train,2190,35,35840,48,9216,45056
train,2191,771,789504,22833,4383936,5173440
train,2192,360,368640,4978,955776,1324416
train,2193,532,544768,10871,2087232,2632000
train,2194,64,65536,158,30336,95872
train,2195,119,121856,544,104448,226304
train,2196,80,81920,246,47232,129152
train,2197,29,29696,35,6720,36416
train,2198,152,155648,888,170496,326144
train,2199,361,369664,5006,961152,1330816
train,2200,26,26624,26,4992,31616
train,2201,92,94208,326,62592,156800
train,2202,71,72704,200,38400,111104
train,2203,9,9216,9,1728,10944
train,2204,98,100352,369,70848,171200
train,2205,443,453632,7538,1447296,1900928
train,2206,135,138240,700,134400,272640
train,2207,88,90112,298,57216,147328
train,2208,366,374784,5146,988032,1362816
train,2209,209,214016,1678,322176,536192
train,2210,685,701440,18023,3460416,4161856
train,2211,90,92160,312,59904,152064
train,2212,98,100352,369,70848,171200
train,2213,194,198656,1446,277632,476288
train,2214,77,78848,228,43776,122624
train,2215,585,599040,13145,2523840,3122880
train,2216,39,39936,62,11904,51840
train,2217,78,79872,234,44928,124800
train,2218,100,102400,385,73920,176320
train,2219,87,89088,291,55872,144960
train,2220,32,32768,50,9600,42368
train,2221,48,49152,89,17088,66240
train,2222,227,232448,1980,380160,612608
train,2223,49,50176,93,17856,68032
train,2224,305,312320,3574,686208,998528
train,2225,6,6144,4,768,6912
train,2226,29,29696,37,7104,36800
train,2227,558,571392,11960,2296320,2867712
train,2228,48,49152,89,17088,66240
train,2229,131,134144,660,126720,260864
train,2230,12,12288,10,1920,14208
train,2231,379,388096,5518,1059456,1447552
train,2232,52,53248,104,19968,73216
train,2233,247,252928,2344,450048,702976
train,2234,29,29696,35,6720,36416
train,2235,14,14336,10,1920,16256
train,2236,46,47104,89,17088,64192
train,2237,369,377856,5230,1004160,1382016
train,2238,20,20480,19,3648,24128
train,2239,50,51200,96,18432,69632
train,2240,107,109568,440,84480,194048
train,2241,436,446464,7302,1401984,1848448
train,2242,358,366592,4923,945216,1311808
train,2243,250,256000,2401,460992,716992
train,2244,81,82944,252,48384,131328
train,2245,25,25600,28,5376,30976
train,2246,101,103424,392,75264,178688
train,2247,22,22528,23,4416,26944
train,2248,347,355328,4625,888000,1243328
train,2249,62,63488,148,28416,91904
train,2250,123,125952,582,111744,237696
train,2251,85,87040,278,53376,140416
train,2252,122,124928,572,109824,234752
train,2253,68,69632,178,34176,103808
train,2254,8,8192,8,1536,9728
train,2255,91,93184,319,61248,154432
train,2256,119,121856,544,104448,226304
train,2257,249,254976,2382,457344,712320
train,2258,436,446464,7302,1401984,1848448
train,2259,81,82944,252,48384,131328
train,2260,154,157696,911,174912,332608
train,2261,50,51200,96,18432,69632
train,2262,36,36864,50,9600,46464
train,2263,53,54272,108,20736,75008
train,2264,159,162816,972,186624,349440
train,2265,68,69632,178,34176,103808
train,2266,105,107520,424,81408,188928
train,2267,27,27648,31,5952,33600
train,2268,46,47104,82,15744,62848
train,2269,27,27648,33,6336,33984
train,2270,11,11264,10,1920,13184
train,2271,19,19456,21,4032,23488
train,2272,69,70656,183,35136,105792
train,2273,214,219136,1759,337728,556864
train,2274,156,159744,935,179520,339264
train,2275,28,28672,31,5952,34624
train,2276,273,279552,2863,549696,829248
train,2277,298,305152,3411,654912,960064
train,2278,106,108544,432,82944,191488
train,2279,28,28672,33,6336,35008
train,2280,66,67584,168,32256,99840
train,2281,137,140288,721,138432,278720
train,2282,108,110592,448,86016,196608
train,2283,268,274432,2759,529728,804160
train,2284,14,14336,13,2496,16832
train,2285,24,24576,28,5376,29952
train,2286,173,177152,1150,220800,397952
train,2287,11,11264,8,1536,12800
train,2288,49,50176,93,17856,68032
train,2289,580,593920,12922,2481024,3074944
train,2290,83,84992,265,50880,135872
train,2291,246,251904,2325,446400,698304
train,2292,61,62464,143,27456,89920
train,2293,338,346112,4389,842688,1188800
train,2294,64,65536,158,30336,95872
train,2295,30,30720,37,7104,37824
train,2296,85,87040,278,53376,140416
train,2297,62,63488,148,28416,91904
train,2298,68,69632,178,34176,103808
train,2299,52,53248,104,19968,73216
train,2300,10,10240,9,1728,11968
train,2301,21,21504,21,4032,25536
train,2302,108,110592,448,86016,196608
train,2303,315,322560,3812,731904,1054464
train,2304,144,147456,797,153024,300480
train,2305,803,822272,24768,4755456,5577728
train,2306,42,43008,68,13056,56064
train,2307,137,140288,721,138432,278720
train,2308,67,68608,173,33216,101824
train,2309,751,769024,21664,4159488,4928512
train,2310,209,214016,1678,322176,536192
train,2311,106,108544,432,82944,191488
train,2312,83,84992,265,50880,135872
train,2313,47,48128,85,16320,64448
train,2314,47,48128,85,16320,64448
train,2315,26,26624,28,5376,32000
train,2316,570,583680,12480,2396160,2979840
train,2317,82,83968,259,49728,133696
train,2318,319,326656,3909,750528,1077184
train,2319,108,110592,448,86016,196608
train,2320,77,78848,228,43776,122624
train,2321,206,210944,1630,312960,523904
train,2322,29,29696,35,6720,36416
train,2323,120,122880,554,106368,229248
train,2324,79,80896,240,46080,126976
train,2325,26,26624,31,5952,32576
train,2326,29,29696,37,7104,36800
train,2327,55,56320,117,22464,78784
train,2328,45,46080,78,14976,61056
train,2329,12,12288,9,1728,14016
train,2330,47,48128,85,16320,64448
train,2331,38,38912,59,11328,50240
train,2332,29,29696,35,6720,36416
train,2333,255,261120,2498,479616,740736
train,2334,69,70656,189,36288,106944
train,2335,227,232448,1980,380160,612608
train,2336,413,422912,6552,1257984,1680896
train,2337,58,59392,130,24960,84352
train,2338,77,78848,228,43776,122624
train,2339,58,59392,130,24960,84352
train,2340,59,60416,134,25728,86144
train,2341,281,287744,3033,582336,870080
train,2342,33,33792,45,8640,42432
train,2343,27,27648,31,5952,33600
train,2344,51,52224,100,19200,71424
train,2345,245,250880,2306,442752,693632
train,2346,147,150528,830,159360,309888
train,2347,6,6144,7,1344,7488
train,2348,132,135168,670,128640,263808
train,2349,79,80896,240,46080,126976
train,2350,25,25600,28,5376,30976
train,2351,97,99328,362,69504,168832
train,2352,772,790528,22892,4395264,5185792
train,2353,9,9216,8,1536,10752
train,2354,229,234496,2015,386880,621376
train,2355,119,121856,544,104448,226304
train,2356,59,60416,134,25728,86144
train,2357,6,6144,7,1344,7488
train,2358,50,51200,96,18432,69632
train,2359,98,100352,369,70848,171200
train,2360,176,180224,1190,228480,408704
train,2361,197,201728,1491,286272,488000
train,2362,12,12288,9,1728,14016
train,2363,279,285696,2990,574080,859776
train,2364,86,88064,285,54720,142784
train,2365,11,11264,8,1536,12800
train,2366,75,76800,217,41664,118464
train,2367,130,133120,650,124800,257920
train,2368,318,325632,3885,745920,1071552
train,2369,31,31744,37,7104,38848
train,2370,86,88064,285,54720,142784
train,2371,8,8192,7,1344,9536
train,2372,81,82944,252,48384,131328
train,2373,245,250880,2306,442752,693632
train,2374,51,52224,100,19200,71424
train,2375,156,159744,935,179520,339264
train,2376,191,195584,1402,269184,464768
train,2377,247,252928,2344,450048,702976
train,2378,73,74752,205,39360,114112
train,2379,88,90112,298,57216,147328
train,2380,95,97280,347,66624,163904
train,2381,485,496640,9036,1734912,2231552
train,2382,159,162816,972,186624,349440
train,2383,245,250880,2306,442752,693632
train,2384,183,187392,1287,247104,434496
train,2385,183,187392,1287,247104,434496
train,2386,89,91136,305,58560,149696
train,2387,34,34816,45,8640,43456
train,2388,580,593920,12922,2481024,3074944
train,2389,104,106496,416,79872,186368
train,2390,37,37888,56,10752,48640
train,2391,71,72704,194,37248,109952
train,2392,245,250880,2306,442752,693632
train,2393,48,49152,89,17088,66240
train,2394,40,40960,68,13056,54016
train,2395,166,169984,1059,203328,373312
train,2396,148,151552,842,161664,313216
train,2397,87,89088,291,55872,144960
train,2398,41,41984,68,13056,55040
train,2399,7,7168,6,1152,8320
train,2400,34,34816,45,8640,43456
train,2401,226,231424,1962,376704,608128
train,2402,54,55296,112,21504,76800
train,2403,8,8192,7,1344,9536
train,2404,35,35840,50,9600,45440
train,2405,118,120832,535,102720,223552
train,2406,25,25600,26,4992,30592
train,2407,105,107520,424,81408,188928
train,2408,36,36864,53,10176,47040
train,2409,125,128000,601,115392,243392
train,2410,79,80896,240,46080,126976
train,2411,366,374784,5146,988032,1362816
train,2412,409,418816,6426,1233792,1652608
train,2413,52,53248,104,19968,73216
train,2414,110,112640,465,89280,201920
train,2415,354,362496,4814,924288,1286784
train,2416,233,238592,2086,400512,639104
train,2417,281,287744,3033,582336,870080
train,2418,9,9216,7,1344,10560
train,2419,15,15360,12,2304,17664
train,2420,53,54272,108,20736,75008
train,2421,41,41984,65,12480,54464
train,2422,155,158720,923,177216,335936
train,2423,26,26624,31,5952,32576
train,2424,119,121856,544,104448,226304
train,2425,65,66560,163,31296,97856
train,2426,259,265216,2577,494784,760000
train,2427,14,14336,13,2496,16832
train,2428,116,118784,517,99264,218048
train,2429,188,192512,1358,260736,453248
train,2430,155,158720,923,177216,335936
train,2431,27,27648,31,5952,33600
train,2432,92,94208,326,62592,156800
train,2433,32,32768,40,7680,40448
train,2434,8,8192,7,1344,9536
train,2435,77,78848,228,43776,122624
train,2436,80,81920,246,47232,129152
train,2437,115,117760,508,97536,215296
train,2438,465,476160,8306,1594752,2070912
train,2439,34,34816,45,8640,43456
train,2440,102,104448,400,76800,181248
train,2441,58,59392,130,24960,84352
train,2442,86,88064,285,54720,142784
train,2443,76,77824,222,42624,120448
train,2444,41,41984,65,12480,54464
train,2445,130,133120,650,124800,257920
train,2446,122,124928,572,109824,234752
train,2447,36,36864,56,10752,47616
train,2448,536,548864,11036,2118912,2667776
train,2449,58,59392,134,25728,85120
train,2450,37,37888,53,10176,48064
train,2451,880,901120,29745,5711040,6612160
train,2452,44,45056,78,14976,60032
train,2453,80,81920,246,47232,129152
train,2454,242,247808,2250,432000,679808
train,2455,42,43008,68,13056,56064
train,2456,72,73728,200,38400,112128
train,2457,215,220160,1776,340992,561152
train,2458,83,84992,265,50880,135872
train,2459,308,315392,3644,699648,1015040
train,2460,83,84992,265,50880,135872
train,2461,25,25600,28,5376,30976
train,2462,95,97280,347,66624,163904
train,2463,199,203776,1522,292224,496000
train,2464,116,118784,517,99264,218048
train,2465,108,110592,448,86016,196608
train,2466,108,110592,448,86016,196608
train,2467,74,75776,211,40512,116288
train,2468,85,87040,278,53376,140416
train,2469,417,427008,6680,1282560,1709568
train,2470,11,11264,10,1920,13184
train,2471,6,6144,6,1152,7296
train,2472,72,73728,200,38400,112128
train,2473,116,118784,517,99264,218048
train,2474,56,57344,121,23232,80576
train,2475,251,257024,2420,464640,721664
train,2476,45,46080,78,14976,61056
train,2477,65,66560,163,31296,97856
train,2478,10,10240,9,1728,11968
train,2479,27,27648,31,5952,33600
train,2480,119,121856,544,104448,226304
train,2481,68,69632,178,34176,103808
train,2482,77,78848,228,43776,122624
train,2483,55,56320,121,23232,79552
train,2484,9,9216,7,1344,10560
train,2485,24,24576,24,4608,29184
train,2486,431,441344,7136,1370112,1811456
train,2487,6,6144,4,768,6912
train,2488,21,21504,23,4416,25920
train,2489,126,129024,610,117120,246144
train,2490,257,263168,2537,487104,750272
train,2491,116,118784,517,99264,218048
train,2492,11,11264,8,1536,12800
train,2493,117,119808,526,100992,220800
train,2494,81,82944,252,48384,131328
train,2495,95,97280,347,66624,163904
train,2496,114,116736,500,96000,212736
train,2497,354,362496,4814,924288,1286784
train,2498,106,108544,432,82944,191488
train,2499,92,94208,326,62592,156800
train,2500,363,371712,5062,971904,1343616
train,2501,49,50176,93,17856,68032
train,2502,66,67584,173,33216,100800
train,2503,182,186368,1273,244416,430784
train,2504,379,388096,5518,1059456,1447552
train,2505,223,228352,1911,366912,595264
train,2506,76,77824,222,42624,120448
train,2507,60,61440,139,26688,88128
train,2508,99,101376,377,72384,173760
train,2509,69,70656,183,35136,105792
train,2510,48,49152,96,18432,67584
train,2511,161,164864,996,191232,356096
train,2512,210,215040,1694,325248,540288
train,2513,12,12288,10,1920,14208
train,2514,220,225280,1860,357120,582400
train,2515,94,96256,340,65280,161536
train,2516,21,21504,24,4608,26112
train,2517,96,98304,354,67968,166272
train,2518,40,40960,65,12480,53440
train,2519,496,507904,9450,1814400,2322304
train,2520,70,71680,189,36288,107968
train,2521,56,57344,121,23232,80576
train,2522,91,93184,319,61248,154432
train,2523,5,5120,4,768,5888
train,2524,60,61440,139,26688,88128
train,2525,59,60416,134,25728,86144
train,2526,161,164864,996,191232,356096
train,2527,317,324608,3860,741120,1065728
train,2528,108,110592,448,86016,196608
train,2529,68,69632,178,34176,103808
train,2530,455,465920,7952,1526784,1992704
train,2531,213,218112,1743,334656,552768
train,2532,112,114688,482,92544,207232
train,2533,46,47104,85,16320,63424
train,2534,23,23552,24,4608,28160
train,2535,157,160768,947,181824,342592
train,2536,121,123904,563,108096,232000
train,2537,100,102400,385,73920,176320
train,2538,64,65536,158,30336,95872
train,2539,90,92160,312,59904,152064
train,2540,12,12288,9,1728,14016
train,2541,254,260096,2479,475968,736064
train,2542,123,125952,582,111744,237696
train,2543,62,63488,148,28416,91904
train,2544,6,6144,7,1344,7488
train,2545,41,41984,65,12480,54464
train,2546,44,45056,75,14400,59456
train,2547,95,97280,347,66624,163904
train,2548,83,84992,265,50880,135872
train,2549,103,105472,408,78336,183808
train,2550,33,33792,42,8064,41856
train,2551,54,55296,112,21504,76800
train,2552,24,24576,26,4992,29568
train,2553,245,250880,2306,442752,693632
train,2554,25,25600,31,5952,31552
train,2555,219,224256,1843,353856,578112
train,2556,25,25600,28,5376,30976
train,2557,171,175104,1124,215808,390912
train,2558,102,104448,400,76800,181248
train,2559,50,51200,96,18432,69632
train,2560,431,441344,7136,1370112,1811456
train,2561,245,250880,2306,442752,693632
train,2562,27,27648,31,5952,33600
train,2563,40,40960,65,12480,53440
train,2564,51,52224,100,19200,71424
train,2565,125,128000,601,115392,243392
train,2566,173,177152,1150,220800,397952
train,2567,119,121856,544,104448,226304
train,2568,268,274432,2759,529728,804160
train,2569,119,121856,544,104448,226304
train,2570,135,138240,700,134400,272640
train,2571,179,183296,1231,236352,419648
train,2572,93,95232,333,63936,159168
train,2573,28,28672,35,6720,35392
train,2574,54,55296,117,22464,77760
train,2575,8,8192,7,1344,9536
train,2576,165,168960,1046,200832,369792
train,2577,455,465920,7952,1526784,1992704
train,2578,13,13312,10,1920,15232
train,2579,95,97280,347,66624,163904
train,2580,221,226304,1876,360192,586496
train,2581,231,236544,2050,393600,630144
train,2582,118,120832,535,102720,223552
train,2583,155,158720,923,177216,335936
train,2584,53,54272,112,21504,75776
train,2585,77,78848,228,43776,122624
train,2586,52,53248,104,19968,73216
train,2587,7,7168,7,1344,8512
train,2588,96,98304,354,67968,166272
train,2589,25,25600,28,5376,30976
train,2590,34,34816,45,8640,43456
train,2591,92,94208,326,62592,156800
train,2592,49,50176,93,17856,68032
train,2593,26,26624,28,5376,32000
train,2594,63,64512,153,29376,93888
train,2595,114,116736,500,96000,212736
train,2596,79,80896,240,46080,126976
train,2597,104,106496,424,81408,187904
train,2598,43,44032,75,14400,58432
train,2599,54,55296,112,21504,76800
train,2600,131,134144,660,126720,260864
train,2601,83,84992,265,50880,135872
train,2602,226,231424,1962,376704,608128
train,2603,67,68608,173,33216,101824
train,2604,91,93184,319,61248,154432
train,2605,128,131072,630,120960,252032
train,2606,28,28672,35,6720,35392
train,2607,90,92160,312,59904,152064
train,2608,43,44032,75,14400,58432
train,2609,41,41984,68,13056,55040
train,2610,138,141312,732,140544,281856
train,2611,217,222208,1809,347328,569536
train,2612,125,128000,601,115392,243392
train,2613,42,43008,68,13056,56064
train,2614,115,117760,508,97536,215296
train,2615,44,45056,75,14400,59456
train,2616,103,105472,408,78336,183808
train,2617,17,17408,16,3072,20480
train,2618,169,173056,1097,210624,383680
train,2619,25,25600,26,4992,30592
train,2620,463,474112,8234,1580928,2055040
train,2621,111,113664,474,91008,204672
train,2622,82,83968,259,49728,133696
train,2623,61,62464,143,27456,89920
train,2624,91,93184,319,61248,154432
train,2625,165,168960,1046,200832,369792
train,2626,64,65536,158,30336,95872
train,2627,469,480256,8449,1622208,2102464
train,2628,183,187392,1287,247104,434496
train,2629,53,54272,108,20736,75008
train,2630,188,192512,1358,260736,453248
train,2631,32,32768,40,7680,40448
train,2632,39,39936,65,12480,52416
train,2633,112,114688,482,92544,207232
train,2634,60,61440,139,26688,88128
train,2635,129,132096,640,122880,254976
train,2636,190,194560,1387,266304,460864
train,2637,105,107520,424,81408,188928
train,2638,300,307200,3457,663744,970944
train,2639,122,124928,572,109824,234752
train,2640,24,24576,28,5376,29952
train,2641,25,25600,26,4992,30592
train,2642,99,101376,377,72384,173760
train,2643,180,184320,1245,239040,423360
train,2644,53,54272,112,21504,75776
train,2645,421,431104,6808,1307136,1738240
train,2646,131,134144,660,126720,260864
train,2647,58,59392,130,24960,84352
train,2648,30,30720,35,6720,37440
train,2649,31,31744,37,7104,38848
train,2650,45,46080,78,14976,61056
train,2651,90,92160,312,59904,152064
train,2652,60,61440,139,26688,88128
train,2653,80,81920,246,47232,129152
train,2654,26,26624,28,5376,32000
train,2655,231,236544,2050,393600,630144
train,2656,389,398336,5813,1116096,1514432
train,2657,55,56320,117,22464,78784
train,2658,45,46080,82,15744,61824
train,2659,12,12288,12,2304,14592
train,2660,309,316416,3668,704256,1020672
train,2661,218,223232,1826,350592,573824
train,2662,103,105472,408,78336,183808
train,2663,87,89088,291,55872,144960
train,2664,112,114688,482,92544,207232
train,2665,82,83968,259,49728,133696
train,2666,14,14336,10,1920,16256
train,2667,108,110592,448,86016,196608
train,2668,39,39936,59,11328,51264
train,2669,8,8192,8,1536,9728
train,2670,278,284672,2969,570048,854720
train,2671,525,537600,10587,2032704,2570304
train,2672,156,159744,935,179520,339264
train,2673,54,55296,112,21504,76800
train,2674,28,28672,31,5952,34624
train,2675,239,244736,2194,421248,665984
train,2676,258,264192,2557,490944,755136
train,2677,45,46080,78,14976,61056
train,2678,131,134144,660,126720,260864
train,2679,23,23552,23,4416,27968
train,2680,168,172032,1085,208320,380352
train,2681,53,54272,112,21504,75776
train,2682,157,160768,947,181824,342592
train,2683,74,75776,211,40512,116288
train,2684,85,87040,278,53376,140416
train,2685,31,31744,37,7104,38848
train,2686,85,87040,278,53376,140416
train,2687,78,79872,234,44928,124800
train,2688,51,52224,100,19200,71424
train,2689,115,117760,508,97536,215296
train,2690,243,248832,2269,435648,684480
train,2691,137,140288,721,138432,278720
train,2692,66,67584,168,32256,99840
train,2693,55,56320,121,23232,79552
train,2694,119,121856,544,104448,226304
train,2695,54,55296,112,21504,76800
train,2696,394,403456,5963,1144896,1548352
train,2697,95,97280,347,66624,163904
train,2698,52,53248,104,19968,73216
train,2699,34,34816,45,8640,43456
train,2700,79,80896,240,46080,126976
train,2701,52,53248,108,20736,73984
train,2702,537,549888,11077,2126784,2676672
train,2703,9,9216,8,1536,10752
train,2704,343,351232,4519,867648,1218880
train,2705,86,88064,285,54720,142784
train,2706,29,29696,37,7104,36800
train,2707,24,24576,24,4608,29184
train,2708,58,59392,130,24960,84352
train,2709,25,25600,31,5952,31552
train,2710,172,176128,1137,218304,394432
train,2711,23,23552,24,4608,28160
train,2712,135,138240,700,134400,272640
train,2713,12,12288,10,1920,14208
train,2714,133,136192,680,130560,266752
train,2715,8,8192,5,960,9152
train,2716,321,328704,3958,759936,1088640
train,2717,54,55296,112,21504,76800
train,2718,278,284672,2969,570048,854720
train,2719,127,130048,620,119040,249088
train,2720,91,93184,319,61248,154432
train,2721,23,23552,24,4608,28160
train,2722,101,103424,392,75264,178688
train,2723,246,251904,2325,446400,698304
train,2724,41,41984,65,12480,54464
train,2725,318,325632,3885,745920,1071552
train,2726,371,379904,5287,1015104,1395008
train,2727,99,101376,377,72384,173760
train,2728,54,55296,112,21504,76800
train,2729,87,89088,291,55872,144960
train,2730,44,45056,75,14400,59456
train,2731,60,61440,139,26688,88128
train,2732,63,64512,158,30336,94848
train,2733,107,109568,440,84480,194048
train,2734,223,228352,1911,366912,595264
train,2735,121,123904,563,108096,232000
train,2736,62,63488,148,28416,91904
train,2737,51,52224,100,19200,71424
train,2738,61,62464,143,27456,89920
train,2739,121,123904,563,108096,232000
train,2740,62,63488,148,28416,91904
train,2741,35,35840,50,9600,45440
train,2742,39,39936,59,11328,51264
train,2743,27,27648,40,7680,35328
train,2744,124,126976,591,113472,240448
train,2745,75,76800,217,41664,118464
train,2746,9,9216,9,1728,10944
train,2747,91,93184,319,61248,154432
train,2748,106,108544,432,82944,191488
train,2749,122,124928,572,109824,234752
train,2750,60,61440,139,26688,88128
train,2751,951,973824,34739,6669888,7643712
train,2752,19,19456,19,3648,23104
train,2753,8,8192,6,1152,9344
train,2754,392,401408,5903,1133376,1534784
train,2755,210,215040,1694,325248,540288
train,2756,140,143360,753,144576,287936
train,2757,278,284672,2969,570048,854720
train,2758,668,684032,17140,3290880,3974912
train,2759,26,26624,28,5376,32000
train,2760,72,73728,200,38400,112128
train,2761,8,8192,7,1344,9536
train,2762,74,75776,211,40512,116288
train,2763,103,105472,408,78336,183808
train,2764,169,173056,1097,210624,383680
train,2765,28,28672,33,6336,35008
train,2766,63,64512,153,29376,93888
train,2767,72,73728,200,38400,112128
train,2768,69,70656,183,35136,105792
train,2769,79,80896,240,46080,126976
train,2770,302,309248,3504,672768,982016
train,2771,334,342016,4285,822720,1164736
train,2772,16,16384,13,2496,18880
train,2773,149,152576,853,163776,316352
train,2774,223,228352,1911,366912,595264
train,2775,71,72704,194,37248,109952
train,2776,22,22528,26,4992,27520
train,2777,78,79872,234,44928,124800
train,2778,21,21504,24,4608,26112
train,2779,30,30720,35,6720,37440
train,2780,69,70656,183,35136,105792
train,2781,78,79872,240,46080,125952
train,2782,201,205824,1552,297984,503808
train,2783,124,126976,591,113472,240448
train,2784,439,449536,7403,1421376,1870912
train,2785,273,279552,2863,549696,829248
train,2786,450,460800,7779,1493568,1954368
train,2787,91,93184,319,61248,154432
train,2788,89,91136,305,58560,149696
train,2789,158,161792,959,184128,345920
train,2790,99,101376,377,72384,173760
train,2791,131,134144,660,126720,260864
train,2792,63,64512,153,29376,93888
train,2793,351,359424,4733,908736,1268160
train,2794,82,83968,259,49728,133696
train,2795,55,56320,117,22464,78784
train,2796,66,67584,173,33216,100800
train,2797,85,87040,278,53376,140416
train,2798,107,109568,440,84480,194048
train,2799,557,570368,11917,2288064,2858432
train,2800,139,142336,743,142656,284992
train,2801,26,26624,28,5376,32000
train,2802,241,246784,2231,428352,675136
train,2803,55,56320,117,22464,78784
train,2804,216,221184,1793,344256,565440
train,2805,84,86016,271,52032,138048
train,2806,121,123904,563,108096,232000
train,2807,215,220160,1776,340992,561152
train,2808,42,43008,68,13056,56064
train,2809,44,45056,75,14400,59456
train,2810,110,112640,465,89280,201920
train,2811,113,115712,491,94272,209984
train,2812,111,113664,474,91008,204672
train,2813,146,149504,819,157248,306752
train,2814,220,225280,1860,357120,582400
train,2815,297,304128,3389,650688,954816
train,2816,89,91136,305,58560,149696
train,2817,49,50176,93,17856,68032
train,2818,114,116736,500,96000,212736
train,2819,102,104448,400,76800,181248
train,2820,13,13312,12,2304,15616
train,2821,230,235520,2032,390144,625664
train,2822,230,235520,2032,390144,625664
train,2823,113,115712,491,94272,209984
train,2824,11,11264,8,1536,12800
train,2825,67,68608,173,33216,101824
train,2826,14,14336,12,2304,16640
train,2827,78,79872,234,44928,124800
train,2828,28,28672,35,6720,35392
train,2829,128,131072,630,120960,252032
train,2830,356,364544,4868,934656,1299200
train,2831,300,307200,3457,663744,970944
train,2832,49,50176,93,17856,68032
train,2833,82,83968,259,49728,133696
train,2834,380,389120,5547,1065024,1454144
train,2835,32,32768,42,8064,40832
train,2836,220,225280,1860,357120,582400
train,2837,104,106496,416,79872,186368
train,2838,102,104448,400,76800,181248
train,2839,197,201728,1491,286272,488000
train,2840,77,78848,228,43776,122624
train,2841,28,28672,35,6720,35392
train,2842,11,11264,9,1728,12992
train,2843,53,54272,112,21504,75776
train,2844,36,36864,50,9600,46464
train,2845,327,334848,4108,788736,1123584
train,2846,27,27648,31,5952,33600
train,2847,14,14336,14,2688,17024
train,2848,422,432128,6841,1313472,1745600
train,2849,52,53248,104,19968,73216
train,2850,165,168960,1046,200832,369792
train,2851,38,38912,59,11328,50240
train,2852,115,117760,508,97536,215296
train,2853,117,119808,526,100992,220800
train,2854,49,50176,93,17856,68032
train,2855,27,27648,33,6336,33984
train,2856,30,30720,35,6720,37440
train,2857,110,112640,465,89280,201920
train,2858,24,24576,28,5376,29952
train,2859,35,35840,48,9216,45056
train,2860,237,242688,2158,414336,657024
train,2861,182,186368,1273,244416,430784
train,2862,42,43008,68,13056,56064
train,2863,565,578560,12262,2354304,2932864
train,2864,37,37888,56,10752,48640
train,2865,83,84992,265,50880,135872
train,2866,44,45056,75,14400,59456
train,2867,96,98304,354,67968,166272
train,2868,69,70656,183,35136,105792
train,2869,12,12288,9,1728,14016
train,2870,14,14336,12,2304,16640
train,2871,363,371712,5062,971904,1343616
train,2872,77,78848,228,43776,122624
train,2873,122,124928,572,109824,234752
train,2874,47,48128,85,16320,64448
train,2875,102,104448,400,76800,181248
train,2876,124,126976,591,113472,240448
train,2877,77,78848,228,43776,122624
train,2878,105,107520,424,81408,188928
train,2879,344,352256,4546,872832,1225088
train,2880,120,122880,554,106368,229248
train,2881,82,83968,259,49728,133696
train,2882,21,21504,21,4032,25536
train,2883,147,150528,830,159360,309888
train,2884,113,115712,491,94272,209984
train,2885,33,33792,42,8064,41856
train,2886,97,99328,362,69504,168832
train,2887,45,46080,78,14976,61056
train,2888,88,90112,298,57216,147328
train,2889,287,293888,3164,607488,901376
train,2890,23,23552,26,4992,28544
train,2891,122,124928,572,109824,234752
train,2892,33,33792,42,8064,41856
train,2893,135,138240,700,134400,272640
train,2894,90,92160,312,59904,152064
train,2895,95,97280,347,66624,163904
train,2896,7,7168,5,960,8128
train,2897,43,44032,71,13632,57664
train,2898,85,87040,278,53376,140416
train,2899,13,13312,10,1920,15232
train,2900,87,89088,291,55872,144960
train,2901,82,83968,259,49728,133696
train,2902,97,99328,362,69504,168832
train,2903,131,134144,660,126720,260864
train,2904,17,17408,16,3072,20480
train,2905,86,88064,285,54720,142784
train,2906,207,211968,1646,316032,528000
train,2907,58,59392,134,25728,85120
train,2908,70,71680,189,36288,107968
train,2909,79,80896,240,46080,126976
train,2910,272,278528,2842,545664,824192
train,2911,170,174080,1111,213312,387392
train,2912,138,141312,732,140544,281856
train,2913,150,153600,865,166080,319680
train,2914,108,110592,448,86016,196608
train,2915,128,131072,630,120960,252032
train,2916,52,53248,104,19968,73216
train,2917,125,128000,601,115392,243392
train,2918,53,54272,108,20736,75008
train,2919,52,53248,104,19968,73216
train,2920,47,48128,85,16320,64448
train,2921,28,28672,35,6720,35392
train,2922,46,47104,89,17088,64192
train,2923,96,98304,354,67968,166272
train,2924,47,48128,85,16320,64448
train,2925,975,998400,36514,7010688,8009088
train,2926,65,66560,163,31296,97856
train,2927,74,75776,211,40512,116288
train,2928,49,50176,93,17856,68032
train,2929,206,210944,1630,312960,523904
train,2930,5,5120,4,768,5888
train,2931,417,427008,6680,1282560,1709568
train,2932,130,133120,650,124800,257920
train,2933,9,9216,10,1920,11136
train,2934,756,774144,21953,4214976,4989120
train,2935,26,26624,28,5376,32000
train,2936,33,33792,42,8064,41856
train,2937,38,38912,56,10752,49664
train,2938,21,21504,21,4032,25536
train,2939,121,123904,563,108096,232000
train,2940,83,84992,265,50880,135872
train,2941,10,10240,8,1536,11776
train,2942,23,23552,24,4608,28160
train,2943,10,10240,10,1920,12160
train,2944,105,107520,424,81408,188928
train,2945,30,30720,40,7680,38400
train,2946,120,122880,554,106368,229248
train,2947,72,73728,200,38400,112128
train,2948,148,151552,842,161664,313216
train,2949,16,16384,12,2304,18688
train,2950,141,144384,764,146688,291072
train,2951,146,149504,819,157248,306752
train,2952,55,56320,117,22464,78784
train,2953,86,88064,285,54720,142784
train,2954,44,45056,75,14400,59456
train,2955,130,133120,650,124800,257920
train,2956,16,16384,13,2496,18880
train,2957,194,198656,1446,277632,476288
train,2958,123,125952,582,111744,237696
train,2959,92,94208,326,62592,156800
train,2960,115,117760,508,97536,215296
train,2961,108,110592,448,86016,196608
train,2962,12,12288,10,1920,14208
train,2963,89,91136,305,58560,149696
train,2964,108,110592,448,86016,196608
train,2965,125,128000,601,115392,243392
train,2966,28,28672,31,5952,34624
train,2967,73,74752,205,39360,114112
train,2968,16,16384,14,2688,19072
train,2969,40,40960,62,11904,52864
train,2970,43,44032,71,13632,57664
train,2971,94,96256,340,65280,161536
train,2972,136,139264,711,136512,275776
train,2973,26,26624,31,5952,32576
train,2974,541,553984,11242,2158464,2712448
train,2975,54,55296,112,21504,76800
train,2976,24,24576,28,5376,29952
train,2977,78,79872,234,44928,124800
train,2978,148,151552,842,161664,313216
train,2979,25,25600,26,4992,30592
train,2980,57,58368,125,24000,82368
train,2981,393,402432,5933,1139136,1541568
train,2982,111,113664,474,91008,204672
train,2983,35,35840,48,9216,45056
train,2984,113,115712,491,94272,209984
train,2985,32,32768,40,7680,40448
train,2986,25,25600,28,5376,30976
train,2987,86,88064,285,54720,142784
train,2988,30,30720,37,7104,37824
train,2989,215,220160,1776,340992,561152
train,2990,119,121856,544,104448,226304
train,2991,51,52224,100,19200,71424
train,2992,232,237568,2068,397056,634624
train,2993,24,24576,24,4608,29184
train,2994,131,134144,660,126720,260864
train,2995,28,28672,33,6336,35008
train,2996,10,10240,8,1536,11776
train,2997,9,9216,8,1536,10752
train,2998,928,950272,33079,6351168,7301440
train,2999,311,318464,3716,713472,1031936
train,3000,95,97280,347,66624,163904
train,3001,425,435200,6938,1332096,1767296
train,3002,215,220160,1776,340992,561152
train,3003,24,24576,26,4992,29568
train,3004,122,124928,572,109824,234752
train,3005,11,11264,10,1920,13184
train,3006,27,27648,33,6336,33984
train,3007,113,115712,491,94272,209984
train,3008,116,118784,517,99264,218048
train,3009,10,10240,8,1536,11776
train,3010,271,277504,2821,541632,819136
train,3011,109,111616,457,87744,199360
train,3012,53,54272,108,20736,75008
train,3013,146,149504,819,157248,306752
train,3014,181,185344,1259,241728,427072
train,3015,48,49152,89,17088,66240
train,3016,193,197632,1431,274752,472384
train,3017,10,10240,7,1344,11584
train,3018,148,151552,842,161664,313216
train,3019,61,62464,143,27456,89920
train,3020,76,77824,222,42624,120448
train,3021,17,17408,16,3072,20480
train,3022,540,552960,11201,2150592,2703552
train,3023,80,81920,246,47232,129152
train,3024,132,135168,670,128640,263808
train,3025,109,111616,457,87744,199360
train,3026,29,29696,35,6720,36416
train,3027,42,43008,68,13056,56064
train,3028,44,45056,75,14400,59456
train,3029,50,51200,96,18432,69632
train,3030,24,24576,26,4992,29568
train,3031,45,46080,78,14976,61056
train,3032,41,41984,65,12480,54464
train,3033,180,184320,1245,239040,423360
train,3034,175,179200,1177,225984,405184
train,3035,106,108544,432,82944,191488
train,3036,139,142336,743,142656,284992
train,3037,24,24576,26,4992,29568
train,3038,28,28672,33,6336,35008
train,3039,109,111616,457,87744,199360
train,3040,91,93184,319,61248,154432
train,3041,25,25600,28,5376,30976
train,3042,353,361472,4787,919104,1280576
train,3043,87,89088,291,55872,144960
train,3044,75,76800,217,41664,118464
train,3045,64,65536,158,30336,95872
train,3046,5,5120,4,768,5888
train,3047,42,43008,71,13632,56640
train,3048,7,7168,7,1344,8512
train,3049,29,29696,35,6720,36416
train,3050,28,28672,31,5952,34624
train,3051,35,35840,53,10176,46016
train,3052,126,129024,610,117120,246144
train,3053,38,38912,56,10752,49664
train,3054,23,23552,26,4992,28544
train,3055,50,51200,96,18432,69632
train,3056,63,64512,153,29376,93888
train,3057,39,39936,59,11328,51264
train,3058,72,73728,200,38400,112128
train,3059,56,57344,121,23232,80576
train,3060,107,109568,440,84480,194048
train,3061,153,156672,900,172800,329472
train,3062,109,111616,457,87744,199360
train,3063,35,35840,48,9216,45056
train,3064,58,59392,130,24960,84352
train,3065,41,41984,65,12480,54464
train,3066,148,151552,842,161664,313216
train,3067,41,41984,65,12480,54464
train,3068,113,115712,491,94272,209984
train,3069,60,61440,139,26688,88128
train,3070,244,249856,2287,439104,688960
train,3071,109,111616,457,87744,199360
train,3072,43,44032,75,14400,58432
train,3073,362,370688,5034,966528,1337216
train,3074,161,164864,996,191232,356096
train,3075,175,179200,1177,225984,405184
train,3076,72,73728,200,38400,112128
train,3077,74,75776,211,40512,116288
train,3078,74,75776,211,40512,116288
train,3079,47,48128,85,16320,64448
train,3080,73,74752,205,39360,114112
train,3081,93,95232,333,63936,159168
train,3082,5,5120,4,768,5888
train,3083,141,144384,764,146688,291072
train,3084,135,138240,700,134400,272640
train,3085,278,284672,2969,570048,854720
train,3086,63,64512,153,29376,93888
train,3087,254,260096,2479,475968,736064
train,3088,30,30720,42,8064,38784
train,3089,66,67584,168,32256,99840
train,3090,11,11264,13,2496,13760
train,3091,81,82944,252,48384,131328
train,3092,121,123904,563,108096,232000
train,3093,165,168960,1046,200832,369792
train,3094,236,241664,2140,410880,652544
train,3095,19,19456,21,4032,23488
train,3096,94,96256,340,65280,161536
train,3097,127,130048,620,119040,249088
train,3098,29,29696,33,6336,36032
train,3099,49,50176,93,17856,68032
train,3100,143,146432,786,150912,297344
train,3101,120,122880,554,106368,229248
train,3102,7,7168,7,1344,8512
train,3103,103,105472,408,78336,183808
train,3104,145,148480,808,155136,303616
train,3105,101,103424,392,75264,178688
train,3106,28,28672,31,5952,34624
train,3107,834,854016,26717,5129664,5983680
train,3108,89,91136,305,58560,149696
train,3109,22,22528,24,4608,27136
train,3110,119,121856,544,104448,226304
train,3111,129,132096,640,122880,254976
train,3112,233,238592,2086,400512,639104
train,3113,128,131072,630,120960,252032
train,3114,120,122880,554,106368,229248
train,3115,63,64512,153,29376,93888
train,3116,471,482304,8521,1636032,2118336
train,3117,64,65536,158,30336,95872
train,3118,22,22528,23,4416,26944
train,3119,192,196608,1416,271872,468480
train,3120,49,50176,100,19200,69376
train,3121,223,228352,1911,366912,595264
train,3122,69,70656,183,35136,105792
train,3123,90,92160,312,59904,152064
train,3124,91,93184,319,61248,154432
train,3125,119,121856,544,104448,226304
train,3126,20,20480,24,4608,25088
train,3127,108,110592,448,86016,196608
train,3128,46,47104,82,15744,62848
train,3129,106,108544,432,82944,191488
train,3130,88,90112,298,57216,147328
train,3131,13,13312,13,2496,15808
train,3132,150,153600,865,166080,319680
train,3133,28,28672,33,6336,35008
train,3134,50,51200,96,18432,69632
train,3135,196,200704,1476,283392,484096
train,3136,104,106496,416,79872,186368
train,3137,25,25600,26,4992,30592
train,3138,115,117760,508,97536,215296
train,3139,66,67584,168,32256,99840
train,3140,68,69632,178,34176,103808
train,3141,51,52224,100,19200,71424
train,3142,46,47104,82,15744,62848
train,3143,88,90112,298,57216,147328
train,3144,120,122880,554,106368,229248
train,3145,99,101376,377,72384,173760
train,3146,127,130048,620,119040,249088
train,3147,29,29696,33,6336,36032
train,3148,56,57344,121,23232,80576
train,3149,66,67584,173,33216,100800
train,3150,59,60416,134,25728,86144
train,3151,7,7168,8,1536,8704
train,3152,5,5120,4,768,5888
train,3153,54,55296,112,21504,76800
train,3154,47,48128,85,16320,64448
train,3155,117,119808,526,100992,220800
train,3156,29,29696,33,6336,36032
train,3157,63,64512,153,29376,93888
train,3158,25,25600,31,5952,31552
train,3159,293,300032,3298,633216,933248
train,3160,7,7168,6,1152,8320
train,3161,83,84992,265,50880,135872
train,3162,23,23552,23,4416,27968
train,3163,43,44032,71,13632,57664
train,3164,66,67584,168,32256,99840
train,3165,213,218112,1743,334656,552768
train,3166,27,27648,31,5952,33600
train,3167,54,55296,112,21504,76800
train,3168,274,280576,2884,553728,834304
train,3169,130,133120,650,124800,257920
train,3170,9,9216,7,1344,10560
train,3171,56,57344,125,24000,81344
train,3172,209,214016,1678,322176,536192
train,3173,8,8192,8,1536,9728
train,3174,40,40960,65,12480,53440
train,3175,112,114688,482,92544,207232
train,3176,320,327680,3934,755328,1083008
train,3177,71,72704,194,37248,109952
train,3178,74,75776,217,41664,117440
train,3179,28,28672,33,6336,35008
train,3180,42,43008,68,13056,56064
train,3181,163,166912,1021,196032,362944
train,3182,64,65536,158,30336,95872
train,3183,453,463872,7883,1513536,1977408
train,3184,7,7168,6,1152,8320
train,3185,246,251904,2325,446400,698304
train,3186,79,80896,240,46080,126976
train,3187,23,23552,26,4992,28544
train,3188,9,9216,9,1728,10944
train,3189,195,199680,1461,280512,480192
train,3190,9,9216,9,1728,10944
train,3191,10,10240,8,1536,11776
train,3192,105,107520,424,81408,188928
train,3193,243,248832,2269,435648,684480
train,3194,78,79872,234,44928,124800
train,3195,69,70656,183,35136,105792
train,3196,811,830464,25264,4850688,5681152
train,3197,58,59392,130,24960,84352
train,3198,129,132096,640,122880,254976
train,3199,86,88064,285,54720,142784
train,3200,23,23552,26,4992,28544
train,3201,70,71680,189,36288,107968
train,3202,223,228352,1911,366912,595264
train,3203,14,14336,12,2304,16640
train,3204,7,7168,7,1344,8512
train,3205,6,6144,6,1152,7296
train,3206,6,6144,4,768,6912
train,3207,5,5120,5,960,6080
train,3208,75,76800,217,41664,118464
train,3209,275,281600,2905,557760,839360
train,3210,228,233472,1997,383424,616896
train,3211,62,63488,148,28416,91904
train,3212,54,55296,112,21504,76800
train,3213,33,33792,48,9216,43008
train,3214,105,107520,424,81408,188928
train,3215,106,108544,432,82944,191488
train,3216,104,106496,416,79872,186368
train,3217,108,110592,448,86016,196608
train,3218,45,46080,78,14976,61056
train,3219,160,163840,984,188928,352768
train,3220,62,63488,148,28416,91904
train,3221,9,9216,9,1728,10944
train,3222,8,8192,7,1344,9536
train,3223,354,362496,4814,924288,1286784
train,3224,43,44032,71,13632,57664
train,3225,457,467968,8022,1540224,2008192
train,3226,173,177152,1150,220800,397952
train,3227,349,357376,4679,898368,1255744
train,3228,34,34816,48,9216,44032
train,3229,25,25600,28,5376,30976
train,3230,381,390144,5576,1070592,1460736
train,3231,104,106496,416,79872,186368
train,3232,639,654336,15684,3011328,3665664
train,3233,136,139264,711,136512,275776
train,3234,27,27648,31,5952,33600
train,3235,100,102400,385,73920,176320
train,3236,134,137216,690,132480,269696
train,3237,32,32768,40,7680,40448
train,3238,296,303104,3366,646272,949376
train,3239,165,168960,1046,200832,369792
train,3240,288,294912,3186,611712,906624
train,3241,77,78848,228,43776,122624
train,3242,78,79872,234,44928,124800
train,3243,108,110592,448,86016,196608
train,3244,310,317440,3692,708864,1026304
train,3245,285,291840,3120,599040,890880
train,3246,26,26624,28,5376,32000
train,3247,75,76800,217,41664,118464
train,3248,110,112640,465,89280,201920
train,3249,36,36864,50,9600,46464
train,3250,217,222208,1809,347328,569536
train,3251,72,73728,200,38400,112128
train,3252,21,21504,23,4416,25920
train,3253,113,115712,491,94272,209984
train,3254,46,47104,89,17088,64192
train,3255,78,79872,234,44928,124800
train,3256,44,45056,75,14400,59456
train,3257,24,24576,23,4416,28992
train,3258,87,89088,291,55872,144960
train,3259,7,7168,6,1152,8320
train,3260,109,111616,457,87744,199360
train,3261,251,257024,2420,464640,721664
train,3262,133,136192,680,130560,266752
train,3263,116,118784,517,99264,218048
train,3264,43,44032,75,14400,58432
train,3265,57,58368,125,24000,82368
train,3266,287,293888,3164,607488,901376
train,3267,10,10240,8,1536,11776
train,3268,90,92160,319,61248,153408
train,3269,160,163840,984,188928,352768
train,3270,88,90112,298,57216,147328
train,3271,319,326656,3909,750528,1077184
train,3272,63,64512,153,29376,93888
train,3273,49,50176,93,17856,68032
train,3274,18,18432,16,3072,21504
train,3275,325,332800,4058,779136,1111936
train,3276,22,22528,23,4416,26944
train,3277,42,43008,68,13056,56064
train,3278,39,39936,59,11328,51264
train,3279,159,162816,972,186624,349440
train,3280,111,113664,474,91008,204672
train,3281,131,134144,660,126720,260864
train,3282,24,24576,26,4992,29568
train,3283,87,89088,291,55872,144960
train,3284,234,239616,2104,403968,643584
train,3285,87,89088,291,55872,144960
train,3286,156,159744,935,179520,339264
train,3287,65,66560,163,31296,97856
train,3288,327,334848,4108,788736,1123584
train,3289,101,103424,392,75264,178688
train,3290,4,4096,4,768,4864
train,3291,130,133120,650,124800,257920
train,3292,183,187392,1287,247104,434496
train,3293,82,83968,259,49728,133696
train,3294,4,4096,4,768,4864
train,3295,86,88064,285,54720,142784
train,3296,69,70656,183,35136,105792
train,3297,192,196608,1416,271872,468480
train,3298,49,50176,93,17856,68032
train,3299,48,49152,89,17088,66240
train,3300,11,11264,9,1728,12992
train,3301,76,77824,222,42624,120448
train,3302,57,58368,134,25728,84096
train,3303,233,238592,2086,400512,639104
train,3304,789,807936,23912,4591104,5399040
train,3305,10,10240,9,1728,11968
train,3306,92,94208,326,62592,156800
train,3307,134,137216,690,132480,269696
train,3308,17,17408,16,3072,20480
train,3309,99,101376,377,72384,173760
train,3310,62,63488,148,28416,91904
train,3311,412,421888,6520,1251840,1673728
train,3312,178,182272,1217,233664,415936
train,3313,109,111616,457,87744,199360
train,3314,16,16384,14,2688,19072
train,3315,311,318464,3716,713472,1031936
train,3316,44,45056,75,14400,59456
train,3317,195,199680,1461,280512,480192
train,3318,110,112640,465,89280,201920
train,3319,313,320512,3763,722496,1043008
train,3320,93,95232,333,63936,159168
train,3321,96,98304,354,67968,166272
train,3322,7,7168,6,1152,8320
train,3323,82,83968,259,49728,133696
train,3324,58,59392,130,24960,84352
train,3325,170,174080,1111,213312,387392
train,3326,46,47104,82,15744,62848
train,3327,10,10240,8,1536,11776
train,3328,99,101376,377,72384,173760
train,3329,210,215040,1694,325248,540288
train,3330,95,97280,347,66624,163904
train,3331,11,11264,7,1344,12608
train,3332,7,7168,7,1344,8512
train,3333,169,173056,1097,210624,383680
train,3334,303,310272,3527,677184,987456
train,3335,274,280576,2884,553728,834304
train,3336,60,61440,139,26688,88128
train,3337,396,405504,6024,1156608,1562112
train,3338,92,94208,326,62592,156800
train,3339,111,113664,474,91008,204672
train,3340,105,107520,424,81408,188928
train,3341,23,23552,23,4416,27968
train,3342,8,8192,6,1152,9344
train,3343,110,112640,465,89280,201920
train,3344,13,13312,12,2304,15616
train,3345,70,71680,189,36288,107968
train,3346,75,76800,217,41664,118464
train,3347,119,121856,544,104448,226304
train,3348,218,223232,1826,350592,573824
train,3349,34,34816,50,9600,44416
train,3350,7,7168,7,1344,8512
train,3351,267,273408,2739,525888,799296
train,3352,91,93184,319,61248,154432
train,3353,31,31744,40,7680,39424
train,3354,55,56320,117,22464,78784
train,3355,60,61440,139,26688,88128
train,3356,49,50176,93,17856,68032
train,3357,239,244736,2194,421248,665984
train,3358,66,67584,168,32256,99840
train,3359,257,263168,2537,487104,750272
train,3360,312,319488,3739,717888,1037376
train,3361,311,318464,3716,713472,1031936
train,3362,27,27648,31,5952,33600
train,3363,628,643072,15149,2908608,3551680
train,3364,62,63488,148,28416,91904
train,3365,101,103424,392,75264,178688
train,3366,139,142336,743,142656,284992
train,3367,15,15360,13,2496,17856
train,3368,155,158720,923,177216,335936
train,3369,50,51200,96,18432,69632
train,3370,116,118784,517,99264,218048
train,3371,80,81920,246,47232,129152
train,3372,58,59392,130,24960,84352
train,3373,209,214016,1678,322176,536192
train,3374,87,89088,291,55872,144960
train,3375,46,47104,82,15744,62848
train,3376,27,27648,33,6336,33984
train,3377,62,63488,148,28416,91904
train,3378,123,125952,582,111744,237696
train,3379,915,936960,32158,6174336,7111296
train,3380,47,48128,89,17088,65216
train,3381,26,26624,28,5376,32000
train,3382,120,122880,554,106368,229248
train,3383,143,146432,786,150912,297344
train,3384,79,80896,240,46080,126976
train,3385,10,10240,9,1728,11968
train,3386,61,62464,143,27456,89920
train,3387,115,117760,508,97536,215296
train,3388,17,17408,19,3648,21056
train,3389,102,104448,400,76800,181248
train,3390,48,49152,89,17088,66240
train,3391,39,39936,59,11328,51264
train,3392,24,24576,24,4608,29184
train,3393,98,100352,369,70848,171200
train,3394,65,66560,163,31296,97856
train,3395,332,339968,4234,812928,1152896
train,3396,75,76800,217,41664,118464
train,3397,29,29696,33,6336,36032
train,3398,226,231424,1962,376704,608128
train,3399,11,11264,8,1536,12800
train,3400,385,394240,5694,1093248,1487488
train,3401,141,144384,764,146688,291072
train,3402,273,279552,2863,549696,829248
train,3403,65,66560,163,31296,97856
train,3404,69,70656,183,35136,105792
train,3405,87,89088,291,55872,144960
train,3406,391,400384,5873,1127616,1528000
train,3407,73,74752,205,39360,114112
train,3408,34,34816,48,9216,44032
train,3409,93,95232,333,63936,159168
train,3410,111,113664,474,91008,204672
train,3411,124,126976,591,113472,240448
train,3412,135,138240,700,134400,272640
train,3413,64,65536,158,30336,95872
train,3414,717,734208,19747,3791424,4525632
train,3415,116,118784,517,99264,218048
train,3416,27,27648,31,5952,33600
train,3417,126,129024,610,117120,246144
train,3418,245,250880,2306,442752,693632
train,3419,70,71680,189,36288,107968
train,3420,44,45056,78,14976,60032
train,3421,208,212992,1662,319104,532096
train,3422,50,51200,96,18432,69632
train,3423,68,69632,178,34176,103808
train,3424,14,14336,13,2496,16832
train,3425,67,68608,173,33216,101824
train,3426,122,124928,572,109824,234752
train,3427,166,169984,1059,203328,373312
train,3428,43,44032,71,13632,57664
train,3429,24,24576,24,4608,29184
train,3430,100,102400,385,73920,176320
train,3431,147,150528,830,159360,309888
train,3432,321,328704,3958,759936,1088640
train,3433,338,346112,4389,842688,1188800
train,3434,44,45056,78,14976,60032
train,3435,236,241664,2140,410880,652544
train,3436,13,13312,12,2304,15616
train,3437,266,272384,2718,521856,794240
train,3438,484,495616,8998,1727616,2223232
train,3439,141,144384,764,146688,291072
train,3440,85,87040,278,53376,140416
train,3441,112,114688,482,92544,207232
train,3442,101,103424,392,75264,178688
train,3443,20,20480,21,4032,24512
train,3444,197,201728,1491,286272,488000
train,3445,110,112640,465,89280,201920
train,3446,22,22528,23,4416,26944
train,3447,90,92160,312,59904,152064
train,3448,220,225280,1860,357120,582400
train,3449,252,258048,2440,468480,726528
train,3450,7,7168,5,960,8128
train,3451,10,10240,9,1728,11968
train,3452,16,16384,13,2496,18880
train,3453,27,27648,33,6336,33984
train,3454,204,208896,1599,307008,515904
train,3455,11,11264,8,1536,12800
train,3456,104,106496,416,79872,186368
train,3457,94,96256,340,65280,161536
train,3458,154,157696,911,174912,332608
train,3459,25,25600,26,4992,30592
train,3460,91,93184,319,61248,154432
train,3461,47,48128,85,16320,64448
train,3462,39,39936,62,11904,51840
train,3463,539,551936,11159,2142528,2694464
train,3464,59,60416,143,27456,87872
train,3465,9,9216,7,1344,10560
train,3466,124,126976,591,113472,240448
train,3467,48,49152,89,17088,66240
train,3468,109,111616,457,87744,199360
train,3469,101,103424,392,75264,178688
train,3470,16,16384,14,2688,19072
train,3471,14,14336,9,1728,16064
train,3472,120,122880,554,106368,229248
train,3473,684,700416,17971,3450432,4150848
train,3474,29,29696,33,6336,36032
train,3475,39,39936,62,11904,51840
train,3476,12,12288,13,2496,14784
train,3477,42,43008,68,13056,56064
train,3478,109,111616,457,87744,199360
train,3479,129,132096,640,122880,254976
train,3480,112,114688,482,92544,207232
train,3481,183,187392,1287,247104,434496
train,3482,301,308224,3480,668160,976384
train,3483,38,38912,56,10752,49664
train,3484,111,113664,474,91008,204672
train,3485,98,100352,369,70848,171200
train,3486,166,169984,1059,203328,373312
train,3487,238,243712,2176,417792,661504
train,3488,120,122880,554,106368,229248
train,3489,37,37888,53,10176,48064
train,3490,195,199680,1461,280512,480192
train,3491,78,79872,234,44928,124800
train,3492,80,81920,252,48384,130304
train,3493,35,35840,48,9216,45056
train,3494,169,173056,1097,210624,383680
train,3495,8,8192,6,1152,9344
train,3496,376,385024,5431,1042752,1427776
train,3497,302,309248,3504,672768,982016
train,3498,80,81920,246,47232,129152
train,3499,154,157696,911,174912,332608
train,3500,9,9216,10,1920,11136
train,3501,102,104448,400,76800,181248
train,3502,47,48128,85,16320,64448
train,3503,305,312320,3574,686208,998528
train,3504,84,86016,271,52032,138048
train,3505,547,560128,11493,2206656,2766784
train,3506,110,112640,465,89280,201920
train,3507,24,24576,26,4992,29568
train,3508,315,322560,3812,731904,1054464
train,3509,13,13312,14,2688,16000
train,3510,226,231424,1962,376704,608128
train,3511,622,636928,14861,2853312,3490240
train,3512,308,315392,3644,699648,1015040
train,3513,48,49152,93,17856,67008
train,3514,17,17408,17,3264,20672
train,3515,179,183296,1231,236352,419648
train,3516,101,103424,392,75264,178688
train,3517,193,197632,1431,274752,472384
train,3518,428,438272,7037,1351104,1789376
train,3519,40,40960,62,11904,52864
train,3520,93,95232,333,63936,159168
train,3521,130,133120,650,124800,257920
train,3522,23,23552,28,5376,28928
train,3523,39,39936,59,11328,51264
train,3524,249,254976,2382,457344,712320
train,3525,94,96256,340,65280,161536
train,3526,13,13312,9,1728,15040
train,3527,75,76800,217,41664,118464
train,3528,56,57344,121,23232,80576
train,3529,57,58368,130,24960,83328
train,3530,101,103424,392,75264,178688
train,3531,58,59392,130,24960,84352
train,3532,120,122880,554,106368,229248
train,3533,12,12288,9,1728,14016
train,3534,276,282624,2926,561792,844416
train,3535,82,83968,259,49728,133696
train,3536,110,112640,465,89280,201920
train,3537,11,11264,9,1728,12992
train,3538,15,15360,13,2496,17856
train,3539,208,212992,1662,319104,532096
train,3540,70,71680,189,36288,107968
train,3541,26,26624,26,4992,31616
train,3542,30,30720,37,7104,37824
train,3543,68,69632,178,34176,103808
train,3544,69,70656,183,35136,105792
train,3545,579,592896,12877,2472384,3065280
train,3546,74,75776,211,40512,116288
train,3547,22,22528,23,4416,26944
train,3548,244,249856,2287,439104,688960
train,3549,66,67584,168,32256,99840
train,3550,40,40960,62,11904,52864
train,3551,11,11264,12,2304,13568
train,3552,60,61440,139,26688,88128
train,3553,164,167936,1034,198528,366464
train,3554,101,103424,392,75264,178688
train,3555,49,50176,93,17856,68032
train,3556,48,49152,89,17088,66240
train,3557,218,223232,1826,350592,573824
train,3558,666,681984,17038,3271296,3953280
train,3559,117,119808,526,100992,220800
train,3560,51,52224,100,19200,71424
train,3561,296,303104,3366,646272,949376
train,3562,95,97280,347,66624,163904
train,3563,28,28672,35,6720,35392
train,3564,98,100352,369,70848,171200
train,3565,257,263168,2537,487104,750272
train,3566,135,138240,700,134400,272640
train,3567,157,160768,947,181824,342592
train,3568,8,8192,7,1344,9536
train,3569,335,343040,4311,827712,1170752
train,3570,67,68608,173,33216,101824
train,3571,59,60416,134,25728,86144
train,3572,62,63488,148,28416,91904
train,3573,102,104448,400,76800,181248
train,3574,312,319488,3739,717888,1037376
train,3575,204,208896,1599,307008,515904
train,3576,22,22528,23,4416,26944
train,3577,28,28672,31,5952,34624
train,3578,56,57344,121,23232,80576
train,3579,27,27648,31,5952,33600
train,3580,128,131072,630,120960,252032
train,3581,28,28672,35,6720,35392
train,3582,73,74752,205,39360,114112
train,3583,32,32768,40,7680,40448
train,3584,188,192512,1358,260736,453248
train,3585,233,238592,2086,400512,639104
train,3586,113,115712,491,94272,209984
train,3587,470,481280,8485,1629120,2110400
train,3588,288,294912,3186,611712,906624
train,3589,56,57344,121,23232,80576
train,3590,39,39936,59,11328,51264
train,3591,76,77824,222,42624,120448
train,3592,117,119808,526,100992,220800
train,3593,44,45056,75,14400,59456
train,3594,63,64512,153,29376,93888
train,3595,78,79872,234,44928,124800
train,3596,57,58368,134,25728,84096
train,3597,120,122880,554,106368,229248
train,3598,78,79872,234,44928,124800
train,3599,13,13312,12,2304,15616
train,3600,176,180224,1190,228480,408704
train,3601,238,243712,2176,417792,661504
train,3602,54,55296,112,21504,76800
train,3603,63,64512,153,29376,93888
train,3604,100,102400,385,73920,176320
train,3605,286,292864,3142,603264,896128
train,3606,93,95232,333,63936,159168
train,3607,432,442368,7169,1376448,1818816
train,3608,54,55296,112,21504,76800
train,3609,137,140288,721,138432,278720
train,3610,281,287744,3033,582336,870080
train,3611,803,822272,24768,4755456,5577728
train,3612,127,130048,620,119040,249088
train,3613,51,52224,100,19200,71424
train,3614,427,437248,7004,1344768,1782016
train,3615,120,122880,554,106368,229248
train,3616,168,172032,1085,208320,380352
train,3617,136,139264,711,136512,275776
train,3618,46,47104,82,15744,62848
train,3619,238,243712,2176,417792,661504
train,3620,73,74752,211,40512,115264
train,3621,111,113664,474,91008,204672
train,3622,26,26624,28,5376,32000
train,3623,109,111616,457,87744,199360
train,3624,102,104448,400,76800,181248
train,3625,189,193536,1373,263616,457152
train,3626,37,37888,56,10752,48640
train,3627,120,122880,554,106368,229248
train,3628,59,60416,134,25728,86144
train,3629,122,124928,572,109824,234752
train,3630,51,52224,100,19200,71424
train,3631,66,67584,168,32256,99840
train,3632,75,76800,217,41664,118464
train,3633,11,11264,8,1536,12800
train,3634,75,76800,217,41664,118464
train,3635,38,38912,65,12480,51392
train,3636,243,248832,2269,435648,684480
train,3637,71,72704,194,37248,109952
train,3638,36,36864,50,9600,46464
train,3639,795,814080,24277,4661184,5475264
train,3640,13,13312,13,2496,15808
train,3641,89,91136,305,58560,149696
train,3642,182,186368,1273,244416,430784
train,3643,22,22528,24,4608,27136
train,3644,28,28672,33,6336,35008
train,3645,59,60416,134,25728,86144
train,3646,21,21504,23,4416,25920
train,3647,12,12288,9,1728,14016
train,3648,105,107520,424,81408,188928
train,3649,122,124928,572,109824,234752
train,3650,21,21504,21,4032,25536
train,3651,34,34816,45,8640,43456
train,3652,81,82944,252,48384,131328
train,3653,11,11264,9,1728,12992
train,3654,179,183296,1231,236352,419648
train,3655,43,44032,75,14400,58432
train,3656,82,83968,259,49728,133696
train,3657,56,57344,121,23232,80576
train,3658,24,24576,23,4416,28992
train,3659,179,183296,1231,236352,419648
train,3660,252,258048,2440,468480,726528
train,3661,11,11264,8,1536,12800
train,3662,301,308224,3480,668160,976384
train,3663,14,14336,14,2688,17024
train,3664,74,75776,211,40512,116288
train,3665,22,22528,24,4608,27136
train,3666,212,217088,1727,331584,548672
train,3667,35,35840,53,10176,46016
train,3668,27,27648,33,6336,33984
train,3669,63,64512,158,30336,94848
train,3670,303,310272,3527,677184,987456
train,3671,174,178176,1163,223296,401472
train,3672,206,210944,1630,312960,523904
train,3673,27,27648,31,5952,33600
train,3674,280,286720,3012,578304,865024
train,3675,38,38912,59,11328,50240
train,3676,214,219136,1759,337728,556864
train,3677,201,205824,1552,297984,503808
train,3678,53,54272,108,20736,75008
train,3679,24,24576,28,5376,29952
train,3680,211,216064,1711,328512,544576
train,3681,150,153600,865,166080,319680
train,3682,126,129024,610,117120,246144
train,3683,79,80896,240,46080,126976
train,3684,13,13312,10,1920,15232
train,3685,126,129024,610,117120,246144
train,3686,202,206848,1568,301056,507904
train,3687,27,27648,31,5952,33600
train,3688,15,15360,12,2304,17664
train,3689,113,115712,491,94272,209984
train,3690,29,29696,33,6336,36032
train,3691,104,106496,416,79872,186368
train,3692,23,23552,24,4608,28160
train,3693,8,8192,7,1344,9536
train,3694,116,118784,517,99264,218048
train,3695,116,118784,517,99264,218048
train,3696,108,110592,448,86016,196608
train,3697,79,80896,240,46080,126976
train,3698,80,81920,246,47232,129152
train,3699,24,24576,28,5376,29952
train,3700,41,41984,71,13632,55616
train,3701,22,22528,24,4608,27136
train,3702,27,27648,31,5952,33600
train,3703,95,97280,347,66624,163904
train,3704,81,82944,252,48384,131328
train,3705,193,197632,1431,274752,472384
train,3706,48,49152,89,17088,66240
train,3707,224,229376,1928,370176,599552
train,3708,13,13312,13,2496,15808
train,3709,231,236544,2050,393600,630144
train,3710,96,98304,354,67968,166272
train,3711,107,109568,440,84480,194048
train,3712,227,232448,1980,380160,612608
train,3713,186,190464,1329,255168,445632
train,3714,54,55296,112,21504,76800
train,3715,52,53248,104,19968,73216
train,3716,28,28672,35,6720,35392
train,3717,35,35840,48,9216,45056
train,3718,8,8192,8,1536,9728
train,3719,250,256000,2401,460992,716992
train,3720,98,100352,369,70848,171200
train,3721,72,73728,200,38400,112128
train,3722,28,28672,33,6336,35008
train,3723,80,81920,246,47232,129152
train,3724,67,68608,173,33216,101824
train,3725,106,108544,432,82944,191488
train,3726,86,88064,285,54720,142784
train,3727,68,69632,178,34176,103808
train,3728,298,305152,3411,654912,960064
train,3729,160,163840,984,188928,352768
train,3730,100,102400,385,73920,176320
train,3731,36,36864,59,11328,48192
train,3732,77,78848,228,43776,122624
train,3733,89,91136,305,58560,149696
train,3734,668,684032,17140,3290880,3974912
train,3735,84,86016,271,52032,138048
train,3736,244,249856,2287,439104,688960
train,3737,30,30720,35,6720,37440
train,3738,178,182272,1217,233664,415936
train,3739,145,148480,808,155136,303616
train,3740,258,264192,2557,490944,755136
train,3741,8,8192,6,1152,9344
train,3742,29,29696,35,6720,36416
train,3743,68,69632,178,34176,103808
train,3744,101,103424,392,75264,178688
train,3745,200,204800,1537,295104,499904
train,3746,108,110592,448,86016,196608
train,3747,214,219136,1759,337728,556864
train,3748,26,26624,28,5376,32000
train,3749,10,10240,8,1536,11776
train,3750,49,50176,96,18432,68608
train,3751,115,117760,508,97536,215296
train,3752,28,28672,37,7104,35776
train,3753,98,100352,369,70848,171200
train,3754,50,51200,96,18432,69632
train,3755,182,186368,1273,244416,430784
train,3756,34,34816,50,9600,44416
train,3757,66,67584,168,32256,99840
train,3758,44,45056,75,14400,59456
train,3759,110,112640,465,89280,201920
train,3760,829,848896,26398,5068416,5917312
train,3761,684,700416,17971,3450432,4150848
train,3762,32,32768,40,7680,40448
train,3763,52,53248,104,19968,73216
train,3764,44,45056,75,14400,59456
train,3765,300,307200,3457,663744,970944
train,3766,354,362496,4814,924288,1286784
train,3767,162,165888,1008,193536,359424
train,3768,214,219136,1759,337728,556864
train,3769,23,23552,24,4608,28160
train,3770,27,27648,31,5952,33600
train,3771,175,179200,1177,225984,405184
train,3772,25,25600,28,5376,30976
train,3773,54,55296,112,21504,76800
train,3774,41,41984,65,12480,54464
train,3775,86,88064,285,54720,142784
train,3776,97,99328,362,69504,168832
train,3777,136,139264,711,136512,275776
train,3778,70,71680,189,36288,107968
train,3779,53,54272,108,20736,75008
train,3780,137,140288,721,138432,278720
train,3781,105,107520,424,81408,188928
train,3782,63,64512,153,29376,93888
train,3783,215,220160,1776,340992,561152
train,3784,16,16384,14,2688,19072
train,3785,76,77824,222,42624,120448
train,3786,122,124928,572,109824,234752
train,3787,268,274432,2759,529728,804160
train,3788,57,58368,125,24000,82368
train,3789,153,156672,900,172800,329472
train,3790,138,141312,732,140544,281856
train,3791,288,294912,3186,611712,906624
train,3792,144,147456,797,153024,300480
train,3793,138,141312,732,140544,281856
train,3794,349,357376,4679,898368,1255744
train,3795,189,193536,1373,263616,457152
train,3796,52,53248,112,21504,74752
train,3797,93,95232,333,63936,159168
train,3798,30,30720,37,7104,37824
train,3799,35,35840,50,9600,45440
train,3800,55,56320,117,22464,78784
train,3801,121,123904,563,108096,232000
train,3802,23,23552,23,4416,27968
train,3803,14,14336,13,2496,16832
train,3804,24,24576,28,5376,29952
train,3805,83,84992,265,50880,135872
train,3806,76,77824,222,42624,120448
train,3807,112,114688,482,92544,207232
train,3808,60,61440,139,26688,88128
train,3809,201,205824,1552,297984,503808
train,3810,153,156672,900,172800,329472
train,3811,102,104448,400,76800,181248
train,3812,7,7168,6,1152,8320
train,3813,171,175104,1124,215808,390912
train,3814,197,201728,1491,286272,488000
train,3815,143,146432,786,150912,297344
train,3816,215,220160,1776,340992,561152
train,3817,78,79872,234,44928,124800
train,3818,52,53248,104,19968,73216
train,3819,94,96256,340,65280,161536
train,3820,217,222208,1809,347328,569536
train,3821,105,107520,424,81408,188928
train,3822,461,472064,8163,1567296,2039360
train,3823,7,7168,7,1344,8512
train,3824,122,124928,572,109824,234752
train,3825,12,12288,13,2496,14784
train,3826,106,108544,432,82944,191488
train,3827,116,118784,517,99264,218048
train,3828,63,64512,153,29376,93888
train,3829,340,348160,4441,852672,1200832
train,3830,7,7168,4,768,7936
train,3831,644,659456,15931,3058752,3718208
train,3832,9,9216,8,1536,10752
train,3833,91,93184,319,61248,154432
train,3834,71,72704,194,37248,109952
train,3835,93,95232,333,63936,159168
train,3836,39,39936,62,11904,51840
train,3837,197,201728,1491,286272,488000
train,3838,79,80896,240,46080,126976
train,3839,48,49152,89,17088,66240
train,3840,117,119808,526,100992,220800
train,3841,157,160768,947,181824,342592
train,3842,5,5120,4,768,5888
train,3843,56,57344,121,23232,80576
train,3844,42,43008,71,13632,56640
train,3845,58,59392,130,24960,84352
train,3846,349,357376,4679,898368,1255744
train,3847,80,81920,246,47232,129152
train,3848,57,58368,125,24000,82368
train,3849,394,403456,5963,1144896,1548352
train,3850,30,30720,37,7104,37824
train,3851,25,25600,26,4992,30592
train,3852,230,235520,2032,390144,625664
train,3853,90,92160,312,59904,152064
train,3854,40,40960,62,11904,52864
train,3855,5,5120,5,960,6080
train,3856,214,219136,1759,337728,556864
train,3857,14,14336,17,3264,17600
train,3858,34,34816,48,9216,44032
train,3859,139,142336,743,142656,284992
train,3860,11,11264,10,1920,13184
train,3861,6,6144,8,1536,7680
train,3862,22,22528,26,4992,27520
train,3863,167,171008,1072,205824,376832
train,3864,239,244736,2194,421248,665984
train,3865,57,58368,125,24000,82368
train,3866,65,66560,163,31296,97856
train,3867,66,67584,168,32256,99840
train,3868,78,79872,234,44928,124800
train,3869,63,64512,153,29376,93888
train,3870,29,29696,35,6720,36416
train,3871,15,15360,13,2496,17856
train,3872,63,64512,153,29376,93888
train,3873,53,54272,112,21504,75776
train,3874,545,558080,11409,2190528,2748608
train,3875,12,12288,12,2304,14592
train,3876,116,118784,517,99264,218048
train,3877,41,41984,71,13632,55616
train,3878,240,245760,2213,424896,670656
train,3879,119,121856,544,104448,226304
train,3880,66,67584,168,32256,99840
train,3881,18,18432,17,3264,21696
train,3882,11,11264,8,1536,12800
train,3883,195,199680,1461,280512,480192
train,3884,10,10240,6,1152,11392
train,3885,785,803840,23670,4544640,5348480
train,3886,22,22528,23,4416,26944
train,3887,39,39936,59,11328,51264
train,3888,66,67584,168,32256,99840
train,3889,112,114688,482,92544,207232
train,3890,43,44032,75,14400,58432
train,3891,40,40960,75,14400,55360
train,3892,125,128000,601,115392,243392
train,3893,492,503808,9298,1785216,2289024
train,3894,151,154624,876,168192,322816
train,3895,37,37888,53,10176,48064
train,3896,25,25600,26,4992,30592
train,3897,54,55296,112,21504,76800
train,3898,118,120832,535,102720,223552
train,3899,459,470016,8093,1553856,2023872
train,3900,62,63488,153,29376,92864
train,3901,120,122880,554,106368,229248
train,3902,77,78848,228,43776,122624
train,3903,91,93184,319,61248,154432
train,3904,44,45056,75,14400,59456
train,3905,16,16384,13,2496,18880
train,3906,278,284672,2969,570048,854720
train,3907,199,203776,1522,292224,496000
train,3908,29,29696,35,6720,36416
train,3909,168,172032,1085,208320,380352
train,3910,29,29696,33,6336,36032
train,3911,51,52224,100,19200,71424
train,3912,95,97280,354,67968,165248
train,3913,283,289792,3077,590784,880576
train,3914,111,113664,474,91008,204672
train,3915,360,368640,4978,955776,1324416
train,3916,148,151552,842,161664,313216
train,3917,132,135168,670,128640,263808
train,3918,276,282624,2926,561792,844416
train,3919,498,509952,9526,1828992,2338944
train,3920,282,288768,3055,586560,875328
train,3921,23,23552,26,4992,28544
train,3922,19,19456,16,3072,22528
train,3923,16,16384,14,2688,19072
train,3924,123,125952,582,111744,237696
train,3925,65,66560,163,31296,97856
train,3926,182,186368,1273,244416,430784
train,3927,26,26624,35,6720,33344
train,3928,58,59392,130,24960,84352
train,3929,93,95232,333,63936,159168
train,3930,100,102400,385,73920,176320
train,3931,228,233472,1997,383424,616896
train,3932,93,95232,333,63936,159168
train,3933,28,28672,37,7104,35776
train,3934,105,107520,424,81408,188928
train,3935,544,557056,11367,2182464,2739520
train,3936,29,29696,37,7104,36800
train,3937,26,26624,31,5952,32576
train,3938,28,28672,35,6720,35392
train,3939,63,64512,153,29376,93888
train,3940,301,308224,3480,668160,976384
train,3941,37,37888,53,10176,48064
train,3942,776,794624,23130,4440960,5235584
train,3943,22,22528,23,4416,26944
train,3944,108,110592,448,86016,196608
train,3945,163,166912,1021,196032,362944
train,3946,107,109568,440,84480,194048
train,3947,8,8192,7,1344,9536
train,3948,51,52224,100,19200,71424
train,3949,9,9216,9,1728,10944
train,3950,7,7168,6,1152,8320
train,3951,64,65536,158,30336,95872
train,3952,42,43008,68,13056,56064
train,3953,91,93184,319,61248,154432
train,3954,26,26624,31,5952,32576
train,3955,229,234496,2015,386880,621376
train,3956,242,247808,2250,432000,679808
train,3957,131,134144,660,126720,260864
train,3958,20,20480,21,4032,24512
train,3959,94,96256,340,65280,161536
train,3960,49,50176,93,17856,68032
train,3961,31,31744,40,7680,39424
train,3962,37,37888,56,10752,48640
train,3963,337,345088,4363,837696,1182784
train,3964,83,84992,265,50880,135872
train,3965,31,31744,40,7680,39424
train,3966,110,112640,465,89280,201920
train,3967,104,106496,416,79872,186368
train,3968,131,134144,660,126720,260864
train,3969,99,101376,377,72384,173760
train,3970,180,184320,1245,239040,423360
train,3971,56,57344,121,23232,80576
train,3972,115,117760,508,97536,215296
train,3973,154,157696,911,174912,332608
train,3974,32,32768,42,8064,40832
train,3975,114,116736,500,96000,212736
train,3976,130,133120,650,124800,257920
train,3977,142,145408,775,148800,294208
train,3978,119,121856,544,104448,226304
train,3979,59,60416,134,25728,86144
train,3980,67,68608,173,33216,101824
train,3981,57,58368,125,24000,82368
train,3982,151,154624,876,168192,322816
train,3983,134,137216,690,132480,269696
train,3984,89,91136,305,58560,149696
train,3985,108,110592,448,86016,196608
train,3986,257,263168,2537,487104,750272
train,3987,63,64512,153,29376,93888
train,3988,43,44032,71,13632,57664
train,3989,99,101376,377,72384,173760
train,3990,375,384000,5402,1037184,1421184
train,3991,18,18432,19,3648,22080
train,3992,324,331776,4033,774336,1106112
train,3993,239,244736,2194,421248,665984
train,3994,113,115712,491,94272,209984
train,3995,313,320512,3763,722496,1043008
train,3996,119,121856,544,104448,226304
train,3997,27,27648,31,5952,33600
train,3998,16,16384,16,3072,19456
train,3999,70,71680,189,36288,107968
train,4000,110,112640,465,89280,201920
train,4001,100,102400,385,73920,176320
train,4002,23,23552,24,4608,28160
train,4003,67,68608,173,33216,101824
train,4004,114,116736,500,96000,212736
train,4005,72,73728,200,38400,112128
train,4006,57,58368,125,24000,82368
train,4007,224,229376,1928,370176,599552
train,4008,42,43008,68,13056,56064
train,4009,94,96256,340,65280,161536
train,4010,85,87040,278,53376,140416
train,4011,211,216064,1711,328512,544576
train,4012,6,6144,6,1152,7296
train,4013,62,63488,148,28416,91904
train,4014,512,524288,10069,1933248,2457536
train,4015,64,65536,158,30336,95872
train,4016,146,149504,819,157248,306752
train,4017,127,130048,620,119040,249088
train,4018,101,103424,392,75264,178688
train,4019,23,23552,26,4992,28544
train,4020,104,106496,416,79872,186368
train,4021,203,207872,1583,303936,511808
train,4022,96,98304,354,67968,166272
train,4023,86,88064,285,54720,142784
train,4024,741,758784,21091,4049472,4808256
train,4025,38,38912,62,11904,50816
train,4026,228,233472,1997,383424,616896
train,4027,67,68608,173,33216,101824
train,4028,277,283648,2948,566016,849664
train,4029,73,74752,205,39360,114112
train,4030,82,83968,259,49728,133696
train,4031,100,102400,385,73920,176320
train,4032,32,32768,45,8640,41408
train,4033,36,36864,53,10176,47040
train,4034,83,84992,265,50880,135872
train,4035,23,23552,24,4608,28160
train,4036,537,549888,11077,2126784,2676672
train,4037,88,90112,298,57216,147328
train,4038,201,205824,1552,297984,503808
train,4039,73,74752,205,39360,114112
train,4040,26,26624,28,5376,32000
train,4041,75,76800,217,41664,118464
train,4042,157,160768,947,181824,342592
train,4043,191,195584,1402,269184,464768
train,4044,807,826368,25015,4802880,5629248
train,4045,157,160768,947,181824,342592
train,4046,363,371712,5062,971904,1343616
train,4047,26,26624,26,4992,31616
train,4048,89,91136,305,58560,149696
train,4049,93,95232,333,63936,159168
train,4050,78,79872,234,44928,124800
train,4051,137,140288,721,138432,278720
train,4052,331,338944,4209,808128,1147072
train,4053,164,167936,1034,198528,366464
train,4054,95,97280,347,66624,163904
train,4055,63,64512,153,29376,93888
train,4056,88,90112,298,57216,147328
train,4057,180,184320,1245,239040,423360
train,4058,46,47104,82,15744,62848
train,4059,108,110592,448,86016,196608
train,4060,311,318464,3716,713472,1031936
train,4061,7,7168,6,1152,8320
train,4062,41,41984,65,12480,54464
train,4063,127,130048,620,119040,249088
train,4064,145,148480,808,155136,303616
train,4065,234,239616,2104,403968,643584
train,4066,409,418816,6426,1233792,1652608
train,4067,189,193536,1373,263616,457152
train,4068,417,427008,6680,1282560,1709568
train,4069,55,56320,121,23232,79552
train,4070,73,74752,205,39360,114112
train,4071,72,73728,200,38400,112128
train,4072,6,6144,5,960,7104
train,4073,60,61440,139,26688,88128
train,4074,443,453632,7538,1447296,1900928
train,4075,71,72704,194,37248,109952
train,4076,423,433152,6873,1319616,1752768
train,4077,136,139264,711,136512,275776
train,4078,29,29696,33,6336,36032
train,4079,227,232448,1980,380160,612608
train,4080,47,48128,85,16320,64448
train,4081,17,17408,19,3648,21056
train,4082,63,64512,153,29376,93888
train,4083,77,78848,228,43776,122624
train,4084,172,176128,1137,218304,394432
train,4085,51,52224,100,19200,71424
train,4086,528,540672,10709,2056128,2596800
train,4087,28,28672,35,6720,35392
train,4088,111,113664,474,91008,204672
train,4089,121,123904,563,108096,232000
train,4090,64,65536,158,30336,95872
train,4091,54,55296,112,21504,76800
train,4092,9,9216,7,1344,10560
train,4093,235,240640,2122,407424,648064
train,4094,593,607232,13507,2593344,3200576
train,4095,50,51200,96,18432,69632
train,4096,39,39936,59,11328,51264
train,4097,70,71680,189,36288,107968
train,4098,120,122880,554,106368,229248
train,4099,201,205824,1552,297984,503808
train,4100,125,128000,601,115392,243392
train,4101,26,26624,31,5952,32576
train,4102,108,110592,448,86016,196608
train,4103,93,95232,333,63936,159168
train,4104,54,55296,112,21504,76800
train,4105,51,52224,100,19200,71424
train,4106,341,349184,4467,857664,1206848
train,4107,78,79872,234,44928,124800
train,4108,121,123904,563,108096,232000
train,4109,331,338944,4209,808128,1147072
train,4110,141,144384,764,146688,291072
train,4111,23,23552,24,4608,28160
train,4112,260,266240,2597,498624,764864
train,4113,59,60416,134,25728,86144
train,4114,184,188416,1301,249792,438208
train,4115,545,558080,11409,2190528,2748608
train,4116,562,575488,12132,2329344,2904832
train,4117,169,173056,1097,210624,383680
train,4118,247,252928,2344,450048,702976
train,4119,466,477184,8341,1601472,2078656
train,4120,122,124928,572,109824,234752
train,4121,18,18432,17,3264,21696
train,4122,230,235520,2032,390144,625664
train,4123,48,49152,93,17856,67008
train,4124,95,97280,347,66624,163904
train,4125,23,23552,26,4992,28544
train,4126,30,30720,37,7104,37824
train,4127,170,174080,1111,213312,387392
train,4128,46,47104,82,15744,62848
train,4129,663,678912,16884,3241728,3920640
train,4130,126,129024,610,117120,246144
train,4131,121,123904,563,108096,232000
train,4132,189,193536,1373,263616,457152
train,4133,90,92160,312,59904,152064
train,4134,16,16384,12,2304,18688
train,4135,53,54272,108,20736,75008
train,4136,95,97280,347,66624,163904
train,4137,248,253952,2363,453696,707648
train,4138,70,71680,189,36288,107968
train,4139,163,166912,1021,196032,362944
train,4140,421,431104,6808,1307136,1738240
train,4141,98,100352,369,70848,171200
train,4142,182,186368,1273,244416,430784
train,4143,80,81920,246,47232,129152
train,4144,115,117760,508,97536,215296
train,4145,222,227328,1893,363456,590784
train,4146,90,92160,312,59904,152064
train,4147,88,90112,298,57216,147328
train,4148,63,64512,153,29376,93888
train,4149,212,217088,1727,331584,548672
train,4150,233,238592,2086,400512,639104
train,4151,251,257024,2420,464640,721664
train,4152,80,81920,252,48384,130304
train,4153,12,12288,10,1920,14208
train,4154,81,82944,252,48384,131328
train,4155,23,23552,23,4416,27968
train,4156,185,189440,1315,252480,441920
train,4157,59,60416,134,25728,86144
train,4158,309,316416,3668,704256,1020672
train,4159,42,43008,68,13056,56064
train,4160,44,45056,75,14400,59456
train,4161,116,118784,517,99264,218048
train,4162,37,37888,53,10176,48064
train,4163,65,66560,163,31296,97856
train,4164,51,52224,100,19200,71424
train,4165,61,62464,143,27456,89920
train,4166,269,275456,2780,533760,809216
train,4167,119,121856,544,104448,226304
train,4168,25,25600,24,4608,30208
train,4169,22,22528,23,4416,26944
train,4170,24,24576,33,6336,30912
train,4171,115,117760,508,97536,215296
train,4172,61,62464,143,27456,89920
train,4173,61,62464,143,27456,89920
train,4174,72,73728,200,38400,112128
train,4175,140,143360,753,144576,287936
train,4176,51,52224,104,19968,72192
train,4177,26,26624,28,5376,32000
train,4178,31,31744,40,7680,39424
train,4179,128,131072,630,120960,252032
train,4180,521,533504,10427,2001984,2535488
train,4181,150,153600,865,166080,319680
train,4182,109,111616,457,87744,199360
train,4183,72,73728,200,38400,112128
train,4184,167,171008,1072,205824,376832
train,4185,186,190464,1329,255168,445632
train,4186,437,447488,7336,1408512,1856000
train,4187,68,69632,178,34176,103808
train,4188,151,154624,876,168192,322816
train,4189,179,183296,1231,236352,419648
train,4190,179,183296,1231,236352,419648
train,4191,73,74752,205,39360,114112
train,4192,54,55296,112,21504,76800
train,4193,78,79872,234,44928,124800
train,4194,54,55296,112,21504,76800
train,4195,23,23552,23,4416,27968
train,4196,14,14336,13,2496,16832
train,4197,61,62464,143,27456,89920
train,4198,61,62464,148,28416,90880
train,4199,60,61440,139,26688,88128
train,4200,875,896000,29408,5646336,6542336
train,4201,165,168960,1046,200832,369792
train,4202,115,117760,508,97536,215296
train,4203,593,607232,13507,2593344,3200576
train,4204,136,139264,711,136512,275776
train,4205,89,91136,305,58560,149696
train,4206,109,111616,457,87744,199360
train,4207,42,43008,68,13056,56064
train,4208,41,41984,71,13632,55616
train,4209,24,24576,26,4992,29568
train,4210,49,50176,93,17856,68032
train,4211,49,50176,93,17856,68032
train,4212,66,67584,168,32256,99840
train,4213,546,559104,11451,2198592,2757696
train,4214,88,90112,298,57216,147328
train,4215,49,50176,96,18432,68608
train,4216,145,148480,808,155136,303616
train,4217,9,9216,8,1536,10752
train,4218,66,67584,168,32256,99840
train,4219,529,541696,10749,2063808,2605504
train,4220,36,36864,59,11328,48192
train,4221,64,65536,158,30336,95872
train,4222,62,63488,148,28416,91904
train,4223,64,65536,158,30336,95872
train,4224,31,31744,42,8064,39808
train,4225,130,133120,650,124800,257920
train,4226,45,46080,78,14976,61056
train,4227,34,34816,50,9600,44416
train,4228,46,47104,82,15744,62848
train,4229,125,128000,601,115392,243392
train,4230,41,41984,65,12480,54464
train,4231,287,293888,3164,607488,901376
train,4232,760,778240,22186,4259712,5037952
train,4233,125,128000,601,115392,243392
train,4234,52,53248,104,19968,73216
train,4235,25,25600,28,5376,30976
train,4236,53,54272,108,20736,75008
train,4237,108,110592,448,86016,196608
train,4238,65,66560,163,31296,97856
train,4239,45,46080,78,14976,61056
train,4240,296,303104,3366,646272,949376
train,4241,66,67584,168,32256,99840
train,4242,78,79872,234,44928,124800
train,4243,273,279552,2863,549696,829248
train,4244,63,64512,153,29376,93888
train,4245,40,40960,62,11904,52864
train,4246,154,157696,911,174912,332608
train,4247,69,70656,183,35136,105792
train,4248,24,24576,28,5376,29952
train,4249,68,69632,178,34176,103808
train,4250,24,24576,24,4608,29184
train,4251,101,103424,392,75264,178688
train,4252,8,8192,7,1344,9536
train,4253,354,362496,4814,924288,1286784
train,4254,331,338944,4209,808128,1147072
train,4255,97,99328,362,69504,168832
train,4256,224,229376,1928,370176,599552
train,4257,125,128000,601,115392,243392
train,4258,39,39936,59,11328,51264
train,4259,106,108544,432,82944,191488
train,4260,205,209920,1615,310080,520000
train,4261,26,26624,28,5376,32000
train,4262,97,99328,362,69504,168832
train,4263,47,48128,85,16320,64448
train,4264,10,10240,8,1536,11776
train,4265,92,94208,326,62592,156800
train,4266,141,144384,764,146688,291072
train,4267,56,57344,121,23232,80576
train,4268,168,172032,1085,208320,380352
train,4269,36,36864,50,9600,46464
train,4270,249,254976,2382,457344,712320
train,4271,76,77824,222,42624,120448
train,4272,179,183296,1231,236352,419648
train,4273,56,57344,121,23232,80576
train,4274,159,162816,972,186624,349440
train,4275,90,92160,312,59904,152064
train,4276,6,6144,7,1344,7488
train,4277,45,46080,85,16320,62400
train,4278,161,164864,996,191232,356096
train,4279,171,175104,1124,215808,390912
train,4280,54,55296,112,21504,76800
train,4281,95,97280,347,66624,163904
train,4282,123,125952,582,111744,237696
train,4283,22,22528,24,4608,27136
train,4284,78,79872,234,44928,124800
train,4285,156,159744,935,179520,339264
train,4286,96,98304,354,67968,166272
train,4287,95,97280,354,67968,165248
train,4288,124,126976,591,113472,240448
train,4289,60,61440,139,26688,88128
train,4290,229,234496,2015,386880,621376
train,4291,572,585728,12568,2413056,2998784
train,4292,191,195584,1402,269184,464768
train,4293,59,60416,134,25728,86144
train,4294,118,120832,535,102720,223552
train,4295,576,589824,12744,2446848,3036672
train,4296,222,227328,1893,363456,590784
train,4297,169,173056,1097,210624,383680
train,4298,198,202752,1506,289152,491904
train,4299,178,182272,1217,233664,415936
train,4300,40,40960,65,12480,53440
train,4301,88,90112,298,57216,147328
train,4302,8,8192,7,1344,9536
train,4303,183,187392,1287,247104,434496
train,4304,234,239616,2104,403968,643584
train,4305,243,248832,2269,435648,684480
train,4306,113,115712,491,94272,209984
train,4307,707,723968,19200,3686400,4410368
train,4308,345,353280,4572,877824,1231104
train,4309,195,199680,1461,280512,480192
train,4310,105,107520,424,81408,188928
train,4311,62,63488,148,28416,91904
train,4312,78,79872,240,46080,125952
train,4313,34,34816,45,8640,43456
train,4314,27,27648,31,5952,33600
train,4315,56,57344,125,24000,81344
train,4316,53,54272,108,20736,75008
train,4317,208,212992,1662,319104,532096
train,4318,234,239616,2104,403968,643584
train,4319,231,236544,2050,393600,630144
train,4320,10,10240,9,1728,11968
train,4321,22,22528,24,4608,27136
train,4322,64,65536,158,30336,95872
train,4323,106,108544,432,82944,191488
train,4324,130,133120,650,124800,257920
train,4325,75,76800,217,41664,118464
train,4326,62,63488,148,28416,91904
train,4327,89,91136,305,58560,149696
train,4328,161,164864,996,191232,356096
train,4329,97,99328,362,69504,168832
train,4330,73,74752,211,40512,115264
train,4331,79,80896,240,46080,126976
train,4332,88,90112,298,57216,147328
train,4333,120,122880,554,106368,229248
train,4334,15,15360,12,2304,17664
train,4335,584,598016,13101,2515392,3113408
train,4336,95,97280,347,66624,163904
train,4337,141,144384,764,146688,291072
train,4338,97,99328,362,69504,168832
train,4339,230,235520,2032,390144,625664
train,4340,38,38912,59,11328,50240
train,4341,106,108544,432,82944,191488
train,4342,216,221184,1793,344256,565440
train,4343,54,55296,112,21504,76800
train,4344,119,121856,544,104448,226304
train,4345,78,79872,234,44928,124800
train,4346,18,18432,14,2688,21120
train,4347,88,90112,298,57216,147328
train,4348,280,286720,3012,578304,865024
train,4349,60,61440,139,26688,88128
train,4350,387,396288,5753,1104576,1500864
train,4351,24,24576,24,4608,29184
train,4352,62,63488,148,28416,91904
train,4353,7,7168,7,1344,8512
train,4354,286,292864,3142,603264,896128
train,4355,14,14336,10,1920,16256
train,4356,6,6144,5,960,7104
train,4357,849,869376,27687,5315904,6185280
train,4358,95,97280,347,66624,163904
train,4359,105,107520,424,81408,188928
train,4360,88,90112,298,57216,147328
train,4361,60,61440,139,26688,88128
train,4362,132,135168,670,128640,263808
train,4363,36,36864,50,9600,46464
train,4364,8,8192,8,1536,9728
train,4365,74,75776,211,40512,116288
train,4366,77,78848,228,43776,122624
train,4367,12,12288,10,1920,14208
train,4368,230,235520,2032,390144,625664
train,4369,111,113664,474,91008,204672
train,4370,704,720896,19037,3655104,4376000
train,4371,155,158720,923,177216,335936
train,4372,142,145408,775,148800,294208
train,4373,328,335872,4133,793536,1129408
train,4374,298,305152,3411,654912,960064
train,4375,9,9216,10,1920,11136
train,4376,76,77824,222,42624,120448
train,4377,68,69632,178,34176,103808
train,4378,64,65536,158,30336,95872
train,4379,95,97280,347,66624,163904
train,4380,63,64512,153,29376,93888
train,4381,48,49152,89,17088,66240
train,4382,229,234496,2015,386880,621376
train,4383,157,160768,947,181824,342592
train,4384,90,92160,312,59904,152064
train,4385,176,180224,1190,228480,408704
train,4386,108,110592,448,86016,196608
train,4387,82,83968,259,49728,133696
validation,0,43,44032,71,13632,57664
validation,1,75,76800,217,41664,118464
validation,2,74,75776,211,40512,116288
validation,3,76,77824,222,42624,120448
validation,4,52,53248,104,19968,73216
validation,5,56,57344,121,23232,80576
validation,6,27,27648,31,5952,33600
validation,7,91,93184,319,61248,154432
validation,8,46,47104,82,15744,62848
validation,9,24,24576,28,5376,29952
validation,10,66,67584,168,32256,99840
validation,11,32,32768,40,7680,40448
validation,12,8,8192,8,1536,9728
validation,13,24,24576,28,5376,29952
validation,14,97,99328,362,69504,168832
validation,15,141,144384,764,146688,291072
validation,16,92,94208,326,62592,156800
validation,17,29,29696,37,7104,36800
validation,18,15,15360,16,3072,18432
validation,19,103,105472,408,78336,183808
validation,20,110,112640,465,89280,201920
validation,21,461,472064,8163,1567296,2039360
validation,22,115,117760,508,97536,215296
validation,23,16,16384,12,2304,18688
validation,24,418,428032,6712,1288704,1716736
validation,25,45,46080,78,14976,61056
validation,26,46,47104,82,15744,62848
validation,27,90,92160,312,59904,152064
validation,28,127,130048,620,119040,249088
validation,29,208,212992,1662,319104,532096
validation,30,42,43008,71,13632,56640
validation,31,242,247808,2250,432000,679808
validation,32,22,22528,23,4416,26944
validation,33,13,13312,12,2304,15616
validation,34,50,51200,104,19968,71168
validation,35,69,70656,183,35136,105792
validation,36,52,53248,104,19968,73216
validation,37,11,11264,10,1920,13184
validation,38,817,836608,25639,4922688,5759296
validation,39,433,443392,7202,1382784,1826176
validation,40,88,90112,298,57216,147328
validation,41,468,479232,8413,1615296,2094528
validation,42,306,313344,3597,690624,1003968
validation,43,83,84992,265,50880,135872
validation,44,224,229376,1928,370176,599552
validation,45,361,369664,5006,961152,1330816
validation,46,62,63488,148,28416,91904
validation,47,44,45056,75,14400,59456
validation,48,92,94208,326,62592,156800
validation,49,77,78848,228,43776,122624
validation,50,91,93184,319,61248,154432
validation,51,88,90112,298,57216,147328
validation,52,36,36864,50,9600,46464
validation,53,777,795648,23190,4452480,5248128
validation,54,39,39936,59,11328,51264
validation,55,81,82944,259,49728,132672
validation,56,47,48128,85,16320,64448
validation,57,19,19456,17,3264,22720
validation,58,282,288768,3055,586560,875328
validation,59,698,714752,18714,3593088,4307840
validation,60,78,79872,234,44928,124800
validation,61,181,185344,1259,241728,427072
validation,62,65,66560,163,31296,97856
validation,63,5,5120,7,1344,6464
validation,64,52,53248,104,19968,73216
validation,65,76,77824,222,42624,120448
validation,66,58,59392,130,24960,84352
validation,67,55,56320,117,22464,78784
validation,68,70,71680,189,36288,107968
validation,69,88,90112,298,57216,147328
validation,70,74,75776,211,40512,116288
validation,71,271,277504,2821,541632,819136
validation,72,759,777216,22128,4248576,5025792
validation,73,382,391168,5605,1076160,1467328
validation,74,239,244736,2194,421248,665984
validation,75,180,184320,1245,239040,423360
validation,76,24,24576,26,4992,29568
validation,77,129,132096,640,122880,254976
validation,78,290,296960,3231,620352,917312
validation,79,134,137216,690,132480,269696
validation,80,401,410624,6177,1185984,1596608
validation,81,6,6144,5,960,7104
validation,82,62,63488,148,28416,91904
validation,83,219,224256,1843,353856,578112
validation,84,82,83968,259,49728,133696
validation,85,23,23552,24,4608,28160
validation,86,329,336896,4158,798336,1135232
validation,87,198,202752,1506,289152,491904
validation,88,154,157696,911,174912,332608
validation,89,87,89088,291,55872,144960
validation,90,60,61440,139,26688,88128
validation,91,429,439296,7070,1357440,1796736
validation,92,82,83968,259,49728,133696
validation,93,121,123904,563,108096,232000
validation,94,754,772096,21837,4192704,4964800
validation,95,87,89088,291,55872,144960
validation,96,32,32768,40,7680,40448
validation,97,83,84992,265,50880,135872
validation,98,222,227328,1893,363456,590784
validation,99,32,32768,40,7680,40448
validation,100,48,49152,89,17088,66240
validation,101,40,40960,62,11904,52864
validation,102,329,336896,4158,798336,1135232
validation,103,71,72704,194,37248,109952
validation,104,700,716800,18821,3613632,4330432
validation,105,314,321536,3788,727296,1048832
validation,106,14,14336,14,2688,17024
validation,107,136,139264,711,136512,275776
validation,108,176,180224,1190,228480,408704
validation,109,6,6144,5,960,7104
validation,110,104,106496,416,79872,186368
validation,111,238,243712,2176,417792,661504
validation,112,42,43008,71,13632,56640
validation,113,28,28672,35,6720,35392
validation,114,45,46080,78,14976,61056
validation,115,11,11264,8,1536,12800
validation,116,9,9216,7,1344,10560
validation,117,757,775168,22011,4226112,5001280
validation,118,557,570368,11917,2288064,2858432
validation,119,78,79872,234,44928,124800
validation,120,128,131072,630,120960,252032
validation,121,121,123904,563,108096,232000
validation,122,273,279552,2863,549696,829248
validation,123,36,36864,50,9600,46464
validation,124,120,122880,554,106368,229248
validation,125,690,706560,18288,3511296,4217856
validation,126,56,57344,121,23232,80576
validation,127,119,121856,544,104448,226304
validation,128,373,381952,5344,1026048,1408000
validation,129,808,827392,25077,4814784,5642176
validation,130,89,91136,305,58560,149696
validation,131,202,206848,1568,301056,507904
validation,132,99,101376,377,72384,173760
validation,133,424,434176,6906,1325952,1760128
validation,134,77,78848,228,43776,122624
validation,135,187,191488,1344,258048,449536
validation,136,103,105472,408,78336,183808
validation,137,46,47104,82,15744,62848
validation,138,201,205824,1552,297984,503808
validation,139,124,126976,591,113472,240448
validation,140,191,195584,1402,269184,464768
validation,141,75,76800,217,41664,118464
validation,142,183,187392,1287,247104,434496
validation,143,91,93184,319,61248,154432
validation,144,407,416768,6363,1221696,1638464
validation,145,91,93184,319,61248,154432
validation,146,7,7168,7,1344,8512
validation,147,105,107520,424,81408,188928
validation,148,24,24576,26,4992,29568
validation,149,65,66560,163,31296,97856
validation,150,32,32768,40,7680,40448
validation,151,675,691200,17501,3360192,4051392
validation,152,256,262144,2518,483456,745600
validation,153,304,311296,3550,681600,992896
validation,154,708,724992,19254,3696768,4421760
validation,155,64,65536,158,30336,95872
validation,156,859,879616,28343,5441856,6321472
validation,157,97,99328,362,69504,168832
validation,158,192,196608,1416,271872,468480
validation,159,12,12288,10,1920,14208
validation,160,156,159744,935,179520,339264
validation,161,138,141312,732,140544,281856
validation,162,99,101376,377,72384,173760
validation,163,47,48128,85,16320,64448
validation,164,79,80896,240,46080,126976
validation,165,110,112640,465,89280,201920
validation,166,34,34816,45,8640,43456
validation,167,7,7168,5,960,8128
validation,168,95,97280,347,66624,163904
validation,169,452,462848,7848,1506816,1969664
validation,170,76,77824,222,42624,120448
validation,171,170,174080,1111,213312,387392
validation,172,38,38912,56,10752,49664
validation,173,99,101376,377,72384,173760
validation,174,70,71680,189,36288,107968
validation,175,126,129024,610,117120,246144
validation,176,92,94208,326,62592,156800
validation,177,78,79872,234,44928,124800
validation,178,139,142336,743,142656,284992
validation,179,27,27648,31,5952,33600
validation,180,236,241664,2140,410880,652544
validation,181,94,96256,340,65280,161536
validation,182,224,229376,1928,370176,599552
validation,183,197,201728,1491,286272,488000
validation,184,22,22528,23,4416,26944
validation,185,94,96256,340,65280,161536
validation,186,301,308224,3480,668160,976384
validation,187,50,51200,96,18432,69632
validation,188,10,10240,8,1536,11776
validation,189,72,73728,200,38400,112128
validation,190,36,36864,50,9600,46464
validation,191,75,76800,217,41664,118464
validation,192,126,129024,610,117120,246144
validation,193,48,49152,89,17088,66240
validation,194,73,74752,205,39360,114112
validation,195,29,29696,35,6720,36416
validation,196,24,24576,26,4992,29568
validation,197,84,86016,271,52032,138048
validation,198,98,100352,369,70848,171200
validation,199,31,31744,37,7104,38848
validation,200,19,19456,21,4032,23488
validation,201,11,11264,10,1920,13184
validation,202,49,50176,93,17856,68032
validation,203,10,10240,9,1728,11968
validation,204,385,394240,5694,1093248,1487488
validation,205,49,50176,93,17856,68032
validation,206,120,122880,554,106368,229248
validation,207,6,6144,5,960,7104
validation,208,62,63488,148,28416,91904
validation,209,159,162816,972,186624,349440
validation,210,51,52224,104,19968,72192
validation,211,29,29696,33,6336,36032
validation,212,64,65536,163,31296,96832
validation,213,85,87040,278,53376,140416
validation,214,121,123904,563,108096,232000
validation,215,266,272384,2718,521856,794240
validation,216,24,24576,26,4992,29568
validation,217,63,64512,153,29376,93888
validation,218,78,79872,234,44928,124800
validation,219,13,13312,10,1920,15232
validation,220,92,94208,326,62592,156800
validation,221,88,90112,298,57216,147328
validation,222,111,113664,474,91008,204672
validation,223,73,74752,205,39360,114112
validation,224,58,59392,130,24960,84352
validation,225,56,57344,121,23232,80576
validation,226,76,77824,222,42624,120448
validation,227,9,9216,8,1536,10752
validation,228,78,79872,234,44928,124800
validation,229,75,76800,217,41664,118464
validation,230,64,65536,158,30336,95872
validation,231,109,111616,457,87744,199360
validation,232,130,133120,650,124800,257920
validation,233,91,93184,319,61248,154432
validation,234,52,53248,104,19968,73216
validation,235,6,6144,6,1152,7296
validation,236,232,237568,2068,397056,634624
validation,237,96,98304,354,67968,166272
validation,238,44,45056,75,14400,59456
validation,239,71,72704,194,37248,109952
validation,240,133,136192,680,130560,266752
validation,241,59,60416,134,25728,86144
validation,242,100,102400,385,73920,176320
validation,243,6,6144,6,1152,7296
validation,244,150,153600,865,166080,319680
validation,245,9,9216,7,1344,10560
validation,246,194,198656,1446,277632,476288
validation,247,22,22528,26,4992,27520
validation,248,336,344064,4337,832704,1176768
validation,249,160,163840,984,188928,352768
validation,250,98,100352,369,70848,171200
validation,251,28,28672,33,6336,35008
validation,252,127,130048,620,119040,249088
validation,253,56,57344,121,23232,80576
validation,254,73,74752,205,39360,114112
validation,255,9,9216,10,1920,11136
validation,256,277,283648,2948,566016,849664
validation,257,34,34816,45,8640,43456
validation,258,351,359424,4733,908736,1268160
validation,259,240,245760,2213,424896,670656
validation,260,50,51200,96,18432,69632
validation,261,69,70656,183,35136,105792
validation,262,80,81920,246,47232,129152
validation,263,85,87040,278,53376,140416
validation,264,87,89088,291,55872,144960
validation,265,26,26624,28,5376,32000
validation,266,46,47104,85,16320,63424
validation,267,40,40960,65,12480,53440
validation,268,83,84992,265,50880,135872
validation,269,451,461824,7813,1500096,1961920
validation,270,51,52224,100,19200,71424
validation,271,105,107520,424,81408,188928
validation,272,115,117760,508,97536,215296
validation,273,81,82944,252,48384,131328
validation,274,127,130048,620,119040,249088
validation,275,235,240640,2122,407424,648064
validation,276,112,114688,482,92544,207232
validation,277,375,384000,5402,1037184,1421184
validation,278,123,125952,582,111744,237696
validation,279,124,126976,591,113472,240448
validation,280,8,8192,8,1536,9728
validation,281,133,136192,680,130560,266752
validation,282,111,113664,474,91008,204672
validation,283,58,59392,130,24960,84352
validation,284,210,215040,1694,325248,540288
validation,285,117,119808,526,100992,220800
validation,286,165,168960,1046,200832,369792
validation,287,126,129024,610,117120,246144
validation,288,25,25600,31,5952,31552
validation,289,8,8192,6,1152,9344
validation,290,11,11264,10,1920,13184
validation,291,108,110592,448,86016,196608
validation,292,45,46080,78,14976,61056
validation,293,74,75776,211,40512,116288
validation,294,74,75776,211,40512,116288
validation,295,40,40960,62,11904,52864
validation,296,52,53248,104,19968,73216
validation,297,232,237568,2068,397056,634624
validation,298,36,36864,50,9600,46464
validation,299,131,134144,660,126720,260864
validation,300,57,58368,125,24000,82368
validation,301,466,477184,8341,1601472,2078656
validation,302,183,187392,1287,247104,434496
validation,303,71,72704,194,37248,109952
validation,304,60,61440,139,26688,88128
validation,305,47,48128,85,16320,64448
validation,306,103,105472,408,78336,183808
validation,307,23,23552,28,5376,28928
validation,308,8,8192,6,1152,9344
validation,309,107,109568,440,84480,194048
validation,310,293,300032,3298,633216,933248
validation,311,129,132096,640,122880,254976
validation,312,43,44032,78,14976,59008
validation,313,247,252928,2344,450048,702976
validation,314,82,83968,259,49728,133696
validation,315,13,13312,12,2304,15616
validation,316,72,73728,200,38400,112128
validation,317,90,92160,319,61248,153408
validation,318,338,346112,4389,842688,1188800
validation,319,6,6144,4,768,6912
validation,320,30,30720,35,6720,37440
validation,321,22,22528,23,4416,26944
validation,322,381,390144,5576,1070592,1460736
validation,323,63,64512,153,29376,93888
validation,324,10,10240,9,1728,11968
validation,325,80,81920,246,47232,129152
validation,326,26,26624,31,5952,32576
validation,327,121,123904,563,108096,232000
validation,328,126,129024,610,117120,246144
validation,329,521,533504,10427,2001984,2535488
validation,330,83,84992,265,50880,135872
validation,331,112,114688,482,92544,207232
validation,332,65,66560,163,31296,97856
validation,333,29,29696,37,7104,36800
validation,334,292,299008,3275,628800,927808
validation,335,39,39936,59,11328,51264
validation,336,469,480256,8449,1622208,2102464
validation,337,58,59392,130,24960,84352
validation,338,15,15360,17,3264,18624
validation,339,56,57344,121,23232,80576
validation,340,12,12288,10,1920,14208
validation,341,162,165888,1008,193536,359424
validation,342,119,121856,544,104448,226304
validation,343,86,88064,285,54720,142784
validation,344,68,69632,178,34176,103808
validation,345,86,88064,285,54720,142784
validation,346,268,274432,2759,529728,804160
validation,347,41,41984,65,12480,54464
validation,348,139,142336,743,142656,284992
validation,349,48,49152,89,17088,66240
validation,350,50,51200,96,18432,69632
validation,351,53,54272,108,20736,75008
validation,352,112,114688,482,92544,207232
validation,353,127,130048,620,119040,249088
validation,354,574,587776,12656,2429952,3017728
validation,355,179,183296,1231,236352,419648
validation,356,56,57344,121,23232,80576
validation,357,24,24576,26,4992,29568
validation,358,25,25600,31,5952,31552
validation,359,97,99328,362,69504,168832
validation,360,204,208896,1599,307008,515904
validation,361,112,114688,482,92544,207232
validation,362,41,41984,65,12480,54464
validation,363,109,111616,457,87744,199360
validation,364,47,48128,85,16320,64448
validation,365,192,196608,1416,271872,468480
validation,366,300,307200,3457,663744,970944
validation,367,361,369664,5006,961152,1330816
validation,368,149,152576,853,163776,316352
validation,369,28,28672,35,6720,35392
validation,370,322,329728,3983,764736,1094464
validation,371,88,90112,298,57216,147328
validation,372,176,180224,1190,228480,408704
validation,373,23,23552,26,4992,28544
validation,374,59,60416,134,25728,86144
validation,375,29,29696,35,6720,36416
validation,376,447,457728,7675,1473600,1931328
validation,377,24,24576,28,5376,29952
validation,378,7,7168,6,1152,8320
validation,379,225,230400,1945,373440,603840
validation,380,50,51200,96,18432,69632
validation,381,107,109568,440,84480,194048
validation,382,199,203776,1522,292224,496000
validation,383,83,84992,265,50880,135872
validation,384,181,185344,1259,241728,427072
validation,385,543,556032,11326,2174592,2730624
validation,386,78,79872,234,44928,124800
validation,387,28,28672,35,6720,35392
validation,388,130,133120,650,124800,257920
validation,389,70,71680,189,36288,107968
validation,390,141,144384,764,146688,291072
validation,391,29,29696,35,6720,36416
validation,392,67,68608,173,33216,101824
validation,393,73,74752,205,39360,114112
validation,394,121,123904,563,108096,232000
validation,395,27,27648,37,7104,34752
validation,396,115,117760,508,97536,215296
validation,397,271,277504,2821,541632,819136
validation,398,131,134144,660,126720,260864
validation,399,54,55296,117,22464,77760
validation,400,53,54272,108,20736,75008
validation,401,106,108544,432,82944,191488
validation,402,82,83968,259,49728,133696
validation,403,69,70656,183,35136,105792
validation,404,339,347136,4415,847680,1194816
validation,405,106,108544,432,82944,191488
validation,406,44,45056,75,14400,59456
validation,407,201,205824,1552,297984,503808
validation,408,207,211968,1646,316032,528000
validation,409,25,25600,28,5376,30976
validation,410,57,58368,125,24000,82368
validation,411,24,24576,26,4992,29568
validation,412,68,69632,178,34176,103808
validation,413,114,116736,500,96000,212736
validation,414,223,228352,1911,366912,595264
validation,415,3,3072,2,384,3456
validation,416,46,47104,82,15744,62848
validation,417,122,124928,572,109824,234752
validation,418,24,24576,26,4992,29568
validation,419,38,38912,65,12480,51392
validation,420,150,153600,865,166080,319680
validation,421,103,105472,408,78336,183808
validation,422,248,253952,2363,453696,707648
validation,423,59,60416,134,25728,86144
validation,424,193,197632,1431,274752,472384
validation,425,97,99328,362,69504,168832
validation,426,69,70656,183,35136,105792
validation,427,220,225280,1860,357120,582400
validation,428,79,80896,240,46080,126976
validation,429,153,156672,900,172800,329472
validation,430,118,120832,535,102720,223552
validation,431,134,137216,690,132480,269696
validation,432,543,556032,11326,2174592,2730624
validation,433,44,45056,75,14400,59456
validation,434,84,86016,271,52032,138048
validation,435,70,71680,189,36288,107968
validation,436,75,76800,222,42624,119424
validation,437,45,46080,78,14976,61056
validation,438,51,52224,100,19200,71424
validation,439,9,9216,7,1344,10560
validation,440,161,164864,996,191232,356096
validation,441,70,71680,189,36288,107968
validation,442,87,89088,291,55872,144960
validation,443,74,75776,211,40512,116288
validation,444,281,287744,3033,582336,870080
validation,445,34,34816,45,8640,43456
validation,446,25,25600,31,5952,31552
validation,447,88,90112,298,57216,147328
validation,448,52,53248,104,19968,73216
validation,449,200,204800,1537,295104,499904
validation,450,59,60416,134,25728,86144
validation,451,15,15360,14,2688,18048
validation,452,57,58368,125,24000,82368
validation,453,229,234496,2015,386880,621376
validation,454,168,172032,1085,208320,380352
validation,455,6,6144,7,1344,7488
validation,456,126,129024,610,117120,246144
validation,457,63,64512,153,29376,93888
validation,458,33,33792,42,8064,41856
validation,459,33,33792,45,8640,42432
validation,460,37,37888,59,11328,49216
validation,461,49,50176,93,17856,68032
validation,462,77,78848,228,43776,122624
validation,463,246,251904,2325,446400,698304
validation,464,74,75776,211,40512,116288
validation,465,62,63488,148,28416,91904
validation,466,218,223232,1826,350592,573824
validation,467,23,23552,24,4608,28160
validation,468,24,24576,23,4416,28992
validation,469,65,66560,163,31296,97856
validation,470,50,51200,96,18432,69632
validation,471,76,77824,222,42624,120448
validation,472,118,120832,535,102720,223552
validation,473,25,25600,28,5376,30976
validation,474,19,19456,16,3072,22528
validation,475,8,8192,7,1344,9536
validation,476,6,6144,5,960,7104
validation,477,105,107520,424,81408,188928
validation,478,426,436224,6971,1338432,1774656
validation,479,75,76800,217,41664,118464
validation,480,7,7168,6,1152,8320
validation,481,99,101376,377,72384,173760
validation,482,115,117760,508,97536,215296
validation,483,90,92160,312,59904,152064
validation,484,126,129024,610,117120,246144
validation,485,286,292864,3142,603264,896128
validation,486,98,100352,369,70848,171200
validation,487,35,35840,50,9600,45440
validation,488,115,117760,508,97536,215296
validation,489,102,104448,400,76800,181248
validation,490,11,11264,8,1536,12800
validation,491,16,16384,13,2496,18880
validation,492,10,10240,9,1728,11968
validation,493,97,99328,362,69504,168832
validation,494,32,32768,40,7680,40448
validation,495,66,67584,173,33216,100800
validation,496,55,56320,117,22464,78784
validation,497,251,257024,2420,464640,721664
validation,498,91,93184,319,61248,154432
validation,499,131,134144,660,126720,260864
validation,500,99,101376,377,72384,173760
validation,501,53,54272,108,20736,75008
validation,502,224,229376,1928,370176,599552
validation,503,19,19456,21,4032,23488
validation,504,45,46080,78,14976,61056
validation,505,90,92160,312,59904,152064
validation,506,95,97280,347,66624,163904
validation,507,101,103424,392,75264,178688
validation,508,530,542720,10790,2071680,2614400
validation,509,323,330752,4008,769536,1100288
validation,510,41,41984,65,12480,54464
validation,511,359,367616,4951,950592,1318208
validation,512,117,119808,526,100992,220800
validation,513,40,40960,62,11904,52864
validation,514,99,101376,377,72384,173760
validation,515,394,403456,5963,1144896,1548352
validation,516,72,73728,200,38400,112128
validation,517,470,481280,8485,1629120,2110400
validation,518,129,132096,640,122880,254976
validation,519,74,75776,211,40512,116288
validation,520,138,141312,732,140544,281856
validation,521,22,22528,24,4608,27136
validation,522,45,46080,78,14976,61056
validation,523,16,16384,16,3072,19456
validation,524,95,97280,347,66624,163904
validation,525,199,203776,1522,292224,496000
validation,526,172,176128,1137,218304,394432
validation,527,77,78848,228,43776,122624
validation,528,433,443392,7202,1382784,1826176
validation,529,8,8192,7,1344,9536
validation,530,164,167936,1034,198528,366464
validation,531,79,80896,240,46080,126976
validation,532,54,55296,117,22464,77760
validation,533,118,120832,535,102720,223552
validation,534,121,123904,563,108096,232000
validation,535,210,215040,1694,325248,540288
validation,536,58,59392,134,25728,85120
validation,537,19,19456,21,4032,23488
validation,538,90,92160,312,59904,152064
validation,539,125,128000,601,115392,243392
validation,540,75,76800,217,41664,118464
validation,541,325,332800,4058,779136,1111936
validation,542,64,65536,158,30336,95872
validation,543,4,4096,4,768,4864
validation,544,26,26624,26,4992,31616
validation,545,25,25600,28,5376,30976
validation,546,108,110592,448,86016,196608
validation,547,127,130048,620,119040,249088
validation,548,106,108544,432,82944,191488
validation,549,80,81920,246,47232,129152
validation,550,59,60416,134,25728,86144
validation,551,594,608256,13553,2602176,3210432
validation,552,102,104448,400,76800,181248
validation,553,67,68608,173,33216,101824
validation,554,17,17408,13,2496,19904
validation,555,166,169984,1059,203328,373312
validation,556,80,81920,246,47232,129152
validation,557,98,100352,369,70848,171200
validation,558,41,41984,65,12480,54464
validation,559,102,104448,400,76800,181248
validation,560,32,32768,42,8064,40832
validation,561,99,101376,377,72384,173760
validation,562,112,114688,482,92544,207232
validation,563,77,78848,228,43776,122624
validation,564,135,138240,700,134400,272640
validation,565,73,74752,205,39360,114112
validation,566,102,104448,400,76800,181248
validation,567,61,62464,143,27456,89920
validation,568,22,22528,24,4608,27136
validation,569,23,23552,26,4992,28544
validation,570,56,57344,130,24960,82304
validation,571,231,236544,2050,393600,630144
validation,572,32,32768,42,8064,40832
validation,573,270,276480,2801,537792,814272
validation,574,26,26624,26,4992,31616
validation,575,147,150528,830,159360,309888
validation,576,41,41984,65,12480,54464
validation,577,149,152576,853,163776,316352
validation,578,78,79872,234,44928,124800
validation,579,66,67584,168,32256,99840
validation,580,78,79872,234,44928,124800
validation,581,24,24576,24,4608,29184
validation,582,198,202752,1506,289152,491904
validation,583,70,71680,189,36288,107968
validation,584,12,12288,9,1728,14016
validation,585,106,108544,432,82944,191488
validation,586,340,348160,4441,852672,1200832
validation,587,546,559104,11451,2198592,2757696
validation,588,88,90112,298,57216,147328
validation,589,16,16384,16,3072,19456
validation,590,272,278528,2842,545664,824192
validation,591,90,92160,312,59904,152064
validation,592,338,346112,4389,842688,1188800
validation,593,382,391168,5605,1076160,1467328
validation,594,51,52224,100,19200,71424
validation,595,96,98304,354,67968,166272
validation,596,85,87040,278,53376,140416
validation,597,40,40960,62,11904,52864
validation,598,46,47104,82,15744,62848
validation,599,22,22528,24,4608,27136
validation,600,581,594944,12966,2489472,3084416
validation,601,117,119808,526,100992,220800
validation,602,34,34816,45,8640,43456
validation,603,134,137216,690,132480,269696
validation,604,18,18432,17,3264,21696
validation,605,74,75776,211,40512,116288
validation,606,52,53248,104,19968,73216
validation,607,8,8192,7,1344,9536
validation,608,86,88064,285,54720,142784
validation,609,88,90112,298,57216,147328
validation,610,69,70656,183,35136,105792
validation,611,63,64512,153,29376,93888
validation,612,33,33792,42,8064,41856
validation,613,20,20480,24,4608,25088
validation,614,12,12288,9,1728,14016
validation,615,371,379904,5287,1015104,1395008
validation,616,92,94208,326,62592,156800
validation,617,5,5120,4,768,5888
validation,618,144,147456,797,153024,300480
validation,619,39,39936,62,11904,51840
validation,620,163,166912,1021,196032,362944
validation,621,233,238592,2086,400512,639104
validation,622,69,70656,183,35136,105792
validation,623,99,101376,377,72384,173760
validation,624,94,96256,340,65280,161536
validation,625,48,49152,100,19200,68352
validation,626,24,24576,28,5376,29952
validation,627,93,95232,333,63936,159168
validation,628,352,360448,4760,913920,1274368
validation,629,185,189440,1315,252480,441920
validation,630,72,73728,200,38400,112128
validation,631,32,32768,50,9600,42368
validation,632,309,316416,3668,704256,1020672
validation,633,58,59392,130,24960,84352
validation,634,63,64512,153,29376,93888
validation,635,23,23552,26,4992,28544
validation,636,50,51200,96,18432,69632
validation,637,310,317440,3692,708864,1026304
validation,638,240,245760,2213,424896,670656
validation,639,124,126976,591,113472,240448
validation,640,60,61440,139,26688,88128
validation,641,41,41984,71,13632,55616
validation,642,27,27648,31,5952,33600
validation,643,112,114688,482,92544,207232
validation,644,100,102400,385,73920,176320
validation,645,31,31744,37,7104,38848
validation,646,141,144384,764,146688,291072
validation,647,26,26624,28,5376,32000
validation,648,42,43008,68,13056,56064
validation,649,22,22528,23,4416,26944
validation,650,117,119808,526,100992,220800
validation,651,27,27648,31,5952,33600
validation,652,94,96256,340,65280,161536
validation,653,30,30720,37,7104,37824
validation,654,114,116736,500,96000,212736
validation,655,120,122880,554,106368,229248
validation,656,81,82944,252,48384,131328
validation,657,447,457728,7675,1473600,1931328
validation,658,71,72704,200,38400,111104
validation,659,8,8192,7,1344,9536
validation,660,76,77824,222,42624,120448
validation,661,41,41984,65,12480,54464
validation,662,42,43008,68,13056,56064
validation,663,137,140288,721,138432,278720
validation,664,104,106496,416,79872,186368
validation,665,107,109568,440,84480,194048
validation,666,26,26624,28,5376,32000
validation,667,319,326656,3909,750528,1077184
validation,668,84,86016,271,52032,138048
validation,669,35,35840,53,10176,46016
validation,670,319,326656,3909,750528,1077184
validation,671,131,134144,660,126720,260864
validation,672,174,178176,1163,223296,401472
validation,673,98,100352,369,70848,171200
validation,674,71,72704,194,37248,109952
validation,675,87,89088,291,55872,144960
validation,676,79,80896,240,46080,126976
validation,677,124,126976,591,113472,240448
validation,678,977,1000448,36664,7039488,8039936
validation,679,21,21504,19,3648,25152
validation,680,74,75776,211,40512,116288
validation,681,221,226304,1876,360192,586496
validation,682,385,394240,5694,1093248,1487488
validation,683,84,86016,271,52032,138048
validation,684,257,263168,2537,487104,750272
validation,685,180,184320,1245,239040,423360
validation,686,87,89088,291,55872,144960
validation,687,134,137216,690,132480,269696
validation,688,116,118784,517,99264,218048
validation,689,109,111616,457,87744,199360
validation,690,60,61440,139,26688,88128
validation,691,89,91136,305,58560,149696
validation,692,151,154624,876,168192,322816
validation,693,22,22528,21,4032,26560
validation,694,110,112640,465,89280,201920
validation,695,83,84992,265,50880,135872
validation,696,116,118784,517,99264,218048
validation,697,125,128000,601,115392,243392
validation,698,175,179200,1177,225984,405184
validation,699,63,64512,153,29376,93888
validation,700,27,27648,31,5952,33600
validation,701,70,71680,189,36288,107968
validation,702,75,76800,217,41664,118464
validation,703,43,44032,71,13632,57664
validation,704,23,23552,26,4992,28544
validation,705,45,46080,78,14976,61056
validation,706,75,76800,217,41664,118464
validation,707,281,287744,3033,582336,870080
validation,708,108,110592,448,86016,196608
validation,709,27,27648,33,6336,33984
validation,710,43,44032,75,14400,58432
validation,711,327,334848,4108,788736,1123584
validation,712,57,58368,130,24960,83328
validation,713,8,8192,9,1728,9920
validation,714,46,47104,82,15744,62848
validation,715,18,18432,16,3072,21504
validation,716,11,11264,9,1728,12992
validation,717,17,17408,19,3648,21056
validation,718,137,140288,721,138432,278720
validation,719,65,66560,163,31296,97856
validation,720,64,65536,158,30336,95872
validation,721,61,62464,143,27456,89920
validation,722,5,5120,4,768,5888
validation,723,93,95232,333,63936,159168
validation,724,223,228352,1911,366912,595264
validation,725,43,44032,78,14976,59008
validation,726,125,128000,601,115392,243392
validation,727,132,135168,670,128640,263808
validation,728,115,117760,508,97536,215296
validation,729,105,107520,424,81408,188928
validation,730,183,187392,1287,247104,434496
validation,731,558,571392,11960,2296320,2867712
validation,732,125,128000,601,115392,243392
validation,733,107,109568,440,84480,194048
validation,734,82,83968,259,49728,133696
validation,735,14,14336,12,2304,16640
validation,736,289,295936,3209,616128,912064
validation,737,6,6144,7,1344,7488
validation,738,70,71680,189,36288,107968
validation,739,267,273408,2739,525888,799296
validation,740,207,211968,1646,316032,528000
validation,741,385,394240,5694,1093248,1487488
validation,742,267,273408,2739,525888,799296
validation,743,83,84992,265,50880,135872
validation,744,96,98304,354,67968,166272
validation,745,215,220160,1776,340992,561152
validation,746,111,113664,474,91008,204672
validation,747,86,88064,285,54720,142784
validation,748,148,151552,842,161664,313216
validation,749,69,70656,183,35136,105792
validation,750,135,138240,700,134400,272640
validation,751,169,173056,1097,210624,383680
validation,752,39,39936,59,11328,51264
validation,753,141,144384,764,146688,291072
validation,754,46,47104,82,15744,62848
validation,755,802,821248,24706,4743552,5564800
validation,756,37,37888,53,10176,48064
validation,757,85,87040,278,53376,140416
validation,758,12,12288,12,2304,14592
validation,759,137,140288,721,138432,278720
validation,760,7,7168,7,1344,8512
validation,761,81,82944,252,48384,131328
validation,762,69,70656,183,35136,105792
validation,763,99,101376,377,72384,173760
validation,764,84,86016,271,52032,138048
validation,765,88,90112,298,57216,147328
validation,766,415,424960,6616,1270272,1695232
validation,767,42,43008,68,13056,56064
validation,768,119,121856,544,104448,226304
validation,769,57,58368,125,24000,82368
validation,770,46,47104,89,17088,64192
validation,771,41,41984,65,12480,54464
validation,772,132,135168,670,128640,263808
validation,773,15,15360,14,2688,18048
validation,774,106,108544,432,82944,191488
validation,775,53,54272,108,20736,75008
validation,776,69,70656,183,35136,105792
validation,777,50,51200,96,18432,69632
validation,778,47,48128,85,16320,64448
validation,779,12,12288,9,1728,14016
validation,780,290,296960,3231,620352,917312
validation,781,66,67584,168,32256,99840
validation,782,65,66560,163,31296,97856
validation,783,58,59392,130,24960,84352
validation,784,45,46080,78,14976,61056
validation,785,47,48128,85,16320,64448
validation,786,90,92160,312,59904,152064
validation,787,10,10240,10,1920,12160
validation,788,602,616448,13920,2672640,3289088
validation,789,234,239616,2104,403968,643584
validation,790,40,40960,62,11904,52864
validation,791,468,479232,8413,1615296,2094528
validation,792,94,96256,340,65280,161536
validation,793,78,79872,234,44928,124800
validation,794,87,89088,291,55872,144960
validation,795,81,82944,252,48384,131328
validation,796,61,62464,143,27456,89920
validation,797,11,11264,9,1728,12992
validation,798,7,7168,7,1344,8512
validation,799,37,37888,56,10752,48640
validation,800,23,23552,26,4992,28544
validation,801,32,32768,40,7680,40448
validation,802,118,120832,535,102720,223552
validation,803,54,55296,112,21504,76800
validation,804,109,111616,457,87744,199360
validation,805,72,73728,200,38400,112128
validation,806,50,51200,96,18432,69632
validation,807,196,200704,1476,283392,484096
validation,808,62,63488,148,28416,91904
validation,809,47,48128,85,16320,64448
validation,810,51,52224,100,19200,71424
validation,811,185,189440,1315,252480,441920
validation,812,50,51200,96,18432,69632
validation,813,120,122880,554,106368,229248
validation,814,79,80896,240,46080,126976
validation,815,85,87040,278,53376,140416
validation,816,179,183296,1231,236352,419648
validation,817,126,129024,610,117120,246144
validation,818,257,263168,2537,487104,750272
validation,819,222,227328,1893,363456,590784
validation,820,116,118784,517,99264,218048
validation,821,31,31744,37,7104,38848
validation,822,240,245760,2213,424896,670656
validation,823,49,50176,96,18432,68608
validation,824,74,75776,211,40512,116288
validation,825,55,56320,117,22464,78784
validation,826,59,60416,134,25728,86144
validation,827,85,87040,278,53376,140416
validation,828,124,126976,591,113472,240448
validation,829,252,258048,2440,468480,726528
validation,830,137,140288,721,138432,278720
validation,831,66,67584,168,32256,99840
validation,832,67,68608,173,33216,101824
validation,833,49,50176,93,17856,68032
validation,834,84,86016,271,52032,138048
validation,835,393,402432,5933,1139136,1541568
validation,836,54,55296,112,21504,76800
validation,837,122,124928,572,109824,234752
validation,838,632,647168,15342,2945664,3592832
validation,839,20,20480,23,4416,24896
validation,840,19,19456,19,3648,23104
validation,841,79,80896,240,46080,126976
validation,842,120,122880,554,106368,229248
validation,843,26,26624,35,6720,33344
validation,844,66,67584,168,32256,99840
validation,845,125,128000,601,115392,243392
validation,846,89,91136,305,58560,149696
validation,847,46,47104,82,15744,62848
validation,848,67,68608,173,33216,101824
validation,849,135,138240,700,134400,272640
validation,850,118,120832,535,102720,223552
validation,851,56,57344,121,23232,80576
validation,852,147,150528,830,159360,309888
validation,853,156,159744,935,179520,339264
validation,854,57,58368,125,24000,82368
validation,855,96,98304,354,67968,166272
validation,856,64,65536,158,30336,95872
validation,857,542,555008,11284,2166528,2721536
validation,858,44,45056,78,14976,60032
validation,859,123,125952,582,111744,237696
validation,860,54,55296,112,21504,76800
validation,861,86,88064,285,54720,142784
validation,862,66,67584,168,32256,99840
validation,863,103,105472,408,78336,183808
validation,864,211,216064,1711,328512,544576
validation,865,35,35840,48,9216,45056
validation,866,320,327680,3934,755328,1083008
validation,867,114,116736,500,96000,212736
validation,868,47,48128,89,17088,65216
validation,869,247,252928,2344,450048,702976
validation,870,71,72704,194,37248,109952
validation,871,99,101376,377,72384,173760
validation,872,45,46080,78,14976,61056
validation,873,117,119808,526,100992,220800
validation,874,233,238592,2086,400512,639104
validation,875,68,69632,178,34176,103808
validation,876,24,24576,28,5376,29952
validation,877,12,12288,10,1920,14208
validation,878,417,427008,6680,1282560,1709568
validation,879,48,49152,89,17088,66240
validation,880,13,13312,10,1920,15232
validation,881,86,88064,285,54720,142784
validation,882,574,587776,12656,2429952,3017728
validation,883,47,48128,85,16320,64448
validation,884,24,24576,26,4992,29568
validation,885,66,67584,168,32256,99840
validation,886,26,26624,28,5376,32000
validation,887,36,36864,53,10176,47040
validation,888,103,105472,408,78336,183808
validation,889,108,110592,448,86016,196608
validation,890,112,114688,482,92544,207232
validation,891,163,166912,1021,196032,362944
validation,892,69,70656,183,35136,105792
validation,893,242,247808,2250,432000,679808
validation,894,47,48128,85,16320,64448
validation,895,371,379904,5287,1015104,1395008
validation,896,313,320512,3763,722496,1043008
validation,897,85,87040,278,53376,140416
validation,898,51,52224,100,19200,71424
validation,899,76,77824,222,42624,120448
validation,900,9,9216,8,1536,10752
validation,901,116,118784,517,99264,218048
validation,902,59,60416,134,25728,86144
validation,903,16,16384,16,3072,19456
validation,904,61,62464,143,27456,89920
validation,905,177,181248,1204,231168,412416
validation,906,21,21504,21,4032,25536
validation,907,69,70656,183,35136,105792
validation,908,30,30720,35,6720,37440
validation,909,44,45056,75,14400,59456
validation,910,167,171008,1072,205824,376832
validation,911,65,66560,163,31296,97856
validation,912,274,280576,2884,553728,834304
validation,913,42,43008,68,13056,56064
validation,914,42,43008,68,13056,56064
validation,915,68,69632,178,34176,103808
validation,916,52,53248,104,19968,73216
validation,917,143,146432,786,150912,297344
validation,918,105,107520,424,81408,188928
validation,919,41,41984,65,12480,54464
validation,920,63,64512,153,29376,93888
validation,921,49,50176,96,18432,68608
validation,922,45,46080,78,14976,61056
validation,923,24,24576,26,4992,29568
validation,924,37,37888,56,10752,48640
validation,925,55,56320,117,22464,78784
validation,926,23,23552,24,4608,28160
validation,927,54,55296,112,21504,76800
validation,928,294,301056,3320,637440,938496
validation,929,26,26624,28,5376,32000
validation,930,53,54272,108,20736,75008
validation,931,107,109568,440,84480,194048
validation,932,75,76800,217,41664,118464
validation,933,59,60416,134,25728,86144
validation,934,122,124928,572,109824,234752
validation,935,10,10240,9,1728,11968
validation,936,138,141312,732,140544,281856
validation,937,15,15360,13,2496,17856
validation,938,83,84992,271,52032,137024
validation,939,398,407552,6085,1168320,1575872
validation,940,91,93184,319,61248,154432
validation,941,140,143360,753,144576,287936
validation,942,199,203776,1522,292224,496000
validation,943,59,60416,134,25728,86144
validation,944,230,235520,2032,390144,625664
validation,945,45,46080,78,14976,61056
validation,946,32,32768,40,7680,40448
validation,947,54,55296,112,21504,76800
validation,948,70,71680,189,36288,107968
validation,949,618,632832,14670,2816640,3449472
validation,950,139,142336,743,142656,284992
validation,951,48,49152,89,17088,66240
validation,952,195,199680,1461,280512,480192
validation,953,32,32768,40,7680,40448
validation,954,109,111616,457,87744,199360
validation,955,239,244736,2194,421248,665984
validation,956,88,90112,298,57216,147328
validation,957,73,74752,205,39360,114112
validation,958,121,123904,563,108096,232000
validation,959,54,55296,112,21504,76800
validation,960,26,26624,26,4992,31616
validation,961,38,38912,59,11328,50240
validation,962,26,26624,31,5952,32576
validation,963,65,66560,168,32256,98816
validation,964,134,137216,690,132480,269696
validation,965,101,103424,392,75264,178688
validation,966,68,69632,183,35136,104768
validation,967,17,17408,17,3264,20672
validation,968,95,97280,347,66624,163904
validation,969,239,244736,2194,421248,665984
validation,970,29,29696,37,7104,36800
validation,971,66,67584,168,32256,99840
validation,972,26,26624,28,5376,32000
validation,973,53,54272,108,20736,75008
validation,974,91,93184,319,61248,154432
validation,975,115,117760,508,97536,215296
validation,976,60,61440,139,26688,88128
validation,977,216,221184,1793,344256,565440
validation,978,172,176128,1137,218304,394432
validation,979,40,40960,62,11904,52864
validation,980,101,103424,392,75264,178688
validation,981,42,43008,68,13056,56064
validation,982,45,46080,78,14976,61056
validation,983,110,112640,465,89280,201920
validation,984,9,9216,6,1152,10368
validation,985,78,79872,234,44928,124800
validation,986,345,353280,4572,877824,1231104
validation,987,68,69632,178,34176,103808
validation,988,138,141312,732,140544,281856
validation,989,61,62464,143,27456,89920
validation,990,100,102400,385,73920,176320
validation,991,232,237568,2068,397056,634624
validation,992,69,70656,183,35136,105792
validation,993,138,141312,732,140544,281856
validation,994,72,73728,200,38400,112128
validation,995,285,291840,3120,599040,890880
validation,996,31,31744,37,7104,38848
validation,997,82,83968,259,49728,133696
validation,998,523,535552,10507,2017344,2552896
validation,999,85,87040,278,53376,140416
validation,1000,314,321536,3788,727296,1048832
validation,1001,54,55296,112,21504,76800
validation,1002,76,77824,222,42624,120448
validation,1003,302,309248,3504,672768,982016
validation,1004,28,28672,31,5952,34624
validation,1005,164,167936,1034,198528,366464
validation,1006,17,17408,17,3264,20672
validation,1007,71,72704,194,37248,109952
validation,1008,409,418816,6426,1233792,1652608
validation,1009,15,15360,14,2688,18048
validation,1010,91,93184,319,61248,154432
validation,1011,353,361472,4787,919104,1280576
validation,1012,170,174080,1111,213312,387392
validation,1013,113,115712,491,94272,209984
validation,1014,114,116736,500,96000,212736
validation,1015,45,46080,78,14976,61056
validation,1016,290,296960,3231,620352,917312
validation,1017,166,169984,1059,203328,373312
validation,1018,54,55296,112,21504,76800
validation,1019,26,26624,28,5376,32000
validation,1020,500,512000,9603,1843776,2355776
validation,1021,334,342016,4285,822720,1164736
validation,1022,77,78848,228,43776,122624
validation,1023,420,430080,6776,1300992,1731072
validation,1024,86,88064,285,54720,142784
validation,1025,223,228352,1911,366912,595264
validation,1026,29,29696,35,6720,36416
validation,1027,23,23552,23,4416,27968
validation,1028,25,25600,26,4992,30592
validation,1029,23,23552,24,4608,28160
validation,1030,82,83968,259,49728,133696
validation,1031,364,372736,5090,977280,1350016
validation,1032,40,40960,62,11904,52864
validation,1033,117,119808,526,100992,220800
validation,1034,133,136192,680,130560,266752
validation,1035,37,37888,59,11328,49216
validation,1036,72,73728,200,38400,112128
validation,1037,262,268288,2637,506304,774592
validation,1038,11,11264,9,1728,12992
validation,1039,64,65536,158,30336,95872
validation,1040,657,672768,16580,3183360,3856128
validation,1041,63,64512,153,29376,93888
validation,1042,683,699392,17918,3440256,4139648
validation,1043,138,141312,732,140544,281856
validation,1044,57,58368,125,24000,82368
validation,1045,25,25600,28,5376,30976
validation,1046,166,169984,1059,203328,373312
validation,1047,71,72704,194,37248,109952
validation,1048,37,37888,53,10176,48064
validation,1049,61,62464,143,27456,89920
validation,1050,8,8192,9,1728,9920
validation,1051,119,121856,544,104448,226304
validation,1052,97,99328,362,69504,168832
validation,1053,122,124928,572,109824,234752
validation,1054,29,29696,33,6336,36032
validation,1055,115,117760,508,97536,215296
validation,1056,115,117760,508,97536,215296
validation,1057,229,234496,2015,386880,621376
validation,1058,49,50176,93,17856,68032
validation,1059,192,196608,1416,271872,468480
validation,1060,105,107520,424,81408,188928
validation,1061,26,26624,33,6336,32960
validation,1062,62,63488,148,28416,91904
validation,1063,235,240640,2122,407424,648064
validation,1064,90,92160,312,59904,152064
validation,1065,159,162816,972,186624,349440
validation,1066,11,11264,12,2304,13568
validation,1067,8,8192,6,1152,9344
validation,1068,16,16384,14,2688,19072
validation,1069,35,35840,50,9600,45440
validation,1070,31,31744,37,7104,38848
validation,1071,315,322560,3812,731904,1054464
validation,1072,69,70656,183,35136,105792
validation,1073,51,52224,100,19200,71424
validation,1074,28,28672,33,6336,35008
validation,1075,66,67584,168,32256,99840
validation,1076,384,393216,5664,1087488,1480704
validation,1077,77,78848,228,43776,122624
validation,1078,257,263168,2537,487104,750272
validation,1079,41,41984,65,12480,54464
validation,1080,12,12288,9,1728,14016
validation,1081,103,105472,408,78336,183808
validation,1082,14,14336,13,2496,16832
validation,1083,214,219136,1759,337728,556864
validation,1084,171,175104,1124,215808,390912
validation,1085,31,31744,40,7680,39424
validation,1086,11,11264,9,1728,12992
validation,1087,50,51200,96,18432,69632
validation,1088,29,29696,33,6336,36032
validation,1089,357,365568,4896,940032,1305600
validation,1090,37,37888,59,11328,49216
validation,1091,88,90112,298,57216,147328
validation,1092,247,252928,2344,450048,702976
validation,1093,93,95232,333,63936,159168
validation,1094,100,102400,385,73920,176320
validation,1095,22,22528,24,4608,27136
validation,1096,10,10240,10,1920,12160
test,0,92,94208,326,62592,156800
test,1,108,110592,448,86016,196608
test,2,81,82944,252,48384,131328
test,3,60,61440,139,26688,88128
test,4,63,64512,153,29376,93888
test,5,30,30720,37,7104,37824
test,6,128,131072,630,120960,252032
test,7,65,66560,163,31296,97856
test,8,56,57344,121,23232,80576
test,9,109,111616,457,87744,199360
test,10,6,6144,5,960,7104
test,11,493,504832,9336,1792512,2297344
test,12,103,105472,408,78336,183808
test,13,235,240640,2122,407424,648064
test,14,153,156672,900,172800,329472
test,15,252,258048,2440,468480,726528
test,16,213,218112,1743,334656,552768
test,17,37,37888,53,10176,48064
test,18,233,238592,2086,400512,639104
test,19,11,11264,8,1536,12800
test,20,127,130048,620,119040,249088
test,21,24,24576,26,4992,29568
test,22,147,150528,830,159360,309888
test,23,74,75776,211,40512,116288
test,24,48,49152,89,17088,66240
test,25,221,226304,1876,360192,586496
test,26,60,61440,139,26688,88128
test,27,106,108544,432,82944,191488
test,28,105,107520,424,81408,188928
test,29,124,126976,591,113472,240448
test,30,117,119808,526,100992,220800
test,31,40,40960,65,12480,53440
test,32,48,49152,89,17088,66240
test,33,200,204800,1537,295104,499904
test,34,10,10240,7,1344,11584
test,35,93,95232,333,63936,159168
test,36,138,141312,732,140544,281856
test,37,24,24576,26,4992,29568
test,38,113,115712,491,94272,209984
test,39,52,53248,108,20736,73984
test,40,106,108544,440,84480,193024
test,41,23,23552,24,4608,28160
test,42,129,132096,640,122880,254976
test,43,93,95232,333,63936,159168
test,44,168,172032,1085,208320,380352
test,45,5,5120,6,1152,6272
test,46,63,64512,158,30336,94848
test,47,106,108544,432,82944,191488
test,48,82,83968,259,49728,133696
test,49,75,76800,217,41664,118464
test,50,51,52224,100,19200,71424
test,51,112,114688,482,92544,207232
test,52,45,46080,78,14976,61056
test,53,97,99328,362,69504,168832
test,54,78,79872,234,44928,124800
test,55,9,9216,8,1536,10752
test,56,27,27648,31,5952,33600
test,57,85,87040,278,53376,140416
test,58,97,99328,362,69504,168832
test,59,36,36864,50,9600,46464
test,60,8,8192,7,1344,9536
test,61,243,248832,2269,435648,684480
test,62,50,51200,96,18432,69632
test,63,85,87040,278,53376,140416
test,64,43,44032,71,13632,57664
test,65,77,78848,228,43776,122624
test,66,35,35840,48,9216,45056
test,67,121,123904,563,108096,232000
test,68,62,63488,148,28416,91904
test,69,134,137216,690,132480,269696
test,70,81,82944,252,48384,131328
test,71,41,41984,68,13056,55040
test,72,70,71680,189,36288,107968
test,73,122,124928,572,109824,234752
test,74,45,46080,78,14976,61056
test,75,59,60416,134,25728,86144
test,76,27,27648,31,5952,33600
test,77,148,151552,842,161664,313216
test,78,10,10240,8,1536,11776
test,79,96,98304,354,67968,166272
test,80,68,69632,178,34176,103808
test,81,59,60416,134,25728,86144
test,82,172,176128,1137,218304,394432
test,83,54,55296,112,21504,76800
test,84,114,116736,500,96000,212736
test,85,98,100352,369,70848,171200
test,86,113,115712,491,94272,209984
test,87,129,132096,640,122880,254976
test,88,116,118784,517,99264,218048
test,89,225,230400,1945,373440,603840
test,90,191,195584,1402,269184,464768
test,91,42,43008,68,13056,56064
test,92,54,55296,112,21504,76800
test,93,156,159744,935,179520,339264
test,94,37,37888,53,10176,48064
test,95,184,188416,1301,249792,438208
test,96,85,87040,278,53376,140416
test,97,59,60416,134,25728,86144
test,98,135,138240,700,134400,272640
test,99,37,37888,59,11328,49216
test,100,29,29696,37,7104,36800
test,101,521,533504,10427,2001984,2535488
test,102,107,109568,440,84480,194048
test,103,51,52224,100,19200,71424
test,104,113,115712,491,94272,209984
test,105,113,115712,491,94272,209984
test,106,107,109568,440,84480,194048
test,107,131,134144,660,126720,260864
test,108,67,68608,173,33216,101824
test,109,21,21504,23,4416,25920
test,110,89,91136,305,58560,149696
test,111,121,123904,563,108096,232000
test,112,37,37888,53,10176,48064
test,113,50,51200,96,18432,69632
test,114,114,116736,500,96000,212736
test,115,70,71680,189,36288,107968
test,116,199,203776,1522,292224,496000
test,117,213,218112,1743,334656,552768
test,118,158,161792,959,184128,345920
test,119,102,104448,400,76800,181248
test,120,97,99328,362,69504,168832
test,121,13,13312,10,1920,15232
test,122,21,21504,24,4608,26112
test,123,14,14336,9,1728,16064
test,124,22,22528,26,4992,27520
test,125,22,22528,24,4608,27136
test,126,114,116736,500,96000,212736
test,127,105,107520,424,81408,188928
test,128,385,394240,5694,1093248,1487488
test,129,407,416768,6363,1221696,1638464
test,130,4,4096,4,768,4864
test,131,50,51200,100,19200,70400
test,132,78,79872,240,46080,125952
test,133,55,56320,117,22464,78784
test,134,46,47104,82,15744,62848
test,135,107,109568,440,84480,194048
test,136,101,103424,392,75264,178688
test,137,59,60416,134,25728,86144
test,138,312,319488,3739,717888,1037376
test,139,50,51200,96,18432,69632
test,140,243,248832,2269,435648,684480
test,141,81,82944,252,48384,131328
test,142,138,141312,732,140544,281856
test,143,66,67584,168,32256,99840
test,144,93,95232,333,63936,159168
test,145,123,125952,582,111744,237696
test,146,78,79872,234,44928,124800
test,147,40,40960,62,11904,52864
test,148,119,121856,544,104448,226304
test,149,317,324608,3860,741120,1065728
test,150,37,37888,53,10176,48064
test,151,56,57344,121,23232,80576
test,152,155,158720,923,177216,335936
test,153,105,107520,424,81408,188928
test,154,10,10240,9,1728,11968
test,155,172,176128,1137,218304,394432
test,156,232,237568,2068,397056,634624
test,157,25,25600,28,5376,30976
test,158,6,6144,6,1152,7296
test,159,281,287744,3033,582336,870080
test,160,211,216064,1711,328512,544576
test,161,36,36864,53,10176,47040
test,162,321,328704,3958,759936,1088640
test,163,255,261120,2498,479616,740736
test,164,385,394240,5694,1093248,1487488
test,165,220,225280,1860,357120,582400
test,166,62,63488,148,28416,91904
test,167,46,47104,82,15744,62848
test,168,280,286720,3012,578304,865024
test,169,526,538624,10628,2040576,2579200
test,170,90,92160,312,59904,152064
test,171,25,25600,28,5376,30976
test,172,27,27648,28,5376,33024
test,173,81,82944,252,48384,131328
test,174,8,8192,6,1152,9344
test,175,37,37888,56,10752,48640
test,176,59,60416,134,25728,86144
test,177,51,52224,100,19200,71424
test,178,76,77824,222,42624,120448
test,179,12,12288,9,1728,14016
test,180,68,69632,178,34176,103808
test,181,8,8192,9,1728,9920
test,182,84,86016,271,52032,138048
test,183,336,344064,4337,832704,1176768
test,184,19,19456,21,4032,23488
test,185,58,59392,134,25728,85120
test,186,55,56320,117,22464,78784
test,187,6,6144,6,1152,7296
test,188,738,755712,20920,4016640,4772352
test,189,124,126976,591,113472,240448
test,190,76,77824,222,42624,120448
test,191,68,69632,178,34176,103808
test,192,153,156672,900,172800,329472
test,193,7,7168,6,1152,8320
test,194,80,81920,246,47232,129152
test,195,91,93184,319,61248,154432
test,196,492,503808,9298,1785216,2289024
test,197,116,118784,517,99264,218048
test,198,132,135168,670,128640,263808
test,199,42,43008,68,13056,56064
test,200,108,110592,448,86016,196608
test,201,8,8192,6,1152,9344
test,202,29,29696,35,6720,36416
test,203,123,125952,582,111744,237696
test,204,46,47104,82,15744,62848
test,205,271,277504,2821,541632,819136
test,206,25,25600,26,4992,30592
test,207,77,78848,228,43776,122624
test,208,36,36864,53,10176,47040
test,209,632,647168,15342,2945664,3592832
test,210,38,38912,56,10752,49664
test,211,101,103424,392,75264,178688
test,212,303,310272,3527,677184,987456
test,213,19,19456,16,3072,22528
test,214,230,235520,2032,390144,625664
test,215,70,71680,189,36288,107968
test,216,104,106496,416,79872,186368
test,217,185,189440,1315,252480,441920
test,218,48,49152,89,17088,66240
test,219,56,57344,121,23232,80576
test,220,32,32768,40,7680,40448
test,221,719,736256,19857,3812544,4548800
test,222,21,21504,21,4032,25536
test,223,9,9216,8,1536,10752
test,224,8,8192,6,1152,9344
test,225,66,67584,168,32256,99840
test,226,403,412672,6239,1197888,1610560
test,227,60,61440,139,26688,88128
test,228,41,41984,71,13632,55616
test,229,101,103424,392,75264,178688
test,230,98,100352,369,70848,171200
test,231,80,81920,246,47232,129152
test,232,35,35840,48,9216,45056
test,233,33,33792,45,8640,42432
test,234,133,136192,680,130560,266752
test,235,582,595968,13011,2498112,3094080
test,236,150,153600,865,166080,319680
test,237,129,132096,640,122880,254976
test,238,187,191488,1344,258048,449536
test,239,72,73728,200,38400,112128
test,240,178,182272,1217,233664,415936
test,241,143,146432,786,150912,297344
test,242,26,26624,33,6336,32960
test,243,87,89088,291,55872,144960
test,244,70,71680,189,36288,107968
test,245,49,50176,93,17856,68032
test,246,143,146432,786,150912,297344
test,247,275,281600,2905,557760,839360
test,248,232,237568,2068,397056,634624
test,249,88,90112,298,57216,147328
test,250,34,34816,45,8640,43456
test,251,78,79872,234,44928,124800
test,252,19,19456,21,4032,23488
test,253,220,225280,1860,357120,582400
test,254,28,28672,37,7104,35776
test,255,91,93184,319,61248,154432
test,256,59,60416,134,25728,86144
test,257,100,102400,385,73920,176320
test,258,51,52224,100,19200,71424
test,259,178,182272,1217,233664,415936
test,260,141,144384,764,146688,291072
test,261,58,59392,130,24960,84352
test,262,117,119808,526,100992,220800
test,263,553,566272,11747,2255424,2821696
test,264,45,46080,78,14976,61056
test,265,89,91136,305,58560,149696
test,266,100,102400,385,73920,176320
test,267,21,21504,19,3648,25152
test,268,117,119808,526,100992,220800
test,269,239,244736,2194,421248,665984
test,270,26,26624,28,5376,32000
test,271,6,6144,6,1152,7296
test,272,72,73728,200,38400,112128
test,273,29,29696,37,7104,36800
test,274,26,26624,26,4992,31616
test,275,71,72704,194,37248,109952
test,276,56,57344,121,23232,80576
test,277,57,58368,125,24000,82368
test,278,11,11264,9,1728,12992
test,279,519,531456,10347,1986624,2518080
test,280,14,14336,14,2688,17024
test,281,60,61440,139,26688,88128
test,282,24,24576,23,4416,28992
test,283,136,139264,711,136512,275776
test,284,56,57344,121,23232,80576
test,285,72,73728,200,38400,112128
test,286,219,224256,1843,353856,578112
test,287,15,15360,13,2496,17856
test,288,123,125952,582,111744,237696
test,289,113,115712,491,94272,209984
test,290,9,9216,9,1728,10944
test,291,7,7168,7,1344,8512
test,292,34,34816,48,9216,44032
test,293,127,130048,620,119040,249088
test,294,41,41984,65,12480,54464
test,295,34,34816,50,9600,44416
test,296,30,30720,37,7104,37824
test,297,9,9216,10,1920,11136
test,298,86,88064,285,54720,142784
test,299,9,9216,8,1536,10752
test,300,35,35840,48,9216,45056
test,301,483,494592,8961,1720512,2215104
test,302,65,66560,163,31296,97856
test,303,72,73728,200,38400,112128
test,304,98,100352,369,70848,171200
test,305,153,156672,900,172800,329472
test,306,49,50176,93,17856,68032
test,307,62,63488,148,28416,91904
test,308,66,67584,168,32256,99840
test,309,14,14336,10,1920,16256
test,310,78,79872,234,44928,124800
test,311,49,50176,93,17856,68032
test,312,119,121856,544,104448,226304
test,313,111,113664,474,91008,204672
test,314,249,254976,2382,457344,712320
test,315,78,79872,234,44928,124800
test,316,45,46080,78,14976,61056
test,317,12,12288,12,2304,14592
test,318,54,55296,112,21504,76800
test,319,64,65536,158,30336,95872
test,320,63,64512,153,29376,93888
test,321,49,50176,93,17856,68032
test,322,29,29696,37,7104,36800
test,323,110,112640,465,89280,201920
test,324,73,74752,205,39360,114112
test,325,201,205824,1552,297984,503808
test,326,10,10240,8,1536,11776
test,327,65,66560,163,31296,97856
test,328,25,25600,31,5952,31552
test,329,23,23552,24,4608,28160
test,330,329,336896,4158,798336,1135232
test,331,106,108544,432,82944,191488
test,332,196,200704,1476,283392,484096
test,333,120,122880,554,106368,229248
test,334,115,117760,508,97536,215296
test,335,97,99328,362,69504,168832
test,336,110,112640,465,89280,201920
test,337,369,377856,5230,1004160,1382016
test,338,97,99328,362,69504,168832
test,339,68,69632,178,34176,103808
test,340,84,86016,271,52032,138048
test,341,43,44032,71,13632,57664
test,342,41,41984,65,12480,54464
test,343,487,498688,9110,1749120,2247808
test,344,53,54272,108,20736,75008
test,345,64,65536,158,30336,95872
test,346,28,28672,31,5952,34624
test,347,14,14336,14,2688,17024
test,348,137,140288,721,138432,278720
test,349,70,71680,189,36288,107968
test,350,46,47104,82,15744,62848
test,351,37,37888,53,10176,48064
test,352,253,259072,2459,472128,731200
test,353,64,65536,158,30336,95872
test,354,73,74752,205,39360,114112
test,355,36,36864,50,9600,46464
test,356,25,25600,26,4992,30592
test,357,14,14336,13,2496,16832
test,358,131,134144,660,126720,260864
test,359,84,86016,271,52032,138048
test,360,322,329728,3983,764736,1094464
test,361,117,119808,526,100992,220800
test,362,59,60416,134,25728,86144
test,363,125,128000,601,115392,243392
test,364,10,10240,9,1728,11968
test,365,60,61440,139,26688,88128
test,366,14,14336,12,2304,16640
test,367,191,195584,1402,269184,464768
test,368,208,212992,1662,319104,532096
test,369,36,36864,56,10752,47616
test,370,80,81920,246,47232,129152
test,371,55,56320,117,22464,78784
test,372,123,125952,582,111744,237696
test,373,27,27648,33,6336,33984
test,374,29,29696,35,6720,36416
test,375,129,132096,640,122880,254976
test,376,11,11264,13,2496,13760
test,377,98,100352,369,70848,171200
test,378,11,11264,10,1920,13184
test,379,64,65536,158,30336,95872
test,380,154,157696,911,174912,332608
test,381,34,34816,45,8640,43456
test,382,120,122880,554,106368,229248
test,383,26,26624,31,5952,32576
test,384,262,268288,2637,506304,774592
test,385,56,57344,121,23232,80576
test,386,25,25600,26,4992,30592
test,387,67,68608,173,33216,101824
test,388,130,133120,650,124800,257920
test,389,97,99328,362,69504,168832
test,390,56,57344,121,23232,80576
test,391,61,62464,143,27456,89920
test,392,209,214016,1678,322176,536192
test,393,32,32768,40,7680,40448
test,394,155,158720,923,177216,335936
test,395,37,37888,53,10176,48064
test,396,42,43008,75,14400,57408
test,397,128,131072,630,120960,252032
test,398,25,25600,26,4992,30592
test,399,88,90112,298,57216,147328
test,400,242,247808,2250,432000,679808
test,401,126,129024,610,117120,246144
test,402,44,45056,75,14400,59456
test,403,154,157696,911,174912,332608
test,404,40,40960,62,11904,52864
test,405,78,79872,234,44928,124800
test,406,42,43008,68,13056,56064
test,407,15,15360,13,2496,17856
test,408,66,67584,168,32256,99840
test,409,452,462848,7848,1506816,1969664
test,410,40,40960,62,11904,52864
test,411,40,40960,65,12480,53440
test,412,57,58368,125,24000,82368
test,413,77,78848,228,43776,122624
test,414,51,52224,100,19200,71424
test,415,114,116736,500,96000,212736
test,416,51,52224,100,19200,71424
test,417,28,28672,31,5952,34624
test,418,49,50176,93,17856,68032
test,419,64,65536,158,30336,95872
test,420,24,24576,24,4608,29184
test,421,20,20480,23,4416,24896
test,422,419,429056,6744,1294848,1723904
test,423,68,69632,178,34176,103808
test,424,47,48128,89,17088,65216
test,425,167,171008,1072,205824,376832
test,426,57,58368,125,24000,82368
test,427,44,45056,75,14400,59456
test,428,26,26624,28,5376,32000
test,429,37,37888,53,10176,48064
test,430,51,52224,100,19200,71424
test,431,181,185344,1259,241728,427072
test,432,60,61440,139,26688,88128
test,433,13,13312,10,1920,15232
test,434,26,26624,28,5376,32000
test,435,93,95232,333,63936,159168
test,436,306,313344,3597,690624,1003968
test,437,88,90112,298,57216,147328
test,438,364,372736,5090,977280,1350016
test,439,133,136192,680,130560,266752
test,440,48,49152,89,17088,66240
test,441,183,187392,1287,247104,434496
test,442,64,65536,158,30336,95872
test,443,186,190464,1329,255168,445632
test,444,96,98304,354,67968,166272
test,445,355,363520,4841,929472,1292992
test,446,6,6144,6,1152,7296
test,447,98,100352,369,70848,171200
test,448,39,39936,59,11328,51264
test,449,118,120832,535,102720,223552
test,450,27,27648,31,5952,33600
test,451,36,36864,53,10176,47040
test,452,36,36864,53,10176,47040
test,453,221,226304,1876,360192,586496
test,454,141,144384,764,146688,291072
test,455,65,66560,163,31296,97856
test,456,245,250880,2306,442752,693632
test,457,44,45056,82,15744,60800
test,458,189,193536,1373,263616,457152
test,459,43,44032,75,14400,58432
test,460,54,55296,112,21504,76800
test,461,79,80896,240,46080,126976
test,462,87,89088,291,55872,144960
test,463,114,116736,500,96000,212736
test,464,100,102400,385,73920,176320
test,465,8,8192,8,1536,9728
test,466,102,104448,400,76800,181248
test,467,15,15360,14,2688,18048
test,468,75,76800,217,41664,118464
test,469,47,48128,85,16320,64448
test,470,123,125952,582,111744,237696
test,471,448,458752,7710,1480320,1939072
test,472,10,10240,9,1728,11968
test,473,66,67584,168,32256,99840
test,474,212,217088,1727,331584,548672
test,475,86,88064,285,54720,142784
test,476,46,47104,82,15744,62848
test,477,131,134144,660,126720,260864
test,478,87,89088,291,55872,144960
test,479,77,78848,228,43776,122624
test,480,6,6144,6,1152,7296
test,481,313,320512,3763,722496,1043008
test,482,139,142336,743,142656,284992
test,483,159,162816,972,186624,349440
test,484,72,73728,200,38400,112128
test,485,88,90112,298,57216,147328
test,486,221,226304,1876,360192,586496
test,487,158,161792,959,184128,345920
test,488,133,136192,680,130560,266752
test,489,177,181248,1204,231168,412416
test,490,87,89088,291,55872,144960
test,491,84,86016,271,52032,138048
test,492,8,8192,7,1344,9536
test,493,56,57344,121,23232,80576
test,494,101,103424,392,75264,178688
test,495,127,130048,620,119040,249088
test,496,18,18432,17,3264,21696
test,497,42,43008,68,13056,56064
test,498,69,70656,183,35136,105792
test,499,61,62464,143,27456,89920
test,500,46,47104,82,15744,62848
test,501,18,18432,21,4032,22464
test,502,61,62464,143,27456,89920
test,503,68,69632,178,34176,103808
test,504,374,382976,5373,1031616,1414592
test,505,149,152576,853,163776,316352
test,506,47,48128,85,16320,64448
test,507,79,80896,240,46080,126976
test,508,177,181248,1204,231168,412416
test,509,295,302080,3343,641856,943936
test,510,340,348160,4441,852672,1200832
test,511,301,308224,3480,668160,976384
test,512,10,10240,9,1728,11968
test,513,116,118784,517,99264,218048
test,514,49,50176,93,17856,68032
test,515,116,118784,517,99264,218048
test,516,57,58368,125,24000,82368
test,517,28,28672,35,6720,35392
test,518,114,116736,500,96000,212736
test,519,48,49152,89,17088,66240
test,520,296,303104,3366,646272,949376
test,521,70,71680,189,36288,107968
test,522,50,51200,96,18432,69632
test,523,137,140288,721,138432,278720
test,524,99,101376,377,72384,173760
test,525,91,93184,319,61248,154432
test,526,501,513024,9641,1851072,2364096
test,527,146,149504,819,157248,306752
test,528,121,123904,563,108096,232000
test,529,23,23552,26,4992,28544
test,530,60,61440,139,26688,88128
test,531,52,53248,104,19968,73216
test,532,413,422912,6552,1257984,1680896
test,533,824,843776,26080,5007360,5851136
test,534,59,60416,134,25728,86144
test,535,53,54272,108,20736,75008
test,536,190,194560,1387,266304,460864
test,537,43,44032,75,14400,58432
test,538,39,39936,59,11328,51264
test,539,114,116736,500,96000,212736
test,540,10,10240,8,1536,11776
test,541,12,12288,12,2304,14592
test,542,6,6144,5,960,7104
test,543,70,71680,189,36288,107968
test,544,51,52224,100,19200,71424
test,545,81,82944,252,48384,131328
test,546,258,264192,2557,490944,755136
test,547,9,9216,10,1920,11136
test,548,70,71680,189,36288,107968
test,549,92,94208,326,62592,156800
test,550,415,424960,6616,1270272,1695232
test,551,38,38912,56,10752,49664
test,552,113,115712,491,94272,209984
test,553,52,53248,104,19968,73216
test,554,275,281600,2905,557760,839360
test,555,58,59392,130,24960,84352
test,556,66,67584,168,32256,99840
test,557,126,129024,610,117120,246144
test,558,14,14336,13,2496,16832
test,559,54,55296,117,22464,77760
test,560,67,68608,173,33216,101824
test,561,39,39936,59,11328,51264
test,562,26,26624,28,5376,32000
test,563,36,36864,50,9600,46464
test,564,92,94208,326,62592,156800
test,565,68,69632,178,34176,103808
test,566,37,37888,56,10752,48640
test,567,16,16384,13,2496,18880
test,568,41,41984,65,12480,54464
test,569,131,134144,660,126720,260864
test,570,62,63488,148,28416,91904
test,571,30,30720,37,7104,37824
test,572,90,92160,312,59904,152064
test,573,208,212992,1662,319104,532096
test,574,95,97280,347,66624,163904
test,575,9,9216,8,1536,10752
test,576,47,48128,85,16320,64448
test,577,153,156672,900,172800,329472
test,578,220,225280,1860,357120,582400
test,579,39,39936,59,11328,51264
test,580,46,47104,85,16320,63424
test,581,144,147456,797,153024,300480
test,582,419,429056,6744,1294848,1723904
test,583,88,90112,298,57216,147328
test,584,56,57344,121,23232,80576
test,585,568,581632,12393,2379456,2961088
test,586,48,49152,89,17088,66240
test,587,200,204800,1537,295104,499904
test,588,76,77824,222,42624,120448
test,589,27,27648,28,5376,33024
test,590,232,237568,2068,397056,634624
test,591,9,9216,6,1152,10368
test,592,23,23552,26,4992,28544
test,593,520,532480,10387,1994304,2526784
test,594,117,119808,526,100992,220800
test,595,120,122880,554,106368,229248
test,596,25,25600,26,4992,30592
test,597,79,80896,240,46080,126976
test,598,79,80896,240,46080,126976
test,599,26,26624,28,5376,32000
test,600,26,26624,33,6336,32960
test,601,61,62464,143,27456,89920
test,602,25,25600,26,4992,30592
test,603,206,210944,1630,312960,523904
test,604,55,56320,117,22464,78784
test,605,33,33792,45,8640,42432
test,606,48,49152,89,17088,66240
test,607,53,54272,108,20736,75008
test,608,52,53248,104,19968,73216
test,609,85,87040,278,53376,140416
test,610,176,180224,1190,228480,408704
test,611,115,117760,508,97536,215296
test,612,39,39936,62,11904,51840
test,613,35,35840,50,9600,45440
test,614,94,96256,340,65280,161536
test,615,79,80896,240,46080,126976
test,616,35,35840,50,9600,45440
test,617,90,92160,312,59904,152064
test,618,72,73728,200,38400,112128
test,619,108,110592,448,86016,196608
test,620,111,113664,474,91008,204672
test,621,221,226304,1876,360192,586496
test,622,111,113664,474,91008,204672
test,623,36,36864,50,9600,46464
test,624,177,181248,1204,231168,412416
test,625,57,58368,130,24960,83328
test,626,26,26624,28,5376,32000
test,627,82,83968,259,49728,133696
test,628,77,78848,228,43776,122624
test,629,66,67584,168,32256,99840
test,630,153,156672,900,172800,329472
test,631,15,15360,17,3264,18624
test,632,29,29696,33,6336,36032
test,633,113,115712,491,94272,209984
test,634,71,72704,194,37248,109952
test,635,111,113664,474,91008,204672
test,636,70,71680,189,36288,107968
test,637,206,210944,1630,312960,523904
test,638,113,115712,491,94272,209984
test,639,7,7168,6,1152,8320
test,640,316,323584,3836,736512,1060096
test,641,194,198656,1446,277632,476288
test,642,11,11264,10,1920,13184
test,643,54,55296,112,21504,76800
test,644,190,194560,1387,266304,460864
test,645,63,64512,153,29376,93888
test,646,122,124928,572,109824,234752
test,647,129,132096,640,122880,254976
test,648,52,53248,108,20736,73984
test,649,36,36864,50,9600,46464
test,650,34,34816,48,9216,44032
test,651,82,83968,259,49728,133696
test,652,122,124928,572,109824,234752
test,653,58,59392,130,24960,84352
test,654,28,28672,33,6336,35008
test,655,819,838656,25765,4946880,5785536
test,656,223,228352,1911,366912,595264
test,657,159,162816,972,186624,349440
test,658,54,55296,112,21504,76800
test,659,77,78848,228,43776,122624
test,660,144,147456,797,153024,300480
test,661,82,83968,259,49728,133696
test,662,108,110592,448,86016,196608
test,663,46,47104,82,15744,62848
test,664,78,79872,234,44928,124800
test,665,299,306176,3434,659328,965504
test,666,47,48128,85,16320,64448
test,667,254,260096,2479,475968,736064
test,668,29,29696,37,7104,36800
test,669,147,150528,830,159360,309888
test,670,119,121856,544,104448,226304
test,671,16,16384,14,2688,19072
test,672,61,62464,143,27456,89920
test,673,272,278528,2842,545664,824192
test,674,100,102400,385,73920,176320
test,675,51,52224,100,19200,71424
test,676,183,187392,1287,247104,434496
test,677,256,262144,2518,483456,745600
test,678,88,90112,298,57216,147328
test,679,54,55296,112,21504,76800
test,680,195,199680,1461,280512,480192
test,681,25,25600,28,5376,30976
test,682,72,73728,205,39360,113088
test,683,213,218112,1743,334656,552768
test,684,139,142336,743,142656,284992
test,685,67,68608,173,33216,101824
test,686,64,65536,158,30336,95872
test,687,136,139264,711,136512,275776
test,688,102,104448,400,76800,181248
test,689,163,166912,1021,196032,362944
test,690,40,40960,68,13056,54016
test,691,84,86016,271,52032,138048
test,692,110,112640,465,89280,201920
test,693,151,154624,876,168192,322816
test,694,43,44032,75,14400,58432
test,695,13,13312,12,2304,15616
test,696,52,53248,104,19968,73216
test,697,57,58368,125,24000,82368
test,698,37,37888,53,10176,48064
test,699,48,49152,89,17088,66240
test,700,106,108544,432,82944,191488
test,701,161,164864,996,191232,356096
test,702,8,8192,7,1344,9536
test,703,115,117760,508,97536,215296
test,704,91,93184,319,61248,154432
test,705,9,9216,8,1536,10752
test,706,128,131072,630,120960,252032
test,707,65,66560,163,31296,97856
test,708,387,396288,5753,1104576,1500864
test,709,36,36864,50,9600,46464
test,710,302,309248,3504,672768,982016
test,711,350,358400,4706,903552,1261952
test,712,45,46080,78,14976,61056
test,713,666,681984,17038,3271296,3953280
test,714,331,338944,4209,808128,1147072
test,715,58,59392,130,24960,84352
test,716,168,172032,1085,208320,380352
test,717,106,108544,432,82944,191488
test,718,217,222208,1809,347328,569536
test,719,79,80896,246,47232,128128
test,720,129,132096,640,122880,254976
test,721,37,37888,53,10176,48064
test,722,91,93184,319,61248,154432
test,723,107,109568,440,84480,194048
test,724,22,22528,23,4416,26944
test,725,82,83968,259,49728,133696
test,726,75,76800,217,41664,118464
test,727,23,23552,24,4608,28160
test,728,59,60416,134,25728,86144
test,729,85,87040,278,53376,140416
test,730,54,55296,112,21504,76800
test,731,624,638976,14956,2871552,3510528
test,732,40,40960,65,12480,53440
test,733,244,249856,2287,439104,688960
test,734,67,68608,173,33216,101824
test,735,56,57344,121,23232,80576
test,736,321,328704,3958,759936,1088640
test,737,14,14336,12,2304,16640
test,738,51,52224,100,19200,71424
test,739,68,69632,178,34176,103808
test,740,11,11264,12,2304,13568
test,741,542,555008,11284,2166528,2721536
test,742,57,58368,125,24000,82368
test,743,104,106496,416,79872,186368
test,744,106,108544,432,82944,191488
test,745,208,212992,1662,319104,532096
test,746,43,44032,71,13632,57664
test,747,34,34816,53,10176,44992
test,748,82,83968,259,49728,133696
test,749,194,198656,1446,277632,476288
test,750,9,9216,6,1152,10368
test,751,28,28672,33,6336,35008
test,752,7,7168,6,1152,8320
test,753,27,27648,31,5952,33600
test,754,112,114688,482,92544,207232
test,755,233,238592,2086,400512,639104
test,756,291,297984,3253,624576,922560
test,757,288,294912,3186,611712,906624
test,758,53,54272,108,20736,75008
test,759,111,113664,474,91008,204672
test,760,80,81920,246,47232,129152
test,761,58,59392,130,24960,84352
test,762,8,8192,6,1152,9344
test,763,347,355328,4625,888000,1243328
test,764,117,119808,526,100992,220800
test,765,49,50176,93,17856,68032
test,766,10,10240,9,1728,11968
test,767,52,53248,104,19968,73216
test,768,364,372736,5090,977280,1350016
test,769,358,366592,4923,945216,1311808
test,770,40,40960,65,12480,53440
test,771,49,50176,93,17856,68032
test,772,19,19456,23,4416,23872
test,773,119,121856,544,104448,226304
test,774,94,96256,340,65280,161536
test,775,160,163840,984,188928,352768
test,776,95,97280,347,66624,163904
test,777,79,80896,240,46080,126976
test,778,232,237568,2068,397056,634624
test,779,76,77824,222,42624,120448
test,780,51,52224,100,19200,71424
test,781,357,365568,4896,940032,1305600
test,782,53,54272,108,20736,75008
test,783,52,53248,104,19968,73216
test,784,154,157696,911,174912,332608
test,785,91,93184,319,61248,154432
test,786,63,64512,153,29376,93888
test,787,105,107520,424,81408,188928
test,788,248,253952,2363,453696,707648
test,789,494,505856,9374,1799808,2305664
test,790,26,26624,28,5376,32000
test,791,59,60416,134,25728,86144
test,792,202,206848,1568,301056,507904
test,793,117,119808,526,100992,220800
test,794,58,59392,130,24960,84352
test,795,124,126976,591,113472,240448
test,796,17,17408,16,3072,20480
test,797,17,17408,16,3072,20480
test,798,40,40960,65,12480,53440
test,799,70,71680,189,36288,107968
test,800,632,647168,15342,2945664,3592832
test,801,252,258048,2440,468480,726528
test,802,166,169984,1059,203328,373312
test,803,29,29696,33,6336,36032
test,804,114,116736,500,96000,212736
test,805,573,586752,12612,2421504,3008256
test,806,14,14336,12,2304,16640
test,807,89,91136,305,58560,149696
test,808,209,214016,1678,322176,536192
test,809,54,55296,112,21504,76800
test,810,96,98304,354,67968,166272
test,811,20,20480,21,4032,24512
test,812,51,52224,100,19200,71424
test,813,92,94208,326,62592,156800
test,814,30,30720,35,6720,37440
test,815,43,44032,78,14976,59008
test,816,68,69632,178,34176,103808
test,817,237,242688,2158,414336,657024
test,818,137,140288,721,138432,278720
test,819,139,142336,743,142656,284992
test,820,874,894976,29341,5633472,6528448
test,821,82,83968,259,49728,133696
test,822,144,147456,797,153024,300480
test,823,73,74752,205,39360,114112
test,824,110,112640,465,89280,201920
test,825,87,89088,291,55872,144960
test,826,49,50176,93,17856,68032
test,827,202,206848,1568,301056,507904
test,828,37,37888,53,10176,48064
test,829,96,98304,354,67968,166272
test,830,68,69632,178,34176,103808
test,831,223,228352,1911,366912,595264
test,832,68,69632,178,34176,103808
test,833,260,266240,2597,498624,764864
test,834,59,60416,134,25728,86144
test,835,384,393216,5664,1087488,1480704
test,836,69,70656,183,35136,105792
test,837,7,7168,6,1152,8320
test,838,79,80896,240,46080,126976
test,839,515,527360,10188,1956096,2483456
test,840,85,87040,285,54720,141760
test,841,216,221184,1793,344256,565440
test,842,34,34816,53,10176,44992
test,843,48,49152,89,17088,66240
test,844,39,39936,62,11904,51840
test,845,140,143360,753,144576,287936
test,846,99,101376,377,72384,173760
test,847,7,7168,5,960,8128
test,848,91,93184,319,61248,154432
test,849,249,254976,2382,457344,712320
test,850,28,28672,33,6336,35008
test,851,80,81920,246,47232,129152
test,852,53,54272,108,20736,75008
test,853,54,55296,112,21504,76800
test,854,152,155648,888,170496,326144
test,855,108,110592,448,86016,196608
test,856,13,13312,10,1920,15232
test,857,30,30720,37,7104,37824
test,858,10,10240,9,1728,11968
test,859,59,60416,134,25728,86144
test,860,599,613376,13782,2646144,3259520
test,861,52,53248,108,20736,73984
test,862,84,86016,271,52032,138048
test,863,148,151552,842,161664,313216
test,864,63,64512,153,29376,93888
test,865,74,75776,211,40512,116288
test,866,96,98304,354,67968,166272
test,867,104,106496,416,79872,186368
test,868,14,14336,12,2304,16640
test,869,44,45056,75,14400,59456
test,870,181,185344,1259,241728,427072
test,871,7,7168,8,1536,8704
test,872,45,46080,78,14976,61056
test,873,88,90112,298,57216,147328
test,874,103,105472,408,78336,183808
test,875,45,46080,78,14976,61056
test,876,262,268288,2637,506304,774592
test,877,132,135168,670,128640,263808
test,878,52,53248,104,19968,73216
test,879,113,115712,491,94272,209984
test,880,153,156672,900,172800,329472
test,881,35,35840,48,9216,45056
test,882,179,183296,1231,236352,419648
test,883,266,272384,2718,521856,794240
test,884,154,157696,911,174912,332608
test,885,10,10240,9,1728,11968
test,886,101,103424,392,75264,178688
test,887,77,78848,228,43776,122624
test,888,83,84992,265,50880,135872
test,889,94,96256,340,65280,161536
test,890,116,118784,526,100992,219776
test,891,51,52224,100,19200,71424
test,892,97,99328,362,69504,168832
test,893,129,132096,640,122880,254976
test,894,108,110592,448,86016,196608
test,895,39,39936,59,11328,51264
test,896,111,113664,474,91008,204672
test,897,652,667648,16329,3135168,3802816
test,898,83,84992,265,50880,135872
test,899,40,40960,62,11904,52864
test,900,74,75776,211,40512,116288
test,901,77,78848,228,43776,122624
test,902,56,57344,121,23232,80576
test,903,64,65536,163,31296,96832
test,904,35,35840,53,10176,46016
test,905,57,58368,130,24960,83328
test,906,274,280576,2884,553728,834304
test,907,97,99328,369,70848,170176
test,908,64,65536,158,30336,95872
test,909,97,99328,362,69504,168832
test,910,40,40960,62,11904,52864
test,911,73,74752,205,39360,114112
test,912,117,119808,526,100992,220800
test,913,50,51200,96,18432,69632
test,914,239,244736,2194,421248,665984
test,915,129,132096,640,122880,254976
test,916,39,39936,59,11328,51264
test,917,88,90112,298,57216,147328
test,918,51,52224,100,19200,71424
test,919,233,238592,2086,400512,639104
test,920,132,135168,670,128640,263808
test,921,47,48128,85,16320,64448
test,922,157,160768,947,181824,342592
test,923,229,234496,2015,386880,621376
test,924,63,64512,153,29376,93888
test,925,520,532480,10387,1994304,2526784
test,926,126,129024,610,117120,246144
test,927,32,32768,45,8640,41408
test,928,52,53248,117,22464,75712
test,929,37,37888,53,10176,48064
test,930,6,6144,6,1152,7296
test,931,32,32768,40,7680,40448
test,932,69,70656,183,35136,105792
test,933,66,67584,168,32256,99840
test,934,68,69632,178,34176,103808
test,935,121,123904,563,108096,232000
test,936,8,8192,9,1728,9920
test,937,55,56320,117,22464,78784
test,938,45,46080,78,14976,61056
test,939,225,230400,1945,373440,603840
test,940,72,73728,200,38400,112128
test,941,130,133120,650,124800,257920
test,942,44,45056,75,14400,59456
test,943,115,117760,508,97536,215296
test,944,87,89088,291,55872,144960
test,945,45,46080,78,14976,61056
test,946,78,79872,234,44928,124800
test,947,212,217088,1727,331584,548672
test,948,114,116736,500,96000,212736
test,949,124,126976,591,113472,240448
test,950,43,44032,71,13632,57664
test,951,228,233472,1997,383424,616896
test,952,345,353280,4572,877824,1231104
test,953,92,94208,326,62592,156800
test,954,48,49152,89,17088,66240
test,955,285,291840,3120,599040,890880
test,956,52,53248,104,19968,73216
test,957,13,13312,9,1728,15040
test,958,38,38912,59,11328,50240
test,959,56,57344,121,23232,80576
test,960,90,92160,312,59904,152064
test,961,137,140288,721,138432,278720
test,962,72,73728,200,38400,112128
test,963,122,124928,572,109824,234752
test,964,716,733184,19692,3780864,4514048
test,965,192,196608,1416,271872,468480
test,966,61,62464,143,27456,89920
test,967,423,433152,6873,1319616,1752768
test,968,72,73728,200,38400,112128
test,969,66,67584,168,32256,99840
test,970,28,28672,35,6720,35392
test,971,78,79872,234,44928,124800
test,972,32,32768,40,7680,40448
test,973,282,288768,3055,586560,875328
test,974,349,357376,4679,898368,1255744
test,975,61,62464,143,27456,89920
test,976,19,19456,19,3648,23104
test,977,331,338944,4209,808128,1147072
test,978,75,76800,217,41664,118464
test,979,127,130048,620,119040,249088
test,980,73,74752,205,39360,114112
test,981,77,78848,228,43776,122624
test,982,32,32768,40,7680,40448
test,983,86,88064,285,54720,142784
test,984,201,205824,1552,297984,503808
test,985,92,94208,326,62592,156800
test,986,65,66560,163,31296,97856
test,987,61,62464,143,27456,89920
test,988,492,503808,9298,1785216,2289024
test,989,6,6144,6,1152,7296
test,990,78,79872,234,44928,124800
test,991,106,108544,432,82944,191488
test,992,58,59392,130,24960,84352
test,993,144,147456,797,153024,300480
test,994,47,48128,85,16320,64448
test,995,24,24576,24,4608,29184
test,996,132,135168,670,128640,263808
test,997,81,82944,259,49728,132672
test,998,228,233472,1997,383424,616896
test,999,231,236544,2050,393600,630144
test,1000,69,70656,194,37248,107904
test,1001,64,65536,158,30336,95872
test,1002,51,52224,112,21504,73728
test,1003,70,71680,189,36288,107968
test,1004,26,26624,28,5376,32000
test,1005,169,173056,1097,210624,383680
test,1006,122,124928,572,109824,234752
test,1007,114,116736,500,96000,212736
test,1008,42,43008,71,13632,56640
test,1009,76,77824,222,42624,120448
test,1010,58,59392,130,24960,84352
test,1011,214,219136,1759,337728,556864
test,1012,54,55296,112,21504,76800
test,1013,171,175104,1124,215808,390912
test,1014,8,8192,7,1344,9536
test,1015,187,191488,1344,258048,449536
test,1016,290,296960,3231,620352,917312
test,1017,89,91136,305,58560,149696
test,1018,238,243712,2176,417792,661504
test,1019,111,113664,474,91008,204672
test,1020,10,10240,8,1536,11776
test,1021,456,466944,7987,1533504,2000448
test,1022,91,93184,319,61248,154432
test,1023,73,74752,205,39360,114112
test,1024,51,52224,100,19200,71424
test,1025,98,100352,369,70848,171200
test,1026,5,5120,5,960,6080
test,1027,64,65536,158,30336,95872
test,1028,67,68608,173,33216,101824
test,1029,66,67584,178,34176,101760
test,1030,25,25600,26,4992,30592
test,1031,212,217088,1727,331584,548672
test,1032,351,359424,4733,908736,1268160
test,1033,139,142336,743,142656,284992
test,1034,33,33792,45,8640,42432
test,1035,89,91136,305,58560,149696
test,1036,31,31744,40,7680,39424
test,1037,30,30720,45,8640,39360
test,1038,66,67584,168,32256,99840
test,1039,58,59392,130,24960,84352
test,1040,47,48128,85,16320,64448
test,1041,75,76800,217,41664,118464
test,1042,87,89088,298,57216,146304
test,1043,310,317440,3692,708864,1026304
test,1044,103,105472,408,78336,183808
test,1045,161,164864,996,191232,356096
test,1046,53,54272,108,20736,75008
test,1047,70,71680,189,36288,107968
test,1048,391,400384,5873,1127616,1528000
test,1049,78,79872,234,44928,124800
test,1050,59,60416,134,25728,86144
test,1051,35,35840,48,9216,45056
test,1052,38,38912,59,11328,50240
test,1053,48,49152,89,17088,66240
test,1054,61,62464,143,27456,89920
test,1055,125,128000,601,115392,243392
test,1056,95,97280,347,66624,163904
test,1057,170,174080,1111,213312,387392
test,1058,87,89088,291,55872,144960
test,1059,297,304128,3389,650688,954816
test,1060,62,63488,148,28416,91904
test,1061,174,178176,1163,223296,401472
test,1062,206,210944,1630,312960,523904
test,1063,125,128000,601,115392,243392
test,1064,110,112640,465,89280,201920
test,1065,532,544768,10871,2087232,2632000
test,1066,207,211968,1646,316032,528000
test,1067,45,46080,78,14976,61056
test,1068,115,117760,508,97536,215296
test,1069,12,12288,9,1728,14016
test,1070,67,68608,173,33216,101824
test,1071,176,180224,1190,228480,408704
test,1072,116,118784,517,99264,218048
test,1073,50,51200,96,18432,69632
test,1074,81,82944,252,48384,131328
test,1075,35,35840,53,10176,46016
test,1076,12,12288,9,1728,14016
test,1077,577,590848,12788,2455296,3046144
test,1078,74,75776,211,40512,116288
test,1079,152,155648,888,170496,326144
test,1080,55,56320,117,22464,78784
test,1081,45,46080,78,14976,61056
test,1082,49,50176,93,17856,68032
test,1083,91,93184,319,61248,154432
test,1084,144,147456,797,153024,300480
test,1085,79,80896,240,46080,126976
test,1086,124,126976,591,113472,240448
test,1087,33,33792,45,8640,42432
test,1088,119,121856,544,104448,226304
test,1089,55,56320,117,22464,78784
test,1090,102,104448,400,76800,181248
test,1091,37,37888,53,10176,48064
test,1092,15,15360,19,3648,19008
test,1093,145,148480,808,155136,303616
test,1094,66,67584,168,32256,99840
test,1095,217,222208,1809,347328,569536
test,1096,7,7168,7,1344,8512
test,1097,50,51200,96,18432,69632
test,1098,105,107520,424,81408,188928
test,1099,165,168960,1046,200832,369792
test,1100,113,115712,491,94272,209984
test,1101,48,49152,93,17856,67008
test,1102,80,81920,246,47232,129152
test,1103,102,104448,400,76800,181248
test,1104,59,60416,134,25728,86144
test,1105,106,108544,432,82944,191488
test,1106,135,138240,700,134400,272640
test,1107,265,271360,2698,518016,789376
test,1108,61,62464,143,27456,89920
test,1109,75,76800,217,41664,118464
test,1110,225,230400,1945,373440,603840
test,1111,41,41984,65,12480,54464
test,1112,950,972800,34666,6655872,7628672
test,1113,143,146432,786,150912,297344
test,1114,84,86016,271,52032,138048
test,1115,419,429056,6744,1294848,1723904
test,1116,30,30720,37,7104,37824
test,1117,55,56320,117,22464,78784
test,1118,160,163840,984,188928,352768
test,1119,451,461824,7813,1500096,1961920
test,1120,120,122880,554,106368,229248
test,1121,42,43008,71,13632,56640
test,1122,112,114688,482,92544,207232
test,1123,136,139264,711,136512,275776
test,1124,118,120832,535,102720,223552
test,1125,103,105472,408,78336,183808
test,1126,59,60416,134,25728,86144
test,1127,26,26624,28,5376,32000
test,1128,65,66560,163,31296,97856
test,1129,298,305152,3411,654912,960064
test,1130,25,25600,26,4992,30592
test,1131,310,317440,3692,708864,1026304
test,1132,26,26624,26,4992,31616
test,1133,176,180224,1190,228480,408704
test,1134,74,75776,211,40512,116288
test,1135,23,23552,23,4416,27968
test,1136,45,46080,78,14976,61056
test,1137,112,114688,482,92544,207232
test,1138,10,10240,8,1536,11776
test,1139,13,13312,12,2304,15616
test,1140,57,58368,125,24000,82368
test,1141,202,206848,1568,301056,507904
test,1142,42,43008,68,13056,56064
test,1143,285,291840,3120,599040,890880
test,1144,102,104448,400,76800,181248
test,1145,64,65536,158,30336,95872
test,1146,54,55296,112,21504,76800
test,1147,11,11264,8,1536,12800
test,1148,95,97280,347,66624,163904
test,1149,192,196608,1416,271872,468480
test,1150,12,12288,12,2304,14592
test,1151,30,30720,40,7680,38400
test,1152,62,63488,148,28416,91904
test,1153,198,202752,1506,289152,491904
test,1154,77,78848,228,43776,122624
test,1155,33,33792,45,8640,42432
test,1156,38,38912,59,11328,50240
test,1157,89,91136,305,58560,149696
test,1158,21,21504,24,4608,26112
test,1159,82,83968,259,49728,133696
test,1160,326,333824,4083,783936,1117760
test,1161,24,24576,26,4992,29568
test,1162,69,70656,183,35136,105792
test,1163,19,19456,19,3648,23104
test,1164,101,103424,392,75264,178688
test,1165,46,47104,82,15744,62848
test,1166,59,60416,134,25728,86144
test,1167,41,41984,71,13632,55616
test,1168,160,163840,984,188928,352768
test,1169,235,240640,2122,407424,648064
test,1170,54,55296,112,21504,76800
test,1171,33,33792,48,9216,43008
test,1172,98,100352,369,70848,171200
test,1173,140,143360,753,144576,287936
test,1174,470,481280,8485,1629120,2110400
test,1175,55,56320,117,22464,78784
test,1176,58,59392,130,24960,84352
test,1177,15,15360,13,2496,17856
test,1178,109,111616,457,87744,199360
test,1179,753,771072,21779,4181568,4952640
test,1180,58,59392,130,24960,84352
test,1181,52,53248,104,19968,73216
test,1182,115,117760,508,97536,215296
test,1183,122,124928,572,109824,234752
test,1184,231,236544,2050,393600,630144
test,1185,60,61440,139,26688,88128
test,1186,416,425984,6648,1276416,1702400
test,1187,343,351232,4519,867648,1218880
test,1188,41,41984,71,13632,55616
test,1189,155,158720,923,177216,335936
test,1190,69,70656,183,35136,105792
test,1191,207,211968,1646,316032,528000
test,1192,55,56320,117,22464,78784
test,1193,24,24576,26,4992,29568
test,1194,802,821248,24706,4743552,5564800
test,1195,102,104448,400,76800,181248
test,1196,149,152576,853,163776,316352
test,1197,118,120832,535,102720,223552
test,1198,693,709632,18447,3541824,4251456
test,1199,156,159744,935,179520,339264
test,1200,115,117760,508,97536,215296
test,1201,61,62464,143,27456,89920
test,1202,419,429056,6744,1294848,1723904
test,1203,112,114688,482,92544,207232
test,1204,258,264192,2557,490944,755136
test,1205,53,54272,108,20736,75008
test,1206,209,214016,1678,322176,536192
test,1207,9,9216,7,1344,10560
test,1208,87,89088,291,55872,144960
test,1209,33,33792,42,8064,41856
test,1210,59,60416,134,25728,86144
test,1211,37,37888,53,10176,48064
test,1212,106,108544,432,82944,191488
test,1213,69,70656,183,35136,105792
test,1214,69,70656,183,35136,105792
test,1215,84,86016,271,52032,138048
test,1216,92,94208,326,62592,156800
test,1217,70,71680,189,36288,107968
test,1218,77,78848,228,43776,122624
test,1219,20,20480,21,4032,24512
test,1220,79,80896,240,46080,126976
test,1221,40,40960,62,11904,52864
test,1222,56,57344,121,23232,80576
test,1223,97,99328,362,69504,168832
test,1224,77,78848,228,43776,122624
test,1225,88,90112,298,57216,147328
test,1226,126,129024,610,117120,246144
test,1227,109,111616,457,87744,199360
test,1228,105,107520,424,81408,188928
test,1229,100,102400,385,73920,176320
test,1230,98,100352,369,70848,171200
test,1231,99,101376,377,72384,173760
test,1232,140,143360,753,144576,287936
test,1233,88,90112,298,57216,147328
test,1234,51,52224,100,19200,71424
test,1235,7,7168,5,960,8128
test,1236,117,119808,526,100992,220800
test,1237,214,219136,1759,337728,556864
test,1238,106,108544,432,82944,191488
test,1239,49,50176,93,17856,68032
test,1240,201,205824,1552,297984,503808
test,1241,69,70656,183,35136,105792
test,1242,598,612352,13736,2637312,3249664
test,1243,70,71680,194,37248,108928
test,1244,91,93184,319,61248,154432
test,1245,90,92160,312,59904,152064
test,1246,45,46080,78,14976,61056
test,1247,638,653312,15635,3001920,3655232
test,1248,102,104448,400,76800,181248
test,1249,9,9216,7,1344,10560
test,1250,76,77824,222,42624,120448
test,1251,188,192512,1358,260736,453248
test,1252,324,331776,4033,774336,1106112
test,1253,187,191488,1344,258048,449536
test,1254,195,199680,1461,280512,480192
test,1255,32,32768,40,7680,40448
test,1256,218,223232,1826,350592,573824
test,1257,49,50176,93,17856,68032
test,1258,35,35840,48,9216,45056
test,1259,113,115712,491,94272,209984
test,1260,40,40960,65,12480,53440
test,1261,84,86016,271,52032,138048
test,1262,68,69632,183,35136,104768
test,1263,34,34816,48,9216,44032
test,1264,206,210944,1630,312960,523904
test,1265,196,200704,1476,283392,484096
test,1266,430,440320,7103,1363776,1804096
test,1267,232,237568,2068,397056,634624
test,1268,65,66560,163,31296,97856
test,1269,67,68608,173,33216,101824
test,1270,97,99328,362,69504,168832
test,1271,42,43008,75,14400,57408
test,1272,32,32768,40,7680,40448
test,1273,61,62464,143,27456,89920
test,1274,90,92160,312,59904,152064
test,1275,83,84992,265,50880,135872
test,1276,101,103424,392,75264,178688
test,1277,134,137216,690,132480,269696
test,1278,54,55296,112,21504,76800
test,1279,25,25600,26,4992,30592
test,1280,34,34816,48,9216,44032
test,1281,623,637952,14909,2862528,3500480
test,1282,81,82944,252,48384,131328
test,1283,8,8192,6,1152,9344
test,1284,97,99328,362,69504,168832
test,1285,33,33792,48,9216,43008
test,1286,447,457728,7675,1473600,1931328
test,1287,93,95232,333,63936,159168
test,1288,38,38912,56,10752,49664
test,1289,49,50176,93,17856,68032
test,1290,61,62464,143,27456,89920
test,1291,33,33792,45,8640,42432
test,1292,292,299008,3275,628800,927808
test,1293,236,241664,2140,410880,652544
test,1294,64,65536,158,30336,95872
test,1295,11,11264,12,2304,13568
test,1296,82,83968,259,49728,133696
test,1297,60,61440,139,26688,88128
test,1298,55,56320,125,24000,80320
test,1299,86,88064,285,54720,142784
test,1300,120,122880,554,106368,229248
test,1301,372,380928,5316,1020672,1401600
test,1302,110,112640,465,89280,201920
test,1303,70,71680,189,36288,107968
test,1304,4,4096,4,768,4864
test,1305,76,77824,228,43776,121600
test,1306,135,138240,700,134400,272640
test,1307,59,60416,143,27456,87872
test,1308,530,542720,10790,2071680,2614400
test,1309,47,48128,85,16320,64448
test,1310,44,45056,75,14400,59456
test,1311,102,104448,400,76800,181248
test,1312,47,48128,85,16320,64448
test,1313,24,24576,31,5952,30528
test,1314,100,102400,385,73920,176320
test,1315,85,87040,278,53376,140416
test,1316,109,111616,457,87744,199360
test,1317,42,43008,71,13632,56640
test,1318,78,79872,234,44928,124800
test,1319,27,27648,31,5952,33600
test,1320,64,65536,158,30336,95872
test,1321,84,86016,271,52032,138048
test,1322,53,54272,108,20736,75008
test,1323,101,103424,392,75264,178688
test,1324,90,92160,312,59904,152064
test,1325,6,6144,4,768,6912
test,1326,88,90112,298,57216,147328
test,1327,16,16384,16,3072,19456
test,1328,767,785408,22597,4338624,5124032
test,1329,337,345088,4363,837696,1182784
test,1330,68,69632,183,35136,104768
test,1331,144,147456,797,153024,300480
test,1332,279,285696,2990,574080,859776
test,1333,12,12288,12,2304,14592
test,1334,32,32768,40,7680,40448
test,1335,56,57344,121,23232,80576
test,1336,55,56320,117,22464,78784
test,1337,104,106496,416,79872,186368
test,1338,55,56320,117,22464,78784
test,1339,40,40960,62,11904,52864
test,1340,238,243712,2176,417792,661504
test,1341,108,110592,448,86016,196608
test,1342,243,248832,2269,435648,684480
test,1343,264,270336,2678,514176,784512
test,1344,146,149504,819,157248,306752
test,1345,110,112640,465,89280,201920
test,1346,82,83968,259,49728,133696
test,1347,70,71680,189,36288,107968
test,1348,42,43008,68,13056,56064
test,1349,77,78848,228,43776,122624
test,1350,91,93184,319,61248,154432
test,1351,83,84992,265,50880,135872
test,1352,41,41984,71,13632,55616
test,1353,90,92160,312,59904,152064
test,1354,230,235520,2032,390144,625664
test,1355,26,26624,31,5952,32576
test,1356,154,157696,911,174912,332608
test,1357,60,61440,139,26688,88128
test,1358,57,58368,130,24960,83328
test,1359,165,168960,1046,200832,369792
test,1360,114,116736,500,96000,212736
test,1361,10,10240,8,1536,11776
test,1362,33,33792,48,9216,43008
test,1363,45,46080,78,14976,61056
test,1364,75,76800,217,41664,118464
test,1365,93,95232,333,63936,159168
test,1366,5,5120,4,768,5888
test,1367,254,260096,2479,475968,736064
test,1368,126,129024,610,117120,246144
test,1369,9,9216,6,1152,10368
test,1370,191,195584,1402,269184,464768
test,1371,32,32768,56,10752,43520
test,1372,109,111616,457,87744,199360
test,1373,91,93184,319,61248,154432
test,1374,871,891904,29140,5594880,6486784
test,1375,8,8192,7,1344,9536
test,1376,210,215040,1694,325248,540288
test,1377,237,242688,2158,414336,657024
test,1378,29,29696,35,6720,36416
test,1379,27,27648,28,5376,33024
test,1380,79,80896,240,46080,126976
test,1381,12,12288,10,1920,14208
test,1382,84,86016,271,52032,138048
test,1383,312,319488,3739,717888,1037376
test,1384,44,45056,75,14400,59456
test,1385,56,57344,121,23232,80576
test,1386,172,176128,1137,218304,394432
test,1387,65,66560,163,31296,97856
test,1388,45,46080,78,14976,61056
test,1389,23,23552,24,4608,28160
test,1390,65,66560,163,31296,97856
test,1391,118,120832,535,102720,223552
test,1392,81,82944,252,48384,131328
test,1393,26,26624,31,5952,32576
test,1394,25,25600,31,5952,31552
test,1395,129,132096,640,122880,254976
test,1396,120,122880,554,106368,229248
test,1397,75,76800,217,41664,118464
test,1398,16,16384,13,2496,18880
test,1399,233,238592,2086,400512,639104
test,1400,15,15360,13,2496,17856
test,1401,62,63488,148,28416,91904
test,1402,71,72704,194,37248,109952
test,1403,305,312320,3574,686208,998528
test,1404,499,510976,9565,1836480,2347456
test,1405,64,65536,158,30336,95872
test,1406,233,238592,2086,400512,639104
test,1407,34,34816,50,9600,44416
test,1408,99,101376,377,72384,173760
test,1409,119,121856,544,104448,226304
test,1410,162,165888,1008,193536,359424
test,1411,206,210944,1630,312960,523904
test,1412,65,66560,163,31296,97856
test,1413,73,74752,205,39360,114112
test,1414,124,126976,591,113472,240448
test,1415,122,124928,572,109824,234752
test,1416,175,179200,1177,225984,405184
test,1417,261,267264,2617,502464,769728
test,1418,55,56320,117,22464,78784
test,1419,84,86016,271,52032,138048
test,1420,46,47104,82,15744,62848
test,1421,109,111616,457,87744,199360
test,1422,47,48128,85,16320,64448
test,1423,107,109568,440,84480,194048
test,1424,55,56320,117,22464,78784
test,1425,92,94208,326,62592,156800
test,1426,109,111616,457,87744,199360
test,1427,87,89088,291,55872,144960
test,1428,12,12288,10,1920,14208
test,1429,14,14336,16,3072,17408
test,1430,61,62464,143,27456,89920
test,1431,56,57344,121,23232,80576
test,1432,40,40960,62,11904,52864
test,1433,59,60416,134,25728,86144
test,1434,10,10240,8,1536,11776
test,1435,112,114688,482,92544,207232
test,1436,29,29696,35,6720,36416
test,1437,112,114688,482,92544,207232
test,1438,144,147456,797,153024,300480
test,1439,110,112640,465,89280,201920
test,1440,60,61440,139,26688,88128
test,1441,50,51200,96,18432,69632
test,1442,543,556032,11326,2174592,2730624
test,1443,100,102400,392,75264,177664
test,1444,54,55296,112,21504,76800
test,1445,616,630784,14575,2798400,3429184
test,1446,37,37888,53,10176,48064
test,1447,32,32768,42,8064,40832
test,1448,155,158720,923,177216,335936
test,1449,57,58368,125,24000,82368
test,1450,29,29696,35,6720,36416
test,1451,97,99328,362,69504,168832
test,1452,121,123904,563,108096,232000
test,1453,98,100352,369,70848,171200
test,1454,36,36864,56,10752,47616
test,1455,162,165888,1008,193536,359424
test,1456,286,292864,3142,603264,896128
test,1457,44,45056,78,14976,60032
test,1458,118,120832,535,102720,223552
test,1459,71,72704,194,37248,109952
test,1460,42,43008,68,13056,56064
test,1461,24,24576,24,4608,29184
test,1462,46,47104,85,16320,63424
test,1463,8,8192,4,768,8960
test,1464,73,74752,205,39360,114112
test,1465,105,107520,424,81408,188928
test,1466,158,161792,959,184128,345920
test,1467,81,82944,252,48384,131328
test,1468,36,36864,50,9600,46464
test,1469,69,70656,183,35136,105792
test,1470,56,57344,121,23232,80576
test,1471,7,7168,6,1152,8320
test,1472,126,129024,610,117120,246144
test,1473,89,91136,305,58560,149696
test,1474,123,125952,582,111744,237696
test,1475,100,102400,385,73920,176320
test,1476,17,17408,14,2688,20096
test,1477,90,92160,312,59904,152064
test,1478,234,239616,2104,403968,643584
test,1479,73,74752,205,39360,114112
test,1480,162,165888,1008,193536,359424
test,1481,193,197632,1431,274752,472384
test,1482,78,79872,234,44928,124800
test,1483,51,52224,100,19200,71424
test,1484,17,17408,17,3264,20672
test,1485,58,59392,130,24960,84352
test,1486,70,71680,189,36288,107968
test,1487,101,103424,392,75264,178688
test,1488,124,126976,591,113472,240448
test,1489,123,125952,582,111744,237696
test,1490,20,20480,24,4608,25088
test,1491,26,26624,26,4992,31616
test,1492,748,765952,21491,4126272,4892224
test,1493,150,153600,865,166080,319680
test,1494,35,35840,48,9216,45056
test,1495,188,192512,1358,260736,453248
test,1496,5,5120,6,1152,6272
test,1497,124,126976,591,113472,240448
test,1498,76,77824,222,42624,120448
test,1499,40,40960,68,13056,54016
test,1500,42,43008,75,14400,57408
test,1501,16,16384,12,2304,18688
test,1502,140,143360,753,144576,287936
test,1503,438,448512,7369,1414848,1863360
test,1504,57,58368,125,24000,82368
test,1505,74,75776,211,40512,116288
test,1506,41,41984,65,12480,54464
test,1507,39,39936,59,11328,51264
test,1508,19,19456,17,3264,22720
test,1509,86,88064,285,54720,142784
test,1510,189,193536,1373,263616,457152
test,1511,39,39936,59,11328,51264
test,1512,116,118784,517,99264,218048
test,1513,153,156672,900,172800,329472
test,1514,420,430080,6776,1300992,1731072
test,1515,14,14336,14,2688,17024
test,1516,108,110592,448,86016,196608
test,1517,45,46080,78,14976,61056
test,1518,262,268288,2637,506304,774592
test,1519,69,70656,183,35136,105792
test,1520,41,41984,68,13056,55040
test,1521,47,48128,85,16320,64448
test,1522,16,16384,16,3072,19456
test,1523,392,401408,5903,1133376,1534784
test,1524,37,37888,53,10176,48064
test,1525,43,44032,71,13632,57664
test,1526,104,106496,416,79872,186368
test,1527,7,7168,8,1536,8704
test,1528,6,6144,5,960,7104
test,1529,568,581632,12393,2379456,2961088
test,1530,22,22528,23,4416,26944
test,1531,202,206848,1568,301056,507904
test,1532,39,39936,59,11328,51264
test,1533,128,131072,630,120960,252032
test,1534,45,46080,78,14976,61056
test,1535,74,75776,211,40512,116288
test,1536,14,14336,14,2688,17024
test,1537,53,54272,108,20736,75008
test,1538,36,36864,56,10752,47616
test,1539,738,755712,20920,4016640,4772352
test,1540,243,248832,2269,435648,684480
test,1541,41,41984,71,13632,55616
test,1542,205,209920,1615,310080,520000
test,1543,40,40960,62,11904,52864
test,1544,116,118784,517,99264,218048
test,1545,28,28672,33,6336,35008
test,1546,365,373760,5118,982656,1356416
test,1547,47,48128,85,16320,64448
test,1548,51,52224,100,19200,71424
test,1549,43,44032,71,13632,57664
test,1550,76,77824,222,42624,120448
test,1551,237,242688,2158,414336,657024
test,1552,261,267264,2617,502464,769728
test,1553,76,77824,222,42624,120448
test,1554,9,9216,8,1536,10752
test,1555,9,9216,8,1536,10752
test,1556,31,31744,40,7680,39424
test,1557,163,166912,1021,196032,362944
test,1558,15,15360,14,2688,18048
test,1559,24,24576,28,5376,29952
test,1560,9,9216,10,1920,11136
test,1561,67,68608,173,33216,101824
test,1562,6,6144,7,1344,7488
test,1563,49,50176,93,17856,68032
test,1564,115,117760,508,97536,215296
test,1565,148,151552,842,161664,313216
test,1566,74,75776,211,40512,116288
test,1567,66,67584,168,32256,99840
test,1568,41,41984,65,12480,54464
test,1569,59,60416,134,25728,86144
test,1570,538,550912,11118,2134656,2685568
test,1571,114,116736,500,96000,212736
test,1572,14,14336,12,2304,16640
test,1573,62,63488,148,28416,91904
test,1574,176,180224,1190,228480,408704
test,1575,70,71680,189,36288,107968
test,1576,18,18432,17,3264,21696
test,1577,45,46080,78,14976,61056
test,1578,480,491520,8850,1699200,2190720
test,1579,29,29696,35,6720,36416
test,1580,105,107520,424,81408,188928
test,1581,56,57344,121,23232,80576
test,1582,137,140288,721,138432,278720
test,1583,38,38912,59,11328,50240
test,1584,36,36864,50,9600,46464
test,1585,30,30720,35,6720,37440
test,1586,72,73728,200,38400,112128
test,1587,162,165888,1008,193536,359424
test,1588,76,77824,222,42624,120448
test,1589,14,14336,10,1920,16256
test,1590,179,183296,1231,236352,419648
test,1591,22,22528,24,4608,27136
test,1592,131,134144,660,126720,260864
test,1593,25,25600,31,5952,31552
test,1594,42,43008,68,13056,56064
test,1595,117,119808,526,100992,220800
test,1596,37,37888,56,10752,48640
test,1597,118,120832,535,102720,223552
test,1598,235,240640,2122,407424,648064
test,1599,51,52224,100,19200,71424
test,1600,55,56320,121,23232,79552
test,1601,91,93184,319,61248,154432
test,1602,133,136192,680,130560,266752
test,1603,46,47104,82,15744,62848
test,1604,40,40960,62,11904,52864
test,1605,66,67584,168,32256,99840
test,1606,84,86016,271,52032,138048
test,1607,29,29696,35,6720,36416
test,1608,37,37888,53,10176,48064
test,1609,64,65536,158,30336,95872
test,1610,547,560128,11493,2206656,2766784
test,1611,48,49152,89,17088,66240
test,1612,33,33792,50,9600,43392
test,1613,104,106496,416,79872,186368
test,1614,195,199680,1461,280512,480192
test,1615,80,81920,246,47232,129152
test,1616,134,137216,690,132480,269696
test,1617,110,112640,465,89280,201920
test,1618,45,46080,82,15744,61824
test,1619,83,84992,265,50880,135872
test,1620,85,87040,278,53376,140416
test,1621,298,305152,3411,654912,960064
test,1622,114,116736,500,96000,212736
test,1623,78,79872,234,44928,124800
test,1624,89,91136,305,58560,149696
test,1625,60,61440,143,27456,88896
test,1626,41,41984,65,12480,54464
test,1627,93,95232,333,63936,159168
test,1628,73,74752,205,39360,114112
test,1629,154,157696,911,174912,332608
test,1630,198,202752,1506,289152,491904
test,1631,141,144384,764,146688,291072
test,1632,75,76800,217,41664,118464
test,1633,21,21504,24,4608,26112
test,1634,204,208896,1599,307008,515904
test,1635,136,139264,711,136512,275776
test,1636,86,88064,285,54720,142784
test,1637,80,81920,246,47232,129152
test,1638,179,183296,1231,236352,419648
test,1639,30,30720,40,7680,38400
test,1640,149,152576,853,163776,316352
test,1641,61,62464,143,27456,89920
test,1642,220,225280,1860,357120,582400
test,1643,58,59392,130,24960,84352
test,1644,114,116736,500,96000,212736
test,1645,62,63488,148,28416,91904
test,1646,117,119808,526,100992,220800
test,1647,72,73728,200,38400,112128
test,1648,105,107520,424,81408,188928
test,1649,167,171008,1072,205824,376832
test,1650,38,38912,56,10752,49664
test,1651,60,61440,139,26688,88128
test,1652,108,110592,448,86016,196608
test,1653,8,8192,7,1344,9536
test,1654,71,72704,194,37248,109952
test,1655,197,201728,1491,286272,488000
test,1656,92,94208,326,62592,156800
test,1657,55,56320,117,22464,78784
test,1658,7,7168,5,960,8128
test,1659,61,62464,148,28416,90880
test,1660,39,39936,59,11328,51264
test,1661,384,393216,5664,1087488,1480704
test,1662,201,205824,1552,297984,503808
test,1663,99,101376,377,72384,173760
test,1664,31,31744,40,7680,39424
test,1665,125,128000,601,115392,243392
test,1666,57,58368,125,24000,82368
test,1667,64,65536,158,30336,95872
test,1668,79,80896,240,46080,126976
test,1669,152,155648,888,170496,326144
test,1670,50,51200,96,18432,69632
test,1671,39,39936,59,11328,51264
test,1672,138,141312,732,140544,281856
test,1673,538,550912,11118,2134656,2685568
test,1674,9,9216,10,1920,11136
test,1675,81,82944,259,49728,132672
test,1676,24,24576,26,4992,29568
test,1677,282,288768,3055,586560,875328
test,1678,72,73728,200,38400,112128
test,1679,115,117760,508,97536,215296
test,1680,35,35840,48,9216,45056
test,1681,36,36864,50,9600,46464
test,1682,77,78848,228,43776,122624
test,1683,101,103424,392,75264,178688
test,1684,60,61440,139,26688,88128
test,1685,39,39936,59,11328,51264
test,1686,50,51200,96,18432,69632
test,1687,135,138240,700,134400,272640
test,1688,85,87040,278,53376,140416
test,1689,90,92160,312,59904,152064
test,1690,62,63488,148,28416,91904
test,1691,194,198656,1446,277632,476288
test,1692,105,107520,424,81408,188928
test,1693,50,51200,100,19200,70400
test,1694,323,330752,4008,769536,1100288
test,1695,250,256000,2401,460992,716992
test,1696,411,420864,6489,1245888,1666752
test,1697,119,121856,544,104448,226304
test,1698,190,194560,1387,266304,460864
test,1699,58,59392,130,24960,84352
test,1700,48,49152,89,17088,66240
test,1701,506,518144,9835,1888320,2406464
test,1702,100,102400,385,73920,176320
test,1703,102,104448,400,76800,181248
test,1704,248,253952,2363,453696,707648
test,1705,93,95232,333,63936,159168
test,1706,86,88064,285,54720,142784
test,1707,57,58368,125,24000,82368
test,1708,105,107520,424,81408,188928
test,1709,416,425984,6648,1276416,1702400
test,1710,103,105472,408,78336,183808
test,1711,62,63488,153,29376,92864
test,1712,114,116736,500,96000,212736
test,1713,31,31744,37,7104,38848
test,1714,70,71680,189,36288,107968
test,1715,10,10240,8,1536,11776
test,1716,106,108544,432,82944,191488
test,1717,357,365568,4896,940032,1305600
test,1718,99,101376,377,72384,173760
test,1719,112,114688,482,92544,207232
test,1720,75,76800,217,41664,118464
test,1721,24,24576,24,4608,29184
test,1722,114,116736,500,96000,212736
test,1723,46,47104,82,15744,62848
test,1724,260,266240,2597,498624,764864
test,1725,55,56320,117,22464,78784
test,1726,57,58368,125,24000,82368
test,1727,71,72704,194,37248,109952
test,1728,118,120832,535,102720,223552
test,1729,100,102400,385,73920,176320
test,1730,72,73728,200,38400,112128
test,1731,26,26624,28,5376,32000
test,1732,26,26624,28,5376,32000
test,1733,90,92160,312,59904,152064
test,1734,112,114688,482,92544,207232
test,1735,73,74752,205,39360,114112
test,1736,125,128000,601,115392,243392
test,1737,206,210944,1630,312960,523904
test,1738,54,55296,112,21504,76800
test,1739,648,663552,16129,3096768,3760320
test,1740,59,60416,134,25728,86144
test,1741,48,49152,89,17088,66240
test,1742,45,46080,78,14976,61056
test,1743,13,13312,13,2496,15808
test,1744,96,98304,354,67968,166272
test,1745,32,32768,40,7680,40448
test,1746,31,31744,37,7104,38848
test,1747,36,36864,56,10752,47616
test,1748,76,77824,222,42624,120448
test,1749,25,25600,28,5376,30976
test,1750,59,60416,139,26688,87104
test,1751,471,482304,8521,1636032,2118336
test,1752,237,242688,2158,414336,657024
test,1753,59,60416,139,26688,87104
test,1754,455,465920,7952,1526784,1992704
test,1755,28,28672,31,5952,34624
test,1756,53,54272,108,20736,75008
test,1757,145,148480,808,155136,303616
test,1758,172,176128,1137,218304,394432
test,1759,124,126976,591,113472,240448
test,1760,107,109568,440,84480,194048
test,1761,241,246784,2231,428352,675136
test,1762,11,11264,12,2304,13568
test,1763,33,33792,42,8064,41856
test,1764,78,79872,234,44928,124800
test,1765,115,117760,508,97536,215296
test,1766,47,48128,85,16320,64448
test,1767,30,30720,37,7104,37824
test,1768,382,391168,5605,1076160,1467328
test,1769,335,343040,4311,827712,1170752
test,1770,177,181248,1204,231168,412416
test,1771,46,47104,82,15744,62848
test,1772,82,83968,259,49728,133696
test,1773,8,8192,6,1152,9344
test,1774,25,25600,31,5952,31552
test,1775,30,30720,35,6720,37440
test,1776,114,116736,500,96000,212736
test,1777,128,131072,630,120960,252032
test,1778,59,60416,139,26688,87104
test,1779,401,410624,6177,1185984,1596608
test,1780,125,128000,601,115392,243392
test,1781,55,56320,117,22464,78784
test,1782,99,101376,377,72384,173760
test,1783,428,438272,7037,1351104,1789376
test,1784,192,196608,1416,271872,468480
test,1785,108,110592,448,86016,196608
test,1786,61,62464,143,27456,89920
test,1787,18,18432,14,2688,21120
test,1788,19,19456,19,3648,23104
test,1789,178,182272,1217,233664,415936
test,1790,114,116736,500,96000,212736
test,1791,89,91136,305,58560,149696
test,1792,44,45056,75,14400,59456
test,1793,100,102400,385,73920,176320
test,1794,32,32768,42,8064,40832
test,1795,41,41984,65,12480,54464
test,1796,284,290816,3098,594816,885632
test,1797,80,81920,246,47232,129152
test,1798,30,30720,35,6720,37440
test,1799,122,124928,572,109824,234752
test,1800,101,103424,392,75264,178688
test,1801,855,875520,28079,5391168,6266688
test,1802,11,11264,9,1728,12992
test,1803,352,360448,4760,913920,1274368
test,1804,79,80896,240,46080,126976
test,1805,83,84992,265,50880,135872
test,1806,332,339968,4234,812928,1152896
test,1807,51,52224,100,19200,71424
test,1808,7,7168,5,960,8128
test,1809,63,64512,153,29376,93888
test,1810,86,88064,285,54720,142784
test,1811,131,134144,660,126720,260864
test,1812,72,73728,205,39360,113088
test,1813,197,201728,1491,286272,488000
test,1814,41,41984,65,12480,54464
test,1815,82,83968,259,49728,133696
test,1816,367,375808,5174,993408,1369216
test,1817,95,97280,347,66624,163904
test,1818,70,71680,189,36288,107968
test,1819,61,62464,143,27456,89920
test,1820,93,95232,333,63936,159168
test,1821,11,11264,10,1920,13184
test,1822,87,89088,291,55872,144960
test,1823,39,39936,59,11328,51264
test,1824,141,144384,764,146688,291072
test,1825,123,125952,582,111744,237696
test,1826,47,48128,85,16320,64448
test,1827,25,25600,33,6336,31936
test,1828,68,69632,178,34176,103808
test,1829,51,52224,100,19200,71424
test,1830,139,142336,743,142656,284992
test,1831,110,112640,465,89280,201920
test,1832,121,123904,563,108096,232000
test,1833,47,48128,85,16320,64448
test,1834,71,72704,200,38400,111104
test,1835,219,224256,1843,353856,578112
test,1836,43,44032,75,14400,58432
test,1837,43,44032,71,13632,57664
test,1838,41,41984,68,13056,55040
test,1839,67,68608,173,33216,101824
test,1840,168,172032,1085,208320,380352
test,1841,15,15360,12,2304,17664
test,1842,51,52224,100,19200,71424
test,1843,53,54272,108,20736,75008
test,1844,108,110592,448,86016,196608
test,1845,18,18432,19,3648,22080
test,1846,29,29696,33,6336,36032
test,1847,37,37888,56,10752,48640
test,1848,96,98304,354,67968,166272
test,1849,27,27648,33,6336,33984
test,1850,111,113664,474,91008,204672
test,1851,97,99328,362,69504,168832
test,1852,12,12288,12,2304,14592
test,1853,278,284672,2969,570048,854720
test,1854,65,66560,163,31296,97856
test,1855,117,119808,526,100992,220800
test,1856,17,17408,16,3072,20480
test,1857,10,10240,8,1536,11776
test,1858,48,49152,89,17088,66240
test,1859,107,109568,440,84480,194048
test,1860,263,269312,2657,510144,779456
test,1861,8,8192,9,1728,9920
test,1862,85,87040,278,53376,140416
test,1863,230,235520,2032,390144,625664
test,1864,84,86016,271,52032,138048
test,1865,548,561152,11535,2214720,2775872
test,1866,165,168960,1046,200832,369792
test,1867,11,11264,8,1536,12800
test,1868,60,61440,139,26688,88128
test,1869,25,25600,31,5952,31552
test,1870,117,119808,526,100992,220800
test,1871,558,571392,11960,2296320,2867712
test,1872,97,99328,362,69504,168832
test,1873,227,232448,1980,380160,612608
test,1874,52,53248,104,19968,73216
test,1875,215,220160,1776,340992,561152
test,1876,29,29696,40,7680,37376
test,1877,175,179200,1177,225984,405184
test,1878,174,178176,1163,223296,401472
test,1879,22,22528,26,4992,27520
test,1880,11,11264,8,1536,12800
test,1881,104,106496,416,79872,186368
test,1882,111,113664,474,91008,204672
test,1883,90,92160,312,59904,152064
test,1884,10,10240,8,1536,11776
test,1885,258,264192,2557,490944,755136
test,1886,10,10240,8,1536,11776
test,1887,86,88064,285,54720,142784
test,1888,260,266240,2597,498624,764864
test,1889,431,441344,7136,1370112,1811456
test,1890,72,73728,200,38400,112128
test,1891,121,123904,563,108096,232000
test,1892,54,55296,117,22464,77760
test,1893,169,173056,1097,210624,383680
test,1894,82,83968,259,49728,133696
test,1895,68,69632,178,34176,103808
test,1896,141,144384,764,146688,291072
test,1897,47,48128,89,17088,65216
test,1898,70,71680,189,36288,107968
test,1899,56,57344,121,23232,80576
test,1900,121,123904,563,108096,232000
test,1901,95,97280,347,66624,163904
test,1902,70,71680,189,36288,107968
test,1903,5,5120,4,768,5888
test,1904,84,86016,271,52032,138048
test,1905,408,417792,6394,1227648,1645440
test,1906,54,55296,112,21504,76800
test,1907,124,126976,591,113472,240448
test,1908,46,47104,82,15744,62848
test,1909,102,104448,400,76800,181248
test,1910,55,56320,117,22464,78784
test,1911,47,48128,85,16320,64448
test,1912,55,56320,117,22464,78784
test,1913,148,151552,842,161664,313216
test,1914,36,36864,50,9600,46464
test,1915,45,46080,78,14976,61056
test,1916,97,99328,362,69504,168832
test,1917,204,208896,1599,307008,515904
test,1918,258,264192,2557,490944,755136
test,1919,526,538624,10628,2040576,2579200
test,1920,81,82944,252,48384,131328
test,1921,7,7168,6,1152,8320
test,1922,238,243712,2176,417792,661504
test,1923,129,132096,640,122880,254976
test,1924,65,66560,163,31296,97856
test,1925,161,164864,996,191232,356096
test,1926,60,61440,139,26688,88128
test,1927,27,27648,33,6336,33984
test,1928,53,54272,108,20736,75008
test,1929,7,7168,7,1344,8512
test,1930,57,58368,125,24000,82368
test,1931,86,88064,285,54720,142784
test,1932,86,88064,285,54720,142784
test,1933,139,142336,743,142656,284992
test,1934,65,66560,163,31296,97856
test,1935,302,309248,3504,672768,982016
test,1936,26,26624,28,5376,32000
test,1937,12,12288,12,2304,14592
test,1938,148,151552,842,161664,313216
test,1939,135,138240,700,134400,272640
test,1940,42,43008,68,13056,56064
test,1941,68,69632,178,34176,103808
test,1942,125,128000,601,115392,243392
test,1943,241,246784,2231,428352,675136
test,1944,239,244736,2194,421248,665984
test,1945,96,98304,354,67968,166272
test,1946,454,464896,7917,1520064,1984960
test,1947,124,126976,591,113472,240448
test,1948,125,128000,601,115392,243392
test,1949,305,312320,3574,686208,998528
test,1950,112,114688,482,92544,207232
test,1951,22,22528,21,4032,26560
test,1952,69,70656,183,35136,105792
test,1953,99,101376,377,72384,173760
test,1954,80,81920,246,47232,129152
test,1955,54,55296,112,21504,76800
test,1956,39,39936,59,11328,51264
test,1957,60,61440,139,26688,88128
test,1958,87,89088,291,55872,144960
test,1959,10,10240,9,1728,11968
test,1960,131,134144,660,126720,260864
test,1961,146,149504,819,157248,306752
test,1962,12,12288,12,2304,14592
test,1963,83,84992,265,50880,135872
test,1964,227,232448,1980,380160,612608
test,1965,197,201728,1491,286272,488000
test,1966,49,50176,93,17856,68032
test,1967,109,111616,457,87744,199360
test,1968,56,57344,121,23232,80576
test,1969,73,74752,205,39360,114112
test,1970,65,66560,163,31296,97856
test,1971,84,86016,271,52032,138048
test,1972,75,76800,217,41664,118464
test,1973,110,112640,465,89280,201920
test,1974,179,183296,1231,236352,419648
test,1975,135,138240,700,134400,272640
test,1976,109,111616,457,87744,199360
test,1977,84,86016,271,52032,138048
test,1978,361,369664,5006,961152,1330816
test,1979,133,136192,680,130560,266752
test,1980,51,52224,100,19200,71424
test,1981,50,51200,96,18432,69632
test,1982,83,84992,271,52032,137024
test,1983,60,61440,139,26688,88128
test,1984,178,182272,1217,233664,415936
test,1985,103,105472,408,78336,183808
test,1986,54,55296,112,21504,76800
test,1987,48,49152,89,17088,66240
test,1988,9,9216,10,1920,11136
test,1989,92,94208,326,62592,156800
test,1990,58,59392,130,24960,84352
test,1991,239,244736,2194,421248,665984
test,1992,55,56320,117,22464,78784
test,1993,107,109568,440,84480,194048
test,1994,117,119808,526,100992,220800
test,1995,102,104448,400,76800,181248
test,1996,245,250880,2306,442752,693632
test,1997,211,216064,1711,328512,544576
test,1998,134,137216,690,132480,269696
test,1999,73,74752,205,39360,114112
test,2000,25,25600,26,4992,30592
test,2001,46,47104,82,15744,62848
test,2002,397,406528,6054,1162368,1568896
test,2003,41,41984,65,12480,54464
test,2004,61,62464,143,27456,89920
test,2005,156,159744,935,179520,339264
test,2006,41,41984,65,12480,54464
test,2007,199,203776,1522,292224,496000
test,2008,491,502784,9260,1777920,2280704
test,2009,182,186368,1273,244416,430784
test,2010,906,927744,31529,6053568,6981312
test,2011,34,34816,45,8640,43456
test,2012,208,212992,1662,319104,532096
test,2013,15,15360,12,2304,17664
test,2014,48,49152,100,19200,68352
test,2015,103,105472,408,78336,183808
test,2016,73,74752,205,39360,114112
test,2017,60,61440,143,27456,88896
test,2018,213,218112,1743,334656,552768
test,2019,69,70656,183,35136,105792
test,2020,140,143360,753,144576,287936
test,2021,40,40960,68,13056,54016
test,2022,76,77824,222,42624,120448
test,2023,41,41984,65,12480,54464
test,2024,132,135168,670,128640,263808
test,2025,507,519168,9874,1895808,2414976
test,2026,45,46080,78,14976,61056
test,2027,200,204800,1537,295104,499904
test,2028,246,251904,2325,446400,698304
test,2029,69,70656,183,35136,105792
test,2030,74,75776,211,40512,116288
test,2031,117,119808,526,100992,220800
test,2032,79,80896,240,46080,126976
test,2033,235,240640,2122,407424,648064
test,2034,65,66560,163,31296,97856
test,2035,238,243712,2176,417792,661504
test,2036,47,48128,85,16320,64448
test,2037,143,146432,786,150912,297344
test,2038,34,34816,45,8640,43456
test,2039,82,83968,259,49728,133696
test,2040,43,44032,71,13632,57664
test,2041,106,108544,432,82944,191488
test,2042,177,181248,1204,231168,412416
test,2043,246,251904,2325,446400,698304
test,2044,122,124928,572,109824,234752
test,2045,65,66560,163,31296,97856
test,2046,72,73728,200,38400,112128
test,2047,57,58368,125,24000,82368
test,2048,14,14336,14,2688,17024
test,2049,75,76800,217,41664,118464
test,2050,29,29696,35,6720,36416
test,2051,8,8192,8,1536,9728
test,2052,118,120832,535,102720,223552
test,2053,180,184320,1245,239040,423360
test,2054,333,340992,4260,817920,1158912
test,2055,71,72704,194,37248,109952
test,2056,13,13312,9,1728,15040
test,2057,342,350208,4493,862656,1212864
test,2058,56,57344,121,23232,80576
test,2059,295,302080,3343,641856,943936
test,2060,708,724992,19254,3696768,4421760
test,2061,49,50176,93,17856,68032
test,2062,82,83968,259,49728,133696
test,2063,76,77824,222,42624,120448
test,2064,13,13312,12,2304,15616
test,2065,122,124928,572,109824,234752
test,2066,6,6144,4,768,6912
test,2067,51,52224,100,19200,71424
test,2068,454,464896,7917,1520064,1984960
test,2069,175,179200,1177,225984,405184
test,2070,47,48128,85,16320,64448
test,2071,181,185344,1259,241728,427072
test,2072,103,105472,408,78336,183808
test,2073,98,100352,369,70848,171200
test,2074,100,102400,385,73920,176320
test,2075,27,27648,31,5952,33600
test,2076,44,45056,75,14400,59456
test,2077,105,107520,424,81408,188928
test,2078,57,58368,125,24000,82368
test,2079,38,38912,56,10752,49664
test,2080,102,104448,400,76800,181248
test,2081,62,63488,148,28416,91904
test,2082,50,51200,96,18432,69632
test,2083,127,130048,620,119040,249088
test,2084,55,56320,117,22464,78784
test,2085,116,118784,517,99264,218048
test,2086,96,98304,354,67968,166272
test,2087,40,40960,62,11904,52864
test,2088,183,187392,1287,247104,434496
test,2089,77,78848,228,43776,122624
test,2090,56,57344,121,23232,80576
test,2091,305,312320,3574,686208,998528
test,2092,294,301056,3320,637440,938496
test,2093,67,68608,173,33216,101824
test,2094,97,99328,362,69504,168832
test,2095,62,63488,148,28416,91904
test,2096,274,280576,2884,553728,834304
test,2097,207,211968,1646,316032,528000
test,2098,36,36864,50,9600,46464
test,2099,13,13312,12,2304,15616
test,2100,54,55296,112,21504,76800
test,2101,7,7168,7,1344,8512
test,2102,103,105472,408,78336,183808
test,2103,103,105472,408,78336,183808
test,2104,71,72704,194,37248,109952
test,2105,37,37888,56,10752,48640
test,2106,66,67584,168,32256,99840
test,2107,48,49152,89,17088,66240
test,2108,5,5120,5,960,6080
test,2109,62,63488,148,28416,91904
test,2110,159,162816,972,186624,349440
test,2111,120,122880,563,108096,230976
test,2112,93,95232,333,63936,159168
test,2113,49,50176,104,19968,70144
test,2114,107,109568,440,84480,194048
test,2115,207,211968,1646,316032,528000
test,2116,115,117760,508,97536,215296
test,2117,56,57344,121,23232,80576
test,2118,37,37888,53,10176,48064
test,2119,110,112640,465,89280,201920
test,2120,28,28672,31,5952,34624
test,2121,46,47104,82,15744,62848
test,2122,15,15360,13,2496,17856
test,2123,72,73728,200,38400,112128
test,2124,4,4096,4,768,4864
test,2125,64,65536,158,30336,95872
test,2126,28,28672,33,6336,35008
test,2127,221,226304,1876,360192,586496
test,2128,47,48128,85,16320,64448
test,2129,26,26624,28,5376,32000
test,2130,214,219136,1759,337728,556864
test,2131,30,30720,40,7680,38400
test,2132,103,105472,408,78336,183808
test,2133,76,77824,222,42624,120448
test,2134,70,71680,189,36288,107968
test,2135,669,685056,17191,3300672,3985728
test,2136,298,305152,3411,654912,960064
test,2137,229,234496,2015,386880,621376
test,2138,51,52224,100,19200,71424
test,2139,336,344064,4337,832704,1176768
test,2140,45,46080,78,14976,61056
test,2141,12,12288,12,2304,14592
test,2142,26,26624,28,5376,32000
test,2143,63,64512,158,30336,94848
test,2144,173,177152,1150,220800,397952
test,2145,57,58368,125,24000,82368
test,2146,29,29696,37,7104,36800
test,2147,241,246784,2231,428352,675136
test,2148,12,12288,13,2496,14784
test,2149,102,104448,400,76800,181248
test,2150,54,55296,112,21504,76800
test,2151,79,80896,240,46080,126976
test,2152,38,38912,56,10752,49664
test,2153,45,46080,78,14976,61056
test,2154,234,239616,2104,403968,643584
test,2155,130,133120,650,124800,257920
test,2156,25,25600,28,5376,30976
test,2157,75,76800,217,41664,118464
test,2158,185,189440,1315,252480,441920
test,2159,332,339968,4234,812928,1152896
test,2160,11,11264,8,1536,12800
test,2161,7,7168,7,1344,8512
test,2162,176,180224,1190,228480,408704
test,2163,46,47104,85,16320,63424
test,2164,211,216064,1711,328512,544576
test,2165,415,424960,6616,1270272,1695232
test,2166,90,92160,312,59904,152064
test,2167,717,734208,19747,3791424,4525632
test,2168,30,30720,35,6720,37440
test,2169,900,921600,31113,5973696,6895296
test,2170,64,65536,158,30336,95872
test,2171,60,61440,139,26688,88128
test,2172,114,116736,500,96000,212736
test,2173,75,76800,217,41664,118464
test,2174,73,74752,211,40512,115264
test,2175,32,32768,40,7680,40448
test,2176,56,57344,121,23232,80576
test,2177,49,50176,93,17856,68032
test,2178,39,39936,59,11328,51264
test,2179,47,48128,93,17856,65984
test,2180,115,117760,508,97536,215296
test,2181,84,86016,271,52032,138048
test,2182,216,221184,1793,344256,565440
test,2183,127,130048,620,119040,249088
test,2184,109,111616,457,87744,199360
test,2185,39,39936,62,11904,51840
test,2186,95,97280,347,66624,163904
test,2187,117,119808,526,100992,220800
test,2188,448,458752,7710,1480320,1939072
