split,index,nodes,total_values_for_nodes,edges,total_values_for_edges,total_values_for_graph
train,0,60,61440,1568,301056,362496
train,1,16,16384,112,21504,37888
train,2,35,35840,534,102528,138368
train,3,20,20480,174,33408,53888
train,4,42,43008,768,147456,190464
train,5,24,24576,251,48192,72768
train,6,14,14336,85,16320,30656
train,7,21,21504,192,36864,58368
train,8,20,20480,174,33408,53888
train,9,33,33792,474,91008,124800
train,10,32,32768,446,85632,118400
train,11,23,23552,230,44160,67712
train,12,26,26624,295,56640,83264
train,13,10,10240,44,8448,18688
train,14,14,14336,85,16320,30656
train,15,15,15360,98,18816,34176
train,16,29,29696,366,70272,99968
train,17,9,9216,35,6720,15936
train,18,21,21504,192,36864,58368
train,19,33,33792,474,91008,124800
train,20,13,13312,74,14208,27520
train,21,4,4096,7,1344,5440
train,22,37,37888,596,114432,152320
train,23,18,18432,141,27072,45504
train,24,12,12288,63,12096,24384
train,25,19,19456,157,30144,49600
train,26,22,22528,211,40512,63040
train,27,31,31744,419,80448,112192
train,28,20,20480,174,33408,53888
train,29,5,5120,11,2112,7232
train,30,33,33792,474,91008,124800
train,31,23,23552,230,44160,67712
train,32,4,4096,7,1344,5440
train,33,23,23552,230,44160,67712
train,34,39,39936,663,127296,167232
train,35,35,35840,534,102528,138368
train,36,42,43008,768,147456,190464
train,37,35,35840,534,102528,138368
train,38,36,36864,565,108480,145344
train,39,37,37888,596,114432,152320
train,40,28,28672,342,65664,94336
train,41,17,17408,126,24192,41600
train,42,15,15360,98,18816,34176
train,43,15,15360,98,18816,34176
train,44,36,36864,565,108480,145344
train,45,17,17408,126,24192,41600
train,46,24,24576,251,48192,72768
train,47,28,28672,342,65664,94336
train,48,41,41984,732,140544,182528
train,49,18,18432,141,27072,45504
train,50,15,15360,98,18816,34176
train,51,29,29696,366,70272,99968
train,52,30,30720,392,75264,105984
train,53,27,27648,318,61056,88704
train,54,17,17408,126,24192,41600
train,55,27,27648,318,61056,88704
train,56,16,16384,112,21504,37888
train,57,4,4096,7,1344,5440
train,58,33,33792,474,91008,124800
train,59,26,26624,295,56640,83264
train,60,5,5120,11,2112,7232
train,61,37,37888,596,114432,152320
train,62,24,24576,251,48192,72768
train,63,18,18432,141,27072,45504
train,64,5,5120,11,2112,7232
train,65,16,16384,112,21504,37888
train,66,22,22528,211,40512,63040
train,67,24,24576,251,48192,72768
train,68,22,22528,211,40512,63040
train,69,43,44032,805,154560,198592
train,70,7,7168,21,4032,11200
train,71,15,15360,98,18816,34176
train,72,23,23552,230,44160,67712
train,73,37,37888,596,114432,152320
train,74,9,9216,35,6720,15936
train,75,20,20480,174,33408,53888
train,76,15,15360,98,18816,34176
train,77,36,36864,565,108480,145344
train,78,23,23552,230,44160,67712
train,79,33,33792,474,91008,124800
train,80,13,13312,74,14208,27520
train,81,12,12288,63,12096,24384
train,82,22,22528,211,40512,63040
train,83,10,10240,44,8448,18688
train,84,35,35840,534,102528,138368
train,85,20,20480,174,33408,53888
train,86,25,25600,272,52224,77824
train,87,28,28672,342,65664,94336
train,88,34,34816,504,96768,131584
train,89,11,11264,53,10176,21440
train,90,6,6144,16,3072,9216
train,91,30,30720,392,75264,105984
train,92,17,17408,126,24192,41600
train,93,14,14336,85,16320,30656
train,94,9,9216,35,6720,15936
train,95,20,20480,174,33408,53888
train,96,29,29696,366,70272,99968
train,97,17,17408,126,24192,41600
train,98,16,16384,112,21504,37888
train,99,28,28672,342,65664,94336
train,100,21,21504,192,36864,58368
train,101,29,29696,366,70272,99968
train,102,26,26624,295,56640,83264
train,103,49,50176,1046,200832,251008
train,104,19,19456,157,30144,49600
train,105,38,38912,629,120768,159680
train,106,17,17408,126,24192,41600
train,107,19,19456,157,30144,49600
train,108,19,19456,157,30144,49600
train,109,17,17408,126,24192,41600
train,110,17,17408,126,24192,41600
train,111,31,31744,419,80448,112192
train,112,32,32768,446,85632,118400
train,113,26,26624,295,56640,83264
train,114,17,17408,126,24192,41600
train,115,16,16384,112,21504,37888
train,116,7,7168,21,4032,11200
train,117,20,20480,174,33408,53888
train,118,11,11264,53,10176,21440
train,119,60,61440,1568,301056,362496
train,120,10,10240,44,8448,18688
train,121,20,20480,174,33408,53888
train,122,8,8192,28,5376,13568
train,123,29,29696,366,70272,99968
train,124,35,35840,534,102528,138368
train,125,32,32768,446,85632,118400
train,126,21,21504,192,36864,58368
train,127,33,33792,474,91008,124800
train,128,21,21504,192,36864,58368
train,129,25,25600,272,52224,77824
train,130,24,24576,251,48192,72768
train,131,37,37888,596,114432,152320
train,132,28,28672,342,65664,94336
train,133,37,37888,596,114432,152320
train,134,54,55296,1270,243840,299136
train,135,40,40960,697,133824,174784
train,136,17,17408,126,24192,41600
train,137,43,44032,805,154560,198592
train,138,37,37888,596,114432,152320
train,139,14,14336,85,16320,30656
train,140,31,31744,419,80448,112192
train,141,6,6144,16,3072,9216
train,142,15,15360,98,18816,34176
train,143,14,14336,85,16320,30656
train,144,22,22528,211,40512,63040
train,145,25,25600,272,52224,77824
train,146,18,18432,141,27072,45504
train,147,24,24576,251,48192,72768
train,148,32,32768,446,85632,118400
train,149,11,11264,53,10176,21440
train,150,34,34816,504,96768,131584
train,151,13,13312,74,14208,27520
train,152,18,18432,141,27072,45504
train,153,25,25600,272,52224,77824
train,154,13,13312,74,14208,27520
train,155,10,10240,44,8448,18688
train,156,28,28672,342,65664,94336
train,157,25,25600,272,52224,77824
train,158,28,28672,342,65664,94336
train,159,7,7168,21,4032,11200
train,160,12,12288,63,12096,24384
train,161,26,26624,295,56640,83264
train,162,4,4096,7,1344,5440
train,163,8,8192,28,5376,13568
train,164,23,23552,230,44160,67712
train,165,12,12288,63,12096,24384
train,166,29,29696,366,70272,99968
train,167,7,7168,21,4032,11200
train,168,25,25600,272,52224,77824
train,169,20,20480,174,33408,53888
train,170,28,28672,342,65664,94336
train,171,33,33792,474,91008,124800
train,172,21,21504,192,36864,58368
train,173,11,11264,53,10176,21440
train,174,18,18432,141,27072,45504
train,175,33,33792,474,91008,124800
train,176,10,10240,44,8448,18688
train,177,26,26624,295,56640,83264
train,178,10,10240,44,8448,18688
train,179,31,31744,419,80448,112192
train,180,23,23552,230,44160,67712
train,181,42,43008,768,147456,190464
train,182,23,23552,230,44160,67712
train,183,16,16384,112,21504,37888
train,184,20,20480,174,33408,53888
train,185,23,23552,230,44160,67712
train,186,10,10240,44,8448,18688
train,187,21,21504,192,36864,58368
train,188,29,29696,366,70272,99968
train,189,37,37888,596,114432,152320
train,190,17,17408,126,24192,41600
train,191,11,11264,53,10176,21440
train,192,36,36864,565,108480,145344
train,193,15,15360,98,18816,34176
train,194,31,31744,419,80448,112192
train,195,27,27648,318,61056,88704
train,196,25,25600,272,52224,77824
train,197,11,11264,53,10176,21440
train,198,14,14336,85,16320,30656
train,199,15,15360,98,18816,34176
train,200,17,17408,126,24192,41600
train,201,30,30720,392,75264,105984
train,202,9,9216,35,6720,15936
train,203,18,18432,141,27072,45504
train,204,5,5120,11,2112,7232
train,205,20,20480,174,33408,53888
train,206,20,20480,174,33408,53888
train,207,39,39936,663,127296,167232
train,208,18,18432,141,27072,45504
train,209,20,20480,174,33408,53888
train,210,13,13312,74,14208,27520
train,211,36,36864,565,108480,145344
train,212,25,25600,272,52224,77824
train,213,31,31744,419,80448,112192
train,214,10,10240,44,8448,18688
train,215,24,24576,251,48192,72768
train,216,22,22528,211,40512,63040
train,217,29,29696,366,70272,99968
train,218,8,8192,28,5376,13568
train,219,26,26624,295,56640,83264
train,220,16,16384,112,21504,37888
train,221,26,26624,295,56640,83264
train,222,39,39936,663,127296,167232
train,223,27,27648,318,61056,88704
train,224,28,28672,342,65664,94336
train,225,6,6144,16,3072,9216
train,226,30,30720,392,75264,105984
train,227,30,30720,392,75264,105984
train,228,7,7168,21,4032,11200
train,229,51,52224,1133,217536,269760
train,230,23,23552,230,44160,67712
train,231,12,12288,63,12096,24384
train,232,18,18432,141,27072,45504
train,233,11,11264,53,10176,21440
train,234,8,8192,28,5376,13568
train,235,22,22528,211,40512,63040
train,236,16,16384,112,21504,37888
train,237,24,24576,251,48192,72768
train,238,19,19456,157,30144,49600
train,239,8,8192,28,5376,13568
train,240,36,36864,565,108480,145344
train,241,14,14336,85,16320,30656
train,242,13,13312,74,14208,27520
train,243,13,13312,74,14208,27520
train,244,6,6144,16,3072,9216
train,245,23,23552,230,44160,67712
train,246,34,34816,504,96768,131584
train,247,30,30720,392,75264,105984
train,248,10,10240,44,8448,18688
train,249,27,27648,318,61056,88704
train,250,34,34816,504,96768,131584
train,251,8,8192,28,5376,13568
train,252,26,26624,295,56640,83264
train,253,17,17408,126,24192,41600
train,254,27,27648,318,61056,88704
train,255,6,6144,16,3072,9216
train,256,21,21504,192,36864,58368
train,257,11,11264,53,10176,21440
train,258,33,33792,474,91008,124800
train,259,14,14336,85,16320,30656
train,260,22,22528,211,40512,63040
train,261,30,30720,392,75264,105984
train,262,41,41984,732,140544,182528
train,263,38,38912,629,120768,159680
train,264,7,7168,21,4032,11200
train,265,22,22528,211,40512,63040
train,266,16,16384,112,21504,37888
train,267,29,29696,366,70272,99968
train,268,23,23552,230,44160,67712
train,269,41,41984,732,140544,182528
train,270,36,36864,565,108480,145344
train,271,12,12288,63,12096,24384
train,272,23,23552,230,44160,67712
train,273,36,36864,565,108480,145344
train,274,27,27648,318,61056,88704
train,275,36,36864,565,108480,145344
train,276,33,33792,474,91008,124800
train,277,20,20480,174,33408,53888
train,278,30,30720,392,75264,105984
train,279,4,4096,7,1344,5440
train,280,8,8192,28,5376,13568
train,281,23,23552,230,44160,67712
train,282,16,16384,112,21504,37888
train,283,21,21504,192,36864,58368
train,284,18,18432,141,27072,45504
train,285,28,28672,342,65664,94336
train,286,9,9216,35,6720,15936
train,287,47,48128,962,184704,232832
train,288,17,17408,126,24192,41600
train,289,25,25600,272,52224,77824
train,290,13,13312,74,14208,27520
train,291,34,34816,504,96768,131584
train,292,26,26624,295,56640,83264
train,293,45,46080,882,169344,215424
train,294,17,17408,126,24192,41600
train,295,8,8192,28,5376,13568
train,296,43,44032,805,154560,198592
train,297,28,28672,342,65664,94336
train,298,19,19456,157,30144,49600
train,299,7,7168,21,4032,11200
train,300,27,27648,318,61056,88704
train,301,20,20480,174,33408,53888
train,302,21,21504,192,36864,58368
train,303,19,19456,157,30144,49600
train,304,9,9216,35,6720,15936
train,305,5,5120,11,2112,7232
train,306,7,7168,21,4032,11200
train,307,23,23552,230,44160,67712
train,308,19,19456,157,30144,49600
train,309,24,24576,251,48192,72768
train,310,13,13312,74,14208,27520
train,311,25,25600,272,52224,77824
train,312,41,41984,732,140544,182528
train,313,35,35840,534,102528,138368
train,314,11,11264,53,10176,21440
train,315,39,39936,663,127296,167232
train,316,21,21504,192,36864,58368
train,317,23,23552,230,44160,67712
train,318,6,6144,16,3072,9216
train,319,33,33792,474,91008,124800
train,320,26,26624,295,56640,83264
train,321,25,25600,272,52224,77824
train,322,17,17408,126,24192,41600
train,323,18,18432,141,27072,45504
train,324,31,31744,419,80448,112192
train,325,20,20480,174,33408,53888
train,326,24,24576,251,48192,72768
train,327,22,22528,211,40512,63040
train,328,38,38912,629,120768,159680
train,329,11,11264,53,10176,21440
train,330,37,37888,596,114432,152320
train,331,14,14336,85,16320,30656
train,332,26,26624,295,56640,83264
train,333,26,26624,295,56640,83264
train,334,36,36864,565,108480,145344
train,335,39,39936,663,127296,167232
train,336,20,20480,174,33408,53888
train,337,10,10240,44,8448,18688
train,338,34,34816,504,96768,131584
train,339,6,6144,16,3072,9216
train,340,17,17408,126,24192,41600
train,341,45,46080,882,169344,215424
train,342,8,8192,28,5376,13568
train,343,6,6144,16,3072,9216
train,344,5,5120,11,2112,7232
train,345,33,33792,474,91008,124800
train,346,29,29696,366,70272,99968
train,347,15,15360,98,18816,34176
train,348,9,9216,35,6720,15936
train,349,8,8192,28,5376,13568
train,350,32,32768,446,85632,118400
train,351,17,17408,126,24192,41600
train,352,42,43008,768,147456,190464
train,353,14,14336,85,16320,30656
train,354,25,25600,272,52224,77824
train,355,21,21504,192,36864,58368
train,356,23,23552,230,44160,67712
train,357,22,22528,211,40512,63040
train,358,37,37888,596,114432,152320
train,359,16,16384,112,21504,37888
train,360,12,12288,63,12096,24384
train,361,22,22528,211,40512,63040
train,362,19,19456,157,30144,49600
train,363,19,19456,157,30144,49600
train,364,16,16384,112,21504,37888
train,365,23,23552,230,44160,67712
train,366,32,32768,446,85632,118400
train,367,18,18432,141,27072,45504
train,368,37,37888,596,114432,152320
train,369,52,53248,1178,226176,279424
train,370,43,44032,805,154560,198592
train,371,11,11264,53,10176,21440
train,372,32,32768,446,85632,118400
train,373,9,9216,35,6720,15936
train,374,12,12288,63,12096,24384
train,375,18,18432,141,27072,45504
train,376,22,22528,211,40512,63040
train,377,14,14336,85,16320,30656
train,378,14,14336,85,16320,30656
train,379,35,35840,534,102528,138368
train,380,20,20480,174,33408,53888
train,381,6,6144,16,3072,9216
train,382,13,13312,74,14208,27520
train,383,10,10240,44,8448,18688
train,384,14,14336,85,16320,30656
train,385,8,8192,28,5376,13568
train,386,12,12288,63,12096,24384
train,387,9,9216,35,6720,15936
train,388,23,23552,230,44160,67712
train,389,31,31744,419,80448,112192
train,390,22,22528,211,40512,63040
train,391,5,5120,11,2112,7232
train,392,19,19456,157,30144,49600
train,393,25,25600,272,52224,77824
train,394,11,11264,53,10176,21440
train,395,22,22528,211,40512,63040
train,396,42,43008,768,147456,190464
train,397,15,15360,98,18816,34176
train,398,15,15360,98,18816,34176
train,399,36,36864,565,108480,145344
train,400,6,6144,16,3072,9216
train,401,41,41984,732,140544,182528
train,402,25,25600,272,52224,77824
train,403,40,40960,697,133824,174784
train,404,49,50176,1046,200832,251008
train,405,39,39936,663,127296,167232
train,406,26,26624,295,56640,83264
train,407,12,12288,63,12096,24384
train,408,28,28672,342,65664,94336
train,409,15,15360,98,18816,34176
train,410,20,20480,174,33408,53888
train,411,9,9216,35,6720,15936
train,412,23,23552,230,44160,67712
train,413,28,28672,342,65664,94336
train,414,41,41984,732,140544,182528
train,415,9,9216,35,6720,15936
train,416,28,28672,342,65664,94336
train,417,17,17408,126,24192,41600
train,418,34,34816,504,96768,131584
train,419,15,15360,98,18816,34176
train,420,19,19456,157,30144,49600
train,421,28,28672,342,65664,94336
train,422,10,10240,44,8448,18688
train,423,15,15360,98,18816,34176
train,424,29,29696,366,70272,99968
train,425,11,11264,53,10176,21440
train,426,26,26624,295,56640,83264
train,427,22,22528,211,40512,63040
train,428,26,26624,295,56640,83264
train,429,30,30720,392,75264,105984
train,430,18,18432,141,27072,45504
train,431,28,28672,342,65664,94336
train,432,25,25600,272,52224,77824
train,433,16,16384,112,21504,37888
train,434,36,36864,565,108480,145344
train,435,22,22528,211,40512,63040
train,436,34,34816,504,96768,131584
train,437,22,22528,211,40512,63040
train,438,14,14336,85,16320,30656
train,439,12,12288,63,12096,24384
train,440,12,12288,63,12096,24384
train,441,34,34816,504,96768,131584
train,442,40,40960,697,133824,174784
train,443,11,11264,53,10176,21440
train,444,14,14336,85,16320,30656
train,445,33,33792,474,91008,124800
train,446,15,15360,98,18816,34176
train,447,38,38912,629,120768,159680
train,448,22,22528,211,40512,63040
train,449,29,29696,366,70272,99968
train,450,33,33792,474,91008,124800
train,451,20,20480,174,33408,53888
train,452,10,10240,44,8448,18688
train,453,14,14336,85,16320,30656
train,454,10,10240,44,8448,18688
train,455,12,12288,63,12096,24384
train,456,44,45056,843,161856,206912
train,457,33,33792,474,91008,124800
train,458,6,6144,16,3072,9216
train,459,29,29696,366,70272,99968
train,460,11,11264,53,10176,21440
train,461,30,30720,392,75264,105984
train,462,41,41984,732,140544,182528
train,463,24,24576,251,48192,72768
train,464,17,17408,126,24192,41600
train,465,30,30720,392,75264,105984
train,466,26,26624,295,56640,83264
train,467,28,28672,342,65664,94336
train,468,27,27648,318,61056,88704
train,469,15,15360,98,18816,34176
train,470,24,24576,251,48192,72768
train,471,29,29696,366,70272,99968
train,472,31,31744,419,80448,112192
train,473,17,17408,126,24192,41600
train,474,33,33792,474,91008,124800
train,475,26,26624,295,56640,83264
train,476,33,33792,474,91008,124800
train,477,44,45056,843,161856,206912
train,478,18,18432,141,27072,45504
train,479,22,22528,211,40512,63040
train,480,30,30720,392,75264,105984
train,481,32,32768,446,85632,118400
train,482,5,5120,11,2112,7232
train,483,12,12288,63,12096,24384
train,484,44,45056,843,161856,206912
train,485,17,17408,126,24192,41600
train,486,27,27648,318,61056,88704
train,487,15,15360,98,18816,34176
train,488,28,28672,342,65664,94336
train,489,37,37888,596,114432,152320
train,490,13,13312,74,14208,27520
train,491,32,32768,446,85632,118400
train,492,9,9216,35,6720,15936
train,493,25,25600,272,52224,77824
train,494,8,8192,28,5376,13568
train,495,19,19456,157,30144,49600
train,496,12,12288,63,12096,24384
train,497,20,20480,174,33408,53888
train,498,36,36864,565,108480,145344
train,499,15,15360,98,18816,34176
train,500,26,26624,295,56640,83264
train,501,7,7168,21,4032,11200
train,502,29,29696,366,70272,99968
train,503,45,46080,882,169344,215424
train,504,36,36864,565,108480,145344
train,505,26,26624,295,56640,83264
train,506,19,19456,157,30144,49600
train,507,33,33792,474,91008,124800
train,508,30,30720,392,75264,105984
train,509,33,33792,474,91008,124800
train,510,32,32768,446,85632,118400
train,511,18,18432,141,27072,45504
train,512,10,10240,44,8448,18688
train,513,22,22528,211,40512,63040
train,514,16,16384,112,21504,37888
train,515,16,16384,112,21504,37888
train,516,34,34816,504,96768,131584
train,517,23,23552,230,44160,67712
train,518,15,15360,98,18816,34176
train,519,12,12288,63,12096,24384
train,520,43,44032,805,154560,198592
train,521,19,19456,157,30144,49600
train,522,9,9216,35,6720,15936
train,523,10,10240,44,8448,18688
train,524,16,16384,112,21504,37888
train,525,8,8192,28,5376,13568
train,526,27,27648,318,61056,88704
train,527,30,30720,392,75264,105984
train,528,15,15360,98,18816,34176
train,529,22,22528,211,40512,63040
train,530,16,16384,112,21504,37888
train,531,23,23552,230,44160,67712
train,532,16,16384,112,21504,37888
train,533,26,26624,295,56640,83264
train,534,29,29696,366,70272,99968
train,535,23,23552,230,44160,67712
train,536,48,49152,1004,192768,241920
train,537,23,23552,230,44160,67712
train,538,9,9216,35,6720,15936
train,539,26,26624,295,56640,83264
train,540,16,16384,112,21504,37888
train,541,24,24576,251,48192,72768
train,542,5,5120,11,2112,7232
train,543,16,16384,112,21504,37888
train,544,39,39936,663,127296,167232
train,545,44,45056,843,161856,206912
train,546,25,25600,272,52224,77824
train,547,37,37888,596,114432,152320
train,548,22,22528,211,40512,63040
train,549,13,13312,74,14208,27520
train,550,15,15360,98,18816,34176
train,551,36,36864,565,108480,145344
train,552,12,12288,63,12096,24384
train,553,25,25600,272,52224,77824
train,554,23,23552,230,44160,67712
train,555,6,6144,16,3072,9216
train,556,23,23552,230,44160,67712
train,557,14,14336,85,16320,30656
train,558,29,29696,366,70272,99968
train,559,29,29696,366,70272,99968
train,560,14,14336,85,16320,30656
train,561,20,20480,174,33408,53888
train,562,8,8192,28,5376,13568
train,563,19,19456,157,30144,49600
train,564,37,37888,596,114432,152320
train,565,37,37888,596,114432,152320
train,566,41,41984,732,140544,182528
train,567,26,26624,295,56640,83264
train,568,13,13312,74,14208,27520
train,569,9,9216,35,6720,15936
train,570,9,9216,35,6720,15936
train,571,19,19456,157,30144,49600
train,572,22,22528,211,40512,63040
train,573,36,36864,565,108480,145344
train,574,8,8192,28,5376,13568
train,575,38,38912,629,120768,159680
train,576,26,26624,295,56640,83264
train,577,28,28672,342,65664,94336
train,578,24,24576,251,48192,72768
train,579,16,16384,112,21504,37888
train,580,19,19456,157,30144,49600
train,581,25,25600,272,52224,77824
train,582,24,24576,251,48192,72768
train,583,15,15360,98,18816,34176
train,584,31,31744,419,80448,112192
train,585,28,28672,342,65664,94336
train,586,16,16384,112,21504,37888
train,587,20,20480,174,33408,53888
train,588,20,20480,174,33408,53888
train,589,49,50176,1046,200832,251008
train,590,27,27648,318,61056,88704
train,591,29,29696,366,70272,99968
train,592,27,27648,318,61056,88704
train,593,15,15360,98,18816,34176
train,594,30,30720,392,75264,105984
train,595,50,51200,1089,209088,260288
train,596,14,14336,85,16320,30656
train,597,8,8192,28,5376,13568
train,598,33,33792,474,91008,124800
train,599,22,22528,211,40512,63040
train,600,22,22528,211,40512,63040
train,601,26,26624,295,56640,83264
train,602,6,6144,16,3072,9216
train,603,21,21504,192,36864,58368
train,604,8,8192,28,5376,13568
train,605,18,18432,141,27072,45504
train,606,10,10240,44,8448,18688
train,607,18,18432,141,27072,45504
train,608,21,21504,192,36864,58368
train,609,20,20480,174,33408,53888
train,610,10,10240,44,8448,18688
train,611,30,30720,392,75264,105984
train,612,9,9216,35,6720,15936
train,613,34,34816,504,96768,131584
train,614,11,11264,53,10176,21440
train,615,38,38912,629,120768,159680
train,616,28,28672,342,65664,94336
train,617,9,9216,35,6720,15936
train,618,38,38912,629,120768,159680
train,619,12,12288,63,12096,24384
train,620,36,36864,565,108480,145344
train,621,3,3072,4,768,3840
train,622,36,36864,565,108480,145344
train,623,14,14336,85,16320,30656
train,624,21,21504,192,36864,58368
train,625,20,20480,174,33408,53888
train,626,28,28672,342,65664,94336
train,627,33,33792,474,91008,124800
train,628,37,37888,596,114432,152320
train,629,9,9216,35,6720,15936
train,630,5,5120,11,2112,7232
train,631,45,46080,882,169344,215424
train,632,22,22528,211,40512,63040
train,633,23,23552,230,44160,67712
train,634,26,26624,295,56640,83264
train,635,8,8192,28,5376,13568
train,636,19,19456,157,30144,49600
train,637,19,19456,157,30144,49600
train,638,26,26624,295,56640,83264
train,639,20,20480,174,33408,53888
train,640,25,25600,272,52224,77824
train,641,51,52224,1133,217536,269760
train,642,35,35840,534,102528,138368
train,643,50,51200,1089,209088,260288
train,644,32,32768,446,85632,118400
train,645,33,33792,474,91008,124800
train,646,16,16384,112,21504,37888
train,647,15,15360,98,18816,34176
train,648,22,22528,211,40512,63040
train,649,18,18432,141,27072,45504
train,650,14,14336,85,16320,30656
train,651,41,41984,732,140544,182528
train,652,15,15360,98,18816,34176
train,653,20,20480,174,33408,53888
train,654,11,11264,53,10176,21440
train,655,29,29696,366,70272,99968
train,656,13,13312,74,14208,27520
train,657,23,23552,230,44160,67712
train,658,27,27648,318,61056,88704
train,659,5,5120,11,2112,7232
train,660,26,26624,295,56640,83264
train,661,19,19456,157,30144,49600
train,662,23,23552,230,44160,67712
train,663,3,3072,4,768,3840
train,664,12,12288,63,12096,24384
train,665,12,12288,63,12096,24384
train,666,17,17408,126,24192,41600
train,667,21,21504,192,36864,58368
train,668,8,8192,28,5376,13568
train,669,13,13312,74,14208,27520
train,670,36,36864,565,108480,145344
train,671,15,15360,98,18816,34176
train,672,16,16384,112,21504,37888
train,673,8,8192,28,5376,13568
train,674,13,13312,74,14208,27520
train,675,18,18432,141,27072,45504
train,676,40,40960,697,133824,174784
train,677,25,25600,272,52224,77824
train,678,18,18432,141,27072,45504
train,679,6,6144,16,3072,9216
train,680,13,13312,74,14208,27520
train,681,11,11264,53,10176,21440
train,682,8,8192,28,5376,13568
train,683,17,17408,126,24192,41600
train,684,18,18432,141,27072,45504
train,685,9,9216,35,6720,15936
train,686,6,6144,16,3072,9216
train,687,15,15360,98,18816,34176
train,688,13,13312,74,14208,27520
train,689,23,23552,230,44160,67712
train,690,11,11264,53,10176,21440
train,691,5,5120,11,2112,7232
train,692,10,10240,44,8448,18688
train,693,27,27648,318,61056,88704
train,694,9,9216,35,6720,15936
train,695,59,60416,1516,291072,351488
train,696,31,31744,419,80448,112192
train,697,31,31744,419,80448,112192
train,698,13,13312,74,14208,27520
train,699,14,14336,85,16320,30656
train,700,46,47104,922,177024,224128
train,701,15,15360,98,18816,34176
train,702,12,12288,63,12096,24384
train,703,17,17408,126,24192,41600
train,704,25,25600,272,52224,77824
train,705,24,24576,251,48192,72768
train,706,10,10240,44,8448,18688
train,707,34,34816,504,96768,131584
train,708,23,23552,230,44160,67712
train,709,19,19456,157,30144,49600
train,710,33,33792,474,91008,124800
train,711,21,21504,192,36864,58368
train,712,15,15360,98,18816,34176
train,713,22,22528,211,40512,63040
train,714,44,45056,843,161856,206912
train,715,23,23552,230,44160,67712
train,716,29,29696,366,70272,99968
train,717,19,19456,157,30144,49600
train,718,36,36864,565,108480,145344
train,719,34,34816,504,96768,131584
train,720,16,16384,112,21504,37888
train,721,38,38912,629,120768,159680
train,722,11,11264,53,10176,21440
train,723,31,31744,419,80448,112192
train,724,20,20480,174,33408,53888
train,725,16,16384,112,21504,37888
train,726,24,24576,251,48192,72768
train,727,6,6144,16,3072,9216
train,728,32,32768,446,85632,118400
train,729,27,27648,318,61056,88704
train,730,23,23552,230,44160,67712
train,731,17,17408,126,24192,41600
train,732,41,41984,732,140544,182528
train,733,31,31744,419,80448,112192
train,734,27,27648,318,61056,88704
train,735,37,37888,596,114432,152320
train,736,31,31744,419,80448,112192
train,737,5,5120,11,2112,7232
train,738,18,18432,141,27072,45504
train,739,11,11264,53,10176,21440
train,740,27,27648,318,61056,88704
train,741,12,12288,63,12096,24384
train,742,15,15360,98,18816,34176
train,743,15,15360,98,18816,34176
train,744,4,4096,7,1344,5440
train,745,11,11264,53,10176,21440
train,746,24,24576,251,48192,72768
train,747,36,36864,565,108480,145344
train,748,17,17408,126,24192,41600
train,749,17,17408,126,24192,41600
train,750,25,25600,272,52224,77824
train,751,26,26624,295,56640,83264
train,752,11,11264,53,10176,21440
train,753,23,23552,230,44160,67712
train,754,19,19456,157,30144,49600
train,755,24,24576,251,48192,72768
train,756,30,30720,392,75264,105984
train,757,18,18432,141,27072,45504
train,758,10,10240,44,8448,18688
train,759,26,26624,295,56640,83264
train,760,6,6144,16,3072,9216
train,761,28,28672,342,65664,94336
train,762,21,21504,192,36864,58368
train,763,36,36864,565,108480,145344
train,764,22,22528,211,40512,63040
train,765,27,27648,318,61056,88704
train,766,18,18432,141,27072,45504
train,767,13,13312,74,14208,27520
train,768,42,43008,768,147456,190464
train,769,23,23552,230,44160,67712
train,770,27,27648,318,61056,88704
train,771,13,13312,74,14208,27520
train,772,24,24576,251,48192,72768
train,773,26,26624,295,56640,83264
train,774,34,34816,504,96768,131584
train,775,22,22528,211,40512,63040
train,776,44,45056,843,161856,206912
train,777,33,33792,474,91008,124800
train,778,40,40960,697,133824,174784
train,779,35,35840,534,102528,138368
train,780,37,37888,596,114432,152320
train,781,44,45056,843,161856,206912
train,782,29,29696,366,70272,99968
train,783,25,25600,272,52224,77824
train,784,12,12288,63,12096,24384
train,785,11,11264,53,10176,21440
train,786,14,14336,85,16320,30656
train,787,32,32768,446,85632,118400
train,788,52,53248,1178,226176,279424
train,789,9,9216,35,6720,15936
train,790,25,25600,272,52224,77824
train,791,11,11264,53,10176,21440
train,792,10,10240,44,8448,18688
train,793,26,26624,295,56640,83264
train,794,10,10240,44,8448,18688
train,795,40,40960,697,133824,174784
train,796,41,41984,732,140544,182528
train,797,7,7168,21,4032,11200
train,798,13,13312,74,14208,27520
train,799,19,19456,157,30144,49600
train,800,35,35840,534,102528,138368
train,801,13,13312,74,14208,27520
train,802,9,9216,35,6720,15936
train,803,25,25600,272,52224,77824
train,804,13,13312,74,14208,27520
train,805,25,25600,272,52224,77824
train,806,37,37888,596,114432,152320
train,807,33,33792,474,91008,124800
train,808,28,28672,342,65664,94336
train,809,5,5120,11,2112,7232
train,810,15,15360,98,18816,34176
train,811,6,6144,16,3072,9216
train,812,29,29696,366,70272,99968
train,813,39,39936,663,127296,167232
train,814,49,50176,1046,200832,251008
train,815,41,41984,732,140544,182528
train,816,19,19456,157,30144,49600
train,817,39,39936,663,127296,167232
train,818,30,30720,392,75264,105984
train,819,19,19456,157,30144,49600
train,820,19,19456,157,30144,49600
train,821,21,21504,192,36864,58368
train,822,20,20480,174,33408,53888
train,823,16,16384,112,21504,37888
train,824,27,27648,318,61056,88704
train,825,33,33792,474,91008,124800
train,826,8,8192,28,5376,13568
train,827,39,39936,663,127296,167232
train,828,17,17408,126,24192,41600
train,829,27,27648,318,61056,88704
train,830,42,43008,768,147456,190464
train,831,23,23552,230,44160,67712
train,832,39,39936,663,127296,167232
train,833,12,12288,63,12096,24384
train,834,29,29696,366,70272,99968
train,835,20,20480,174,33408,53888
train,836,38,38912,629,120768,159680
train,837,18,18432,141,27072,45504
train,838,22,22528,211,40512,63040
train,839,26,26624,295,56640,83264
train,840,39,39936,663,127296,167232
train,841,31,31744,419,80448,112192
train,842,9,9216,35,6720,15936
train,843,14,14336,85,16320,30656
train,844,34,34816,504,96768,131584
train,845,7,7168,21,4032,11200
train,846,55,56320,1318,253056,309376
train,847,28,28672,342,65664,94336
train,848,17,17408,126,24192,41600
train,849,15,15360,98,18816,34176
train,850,19,19456,157,30144,49600
train,851,9,9216,35,6720,15936
train,852,35,35840,534,102528,138368
train,853,14,14336,85,16320,30656
train,854,23,23552,230,44160,67712
train,855,15,15360,98,18816,34176
train,856,23,23552,230,44160,67712
train,857,49,50176,1046,200832,251008
train,858,34,34816,504,96768,131584
train,859,35,35840,534,102528,138368
train,860,6,6144,16,3072,9216
train,861,35,35840,534,102528,138368
train,862,19,19456,157,30144,49600
train,863,10,10240,44,8448,18688
train,864,37,37888,596,114432,152320
train,865,17,17408,126,24192,41600
train,866,31,31744,419,80448,112192
train,867,15,15360,98,18816,34176
train,868,20,20480,174,33408,53888
train,869,31,31744,419,80448,112192
train,870,18,18432,141,27072,45504
train,871,22,22528,211,40512,63040
train,872,26,26624,295,56640,83264
train,873,18,18432,141,27072,45504
train,874,20,20480,174,33408,53888
train,875,41,41984,732,140544,182528
train,876,11,11264,53,10176,21440
train,877,34,34816,504,96768,131584
train,878,26,26624,295,56640,83264
train,879,20,20480,174,33408,53888
train,880,11,11264,53,10176,21440
train,881,11,11264,53,10176,21440
train,882,22,22528,211,40512,63040
train,883,15,15360,98,18816,34176
train,884,7,7168,21,4032,11200
train,885,9,9216,35,6720,15936
train,886,19,19456,157,30144,49600
train,887,20,20480,174,33408,53888
train,888,14,14336,85,16320,30656
train,889,20,20480,174,33408,53888
train,890,25,25600,272,52224,77824
train,891,8,8192,28,5376,13568
train,892,27,27648,318,61056,88704
train,893,21,21504,192,36864,58368
train,894,13,13312,74,14208,27520
train,895,36,36864,565,108480,145344
train,896,32,32768,446,85632,118400
train,897,20,20480,174,33408,53888
train,898,27,27648,318,61056,88704
train,899,18,18432,141,27072,45504
train,900,25,25600,272,52224,77824
train,901,20,20480,174,33408,53888
train,902,17,17408,126,24192,41600
train,903,18,18432,141,27072,45504
train,904,26,26624,295,56640,83264
train,905,9,9216,35,6720,15936
train,906,52,53248,1178,226176,279424
train,907,30,30720,392,75264,105984
train,908,27,27648,318,61056,88704
train,909,11,11264,53,10176,21440
train,910,8,8192,28,5376,13568
train,911,25,25600,272,52224,77824
train,912,18,18432,141,27072,45504
train,913,39,39936,663,127296,167232
train,914,7,7168,21,4032,11200
train,915,17,17408,126,24192,41600
train,916,19,19456,157,30144,49600
train,917,24,24576,251,48192,72768
train,918,11,11264,53,10176,21440
train,919,41,41984,732,140544,182528
train,920,16,16384,112,21504,37888
train,921,31,31744,419,80448,112192
train,922,29,29696,366,70272,99968
train,923,12,12288,63,12096,24384
train,924,27,27648,318,61056,88704
train,925,12,12288,63,12096,24384
train,926,17,17408,126,24192,41600
train,927,24,24576,251,48192,72768
train,928,9,9216,35,6720,15936
train,929,31,31744,419,80448,112192
train,930,8,8192,28,5376,13568
train,931,27,27648,318,61056,88704
train,932,10,10240,44,8448,18688
train,933,35,35840,534,102528,138368
train,934,16,16384,112,21504,37888
train,935,32,32768,446,85632,118400
train,936,15,15360,98,18816,34176
train,937,20,20480,174,33408,53888
train,938,23,23552,230,44160,67712
train,939,7,7168,21,4032,11200
train,940,26,26624,295,56640,83264
train,941,26,26624,295,56640,83264
train,942,5,5120,11,2112,7232
train,943,10,10240,44,8448,18688
train,944,19,19456,157,30144,49600
train,945,8,8192,28,5376,13568
train,946,18,18432,141,27072,45504
train,947,20,20480,174,33408,53888
train,948,23,23552,230,44160,67712
train,949,24,24576,251,48192,72768
train,950,22,22528,211,40512,63040
train,951,8,8192,28,5376,13568
train,952,20,20480,174,33408,53888
train,953,12,12288,63,12096,24384
train,954,15,15360,98,18816,34176
train,955,42,43008,768,147456,190464
train,956,8,8192,28,5376,13568
train,957,6,6144,16,3072,9216
train,958,19,19456,157,30144,49600
train,959,25,25600,272,52224,77824
train,960,30,30720,392,75264,105984
train,961,12,12288,63,12096,24384
train,962,32,32768,446,85632,118400
train,963,9,9216,35,6720,15936
train,964,36,36864,565,108480,145344
train,965,8,8192,28,5376,13568
train,966,24,24576,251,48192,72768
train,967,24,24576,251,48192,72768
train,968,31,31744,419,80448,112192
train,969,10,10240,44,8448,18688
train,970,51,52224,1133,217536,269760
train,971,23,23552,230,44160,67712
train,972,46,47104,922,177024,224128
train,973,34,34816,504,96768,131584
train,974,28,28672,342,65664,94336
train,975,43,44032,805,154560,198592
train,976,27,27648,318,61056,88704
train,977,14,14336,85,16320,30656
train,978,10,10240,44,8448,18688
train,979,29,29696,366,70272,99968
train,980,19,19456,157,30144,49600
train,981,12,12288,63,12096,24384
train,982,33,33792,474,91008,124800
train,983,3,3072,4,768,3840
train,984,26,26624,295,56640,83264
train,985,31,31744,419,80448,112192
train,986,38,38912,629,120768,159680
train,987,39,39936,663,127296,167232
train,988,26,26624,295,56640,83264
train,989,17,17408,126,24192,41600
train,990,19,19456,157,30144,49600
train,991,22,22528,211,40512,63040
train,992,48,49152,1004,192768,241920
train,993,5,5120,11,2112,7232
train,994,15,15360,98,18816,34176
train,995,35,35840,534,102528,138368
train,996,14,14336,85,16320,30656
train,997,27,27648,318,61056,88704
train,998,34,34816,504,96768,131584
train,999,36,36864,565,108480,145344
train,1000,37,37888,596,114432,152320
train,1001,17,17408,126,24192,41600
train,1002,15,15360,98,18816,34176
train,1003,39,39936,663,127296,167232
train,1004,32,32768,446,85632,118400
train,1005,13,13312,74,14208,27520
train,1006,36,36864,565,108480,145344
train,1007,25,25600,272,52224,77824
train,1008,38,38912,629,120768,159680
train,1009,31,31744,419,80448,112192
train,1010,25,25600,272,52224,77824
train,1011,30,30720,392,75264,105984
train,1012,9,9216,35,6720,15936
train,1013,18,18432,141,27072,45504
train,1014,36,36864,565,108480,145344
train,1015,15,15360,98,18816,34176
train,1016,35,35840,534,102528,138368
train,1017,29,29696,366,70272,99968
train,1018,39,39936,663,127296,167232
train,1019,19,19456,157,30144,49600
train,1020,32,32768,446,85632,118400
train,1021,13,13312,74,14208,27520
train,1022,10,10240,44,8448,18688
train,1023,21,21504,192,36864,58368
train,1024,14,14336,85,16320,30656
train,1025,23,23552,230,44160,67712
train,1026,31,31744,419,80448,112192
train,1027,37,37888,596,114432,152320
train,1028,5,5120,11,2112,7232
train,1029,25,25600,272,52224,77824
train,1030,13,13312,74,14208,27520
train,1031,28,28672,342,65664,94336
train,1032,31,31744,419,80448,112192
train,1033,23,23552,230,44160,67712
train,1034,10,10240,44,8448,18688
train,1035,35,35840,534,102528,138368
train,1036,21,21504,192,36864,58368
train,1037,23,23552,230,44160,67712
train,1038,28,28672,342,65664,94336
train,1039,24,24576,251,48192,72768
train,1040,26,26624,295,56640,83264
train,1041,37,37888,596,114432,152320
train,1042,27,27648,318,61056,88704
train,1043,20,20480,174,33408,53888
train,1044,15,15360,98,18816,34176
train,1045,11,11264,53,10176,21440
train,1046,23,23552,230,44160,67712
train,1047,15,15360,98,18816,34176
train,1048,12,12288,63,12096,24384
train,1049,23,23552,230,44160,67712
train,1050,35,35840,534,102528,138368
train,1051,23,23552,230,44160,67712
train,1052,12,12288,63,12096,24384
train,1053,33,33792,474,91008,124800
train,1054,18,18432,141,27072,45504
train,1055,18,18432,141,27072,45504
train,1056,18,18432,141,27072,45504
train,1057,19,19456,157,30144,49600
train,1058,15,15360,98,18816,34176
train,1059,7,7168,21,4032,11200
train,1060,26,26624,295,56640,83264
train,1061,14,14336,85,16320,30656
train,1062,29,29696,366,70272,99968
train,1063,23,23552,230,44160,67712
train,1064,38,38912,629,120768,159680
train,1065,17,17408,126,24192,41600
train,1066,23,23552,230,44160,67712
train,1067,37,37888,596,114432,152320
train,1068,20,20480,174,33408,53888
train,1069,29,29696,366,70272,99968
train,1070,4,4096,7,1344,5440
train,1071,21,21504,192,36864,58368
train,1072,22,22528,211,40512,63040
train,1073,31,31744,419,80448,112192
train,1074,12,12288,63,12096,24384
train,1075,34,34816,504,96768,131584
train,1076,34,34816,504,96768,131584
train,1077,12,12288,63,12096,24384
train,1078,9,9216,35,6720,15936
train,1079,40,40960,697,133824,174784
train,1080,14,14336,85,16320,30656
train,1081,17,17408,126,24192,41600
train,1082,8,8192,28,5376,13568
train,1083,7,7168,21,4032,11200
train,1084,16,16384,112,21504,37888
train,1085,29,29696,366,70272,99968
train,1086,14,14336,85,16320,30656
train,1087,23,23552,230,44160,67712
train,1088,11,11264,53,10176,21440
train,1089,25,25600,272,52224,77824
train,1090,30,30720,392,75264,105984
train,1091,34,34816,504,96768,131584
train,1092,30,30720,392,75264,105984
train,1093,12,12288,63,12096,24384
train,1094,15,15360,98,18816,34176
train,1095,22,22528,211,40512,63040
train,1096,44,45056,843,161856,206912
train,1097,31,31744,419,80448,112192
train,1098,29,29696,366,70272,99968
train,1099,29,29696,366,70272,99968
train,1100,20,20480,174,33408,53888
train,1101,25,25600,272,52224,77824
train,1102,31,31744,419,80448,112192
train,1103,13,13312,74,14208,27520
train,1104,29,29696,366,70272,99968
train,1105,28,28672,342,65664,94336
train,1106,18,18432,141,27072,45504
train,1107,5,5120,11,2112,7232
train,1108,17,17408,126,24192,41600
train,1109,10,10240,44,8448,18688
train,1110,9,9216,35,6720,15936
train,1111,38,38912,629,120768,159680
train,1112,19,19456,157,30144,49600
train,1113,16,16384,112,21504,37888
train,1114,43,44032,805,154560,198592
train,1115,41,41984,732,140544,182528
train,1116,9,9216,35,6720,15936
train,1117,34,34816,504,96768,131584
train,1118,53,54272,1224,235008,289280
train,1119,10,10240,44,8448,18688
train,1120,15,15360,98,18816,34176
train,1121,24,24576,251,48192,72768
train,1122,25,25600,272,52224,77824
train,1123,12,12288,63,12096,24384
train,1124,15,15360,98,18816,34176
train,1125,22,22528,211,40512,63040
train,1126,17,17408,126,24192,41600
train,1127,40,40960,697,133824,174784
train,1128,30,30720,392,75264,105984
train,1129,20,20480,174,33408,53888
train,1130,11,11264,53,10176,21440
train,1131,41,41984,732,140544,182528
train,1132,11,11264,53,10176,21440
train,1133,38,38912,629,120768,159680
train,1134,36,36864,565,108480,145344
train,1135,25,25600,272,52224,77824
train,1136,33,33792,474,91008,124800
train,1137,24,24576,251,48192,72768
train,1138,27,27648,318,61056,88704
train,1139,34,34816,504,96768,131584
train,1140,15,15360,98,18816,34176
train,1141,5,5120,11,2112,7232
train,1142,13,13312,74,14208,27520
train,1143,6,6144,16,3072,9216
train,1144,11,11264,53,10176,21440
train,1145,18,18432,141,27072,45504
train,1146,40,40960,697,133824,174784
train,1147,16,16384,112,21504,37888
train,1148,4,4096,7,1344,5440
train,1149,33,33792,474,91008,124800
train,1150,7,7168,21,4032,11200
train,1151,18,18432,141,27072,45504
train,1152,10,10240,44,8448,18688
train,1153,20,20480,174,33408,53888
train,1154,22,22528,211,40512,63040
train,1155,17,17408,126,24192,41600
train,1156,48,49152,1004,192768,241920
train,1157,10,10240,44,8448,18688
train,1158,37,37888,596,114432,152320
train,1159,20,20480,174,33408,53888
train,1160,13,13312,74,14208,27520
train,1161,25,25600,272,52224,77824
train,1162,39,39936,663,127296,167232
train,1163,24,24576,251,48192,72768
train,1164,15,15360,98,18816,34176
train,1165,22,22528,211,40512,63040
train,1166,18,18432,141,27072,45504
train,1167,26,26624,295,56640,83264
train,1168,10,10240,44,8448,18688
train,1169,29,29696,366,70272,99968
train,1170,37,37888,596,114432,152320
train,1171,17,17408,126,24192,41600
train,1172,37,37888,596,114432,152320
train,1173,17,17408,126,24192,41600
train,1174,16,16384,112,21504,37888
train,1175,10,10240,44,8448,18688
train,1176,23,23552,230,44160,67712
train,1177,10,10240,44,8448,18688
train,1178,17,17408,126,24192,41600
train,1179,10,10240,44,8448,18688
train,1180,25,25600,272,52224,77824
train,1181,11,11264,53,10176,21440
train,1182,7,7168,21,4032,11200
train,1183,14,14336,85,16320,30656
train,1184,29,29696,366,70272,99968
train,1185,12,12288,63,12096,24384
train,1186,12,12288,63,12096,24384
train,1187,21,21504,192,36864,58368
train,1188,26,26624,295,56640,83264
train,1189,36,36864,565,108480,145344
train,1190,19,19456,157,30144,49600
train,1191,22,22528,211,40512,63040
train,1192,39,39936,663,127296,167232
train,1193,19,19456,157,30144,49600
train,1194,18,18432,141,27072,45504
train,1195,13,13312,74,14208,27520
train,1196,27,27648,318,61056,88704
train,1197,16,16384,112,21504,37888
train,1198,5,5120,11,2112,7232
train,1199,31,31744,419,80448,112192
train,1200,39,39936,663,127296,167232
train,1201,12,12288,63,12096,24384
train,1202,7,7168,21,4032,11200
train,1203,30,30720,392,75264,105984
train,1204,39,39936,663,127296,167232
train,1205,23,23552,230,44160,67712
train,1206,23,23552,230,44160,67712
train,1207,11,11264,53,10176,21440
train,1208,14,14336,85,16320,30656
train,1209,16,16384,112,21504,37888
train,1210,34,34816,504,96768,131584
train,1211,25,25600,272,52224,77824
train,1212,14,14336,85,16320,30656
train,1213,33,33792,474,91008,124800
train,1214,11,11264,53,10176,21440
train,1215,31,31744,419,80448,112192
train,1216,11,11264,53,10176,21440
train,1217,8,8192,28,5376,13568
train,1218,14,14336,85,16320,30656
train,1219,24,24576,251,48192,72768
train,1220,17,17408,126,24192,41600
train,1221,32,32768,446,85632,118400
train,1222,7,7168,21,4032,11200
train,1223,11,11264,53,10176,21440
train,1224,20,20480,174,33408,53888
train,1225,17,17408,126,24192,41600
train,1226,14,14336,85,16320,30656
train,1227,21,21504,192,36864,58368
train,1228,43,44032,805,154560,198592
train,1229,38,38912,629,120768,159680
train,1230,9,9216,35,6720,15936
train,1231,6,6144,16,3072,9216
train,1232,12,12288,63,12096,24384
train,1233,12,12288,63,12096,24384
train,1234,34,34816,504,96768,131584
train,1235,35,35840,534,102528,138368
train,1236,27,27648,318,61056,88704
train,1237,27,27648,318,61056,88704
train,1238,16,16384,112,21504,37888
train,1239,53,54272,1224,235008,289280
train,1240,15,15360,98,18816,34176
train,1241,5,5120,11,2112,7232
train,1242,19,19456,157,30144,49600
train,1243,24,24576,251,48192,72768
train,1244,36,36864,565,108480,145344
train,1245,17,17408,126,24192,41600
train,1246,18,18432,141,27072,45504
train,1247,36,36864,565,108480,145344
train,1248,25,25600,272,52224,77824
train,1249,5,5120,11,2112,7232
train,1250,5,5120,11,2112,7232
train,1251,7,7168,21,4032,11200
train,1252,14,14336,85,16320,30656
train,1253,16,16384,112,21504,37888
train,1254,25,25600,272,52224,77824
train,1255,12,12288,63,12096,24384
train,1256,18,18432,141,27072,45504
train,1257,24,24576,251,48192,72768
train,1258,30,30720,392,75264,105984
train,1259,6,6144,16,3072,9216
train,1260,13,13312,74,14208,27520
train,1261,21,21504,192,36864,58368
train,1262,7,7168,21,4032,11200
train,1263,44,45056,843,161856,206912
train,1264,28,28672,342,65664,94336
train,1265,31,31744,419,80448,112192
train,1266,10,10240,44,8448,18688
train,1267,29,29696,366,70272,99968
train,1268,25,25600,272,52224,77824
train,1269,11,11264,53,10176,21440
train,1270,26,26624,295,56640,83264
train,1271,33,33792,474,91008,124800
train,1272,29,29696,366,70272,99968
train,1273,24,24576,251,48192,72768
train,1274,26,26624,295,56640,83264
train,1275,31,31744,419,80448,112192
train,1276,27,27648,318,61056,88704
train,1277,22,22528,211,40512,63040
train,1278,22,22528,211,40512,63040
train,1279,28,28672,342,65664,94336
train,1280,31,31744,419,80448,112192
train,1281,16,16384,112,21504,37888
train,1282,46,47104,922,177024,224128
train,1283,25,25600,272,52224,77824
train,1284,25,25600,272,52224,77824
train,1285,11,11264,53,10176,21440
train,1286,28,28672,342,65664,94336
train,1287,23,23552,230,44160,67712
train,1288,28,28672,342,65664,94336
train,1289,42,43008,768,147456,190464
train,1290,33,33792,474,91008,124800
train,1291,11,11264,53,10176,21440
train,1292,28,28672,342,65664,94336
train,1293,61,62464,1621,311232,373696
train,1294,22,22528,211,40512,63040
train,1295,30,30720,392,75264,105984
train,1296,22,22528,211,40512,63040
train,1297,11,11264,53,10176,21440
train,1298,24,24576,251,48192,72768
train,1299,10,10240,44,8448,18688
train,1300,35,35840,534,102528,138368
train,1301,28,28672,342,65664,94336
train,1302,16,16384,112,21504,37888
train,1303,30,30720,392,75264,105984
train,1304,30,30720,392,75264,105984
train,1305,15,15360,98,18816,34176
train,1306,21,21504,192,36864,58368
train,1307,26,26624,295,56640,83264
train,1308,49,50176,1046,200832,251008
train,1309,7,7168,21,4032,11200
train,1310,15,15360,98,18816,34176
train,1311,7,7168,21,4032,11200
train,1312,29,29696,366,70272,99968
train,1313,5,5120,11,2112,7232
train,1314,22,22528,211,40512,63040
train,1315,14,14336,85,16320,30656
train,1316,12,12288,63,12096,24384
train,1317,11,11264,53,10176,21440
train,1318,14,14336,85,16320,30656
train,1319,14,14336,85,16320,30656
train,1320,5,5120,11,2112,7232
train,1321,6,6144,16,3072,9216
train,1322,16,16384,112,21504,37888
train,1323,21,21504,192,36864,58368
train,1324,17,17408,126,24192,41600
train,1325,19,19456,157,30144,49600
train,1326,22,22528,211,40512,63040
train,1327,6,6144,16,3072,9216
train,1328,24,24576,251,48192,72768
train,1329,18,18432,141,27072,45504
train,1330,14,14336,85,16320,30656
train,1331,33,33792,474,91008,124800
train,1332,23,23552,230,44160,67712
train,1333,21,21504,192,36864,58368
train,1334,35,35840,534,102528,138368
train,1335,17,17408,126,24192,41600
train,1336,24,24576,251,48192,72768
train,1337,15,15360,98,18816,34176
train,1338,18,18432,141,27072,45504
train,1339,30,30720,392,75264,105984
train,1340,28,28672,342,65664,94336
train,1341,42,43008,768,147456,190464
train,1342,20,20480,174,33408,53888
train,1343,22,22528,211,40512,63040
train,1344,9,9216,35,6720,15936
train,1345,40,40960,697,133824,174784
train,1346,22,22528,211,40512,63040
train,1347,12,12288,63,12096,24384
train,1348,10,10240,44,8448,18688
train,1349,6,6144,16,3072,9216
train,1350,16,16384,112,21504,37888
train,1351,17,17408,126,24192,41600
train,1352,24,24576,251,48192,72768
train,1353,14,14336,85,16320,30656
train,1354,9,9216,35,6720,15936
train,1355,4,4096,7,1344,5440
train,1356,26,26624,295,56640,83264
train,1357,39,39936,663,127296,167232
train,1358,26,26624,295,56640,83264
train,1359,22,22528,211,40512,63040
train,1360,11,11264,53,10176,21440
train,1361,27,27648,318,61056,88704
train,1362,23,23552,230,44160,67712
train,1363,4,4096,7,1344,5440
train,1364,22,22528,211,40512,63040
train,1365,39,39936,663,127296,167232
train,1366,36,36864,565,108480,145344
train,1367,14,14336,85,16320,30656
train,1368,56,57344,1366,262272,319616
train,1369,20,20480,174,33408,53888
train,1370,21,21504,192,36864,58368
train,1371,56,57344,1366,262272,319616
train,1372,27,27648,318,61056,88704
train,1373,12,12288,63,12096,24384
train,1374,15,15360,98,18816,34176
train,1375,17,17408,126,24192,41600
train,1376,35,35840,534,102528,138368
train,1377,37,37888,596,114432,152320
train,1378,12,12288,63,12096,24384
train,1379,24,24576,251,48192,72768
train,1380,27,27648,318,61056,88704
train,1381,37,37888,596,114432,152320
train,1382,23,23552,230,44160,67712
train,1383,11,11264,53,10176,21440
train,1384,26,26624,295,56640,83264
train,1385,12,12288,63,12096,24384
train,1386,16,16384,112,21504,37888
train,1387,17,17408,126,24192,41600
train,1388,22,22528,211,40512,63040
train,1389,28,28672,342,65664,94336
train,1390,5,5120,11,2112,7232
train,1391,14,14336,85,16320,30656
train,1392,16,16384,112,21504,37888
train,1393,35,35840,534,102528,138368
train,1394,14,14336,85,16320,30656
train,1395,30,30720,392,75264,105984
train,1396,30,30720,392,75264,105984
train,1397,20,20480,174,33408,53888
train,1398,20,20480,174,33408,53888
train,1399,28,28672,342,65664,94336
train,1400,28,28672,342,65664,94336
train,1401,9,9216,35,6720,15936
train,1402,15,15360,98,18816,34176
train,1403,16,16384,112,21504,37888
train,1404,6,6144,16,3072,9216
train,1405,17,17408,126,24192,41600
train,1406,20,20480,174,33408,53888
train,1407,10,10240,44,8448,18688
train,1408,17,17408,126,24192,41600
train,1409,16,16384,112,21504,37888
train,1410,21,21504,192,36864,58368
train,1411,45,46080,882,169344,215424
train,1412,34,34816,504,96768,131584
train,1413,26,26624,295,56640,83264
train,1414,24,24576,251,48192,72768
train,1415,26,26624,295,56640,83264
train,1416,16,16384,112,21504,37888
train,1417,16,16384,112,21504,37888
train,1418,37,37888,596,114432,152320
train,1419,26,26624,295,56640,83264
train,1420,20,20480,174,33408,53888
train,1421,18,18432,141,27072,45504
train,1422,16,16384,112,21504,37888
train,1423,25,25600,272,52224,77824
train,1424,27,27648,318,61056,88704
train,1425,52,53248,1178,226176,279424
train,1426,8,8192,28,5376,13568
train,1427,10,10240,44,8448,18688
train,1428,21,21504,192,36864,58368
train,1429,38,38912,629,120768,159680
train,1430,31,31744,419,80448,112192
train,1431,23,23552,230,44160,67712
train,1432,11,11264,53,10176,21440
train,1433,8,8192,28,5376,13568
train,1434,25,25600,272,52224,77824
train,1435,31,31744,419,80448,112192
train,1436,17,17408,126,24192,41600
train,1437,19,19456,157,30144,49600
train,1438,24,24576,251,48192,72768
train,1439,26,26624,295,56640,83264
train,1440,16,16384,112,21504,37888
train,1441,12,12288,63,12096,24384
train,1442,25,25600,272,52224,77824
train,1443,30,30720,392,75264,105984
train,1444,19,19456,157,30144,49600
train,1445,36,36864,565,108480,145344
train,1446,16,16384,112,21504,37888
train,1447,28,28672,342,65664,94336
train,1448,38,38912,629,120768,159680
train,1449,11,11264,53,10176,21440
train,1450,10,10240,44,8448,18688
train,1451,12,12288,63,12096,24384
train,1452,36,36864,565,108480,145344
train,1453,10,10240,44,8448,18688
train,1454,31,31744,419,80448,112192
train,1455,27,27648,318,61056,88704
train,1456,14,14336,85,16320,30656
train,1457,40,40960,697,133824,174784
train,1458,14,14336,85,16320,30656
train,1459,19,19456,157,30144,49600
train,1460,34,34816,504,96768,131584
train,1461,19,19456,157,30144,49600
train,1462,19,19456,157,30144,49600
train,1463,9,9216,35,6720,15936
train,1464,22,22528,211,40512,63040
train,1465,15,15360,98,18816,34176
train,1466,36,36864,565,108480,145344
train,1467,27,27648,318,61056,88704
train,1468,16,16384,112,21504,37888
train,1469,20,20480,174,33408,53888
train,1470,12,12288,63,12096,24384
train,1471,35,35840,534,102528,138368
train,1472,37,37888,596,114432,152320
train,1473,30,30720,392,75264,105984
train,1474,26,26624,295,56640,83264
train,1475,20,20480,174,33408,53888
train,1476,17,17408,126,24192,41600
train,1477,12,12288,63,12096,24384
train,1478,34,34816,504,96768,131584
train,1479,27,27648,318,61056,88704
train,1480,16,16384,112,21504,37888
train,1481,45,46080,882,169344,215424
train,1482,39,39936,663,127296,167232
train,1483,6,6144,16,3072,9216
train,1484,27,27648,318,61056,88704
train,1485,37,37888,596,114432,152320
train,1486,32,32768,446,85632,118400
train,1487,11,11264,53,10176,21440
train,1488,13,13312,74,14208,27520
train,1489,6,6144,16,3072,9216
train,1490,13,13312,74,14208,27520
train,1491,13,13312,74,14208,27520
train,1492,13,13312,74,14208,27520
train,1493,36,36864,565,108480,145344
train,1494,20,20480,174,33408,53888
train,1495,8,8192,28,5376,13568
train,1496,33,33792,474,91008,124800
train,1497,24,24576,251,48192,72768
train,1498,39,39936,663,127296,167232
train,1499,42,43008,768,147456,190464
train,1500,25,25600,272,52224,77824
train,1501,18,18432,141,27072,45504
train,1502,16,16384,112,21504,37888
train,1503,19,19456,157,30144,49600
train,1504,11,11264,53,10176,21440
train,1505,7,7168,21,4032,11200
train,1506,39,39936,663,127296,167232
train,1507,6,6144,16,3072,9216
train,1508,41,41984,732,140544,182528
train,1509,31,31744,419,80448,112192
train,1510,17,17408,126,24192,41600
train,1511,12,12288,63,12096,24384
train,1512,17,17408,126,24192,41600
train,1513,8,8192,28,5376,13568
train,1514,28,28672,342,65664,94336
train,1515,41,41984,732,140544,182528
train,1516,11,11264,53,10176,21440
train,1517,22,22528,211,40512,63040
train,1518,10,10240,44,8448,18688
train,1519,12,12288,63,12096,24384
train,1520,14,14336,85,16320,30656
train,1521,14,14336,85,16320,30656
train,1522,12,12288,63,12096,24384
train,1523,15,15360,98,18816,34176
train,1524,40,40960,697,133824,174784
train,1525,18,18432,141,27072,45504
train,1526,26,26624,295,56640,83264
train,1527,32,32768,446,85632,118400
train,1528,38,38912,629,120768,159680
train,1529,7,7168,21,4032,11200
train,1530,35,35840,534,102528,138368
train,1531,25,25600,272,52224,77824
train,1532,25,25600,272,52224,77824
train,1533,38,38912,629,120768,159680
train,1534,16,16384,112,21504,37888
train,1535,19,19456,157,30144,49600
train,1536,11,11264,53,10176,21440
train,1537,16,16384,112,21504,37888
train,1538,15,15360,98,18816,34176
train,1539,31,31744,419,80448,112192
train,1540,12,12288,63,12096,24384
train,1541,29,29696,366,70272,99968
train,1542,25,25600,272,52224,77824
train,1543,17,17408,126,24192,41600
train,1544,30,30720,392,75264,105984
train,1545,29,29696,366,70272,99968
train,1546,21,21504,192,36864,58368
train,1547,42,43008,768,147456,190464
train,1548,24,24576,251,48192,72768
train,1549,14,14336,85,16320,30656
train,1550,11,11264,53,10176,21440
train,1551,14,14336,85,16320,30656
train,1552,21,21504,192,36864,58368
train,1553,48,49152,1004,192768,241920
train,1554,9,9216,35,6720,15936
train,1555,24,24576,251,48192,72768
train,1556,10,10240,44,8448,18688
train,1557,37,37888,596,114432,152320
train,1558,16,16384,112,21504,37888
train,1559,34,34816,504,96768,131584
train,1560,17,17408,126,24192,41600
train,1561,6,6144,16,3072,9216
train,1562,14,14336,85,16320,30656
train,1563,9,9216,35,6720,15936
train,1564,8,8192,28,5376,13568
train,1565,37,37888,596,114432,152320
train,1566,26,26624,295,56640,83264
train,1567,15,15360,98,18816,34176
train,1568,36,36864,565,108480,145344
train,1569,17,17408,126,24192,41600
train,1570,34,34816,504,96768,131584
train,1571,28,28672,342,65664,94336
train,1572,27,27648,318,61056,88704
train,1573,27,27648,318,61056,88704
train,1574,21,21504,192,36864,58368
train,1575,14,14336,85,16320,30656
train,1576,7,7168,21,4032,11200
train,1577,19,19456,157,30144,49600
train,1578,10,10240,44,8448,18688
train,1579,41,41984,732,140544,182528
train,1580,47,48128,962,184704,232832
train,1581,28,28672,342,65664,94336
train,1582,53,54272,1224,235008,289280
train,1583,5,5120,11,2112,7232
train,1584,6,6144,16,3072,9216
train,1585,14,14336,85,16320,30656
train,1586,18,18432,141,27072,45504
train,1587,41,41984,732,140544,182528
train,1588,11,11264,53,10176,21440
train,1589,31,31744,419,80448,112192
train,1590,13,13312,74,14208,27520
train,1591,26,26624,295,56640,83264
train,1592,27,27648,318,61056,88704
train,1593,31,31744,419,80448,112192
train,1594,34,34816,504,96768,131584
train,1595,12,12288,63,12096,24384
train,1596,13,13312,74,14208,27520
train,1597,12,12288,63,12096,24384
train,1598,15,15360,98,18816,34176
train,1599,34,34816,504,96768,131584
train,1600,30,30720,392,75264,105984
train,1601,36,36864,565,108480,145344
train,1602,8,8192,28,5376,13568
train,1603,14,14336,85,16320,30656
train,1604,38,38912,629,120768,159680
train,1605,15,15360,98,18816,34176
train,1606,25,25600,272,52224,77824
train,1607,22,22528,211,40512,63040
train,1608,10,10240,44,8448,18688
train,1609,21,21504,192,36864,58368
train,1610,43,44032,805,154560,198592
train,1611,12,12288,63,12096,24384
train,1612,25,25600,272,52224,77824
train,1613,21,21504,192,36864,58368
train,1614,22,22528,211,40512,63040
train,1615,17,17408,126,24192,41600
train,1616,31,31744,419,80448,112192
train,1617,21,21504,192,36864,58368
train,1618,13,13312,74,14208,27520
train,1619,10,10240,44,8448,18688
train,1620,40,40960,697,133824,174784
train,1621,17,17408,126,24192,41600
train,1622,8,8192,28,5376,13568
train,1623,9,9216,35,6720,15936
train,1624,30,30720,392,75264,105984
train,1625,41,41984,732,140544,182528
train,1626,13,13312,74,14208,27520
train,1627,20,20480,174,33408,53888
train,1628,28,28672,342,65664,94336
train,1629,11,11264,53,10176,21440
train,1630,16,16384,112,21504,37888
train,1631,35,35840,534,102528,138368
train,1632,21,21504,192,36864,58368
train,1633,20,20480,174,33408,53888
train,1634,3,3072,4,768,3840
train,1635,28,28672,342,65664,94336
train,1636,35,35840,534,102528,138368
train,1637,10,10240,44,8448,18688
train,1638,9,9216,35,6720,15936
train,1639,12,12288,63,12096,24384
train,1640,52,53248,1178,226176,279424
train,1641,15,15360,98,18816,34176
train,1642,25,25600,272,52224,77824
train,1643,19,19456,157,30144,49600
train,1644,32,32768,446,85632,118400
train,1645,9,9216,35,6720,15936
train,1646,35,35840,534,102528,138368
train,1647,14,14336,85,16320,30656
train,1648,4,4096,7,1344,5440
train,1649,18,18432,141,27072,45504
train,1650,8,8192,28,5376,13568
train,1651,23,23552,230,44160,67712
train,1652,31,31744,419,80448,112192
train,1653,52,53248,1178,226176,279424
train,1654,35,35840,534,102528,138368
train,1655,16,16384,112,21504,37888
train,1656,13,13312,74,14208,27520
train,1657,18,18432,141,27072,45504
train,1658,19,19456,157,30144,49600
train,1659,23,23552,230,44160,67712
train,1660,10,10240,44,8448,18688
train,1661,20,20480,174,33408,53888
train,1662,11,11264,53,10176,21440
train,1663,15,15360,98,18816,34176
train,1664,19,19456,157,30144,49600
train,1665,13,13312,74,14208,27520
train,1666,13,13312,74,14208,27520
train,1667,10,10240,44,8448,18688
train,1668,18,18432,141,27072,45504
train,1669,9,9216,35,6720,15936
train,1670,17,17408,126,24192,41600
train,1671,9,9216,35,6720,15936
train,1672,12,12288,63,12096,24384
train,1673,16,16384,112,21504,37888
train,1674,28,28672,342,65664,94336
train,1675,36,36864,565,108480,145344
train,1676,47,48128,962,184704,232832
train,1677,33,33792,474,91008,124800
train,1678,18,18432,141,27072,45504
train,1679,21,21504,192,36864,58368
train,1680,23,23552,230,44160,67712
train,1681,36,36864,565,108480,145344
train,1682,14,14336,85,16320,30656
train,1683,35,35840,534,102528,138368
train,1684,18,18432,141,27072,45504
train,1685,43,44032,805,154560,198592
train,1686,3,3072,4,768,3840
train,1687,10,10240,44,8448,18688
train,1688,20,20480,174,33408,53888
train,1689,30,30720,392,75264,105984
train,1690,38,38912,629,120768,159680
train,1691,42,43008,768,147456,190464
train,1692,16,16384,112,21504,37888
train,1693,19,19456,157,30144,49600
train,1694,30,30720,392,75264,105984
train,1695,34,34816,504,96768,131584
train,1696,14,14336,85,16320,30656
train,1697,19,19456,157,30144,49600
train,1698,10,10240,44,8448,18688
train,1699,28,28672,342,65664,94336
train,1700,6,6144,16,3072,9216
train,1701,23,23552,230,44160,67712
train,1702,26,26624,295,56640,83264
train,1703,23,23552,230,44160,67712
train,1704,42,43008,768,147456,190464
train,1705,49,50176,1046,200832,251008
train,1706,31,31744,419,80448,112192
train,1707,22,22528,211,40512,63040
train,1708,10,10240,44,8448,18688
train,1709,23,23552,230,44160,67712
train,1710,5,5120,11,2112,7232
train,1711,7,7168,21,4032,11200
train,1712,12,12288,63,12096,24384
train,1713,21,21504,192,36864,58368
train,1714,14,14336,85,16320,30656
train,1715,7,7168,21,4032,11200
train,1716,17,17408,126,24192,41600
train,1717,41,41984,732,140544,182528
train,1718,4,4096,7,1344,5440
train,1719,43,44032,805,154560,198592
train,1720,24,24576,251,48192,72768
train,1721,11,11264,53,10176,21440
train,1722,42,43008,768,147456,190464
train,1723,24,24576,251,48192,72768
train,1724,15,15360,98,18816,34176
train,1725,10,10240,44,8448,18688
train,1726,13,13312,74,14208,27520
train,1727,44,45056,843,161856,206912
train,1728,18,18432,141,27072,45504
train,1729,21,21504,192,36864,58368
train,1730,6,6144,16,3072,9216
train,1731,19,19456,157,30144,49600
train,1732,24,24576,251,48192,72768
train,1733,14,14336,85,16320,30656
train,1734,16,16384,112,21504,37888
train,1735,28,28672,342,65664,94336
train,1736,5,5120,11,2112,7232
train,1737,28,28672,342,65664,94336
train,1738,31,31744,419,80448,112192
train,1739,35,35840,534,102528,138368
train,1740,34,34816,504,96768,131584
train,1741,41,41984,732,140544,182528
train,1742,4,4096,7,1344,5440
train,1743,34,34816,504,96768,131584
train,1744,11,11264,53,10176,21440
train,1745,37,37888,596,114432,152320
train,1746,15,15360,98,18816,34176
train,1747,6,6144,16,3072,9216
train,1748,12,12288,63,12096,24384
train,1749,37,37888,596,114432,152320
train,1750,33,33792,474,91008,124800
train,1751,27,27648,318,61056,88704
train,1752,23,23552,230,44160,67712
train,1753,48,49152,1004,192768,241920
train,1754,24,24576,251,48192,72768
train,1755,19,19456,157,30144,49600
train,1756,33,33792,474,91008,124800
train,1757,17,17408,126,24192,41600
train,1758,17,17408,126,24192,41600
train,1759,11,11264,53,10176,21440
train,1760,30,30720,392,75264,105984
train,1761,21,21504,192,36864,58368
train,1762,15,15360,98,18816,34176
train,1763,33,33792,474,91008,124800
train,1764,35,35840,534,102528,138368
train,1765,16,16384,112,21504,37888
train,1766,44,45056,843,161856,206912
train,1767,11,11264,53,10176,21440
train,1768,12,12288,63,12096,24384
train,1769,24,24576,251,48192,72768
train,1770,13,13312,74,14208,27520
train,1771,29,29696,366,70272,99968
train,1772,39,39936,663,127296,167232
train,1773,17,17408,126,24192,41600
train,1774,15,15360,98,18816,34176
train,1775,17,17408,126,24192,41600
train,1776,20,20480,174,33408,53888
train,1777,3,3072,4,768,3840
train,1778,21,21504,192,36864,58368
train,1779,26,26624,295,56640,83264
train,1780,21,21504,192,36864,58368
train,1781,35,35840,534,102528,138368
train,1782,20,20480,174,33408,53888
train,1783,21,21504,192,36864,58368
train,1784,3,3072,4,768,3840
train,1785,22,22528,211,40512,63040
train,1786,22,22528,211,40512,63040
train,1787,13,13312,74,14208,27520
train,1788,38,38912,629,120768,159680
train,1789,18,18432,141,27072,45504
train,1790,20,20480,174,33408,53888
train,1791,5,5120,11,2112,7232
train,1792,17,17408,126,24192,41600
train,1793,15,15360,98,18816,34176
train,1794,24,24576,251,48192,72768
train,1795,22,22528,211,40512,63040
train,1796,11,11264,53,10176,21440
train,1797,24,24576,251,48192,72768
train,1798,20,20480,174,33408,53888
train,1799,32,32768,446,85632,118400
train,1800,31,31744,419,80448,112192
train,1801,43,44032,805,154560,198592
train,1802,16,16384,112,21504,37888
train,1803,14,14336,85,16320,30656
train,1804,14,14336,85,16320,30656
train,1805,32,32768,446,85632,118400
train,1806,10,10240,44,8448,18688
train,1807,29,29696,366,70272,99968
train,1808,9,9216,35,6720,15936
train,1809,12,12288,63,12096,24384
train,1810,18,18432,141,27072,45504
train,1811,16,16384,112,21504,37888
train,1812,20,20480,174,33408,53888
train,1813,9,9216,35,6720,15936
train,1814,36,36864,565,108480,145344
train,1815,25,25600,272,52224,77824
train,1816,13,13312,74,14208,27520
train,1817,22,22528,211,40512,63040
train,1818,29,29696,366,70272,99968
train,1819,9,9216,35,6720,15936
train,1820,18,18432,141,27072,45504
train,1821,8,8192,28,5376,13568
train,1822,19,19456,157,30144,49600
train,1823,43,44032,805,154560,198592
train,1824,18,18432,141,27072,45504
train,1825,36,36864,565,108480,145344
train,1826,11,11264,53,10176,21440
train,1827,25,25600,272,52224,77824
train,1828,16,16384,112,21504,37888
train,1829,21,21504,192,36864,58368
train,1830,10,10240,44,8448,18688
train,1831,21,21504,192,36864,58368
train,1832,32,32768,446,85632,118400
train,1833,14,14336,85,16320,30656
train,1834,13,13312,74,14208,27520
train,1835,7,7168,21,4032,11200
train,1836,21,21504,192,36864,58368
train,1837,19,19456,157,30144,49600
train,1838,23,23552,230,44160,67712
train,1839,20,20480,174,33408,53888
train,1840,15,15360,98,18816,34176
train,1841,13,13312,74,14208,27520
train,1842,37,37888,596,114432,152320
train,1843,21,21504,192,36864,58368
train,1844,36,36864,565,108480,145344
train,1845,17,17408,126,24192,41600
train,1846,9,9216,35,6720,15936
train,1847,44,45056,843,161856,206912
train,1848,29,29696,366,70272,99968
train,1849,34,34816,504,96768,131584
train,1850,22,22528,211,40512,63040
train,1851,21,21504,192,36864,58368
train,1852,52,53248,1178,226176,279424
train,1853,41,41984,732,140544,182528
train,1854,27,27648,318,61056,88704
train,1855,5,5120,11,2112,7232
train,1856,27,27648,318,61056,88704
train,1857,19,19456,157,30144,49600
train,1858,31,31744,419,80448,112192
train,1859,18,18432,141,27072,45504
train,1860,21,21504,192,36864,58368
train,1861,9,9216,35,6720,15936
train,1862,59,60416,1516,291072,351488
train,1863,10,10240,44,8448,18688
train,1864,14,14336,85,16320,30656
train,1865,19,19456,157,30144,49600
train,1866,21,21504,192,36864,58368
train,1867,29,29696,366,70272,99968
train,1868,22,22528,211,40512,63040
train,1869,43,44032,805,154560,198592
train,1870,36,36864,565,108480,145344
train,1871,21,21504,192,36864,58368
train,1872,4,4096,7,1344,5440
train,1873,20,20480,174,33408,53888
train,1874,29,29696,366,70272,99968
train,1875,24,24576,251,48192,72768
train,1876,10,10240,44,8448,18688
train,1877,17,17408,126,24192,41600
train,1878,7,7168,21,4032,11200
train,1879,15,15360,98,18816,34176
train,1880,16,16384,112,21504,37888
train,1881,17,17408,126,24192,41600
train,1882,7,7168,21,4032,11200
train,1883,42,43008,768,147456,190464
train,1884,31,31744,419,80448,112192
train,1885,31,31744,419,80448,112192
train,1886,31,31744,419,80448,112192
train,1887,11,11264,53,10176,21440
train,1888,6,6144,16,3072,9216
train,1889,13,13312,74,14208,27520
train,1890,23,23552,230,44160,67712
train,1891,12,12288,63,12096,24384
train,1892,9,9216,35,6720,15936
train,1893,14,14336,85,16320,30656
train,1894,9,9216,35,6720,15936
train,1895,26,26624,295,56640,83264
train,1896,13,13312,74,14208,27520
train,1897,16,16384,112,21504,37888
train,1898,29,29696,366,70272,99968
train,1899,52,53248,1178,226176,279424
train,1900,9,9216,35,6720,15936
train,1901,26,26624,295,56640,83264
train,1902,37,37888,596,114432,152320
train,1903,17,17408,126,24192,41600
train,1904,7,7168,21,4032,11200
train,1905,18,18432,141,27072,45504
train,1906,24,24576,251,48192,72768
train,1907,25,25600,272,52224,77824
train,1908,11,11264,53,10176,21440
train,1909,14,14336,85,16320,30656
train,1910,11,11264,53,10176,21440
train,1911,30,30720,392,75264,105984
train,1912,5,5120,11,2112,7232
train,1913,26,26624,295,56640,83264
train,1914,24,24576,251,48192,72768
train,1915,6,6144,16,3072,9216
train,1916,11,11264,53,10176,21440
train,1917,26,26624,295,56640,83264
train,1918,6,6144,16,3072,9216
train,1919,15,15360,98,18816,34176
train,1920,10,10240,44,8448,18688
train,1921,36,36864,565,108480,145344
train,1922,22,22528,211,40512,63040
train,1923,11,11264,53,10176,21440
train,1924,6,6144,16,3072,9216
train,1925,18,18432,141,27072,45504
train,1926,18,18432,141,27072,45504
train,1927,19,19456,157,30144,49600
train,1928,39,39936,663,127296,167232
train,1929,33,33792,474,91008,124800
train,1930,13,13312,74,14208,27520
train,1931,31,31744,419,80448,112192
train,1932,44,45056,843,161856,206912
train,1933,6,6144,16,3072,9216
train,1934,6,6144,16,3072,9216
train,1935,14,14336,85,16320,30656
train,1936,19,19456,157,30144,49600
train,1937,37,37888,596,114432,152320
train,1938,5,5120,11,2112,7232
train,1939,34,34816,504,96768,131584
train,1940,19,19456,157,30144,49600
train,1941,4,4096,7,1344,5440
train,1942,12,12288,63,12096,24384
train,1943,24,24576,251,48192,72768
train,1944,20,20480,174,33408,53888
train,1945,34,34816,504,96768,131584
train,1946,14,14336,85,16320,30656
train,1947,5,5120,11,2112,7232
train,1948,25,25600,272,52224,77824
train,1949,27,27648,318,61056,88704
train,1950,10,10240,44,8448,18688
train,1951,6,6144,16,3072,9216
train,1952,39,39936,663,127296,167232
train,1953,40,40960,697,133824,174784
train,1954,15,15360,98,18816,34176
train,1955,29,29696,366,70272,99968
train,1956,17,17408,126,24192,41600
train,1957,15,15360,98,18816,34176
train,1958,18,18432,141,27072,45504
train,1959,21,21504,192,36864,58368
train,1960,31,31744,419,80448,112192
train,1961,5,5120,11,2112,7232
train,1962,15,15360,98,18816,34176
train,1963,46,47104,922,177024,224128
train,1964,31,31744,419,80448,112192
train,1965,28,28672,342,65664,94336
train,1966,31,31744,419,80448,112192
train,1967,15,15360,98,18816,34176
train,1968,14,14336,85,16320,30656
train,1969,35,35840,534,102528,138368
train,1970,19,19456,157,30144,49600
train,1971,7,7168,21,4032,11200
train,1972,20,20480,174,33408,53888
train,1973,12,12288,63,12096,24384
train,1974,37,37888,596,114432,152320
train,1975,22,22528,211,40512,63040
train,1976,43,44032,805,154560,198592
train,1977,8,8192,28,5376,13568
train,1978,7,7168,21,4032,11200
train,1979,11,11264,53,10176,21440
train,1980,29,29696,366,70272,99968
train,1981,42,43008,768,147456,190464
train,1982,9,9216,35,6720,15936
train,1983,40,40960,697,133824,174784
train,1984,24,24576,251,48192,72768
train,1985,25,25600,272,52224,77824
train,1986,15,15360,98,18816,34176
train,1987,15,15360,98,18816,34176
train,1988,21,21504,192,36864,58368
train,1989,22,22528,211,40512,63040
train,1990,7,7168,21,4032,11200
train,1991,21,21504,192,36864,58368
train,1992,9,9216,35,6720,15936
train,1993,8,8192,28,5376,13568
train,1994,7,7168,21,4032,11200
train,1995,38,38912,629,120768,159680
train,1996,9,9216,35,6720,15936
train,1997,16,16384,112,21504,37888
train,1998,32,32768,446,85632,118400
train,1999,23,23552,230,44160,67712
train,2000,22,22528,211,40512,63040
train,2001,15,15360,98,18816,34176
train,2002,17,17408,126,24192,41600
train,2003,31,31744,419,80448,112192
train,2004,49,50176,1046,200832,251008
train,2005,23,23552,230,44160,67712
train,2006,42,43008,768,147456,190464
train,2007,37,37888,596,114432,152320
train,2008,38,38912,629,120768,159680
train,2009,22,22528,211,40512,63040
train,2010,27,27648,318,61056,88704
train,2011,24,24576,251,48192,72768
train,2012,26,26624,295,56640,83264
train,2013,33,33792,474,91008,124800
train,2014,7,7168,21,4032,11200
train,2015,27,27648,318,61056,88704
train,2016,32,32768,446,85632,118400
train,2017,20,20480,174,33408,53888
train,2018,28,28672,342,65664,94336
train,2019,39,39936,663,127296,167232
train,2020,20,20480,174,33408,53888
train,2021,11,11264,53,10176,21440
train,2022,29,29696,366,70272,99968
train,2023,6,6144,16,3072,9216
train,2024,26,26624,295,56640,83264
train,2025,24,24576,251,48192,72768
train,2026,40,40960,697,133824,174784
train,2027,7,7168,21,4032,11200
train,2028,15,15360,98,18816,34176
train,2029,20,20480,174,33408,53888
train,2030,8,8192,28,5376,13568
train,2031,53,54272,1224,235008,289280
train,2032,15,15360,98,18816,34176
train,2033,31,31744,419,80448,112192
train,2034,16,16384,112,21504,37888
train,2035,10,10240,44,8448,18688
train,2036,37,37888,596,114432,152320
train,2037,6,6144,16,3072,9216
train,2038,25,25600,272,52224,77824
train,2039,33,33792,474,91008,124800
train,2040,16,16384,112,21504,37888
train,2041,54,55296,1270,243840,299136
train,2042,5,5120,11,2112,7232
train,2043,15,15360,98,18816,34176
train,2044,34,34816,504,96768,131584
train,2045,15,15360,98,18816,34176
train,2046,19,19456,157,30144,49600
train,2047,15,15360,98,18816,34176
train,2048,35,35840,534,102528,138368
train,2049,17,17408,126,24192,41600
train,2050,16,16384,112,21504,37888
train,2051,30,30720,392,75264,105984
train,2052,58,59392,1465,281280,340672
train,2053,18,18432,141,27072,45504
train,2054,15,15360,98,18816,34176
train,2055,20,20480,174,33408,53888
train,2056,5,5120,11,2112,7232
train,2057,17,17408,126,24192,41600
train,2058,39,39936,663,127296,167232
train,2059,15,15360,98,18816,34176
train,2060,12,12288,63,12096,24384
train,2061,16,16384,112,21504,37888
train,2062,18,18432,141,27072,45504
train,2063,24,24576,251,48192,72768
train,2064,23,23552,230,44160,67712
train,2065,26,26624,295,56640,83264
train,2066,39,39936,663,127296,167232
train,2067,19,19456,157,30144,49600
train,2068,28,28672,342,65664,94336
train,2069,23,23552,230,44160,67712
train,2070,17,17408,126,24192,41600
train,2071,21,21504,192,36864,58368
train,2072,16,16384,112,21504,37888
train,2073,25,25600,272,52224,77824
train,2074,8,8192,28,5376,13568
train,2075,26,26624,295,56640,83264
train,2076,25,25600,272,52224,77824
train,2077,24,24576,251,48192,72768
train,2078,8,8192,28,5376,13568
train,2079,17,17408,126,24192,41600
train,2080,34,34816,504,96768,131584
train,2081,10,10240,44,8448,18688
train,2082,23,23552,230,44160,67712
train,2083,27,27648,318,61056,88704
train,2084,37,37888,596,114432,152320
train,2085,16,16384,112,21504,37888
train,2086,9,9216,35,6720,15936
train,2087,21,21504,192,36864,58368
train,2088,10,10240,44,8448,18688
train,2089,25,25600,272,52224,77824
train,2090,11,11264,53,10176,21440
train,2091,21,21504,192,36864,58368
train,2092,19,19456,157,30144,49600
train,2093,9,9216,35,6720,15936
train,2094,26,26624,295,56640,83264
train,2095,4,4096,7,1344,5440
train,2096,14,14336,85,16320,30656
train,2097,5,5120,11,2112,7232
train,2098,23,23552,230,44160,67712
train,2099,40,40960,697,133824,174784
train,2100,36,36864,565,108480,145344
train,2101,38,38912,629,120768,159680
train,2102,21,21504,192,36864,58368
train,2103,11,11264,53,10176,21440
train,2104,7,7168,21,4032,11200
train,2105,22,22528,211,40512,63040
train,2106,20,20480,174,33408,53888
train,2107,61,62464,1621,311232,373696
train,2108,21,21504,192,36864,58368
train,2109,5,5120,11,2112,7232
train,2110,14,14336,85,16320,30656
train,2111,20,20480,174,33408,53888
train,2112,44,45056,843,161856,206912
train,2113,8,8192,28,5376,13568
train,2114,50,51200,1089,209088,260288
train,2115,8,8192,28,5376,13568
train,2116,26,26624,295,56640,83264
train,2117,33,33792,474,91008,124800
train,2118,28,28672,342,65664,94336
train,2119,7,7168,21,4032,11200
train,2120,25,25600,272,52224,77824
train,2121,8,8192,28,5376,13568
train,2122,23,23552,230,44160,67712
train,2123,18,18432,141,27072,45504
train,2124,19,19456,157,30144,49600
train,2125,22,22528,211,40512,63040
train,2126,32,32768,446,85632,118400
train,2127,37,37888,596,114432,152320
train,2128,9,9216,35,6720,15936
train,2129,11,11264,53,10176,21440
train,2130,17,17408,126,24192,41600
train,2131,4,4096,7,1344,5440
train,2132,25,25600,272,52224,77824
train,2133,4,4096,7,1344,5440
train,2134,29,29696,366,70272,99968
train,2135,28,28672,342,65664,94336
train,2136,29,29696,366,70272,99968
train,2137,7,7168,21,4032,11200
train,2138,21,21504,192,36864,58368
train,2139,22,22528,211,40512,63040
train,2140,12,12288,63,12096,24384
train,2141,31,31744,419,80448,112192
train,2142,9,9216,35,6720,15936
train,2143,25,25600,272,52224,77824
train,2144,16,16384,112,21504,37888
train,2145,33,33792,474,91008,124800
train,2146,12,12288,63,12096,24384
train,2147,32,32768,446,85632,118400
train,2148,21,21504,192,36864,58368
train,2149,20,20480,174,33408,53888
train,2150,28,28672,342,65664,94336
train,2151,45,46080,882,169344,215424
train,2152,28,28672,342,65664,94336
train,2153,13,13312,74,14208,27520
train,2154,24,24576,251,48192,72768
train,2155,12,12288,63,12096,24384
train,2156,3,3072,4,768,3840
train,2157,9,9216,35,6720,15936
train,2158,13,13312,74,14208,27520
train,2159,34,34816,504,96768,131584
train,2160,11,11264,53,10176,21440
train,2161,13,13312,74,14208,27520
train,2162,6,6144,16,3072,9216
train,2163,25,25600,272,52224,77824
train,2164,43,44032,805,154560,198592
train,2165,7,7168,21,4032,11200
train,2166,14,14336,85,16320,30656
train,2167,12,12288,63,12096,24384
train,2168,25,25600,272,52224,77824
train,2169,13,13312,74,14208,27520
train,2170,26,26624,295,56640,83264
train,2171,22,22528,211,40512,63040
train,2172,23,23552,230,44160,67712
train,2173,33,33792,474,91008,124800
train,2174,19,19456,157,30144,49600
train,2175,29,29696,366,70272,99968
train,2176,28,28672,342,65664,94336
train,2177,11,11264,53,10176,21440
train,2178,33,33792,474,91008,124800
train,2179,12,12288,63,12096,24384
train,2180,27,27648,318,61056,88704
train,2181,22,22528,211,40512,63040
train,2182,9,9216,35,6720,15936
train,2183,27,27648,318,61056,88704
train,2184,16,16384,112,21504,37888
train,2185,3,3072,4,768,3840
train,2186,29,29696,366,70272,99968
train,2187,17,17408,126,24192,41600
train,2188,18,18432,141,27072,45504
train,2189,26,26624,295,56640,83264
train,2190,25,25600,272,52224,77824
train,2191,42,43008,768,147456,190464
train,2192,32,32768,446,85632,118400
train,2193,9,9216,35,6720,15936
train,2194,27,27648,318,61056,88704
train,2195,4,4096,7,1344,5440
train,2196,29,29696,366,70272,99968
train,2197,20,20480,174,33408,53888
train,2198,17,17408,126,24192,41600
train,2199,27,27648,318,61056,88704
train,2200,15,15360,98,18816,34176
train,2201,16,16384,112,21504,37888
train,2202,20,20480,174,33408,53888
train,2203,7,7168,21,4032,11200
train,2204,12,12288,63,12096,24384
train,2205,28,28672,342,65664,94336
train,2206,24,24576,251,48192,72768
train,2207,6,6144,16,3072,9216
train,2208,35,35840,534,102528,138368
train,2209,29,29696,366,70272,99968
train,2210,18,18432,141,27072,45504
train,2211,37,37888,596,114432,152320
train,2212,38,38912,629,120768,159680
train,2213,13,13312,74,14208,27520
train,2214,24,24576,251,48192,72768
train,2215,32,32768,446,85632,118400
train,2216,38,38912,629,120768,159680
train,2217,51,52224,1133,217536,269760
train,2218,27,27648,318,61056,88704
train,2219,10,10240,44,8448,18688
train,2220,9,9216,35,6720,15936
train,2221,9,9216,35,6720,15936
train,2222,15,15360,98,18816,34176
train,2223,17,17408,126,24192,41600
train,2224,31,31744,419,80448,112192
train,2225,10,10240,44,8448,18688
train,2226,18,18432,141,27072,45504
train,2227,24,24576,251,48192,72768
train,2228,23,23552,230,44160,67712
train,2229,20,20480,174,33408,53888
train,2230,39,39936,663,127296,167232
train,2231,12,12288,63,12096,24384
train,2232,23,23552,230,44160,67712
train,2233,30,30720,392,75264,105984
train,2234,33,33792,474,91008,124800
train,2235,19,19456,157,30144,49600
train,2236,31,31744,419,80448,112192
train,2237,12,12288,63,12096,24384
train,2238,16,16384,112,21504,37888
train,2239,6,6144,16,3072,9216
train,2240,29,29696,366,70272,99968
train,2241,29,29696,366,70272,99968
train,2242,27,27648,318,61056,88704
train,2243,19,19456,157,30144,49600
train,2244,10,10240,44,8448,18688
train,2245,9,9216,35,6720,15936
train,2246,35,35840,534,102528,138368
train,2247,45,46080,882,169344,215424
train,2248,34,34816,504,96768,131584
train,2249,8,8192,28,5376,13568
train,2250,29,29696,366,70272,99968
train,2251,17,17408,126,24192,41600
train,2252,31,31744,419,80448,112192
train,2253,50,51200,1089,209088,260288
train,2254,3,3072,4,768,3840
train,2255,25,25600,272,52224,77824
train,2256,16,16384,112,21504,37888
train,2257,12,12288,63,12096,24384
train,2258,27,27648,318,61056,88704
train,2259,13,13312,74,14208,27520
train,2260,45,46080,882,169344,215424
train,2261,7,7168,21,4032,11200
train,2262,15,15360,98,18816,34176
train,2263,30,30720,392,75264,105984
train,2264,26,26624,295,56640,83264
train,2265,21,21504,192,36864,58368
train,2266,23,23552,230,44160,67712
train,2267,33,33792,474,91008,124800
train,2268,25,25600,272,52224,77824
train,2269,31,31744,419,80448,112192
train,2270,17,17408,126,24192,41600
train,2271,27,27648,318,61056,88704
train,2272,36,36864,565,108480,145344
train,2273,29,29696,366,70272,99968
train,2274,25,25600,272,52224,77824
train,2275,22,22528,211,40512,63040
train,2276,17,17408,126,24192,41600
train,2277,41,41984,732,140544,182528
train,2278,11,11264,53,10176,21440
train,2279,30,30720,392,75264,105984
train,2280,29,29696,366,70272,99968
train,2281,13,13312,74,14208,27520
train,2282,25,25600,272,52224,77824
train,2283,8,8192,28,5376,13568
train,2284,24,24576,251,48192,72768
train,2285,30,30720,392,75264,105984
train,2286,18,18432,141,27072,45504
train,2287,40,40960,697,133824,174784
train,2288,23,23552,230,44160,67712
train,2289,13,13312,74,14208,27520
train,2290,33,33792,474,91008,124800
train,2291,10,10240,44,8448,18688
train,2292,17,17408,126,24192,41600
train,2293,17,17408,126,24192,41600
train,2294,7,7168,21,4032,11200
train,2295,30,30720,392,75264,105984
train,2296,32,32768,446,85632,118400
train,2297,26,26624,295,56640,83264
train,2298,18,18432,141,27072,45504
train,2299,28,28672,342,65664,94336
train,2300,22,22528,211,40512,63040
train,2301,11,11264,53,10176,21440
train,2302,37,37888,596,114432,152320
train,2303,10,10240,44,8448,18688
train,2304,35,35840,534,102528,138368
train,2305,31,31744,419,80448,112192
train,2306,30,30720,392,75264,105984
train,2307,10,10240,44,8448,18688
train,2308,42,43008,768,147456,190464
train,2309,14,14336,85,16320,30656
train,2310,22,22528,211,40512,63040
train,2311,24,24576,251,48192,72768
train,2312,9,9216,35,6720,15936
train,2313,31,31744,419,80448,112192
train,2314,13,13312,74,14208,27520
train,2315,21,21504,192,36864,58368
train,2316,28,28672,342,65664,94336
train,2317,21,21504,192,36864,58368
train,2318,29,29696,366,70272,99968
train,2319,18,18432,141,27072,45504
train,2320,18,18432,141,27072,45504
train,2321,17,17408,126,24192,41600
train,2322,14,14336,85,16320,30656
train,2323,32,32768,446,85632,118400
train,2324,43,44032,805,154560,198592
train,2325,6,6144,16,3072,9216
train,2326,27,27648,318,61056,88704
train,2327,41,41984,732,140544,182528
train,2328,23,23552,230,44160,67712
train,2329,24,24576,251,48192,72768
train,2330,22,22528,211,40512,63040
train,2331,16,16384,112,21504,37888
train,2332,42,43008,768,147456,190464
train,2333,11,11264,53,10176,21440
train,2334,18,18432,141,27072,45504
train,2335,29,29696,366,70272,99968
train,2336,24,24576,251,48192,72768
train,2337,22,22528,211,40512,63040
train,2338,19,19456,157,30144,49600
train,2339,28,28672,342,65664,94336
train,2340,41,41984,732,140544,182528
train,2341,16,16384,112,21504,37888
train,2342,16,16384,112,21504,37888
train,2343,21,21504,192,36864,58368
train,2344,25,25600,272,52224,77824
train,2345,24,24576,251,48192,72768
train,2346,32,32768,446,85632,118400
train,2347,14,14336,85,16320,30656
train,2348,23,23552,230,44160,67712
train,2349,31,31744,419,80448,112192
train,2350,48,49152,1004,192768,241920
train,2351,14,14336,85,16320,30656
train,2352,7,7168,21,4032,11200
train,2353,17,17408,126,24192,41600
train,2354,18,18432,141,27072,45504
train,2355,35,35840,534,102528,138368
train,2356,37,37888,596,114432,152320
train,2357,18,18432,141,27072,45504
train,2358,27,27648,318,61056,88704
train,2359,12,12288,63,12096,24384
train,2360,43,44032,805,154560,198592
train,2361,36,36864,565,108480,145344
train,2362,8,8192,28,5376,13568
train,2363,14,14336,85,16320,30656
train,2364,39,39936,663,127296,167232
train,2365,38,38912,629,120768,159680
train,2366,19,19456,157,30144,49600
train,2367,11,11264,53,10176,21440
train,2368,25,25600,272,52224,77824
train,2369,12,12288,63,12096,24384
train,2370,37,37888,596,114432,152320
train,2371,29,29696,366,70272,99968
train,2372,17,17408,126,24192,41600
train,2373,17,17408,126,24192,41600
train,2374,13,13312,74,14208,27520
train,2375,22,22528,211,40512,63040
train,2376,5,5120,11,2112,7232
train,2377,6,6144,16,3072,9216
train,2378,32,32768,446,85632,118400
train,2379,13,13312,74,14208,27520
train,2380,13,13312,74,14208,27520
train,2381,33,33792,474,91008,124800
train,2382,25,25600,272,52224,77824
train,2383,15,15360,98,18816,34176
train,2384,22,22528,211,40512,63040
train,2385,35,35840,534,102528,138368
train,2386,26,26624,295,56640,83264
train,2387,20,20480,174,33408,53888
train,2388,33,33792,474,91008,124800
train,2389,33,33792,474,91008,124800
train,2390,20,20480,174,33408,53888
train,2391,31,31744,419,80448,112192
train,2392,12,12288,63,12096,24384
train,2393,24,24576,251,48192,72768
train,2394,30,30720,392,75264,105984
train,2395,24,24576,251,48192,72768
train,2396,14,14336,85,16320,30656
train,2397,13,13312,74,14208,27520
train,2398,9,9216,35,6720,15936
train,2399,30,30720,392,75264,105984
train,2400,35,35840,534,102528,138368
train,2401,24,24576,251,48192,72768
train,2402,23,23552,230,44160,67712
train,2403,30,30720,392,75264,105984
train,2404,21,21504,192,36864,58368
train,2405,18,18432,141,27072,45504
train,2406,19,19456,157,30144,49600
train,2407,25,25600,272,52224,77824
train,2408,14,14336,85,16320,30656
train,2409,6,6144,16,3072,9216
train,2410,10,10240,44,8448,18688
train,2411,9,9216,35,6720,15936
train,2412,16,16384,112,21504,37888
train,2413,10,10240,44,8448,18688
train,2414,27,27648,318,61056,88704
train,2415,18,18432,141,27072,45504
train,2416,31,31744,419,80448,112192
train,2417,18,18432,141,27072,45504
train,2418,15,15360,98,18816,34176
train,2419,18,18432,141,27072,45504
train,2420,5,5120,11,2112,7232
train,2421,22,22528,211,40512,63040
train,2422,6,6144,16,3072,9216
train,2423,20,20480,174,33408,53888
train,2424,31,31744,419,80448,112192
train,2425,13,13312,74,14208,27520
train,2426,21,21504,192,36864,58368
train,2427,22,22528,211,40512,63040
train,2428,24,24576,251,48192,72768
train,2429,18,18432,141,27072,45504
train,2430,26,26624,295,56640,83264
train,2431,33,33792,474,91008,124800
train,2432,16,16384,112,21504,37888
train,2433,7,7168,21,4032,11200
train,2434,23,23552,230,44160,67712
train,2435,30,30720,392,75264,105984
train,2436,12,12288,63,12096,24384
train,2437,20,20480,174,33408,53888
train,2438,29,29696,366,70272,99968
train,2439,36,36864,565,108480,145344
train,2440,31,31744,419,80448,112192
train,2441,30,30720,392,75264,105984
train,2442,26,26624,295,56640,83264
train,2443,29,29696,366,70272,99968
train,2444,32,32768,446,85632,118400
train,2445,14,14336,85,16320,30656
train,2446,9,9216,35,6720,15936
train,2447,30,30720,392,75264,105984
train,2448,9,9216,35,6720,15936
train,2449,32,32768,446,85632,118400
train,2450,22,22528,211,40512,63040
train,2451,19,19456,157,30144,49600
train,2452,19,19456,157,30144,49600
train,2453,33,33792,474,91008,124800
train,2454,8,8192,28,5376,13568
train,2455,19,19456,157,30144,49600
train,2456,42,43008,768,147456,190464
train,2457,8,8192,28,5376,13568
train,2458,33,33792,474,91008,124800
train,2459,20,20480,174,33408,53888
train,2460,11,11264,53,10176,21440
train,2461,55,56320,1318,253056,309376
train,2462,7,7168,21,4032,11200
train,2463,42,43008,768,147456,190464
train,2464,27,27648,318,61056,88704
train,2465,21,21504,192,36864,58368
train,2466,18,18432,141,27072,45504
train,2467,23,23552,230,44160,67712
train,2468,23,23552,230,44160,67712
train,2469,20,20480,174,33408,53888
train,2470,8,8192,28,5376,13568
train,2471,14,14336,85,16320,30656
train,2472,16,16384,112,21504,37888
train,2473,24,24576,251,48192,72768
train,2474,21,21504,192,36864,58368
train,2475,20,20480,174,33408,53888
train,2476,17,17408,126,24192,41600
train,2477,31,31744,419,80448,112192
train,2478,35,35840,534,102528,138368
train,2479,30,30720,392,75264,105984
train,2480,48,49152,1004,192768,241920
train,2481,11,11264,53,10176,21440
train,2482,32,32768,446,85632,118400
train,2483,45,46080,882,169344,215424
train,2484,36,36864,565,108480,145344
train,2485,28,28672,342,65664,94336
train,2486,23,23552,230,44160,67712
train,2487,33,33792,474,91008,124800
train,2488,37,37888,596,114432,152320
train,2489,31,31744,419,80448,112192
train,2490,16,16384,112,21504,37888
train,2491,27,27648,318,61056,88704
train,2492,50,51200,1089,209088,260288
train,2493,34,34816,504,96768,131584
train,2494,32,32768,446,85632,118400
train,2495,40,40960,697,133824,174784
train,2496,32,32768,446,85632,118400
train,2497,47,48128,962,184704,232832
train,2498,14,14336,85,16320,30656
train,2499,48,49152,1004,192768,241920
train,2500,29,29696,366,70272,99968
train,2501,14,14336,85,16320,30656
train,2502,33,33792,474,91008,124800
train,2503,40,40960,697,133824,174784
train,2504,26,26624,295,56640,83264
train,2505,23,23552,230,44160,67712
train,2506,15,15360,98,18816,34176
train,2507,34,34816,504,96768,131584
train,2508,41,41984,732,140544,182528
train,2509,13,13312,74,14208,27520
train,2510,24,24576,251,48192,72768
train,2511,10,10240,44,8448,18688
train,2512,6,6144,16,3072,9216
train,2513,28,28672,342,65664,94336
train,2514,24,24576,251,48192,72768
train,2515,14,14336,85,16320,30656
train,2516,25,25600,272,52224,77824
train,2517,14,14336,85,16320,30656
train,2518,28,28672,342,65664,94336
train,2519,29,29696,366,70272,99968
train,2520,11,11264,53,10176,21440
train,2521,21,21504,192,36864,58368
train,2522,22,22528,211,40512,63040
train,2523,42,43008,768,147456,190464
train,2524,3,3072,4,768,3840
train,2525,12,12288,63,12096,24384
train,2526,26,26624,295,56640,83264
train,2527,39,39936,663,127296,167232
train,2528,38,38912,629,120768,159680
train,2529,12,12288,63,12096,24384
train,2530,12,12288,63,12096,24384
train,2531,24,24576,251,48192,72768
train,2532,26,26624,295,56640,83264
train,2533,20,20480,174,33408,53888
train,2534,17,17408,126,24192,41600
train,2535,21,21504,192,36864,58368
train,2536,9,9216,35,6720,15936
train,2537,30,30720,392,75264,105984
train,2538,29,29696,366,70272,99968
train,2539,35,35840,534,102528,138368
train,2540,10,10240,44,8448,18688
train,2541,40,40960,697,133824,174784
train,2542,10,10240,44,8448,18688
train,2543,18,18432,141,27072,45504
train,2544,28,28672,342,65664,94336
train,2545,17,17408,126,24192,41600
train,2546,4,4096,7,1344,5440
train,2547,16,16384,112,21504,37888
train,2548,6,6144,16,3072,9216
train,2549,13,13312,74,14208,27520
train,2550,41,41984,732,140544,182528
train,2551,34,34816,504,96768,131584
train,2552,31,31744,419,80448,112192
train,2553,27,27648,318,61056,88704
train,2554,28,28672,342,65664,94336
train,2555,28,28672,342,65664,94336
train,2556,29,29696,366,70272,99968
train,2557,57,58368,1415,271680,330048
train,2558,8,8192,28,5376,13568
train,2559,12,12288,63,12096,24384
train,2560,6,6144,16,3072,9216
train,2561,7,7168,21,4032,11200
train,2562,43,44032,805,154560,198592
train,2563,28,28672,342,65664,94336
train,2564,31,31744,419,80448,112192
train,2565,21,21504,192,36864,58368
train,2566,22,22528,211,40512,63040
train,2567,12,12288,63,12096,24384
train,2568,22,22528,211,40512,63040
train,2569,10,10240,44,8448,18688
train,2570,14,14336,85,16320,30656
train,2571,10,10240,44,8448,18688
train,2572,32,32768,446,85632,118400
train,2573,24,24576,251,48192,72768
train,2574,35,35840,534,102528,138368
train,2575,22,22528,211,40512,63040
train,2576,21,21504,192,36864,58368
train,2577,48,49152,1004,192768,241920
train,2578,25,25600,272,52224,77824
train,2579,41,41984,732,140544,182528
train,2580,37,37888,596,114432,152320
train,2581,24,24576,251,48192,72768
train,2582,19,19456,157,30144,49600
train,2583,20,20480,174,33408,53888
train,2584,21,21504,192,36864,58368
train,2585,19,19456,157,30144,49600
train,2586,10,10240,44,8448,18688
train,2587,9,9216,35,6720,15936
train,2588,14,14336,85,16320,30656
train,2589,18,18432,141,27072,45504
train,2590,7,7168,21,4032,11200
train,2591,52,53248,1178,226176,279424
train,2592,15,15360,98,18816,34176
train,2593,18,18432,141,27072,45504
train,2594,20,20480,174,33408,53888
train,2595,15,15360,98,18816,34176
train,2596,32,32768,446,85632,118400
train,2597,43,44032,805,154560,198592
train,2598,42,43008,768,147456,190464
train,2599,22,22528,211,40512,63040
train,2600,27,27648,318,61056,88704
train,2601,45,46080,882,169344,215424
train,2602,20,20480,174,33408,53888
train,2603,37,37888,596,114432,152320
train,2604,55,56320,1318,253056,309376
train,2605,9,9216,35,6720,15936
train,2606,6,6144,16,3072,9216
train,2607,28,28672,342,65664,94336
train,2608,30,30720,392,75264,105984
train,2609,30,30720,392,75264,105984
train,2610,21,21504,192,36864,58368
train,2611,26,26624,295,56640,83264
train,2612,19,19456,157,30144,49600
train,2613,17,17408,126,24192,41600
train,2614,9,9216,35,6720,15936
train,2615,12,12288,63,12096,24384
train,2616,22,22528,211,40512,63040
train,2617,9,9216,35,6720,15936
train,2618,36,36864,565,108480,145344
train,2619,32,32768,446,85632,118400
train,2620,31,31744,419,80448,112192
train,2621,15,15360,98,18816,34176
train,2622,38,38912,629,120768,159680
train,2623,12,12288,63,12096,24384
train,2624,11,11264,53,10176,21440
train,2625,21,21504,192,36864,58368
train,2626,49,50176,1046,200832,251008
train,2627,17,17408,126,24192,41600
train,2628,45,46080,882,169344,215424
train,2629,18,18432,141,27072,45504
train,2630,34,34816,504,96768,131584
train,2631,37,37888,596,114432,152320
train,2632,30,30720,392,75264,105984
train,2633,15,15360,98,18816,34176
train,2634,20,20480,174,33408,53888
train,2635,27,27648,318,61056,88704
train,2636,24,24576,251,48192,72768
train,2637,13,13312,74,14208,27520
train,2638,32,32768,446,85632,118400
train,2639,21,21504,192,36864,58368
train,2640,19,19456,157,30144,49600
train,2641,25,25600,272,52224,77824
train,2642,53,54272,1224,235008,289280
train,2643,23,23552,230,44160,67712
train,2644,9,9216,35,6720,15936
train,2645,16,16384,112,21504,37888
train,2646,18,18432,141,27072,45504
train,2647,28,28672,342,65664,94336
train,2648,14,14336,85,16320,30656
train,2649,15,15360,98,18816,34176
train,2650,31,31744,419,80448,112192
train,2651,28,28672,342,65664,94336
train,2652,26,26624,295,56640,83264
train,2653,22,22528,211,40512,63040
train,2654,17,17408,126,24192,41600
train,2655,45,46080,882,169344,215424
train,2656,16,16384,112,21504,37888
train,2657,16,16384,112,21504,37888
train,2658,28,28672,342,65664,94336
train,2659,15,15360,98,18816,34176
train,2660,23,23552,230,44160,67712
train,2661,13,13312,74,14208,27520
train,2662,31,31744,419,80448,112192
train,2663,33,33792,474,91008,124800
train,2664,16,16384,112,21504,37888
train,2665,12,12288,63,12096,24384
train,2666,44,45056,843,161856,206912
train,2667,9,9216,35,6720,15936
train,2668,12,12288,63,12096,24384
train,2669,5,5120,11,2112,7232
train,2670,21,21504,192,36864,58368
train,2671,26,26624,295,56640,83264
train,2672,21,21504,192,36864,58368
train,2673,33,33792,474,91008,124800
train,2674,14,14336,85,16320,30656
train,2675,34,34816,504,96768,131584
train,2676,23,23552,230,44160,67712
train,2677,20,20480,174,33408,53888
train,2678,16,16384,112,21504,37888
train,2679,21,21504,192,36864,58368
train,2680,8,8192,28,5376,13568
train,2681,21,21504,192,36864,58368
train,2682,23,23552,230,44160,67712
train,2683,18,18432,141,27072,45504
train,2684,35,35840,534,102528,138368
train,2685,31,31744,419,80448,112192
train,2686,49,50176,1046,200832,251008
train,2687,31,31744,419,80448,112192
train,2688,19,19456,157,30144,49600
train,2689,24,24576,251,48192,72768
train,2690,15,15360,98,18816,34176
train,2691,18,18432,141,27072,45504
train,2692,34,34816,504,96768,131584
train,2693,21,21504,192,36864,58368
train,2694,17,17408,126,24192,41600
train,2695,42,43008,768,147456,190464
train,2696,37,37888,596,114432,152320
train,2697,29,29696,366,70272,99968
train,2698,18,18432,141,27072,45504
train,2699,34,34816,504,96768,131584
train,2700,15,15360,98,18816,34176
train,2701,20,20480,174,33408,53888
train,2702,6,6144,16,3072,9216
train,2703,29,29696,366,70272,99968
train,2704,26,26624,295,56640,83264
train,2705,32,32768,446,85632,118400
train,2706,19,19456,157,30144,49600
train,2707,33,33792,474,91008,124800
train,2708,26,26624,295,56640,83264
train,2709,20,20480,174,33408,53888
train,2710,18,18432,141,27072,45504
train,2711,35,35840,534,102528,138368
train,2712,11,11264,53,10176,21440
train,2713,12,12288,63,12096,24384
train,2714,27,27648,318,61056,88704
train,2715,10,10240,44,8448,18688
train,2716,55,56320,1318,253056,309376
train,2717,15,15360,98,18816,34176
train,2718,20,20480,174,33408,53888
train,2719,27,27648,318,61056,88704
train,2720,48,49152,1004,192768,241920
train,2721,23,23552,230,44160,67712
train,2722,39,39936,663,127296,167232
train,2723,24,24576,251,48192,72768
train,2724,21,21504,192,36864,58368
train,2725,21,21504,192,36864,58368
train,2726,21,21504,192,36864,58368
train,2727,24,24576,251,48192,72768
train,2728,34,34816,504,96768,131584
train,2729,34,34816,504,96768,131584
train,2730,15,15360,98,18816,34176
train,2731,24,24576,251,48192,72768
train,2732,15,15360,98,18816,34176
train,2733,35,35840,534,102528,138368
train,2734,15,15360,98,18816,34176
train,2735,11,11264,53,10176,21440
train,2736,9,9216,35,6720,15936
train,2737,29,29696,366,70272,99968
train,2738,8,8192,28,5376,13568
train,2739,41,41984,732,140544,182528
train,2740,18,18432,141,27072,45504
train,2741,12,12288,63,12096,24384
train,2742,29,29696,366,70272,99968
train,2743,17,17408,126,24192,41600
train,2744,27,27648,318,61056,88704
train,2745,14,14336,85,16320,30656
train,2746,25,25600,272,52224,77824
train,2747,26,26624,295,56640,83264
train,2748,19,19456,157,30144,49600
train,2749,18,18432,141,27072,45504
train,2750,4,4096,7,1344,5440
train,2751,18,18432,141,27072,45504
train,2752,19,19456,157,30144,49600
train,2753,11,11264,53,10176,21440
train,2754,22,22528,211,40512,63040
train,2755,32,32768,446,85632,118400
train,2756,21,21504,192,36864,58368
train,2757,23,23552,230,44160,67712
train,2758,27,27648,318,61056,88704
train,2759,36,36864,565,108480,145344
train,2760,13,13312,74,14208,27520
train,2761,5,5120,11,2112,7232
train,2762,19,19456,157,30144,49600
train,2763,29,29696,366,70272,99968
train,2764,15,15360,98,18816,34176
train,2765,42,43008,768,147456,190464
train,2766,12,12288,63,12096,24384
train,2767,28,28672,342,65664,94336
train,2768,26,26624,295,56640,83264
train,2769,17,17408,126,24192,41600
train,2770,7,7168,21,4032,11200
train,2771,5,5120,11,2112,7232
train,2772,13,13312,74,14208,27520
train,2773,25,25600,272,52224,77824
train,2774,32,32768,446,85632,118400
train,2775,22,22528,211,40512,63040
train,2776,20,20480,174,33408,53888
train,2777,21,21504,192,36864,58368
train,2778,19,19456,157,30144,49600
train,2779,24,24576,251,48192,72768
train,2780,31,31744,419,80448,112192
train,2781,25,25600,272,52224,77824
train,2782,21,21504,192,36864,58368
train,2783,32,32768,446,85632,118400
train,2784,13,13312,74,14208,27520
train,2785,27,27648,318,61056,88704
train,2786,15,15360,98,18816,34176
train,2787,15,15360,98,18816,34176
train,2788,51,52224,1133,217536,269760
train,2789,26,26624,295,56640,83264
train,2790,11,11264,53,10176,21440
train,2791,23,23552,230,44160,67712
train,2792,22,22528,211,40512,63040
train,2793,4,4096,7,1344,5440
train,2794,43,44032,805,154560,198592
train,2795,8,8192,28,5376,13568
train,2796,18,18432,141,27072,45504
train,2797,13,13312,74,14208,27520
train,2798,5,5120,11,2112,7232
train,2799,33,33792,474,91008,124800
train,2800,14,14336,85,16320,30656
train,2801,28,28672,342,65664,94336
train,2802,17,17408,126,24192,41600
train,2803,20,20480,174,33408,53888
train,2804,28,28672,342,65664,94336
train,2805,20,20480,174,33408,53888
train,2806,10,10240,44,8448,18688
train,2807,19,19456,157,30144,49600
train,2808,8,8192,28,5376,13568
train,2809,36,36864,565,108480,145344
train,2810,13,13312,74,14208,27520
train,2811,26,26624,295,56640,83264
train,2812,20,20480,174,33408,53888
train,2813,19,19456,157,30144,49600
train,2814,10,10240,44,8448,18688
train,2815,19,19456,157,30144,49600
train,2816,13,13312,74,14208,27520
train,2817,31,31744,419,80448,112192
train,2818,23,23552,230,44160,67712
train,2819,32,32768,446,85632,118400
train,2820,16,16384,112,21504,37888
train,2821,11,11264,53,10176,21440
train,2822,21,21504,192,36864,58368
train,2823,14,14336,85,16320,30656
train,2824,20,20480,174,33408,53888
train,2825,23,23552,230,44160,67712
train,2826,22,22528,211,40512,63040
train,2827,20,20480,174,33408,53888
train,2828,9,9216,35,6720,15936
train,2829,28,28672,342,65664,94336
train,2830,26,26624,295,56640,83264
train,2831,31,31744,419,80448,112192
train,2832,18,18432,141,27072,45504
train,2833,11,11264,53,10176,21440
train,2834,19,19456,157,30144,49600
train,2835,33,33792,474,91008,124800
train,2836,18,18432,141,27072,45504
train,2837,14,14336,85,16320,30656
train,2838,31,31744,419,80448,112192
train,2839,13,13312,74,14208,27520
train,2840,26,26624,295,56640,83264
train,2841,26,26624,295,56640,83264
train,2842,10,10240,44,8448,18688
train,2843,19,19456,157,30144,49600
train,2844,20,20480,174,33408,53888
train,2845,14,14336,85,16320,30656
train,2846,10,10240,44,8448,18688
train,2847,12,12288,63,12096,24384
train,2848,14,14336,85,16320,30656
train,2849,20,20480,174,33408,53888
train,2850,26,26624,295,56640,83264
train,2851,27,27648,318,61056,88704
train,2852,24,24576,251,48192,72768
train,2853,19,19456,157,30144,49600
train,2854,24,24576,251,48192,72768
train,2855,23,23552,230,44160,67712
train,2856,30,30720,392,75264,105984
train,2857,32,32768,446,85632,118400
train,2858,10,10240,44,8448,18688
train,2859,17,17408,126,24192,41600
train,2860,38,38912,629,120768,159680
train,2861,51,52224,1133,217536,269760
train,2862,46,47104,922,177024,224128
train,2863,28,28672,342,65664,94336
train,2864,22,22528,211,40512,63040
train,2865,26,26624,295,56640,83264
train,2866,11,11264,53,10176,21440
train,2867,47,48128,962,184704,232832
train,2868,23,23552,230,44160,67712
train,2869,30,30720,392,75264,105984
train,2870,27,27648,318,61056,88704
train,2871,23,23552,230,44160,67712
train,2872,19,19456,157,30144,49600
train,2873,5,5120,11,2112,7232
train,2874,25,25600,272,52224,77824
train,2875,14,14336,85,16320,30656
train,2876,11,11264,53,10176,21440
train,2877,18,18432,141,27072,45504
train,2878,30,30720,392,75264,105984
train,2879,26,26624,295,56640,83264
train,2880,32,32768,446,85632,118400
train,2881,44,45056,843,161856,206912
train,2882,5,5120,11,2112,7232
train,2883,17,17408,126,24192,41600
train,2884,41,41984,732,140544,182528
train,2885,11,11264,53,10176,21440
train,2886,16,16384,112,21504,37888
train,2887,21,21504,192,36864,58368
train,2888,20,20480,174,33408,53888
train,2889,39,39936,663,127296,167232
train,2890,11,11264,53,10176,21440
train,2891,18,18432,141,27072,45504
train,2892,14,14336,85,16320,30656
train,2893,22,22528,211,40512,63040
train,2894,39,39936,663,127296,167232
train,2895,47,48128,962,184704,232832
train,2896,12,12288,63,12096,24384
train,2897,10,10240,44,8448,18688
train,2898,16,16384,112,21504,37888
train,2899,29,29696,366,70272,99968
train,2900,5,5120,11,2112,7232
train,2901,15,15360,98,18816,34176
train,2902,12,12288,63,12096,24384
train,2903,21,21504,192,36864,58368
train,2904,27,27648,318,61056,88704
train,2905,12,12288,63,12096,24384
train,2906,18,18432,141,27072,45504
train,2907,16,16384,112,21504,37888
train,2908,13,13312,74,14208,27520
train,2909,21,21504,192,36864,58368
train,2910,25,25600,272,52224,77824
train,2911,25,25600,272,52224,77824
train,2912,11,11264,53,10176,21440
train,2913,17,17408,126,24192,41600
train,2914,25,25600,272,52224,77824
train,2915,13,13312,74,14208,27520
train,2916,28,28672,342,65664,94336
train,2917,14,14336,85,16320,30656
train,2918,5,5120,11,2112,7232
train,2919,26,26624,295,56640,83264
train,2920,9,9216,35,6720,15936
train,2921,34,34816,504,96768,131584
train,2922,25,25600,272,52224,77824
train,2923,23,23552,230,44160,67712
train,2924,19,19456,157,30144,49600
train,2925,17,17408,126,24192,41600
train,2926,28,28672,342,65664,94336
train,2927,9,9216,35,6720,15936
train,2928,43,44032,805,154560,198592
train,2929,7,7168,21,4032,11200
train,2930,25,25600,272,52224,77824
train,2931,18,18432,141,27072,45504
train,2932,23,23552,230,44160,67712
train,2933,15,15360,98,18816,34176
train,2934,40,40960,697,133824,174784
train,2935,45,46080,882,169344,215424
train,2936,29,29696,366,70272,99968
train,2937,16,16384,112,21504,37888
train,2938,47,48128,962,184704,232832
train,2939,23,23552,230,44160,67712
train,2940,15,15360,98,18816,34176
train,2941,22,22528,211,40512,63040
train,2942,15,15360,98,18816,34176
train,2943,11,11264,53,10176,21440
train,2944,9,9216,35,6720,15936
train,2945,45,46080,882,169344,215424
train,2946,34,34816,504,96768,131584
train,2947,27,27648,318,61056,88704
train,2948,18,18432,141,27072,45504
train,2949,24,24576,251,48192,72768
train,2950,6,6144,16,3072,9216
train,2951,18,18432,141,27072,45504
train,2952,18,18432,141,27072,45504
train,2953,32,32768,446,85632,118400
train,2954,16,16384,112,21504,37888
train,2955,37,37888,596,114432,152320
train,2956,31,31744,419,80448,112192
train,2957,40,40960,697,133824,174784
train,2958,28,28672,342,65664,94336
train,2959,30,30720,392,75264,105984
train,2960,5,5120,11,2112,7232
train,2961,16,16384,112,21504,37888
train,2962,34,34816,504,96768,131584
train,2963,14,14336,85,16320,30656
train,2964,4,4096,7,1344,5440
train,2965,31,31744,419,80448,112192
train,2966,24,24576,251,48192,72768
train,2967,20,20480,174,33408,53888
train,2968,28,28672,342,65664,94336
train,2969,23,23552,230,44160,67712
train,2970,19,19456,157,30144,49600
train,2971,20,20480,174,33408,53888
train,2972,16,16384,112,21504,37888
train,2973,21,21504,192,36864,58368
train,2974,31,31744,419,80448,112192
train,2975,17,17408,126,24192,41600
train,2976,31,31744,419,80448,112192
train,2977,44,45056,843,161856,206912
train,2978,34,34816,504,96768,131584
train,2979,31,31744,419,80448,112192
train,2980,25,25600,272,52224,77824
train,2981,12,12288,63,12096,24384
train,2982,17,17408,126,24192,41600
train,2983,35,35840,534,102528,138368
train,2984,18,18432,141,27072,45504
train,2985,14,14336,85,16320,30656
train,2986,24,24576,251,48192,72768
train,2987,36,36864,565,108480,145344
train,2988,18,18432,141,27072,45504
train,2989,21,21504,192,36864,58368
train,2990,29,29696,366,70272,99968
train,2991,17,17408,126,24192,41600
train,2992,10,10240,44,8448,18688
train,2993,7,7168,21,4032,11200
train,2994,14,14336,85,16320,30656
train,2995,31,31744,419,80448,112192
train,2996,22,22528,211,40512,63040
train,2997,15,15360,98,18816,34176
train,2998,3,3072,4,768,3840
train,2999,21,21504,192,36864,58368
train,3000,3,3072,4,768,3840
train,3001,44,45056,843,161856,206912
train,3002,31,31744,419,80448,112192
train,3003,36,36864,565,108480,145344
train,3004,7,7168,21,4032,11200
train,3005,12,12288,63,12096,24384
train,3006,41,41984,732,140544,182528
train,3007,16,16384,112,21504,37888
train,3008,22,22528,211,40512,63040
train,3009,11,11264,53,10176,21440
train,3010,36,36864,565,108480,145344
train,3011,4,4096,7,1344,5440
train,3012,10,10240,44,8448,18688
train,3013,13,13312,74,14208,27520
train,3014,11,11264,53,10176,21440
train,3015,6,6144,16,3072,9216
train,3016,14,14336,85,16320,30656
train,3017,6,6144,16,3072,9216
train,3018,17,17408,126,24192,41600
train,3019,2,2048,2,384,2432
train,3020,20,20480,174,33408,53888
train,3021,19,19456,157,30144,49600
train,3022,5,5120,11,2112,7232
train,3023,15,15360,98,18816,34176
train,3024,19,19456,157,30144,49600
train,3025,29,29696,366,70272,99968
train,3026,28,28672,342,65664,94336
train,3027,6,6144,16,3072,9216
train,3028,23,23552,230,44160,67712
train,3029,38,38912,629,120768,159680
train,3030,6,6144,16,3072,9216
train,3031,26,26624,295,56640,83264
train,3032,21,21504,192,36864,58368
train,3033,50,51200,1089,209088,260288
train,3034,29,29696,366,70272,99968
train,3035,24,24576,251,48192,72768
train,3036,10,10240,44,8448,18688
train,3037,26,26624,295,56640,83264
train,3038,27,27648,318,61056,88704
train,3039,13,13312,74,14208,27520
train,3040,22,22528,211,40512,63040
train,3041,12,12288,63,12096,24384
train,3042,26,26624,295,56640,83264
train,3043,15,15360,98,18816,34176
train,3044,22,22528,211,40512,63040
train,3045,8,8192,28,5376,13568
train,3046,28,28672,342,65664,94336
train,3047,45,46080,882,169344,215424
train,3048,14,14336,85,16320,30656
train,3049,17,17408,126,24192,41600
train,3050,16,16384,112,21504,37888
train,3051,37,37888,596,114432,152320
train,3052,37,37888,596,114432,152320
train,3053,52,53248,1178,226176,279424
train,3054,39,39936,663,127296,167232
train,3055,31,31744,419,80448,112192
train,3056,23,23552,230,44160,67712
train,3057,12,12288,63,12096,24384
train,3058,26,26624,295,56640,83264
train,3059,22,22528,211,40512,63040
train,3060,6,6144,16,3072,9216
train,3061,15,15360,98,18816,34176
train,3062,15,15360,98,18816,34176
train,3063,51,52224,1133,217536,269760
train,3064,21,21504,192,36864,58368
train,3065,34,34816,504,96768,131584
train,3066,23,23552,230,44160,67712
train,3067,34,34816,504,96768,131584
train,3068,28,28672,342,65664,94336
train,3069,27,27648,318,61056,88704
train,3070,33,33792,474,91008,124800
train,3071,14,14336,85,16320,30656
train,3072,49,50176,1046,200832,251008
train,3073,10,10240,44,8448,18688
train,3074,31,31744,419,80448,112192
train,3075,20,20480,174,33408,53888
train,3076,15,15360,98,18816,34176
train,3077,15,15360,98,18816,34176
train,3078,3,3072,4,768,3840
train,3079,19,19456,157,30144,49600
train,3080,10,10240,44,8448,18688
train,3081,11,11264,53,10176,21440
train,3082,14,14336,85,16320,30656
train,3083,34,34816,504,96768,131584
train,3084,13,13312,74,14208,27520
train,3085,14,14336,85,16320,30656
train,3086,13,13312,74,14208,27520
train,3087,22,22528,211,40512,63040
train,3088,33,33792,474,91008,124800
train,3089,14,14336,85,16320,30656
train,3090,21,21504,192,36864,58368
train,3091,27,27648,318,61056,88704
train,3092,54,55296,1270,243840,299136
train,3093,16,16384,112,21504,37888
train,3094,17,17408,126,24192,41600
train,3095,5,5120,11,2112,7232
train,3096,9,9216,35,6720,15936
train,3097,29,29696,366,70272,99968
train,3098,35,35840,534,102528,138368
train,3099,19,19456,157,30144,49600
train,3100,6,6144,16,3072,9216
train,3101,28,28672,342,65664,94336
train,3102,34,34816,504,96768,131584
train,3103,44,45056,843,161856,206912
train,3104,32,32768,446,85632,118400
train,3105,24,24576,251,48192,72768
train,3106,26,26624,295,56640,83264
train,3107,28,28672,342,65664,94336
train,3108,9,9216,35,6720,15936
train,3109,10,10240,44,8448,18688
train,3110,29,29696,366,70272,99968
train,3111,41,41984,732,140544,182528
train,3112,16,16384,112,21504,37888
train,3113,15,15360,98,18816,34176
train,3114,18,18432,141,27072,45504
train,3115,26,26624,295,56640,83264
train,3116,20,20480,174,33408,53888
train,3117,38,38912,629,120768,159680
train,3118,21,21504,192,36864,58368
train,3119,11,11264,53,10176,21440
train,3120,4,4096,7,1344,5440
train,3121,21,21504,192,36864,58368
train,3122,33,33792,474,91008,124800
train,3123,6,6144,16,3072,9216
train,3124,37,37888,596,114432,152320
train,3125,22,22528,211,40512,63040
train,3126,15,15360,98,18816,34176
train,3127,25,25600,272,52224,77824
train,3128,27,27648,318,61056,88704
train,3129,35,35840,534,102528,138368
train,3130,27,27648,318,61056,88704
train,3131,19,19456,157,30144,49600
train,3132,49,50176,1046,200832,251008
train,3133,15,15360,98,18816,34176
train,3134,30,30720,392,75264,105984
train,3135,26,26624,295,56640,83264
train,3136,16,16384,112,21504,37888
train,3137,34,34816,504,96768,131584
train,3138,24,24576,251,48192,72768
train,3139,19,19456,157,30144,49600
train,3140,51,52224,1133,217536,269760
train,3141,30,30720,392,75264,105984
train,3142,25,25600,272,52224,77824
train,3143,16,16384,112,21504,37888
train,3144,36,36864,565,108480,145344
train,3145,36,36864,565,108480,145344
train,3146,17,17408,126,24192,41600
train,3147,31,31744,419,80448,112192
train,3148,6,6144,16,3072,9216
train,3149,37,37888,596,114432,152320
train,3150,14,14336,85,16320,30656
train,3151,12,12288,63,12096,24384
train,3152,19,19456,157,30144,49600
train,3153,19,19456,157,30144,49600
train,3154,17,17408,126,24192,41600
train,3155,21,21504,192,36864,58368
train,3156,38,38912,629,120768,159680
train,3157,23,23552,230,44160,67712
train,3158,30,30720,392,75264,105984
train,3159,21,21504,192,36864,58368
train,3160,36,36864,565,108480,145344
train,3161,28,28672,342,65664,94336
train,3162,12,12288,63,12096,24384
train,3163,12,12288,63,12096,24384
train,3164,24,24576,251,48192,72768
train,3165,11,11264,53,10176,21440
train,3166,44,45056,843,161856,206912
train,3167,22,22528,211,40512,63040
train,3168,24,24576,251,48192,72768
train,3169,21,21504,192,36864,58368
train,3170,42,43008,768,147456,190464
train,3171,18,18432,141,27072,45504
train,3172,12,12288,63,12096,24384
train,3173,26,26624,295,56640,83264
train,3174,12,12288,63,12096,24384
train,3175,11,11264,53,10176,21440
train,3176,27,27648,318,61056,88704
train,3177,58,59392,1465,281280,340672
train,3178,35,35840,534,102528,138368
train,3179,15,15360,98,18816,34176
train,3180,25,25600,272,52224,77824
train,3181,17,17408,126,24192,41600
train,3182,25,25600,272,52224,77824
train,3183,31,31744,419,80448,112192
train,3184,13,13312,74,14208,27520
train,3185,17,17408,126,24192,41600
train,3186,28,28672,342,65664,94336
train,3187,25,25600,272,52224,77824
train,3188,6,6144,16,3072,9216
train,3189,30,30720,392,75264,105984
train,3190,20,20480,174,33408,53888
train,3191,28,28672,342,65664,94336
train,3192,17,17408,126,24192,41600
train,3193,17,17408,126,24192,41600
train,3194,35,35840,534,102528,138368
train,3195,6,6144,16,3072,9216
train,3196,13,13312,74,14208,27520
train,3197,16,16384,112,21504,37888
train,3198,26,26624,295,56640,83264
train,3199,11,11264,53,10176,21440
train,3200,26,26624,295,56640,83264
train,3201,9,9216,35,6720,15936
train,3202,28,28672,342,65664,94336
train,3203,14,14336,85,16320,30656
train,3204,56,57344,1366,262272,319616
train,3205,12,12288,63,12096,24384
train,3206,18,18432,141,27072,45504
train,3207,35,35840,534,102528,138368
train,3208,24,24576,251,48192,72768
train,3209,6,6144,16,3072,9216
train,3210,42,43008,768,147456,190464
train,3211,28,28672,342,65664,94336
train,3212,7,7168,21,4032,11200
train,3213,13,13312,74,14208,27520
train,3214,27,27648,318,61056,88704
train,3215,27,27648,318,61056,88704
train,3216,20,20480,174,33408,53888
train,3217,23,23552,230,44160,67712
train,3218,25,25600,272,52224,77824
train,3219,17,17408,126,24192,41600
train,3220,11,11264,53,10176,21440
train,3221,23,23552,230,44160,67712
train,3222,5,5120,11,2112,7232
train,3223,43,44032,805,154560,198592
train,3224,8,8192,28,5376,13568
train,3225,41,41984,732,140544,182528
train,3226,10,10240,44,8448,18688
train,3227,23,23552,230,44160,67712
train,3228,21,21504,192,36864,58368
train,3229,23,23552,230,44160,67712
train,3230,20,20480,174,33408,53888
train,3231,6,6144,16,3072,9216
train,3232,16,16384,112,21504,37888
train,3233,12,12288,63,12096,24384
train,3234,17,17408,126,24192,41600
train,3235,16,16384,112,21504,37888
train,3236,14,14336,85,16320,30656
train,3237,32,32768,446,85632,118400
train,3238,8,8192,28,5376,13568
train,3239,31,31744,419,80448,112192
train,3240,10,10240,44,8448,18688
train,3241,10,10240,44,8448,18688
train,3242,17,17408,126,24192,41600
train,3243,25,25600,272,52224,77824
train,3244,21,21504,192,36864,58368
train,3245,11,11264,53,10176,21440
train,3246,30,30720,392,75264,105984
train,3247,23,23552,230,44160,67712
train,3248,15,15360,98,18816,34176
train,3249,20,20480,174,33408,53888
train,3250,16,16384,112,21504,37888
train,3251,34,34816,504,96768,131584
train,3252,6,6144,16,3072,9216
train,3253,45,46080,882,169344,215424
train,3254,44,45056,843,161856,206912
train,3255,45,46080,882,169344,215424
train,3256,29,29696,366,70272,99968
train,3257,33,33792,474,91008,124800
train,3258,15,15360,98,18816,34176
train,3259,36,36864,565,108480,145344
train,3260,36,36864,565,108480,145344
train,3261,18,18432,141,27072,45504
train,3262,36,36864,565,108480,145344
train,3263,18,18432,141,27072,45504
train,3264,21,21504,192,36864,58368
train,3265,17,17408,126,24192,41600
train,3266,29,29696,366,70272,99968
train,3267,13,13312,74,14208,27520
train,3268,21,21504,192,36864,58368
train,3269,35,35840,534,102528,138368
train,3270,28,28672,342,65664,94336
train,3271,24,24576,251,48192,72768
train,3272,15,15360,98,18816,34176
train,3273,14,14336,85,16320,30656
train,3274,19,19456,157,30144,49600
train,3275,18,18432,141,27072,45504
train,3276,4,4096,7,1344,5440
train,3277,47,48128,962,184704,232832
train,3278,31,31744,419,80448,112192
train,3279,37,37888,596,114432,152320
train,3280,25,25600,272,52224,77824
train,3281,21,21504,192,36864,58368
train,3282,7,7168,21,4032,11200
train,3283,30,30720,392,75264,105984
train,3284,7,7168,21,4032,11200
train,3285,15,15360,98,18816,34176
train,3286,16,16384,112,21504,37888
train,3287,22,22528,211,40512,63040
train,3288,17,17408,126,24192,41600
train,3289,29,29696,366,70272,99968
train,3290,17,17408,126,24192,41600
train,3291,38,38912,629,120768,159680
train,3292,29,29696,366,70272,99968
train,3293,7,7168,21,4032,11200
train,3294,18,18432,141,27072,45504
train,3295,45,46080,882,169344,215424
train,3296,5,5120,11,2112,7232
train,3297,16,16384,112,21504,37888
train,3298,13,13312,74,14208,27520
train,3299,11,11264,53,10176,21440
train,3300,54,55296,1270,243840,299136
train,3301,18,18432,141,27072,45504
train,3302,17,17408,126,24192,41600
train,3303,21,21504,192,36864,58368
train,3304,22,22528,211,40512,63040
train,3305,32,32768,446,85632,118400
train,3306,18,18432,141,27072,45504
train,3307,27,27648,318,61056,88704
train,3308,5,5120,11,2112,7232
train,3309,8,8192,28,5376,13568
train,3310,6,6144,16,3072,9216
train,3311,12,12288,63,12096,24384
train,3312,8,8192,28,5376,13568
train,3313,34,34816,504,96768,131584
train,3314,10,10240,44,8448,18688
train,3315,5,5120,11,2112,7232
train,3316,17,17408,126,24192,41600
train,3317,33,33792,474,91008,124800
train,3318,12,12288,63,12096,24384
train,3319,30,30720,392,75264,105984
train,3320,25,25600,272,52224,77824
train,3321,24,24576,251,48192,72768
train,3322,30,30720,392,75264,105984
train,3323,12,12288,63,12096,24384
train,3324,25,25600,272,52224,77824
train,3325,18,18432,141,27072,45504
train,3326,26,26624,295,56640,83264
train,3327,50,51200,1089,209088,260288
train,3328,33,33792,474,91008,124800
train,3329,17,17408,126,24192,41600
train,3330,13,13312,74,14208,27520
train,3331,11,11264,53,10176,21440
train,3332,27,27648,318,61056,88704
train,3333,21,21504,192,36864,58368
train,3334,36,36864,565,108480,145344
train,3335,22,22528,211,40512,63040
train,3336,26,26624,295,56640,83264
train,3337,28,28672,342,65664,94336
train,3338,30,30720,392,75264,105984
train,3339,42,43008,768,147456,190464
train,3340,20,20480,174,33408,53888
train,3341,14,14336,85,16320,30656
train,3342,24,24576,251,48192,72768
train,3343,20,20480,174,33408,53888
train,3344,15,15360,98,18816,34176
train,3345,16,16384,112,21504,37888
train,3346,8,8192,28,5376,13568
train,3347,21,21504,192,36864,58368
train,3348,10,10240,44,8448,18688
train,3349,39,39936,663,127296,167232
train,3350,4,4096,7,1344,5440
train,3351,37,37888,596,114432,152320
train,3352,6,6144,16,3072,9216
train,3353,47,48128,962,184704,232832
train,3354,14,14336,85,16320,30656
train,3355,17,17408,126,24192,41600
train,3356,21,21504,192,36864,58368
train,3357,17,17408,126,24192,41600
train,3358,42,43008,768,147456,190464
train,3359,11,11264,53,10176,21440
train,3360,21,21504,192,36864,58368
train,3361,24,24576,251,48192,72768
train,3362,7,7168,21,4032,11200
train,3363,40,40960,697,133824,174784
train,3364,21,21504,192,36864,58368
train,3365,17,17408,126,24192,41600
train,3366,4,4096,7,1344,5440
train,3367,14,14336,85,16320,30656
train,3368,39,39936,663,127296,167232
train,3369,32,32768,446,85632,118400
train,3370,12,12288,63,12096,24384
train,3371,53,54272,1224,235008,289280
train,3372,11,11264,53,10176,21440
train,3373,35,35840,534,102528,138368
train,3374,19,19456,157,30144,49600
train,3375,28,28672,342,65664,94336
train,3376,39,39936,663,127296,167232
train,3377,9,9216,35,6720,15936
train,3378,42,43008,768,147456,190464
train,3379,31,31744,419,80448,112192
train,3380,13,13312,74,14208,27520
train,3381,7,7168,21,4032,11200
train,3382,20,20480,174,33408,53888
train,3383,27,27648,318,61056,88704
train,3384,29,29696,366,70272,99968
train,3385,35,35840,534,102528,138368
train,3386,6,6144,16,3072,9216
train,3387,23,23552,230,44160,67712
train,3388,23,23552,230,44160,67712
train,3389,21,21504,192,36864,58368
train,3390,18,18432,141,27072,45504
train,3391,37,37888,596,114432,152320
train,3392,19,19456,157,30144,49600
train,3393,18,18432,141,27072,45504
train,3394,14,14336,85,16320,30656
train,3395,20,20480,174,33408,53888
train,3396,19,19456,157,30144,49600
train,3397,43,44032,805,154560,198592
train,3398,21,21504,192,36864,58368
train,3399,31,31744,419,80448,112192
train,3400,22,22528,211,40512,63040
train,3401,18,18432,141,27072,45504
train,3402,21,21504,192,36864,58368
train,3403,35,35840,534,102528,138368
train,3404,24,24576,251,48192,72768
train,3405,22,22528,211,40512,63040
train,3406,3,3072,4,768,3840
train,3407,6,6144,16,3072,9216
train,3408,26,26624,295,56640,83264
train,3409,24,24576,251,48192,72768
train,3410,29,29696,366,70272,99968
train,3411,45,46080,882,169344,215424
train,3412,15,15360,98,18816,34176
train,3413,13,13312,74,14208,27520
train,3414,39,39936,663,127296,167232
train,3415,21,21504,192,36864,58368
train,3416,21,21504,192,36864,58368
train,3417,42,43008,768,147456,190464
train,3418,34,34816,504,96768,131584
train,3419,9,9216,35,6720,15936
train,3420,25,25600,272,52224,77824
train,3421,5,5120,11,2112,7232
train,3422,28,28672,342,65664,94336
train,3423,34,34816,504,96768,131584
train,3424,41,41984,732,140544,182528
train,3425,24,24576,251,48192,72768
train,3426,32,32768,446,85632,118400
train,3427,12,12288,63,12096,24384
train,3428,17,17408,126,24192,41600
train,3429,6,6144,16,3072,9216
train,3430,22,22528,211,40512,63040
train,3431,4,4096,7,1344,5440
train,3432,34,34816,504,96768,131584
train,3433,36,36864,565,108480,145344
train,3434,15,15360,98,18816,34176
train,3435,16,16384,112,21504,37888
train,3436,29,29696,366,70272,99968
train,3437,30,30720,392,75264,105984
train,3438,17,17408,126,24192,41600
train,3439,8,8192,28,5376,13568
train,3440,18,18432,141,27072,45504
train,3441,30,30720,392,75264,105984
train,3442,19,19456,157,30144,49600
train,3443,19,19456,157,30144,49600
train,3444,14,14336,85,16320,30656
train,3445,21,21504,192,36864,58368
train,3446,22,22528,211,40512,63040
train,3447,41,41984,732,140544,182528
train,3448,26,26624,295,56640,83264
train,3449,4,4096,7,1344,5440
train,3450,16,16384,112,21504,37888
train,3451,42,43008,768,147456,190464
train,3452,18,18432,141,27072,45504
train,3453,8,8192,28,5376,13568
train,3454,28,28672,342,65664,94336
train,3455,29,29696,366,70272,99968
train,3456,9,9216,35,6720,15936
train,3457,15,15360,98,18816,34176
train,3458,8,8192,28,5376,13568
train,3459,35,35840,534,102528,138368
train,3460,44,45056,843,161856,206912
train,3461,26,26624,295,56640,83264
train,3462,27,27648,318,61056,88704
train,3463,19,19456,157,30144,49600
train,3464,14,14336,85,16320,30656
train,3465,38,38912,629,120768,159680
train,3466,26,26624,295,56640,83264
train,3467,30,30720,392,75264,105984
train,3468,17,17408,126,24192,41600
train,3469,13,13312,74,14208,27520
train,3470,11,11264,53,10176,21440
train,3471,23,23552,230,44160,67712
train,3472,34,34816,504,96768,131584
train,3473,6,6144,16,3072,9216
train,3474,37,37888,596,114432,152320
train,3475,12,12288,63,12096,24384
train,3476,14,14336,85,16320,30656
train,3477,27,27648,318,61056,88704
train,3478,30,30720,392,75264,105984
train,3479,22,22528,211,40512,63040
train,3480,11,11264,53,10176,21440
train,3481,36,36864,565,108480,145344
train,3482,28,28672,342,65664,94336
train,3483,30,30720,392,75264,105984
train,3484,18,18432,141,27072,45504
train,3485,33,33792,474,91008,124800
train,3486,30,30720,392,75264,105984
train,3487,15,15360,98,18816,34176
train,3488,36,36864,565,108480,145344
train,3489,13,13312,74,14208,27520
train,3490,39,39936,663,127296,167232
train,3491,35,35840,534,102528,138368
train,3492,8,8192,28,5376,13568
train,3493,40,40960,697,133824,174784
train,3494,14,14336,85,16320,30656
train,3495,5,5120,11,2112,7232
train,3496,13,13312,74,14208,27520
train,3497,22,22528,211,40512,63040
train,3498,18,18432,141,27072,45504
train,3499,22,22528,211,40512,63040
train,3500,20,20480,174,33408,53888
train,3501,23,23552,230,44160,67712
train,3502,14,14336,85,16320,30656
train,3503,29,29696,366,70272,99968
train,3504,38,38912,629,120768,159680
train,3505,21,21504,192,36864,58368
train,3506,26,26624,295,56640,83264
train,3507,45,46080,882,169344,215424
train,3508,11,11264,53,10176,21440
train,3509,18,18432,141,27072,45504
train,3510,19,19456,157,30144,49600
train,3511,19,19456,157,30144,49600
train,3512,26,26624,295,56640,83264
train,3513,23,23552,230,44160,67712
train,3514,31,31744,419,80448,112192
train,3515,9,9216,35,6720,15936
train,3516,34,34816,504,96768,131584
train,3517,29,29696,366,70272,99968
train,3518,5,5120,11,2112,7232
train,3519,9,9216,35,6720,15936
train,3520,16,16384,112,21504,37888
train,3521,22,22528,211,40512,63040
train,3522,7,7168,21,4032,11200
train,3523,9,9216,35,6720,15936
train,3524,13,13312,74,14208,27520
train,3525,21,21504,192,36864,58368
train,3526,32,32768,446,85632,118400
train,3527,8,8192,28,5376,13568
train,3528,8,8192,28,5376,13568
train,3529,26,26624,295,56640,83264
train,3530,21,21504,192,36864,58368
train,3531,6,6144,16,3072,9216
train,3532,19,19456,157,30144,49600
train,3533,17,17408,126,24192,41600
train,3534,7,7168,21,4032,11200
train,3535,6,6144,16,3072,9216
train,3536,22,22528,211,40512,63040
train,3537,22,22528,211,40512,63040
train,3538,27,27648,318,61056,88704
train,3539,16,16384,112,21504,37888
train,3540,45,46080,882,169344,215424
train,3541,22,22528,211,40512,63040
train,3542,19,19456,157,30144,49600
train,3543,33,33792,474,91008,124800
train,3544,7,7168,21,4032,11200
train,3545,21,21504,192,36864,58368
train,3546,11,11264,53,10176,21440
train,3547,5,5120,11,2112,7232
train,3548,23,23552,230,44160,67712
train,3549,17,17408,126,24192,41600
train,3550,35,35840,534,102528,138368
train,3551,23,23552,230,44160,67712
train,3552,12,12288,63,12096,24384
train,3553,27,27648,318,61056,88704
train,3554,34,34816,504,96768,131584
train,3555,35,35840,534,102528,138368
train,3556,13,13312,74,14208,27520
train,3557,25,25600,272,52224,77824
train,3558,19,19456,157,30144,49600
train,3559,6,6144,16,3072,9216
train,3560,27,27648,318,61056,88704
train,3561,10,10240,44,8448,18688
train,3562,21,21504,192,36864,58368
train,3563,33,33792,474,91008,124800
train,3564,23,23552,230,44160,67712
train,3565,27,27648,318,61056,88704
train,3566,21,21504,192,36864,58368
train,3567,17,17408,126,24192,41600
train,3568,6,6144,16,3072,9216
train,3569,31,31744,419,80448,112192
train,3570,24,24576,251,48192,72768
train,3571,17,17408,126,24192,41600
train,3572,15,15360,98,18816,34176
train,3573,30,30720,392,75264,105984
train,3574,12,12288,63,12096,24384
train,3575,25,25600,272,52224,77824
train,3576,33,33792,474,91008,124800
train,3577,30,30720,392,75264,105984
train,3578,8,8192,28,5376,13568
train,3579,15,15360,98,18816,34176
train,3580,27,27648,318,61056,88704
train,3581,17,17408,126,24192,41600
train,3582,25,25600,272,52224,77824
train,3583,7,7168,21,4032,11200
train,3584,18,18432,141,27072,45504
train,3585,15,15360,98,18816,34176
train,3586,21,21504,192,36864,58368
train,3587,13,13312,74,14208,27520
train,3588,25,25600,272,52224,77824
train,3589,21,21504,192,36864,58368
train,3590,8,8192,28,5376,13568
train,3591,6,6144,16,3072,9216
train,3592,45,46080,882,169344,215424
train,3593,37,37888,596,114432,152320
train,3594,36,36864,565,108480,145344
train,3595,20,20480,174,33408,53888
train,3596,15,15360,98,18816,34176
train,3597,15,15360,98,18816,34176
train,3598,31,31744,419,80448,112192
train,3599,6,6144,16,3072,9216
train,3600,23,23552,230,44160,67712
train,3601,24,24576,251,48192,72768
train,3602,10,10240,44,8448,18688
train,3603,31,31744,419,80448,112192
train,3604,45,46080,882,169344,215424
train,3605,15,15360,98,18816,34176
train,3606,37,37888,596,114432,152320
train,3607,59,60416,1516,291072,351488
train,3608,20,20480,174,33408,53888
train,3609,10,10240,44,8448,18688
train,3610,19,19456,157,30144,49600
train,3611,20,20480,174,33408,53888
train,3612,26,26624,295,56640,83264
train,3613,32,32768,446,85632,118400
train,3614,34,34816,504,96768,131584
train,3615,22,22528,211,40512,63040
train,3616,23,23552,230,44160,67712
train,3617,24,24576,251,48192,72768
train,3618,34,34816,504,96768,131584
train,3619,40,40960,697,133824,174784
train,3620,27,27648,318,61056,88704
train,3621,15,15360,98,18816,34176
train,3622,31,31744,419,80448,112192
train,3623,28,28672,342,65664,94336
train,3624,13,13312,74,14208,27520
train,3625,13,13312,74,14208,27520
train,3626,20,20480,174,33408,53888
train,3627,34,34816,504,96768,131584
train,3628,25,25600,272,52224,77824
train,3629,23,23552,230,44160,67712
train,3630,11,11264,53,10176,21440
train,3631,11,11264,53,10176,21440
train,3632,11,11264,53,10176,21440
train,3633,10,10240,44,8448,18688
train,3634,19,19456,157,30144,49600
train,3635,13,13312,74,14208,27520
train,3636,21,21504,192,36864,58368
train,3637,37,37888,596,114432,152320
train,3638,19,19456,157,30144,49600
train,3639,24,24576,251,48192,72768
train,3640,14,14336,85,16320,30656
train,3641,32,32768,446,85632,118400
train,3642,32,32768,446,85632,118400
train,3643,26,26624,295,56640,83264
train,3644,34,34816,504,96768,131584
train,3645,7,7168,21,4032,11200
train,3646,16,16384,112,21504,37888
train,3647,36,36864,565,108480,145344
train,3648,9,9216,35,6720,15936
train,3649,22,22528,211,40512,63040
train,3650,6,6144,16,3072,9216
train,3651,22,22528,211,40512,63040
train,3652,25,25600,272,52224,77824
train,3653,29,29696,366,70272,99968
train,3654,10,10240,44,8448,18688
train,3655,17,17408,126,24192,41600
train,3656,25,25600,272,52224,77824
train,3657,24,24576,251,48192,72768
train,3658,34,34816,504,96768,131584
train,3659,28,28672,342,65664,94336
train,3660,22,22528,211,40512,63040
train,3661,3,3072,4,768,3840
train,3662,29,29696,366,70272,99968
train,3663,23,23552,230,44160,67712
train,3664,12,12288,63,12096,24384
train,3665,16,16384,112,21504,37888
train,3666,26,26624,295,56640,83264
train,3667,46,47104,922,177024,224128
train,3668,25,25600,272,52224,77824
train,3669,22,22528,211,40512,63040
train,3670,21,21504,192,36864,58368
train,3671,19,19456,157,30144,49600
train,3672,28,28672,342,65664,94336
train,3673,32,32768,446,85632,118400
train,3674,42,43008,768,147456,190464
train,3675,21,21504,192,36864,58368
train,3676,28,28672,342,65664,94336
train,3677,7,7168,21,4032,11200
train,3678,7,7168,21,4032,11200
train,3679,14,14336,85,16320,30656
train,3680,33,33792,474,91008,124800
train,3681,17,17408,126,24192,41600
train,3682,10,10240,44,8448,18688
train,3683,14,14336,85,16320,30656
train,3684,25,25600,272,52224,77824
train,3685,24,24576,251,48192,72768
train,3686,10,10240,44,8448,18688
train,3687,26,26624,295,56640,83264
train,3688,34,34816,504,96768,131584
train,3689,21,21504,192,36864,58368
train,3690,30,30720,392,75264,105984
train,3691,32,32768,446,85632,118400
train,3692,14,14336,85,16320,30656
train,3693,44,45056,843,161856,206912
train,3694,14,14336,85,16320,30656
train,3695,25,25600,272,52224,77824
train,3696,35,35840,534,102528,138368
train,3697,27,27648,318,61056,88704
train,3698,13,13312,74,14208,27520
train,3699,19,19456,157,30144,49600
train,3700,18,18432,141,27072,45504
train,3701,26,26624,295,56640,83264
train,3702,39,39936,663,127296,167232
train,3703,38,38912,629,120768,159680
train,3704,20,20480,174,33408,53888
train,3705,40,40960,697,133824,174784
train,3706,16,16384,112,21504,37888
train,3707,33,33792,474,91008,124800
train,3708,14,14336,85,16320,30656
train,3709,35,35840,534,102528,138368
train,3710,33,33792,474,91008,124800
train,3711,16,16384,112,21504,37888
train,3712,13,13312,74,14208,27520
train,3713,37,37888,596,114432,152320
train,3714,28,28672,342,65664,94336
train,3715,30,30720,392,75264,105984
train,3716,19,19456,157,30144,49600
train,3717,51,52224,1133,217536,269760
train,3718,23,23552,230,44160,67712
train,3719,15,15360,98,18816,34176
train,3720,23,23552,230,44160,67712
train,3721,26,26624,295,56640,83264
train,3722,15,15360,98,18816,34176
train,3723,17,17408,126,24192,41600
train,3724,21,21504,192,36864,58368
train,3725,38,38912,629,120768,159680
train,3726,32,32768,446,85632,118400
train,3727,4,4096,7,1344,5440
train,3728,9,9216,35,6720,15936
train,3729,12,12288,63,12096,24384
train,3730,52,53248,1178,226176,279424
train,3731,21,21504,192,36864,58368
train,3732,18,18432,141,27072,45504
train,3733,27,27648,318,61056,88704
train,3734,32,32768,446,85632,118400
train,3735,20,20480,174,33408,53888
train,3736,49,50176,1046,200832,251008
train,3737,25,25600,272,52224,77824
train,3738,25,25600,272,52224,77824
train,3739,22,22528,211,40512,63040
train,3740,19,19456,157,30144,49600
train,3741,32,32768,446,85632,118400
train,3742,27,27648,318,61056,88704
train,3743,32,32768,446,85632,118400
train,3744,44,45056,843,161856,206912
train,3745,23,23552,230,44160,67712
train,3746,29,29696,366,70272,99968
train,3747,42,43008,768,147456,190464
train,3748,11,11264,53,10176,21440
train,3749,24,24576,251,48192,72768
train,3750,10,10240,44,8448,18688
train,3751,32,32768,446,85632,118400
train,3752,38,38912,629,120768,159680
train,3753,20,20480,174,33408,53888
train,3754,24,24576,251,48192,72768
train,3755,20,20480,174,33408,53888
train,3756,20,20480,174,33408,53888
train,3757,7,7168,21,4032,11200
train,3758,9,9216,35,6720,15936
train,3759,48,49152,1004,192768,241920
train,3760,13,13312,74,14208,27520
train,3761,22,22528,211,40512,63040
train,3762,9,9216,35,6720,15936
train,3763,21,21504,192,36864,58368
train,3764,9,9216,35,6720,15936
train,3765,33,33792,474,91008,124800
train,3766,35,35840,534,102528,138368
train,3767,31,31744,419,80448,112192
train,3768,20,20480,174,33408,53888
train,3769,27,27648,318,61056,88704
train,3770,10,10240,44,8448,18688
train,3771,15,15360,98,18816,34176
train,3772,32,32768,446,85632,118400
train,3773,11,11264,53,10176,21440
train,3774,12,12288,63,12096,24384
train,3775,35,35840,534,102528,138368
train,3776,25,25600,272,52224,77824
train,3777,54,55296,1270,243840,299136
train,3778,54,55296,1270,243840,299136
train,3779,25,25600,272,52224,77824
train,3780,27,27648,318,61056,88704
train,3781,32,32768,446,85632,118400
train,3782,31,31744,419,80448,112192
train,3783,25,25600,272,52224,77824
train,3784,48,49152,1004,192768,241920
train,3785,12,12288,63,12096,24384
train,3786,17,17408,126,24192,41600
train,3787,15,15360,98,18816,34176
train,3788,29,29696,366,70272,99968
train,3789,43,44032,805,154560,198592
train,3790,17,17408,126,24192,41600
train,3791,19,19456,157,30144,49600
train,3792,13,13312,74,14208,27520
train,3793,40,40960,697,133824,174784
train,3794,30,30720,392,75264,105984
train,3795,38,38912,629,120768,159680
train,3796,22,22528,211,40512,63040
train,3797,8,8192,28,5376,13568
train,3798,16,16384,112,21504,37888
train,3799,34,34816,504,96768,131584
train,3800,16,16384,112,21504,37888
train,3801,19,19456,157,30144,49600
train,3802,19,19456,157,30144,49600
train,3803,54,55296,1270,243840,299136
train,3804,22,22528,211,40512,63040
train,3805,4,4096,7,1344,5440
train,3806,24,24576,251,48192,72768
train,3807,13,13312,74,14208,27520
train,3808,11,11264,53,10176,21440
train,3809,18,18432,141,27072,45504
train,3810,27,27648,318,61056,88704
train,3811,43,44032,805,154560,198592
train,3812,21,21504,192,36864,58368
train,3813,15,15360,98,18816,34176
train,3814,19,19456,157,30144,49600
train,3815,41,41984,732,140544,182528
train,3816,33,33792,474,91008,124800
train,3817,10,10240,44,8448,18688
train,3818,7,7168,21,4032,11200
train,3819,38,38912,629,120768,159680
train,3820,27,27648,318,61056,88704
train,3821,16,16384,112,21504,37888
train,3822,14,14336,85,16320,30656
train,3823,26,26624,295,56640,83264
train,3824,23,23552,230,44160,67712
train,3825,19,19456,157,30144,49600
train,3826,18,18432,141,27072,45504
train,3827,25,25600,272,52224,77824
train,3828,22,22528,211,40512,63040
train,3829,28,28672,342,65664,94336
train,3830,17,17408,126,24192,41600
train,3831,11,11264,53,10176,21440
train,3832,17,17408,126,24192,41600
train,3833,39,39936,663,127296,167232
train,3834,17,17408,126,24192,41600
train,3835,4,4096,7,1344,5440
train,3836,13,13312,74,14208,27520
train,3837,15,15360,98,18816,34176
train,3838,53,54272,1224,235008,289280
train,3839,18,18432,141,27072,45504
train,3840,26,26624,295,56640,83264
train,3841,33,33792,474,91008,124800
train,3842,29,29696,366,70272,99968
train,3843,28,28672,342,65664,94336
train,3844,38,38912,629,120768,159680
train,3845,10,10240,44,8448,18688
train,3846,26,26624,295,56640,83264
train,3847,22,22528,211,40512,63040
train,3848,56,57344,1366,262272,319616
train,3849,10,10240,44,8448,18688
train,3850,27,27648,318,61056,88704
train,3851,23,23552,230,44160,67712
train,3852,23,23552,230,44160,67712
train,3853,27,27648,318,61056,88704
train,3854,11,11264,53,10176,21440
train,3855,12,12288,63,12096,24384
train,3856,24,24576,251,48192,72768
train,3857,28,28672,342,65664,94336
train,3858,22,22528,211,40512,63040
train,3859,12,12288,63,12096,24384
train,3860,24,24576,251,48192,72768
train,3861,41,41984,732,140544,182528
train,3862,25,25600,272,52224,77824
train,3863,34,34816,504,96768,131584
train,3864,14,14336,85,16320,30656
train,3865,25,25600,272,52224,77824
train,3866,39,39936,663,127296,167232
train,3867,39,39936,663,127296,167232
train,3868,29,29696,366,70272,99968
train,3869,17,17408,126,24192,41600
train,3870,36,36864,565,108480,145344
train,3871,20,20480,174,33408,53888
train,3872,13,13312,74,14208,27520
train,3873,4,4096,7,1344,5440
train,3874,6,6144,16,3072,9216
train,3875,8,8192,28,5376,13568
train,3876,18,18432,141,27072,45504
train,3877,22,22528,211,40512,63040
train,3878,10,10240,44,8448,18688
train,3879,27,27648,318,61056,88704
train,3880,7,7168,21,4032,11200
train,3881,16,16384,112,21504,37888
train,3882,3,3072,4,768,3840
train,3883,24,24576,251,48192,72768
train,3884,32,32768,446,85632,118400
train,3885,29,29696,366,70272,99968
train,3886,16,16384,112,21504,37888
train,3887,34,34816,504,96768,131584
train,3888,35,35840,534,102528,138368
train,3889,19,19456,157,30144,49600
train,3890,20,20480,174,33408,53888
train,3891,13,13312,74,14208,27520
train,3892,19,19456,157,30144,49600
train,3893,6,6144,16,3072,9216
train,3894,19,19456,157,30144,49600
train,3895,39,39936,663,127296,167232
train,3896,48,49152,1004,192768,241920
train,3897,11,11264,53,10176,21440
train,3898,28,28672,342,65664,94336
train,3899,21,21504,192,36864,58368
train,3900,5,5120,11,2112,7232
train,3901,25,25600,272,52224,77824
train,3902,23,23552,230,44160,67712
train,3903,16,16384,112,21504,37888
train,3904,21,21504,192,36864,58368
train,3905,8,8192,28,5376,13568
train,3906,22,22528,211,40512,63040
train,3907,9,9216,35,6720,15936
train,3908,28,28672,342,65664,94336
train,3909,6,6144,16,3072,9216
train,3910,20,20480,174,33408,53888
train,3911,13,13312,74,14208,27520
train,3912,28,28672,342,65664,94336
train,3913,6,6144,16,3072,9216
train,3914,22,22528,211,40512,63040
train,3915,30,30720,392,75264,105984
train,3916,11,11264,53,10176,21440
train,3917,25,25600,272,52224,77824
train,3918,14,14336,85,16320,30656
train,3919,28,28672,342,65664,94336
train,3920,6,6144,16,3072,9216
train,3921,34,34816,504,96768,131584
train,3922,14,14336,85,16320,30656
train,3923,36,36864,565,108480,145344
train,3924,20,20480,174,33408,53888
train,3925,33,33792,474,91008,124800
train,3926,41,41984,732,140544,182528
train,3927,13,13312,74,14208,27520
train,3928,21,21504,192,36864,58368
train,3929,9,9216,35,6720,15936
train,3930,30,30720,392,75264,105984
train,3931,28,28672,342,65664,94336
train,3932,7,7168,21,4032,11200
train,3933,20,20480,174,33408,53888
train,3934,30,30720,392,75264,105984
train,3935,26,26624,295,56640,83264
train,3936,30,30720,392,75264,105984
train,3937,30,30720,392,75264,105984
train,3938,17,17408,126,24192,41600
train,3939,12,12288,63,12096,24384
train,3940,33,33792,474,91008,124800
train,3941,35,35840,534,102528,138368
train,3942,19,19456,157,30144,49600
train,3943,13,13312,74,14208,27520
train,3944,33,33792,474,91008,124800
train,3945,24,24576,251,48192,72768
train,3946,27,27648,318,61056,88704
train,3947,9,9216,35,6720,15936
train,3948,9,9216,35,6720,15936
train,3949,45,46080,882,169344,215424
train,3950,33,33792,474,91008,124800
train,3951,19,19456,157,30144,49600
train,3952,21,21504,192,36864,58368
train,3953,13,13312,74,14208,27520
train,3954,23,23552,230,44160,67712
train,3955,14,14336,85,16320,30656
train,3956,18,18432,141,27072,45504
train,3957,25,25600,272,52224,77824
train,3958,41,41984,732,140544,182528
train,3959,19,19456,157,30144,49600
train,3960,25,25600,272,52224,77824
train,3961,11,11264,53,10176,21440
train,3962,19,19456,157,30144,49600
train,3963,7,7168,21,4032,11200
train,3964,31,31744,419,80448,112192
train,3965,20,20480,174,33408,53888
train,3966,39,39936,663,127296,167232
train,3967,24,24576,251,48192,72768
train,3968,14,14336,85,16320,30656
train,3969,11,11264,53,10176,21440
train,3970,39,39936,663,127296,167232
train,3971,12,12288,63,12096,24384
train,3972,33,33792,474,91008,124800
train,3973,15,15360,98,18816,34176
train,3974,25,25600,272,52224,77824
train,3975,18,18432,141,27072,45504
train,3976,45,46080,882,169344,215424
train,3977,35,35840,534,102528,138368
train,3978,28,28672,342,65664,94336
train,3979,9,9216,35,6720,15936
train,3980,24,24576,251,48192,72768
train,3981,13,13312,74,14208,27520
train,3982,32,32768,446,85632,118400
train,3983,38,38912,629,120768,159680
train,3984,32,32768,446,85632,118400
train,3985,18,18432,141,27072,45504
train,3986,35,35840,534,102528,138368
train,3987,23,23552,230,44160,67712
train,3988,37,37888,596,114432,152320
train,3989,18,18432,141,27072,45504
train,3990,34,34816,504,96768,131584
train,3991,28,28672,342,65664,94336
train,3992,36,36864,565,108480,145344
train,3993,20,20480,174,33408,53888
train,3994,23,23552,230,44160,67712
train,3995,33,33792,474,91008,124800
train,3996,40,40960,697,133824,174784
train,3997,17,17408,126,24192,41600
train,3998,24,24576,251,48192,72768
train,3999,31,31744,419,80448,112192
train,4000,10,10240,44,8448,18688
train,4001,20,20480,174,33408,53888
train,4002,33,33792,474,91008,124800
train,4003,30,30720,392,75264,105984
train,4004,14,14336,85,16320,30656
train,4005,9,9216,35,6720,15936
train,4006,24,24576,251,48192,72768
train,4007,22,22528,211,40512,63040
train,4008,33,33792,474,91008,124800
train,4009,19,19456,157,30144,49600
train,4010,23,23552,230,44160,67712
train,4011,11,11264,53,10176,21440
train,4012,5,5120,11,2112,7232
train,4013,27,27648,318,61056,88704
train,4014,28,28672,342,65664,94336
train,4015,33,33792,474,91008,124800
train,4016,28,28672,342,65664,94336
train,4017,12,12288,63,12096,24384
train,4018,13,13312,74,14208,27520
train,4019,36,36864,565,108480,145344
train,4020,43,44032,805,154560,198592
train,4021,38,38912,629,120768,159680
train,4022,33,33792,474,91008,124800
train,4023,18,18432,141,27072,45504
train,4024,40,40960,697,133824,174784
train,4025,37,37888,596,114432,152320
train,4026,35,35840,534,102528,138368
train,4027,16,16384,112,21504,37888
train,4028,24,24576,251,48192,72768
train,4029,43,44032,805,154560,198592
train,4030,13,13312,74,14208,27520
train,4031,2,2048,2,384,2432
train,4032,14,14336,85,16320,30656
train,4033,8,8192,28,5376,13568
train,4034,51,52224,1133,217536,269760
train,4035,20,20480,174,33408,53888
train,4036,35,35840,534,102528,138368
train,4037,18,18432,141,27072,45504
train,4038,28,28672,342,65664,94336
train,4039,31,31744,419,80448,112192
train,4040,20,20480,174,33408,53888
train,4041,34,34816,504,96768,131584
train,4042,4,4096,7,1344,5440
train,4043,22,22528,211,40512,63040
train,4044,22,22528,211,40512,63040
train,4045,14,14336,85,16320,30656
train,4046,19,19456,157,30144,49600
train,4047,5,5120,11,2112,7232
train,4048,8,8192,28,5376,13568
train,4049,28,28672,342,65664,94336
train,4050,21,21504,192,36864,58368
train,4051,23,23552,230,44160,67712
train,4052,9,9216,35,6720,15936
train,4053,16,16384,112,21504,37888
train,4054,25,25600,272,52224,77824
train,4055,21,21504,192,36864,58368
train,4056,11,11264,53,10176,21440
train,4057,27,27648,318,61056,88704
train,4058,20,20480,174,33408,53888
train,4059,24,24576,251,48192,72768
train,4060,7,7168,21,4032,11200
train,4061,32,32768,446,85632,118400
train,4062,23,23552,230,44160,67712
train,4063,11,11264,53,10176,21440
train,4064,22,22528,211,40512,63040
train,4065,27,27648,318,61056,88704
train,4066,11,11264,53,10176,21440
train,4067,7,7168,21,4032,11200
train,4068,51,52224,1133,217536,269760
train,4069,9,9216,35,6720,15936
train,4070,11,11264,53,10176,21440
train,4071,5,5120,11,2112,7232
train,4072,17,17408,126,24192,41600
train,4073,12,12288,63,12096,24384
train,4074,28,28672,342,65664,94336
train,4075,10,10240,44,8448,18688
train,4076,29,29696,366,70272,99968
train,4077,37,37888,596,114432,152320
train,4078,11,11264,53,10176,21440
train,4079,21,21504,192,36864,58368
train,4080,15,15360,98,18816,34176
train,4081,34,34816,504,96768,131584
train,4082,37,37888,596,114432,152320
train,4083,29,29696,366,70272,99968
train,4084,21,21504,192,36864,58368
train,4085,53,54272,1224,235008,289280
train,4086,37,37888,596,114432,152320
train,4087,29,29696,366,70272,99968
train,4088,29,29696,366,70272,99968
train,4089,11,11264,53,10176,21440
train,4090,12,12288,63,12096,24384
train,4091,24,24576,251,48192,72768
train,4092,22,22528,211,40512,63040
train,4093,8,8192,28,5376,13568
train,4094,33,33792,474,91008,124800
train,4095,28,28672,342,65664,94336
train,4096,8,8192,28,5376,13568
train,4097,14,14336,85,16320,30656
train,4098,30,30720,392,75264,105984
train,4099,40,40960,697,133824,174784
train,4100,34,34816,504,96768,131584
train,4101,38,38912,629,120768,159680
train,4102,3,3072,4,768,3840
train,4103,24,24576,251,48192,72768
train,4104,35,35840,534,102528,138368
train,4105,17,17408,126,24192,41600
train,4106,2,2048,2,384,2432
train,4107,21,21504,192,36864,58368
train,4108,13,13312,74,14208,27520
train,4109,47,48128,962,184704,232832
train,4110,27,27648,318,61056,88704
train,4111,34,34816,504,96768,131584
train,4112,28,28672,342,65664,94336
train,4113,30,30720,392,75264,105984
train,4114,8,8192,28,5376,13568
train,4115,17,17408,126,24192,41600
train,4116,33,33792,474,91008,124800
train,4117,12,12288,63,12096,24384
train,4118,41,41984,732,140544,182528
train,4119,27,27648,318,61056,88704
train,4120,11,11264,53,10176,21440
train,4121,25,25600,272,52224,77824
train,4122,40,40960,697,133824,174784
train,4123,20,20480,174,33408,53888
train,4124,19,19456,157,30144,49600
train,4125,37,37888,596,114432,152320
train,4126,14,14336,85,16320,30656
train,4127,9,9216,35,6720,15936
train,4128,30,30720,392,75264,105984
train,4129,43,44032,805,154560,198592
train,4130,41,41984,732,140544,182528
train,4131,30,30720,392,75264,105984
train,4132,13,13312,74,14208,27520
train,4133,18,18432,141,27072,45504
train,4134,26,26624,295,56640,83264
train,4135,12,12288,63,12096,24384
train,4136,28,28672,342,65664,94336
train,4137,35,35840,534,102528,138368
train,4138,26,26624,295,56640,83264
train,4139,42,43008,768,147456,190464
train,4140,11,11264,53,10176,21440
train,4141,19,19456,157,30144,49600
train,4142,32,32768,446,85632,118400
train,4143,42,43008,768,147456,190464
train,4144,9,9216,35,6720,15936
train,4145,40,40960,697,133824,174784
train,4146,11,11264,53,10176,21440
train,4147,46,47104,922,177024,224128
train,4148,28,28672,342,65664,94336
train,4149,10,10240,44,8448,18688
train,4150,29,29696,366,70272,99968
train,4151,26,26624,295,56640,83264
train,4152,31,31744,419,80448,112192
train,4153,32,32768,446,85632,118400
train,4154,40,40960,697,133824,174784
train,4155,24,24576,251,48192,72768
train,4156,18,18432,141,27072,45504
train,4157,5,5120,11,2112,7232
train,4158,9,9216,35,6720,15936
train,4159,18,18432,141,27072,45504
train,4160,12,12288,63,12096,24384
train,4161,23,23552,230,44160,67712
train,4162,17,17408,126,24192,41600
train,4163,42,43008,768,147456,190464
train,4164,24,24576,251,48192,72768
train,4165,13,13312,74,14208,27520
train,4166,14,14336,85,16320,30656
train,4167,17,17408,126,24192,41600
train,4168,24,24576,251,48192,72768
train,4169,29,29696,366,70272,99968
train,4170,31,31744,419,80448,112192
train,4171,15,15360,98,18816,34176
train,4172,36,36864,565,108480,145344
train,4173,28,28672,342,65664,94336
train,4174,30,30720,392,75264,105984
train,4175,29,29696,366,70272,99968
train,4176,36,36864,565,108480,145344
train,4177,17,17408,126,24192,41600
train,4178,30,30720,392,75264,105984
train,4179,23,23552,230,44160,67712
train,4180,22,22528,211,40512,63040
train,4181,31,31744,419,80448,112192
train,4182,19,19456,157,30144,49600
train,4183,15,15360,98,18816,34176
train,4184,12,12288,63,12096,24384
train,4185,30,30720,392,75264,105984
train,4186,31,31744,419,80448,112192
train,4187,15,15360,98,18816,34176
train,4188,17,17408,126,24192,41600
train,4189,36,36864,565,108480,145344
train,4190,37,37888,596,114432,152320
train,4191,25,25600,272,52224,77824
train,4192,20,20480,174,33408,53888
train,4193,33,33792,474,91008,124800
train,4194,33,33792,474,91008,124800
train,4195,14,14336,85,16320,30656
train,4196,22,22528,211,40512,63040
train,4197,34,34816,504,96768,131584
train,4198,44,45056,843,161856,206912
train,4199,17,17408,126,24192,41600
train,4200,10,10240,44,8448,18688
train,4201,23,23552,230,44160,67712
train,4202,17,17408,126,24192,41600
train,4203,27,27648,318,61056,88704
train,4204,34,34816,504,96768,131584
train,4205,13,13312,74,14208,27520
train,4206,14,14336,85,16320,30656
train,4207,30,30720,392,75264,105984
train,4208,51,52224,1133,217536,269760
train,4209,14,14336,85,16320,30656
train,4210,43,44032,805,154560,198592
train,4211,11,11264,53,10176,21440
train,4212,36,36864,565,108480,145344
train,4213,21,21504,192,36864,58368
train,4214,29,29696,366,70272,99968
train,4215,10,10240,44,8448,18688
train,4216,28,28672,342,65664,94336
train,4217,34,34816,504,96768,131584
train,4218,6,6144,16,3072,9216
train,4219,41,41984,732,140544,182528
train,4220,30,30720,392,75264,105984
train,4221,7,7168,21,4032,11200
train,4222,25,25600,272,52224,77824
train,4223,39,39936,663,127296,167232
train,4224,23,23552,230,44160,67712
train,4225,10,10240,44,8448,18688
train,4226,45,46080,882,169344,215424
train,4227,9,9216,35,6720,15936
train,4228,17,17408,126,24192,41600
train,4229,33,33792,474,91008,124800
train,4230,29,29696,366,70272,99968
train,4231,22,22528,211,40512,63040
train,4232,16,16384,112,21504,37888
train,4233,17,17408,126,24192,41600
train,4234,18,18432,141,27072,45504
train,4235,36,36864,565,108480,145344
train,4236,19,19456,157,30144,49600
train,4237,15,15360,98,18816,34176
train,4238,24,24576,251,48192,72768
train,4239,39,39936,663,127296,167232
train,4240,18,18432,141,27072,45504
train,4241,7,7168,21,4032,11200
train,4242,13,13312,74,14208,27520
train,4243,15,15360,98,18816,34176
train,4244,21,21504,192,36864,58368
train,4245,4,4096,7,1344,5440
train,4246,27,27648,318,61056,88704
train,4247,30,30720,392,75264,105984
train,4248,6,6144,16,3072,9216
train,4249,18,18432,141,27072,45504
train,4250,26,26624,295,56640,83264
train,4251,16,16384,112,21504,37888
train,4252,24,24576,251,48192,72768
train,4253,14,14336,85,16320,30656
train,4254,6,6144,16,3072,9216
train,4255,11,11264,53,10176,21440
train,4256,24,24576,251,48192,72768
train,4257,18,18432,141,27072,45504
train,4258,29,29696,366,70272,99968
train,4259,36,36864,565,108480,145344
train,4260,8,8192,28,5376,13568
train,4261,13,13312,74,14208,27520
train,4262,10,10240,44,8448,18688
train,4263,15,15360,98,18816,34176
train,4264,9,9216,35,6720,15936
train,4265,19,19456,157,30144,49600
train,4266,15,15360,98,18816,34176
train,4267,9,9216,35,6720,15936
train,4268,17,17408,126,24192,41600
train,4269,22,22528,211,40512,63040
train,4270,23,23552,230,44160,67712
train,4271,41,41984,732,140544,182528
train,4272,13,13312,74,14208,27520
train,4273,23,23552,230,44160,67712
train,4274,21,21504,192,36864,58368
train,4275,12,12288,63,12096,24384
train,4276,30,30720,392,75264,105984
train,4277,15,15360,98,18816,34176
train,4278,44,45056,843,161856,206912
train,4279,19,19456,157,30144,49600
train,4280,14,14336,85,16320,30656
train,4281,24,24576,251,48192,72768
train,4282,3,3072,4,768,3840
train,4283,32,32768,446,85632,118400
train,4284,19,19456,157,30144,49600
train,4285,20,20480,174,33408,53888
train,4286,17,17408,126,24192,41600
train,4287,30,30720,392,75264,105984
train,4288,19,19456,157,30144,49600
train,4289,14,14336,85,16320,30656
train,4290,24,24576,251,48192,72768
train,4291,9,9216,35,6720,15936
train,4292,3,3072,4,768,3840
train,4293,29,29696,366,70272,99968
train,4294,35,35840,534,102528,138368
train,4295,7,7168,21,4032,11200
train,4296,20,20480,174,33408,53888
train,4297,11,11264,53,10176,21440
train,4298,28,28672,342,65664,94336
train,4299,17,17408,126,24192,41600
train,4300,2,2048,2,384,2432
train,4301,21,21504,192,36864,58368
train,4302,39,39936,663,127296,167232
train,4303,23,23552,230,44160,67712
train,4304,14,14336,85,16320,30656
train,4305,24,24576,251,48192,72768
train,4306,47,48128,962,184704,232832
train,4307,6,6144,16,3072,9216
train,4308,13,13312,74,14208,27520
train,4309,46,47104,922,177024,224128
train,4310,25,25600,272,52224,77824
train,4311,31,31744,419,80448,112192
train,4312,32,32768,446,85632,118400
train,4313,16,16384,112,21504,37888
train,4314,27,27648,318,61056,88704
train,4315,29,29696,366,70272,99968
train,4316,16,16384,112,21504,37888
train,4317,15,15360,98,18816,34176
train,4318,15,15360,98,18816,34176
train,4319,24,24576,251,48192,72768
train,4320,34,34816,504,96768,131584
train,4321,15,15360,98,18816,34176
train,4322,5,5120,11,2112,7232
train,4323,19,19456,157,30144,49600
train,4324,18,18432,141,27072,45504
train,4325,7,7168,21,4032,11200
train,4326,11,11264,53,10176,21440
train,4327,13,13312,74,14208,27520
train,4328,35,35840,534,102528,138368
train,4329,27,27648,318,61056,88704
train,4330,8,8192,28,5376,13568
train,4331,22,22528,211,40512,63040
train,4332,41,41984,732,140544,182528
train,4333,33,33792,474,91008,124800
train,4334,8,8192,28,5376,13568
train,4335,18,18432,141,27072,45504
train,4336,6,6144,16,3072,9216
train,4337,38,38912,629,120768,159680
train,4338,37,37888,596,114432,152320
train,4339,35,35840,534,102528,138368
train,4340,11,11264,53,10176,21440
train,4341,19,19456,157,30144,49600
train,4342,28,28672,342,65664,94336
train,4343,9,9216,35,6720,15936
train,4344,33,33792,474,91008,124800
train,4345,8,8192,28,5376,13568
train,4346,31,31744,419,80448,112192
train,4347,22,22528,211,40512,63040
train,4348,52,53248,1178,226176,279424
train,4349,18,18432,141,27072,45504
train,4350,37,37888,596,114432,152320
train,4351,26,26624,295,56640,83264
train,4352,19,19456,157,30144,49600
train,4353,35,35840,534,102528,138368
train,4354,49,50176,1046,200832,251008
train,4355,16,16384,112,21504,37888
train,4356,14,14336,85,16320,30656
train,4357,32,32768,446,85632,118400
train,4358,21,21504,192,36864,58368
train,4359,26,26624,295,56640,83264
train,4360,30,30720,392,75264,105984
train,4361,9,9216,35,6720,15936
train,4362,15,15360,98,18816,34176
train,4363,27,27648,318,61056,88704
train,4364,26,26624,295,56640,83264
train,4365,12,12288,63,12096,24384
train,4366,23,23552,230,44160,67712
train,4367,8,8192,28,5376,13568
train,4368,42,43008,768,147456,190464
train,4369,17,17408,126,24192,41600
train,4370,2,2048,2,384,2432
train,4371,18,18432,141,27072,45504
train,4372,6,6144,16,3072,9216
train,4373,34,34816,504,96768,131584
train,4374,13,13312,74,14208,27520
train,4375,31,31744,419,80448,112192
train,4376,28,28672,342,65664,94336
train,4377,29,29696,366,70272,99968
train,4378,28,28672,342,65664,94336
train,4379,7,7168,21,4032,11200
train,4380,28,28672,342,65664,94336
train,4381,7,7168,21,4032,11200
train,4382,15,15360,98,18816,34176
train,4383,13,13312,74,14208,27520
train,4384,24,24576,251,48192,72768
train,4385,25,25600,272,52224,77824
train,4386,25,25600,272,52224,77824
train,4387,30,30720,392,75264,105984
train,4388,7,7168,21,4032,11200
train,4389,20,20480,174,33408,53888
train,4390,29,29696,366,70272,99968
train,4391,44,45056,843,161856,206912
train,4392,36,36864,565,108480,145344
train,4393,23,23552,230,44160,67712
train,4394,29,29696,366,70272,99968
train,4395,13,13312,74,14208,27520
train,4396,15,15360,98,18816,34176
train,4397,20,20480,174,33408,53888
train,4398,31,31744,419,80448,112192
train,4399,39,39936,663,127296,167232
train,4400,29,29696,366,70272,99968
train,4401,15,15360,98,18816,34176
train,4402,13,13312,74,14208,27520
train,4403,4,4096,7,1344,5440
train,4404,37,37888,596,114432,152320
train,4405,11,11264,53,10176,21440
train,4406,31,31744,419,80448,112192
train,4407,14,14336,85,16320,30656
train,4408,34,34816,504,96768,131584
train,4409,17,17408,126,24192,41600
train,4410,19,19456,157,30144,49600
train,4411,18,18432,141,27072,45504
train,4412,25,25600,272,52224,77824
train,4413,19,19456,157,30144,49600
train,4414,17,17408,126,24192,41600
train,4415,37,37888,596,114432,152320
train,4416,18,18432,141,27072,45504
train,4417,27,27648,318,61056,88704
train,4418,9,9216,35,6720,15936
train,4419,9,9216,35,6720,15936
train,4420,48,49152,1004,192768,241920
train,4421,45,46080,882,169344,215424
train,4422,37,37888,596,114432,152320
train,4423,27,27648,318,61056,88704
train,4424,12,12288,63,12096,24384
train,4425,17,17408,126,24192,41600
train,4426,28,28672,342,65664,94336
train,4427,13,13312,74,14208,27520
train,4428,15,15360,98,18816,34176
train,4429,19,19456,157,30144,49600
train,4430,17,17408,126,24192,41600
train,4431,24,24576,251,48192,72768
train,4432,30,30720,392,75264,105984
train,4433,23,23552,230,44160,67712
train,4434,14,14336,85,16320,30656
train,4435,20,20480,174,33408,53888
train,4436,12,12288,63,12096,24384
train,4437,30,30720,392,75264,105984
train,4438,23,23552,230,44160,67712
train,4439,20,20480,174,33408,53888
train,4440,58,59392,1465,281280,340672
train,4441,19,19456,157,30144,49600
train,4442,19,19456,157,30144,49600
train,4443,33,33792,474,91008,124800
train,4444,25,25600,272,52224,77824
train,4445,33,33792,474,91008,124800
train,4446,24,24576,251,48192,72768
train,4447,25,25600,272,52224,77824
train,4448,8,8192,28,5376,13568
train,4449,45,46080,882,169344,215424
train,4450,15,15360,98,18816,34176
train,4451,27,27648,318,61056,88704
train,4452,23,23552,230,44160,67712
train,4453,25,25600,272,52224,77824
train,4454,14,14336,85,16320,30656
train,4455,48,49152,1004,192768,241920
train,4456,24,24576,251,48192,72768
train,4457,23,23552,230,44160,67712
train,4458,28,28672,342,65664,94336
train,4459,23,23552,230,44160,67712
train,4460,19,19456,157,30144,49600
train,4461,56,57344,1366,262272,319616
train,4462,20,20480,174,33408,53888
train,4463,25,25600,272,52224,77824
train,4464,14,14336,85,16320,30656
train,4465,8,8192,28,5376,13568
train,4466,32,32768,446,85632,118400
train,4467,33,33792,474,91008,124800
train,4468,17,17408,126,24192,41600
train,4469,25,25600,272,52224,77824
train,4470,25,25600,272,52224,77824
train,4471,25,25600,272,52224,77824
train,4472,12,12288,63,12096,24384
train,4473,22,22528,211,40512,63040
train,4474,10,10240,44,8448,18688
train,4475,18,18432,141,27072,45504
train,4476,31,31744,419,80448,112192
train,4477,10,10240,44,8448,18688
train,4478,27,27648,318,61056,88704
train,4479,20,20480,174,33408,53888
train,4480,10,10240,44,8448,18688
train,4481,14,14336,85,16320,30656
train,4482,34,34816,504,96768,131584
train,4483,12,12288,63,12096,24384
train,4484,11,11264,53,10176,21440
train,4485,23,23552,230,44160,67712
train,4486,23,23552,230,44160,67712
train,4487,32,32768,446,85632,118400
train,4488,17,17408,126,24192,41600
train,4489,27,27648,318,61056,88704
train,4490,33,33792,474,91008,124800
train,4491,12,12288,63,12096,24384
train,4492,24,24576,251,48192,72768
train,4493,18,18432,141,27072,45504
train,4494,8,8192,28,5376,13568
train,4495,24,24576,251,48192,72768
train,4496,21,21504,192,36864,58368
train,4497,21,21504,192,36864,58368
train,4498,36,36864,565,108480,145344
train,4499,25,25600,272,52224,77824
train,4500,17,17408,126,24192,41600
train,4501,24,24576,251,48192,72768
train,4502,4,4096,7,1344,5440
train,4503,40,40960,697,133824,174784
train,4504,9,9216,35,6720,15936
train,4505,27,27648,318,61056,88704
train,4506,5,5120,11,2112,7232
train,4507,14,14336,85,16320,30656
train,4508,16,16384,112,21504,37888
train,4509,17,17408,126,24192,41600
train,4510,5,5120,11,2112,7232
train,4511,32,32768,446,85632,118400
train,4512,43,44032,805,154560,198592
train,4513,18,18432,141,27072,45504
train,4514,25,25600,272,52224,77824
train,4515,7,7168,21,4032,11200
train,4516,7,7168,21,4032,11200
train,4517,17,17408,126,24192,41600
train,4518,12,12288,63,12096,24384
train,4519,31,31744,419,80448,112192
train,4520,45,46080,882,169344,215424
train,4521,30,30720,392,75264,105984
train,4522,19,19456,157,30144,49600
train,4523,30,30720,392,75264,105984
train,4524,27,27648,318,61056,88704
train,4525,18,18432,141,27072,45504
train,4526,21,21504,192,36864,58368
train,4527,21,21504,192,36864,58368
train,4528,39,39936,663,127296,167232
train,4529,7,7168,21,4032,11200
train,4530,25,25600,272,52224,77824
train,4531,16,16384,112,21504,37888
train,4532,34,34816,504,96768,131584
train,4533,20,20480,174,33408,53888
train,4534,37,37888,596,114432,152320
train,4535,9,9216,35,6720,15936
train,4536,5,5120,11,2112,7232
train,4537,8,8192,28,5376,13568
train,4538,16,16384,112,21504,37888
train,4539,25,25600,272,52224,77824
train,4540,19,19456,157,30144,49600
train,4541,28,28672,342,65664,94336
train,4542,49,50176,1046,200832,251008
train,4543,17,17408,126,24192,41600
train,4544,26,26624,295,56640,83264
train,4545,14,14336,85,16320,30656
train,4546,26,26624,295,56640,83264
train,4547,29,29696,366,70272,99968
train,4548,26,26624,295,56640,83264
train,4549,25,25600,272,52224,77824
train,4550,19,19456,157,30144,49600
train,4551,43,44032,805,154560,198592
train,4552,15,15360,98,18816,34176
train,4553,28,28672,342,65664,94336
train,4554,18,18432,141,27072,45504
train,4555,35,35840,534,102528,138368
train,4556,25,25600,272,52224,77824
train,4557,25,25600,272,52224,77824
train,4558,38,38912,629,120768,159680
train,4559,13,13312,74,14208,27520
train,4560,34,34816,504,96768,131584
train,4561,18,18432,141,27072,45504
train,4562,35,35840,534,102528,138368
train,4563,3,3072,4,768,3840
train,4564,37,37888,596,114432,152320
train,4565,7,7168,21,4032,11200
train,4566,29,29696,366,70272,99968
train,4567,26,26624,295,56640,83264
train,4568,25,25600,272,52224,77824
train,4569,26,26624,295,56640,83264
train,4570,31,31744,419,80448,112192
train,4571,14,14336,85,16320,30656
train,4572,20,20480,174,33408,53888
train,4573,21,21504,192,36864,58368
train,4574,29,29696,366,70272,99968
train,4575,33,33792,474,91008,124800
train,4576,23,23552,230,44160,67712
train,4577,32,32768,446,85632,118400
train,4578,41,41984,732,140544,182528
train,4579,25,25600,272,52224,77824
train,4580,13,13312,74,14208,27520
train,4581,34,34816,504,96768,131584
train,4582,21,21504,192,36864,58368
train,4583,17,17408,126,24192,41600
train,4584,22,22528,211,40512,63040
train,4585,27,27648,318,61056,88704
train,4586,11,11264,53,10176,21440
train,4587,34,34816,504,96768,131584
train,4588,38,38912,629,120768,159680
train,4589,32,32768,446,85632,118400
train,4590,22,22528,211,40512,63040
train,4591,8,8192,28,5376,13568
train,4592,9,9216,35,6720,15936
train,4593,29,29696,366,70272,99968
train,4594,26,26624,295,56640,83264
train,4595,17,17408,126,24192,41600
train,4596,11,11264,53,10176,21440
train,4597,21,21504,192,36864,58368
train,4598,4,4096,7,1344,5440
train,4599,9,9216,35,6720,15936
train,4600,35,35840,534,102528,138368
train,4601,5,5120,11,2112,7232
train,4602,37,37888,596,114432,152320
train,4603,14,14336,85,16320,30656
train,4604,18,18432,141,27072,45504
train,4605,10,10240,44,8448,18688
train,4606,23,23552,230,44160,67712
train,4607,34,34816,504,96768,131584
train,4608,37,37888,596,114432,152320
train,4609,4,4096,7,1344,5440
train,4610,25,25600,272,52224,77824
train,4611,7,7168,21,4032,11200
train,4612,21,21504,192,36864,58368
train,4613,35,35840,534,102528,138368
train,4614,16,16384,112,21504,37888
train,4615,21,21504,192,36864,58368
train,4616,24,24576,251,48192,72768
train,4617,39,39936,663,127296,167232
train,4618,22,22528,211,40512,63040
train,4619,26,26624,295,56640,83264
train,4620,31,31744,419,80448,112192
train,4621,12,12288,63,12096,24384
train,4622,18,18432,141,27072,45504
train,4623,6,6144,16,3072,9216
train,4624,40,40960,697,133824,174784
train,4625,31,31744,419,80448,112192
train,4626,24,24576,251,48192,72768
train,4627,19,19456,157,30144,49600
train,4628,35,35840,534,102528,138368
train,4629,40,40960,697,133824,174784
train,4630,20,20480,174,33408,53888
train,4631,30,30720,392,75264,105984
train,4632,41,41984,732,140544,182528
train,4633,24,24576,251,48192,72768
train,4634,22,22528,211,40512,63040
train,4635,15,15360,98,18816,34176
train,4636,29,29696,366,70272,99968
train,4637,13,13312,74,14208,27520
train,4638,7,7168,21,4032,11200
train,4639,37,37888,596,114432,152320
train,4640,8,8192,28,5376,13568
train,4641,23,23552,230,44160,67712
train,4642,8,8192,28,5376,13568
train,4643,25,25600,272,52224,77824
train,4644,7,7168,21,4032,11200
train,4645,25,25600,272,52224,77824
train,4646,16,16384,112,21504,37888
train,4647,8,8192,28,5376,13568
train,4648,19,19456,157,30144,49600
train,4649,20,20480,174,33408,53888
train,4650,21,21504,192,36864,58368
train,4651,31,31744,419,80448,112192
train,4652,42,43008,768,147456,190464
train,4653,8,8192,28,5376,13568
train,4654,11,11264,53,10176,21440
train,4655,36,36864,565,108480,145344
train,4656,23,23552,230,44160,67712
train,4657,10,10240,44,8448,18688
train,4658,30,30720,392,75264,105984
train,4659,17,17408,126,24192,41600
train,4660,22,22528,211,40512,63040
train,4661,15,15360,98,18816,34176
train,4662,17,17408,126,24192,41600
train,4663,22,22528,211,40512,63040
train,4664,36,36864,565,108480,145344
train,4665,27,27648,318,61056,88704
train,4666,13,13312,74,14208,27520
train,4667,13,13312,74,14208,27520
train,4668,24,24576,251,48192,72768
train,4669,44,45056,843,161856,206912
train,4670,19,19456,157,30144,49600
train,4671,16,16384,112,21504,37888
train,4672,20,20480,174,33408,53888
train,4673,27,27648,318,61056,88704
train,4674,9,9216,35,6720,15936
train,4675,31,31744,419,80448,112192
train,4676,4,4096,7,1344,5440
train,4677,35,35840,534,102528,138368
train,4678,11,11264,53,10176,21440
train,4679,45,46080,882,169344,215424
train,4680,25,25600,272,52224,77824
train,4681,16,16384,112,21504,37888
train,4682,22,22528,211,40512,63040
train,4683,8,8192,28,5376,13568
train,4684,11,11264,53,10176,21440
train,4685,21,21504,192,36864,58368
train,4686,11,11264,53,10176,21440
train,4687,26,26624,295,56640,83264
train,4688,11,11264,53,10176,21440
train,4689,17,17408,126,24192,41600
train,4690,27,27648,318,61056,88704
train,4691,22,22528,211,40512,63040
train,4692,24,24576,251,48192,72768
train,4693,43,44032,805,154560,198592
train,4694,19,19456,157,30144,49600
train,4695,23,23552,230,44160,67712
train,4696,25,25600,272,52224,77824
train,4697,38,38912,629,120768,159680
train,4698,20,20480,174,33408,53888
train,4699,24,24576,251,48192,72768
train,4700,21,21504,192,36864,58368
train,4701,26,26624,295,56640,83264
train,4702,10,10240,44,8448,18688
train,4703,11,11264,53,10176,21440
train,4704,41,41984,732,140544,182528
train,4705,18,18432,141,27072,45504
train,4706,20,20480,174,33408,53888
train,4707,43,44032,805,154560,198592
train,4708,40,40960,697,133824,174784
train,4709,18,18432,141,27072,45504
train,4710,11,11264,53,10176,21440
train,4711,23,23552,230,44160,67712
train,4712,26,26624,295,56640,83264
train,4713,14,14336,85,16320,30656
train,4714,24,24576,251,48192,72768
train,4715,33,33792,474,91008,124800
train,4716,12,12288,63,12096,24384
train,4717,16,16384,112,21504,37888
train,4718,31,31744,419,80448,112192
train,4719,22,22528,211,40512,63040
train,4720,43,44032,805,154560,198592
train,4721,8,8192,28,5376,13568
train,4722,21,21504,192,36864,58368
train,4723,15,15360,98,18816,34176
train,4724,33,33792,474,91008,124800
train,4725,32,32768,446,85632,118400
train,4726,3,3072,4,768,3840
train,4727,8,8192,28,5376,13568
train,4728,25,25600,272,52224,77824
train,4729,22,22528,211,40512,63040
train,4730,18,18432,141,27072,45504
train,4731,22,22528,211,40512,63040
train,4732,30,30720,392,75264,105984
train,4733,35,35840,534,102528,138368
train,4734,19,19456,157,30144,49600
train,4735,10,10240,44,8448,18688
train,4736,9,9216,35,6720,15936
train,4737,28,28672,342,65664,94336
train,4738,55,56320,1318,253056,309376
train,4739,40,40960,697,133824,174784
train,4740,11,11264,53,10176,21440
train,4741,14,14336,85,16320,30656
train,4742,42,43008,768,147456,190464
train,4743,28,28672,342,65664,94336
train,4744,24,24576,251,48192,72768
train,4745,22,22528,211,40512,63040
train,4746,20,20480,174,33408,53888
train,4747,51,52224,1133,217536,269760
train,4748,23,23552,230,44160,67712
train,4749,36,36864,565,108480,145344
train,4750,42,43008,768,147456,190464
train,4751,12,12288,63,12096,24384
train,4752,16,16384,112,21504,37888
train,4753,8,8192,28,5376,13568
train,4754,23,23552,230,44160,67712
train,4755,44,45056,843,161856,206912
train,4756,22,22528,211,40512,63040
train,4757,42,43008,768,147456,190464
train,4758,17,17408,126,24192,41600
train,4759,16,16384,112,21504,37888
train,4760,22,22528,211,40512,63040
train,4761,31,31744,419,80448,112192
train,4762,14,14336,85,16320,30656
train,4763,15,15360,98,18816,34176
train,4764,24,24576,251,48192,72768
train,4765,37,37888,596,114432,152320
train,4766,22,22528,211,40512,63040
train,4767,22,22528,211,40512,63040
train,4768,23,23552,230,44160,67712
train,4769,42,43008,768,147456,190464
train,4770,20,20480,174,33408,53888
train,4771,13,13312,74,14208,27520
train,4772,9,9216,35,6720,15936
train,4773,47,48128,962,184704,232832
train,4774,16,16384,112,21504,37888
train,4775,41,41984,732,140544,182528
train,4776,34,34816,504,96768,131584
train,4777,18,18432,141,27072,45504
train,4778,13,13312,74,14208,27520
train,4779,19,19456,157,30144,49600
train,4780,11,11264,53,10176,21440
train,4781,16,16384,112,21504,37888
train,4782,13,13312,74,14208,27520
train,4783,14,14336,85,16320,30656
train,4784,17,17408,126,24192,41600
train,4785,13,13312,74,14208,27520
train,4786,14,14336,85,16320,30656
train,4787,25,25600,272,52224,77824
train,4788,53,54272,1224,235008,289280
train,4789,28,28672,342,65664,94336
train,4790,23,23552,230,44160,67712
train,4791,32,32768,446,85632,118400
train,4792,31,31744,419,80448,112192
train,4793,24,24576,251,48192,72768
train,4794,38,38912,629,120768,159680
train,4795,24,24576,251,48192,72768
train,4796,21,21504,192,36864,58368
train,4797,11,11264,53,10176,21440
train,4798,22,22528,211,40512,63040
train,4799,25,25600,272,52224,77824
train,4800,25,25600,272,52224,77824
train,4801,10,10240,44,8448,18688
train,4802,35,35840,534,102528,138368
train,4803,5,5120,11,2112,7232
train,4804,6,6144,16,3072,9216
train,4805,17,17408,126,24192,41600
train,4806,27,27648,318,61056,88704
train,4807,6,6144,16,3072,9216
train,4808,14,14336,85,16320,30656
train,4809,26,26624,295,56640,83264
train,4810,16,16384,112,21504,37888
train,4811,30,30720,392,75264,105984
train,4812,37,37888,596,114432,152320
train,4813,15,15360,98,18816,34176
train,4814,8,8192,28,5376,13568
train,4815,25,25600,272,52224,77824
train,4816,28,28672,342,65664,94336
train,4817,32,32768,446,85632,118400
train,4818,27,27648,318,61056,88704
train,4819,17,17408,126,24192,41600
train,4820,12,12288,63,12096,24384
train,4821,27,27648,318,61056,88704
train,4822,24,24576,251,48192,72768
train,4823,36,36864,565,108480,145344
train,4824,11,11264,53,10176,21440
train,4825,37,37888,596,114432,152320
train,4826,19,19456,157,30144,49600
train,4827,21,21504,192,36864,58368
train,4828,25,25600,272,52224,77824
train,4829,52,53248,1178,226176,279424
train,4830,18,18432,141,27072,45504
train,4831,27,27648,318,61056,88704
train,4832,35,35840,534,102528,138368
train,4833,15,15360,98,18816,34176
train,4834,21,21504,192,36864,58368
train,4835,7,7168,21,4032,11200
train,4836,16,16384,112,21504,37888
train,4837,25,25600,272,52224,77824
train,4838,15,15360,98,18816,34176
train,4839,16,16384,112,21504,37888
train,4840,8,8192,28,5376,13568
train,4841,7,7168,21,4032,11200
train,4842,15,15360,98,18816,34176
train,4843,25,25600,272,52224,77824
train,4844,23,23552,230,44160,67712
train,4845,30,30720,392,75264,105984
train,4846,36,36864,565,108480,145344
train,4847,20,20480,174,33408,53888
train,4848,23,23552,230,44160,67712
train,4849,15,15360,98,18816,34176
train,4850,36,36864,565,108480,145344
train,4851,16,16384,112,21504,37888
train,4852,29,29696,366,70272,99968
train,4853,48,49152,1004,192768,241920
train,4854,23,23552,230,44160,67712
train,4855,18,18432,141,27072,45504
train,4856,32,32768,446,85632,118400
train,4857,17,17408,126,24192,41600
train,4858,31,31744,419,80448,112192
train,4859,11,11264,53,10176,21440
train,4860,14,14336,85,16320,30656
train,4861,14,14336,85,16320,30656
train,4862,28,28672,342,65664,94336
train,4863,16,16384,112,21504,37888
train,4864,19,19456,157,30144,49600
train,4865,25,25600,272,52224,77824
train,4866,10,10240,44,8448,18688
train,4867,39,39936,663,127296,167232
train,4868,20,20480,174,33408,53888
train,4869,52,53248,1178,226176,279424
train,4870,31,31744,419,80448,112192
train,4871,13,13312,74,14208,27520
train,4872,12,12288,63,12096,24384
train,4873,27,27648,318,61056,88704
train,4874,11,11264,53,10176,21440
train,4875,9,9216,35,6720,15936
train,4876,24,24576,251,48192,72768
train,4877,17,17408,126,24192,41600
train,4878,14,14336,85,16320,30656
train,4879,23,23552,230,44160,67712
train,4880,32,32768,446,85632,118400
train,4881,27,27648,318,61056,88704
train,4882,19,19456,157,30144,49600
train,4883,40,40960,697,133824,174784
train,4884,18,18432,141,27072,45504
train,4885,6,6144,16,3072,9216
train,4886,24,24576,251,48192,72768
train,4887,14,14336,85,16320,30656
train,4888,22,22528,211,40512,63040
train,4889,25,25600,272,52224,77824
train,4890,8,8192,28,5376,13568
train,4891,25,25600,272,52224,77824
train,4892,27,27648,318,61056,88704
train,4893,7,7168,21,4032,11200
train,4894,33,33792,474,91008,124800
train,4895,33,33792,474,91008,124800
train,4896,15,15360,98,18816,34176
train,4897,24,24576,251,48192,72768
train,4898,34,34816,504,96768,131584
train,4899,40,40960,697,133824,174784
train,4900,30,30720,392,75264,105984
train,4901,20,20480,174,33408,53888
train,4902,18,18432,141,27072,45504
train,4903,16,16384,112,21504,37888
train,4904,13,13312,74,14208,27520
train,4905,10,10240,44,8448,18688
train,4906,27,27648,318,61056,88704
train,4907,16,16384,112,21504,37888
train,4908,30,30720,392,75264,105984
train,4909,43,44032,805,154560,198592
train,4910,26,26624,295,56640,83264
train,4911,22,22528,211,40512,63040
train,4912,38,38912,629,120768,159680
train,4913,48,49152,1004,192768,241920
train,4914,6,6144,16,3072,9216
train,4915,27,27648,318,61056,88704
train,4916,9,9216,35,6720,15936
train,4917,4,4096,7,1344,5440
train,4918,29,29696,366,70272,99968
train,4919,26,26624,295,56640,83264
train,4920,56,57344,1366,262272,319616
train,4921,28,28672,342,65664,94336
train,4922,27,27648,318,61056,88704
train,4923,25,25600,272,52224,77824
train,4924,39,39936,663,127296,167232
train,4925,16,16384,112,21504,37888
train,4926,8,8192,28,5376,13568
train,4927,39,39936,663,127296,167232
train,4928,20,20480,174,33408,53888
train,4929,16,16384,112,21504,37888
train,4930,17,17408,126,24192,41600
train,4931,31,31744,419,80448,112192
train,4932,9,9216,35,6720,15936
train,4933,23,23552,230,44160,67712
train,4934,11,11264,53,10176,21440
train,4935,17,17408,126,24192,41600
train,4936,34,34816,504,96768,131584
train,4937,3,3072,4,768,3840
train,4938,12,12288,63,12096,24384
train,4939,22,22528,211,40512,63040
train,4940,19,19456,157,30144,49600
train,4941,33,33792,474,91008,124800
train,4942,18,18432,141,27072,45504
train,4943,33,33792,474,91008,124800
train,4944,20,20480,174,33408,53888
train,4945,21,21504,192,36864,58368
train,4946,23,23552,230,44160,67712
train,4947,18,18432,141,27072,45504
train,4948,21,21504,192,36864,58368
train,4949,19,19456,157,30144,49600
train,4950,29,29696,366,70272,99968
train,4951,9,9216,35,6720,15936
train,4952,14,14336,85,16320,30656
train,4953,14,14336,85,16320,30656
train,4954,21,21504,192,36864,58368
train,4955,13,13312,74,14208,27520
train,4956,25,25600,272,52224,77824
train,4957,24,24576,251,48192,72768
train,4958,25,25600,272,52224,77824
train,4959,7,7168,21,4032,11200
train,4960,8,8192,28,5376,13568
train,4961,10,10240,44,8448,18688
train,4962,23,23552,230,44160,67712
train,4963,30,30720,392,75264,105984
train,4964,26,26624,295,56640,83264
train,4965,25,25600,272,52224,77824
train,4966,21,21504,192,36864,58368
train,4967,31,31744,419,80448,112192
train,4968,26,26624,295,56640,83264
train,4969,25,25600,272,52224,77824
train,4970,42,43008,768,147456,190464
train,4971,20,20480,174,33408,53888
train,4972,29,29696,366,70272,99968
train,4973,34,34816,504,96768,131584
train,4974,23,23552,230,44160,67712
train,4975,8,8192,28,5376,13568
train,4976,36,36864,565,108480,145344
train,4977,17,17408,126,24192,41600
train,4978,19,19456,157,30144,49600
train,4979,22,22528,211,40512,63040
train,4980,30,30720,392,75264,105984
train,4981,10,10240,44,8448,18688
train,4982,32,32768,446,85632,118400
train,4983,7,7168,21,4032,11200
train,4984,16,16384,112,21504,37888
train,4985,18,18432,141,27072,45504
train,4986,19,19456,157,30144,49600
train,4987,31,31744,419,80448,112192
train,4988,31,31744,419,80448,112192
train,4989,17,17408,126,24192,41600
train,4990,30,30720,392,75264,105984
train,4991,26,26624,295,56640,83264
train,4992,20,20480,174,33408,53888
train,4993,39,39936,663,127296,167232
train,4994,18,18432,141,27072,45504
train,4995,29,29696,366,70272,99968
train,4996,24,24576,251,48192,72768
train,4997,29,29696,366,70272,99968
train,4998,12,12288,63,12096,24384
train,4999,49,50176,1046,200832,251008
train,5000,39,39936,663,127296,167232
train,5001,4,4096,7,1344,5440
train,5002,26,26624,295,56640,83264
train,5003,12,12288,63,12096,24384
train,5004,16,16384,112,21504,37888
train,5005,41,41984,732,140544,182528
train,5006,6,6144,16,3072,9216
train,5007,6,6144,16,3072,9216
train,5008,31,31744,419,80448,112192
train,5009,11,11264,53,10176,21440
train,5010,30,30720,392,75264,105984
train,5011,13,13312,74,14208,27520
train,5012,21,21504,192,36864,58368
train,5013,32,32768,446,85632,118400
train,5014,15,15360,98,18816,34176
train,5015,19,19456,157,30144,49600
train,5016,9,9216,35,6720,15936
train,5017,6,6144,16,3072,9216
train,5018,18,18432,141,27072,45504
train,5019,32,32768,446,85632,118400
train,5020,10,10240,44,8448,18688
train,5021,37,37888,596,114432,152320
train,5022,30,30720,392,75264,105984
train,5023,26,26624,295,56640,83264
train,5024,16,16384,112,21504,37888
train,5025,16,16384,112,21504,37888
train,5026,30,30720,392,75264,105984
train,5027,9,9216,35,6720,15936
train,5028,19,19456,157,30144,49600
train,5029,19,19456,157,30144,49600
train,5030,21,21504,192,36864,58368
train,5031,21,21504,192,36864,58368
train,5032,21,21504,192,36864,58368
train,5033,13,13312,74,14208,27520
train,5034,46,47104,922,177024,224128
train,5035,32,32768,446,85632,118400
train,5036,22,22528,211,40512,63040
train,5037,29,29696,366,70272,99968
train,5038,9,9216,35,6720,15936
train,5039,18,18432,141,27072,45504
train,5040,31,31744,419,80448,112192
train,5041,28,28672,342,65664,94336
train,5042,24,24576,251,48192,72768
train,5043,51,52224,1133,217536,269760
train,5044,8,8192,28,5376,13568
train,5045,33,33792,474,91008,124800
train,5046,39,39936,663,127296,167232
train,5047,8,8192,28,5376,13568
train,5048,15,15360,98,18816,34176
train,5049,14,14336,85,16320,30656
train,5050,6,6144,16,3072,9216
train,5051,23,23552,230,44160,67712
train,5052,16,16384,112,21504,37888
train,5053,14,14336,85,16320,30656
train,5054,23,23552,230,44160,67712
train,5055,28,28672,342,65664,94336
train,5056,44,45056,843,161856,206912
train,5057,38,38912,629,120768,159680
train,5058,18,18432,141,27072,45504
train,5059,21,21504,192,36864,58368
train,5060,15,15360,98,18816,34176
train,5061,42,43008,768,147456,190464
train,5062,29,29696,366,70272,99968
train,5063,12,12288,63,12096,24384
train,5064,53,54272,1224,235008,289280
train,5065,31,31744,419,80448,112192
train,5066,15,15360,98,18816,34176
train,5067,33,33792,474,91008,124800
train,5068,17,17408,126,24192,41600
train,5069,21,21504,192,36864,58368
train,5070,21,21504,192,36864,58368
train,5071,32,32768,446,85632,118400
train,5072,26,26624,295,56640,83264
train,5073,31,31744,419,80448,112192
train,5074,8,8192,28,5376,13568
train,5075,20,20480,174,33408,53888
train,5076,17,17408,126,24192,41600
train,5077,15,15360,98,18816,34176
train,5078,24,24576,251,48192,72768
train,5079,33,33792,474,91008,124800
train,5080,14,14336,85,16320,30656
train,5081,8,8192,28,5376,13568
train,5082,15,15360,98,18816,34176
train,5083,37,37888,596,114432,152320
train,5084,28,28672,342,65664,94336
train,5085,31,31744,419,80448,112192
train,5086,10,10240,44,8448,18688
train,5087,20,20480,174,33408,53888
train,5088,27,27648,318,61056,88704
train,5089,21,21504,192,36864,58368
train,5090,37,37888,596,114432,152320
train,5091,32,32768,446,85632,118400
train,5092,6,6144,16,3072,9216
train,5093,21,21504,192,36864,58368
train,5094,15,15360,98,18816,34176
train,5095,11,11264,53,10176,21440
train,5096,31,31744,419,80448,112192
train,5097,26,26624,295,56640,83264
train,5098,17,17408,126,24192,41600
train,5099,25,25600,272,52224,77824
train,5100,8,8192,28,5376,13568
train,5101,35,35840,534,102528,138368
train,5102,12,12288,63,12096,24384
train,5103,14,14336,85,16320,30656
train,5104,7,7168,21,4032,11200
train,5105,13,13312,74,14208,27520
train,5106,23,23552,230,44160,67712
train,5107,37,37888,596,114432,152320
train,5108,21,21504,192,36864,58368
train,5109,50,51200,1089,209088,260288
train,5110,39,39936,663,127296,167232
train,5111,41,41984,732,140544,182528
train,5112,10,10240,44,8448,18688
train,5113,24,24576,251,48192,72768
train,5114,40,40960,697,133824,174784
train,5115,8,8192,28,5376,13568
train,5116,31,31744,419,80448,112192
train,5117,23,23552,230,44160,67712
train,5118,16,16384,112,21504,37888
train,5119,15,15360,98,18816,34176
train,5120,48,49152,1004,192768,241920
train,5121,45,46080,882,169344,215424
train,5122,24,24576,251,48192,72768
train,5123,17,17408,126,24192,41600
train,5124,11,11264,53,10176,21440
train,5125,10,10240,44,8448,18688
train,5126,22,22528,211,40512,63040
train,5127,12,12288,63,12096,24384
train,5128,33,33792,474,91008,124800
train,5129,20,20480,174,33408,53888
train,5130,22,22528,211,40512,63040
train,5131,25,25600,272,52224,77824
train,5132,8,8192,28,5376,13568
train,5133,31,31744,419,80448,112192
train,5134,44,45056,843,161856,206912
train,5135,15,15360,98,18816,34176
train,5136,22,22528,211,40512,63040
train,5137,13,13312,74,14208,27520
train,5138,23,23552,230,44160,67712
train,5139,10,10240,44,8448,18688
train,5140,20,20480,174,33408,53888
train,5141,10,10240,44,8448,18688
train,5142,35,35840,534,102528,138368
train,5143,14,14336,85,16320,30656
train,5144,23,23552,230,44160,67712
train,5145,38,38912,629,120768,159680
train,5146,19,19456,157,30144,49600
train,5147,28,28672,342,65664,94336
train,5148,23,23552,230,44160,67712
train,5149,50,51200,1089,209088,260288
train,5150,16,16384,112,21504,37888
train,5151,17,17408,126,24192,41600
train,5152,31,31744,419,80448,112192
train,5153,22,22528,211,40512,63040
train,5154,19,19456,157,30144,49600
train,5155,25,25600,272,52224,77824
train,5156,25,25600,272,52224,77824
train,5157,22,22528,211,40512,63040
train,5158,19,19456,157,30144,49600
train,5159,17,17408,126,24192,41600
train,5160,33,33792,474,91008,124800
train,5161,27,27648,318,61056,88704
train,5162,39,39936,663,127296,167232
train,5163,25,25600,272,52224,77824
train,5164,26,26624,295,56640,83264
train,5165,12,12288,63,12096,24384
train,5166,18,18432,141,27072,45504
train,5167,24,24576,251,48192,72768
train,5168,11,11264,53,10176,21440
train,5169,18,18432,141,27072,45504
train,5170,34,34816,504,96768,131584
train,5171,8,8192,28,5376,13568
train,5172,12,12288,63,12096,24384
train,5173,10,10240,44,8448,18688
train,5174,21,21504,192,36864,58368
train,5175,20,20480,174,33408,53888
train,5176,14,14336,85,16320,30656
train,5177,13,13312,74,14208,27520
train,5178,9,9216,35,6720,15936
train,5179,19,19456,157,30144,49600
train,5180,45,46080,882,169344,215424
train,5181,29,29696,366,70272,99968
train,5182,32,32768,446,85632,118400
train,5183,25,25600,272,52224,77824
train,5184,35,35840,534,102528,138368
train,5185,51,52224,1133,217536,269760
train,5186,34,34816,504,96768,131584
train,5187,30,30720,392,75264,105984
train,5188,26,26624,295,56640,83264
train,5189,32,32768,446,85632,118400
train,5190,12,12288,63,12096,24384
train,5191,13,13312,74,14208,27520
train,5192,35,35840,534,102528,138368
train,5193,8,8192,28,5376,13568
train,5194,3,3072,4,768,3840
train,5195,51,52224,1133,217536,269760
train,5196,9,9216,35,6720,15936
train,5197,24,24576,251,48192,72768
train,5198,42,43008,768,147456,190464
train,5199,16,16384,112,21504,37888
train,5200,10,10240,44,8448,18688
train,5201,15,15360,98,18816,34176
train,5202,8,8192,28,5376,13568
train,5203,35,35840,534,102528,138368
train,5204,3,3072,4,768,3840
train,5205,34,34816,504,96768,131584
train,5206,38,38912,629,120768,159680
train,5207,39,39936,663,127296,167232
train,5208,29,29696,366,70272,99968
train,5209,35,35840,534,102528,138368
train,5210,32,32768,446,85632,118400
train,5211,13,13312,74,14208,27520
train,5212,15,15360,98,18816,34176
train,5213,9,9216,35,6720,15936
train,5214,16,16384,112,21504,37888
train,5215,12,12288,63,12096,24384
train,5216,31,31744,419,80448,112192
train,5217,26,26624,295,56640,83264
train,5218,14,14336,85,16320,30656
train,5219,39,39936,663,127296,167232
train,5220,14,14336,85,16320,30656
train,5221,8,8192,28,5376,13568
train,5222,27,27648,318,61056,88704
train,5223,4,4096,7,1344,5440
train,5224,23,23552,230,44160,67712
train,5225,45,46080,882,169344,215424
train,5226,18,18432,141,27072,45504
train,5227,41,41984,732,140544,182528
train,5228,32,32768,446,85632,118400
train,5229,30,30720,392,75264,105984
train,5230,22,22528,211,40512,63040
train,5231,21,21504,192,36864,58368
train,5232,33,33792,474,91008,124800
train,5233,14,14336,85,16320,30656
train,5234,43,44032,805,154560,198592
train,5235,12,12288,63,12096,24384
train,5236,6,6144,16,3072,9216
train,5237,20,20480,174,33408,53888
train,5238,28,28672,342,65664,94336
train,5239,31,31744,419,80448,112192
train,5240,46,47104,922,177024,224128
train,5241,16,16384,112,21504,37888
train,5242,19,19456,157,30144,49600
train,5243,26,26624,295,56640,83264
train,5244,23,23552,230,44160,67712
train,5245,17,17408,126,24192,41600
train,5246,12,12288,63,12096,24384
train,5247,10,10240,44,8448,18688
train,5248,17,17408,126,24192,41600
train,5249,29,29696,366,70272,99968
train,5250,16,16384,112,21504,37888
train,5251,22,22528,211,40512,63040
train,5252,21,21504,192,36864,58368
train,5253,24,24576,251,48192,72768
train,5254,15,15360,98,18816,34176
train,5255,33,33792,474,91008,124800
train,5256,11,11264,53,10176,21440
train,5257,15,15360,98,18816,34176
train,5258,8,8192,28,5376,13568
train,5259,10,10240,44,8448,18688
train,5260,39,39936,663,127296,167232
train,5261,11,11264,53,10176,21440
train,5262,37,37888,596,114432,152320
train,5263,42,43008,768,147456,190464
train,5264,25,25600,272,52224,77824
train,5265,17,17408,126,24192,41600
train,5266,22,22528,211,40512,63040
train,5267,20,20480,174,33408,53888
train,5268,52,53248,1178,226176,279424
train,5269,8,8192,28,5376,13568
train,5270,9,9216,35,6720,15936
train,5271,34,34816,504,96768,131584
train,5272,18,18432,141,27072,45504
train,5273,21,21504,192,36864,58368
train,5274,44,45056,843,161856,206912
train,5275,16,16384,112,21504,37888
train,5276,41,41984,732,140544,182528
train,5277,25,25600,272,52224,77824
train,5278,15,15360,98,18816,34176
train,5279,21,21504,192,36864,58368
train,5280,25,25600,272,52224,77824
train,5281,39,39936,663,127296,167232
train,5282,25,25600,272,52224,77824
train,5283,14,14336,85,16320,30656
train,5284,28,28672,342,65664,94336
train,5285,16,16384,112,21504,37888
train,5286,21,21504,192,36864,58368
train,5287,45,46080,882,169344,215424
train,5288,21,21504,192,36864,58368
train,5289,21,21504,192,36864,58368
train,5290,18,18432,141,27072,45504
train,5291,25,25600,272,52224,77824
train,5292,12,12288,63,12096,24384
train,5293,14,14336,85,16320,30656
train,5294,30,30720,392,75264,105984
train,5295,36,36864,565,108480,145344
train,5296,30,30720,392,75264,105984
train,5297,17,17408,126,24192,41600
train,5298,23,23552,230,44160,67712
train,5299,26,26624,295,56640,83264
train,5300,15,15360,98,18816,34176
train,5301,13,13312,74,14208,27520
train,5302,9,9216,35,6720,15936
train,5303,14,14336,85,16320,30656
train,5304,18,18432,141,27072,45504
train,5305,26,26624,295,56640,83264
train,5306,30,30720,392,75264,105984
train,5307,29,29696,366,70272,99968
train,5308,13,13312,74,14208,27520
train,5309,9,9216,35,6720,15936
train,5310,28,28672,342,65664,94336
train,5311,4,4096,7,1344,5440
train,5312,16,16384,112,21504,37888
train,5313,15,15360,98,18816,34176
train,5314,40,40960,697,133824,174784
train,5315,15,15360,98,18816,34176
train,5316,21,21504,192,36864,58368
train,5317,19,19456,157,30144,49600
train,5318,25,25600,272,52224,77824
train,5319,34,34816,504,96768,131584
train,5320,39,39936,663,127296,167232
train,5321,20,20480,174,33408,53888
train,5322,24,24576,251,48192,72768
train,5323,34,34816,504,96768,131584
train,5324,12,12288,63,12096,24384
train,5325,15,15360,98,18816,34176
train,5326,20,20480,174,33408,53888
train,5327,18,18432,141,27072,45504
train,5328,6,6144,16,3072,9216
train,5329,35,35840,534,102528,138368
train,5330,5,5120,11,2112,7232
train,5331,37,37888,596,114432,152320
train,5332,22,22528,211,40512,63040
train,5333,9,9216,35,6720,15936
train,5334,18,18432,141,27072,45504
train,5335,13,13312,74,14208,27520
train,5336,15,15360,98,18816,34176
train,5337,23,23552,230,44160,67712
train,5338,6,6144,16,3072,9216
train,5339,19,19456,157,30144,49600
train,5340,10,10240,44,8448,18688
train,5341,42,43008,768,147456,190464
train,5342,25,25600,272,52224,77824
train,5343,11,11264,53,10176,21440
train,5344,26,26624,295,56640,83264
train,5345,20,20480,174,33408,53888
train,5346,22,22528,211,40512,63040
train,5347,4,4096,7,1344,5440
train,5348,12,12288,63,12096,24384
train,5349,21,21504,192,36864,58368
train,5350,23,23552,230,44160,67712
train,5351,29,29696,366,70272,99968
train,5352,26,26624,295,56640,83264
train,5353,20,20480,174,33408,53888
train,5354,24,24576,251,48192,72768
train,5355,40,40960,697,133824,174784
train,5356,6,6144,16,3072,9216
train,5357,10,10240,44,8448,18688
train,5358,6,6144,16,3072,9216
train,5359,19,19456,157,30144,49600
train,5360,25,25600,272,52224,77824
train,5361,29,29696,366,70272,99968
train,5362,32,32768,446,85632,118400
train,5363,17,17408,126,24192,41600
train,5364,23,23552,230,44160,67712
train,5365,17,17408,126,24192,41600
train,5366,18,18432,141,27072,45504
train,5367,14,14336,85,16320,30656
train,5368,29,29696,366,70272,99968
train,5369,12,12288,63,12096,24384
train,5370,23,23552,230,44160,67712
train,5371,19,19456,157,30144,49600
train,5372,20,20480,174,33408,53888
train,5373,21,21504,192,36864,58368
train,5374,19,19456,157,30144,49600
train,5375,7,7168,21,4032,11200
train,5376,44,45056,843,161856,206912
train,5377,15,15360,98,18816,34176
train,5378,43,44032,805,154560,198592
train,5379,5,5120,11,2112,7232
train,5380,32,32768,446,85632,118400
train,5381,24,24576,251,48192,72768
train,5382,18,18432,141,27072,45504
train,5383,31,31744,419,80448,112192
train,5384,21,21504,192,36864,58368
train,5385,9,9216,35,6720,15936
train,5386,20,20480,174,33408,53888
train,5387,18,18432,141,27072,45504
train,5388,36,36864,565,108480,145344
train,5389,30,30720,392,75264,105984
train,5390,14,14336,85,16320,30656
train,5391,28,28672,342,65664,94336
train,5392,14,14336,85,16320,30656
train,5393,24,24576,251,48192,72768
train,5394,12,12288,63,12096,24384
train,5395,9,9216,35,6720,15936
train,5396,11,11264,53,10176,21440
train,5397,29,29696,366,70272,99968
train,5398,13,13312,74,14208,27520
train,5399,12,12288,63,12096,24384
train,5400,8,8192,28,5376,13568
train,5401,27,27648,318,61056,88704
train,5402,7,7168,21,4032,11200
train,5403,5,5120,11,2112,7232
train,5404,26,26624,295,56640,83264
train,5405,12,12288,63,12096,24384
train,5406,35,35840,534,102528,138368
train,5407,29,29696,366,70272,99968
train,5408,21,21504,192,36864,58368
train,5409,6,6144,16,3072,9216
train,5410,31,31744,419,80448,112192
train,5411,27,27648,318,61056,88704
train,5412,20,20480,174,33408,53888
train,5413,12,12288,63,12096,24384
train,5414,20,20480,174,33408,53888
train,5415,22,22528,211,40512,63040
train,5416,51,52224,1133,217536,269760
train,5417,41,41984,732,140544,182528
train,5418,30,30720,392,75264,105984
train,5419,27,27648,318,61056,88704
train,5420,24,24576,251,48192,72768
train,5421,35,35840,534,102528,138368
train,5422,22,22528,211,40512,63040
train,5423,9,9216,35,6720,15936
train,5424,20,20480,174,33408,53888
train,5425,17,17408,126,24192,41600
train,5426,23,23552,230,44160,67712
train,5427,6,6144,16,3072,9216
train,5428,32,32768,446,85632,118400
train,5429,13,13312,74,14208,27520
train,5430,11,11264,53,10176,21440
train,5431,43,44032,805,154560,198592
train,5432,14,14336,85,16320,30656
train,5433,18,18432,141,27072,45504
train,5434,17,17408,126,24192,41600
train,5435,10,10240,44,8448,18688
train,5436,18,18432,141,27072,45504
train,5437,30,30720,392,75264,105984
train,5438,12,12288,63,12096,24384
train,5439,39,39936,663,127296,167232
train,5440,18,18432,141,27072,45504
train,5441,36,36864,565,108480,145344
train,5442,46,47104,922,177024,224128
train,5443,13,13312,74,14208,27520
train,5444,29,29696,366,70272,99968
train,5445,20,20480,174,33408,53888
train,5446,26,26624,295,56640,83264
train,5447,7,7168,21,4032,11200
train,5448,12,12288,63,12096,24384
train,5449,22,22528,211,40512,63040
train,5450,33,33792,474,91008,124800
train,5451,18,18432,141,27072,45504
train,5452,46,47104,922,177024,224128
train,5453,35,35840,534,102528,138368
train,5454,26,26624,295,56640,83264
train,5455,47,48128,962,184704,232832
train,5456,10,10240,44,8448,18688
train,5457,27,27648,318,61056,88704
train,5458,28,28672,342,65664,94336
train,5459,36,36864,565,108480,145344
train,5460,28,28672,342,65664,94336
train,5461,19,19456,157,30144,49600
train,5462,22,22528,211,40512,63040
train,5463,27,27648,318,61056,88704
train,5464,28,28672,342,65664,94336
train,5465,10,10240,44,8448,18688
train,5466,26,26624,295,56640,83264
train,5467,4,4096,7,1344,5440
train,5468,14,14336,85,16320,30656
train,5469,16,16384,112,21504,37888
train,5470,28,28672,342,65664,94336
train,5471,10,10240,44,8448,18688
train,5472,41,41984,732,140544,182528
train,5473,19,19456,157,30144,49600
train,5474,26,26624,295,56640,83264
train,5475,10,10240,44,8448,18688
train,5476,36,36864,565,108480,145344
train,5477,43,44032,805,154560,198592
train,5478,19,19456,157,30144,49600
train,5479,3,3072,4,768,3840
train,5480,34,34816,504,96768,131584
train,5481,9,9216,35,6720,15936
train,5482,24,24576,251,48192,72768
train,5483,13,13312,74,14208,27520
train,5484,18,18432,141,27072,45504
train,5485,23,23552,230,44160,67712
train,5486,44,45056,843,161856,206912
train,5487,13,13312,74,14208,27520
train,5488,9,9216,35,6720,15936
train,5489,37,37888,596,114432,152320
train,5490,16,16384,112,21504,37888
train,5491,36,36864,565,108480,145344
train,5492,18,18432,141,27072,45504
train,5493,29,29696,366,70272,99968
train,5494,44,45056,843,161856,206912
train,5495,24,24576,251,48192,72768
train,5496,13,13312,74,14208,27520
train,5497,32,32768,446,85632,118400
train,5498,18,18432,141,27072,45504
train,5499,14,14336,85,16320,30656
train,5500,16,16384,112,21504,37888
train,5501,24,24576,251,48192,72768
train,5502,20,20480,174,33408,53888
train,5503,32,32768,446,85632,118400
train,5504,4,4096,7,1344,5440
train,5505,15,15360,98,18816,34176
train,5506,10,10240,44,8448,18688
train,5507,50,51200,1089,209088,260288
train,5508,29,29696,366,70272,99968
train,5509,23,23552,230,44160,67712
train,5510,28,28672,342,65664,94336
train,5511,29,29696,366,70272,99968
train,5512,25,25600,272,52224,77824
train,5513,29,29696,366,70272,99968
train,5514,26,26624,295,56640,83264
train,5515,14,14336,85,16320,30656
train,5516,11,11264,53,10176,21440
train,5517,18,18432,141,27072,45504
train,5518,13,13312,74,14208,27520
train,5519,35,35840,534,102528,138368
train,5520,45,46080,882,169344,215424
train,5521,30,30720,392,75264,105984
train,5522,26,26624,295,56640,83264
train,5523,23,23552,230,44160,67712
train,5524,22,22528,211,40512,63040
train,5525,17,17408,126,24192,41600
train,5526,19,19456,157,30144,49600
train,5527,25,25600,272,52224,77824
train,5528,19,19456,157,30144,49600
train,5529,29,29696,366,70272,99968
train,5530,31,31744,419,80448,112192
train,5531,20,20480,174,33408,53888
train,5532,13,13312,74,14208,27520
train,5533,14,14336,85,16320,30656
train,5534,7,7168,21,4032,11200
train,5535,13,13312,74,14208,27520
train,5536,39,39936,663,127296,167232
train,5537,4,4096,7,1344,5440
train,5538,8,8192,28,5376,13568
train,5539,14,14336,85,16320,30656
train,5540,31,31744,419,80448,112192
train,5541,37,37888,596,114432,152320
train,5542,38,38912,629,120768,159680
train,5543,26,26624,295,56640,83264
train,5544,30,30720,392,75264,105984
train,5545,8,8192,28,5376,13568
train,5546,32,32768,446,85632,118400
train,5547,37,37888,596,114432,152320
train,5548,23,23552,230,44160,67712
train,5549,13,13312,74,14208,27520
train,5550,23,23552,230,44160,67712
train,5551,43,44032,805,154560,198592
train,5552,46,47104,922,177024,224128
train,5553,12,12288,63,12096,24384
train,5554,24,24576,251,48192,72768
train,5555,9,9216,35,6720,15936
train,5556,18,18432,141,27072,45504
train,5557,23,23552,230,44160,67712
train,5558,30,30720,392,75264,105984
train,5559,45,46080,882,169344,215424
train,5560,12,12288,63,12096,24384
train,5561,36,36864,565,108480,145344
train,5562,40,40960,697,133824,174784
train,5563,16,16384,112,21504,37888
train,5564,15,15360,98,18816,34176
train,5565,23,23552,230,44160,67712
train,5566,10,10240,44,8448,18688
train,5567,27,27648,318,61056,88704
train,5568,12,12288,63,12096,24384
train,5569,18,18432,141,27072,45504
train,5570,24,24576,251,48192,72768
train,5571,11,11264,53,10176,21440
train,5572,34,34816,504,96768,131584
train,5573,42,43008,768,147456,190464
train,5574,36,36864,565,108480,145344
train,5575,17,17408,126,24192,41600
train,5576,8,8192,28,5376,13568
train,5577,19,19456,157,30144,49600
train,5578,10,10240,44,8448,18688
train,5579,31,31744,419,80448,112192
train,5580,7,7168,21,4032,11200
train,5581,24,24576,251,48192,72768
train,5582,24,24576,251,48192,72768
train,5583,37,37888,596,114432,152320
train,5584,14,14336,85,16320,30656
train,5585,22,22528,211,40512,63040
train,5586,11,11264,53,10176,21440
train,5587,12,12288,63,12096,24384
train,5588,30,30720,392,75264,105984
train,5589,34,34816,504,96768,131584
train,5590,33,33792,474,91008,124800
train,5591,17,17408,126,24192,41600
train,5592,28,28672,342,65664,94336
train,5593,29,29696,366,70272,99968
train,5594,11,11264,53,10176,21440
train,5595,42,43008,768,147456,190464
train,5596,21,21504,192,36864,58368
train,5597,14,14336,85,16320,30656
train,5598,26,26624,295,56640,83264
train,5599,9,9216,35,6720,15936
train,5600,16,16384,112,21504,37888
train,5601,19,19456,157,30144,49600
train,5602,26,26624,295,56640,83264
train,5603,22,22528,211,40512,63040
train,5604,17,17408,126,24192,41600
train,5605,23,23552,230,44160,67712
train,5606,10,10240,44,8448,18688
train,5607,14,14336,85,16320,30656
train,5608,28,28672,342,65664,94336
train,5609,17,17408,126,24192,41600
train,5610,23,23552,230,44160,67712
train,5611,17,17408,126,24192,41600
train,5612,19,19456,157,30144,49600
train,5613,33,33792,474,91008,124800
train,5614,32,32768,446,85632,118400
train,5615,16,16384,112,21504,37888
train,5616,11,11264,53,10176,21440
train,5617,20,20480,174,33408,53888
train,5618,17,17408,126,24192,41600
train,5619,9,9216,35,6720,15936
train,5620,7,7168,21,4032,11200
train,5621,5,5120,11,2112,7232
train,5622,13,13312,74,14208,27520
train,5623,27,27648,318,61056,88704
train,5624,23,23552,230,44160,67712
train,5625,40,40960,697,133824,174784
train,5626,21,21504,192,36864,58368
train,5627,38,38912,629,120768,159680
train,5628,20,20480,174,33408,53888
train,5629,25,25600,272,52224,77824
train,5630,37,37888,596,114432,152320
train,5631,17,17408,126,24192,41600
train,5632,11,11264,53,10176,21440
train,5633,6,6144,16,3072,9216
train,5634,25,25600,272,52224,77824
train,5635,25,25600,272,52224,77824
train,5636,30,30720,392,75264,105984
train,5637,18,18432,141,27072,45504
train,5638,19,19456,157,30144,49600
train,5639,24,24576,251,48192,72768
train,5640,26,26624,295,56640,83264
train,5641,29,29696,366,70272,99968
train,5642,11,11264,53,10176,21440
train,5643,11,11264,53,10176,21440
train,5644,19,19456,157,30144,49600
train,5645,16,16384,112,21504,37888
train,5646,9,9216,35,6720,15936
train,5647,31,31744,419,80448,112192
train,5648,21,21504,192,36864,58368
train,5649,33,33792,474,91008,124800
train,5650,19,19456,157,30144,49600
train,5651,24,24576,251,48192,72768
train,5652,14,14336,85,16320,30656
train,5653,23,23552,230,44160,67712
train,5654,27,27648,318,61056,88704
train,5655,3,3072,4,768,3840
train,5656,6,6144,16,3072,9216
train,5657,39,39936,663,127296,167232
train,5658,39,39936,663,127296,167232
train,5659,29,29696,366,70272,99968
train,5660,24,24576,251,48192,72768
train,5661,30,30720,392,75264,105984
train,5662,18,18432,141,27072,45504
train,5663,16,16384,112,21504,37888
train,5664,29,29696,366,70272,99968
train,5665,43,44032,805,154560,198592
train,5666,33,33792,474,91008,124800
train,5667,14,14336,85,16320,30656
train,5668,11,11264,53,10176,21440
train,5669,12,12288,63,12096,24384
train,5670,19,19456,157,30144,49600
train,5671,6,6144,16,3072,9216
train,5672,19,19456,157,30144,49600
train,5673,20,20480,174,33408,53888
train,5674,26,26624,295,56640,83264
train,5675,14,14336,85,16320,30656
train,5676,20,20480,174,33408,53888
train,5677,22,22528,211,40512,63040
train,5678,23,23552,230,44160,67712
train,5679,27,27648,318,61056,88704
train,5680,19,19456,157,30144,49600
train,5681,26,26624,295,56640,83264
train,5682,13,13312,74,14208,27520
train,5683,45,46080,882,169344,215424
train,5684,22,22528,211,40512,63040
train,5685,9,9216,35,6720,15936
train,5686,27,27648,318,61056,88704
train,5687,17,17408,126,24192,41600
train,5688,23,23552,230,44160,67712
train,5689,41,41984,732,140544,182528
train,5690,37,37888,596,114432,152320
train,5691,20,20480,174,33408,53888
train,5692,5,5120,11,2112,7232
train,5693,24,24576,251,48192,72768
train,5694,33,33792,474,91008,124800
train,5695,31,31744,419,80448,112192
train,5696,44,45056,843,161856,206912
train,5697,13,13312,74,14208,27520
train,5698,34,34816,504,96768,131584
train,5699,32,32768,446,85632,118400
train,5700,24,24576,251,48192,72768
train,5701,3,3072,4,768,3840
train,5702,11,11264,53,10176,21440
train,5703,17,17408,126,24192,41600
train,5704,19,19456,157,30144,49600
train,5705,3,3072,4,768,3840
train,5706,22,22528,211,40512,63040
train,5707,18,18432,141,27072,45504
train,5708,27,27648,318,61056,88704
train,5709,35,35840,534,102528,138368
train,5710,33,33792,474,91008,124800
train,5711,3,3072,4,768,3840
train,5712,15,15360,98,18816,34176
train,5713,36,36864,565,108480,145344
train,5714,27,27648,318,61056,88704
train,5715,7,7168,21,4032,11200
train,5716,29,29696,366,70272,99968
train,5717,13,13312,74,14208,27520
train,5718,22,22528,211,40512,63040
train,5719,12,12288,63,12096,24384
train,5720,40,40960,697,133824,174784
train,5721,24,24576,251,48192,72768
train,5722,7,7168,21,4032,11200
train,5723,24,24576,251,48192,72768
train,5724,20,20480,174,33408,53888
train,5725,14,14336,85,16320,30656
train,5726,17,17408,126,24192,41600
train,5727,9,9216,35,6720,15936
train,5728,33,33792,474,91008,124800
train,5729,23,23552,230,44160,67712
train,5730,31,31744,419,80448,112192
train,5731,6,6144,16,3072,9216
train,5732,5,5120,11,2112,7232
train,5733,37,37888,596,114432,152320
train,5734,16,16384,112,21504,37888
train,5735,13,13312,74,14208,27520
train,5736,20,20480,174,33408,53888
train,5737,28,28672,342,65664,94336
train,5738,24,24576,251,48192,72768
train,5739,27,27648,318,61056,88704
train,5740,8,8192,28,5376,13568
train,5741,21,21504,192,36864,58368
train,5742,18,18432,141,27072,45504
train,5743,5,5120,11,2112,7232
train,5744,15,15360,98,18816,34176
train,5745,18,18432,141,27072,45504
train,5746,9,9216,35,6720,15936
train,5747,21,21504,192,36864,58368
train,5748,52,53248,1178,226176,279424
train,5749,27,27648,318,61056,88704
train,5750,16,16384,112,21504,37888
train,5751,41,41984,732,140544,182528
train,5752,38,38912,629,120768,159680
train,5753,6,6144,16,3072,9216
train,5754,41,41984,732,140544,182528
train,5755,17,17408,126,24192,41600
train,5756,33,33792,474,91008,124800
train,5757,35,35840,534,102528,138368
train,5758,15,15360,98,18816,34176
train,5759,27,27648,318,61056,88704
train,5760,20,20480,174,33408,53888
train,5761,39,39936,663,127296,167232
train,5762,34,34816,504,96768,131584
train,5763,16,16384,112,21504,37888
train,5764,19,19456,157,30144,49600
train,5765,12,12288,63,12096,24384
train,5766,32,32768,446,85632,118400
train,5767,5,5120,11,2112,7232
train,5768,31,31744,419,80448,112192
train,5769,36,36864,565,108480,145344
train,5770,25,25600,272,52224,77824
train,5771,13,13312,74,14208,27520
train,5772,22,22528,211,40512,63040
train,5773,22,22528,211,40512,63040
train,5774,28,28672,342,65664,94336
train,5775,18,18432,141,27072,45504
train,5776,33,33792,474,91008,124800
train,5777,35,35840,534,102528,138368
train,5778,15,15360,98,18816,34176
train,5779,21,21504,192,36864,58368
train,5780,41,41984,732,140544,182528
train,5781,7,7168,21,4032,11200
train,5782,11,11264,53,10176,21440
train,5783,29,29696,366,70272,99968
train,5784,18,18432,141,27072,45504
train,5785,14,14336,85,16320,30656
train,5786,9,9216,35,6720,15936
train,5787,51,52224,1133,217536,269760
train,5788,29,29696,366,70272,99968
train,5789,34,34816,504,96768,131584
train,5790,35,35840,534,102528,138368
train,5791,11,11264,53,10176,21440
train,5792,7,7168,21,4032,11200
train,5793,13,13312,74,14208,27520
train,5794,8,8192,28,5376,13568
train,5795,13,13312,74,14208,27520
train,5796,27,27648,318,61056,88704
train,5797,40,40960,697,133824,174784
train,5798,33,33792,474,91008,124800
train,5799,20,20480,174,33408,53888
train,5800,32,32768,446,85632,118400
train,5801,4,4096,7,1344,5440
train,5802,33,33792,474,91008,124800
train,5803,16,16384,112,21504,37888
train,5804,27,27648,318,61056,88704
train,5805,24,24576,251,48192,72768
train,5806,21,21504,192,36864,58368
train,5807,14,14336,85,16320,30656
train,5808,23,23552,230,44160,67712
train,5809,9,9216,35,6720,15936
train,5810,31,31744,419,80448,112192
train,5811,27,27648,318,61056,88704
train,5812,19,19456,157,30144,49600
train,5813,30,30720,392,75264,105984
train,5814,14,14336,85,16320,30656
train,5815,6,6144,16,3072,9216
train,5816,34,34816,504,96768,131584
train,5817,38,38912,629,120768,159680
train,5818,6,6144,16,3072,9216
train,5819,26,26624,295,56640,83264
train,5820,29,29696,366,70272,99968
train,5821,4,4096,7,1344,5440
train,5822,20,20480,174,33408,53888
train,5823,19,19456,157,30144,49600
train,5824,21,21504,192,36864,58368
train,5825,8,8192,28,5376,13568
train,5826,22,22528,211,40512,63040
train,5827,19,19456,157,30144,49600
train,5828,28,28672,342,65664,94336
train,5829,19,19456,157,30144,49600
train,5830,24,24576,251,48192,72768
train,5831,19,19456,157,30144,49600
train,5832,26,26624,295,56640,83264
train,5833,28,28672,342,65664,94336
train,5834,25,25600,272,52224,77824
train,5835,47,48128,962,184704,232832
train,5836,38,38912,629,120768,159680
train,5837,39,39936,663,127296,167232
train,5838,29,29696,366,70272,99968
train,5839,30,30720,392,75264,105984
train,5840,38,38912,629,120768,159680
train,5841,23,23552,230,44160,67712
train,5842,22,22528,211,40512,63040
train,5843,22,22528,211,40512,63040
train,5844,4,4096,7,1344,5440
train,5845,15,15360,98,18816,34176
train,5846,21,21504,192,36864,58368
train,5847,11,11264,53,10176,21440
train,5848,17,17408,126,24192,41600
train,5849,6,6144,16,3072,9216
train,5850,43,44032,805,154560,198592
train,5851,25,25600,272,52224,77824
train,5852,24,24576,251,48192,72768
train,5853,12,12288,63,12096,24384
train,5854,8,8192,28,5376,13568
train,5855,16,16384,112,21504,37888
train,5856,20,20480,174,33408,53888
train,5857,22,22528,211,40512,63040
train,5858,30,30720,392,75264,105984
train,5859,34,34816,504,96768,131584
train,5860,10,10240,44,8448,18688
train,5861,34,34816,504,96768,131584
train,5862,35,35840,534,102528,138368
train,5863,16,16384,112,21504,37888
train,5864,8,8192,28,5376,13568
train,5865,8,8192,28,5376,13568
train,5866,10,10240,44,8448,18688
train,5867,49,50176,1046,200832,251008
train,5868,16,16384,112,21504,37888
train,5869,25,25600,272,52224,77824
train,5870,29,29696,366,70272,99968
train,5871,32,32768,446,85632,118400
train,5872,16,16384,112,21504,37888
train,5873,11,11264,53,10176,21440
train,5874,27,27648,318,61056,88704
train,5875,18,18432,141,27072,45504
train,5876,34,34816,504,96768,131584
train,5877,45,46080,882,169344,215424
train,5878,26,26624,295,56640,83264
train,5879,35,35840,534,102528,138368
train,5880,12,12288,63,12096,24384
train,5881,40,40960,697,133824,174784
train,5882,9,9216,35,6720,15936
train,5883,18,18432,141,27072,45504
train,5884,22,22528,211,40512,63040
train,5885,22,22528,211,40512,63040
train,5886,24,24576,251,48192,72768
train,5887,24,24576,251,48192,72768
train,5888,42,43008,768,147456,190464
train,5889,26,26624,295,56640,83264
train,5890,16,16384,112,21504,37888
train,5891,40,40960,697,133824,174784
train,5892,17,17408,126,24192,41600
train,5893,11,11264,53,10176,21440
train,5894,11,11264,53,10176,21440
train,5895,34,34816,504,96768,131584
train,5896,18,18432,141,27072,45504
train,5897,40,40960,697,133824,174784
train,5898,23,23552,230,44160,67712
train,5899,29,29696,366,70272,99968
train,5900,25,25600,272,52224,77824
train,5901,23,23552,230,44160,67712
train,5902,10,10240,44,8448,18688
train,5903,30,30720,392,75264,105984
train,5904,18,18432,141,27072,45504
train,5905,36,36864,565,108480,145344
train,5906,28,28672,342,65664,94336
train,5907,19,19456,157,30144,49600
train,5908,9,9216,35,6720,15936
train,5909,18,18432,141,27072,45504
train,5910,13,13312,74,14208,27520
train,5911,30,30720,392,75264,105984
train,5912,9,9216,35,6720,15936
train,5913,39,39936,663,127296,167232
train,5914,28,28672,342,65664,94336
train,5915,13,13312,74,14208,27520
train,5916,18,18432,141,27072,45504
train,5917,27,27648,318,61056,88704
train,5918,12,12288,63,12096,24384
train,5919,12,12288,63,12096,24384
train,5920,15,15360,98,18816,34176
train,5921,33,33792,474,91008,124800
train,5922,32,32768,446,85632,118400
train,5923,6,6144,16,3072,9216
train,5924,6,6144,16,3072,9216
train,5925,37,37888,596,114432,152320
train,5926,21,21504,192,36864,58368
train,5927,3,3072,4,768,3840
train,5928,27,27648,318,61056,88704
train,5929,28,28672,342,65664,94336
train,5930,35,35840,534,102528,138368
train,5931,11,11264,53,10176,21440
train,5932,23,23552,230,44160,67712
train,5933,8,8192,28,5376,13568
train,5934,19,19456,157,30144,49600
train,5935,23,23552,230,44160,67712
train,5936,20,20480,174,33408,53888
train,5937,9,9216,35,6720,15936
train,5938,25,25600,272,52224,77824
train,5939,24,24576,251,48192,72768
train,5940,38,38912,629,120768,159680
train,5941,26,26624,295,56640,83264
train,5942,24,24576,251,48192,72768
train,5943,21,21504,192,36864,58368
train,5944,32,32768,446,85632,118400
train,5945,7,7168,21,4032,11200
train,5946,17,17408,126,24192,41600
train,5947,31,31744,419,80448,112192
train,5948,14,14336,85,16320,30656
train,5949,23,23552,230,44160,67712
train,5950,11,11264,53,10176,21440
train,5951,29,29696,366,70272,99968
train,5952,16,16384,112,21504,37888
train,5953,24,24576,251,48192,72768
train,5954,32,32768,446,85632,118400
train,5955,33,33792,474,91008,124800
train,5956,40,40960,697,133824,174784
train,5957,24,24576,251,48192,72768
train,5958,19,19456,157,30144,49600
train,5959,28,28672,342,65664,94336
train,5960,15,15360,98,18816,34176
train,5961,22,22528,211,40512,63040
train,5962,30,30720,392,75264,105984
train,5963,50,51200,1089,209088,260288
train,5964,14,14336,85,16320,30656
train,5965,20,20480,174,33408,53888
train,5966,16,16384,112,21504,37888
train,5967,33,33792,474,91008,124800
train,5968,19,19456,157,30144,49600
train,5969,24,24576,251,48192,72768
train,5970,48,49152,1004,192768,241920
train,5971,26,26624,295,56640,83264
train,5972,11,11264,53,10176,21440
train,5973,28,28672,342,65664,94336
train,5974,23,23552,230,44160,67712
train,5975,19,19456,157,30144,49600
train,5976,20,20480,174,33408,53888
train,5977,23,23552,230,44160,67712
train,5978,26,26624,295,56640,83264
train,5979,47,48128,962,184704,232832
train,5980,20,20480,174,33408,53888
train,5981,38,38912,629,120768,159680
train,5982,33,33792,474,91008,124800
train,5983,11,11264,53,10176,21440
train,5984,26,26624,295,56640,83264
train,5985,29,29696,366,70272,99968
train,5986,20,20480,174,33408,53888
train,5987,33,33792,474,91008,124800
train,5988,26,26624,295,56640,83264
train,5989,30,30720,392,75264,105984
train,5990,26,26624,295,56640,83264
train,5991,24,24576,251,48192,72768
train,5992,7,7168,21,4032,11200
train,5993,15,15360,98,18816,34176
train,5994,35,35840,534,102528,138368
train,5995,18,18432,141,27072,45504
train,5996,19,19456,157,30144,49600
train,5997,10,10240,44,8448,18688
train,5998,34,34816,504,96768,131584
train,5999,31,31744,419,80448,112192
train,6000,42,43008,768,147456,190464
train,6001,16,16384,112,21504,37888
train,6002,35,35840,534,102528,138368
train,6003,24,24576,251,48192,72768
train,6004,20,20480,174,33408,53888
train,6005,39,39936,663,127296,167232
train,6006,27,27648,318,61056,88704
train,6007,19,19456,157,30144,49600
train,6008,16,16384,112,21504,37888
train,6009,33,33792,474,91008,124800
train,6010,37,37888,596,114432,152320
train,6011,37,37888,596,114432,152320
train,6012,25,25600,272,52224,77824
train,6013,8,8192,28,5376,13568
train,6014,54,55296,1270,243840,299136
train,6015,24,24576,251,48192,72768
train,6016,22,22528,211,40512,63040
train,6017,26,26624,295,56640,83264
train,6018,23,23552,230,44160,67712
train,6019,25,25600,272,52224,77824
train,6020,31,31744,419,80448,112192
train,6021,14,14336,85,16320,30656
train,6022,21,21504,192,36864,58368
train,6023,12,12288,63,12096,24384
train,6024,22,22528,211,40512,63040
train,6025,21,21504,192,36864,58368
train,6026,33,33792,474,91008,124800
train,6027,10,10240,44,8448,18688
train,6028,19,19456,157,30144,49600
train,6029,23,23552,230,44160,67712
train,6030,4,4096,7,1344,5440
train,6031,22,22528,211,40512,63040
train,6032,11,11264,53,10176,21440
train,6033,28,28672,342,65664,94336
train,6034,15,15360,98,18816,34176
train,6035,32,32768,446,85632,118400
train,6036,20,20480,174,33408,53888
train,6037,47,48128,962,184704,232832
train,6038,8,8192,28,5376,13568
train,6039,15,15360,98,18816,34176
train,6040,36,36864,565,108480,145344
train,6041,11,11264,53,10176,21440
train,6042,27,27648,318,61056,88704
train,6043,15,15360,98,18816,34176
train,6044,24,24576,251,48192,72768
train,6045,40,40960,697,133824,174784
train,6046,45,46080,882,169344,215424
train,6047,17,17408,126,24192,41600
train,6048,31,31744,419,80448,112192
train,6049,24,24576,251,48192,72768
train,6050,29,29696,366,70272,99968
train,6051,15,15360,98,18816,34176
train,6052,11,11264,53,10176,21440
train,6053,25,25600,272,52224,77824
train,6054,22,22528,211,40512,63040
train,6055,12,12288,63,12096,24384
train,6056,36,36864,565,108480,145344
train,6057,9,9216,35,6720,15936
train,6058,25,25600,272,52224,77824
train,6059,7,7168,21,4032,11200
train,6060,23,23552,230,44160,67712
train,6061,18,18432,141,27072,45504
train,6062,31,31744,419,80448,112192
train,6063,31,31744,419,80448,112192
train,6064,24,24576,251,48192,72768
train,6065,21,21504,192,36864,58368
train,6066,32,32768,446,85632,118400
train,6067,12,12288,63,12096,24384
train,6068,19,19456,157,30144,49600
train,6069,27,27648,318,61056,88704
train,6070,12,12288,63,12096,24384
train,6071,12,12288,63,12096,24384
train,6072,30,30720,392,75264,105984
train,6073,22,22528,211,40512,63040
train,6074,33,33792,474,91008,124800
train,6075,21,21504,192,36864,58368
train,6076,48,49152,1004,192768,241920
train,6077,5,5120,11,2112,7232
train,6078,9,9216,35,6720,15936
train,6079,19,19456,157,30144,49600
train,6080,15,15360,98,18816,34176
train,6081,13,13312,74,14208,27520
train,6082,24,24576,251,48192,72768
train,6083,20,20480,174,33408,53888
train,6084,15,15360,98,18816,34176
train,6085,6,6144,16,3072,9216
train,6086,26,26624,295,56640,83264
train,6087,30,30720,392,75264,105984
train,6088,25,25600,272,52224,77824
train,6089,9,9216,35,6720,15936
train,6090,10,10240,44,8448,18688
train,6091,24,24576,251,48192,72768
train,6092,12,12288,63,12096,24384
train,6093,20,20480,174,33408,53888
train,6094,17,17408,126,24192,41600
train,6095,31,31744,419,80448,112192
train,6096,18,18432,141,27072,45504
train,6097,24,24576,251,48192,72768
train,6098,30,30720,392,75264,105984
train,6099,13,13312,74,14208,27520
train,6100,6,6144,16,3072,9216
train,6101,20,20480,174,33408,53888
train,6102,25,25600,272,52224,77824
train,6103,10,10240,44,8448,18688
train,6104,19,19456,157,30144,49600
train,6105,24,24576,251,48192,72768
train,6106,28,28672,342,65664,94336
train,6107,15,15360,98,18816,34176
train,6108,11,11264,53,10176,21440
train,6109,40,40960,697,133824,174784
train,6110,26,26624,295,56640,83264
train,6111,6,6144,16,3072,9216
train,6112,31,31744,419,80448,112192
train,6113,11,11264,53,10176,21440
train,6114,17,17408,126,24192,41600
train,6115,21,21504,192,36864,58368
train,6116,23,23552,230,44160,67712
train,6117,24,24576,251,48192,72768
train,6118,37,37888,596,114432,152320
train,6119,33,33792,474,91008,124800
train,6120,23,23552,230,44160,67712
train,6121,5,5120,11,2112,7232
train,6122,19,19456,157,30144,49600
train,6123,23,23552,230,44160,67712
train,6124,36,36864,565,108480,145344
train,6125,34,34816,504,96768,131584
train,6126,17,17408,126,24192,41600
train,6127,12,12288,63,12096,24384
train,6128,25,25600,272,52224,77824
train,6129,13,13312,74,14208,27520
train,6130,17,17408,126,24192,41600
train,6131,22,22528,211,40512,63040
train,6132,8,8192,28,5376,13568
train,6133,24,24576,251,48192,72768
train,6134,11,11264,53,10176,21440
train,6135,16,16384,112,21504,37888
train,6136,20,20480,174,33408,53888
train,6137,29,29696,366,70272,99968
train,6138,24,24576,251,48192,72768
train,6139,23,23552,230,44160,67712
train,6140,20,20480,174,33408,53888
train,6141,16,16384,112,21504,37888
train,6142,15,15360,98,18816,34176
train,6143,25,25600,272,52224,77824
train,6144,17,17408,126,24192,41600
train,6145,15,15360,98,18816,34176
train,6146,21,21504,192,36864,58368
train,6147,30,30720,392,75264,105984
train,6148,28,28672,342,65664,94336
train,6149,13,13312,74,14208,27520
train,6150,37,37888,596,114432,152320
train,6151,8,8192,28,5376,13568
train,6152,21,21504,192,36864,58368
train,6153,19,19456,157,30144,49600
train,6154,18,18432,141,27072,45504
train,6155,41,41984,732,140544,182528
train,6156,28,28672,342,65664,94336
train,6157,27,27648,318,61056,88704
train,6158,35,35840,534,102528,138368
train,6159,30,30720,392,75264,105984
train,6160,42,43008,768,147456,190464
train,6161,23,23552,230,44160,67712
train,6162,37,37888,596,114432,152320
train,6163,18,18432,141,27072,45504
train,6164,26,26624,295,56640,83264
train,6165,34,34816,504,96768,131584
train,6166,8,8192,28,5376,13568
train,6167,5,5120,11,2112,7232
train,6168,11,11264,53,10176,21440
train,6169,25,25600,272,52224,77824
train,6170,26,26624,295,56640,83264
train,6171,16,16384,112,21504,37888
train,6172,29,29696,366,70272,99968
train,6173,11,11264,53,10176,21440
train,6174,17,17408,126,24192,41600
train,6175,25,25600,272,52224,77824
train,6176,19,19456,157,30144,49600
train,6177,8,8192,28,5376,13568
train,6178,28,28672,342,65664,94336
train,6179,19,19456,157,30144,49600
train,6180,15,15360,98,18816,34176
train,6181,32,32768,446,85632,118400
train,6182,14,14336,85,16320,30656
train,6183,15,15360,98,18816,34176
train,6184,25,25600,272,52224,77824
train,6185,39,39936,663,127296,167232
train,6186,46,47104,922,177024,224128
train,6187,19,19456,157,30144,49600
train,6188,3,3072,4,768,3840
train,6189,18,18432,141,27072,45504
train,6190,20,20480,174,33408,53888
train,6191,34,34816,504,96768,131584
train,6192,18,18432,141,27072,45504
train,6193,9,9216,35,6720,15936
train,6194,20,20480,174,33408,53888
train,6195,18,18432,141,27072,45504
train,6196,5,5120,11,2112,7232
train,6197,13,13312,74,14208,27520
train,6198,44,45056,843,161856,206912
train,6199,29,29696,366,70272,99968
train,6200,38,38912,629,120768,159680
train,6201,24,24576,251,48192,72768
train,6202,28,28672,342,65664,94336
train,6203,49,50176,1046,200832,251008
train,6204,22,22528,211,40512,63040
train,6205,21,21504,192,36864,58368
train,6206,34,34816,504,96768,131584
train,6207,25,25600,272,52224,77824
train,6208,33,33792,474,91008,124800
train,6209,21,21504,192,36864,58368
train,6210,19,19456,157,30144,49600
train,6211,22,22528,211,40512,63040
train,6212,26,26624,295,56640,83264
train,6213,13,13312,74,14208,27520
train,6214,14,14336,85,16320,30656
train,6215,28,28672,342,65664,94336
train,6216,43,44032,805,154560,198592
train,6217,25,25600,272,52224,77824
train,6218,30,30720,392,75264,105984
train,6219,29,29696,366,70272,99968
train,6220,24,24576,251,48192,72768
train,6221,29,29696,366,70272,99968
train,6222,20,20480,174,33408,53888
train,6223,17,17408,126,24192,41600
train,6224,31,31744,419,80448,112192
train,6225,29,29696,366,70272,99968
train,6226,32,32768,446,85632,118400
train,6227,26,26624,295,56640,83264
train,6228,19,19456,157,30144,49600
train,6229,21,21504,192,36864,58368
train,6230,39,39936,663,127296,167232
train,6231,10,10240,44,8448,18688
train,6232,6,6144,16,3072,9216
train,6233,10,10240,44,8448,18688
train,6234,10,10240,44,8448,18688
train,6235,35,35840,534,102528,138368
train,6236,30,30720,392,75264,105984
train,6237,6,6144,16,3072,9216
train,6238,18,18432,141,27072,45504
train,6239,34,34816,504,96768,131584
train,6240,23,23552,230,44160,67712
train,6241,39,39936,663,127296,167232
train,6242,26,26624,295,56640,83264
train,6243,14,14336,85,16320,30656
train,6244,11,11264,53,10176,21440
train,6245,19,19456,157,30144,49600
train,6246,10,10240,44,8448,18688
train,6247,25,25600,272,52224,77824
train,6248,35,35840,534,102528,138368
train,6249,30,30720,392,75264,105984
train,6250,33,33792,474,91008,124800
train,6251,6,6144,16,3072,9216
train,6252,32,32768,446,85632,118400
train,6253,6,6144,16,3072,9216
train,6254,16,16384,112,21504,37888
train,6255,20,20480,174,33408,53888
train,6256,5,5120,11,2112,7232
train,6257,11,11264,53,10176,21440
train,6258,23,23552,230,44160,67712
train,6259,21,21504,192,36864,58368
train,6260,7,7168,21,4032,11200
train,6261,31,31744,419,80448,112192
train,6262,25,25600,272,52224,77824
train,6263,40,40960,697,133824,174784
train,6264,34,34816,504,96768,131584
train,6265,5,5120,11,2112,7232
train,6266,14,14336,85,16320,30656
train,6267,24,24576,251,48192,72768
train,6268,48,49152,1004,192768,241920
train,6269,23,23552,230,44160,67712
train,6270,31,31744,419,80448,112192
train,6271,20,20480,174,33408,53888
train,6272,23,23552,230,44160,67712
train,6273,23,23552,230,44160,67712
train,6274,11,11264,53,10176,21440
train,6275,32,32768,446,85632,118400
train,6276,12,12288,63,12096,24384
train,6277,19,19456,157,30144,49600
train,6278,12,12288,63,12096,24384
train,6279,12,12288,63,12096,24384
train,6280,29,29696,366,70272,99968
train,6281,16,16384,112,21504,37888
train,6282,46,47104,922,177024,224128
train,6283,28,28672,342,65664,94336
train,6284,27,27648,318,61056,88704
train,6285,6,6144,16,3072,9216
train,6286,41,41984,732,140544,182528
train,6287,36,36864,565,108480,145344
train,6288,45,46080,882,169344,215424
train,6289,44,45056,843,161856,206912
train,6290,29,29696,366,70272,99968
train,6291,34,34816,504,96768,131584
train,6292,6,6144,16,3072,9216
train,6293,31,31744,419,80448,112192
train,6294,22,22528,211,40512,63040
train,6295,28,28672,342,65664,94336
train,6296,24,24576,251,48192,72768
train,6297,11,11264,53,10176,21440
train,6298,16,16384,112,21504,37888
train,6299,28,28672,342,65664,94336
train,6300,28,28672,342,65664,94336
train,6301,8,8192,28,5376,13568
train,6302,22,22528,211,40512,63040
train,6303,23,23552,230,44160,67712
train,6304,27,27648,318,61056,88704
train,6305,12,12288,63,12096,24384
train,6306,25,25600,272,52224,77824
train,6307,30,30720,392,75264,105984
train,6308,16,16384,112,21504,37888
train,6309,27,27648,318,61056,88704
train,6310,43,44032,805,154560,198592
train,6311,34,34816,504,96768,131584
train,6312,26,26624,295,56640,83264
train,6313,7,7168,21,4032,11200
train,6314,25,25600,272,52224,77824
train,6315,37,37888,596,114432,152320
train,6316,23,23552,230,44160,67712
train,6317,30,30720,392,75264,105984
train,6318,12,12288,63,12096,24384
train,6319,13,13312,74,14208,27520
train,6320,10,10240,44,8448,18688
train,6321,34,34816,504,96768,131584
train,6322,41,41984,732,140544,182528
train,6323,12,12288,63,12096,24384
train,6324,22,22528,211,40512,63040
train,6325,25,25600,272,52224,77824
train,6326,16,16384,112,21504,37888
train,6327,21,21504,192,36864,58368
train,6328,10,10240,44,8448,18688
train,6329,12,12288,63,12096,24384
train,6330,25,25600,272,52224,77824
train,6331,46,47104,922,177024,224128
train,6332,41,41984,732,140544,182528
train,6333,30,30720,392,75264,105984
train,6334,38,38912,629,120768,159680
train,6335,11,11264,53,10176,21440
train,6336,14,14336,85,16320,30656
train,6337,25,25600,272,52224,77824
train,6338,16,16384,112,21504,37888
train,6339,23,23552,230,44160,67712
train,6340,44,45056,843,161856,206912
train,6341,27,27648,318,61056,88704
train,6342,26,26624,295,56640,83264
train,6343,12,12288,63,12096,24384
train,6344,13,13312,74,14208,27520
train,6345,21,21504,192,36864,58368
train,6346,18,18432,141,27072,45504
train,6347,23,23552,230,44160,67712
train,6348,8,8192,28,5376,13568
train,6349,31,31744,419,80448,112192
train,6350,39,39936,663,127296,167232
train,6351,31,31744,419,80448,112192
train,6352,24,24576,251,48192,72768
train,6353,16,16384,112,21504,37888
train,6354,24,24576,251,48192,72768
train,6355,39,39936,663,127296,167232
train,6356,28,28672,342,65664,94336
train,6357,23,23552,230,44160,67712
train,6358,29,29696,366,70272,99968
train,6359,15,15360,98,18816,34176
train,6360,31,31744,419,80448,112192
train,6361,38,38912,629,120768,159680
train,6362,22,22528,211,40512,63040
train,6363,3,3072,4,768,3840
train,6364,10,10240,44,8448,18688
train,6365,30,30720,392,75264,105984
train,6366,14,14336,85,16320,30656
train,6367,10,10240,44,8448,18688
train,6368,8,8192,28,5376,13568
train,6369,39,39936,663,127296,167232
train,6370,8,8192,28,5376,13568
train,6371,22,22528,211,40512,63040
train,6372,39,39936,663,127296,167232
train,6373,18,18432,141,27072,45504
train,6374,23,23552,230,44160,67712
train,6375,27,27648,318,61056,88704
train,6376,24,24576,251,48192,72768
train,6377,11,11264,53,10176,21440
train,6378,19,19456,157,30144,49600
train,6379,14,14336,85,16320,30656
train,6380,35,35840,534,102528,138368
train,6381,13,13312,74,14208,27520
train,6382,21,21504,192,36864,58368
train,6383,21,21504,192,36864,58368
train,6384,6,6144,16,3072,9216
train,6385,19,19456,157,30144,49600
train,6386,24,24576,251,48192,72768
train,6387,38,38912,629,120768,159680
train,6388,39,39936,663,127296,167232
train,6389,15,15360,98,18816,34176
train,6390,30,30720,392,75264,105984
train,6391,33,33792,474,91008,124800
train,6392,15,15360,98,18816,34176
train,6393,50,51200,1089,209088,260288
train,6394,7,7168,21,4032,11200
train,6395,29,29696,366,70272,99968
train,6396,12,12288,63,12096,24384
train,6397,29,29696,366,70272,99968
train,6398,16,16384,112,21504,37888
train,6399,11,11264,53,10176,21440
train,6400,42,43008,768,147456,190464
train,6401,28,28672,342,65664,94336
train,6402,11,11264,53,10176,21440
train,6403,9,9216,35,6720,15936
train,6404,13,13312,74,14208,27520
train,6405,10,10240,44,8448,18688
train,6406,7,7168,21,4032,11200
train,6407,11,11264,53,10176,21440
train,6408,8,8192,28,5376,13568
train,6409,28,28672,342,65664,94336
train,6410,38,38912,629,120768,159680
train,6411,15,15360,98,18816,34176
train,6412,33,33792,474,91008,124800
train,6413,25,25600,272,52224,77824
train,6414,19,19456,157,30144,49600
train,6415,31,31744,419,80448,112192
train,6416,34,34816,504,96768,131584
train,6417,24,24576,251,48192,72768
train,6418,17,17408,126,24192,41600
train,6419,17,17408,126,24192,41600
train,6420,24,24576,251,48192,72768
train,6421,18,18432,141,27072,45504
train,6422,18,18432,141,27072,45504
train,6423,8,8192,28,5376,13568
train,6424,14,14336,85,16320,30656
train,6425,18,18432,141,27072,45504
train,6426,26,26624,295,56640,83264
train,6427,35,35840,534,102528,138368
train,6428,20,20480,174,33408,53888
train,6429,8,8192,28,5376,13568
train,6430,20,20480,174,33408,53888
train,6431,18,18432,141,27072,45504
train,6432,6,6144,16,3072,9216
train,6433,38,38912,629,120768,159680
train,6434,13,13312,74,14208,27520
train,6435,23,23552,230,44160,67712
train,6436,28,28672,342,65664,94336
train,6437,21,21504,192,36864,58368
train,6438,45,46080,882,169344,215424
train,6439,44,45056,843,161856,206912
train,6440,31,31744,419,80448,112192
train,6441,24,24576,251,48192,72768
train,6442,17,17408,126,24192,41600
train,6443,45,46080,882,169344,215424
train,6444,12,12288,63,12096,24384
train,6445,9,9216,35,6720,15936
train,6446,5,5120,11,2112,7232
train,6447,8,8192,28,5376,13568
train,6448,24,24576,251,48192,72768
train,6449,27,27648,318,61056,88704
train,6450,25,25600,272,52224,77824
train,6451,10,10240,44,8448,18688
train,6452,29,29696,366,70272,99968
train,6453,16,16384,112,21504,37888
train,6454,5,5120,11,2112,7232
train,6455,14,14336,85,16320,30656
train,6456,23,23552,230,44160,67712
train,6457,14,14336,85,16320,30656
train,6458,35,35840,534,102528,138368
train,6459,24,24576,251,48192,72768
train,6460,16,16384,112,21504,37888
train,6461,12,12288,63,12096,24384
train,6462,24,24576,251,48192,72768
train,6463,6,6144,16,3072,9216
train,6464,17,17408,126,24192,41600
train,6465,12,12288,63,12096,24384
train,6466,15,15360,98,18816,34176
train,6467,47,48128,962,184704,232832
train,6468,11,11264,53,10176,21440
train,6469,24,24576,251,48192,72768
train,6470,33,33792,474,91008,124800
train,6471,25,25600,272,52224,77824
train,6472,12,12288,63,12096,24384
train,6473,9,9216,35,6720,15936
train,6474,9,9216,35,6720,15936
train,6475,50,51200,1089,209088,260288
train,6476,13,13312,74,14208,27520
train,6477,31,31744,419,80448,112192
train,6478,25,25600,272,52224,77824
train,6479,26,26624,295,56640,83264
train,6480,11,11264,53,10176,21440
train,6481,38,38912,629,120768,159680
train,6482,24,24576,251,48192,72768
train,6483,10,10240,44,8448,18688
train,6484,51,52224,1133,217536,269760
train,6485,23,23552,230,44160,67712
train,6486,24,24576,251,48192,72768
train,6487,41,41984,732,140544,182528
train,6488,16,16384,112,21504,37888
train,6489,4,4096,7,1344,5440
train,6490,22,22528,211,40512,63040
train,6491,39,39936,663,127296,167232
train,6492,28,28672,342,65664,94336
train,6493,44,45056,843,161856,206912
train,6494,19,19456,157,30144,49600
train,6495,22,22528,211,40512,63040
train,6496,37,37888,596,114432,152320
train,6497,26,26624,295,56640,83264
train,6498,17,17408,126,24192,41600
train,6499,49,50176,1046,200832,251008
train,6500,22,22528,211,40512,63040
train,6501,34,34816,504,96768,131584
train,6502,4,4096,7,1344,5440
train,6503,25,25600,272,52224,77824
train,6504,28,28672,342,65664,94336
train,6505,23,23552,230,44160,67712
train,6506,29,29696,366,70272,99968
train,6507,12,12288,63,12096,24384
train,6508,11,11264,53,10176,21440
train,6509,29,29696,366,70272,99968
train,6510,16,16384,112,21504,37888
train,6511,22,22528,211,40512,63040
train,6512,18,18432,141,27072,45504
train,6513,22,22528,211,40512,63040
train,6514,28,28672,342,65664,94336
train,6515,7,7168,21,4032,11200
train,6516,25,25600,272,52224,77824
train,6517,24,24576,251,48192,72768
train,6518,9,9216,35,6720,15936
train,6519,5,5120,11,2112,7232
train,6520,9,9216,35,6720,15936
train,6521,4,4096,7,1344,5440
train,6522,22,22528,211,40512,63040
train,6523,20,20480,174,33408,53888
train,6524,19,19456,157,30144,49600
train,6525,16,16384,112,21504,37888
train,6526,7,7168,21,4032,11200
train,6527,18,18432,141,27072,45504
train,6528,3,3072,4,768,3840
train,6529,16,16384,112,21504,37888
train,6530,18,18432,141,27072,45504
train,6531,26,26624,295,56640,83264
train,6532,19,19456,157,30144,49600
train,6533,17,17408,126,24192,41600
train,6534,36,36864,565,108480,145344
train,6535,19,19456,157,30144,49600
train,6536,19,19456,157,30144,49600
train,6537,29,29696,366,70272,99968
train,6538,46,47104,922,177024,224128
train,6539,7,7168,21,4032,11200
train,6540,27,27648,318,61056,88704
train,6541,23,23552,230,44160,67712
train,6542,9,9216,35,6720,15936
train,6543,22,22528,211,40512,63040
train,6544,32,32768,446,85632,118400
train,6545,38,38912,629,120768,159680
train,6546,13,13312,74,14208,27520
train,6547,27,27648,318,61056,88704
train,6548,36,36864,565,108480,145344
train,6549,14,14336,85,16320,30656
train,6550,12,12288,63,12096,24384
train,6551,11,11264,53,10176,21440
train,6552,4,4096,7,1344,5440
train,6553,23,23552,230,44160,67712
train,6554,22,22528,211,40512,63040
train,6555,13,13312,74,14208,27520
train,6556,18,18432,141,27072,45504
train,6557,14,14336,85,16320,30656
train,6558,17,17408,126,24192,41600
train,6559,38,38912,629,120768,159680
train,6560,11,11264,53,10176,21440
train,6561,9,9216,35,6720,15936
train,6562,6,6144,16,3072,9216
train,6563,4,4096,7,1344,5440
train,6564,7,7168,21,4032,11200
train,6565,6,6144,16,3072,9216
train,6566,40,40960,697,133824,174784
train,6567,34,34816,504,96768,131584
train,6568,28,28672,342,65664,94336
train,6569,18,18432,141,27072,45504
train,6570,49,50176,1046,200832,251008
train,6571,13,13312,74,14208,27520
train,6572,20,20480,174,33408,53888
train,6573,29,29696,366,70272,99968
train,6574,36,36864,565,108480,145344
train,6575,32,32768,446,85632,118400
train,6576,12,12288,63,12096,24384
train,6577,12,12288,63,12096,24384
train,6578,16,16384,112,21504,37888
train,6579,25,25600,272,52224,77824
train,6580,13,13312,74,14208,27520
train,6581,45,46080,882,169344,215424
train,6582,6,6144,16,3072,9216
train,6583,14,14336,85,16320,30656
train,6584,15,15360,98,18816,34176
train,6585,28,28672,342,65664,94336
train,6586,23,23552,230,44160,67712
train,6587,33,33792,474,91008,124800
train,6588,29,29696,366,70272,99968
train,6589,14,14336,85,16320,30656
train,6590,13,13312,74,14208,27520
train,6591,15,15360,98,18816,34176
train,6592,24,24576,251,48192,72768
train,6593,12,12288,63,12096,24384
train,6594,14,14336,85,16320,30656
train,6595,27,27648,318,61056,88704
train,6596,47,48128,962,184704,232832
train,6597,10,10240,44,8448,18688
train,6598,18,18432,141,27072,45504
train,6599,29,29696,366,70272,99968
train,6600,16,16384,112,21504,37888
train,6601,8,8192,28,5376,13568
train,6602,11,11264,53,10176,21440
train,6603,20,20480,174,33408,53888
train,6604,26,26624,295,56640,83264
train,6605,5,5120,11,2112,7232
train,6606,12,12288,63,12096,24384
train,6607,34,34816,504,96768,131584
train,6608,17,17408,126,24192,41600
train,6609,17,17408,126,24192,41600
train,6610,20,20480,174,33408,53888
train,6611,18,18432,141,27072,45504
train,6612,26,26624,295,56640,83264
train,6613,26,26624,295,56640,83264
train,6614,3,3072,4,768,3840
train,6615,17,17408,126,24192,41600
train,6616,16,16384,112,21504,37888
train,6617,19,19456,157,30144,49600
train,6618,38,38912,629,120768,159680
train,6619,28,28672,342,65664,94336
train,6620,20,20480,174,33408,53888
train,6621,21,21504,192,36864,58368
train,6622,24,24576,251,48192,72768
train,6623,31,31744,419,80448,112192
train,6624,8,8192,28,5376,13568
train,6625,19,19456,157,30144,49600
train,6626,18,18432,141,27072,45504
train,6627,39,39936,663,127296,167232
train,6628,20,20480,174,33408,53888
train,6629,5,5120,11,2112,7232
train,6630,32,32768,446,85632,118400
train,6631,14,14336,85,16320,30656
train,6632,26,26624,295,56640,83264
train,6633,14,14336,85,16320,30656
train,6634,19,19456,157,30144,49600
train,6635,24,24576,251,48192,72768
train,6636,24,24576,251,48192,72768
train,6637,19,19456,157,30144,49600
train,6638,4,4096,7,1344,5440
train,6639,15,15360,98,18816,34176
train,6640,6,6144,16,3072,9216
train,6641,17,17408,126,24192,41600
train,6642,45,46080,882,169344,215424
train,6643,10,10240,44,8448,18688
train,6644,23,23552,230,44160,67712
train,6645,9,9216,35,6720,15936
train,6646,41,41984,732,140544,182528
train,6647,37,37888,596,114432,152320
train,6648,35,35840,534,102528,138368
train,6649,24,24576,251,48192,72768
train,6650,25,25600,272,52224,77824
train,6651,12,12288,63,12096,24384
train,6652,30,30720,392,75264,105984
train,6653,27,27648,318,61056,88704
train,6654,12,12288,63,12096,24384
train,6655,25,25600,272,52224,77824
train,6656,30,30720,392,75264,105984
train,6657,23,23552,230,44160,67712
train,6658,14,14336,85,16320,30656
train,6659,26,26624,295,56640,83264
train,6660,27,27648,318,61056,88704
train,6661,11,11264,53,10176,21440
train,6662,12,12288,63,12096,24384
train,6663,30,30720,392,75264,105984
train,6664,22,22528,211,40512,63040
train,6665,11,11264,53,10176,21440
train,6666,12,12288,63,12096,24384
train,6667,7,7168,21,4032,11200
train,6668,34,34816,504,96768,131584
train,6669,29,29696,366,70272,99968
train,6670,27,27648,318,61056,88704
train,6671,32,32768,446,85632,118400
train,6672,18,18432,141,27072,45504
train,6673,39,39936,663,127296,167232
train,6674,13,13312,74,14208,27520
train,6675,12,12288,63,12096,24384
train,6676,7,7168,21,4032,11200
train,6677,18,18432,141,27072,45504
train,6678,25,25600,272,52224,77824
train,6679,24,24576,251,48192,72768
train,6680,28,28672,342,65664,94336
train,6681,20,20480,174,33408,53888
train,6682,22,22528,211,40512,63040
train,6683,55,56320,1318,253056,309376
train,6684,27,27648,318,61056,88704
train,6685,21,21504,192,36864,58368
train,6686,14,14336,85,16320,30656
train,6687,4,4096,7,1344,5440
train,6688,14,14336,85,16320,30656
train,6689,12,12288,63,12096,24384
train,6690,17,17408,126,24192,41600
train,6691,33,33792,474,91008,124800
train,6692,26,26624,295,56640,83264
train,6693,15,15360,98,18816,34176
train,6694,21,21504,192,36864,58368
train,6695,46,47104,922,177024,224128
train,6696,38,38912,629,120768,159680
train,6697,35,35840,534,102528,138368
train,6698,39,39936,663,127296,167232
train,6699,12,12288,63,12096,24384
train,6700,26,26624,295,56640,83264
train,6701,5,5120,11,2112,7232
train,6702,26,26624,295,56640,83264
train,6703,15,15360,98,18816,34176
train,6704,26,26624,295,56640,83264
train,6705,4,4096,7,1344,5440
train,6706,16,16384,112,21504,37888
train,6707,23,23552,230,44160,67712
train,6708,11,11264,53,10176,21440
train,6709,18,18432,141,27072,45504
train,6710,25,25600,272,52224,77824
train,6711,33,33792,474,91008,124800
train,6712,46,47104,922,177024,224128
train,6713,34,34816,504,96768,131584
train,6714,26,26624,295,56640,83264
train,6715,26,26624,295,56640,83264
train,6716,19,19456,157,30144,49600
train,6717,33,33792,474,91008,124800
train,6718,8,8192,28,5376,13568
train,6719,20,20480,174,33408,53888
train,6720,9,9216,35,6720,15936
train,6721,14,14336,85,16320,30656
train,6722,33,33792,474,91008,124800
train,6723,10,10240,44,8448,18688
train,6724,17,17408,126,24192,41600
train,6725,17,17408,126,24192,41600
train,6726,26,26624,295,56640,83264
train,6727,34,34816,504,96768,131584
train,6728,14,14336,85,16320,30656
train,6729,13,13312,74,14208,27520
train,6730,5,5120,11,2112,7232
train,6731,5,5120,11,2112,7232
train,6732,39,39936,663,127296,167232
train,6733,20,20480,174,33408,53888
train,6734,30,30720,392,75264,105984
train,6735,42,43008,768,147456,190464
train,6736,23,23552,230,44160,67712
train,6737,14,14336,85,16320,30656
train,6738,13,13312,74,14208,27520
train,6739,16,16384,112,21504,37888
train,6740,41,41984,732,140544,182528
train,6741,34,34816,504,96768,131584
train,6742,14,14336,85,16320,30656
train,6743,28,28672,342,65664,94336
train,6744,15,15360,98,18816,34176
train,6745,14,14336,85,16320,30656
train,6746,28,28672,342,65664,94336
train,6747,8,8192,28,5376,13568
train,6748,5,5120,11,2112,7232
train,6749,16,16384,112,21504,37888
train,6750,37,37888,596,114432,152320
train,6751,20,20480,174,33408,53888
train,6752,29,29696,366,70272,99968
train,6753,30,30720,392,75264,105984
train,6754,26,26624,295,56640,83264
train,6755,4,4096,7,1344,5440
train,6756,18,18432,141,27072,45504
train,6757,26,26624,295,56640,83264
train,6758,21,21504,192,36864,58368
train,6759,22,22528,211,40512,63040
train,6760,17,17408,126,24192,41600
train,6761,9,9216,35,6720,15936
train,6762,39,39936,663,127296,167232
train,6763,22,22528,211,40512,63040
train,6764,38,38912,629,120768,159680
train,6765,40,40960,697,133824,174784
train,6766,34,34816,504,96768,131584
train,6767,20,20480,174,33408,53888
train,6768,32,32768,446,85632,118400
train,6769,6,6144,16,3072,9216
train,6770,9,9216,35,6720,15936
train,6771,6,6144,16,3072,9216
train,6772,11,11264,53,10176,21440
train,6773,8,8192,28,5376,13568
train,6774,4,4096,7,1344,5440
train,6775,36,36864,565,108480,145344
train,6776,5,5120,11,2112,7232
train,6777,13,13312,74,14208,27520
train,6778,30,30720,392,75264,105984
train,6779,30,30720,392,75264,105984
train,6780,31,31744,419,80448,112192
train,6781,25,25600,272,52224,77824
train,6782,40,40960,697,133824,174784
train,6783,31,31744,419,80448,112192
train,6784,40,40960,697,133824,174784
train,6785,33,33792,474,91008,124800
train,6786,12,12288,63,12096,24384
train,6787,13,13312,74,14208,27520
train,6788,31,31744,419,80448,112192
train,6789,19,19456,157,30144,49600
train,6790,8,8192,28,5376,13568
train,6791,40,40960,697,133824,174784
train,6792,26,26624,295,56640,83264
train,6793,35,35840,534,102528,138368
train,6794,21,21504,192,36864,58368
train,6795,21,21504,192,36864,58368
train,6796,10,10240,44,8448,18688
train,6797,19,19456,157,30144,49600
train,6798,9,9216,35,6720,15936
train,6799,23,23552,230,44160,67712
train,6800,4,4096,7,1344,5440
train,6801,12,12288,63,12096,24384
train,6802,12,12288,63,12096,24384
train,6803,17,17408,126,24192,41600
train,6804,24,24576,251,48192,72768
train,6805,10,10240,44,8448,18688
train,6806,40,40960,697,133824,174784
train,6807,13,13312,74,14208,27520
train,6808,19,19456,157,30144,49600
train,6809,11,11264,53,10176,21440
train,6810,21,21504,192,36864,58368
train,6811,26,26624,295,56640,83264
train,6812,23,23552,230,44160,67712
train,6813,25,25600,272,52224,77824
train,6814,8,8192,28,5376,13568
train,6815,40,40960,697,133824,174784
train,6816,23,23552,230,44160,67712
train,6817,32,32768,446,85632,118400
train,6818,21,21504,192,36864,58368
train,6819,18,18432,141,27072,45504
train,6820,33,33792,474,91008,124800
train,6821,23,23552,230,44160,67712
train,6822,9,9216,35,6720,15936
train,6823,20,20480,174,33408,53888
train,6824,11,11264,53,10176,21440
train,6825,36,36864,565,108480,145344
train,6826,48,49152,1004,192768,241920
train,6827,26,26624,295,56640,83264
train,6828,9,9216,35,6720,15936
train,6829,34,34816,504,96768,131584
train,6830,31,31744,419,80448,112192
train,6831,11,11264,53,10176,21440
train,6832,25,25600,272,52224,77824
train,6833,40,40960,697,133824,174784
train,6834,47,48128,962,184704,232832
train,6835,19,19456,157,30144,49600
train,6836,25,25600,272,52224,77824
train,6837,16,16384,112,21504,37888
train,6838,21,21504,192,36864,58368
train,6839,21,21504,192,36864,58368
train,6840,7,7168,21,4032,11200
train,6841,13,13312,74,14208,27520
train,6842,26,26624,295,56640,83264
train,6843,8,8192,28,5376,13568
train,6844,21,21504,192,36864,58368
train,6845,29,29696,366,70272,99968
train,6846,24,24576,251,48192,72768
train,6847,35,35840,534,102528,138368
train,6848,15,15360,98,18816,34176
train,6849,28,28672,342,65664,94336
train,6850,42,43008,768,147456,190464
train,6851,35,35840,534,102528,138368
train,6852,22,22528,211,40512,63040
train,6853,18,18432,141,27072,45504
train,6854,15,15360,98,18816,34176
train,6855,24,24576,251,48192,72768
train,6856,19,19456,157,30144,49600
train,6857,23,23552,230,44160,67712
train,6858,18,18432,141,27072,45504
train,6859,18,18432,141,27072,45504
train,6860,28,28672,342,65664,94336
train,6861,23,23552,230,44160,67712
train,6862,23,23552,230,44160,67712
train,6863,16,16384,112,21504,37888
train,6864,34,34816,504,96768,131584
train,6865,40,40960,697,133824,174784
train,6866,28,28672,342,65664,94336
train,6867,33,33792,474,91008,124800
train,6868,46,47104,922,177024,224128
train,6869,21,21504,192,36864,58368
train,6870,23,23552,230,44160,67712
train,6871,16,16384,112,21504,37888
train,6872,23,23552,230,44160,67712
train,6873,19,19456,157,30144,49600
train,6874,15,15360,98,18816,34176
train,6875,28,28672,342,65664,94336
train,6876,40,40960,697,133824,174784
train,6877,21,21504,192,36864,58368
train,6878,27,27648,318,61056,88704
train,6879,7,7168,21,4032,11200
train,6880,16,16384,112,21504,37888
train,6881,38,38912,629,120768,159680
train,6882,12,12288,63,12096,24384
train,6883,17,17408,126,24192,41600
train,6884,22,22528,211,40512,63040
train,6885,24,24576,251,48192,72768
train,6886,30,30720,392,75264,105984
train,6887,29,29696,366,70272,99968
train,6888,33,33792,474,91008,124800
train,6889,42,43008,768,147456,190464
train,6890,18,18432,141,27072,45504
train,6891,32,32768,446,85632,118400
train,6892,14,14336,85,16320,30656
train,6893,18,18432,141,27072,45504
train,6894,22,22528,211,40512,63040
train,6895,10,10240,44,8448,18688
train,6896,21,21504,192,36864,58368
train,6897,26,26624,295,56640,83264
train,6898,35,35840,534,102528,138368
train,6899,27,27648,318,61056,88704
train,6900,22,22528,211,40512,63040
train,6901,10,10240,44,8448,18688
train,6902,13,13312,74,14208,27520
train,6903,20,20480,174,33408,53888
train,6904,29,29696,366,70272,99968
train,6905,14,14336,85,16320,30656
train,6906,8,8192,28,5376,13568
train,6907,25,25600,272,52224,77824
train,6908,15,15360,98,18816,34176
train,6909,15,15360,98,18816,34176
train,6910,11,11264,53,10176,21440
train,6911,20,20480,174,33408,53888
train,6912,22,22528,211,40512,63040
train,6913,15,15360,98,18816,34176
train,6914,18,18432,141,27072,45504
train,6915,30,30720,392,75264,105984
train,6916,23,23552,230,44160,67712
train,6917,12,12288,63,12096,24384
train,6918,20,20480,174,33408,53888
train,6919,35,35840,534,102528,138368
validation,0,23,23552,230,44160,67712
validation,1,36,36864,565,108480,145344
validation,2,32,32768,446,85632,118400
validation,3,33,33792,474,91008,124800
validation,4,27,27648,318,61056,88704
validation,5,23,23552,230,44160,67712
validation,6,17,17408,126,24192,41600
validation,7,22,22528,211,40512,63040
validation,8,20,20480,174,33408,53888
validation,9,32,32768,446,85632,118400
validation,10,27,27648,318,61056,88704
validation,11,14,14336,85,16320,30656
validation,12,23,23552,230,44160,67712
validation,13,52,53248,1178,226176,279424
validation,14,24,24576,251,48192,72768
validation,15,17,17408,126,24192,41600
validation,16,11,11264,53,10176,21440
validation,17,10,10240,44,8448,18688
validation,18,23,23552,230,44160,67712
validation,19,11,11264,53,10176,21440
validation,20,36,36864,565,108480,145344
validation,21,30,30720,392,75264,105984
validation,22,10,10240,44,8448,18688
validation,23,7,7168,21,4032,11200
validation,24,28,28672,342,65664,94336
validation,25,47,48128,962,184704,232832
validation,26,13,13312,74,14208,27520
validation,27,14,14336,85,16320,30656
validation,28,42,43008,768,147456,190464
validation,29,18,18432,141,27072,45504
validation,30,16,16384,112,21504,37888
validation,31,53,54272,1224,235008,289280
validation,32,20,20480,174,33408,53888
validation,33,37,37888,596,114432,152320
validation,34,19,19456,157,30144,49600
validation,35,38,38912,629,120768,159680
validation,36,28,28672,342,65664,94336
validation,37,22,22528,211,40512,63040
validation,38,20,20480,174,33408,53888
validation,39,28,28672,342,65664,94336
validation,40,35,35840,534,102528,138368
validation,41,13,13312,74,14208,27520
validation,42,33,33792,474,91008,124800
validation,43,12,12288,63,12096,24384
validation,44,31,31744,419,80448,112192
validation,45,34,34816,504,96768,131584
validation,46,18,18432,141,27072,45504
validation,47,13,13312,74,14208,27520
validation,48,6,6144,16,3072,9216
validation,49,13,13312,74,14208,27520
validation,50,25,25600,272,52224,77824
validation,51,33,33792,474,91008,124800
validation,52,19,19456,157,30144,49600
validation,53,10,10240,44,8448,18688
validation,54,20,20480,174,33408,53888
validation,55,23,23552,230,44160,67712
validation,56,20,20480,174,33408,53888
validation,57,19,19456,157,30144,49600
validation,58,14,14336,85,16320,30656
validation,59,19,19456,157,30144,49600
validation,60,5,5120,11,2112,7232
validation,61,14,14336,85,16320,30656
validation,62,13,13312,74,14208,27520
validation,63,20,20480,174,33408,53888
validation,64,11,11264,53,10176,21440
validation,65,24,24576,251,48192,72768
validation,66,32,32768,446,85632,118400
validation,67,6,6144,16,3072,9216
validation,68,11,11264,53,10176,21440
validation,69,32,32768,446,85632,118400
validation,70,17,17408,126,24192,41600
validation,71,29,29696,366,70272,99968
validation,72,18,18432,141,27072,45504
validation,73,26,26624,295,56640,83264
validation,74,28,28672,342,65664,94336
validation,75,15,15360,98,18816,34176
validation,76,32,32768,446,85632,118400
validation,77,26,26624,295,56640,83264
validation,78,17,17408,126,24192,41600
validation,79,29,29696,366,70272,99968
validation,80,43,44032,805,154560,198592
validation,81,15,15360,98,18816,34176
validation,82,20,20480,174,33408,53888
validation,83,40,40960,697,133824,174784
validation,84,34,34816,504,96768,131584
validation,85,23,23552,230,44160,67712
validation,86,14,14336,85,16320,30656
validation,87,23,23552,230,44160,67712
validation,88,15,15360,98,18816,34176
validation,89,34,34816,504,96768,131584
validation,90,10,10240,44,8448,18688
validation,91,27,27648,318,61056,88704
validation,92,25,25600,272,52224,77824
validation,93,18,18432,141,27072,45504
validation,94,26,26624,295,56640,83264
validation,95,33,33792,474,91008,124800
validation,96,49,50176,1046,200832,251008
validation,97,29,29696,366,70272,99968
validation,98,20,20480,174,33408,53888
validation,99,18,18432,141,27072,45504
validation,100,39,39936,663,127296,167232
validation,101,17,17408,126,24192,41600
validation,102,21,21504,192,36864,58368
validation,103,44,45056,843,161856,206912
validation,104,22,22528,211,40512,63040
validation,105,16,16384,112,21504,37888
validation,106,27,27648,318,61056,88704
validation,107,44,45056,843,161856,206912
validation,108,12,12288,63,12096,24384
validation,109,21,21504,192,36864,58368
validation,110,28,28672,342,65664,94336
validation,111,33,33792,474,91008,124800
validation,112,29,29696,366,70272,99968
validation,113,24,24576,251,48192,72768
validation,114,33,33792,474,91008,124800
validation,115,6,6144,16,3072,9216
validation,116,40,40960,697,133824,174784
validation,117,29,29696,366,70272,99968
validation,118,20,20480,174,33408,53888
validation,119,18,18432,141,27072,45504
validation,120,25,25600,272,52224,77824
validation,121,34,34816,504,96768,131584
validation,122,29,29696,366,70272,99968
validation,123,10,10240,44,8448,18688
validation,124,34,34816,504,96768,131584
validation,125,10,10240,44,8448,18688
validation,126,21,21504,192,36864,58368
validation,127,25,25600,272,52224,77824
validation,128,43,44032,805,154560,198592
validation,129,34,34816,504,96768,131584
validation,130,32,32768,446,85632,118400
validation,131,28,28672,342,65664,94336
validation,132,41,41984,732,140544,182528
validation,133,46,47104,922,177024,224128
validation,134,27,27648,318,61056,88704
validation,135,27,27648,318,61056,88704
validation,136,21,21504,192,36864,58368
validation,137,42,43008,768,147456,190464
validation,138,27,27648,318,61056,88704
validation,139,15,15360,98,18816,34176
validation,140,34,34816,504,96768,131584
validation,141,44,45056,843,161856,206912
validation,142,31,31744,419,80448,112192
validation,143,19,19456,157,30144,49600
validation,144,18,18432,141,27072,45504
validation,145,37,37888,596,114432,152320
validation,146,35,35840,534,102528,138368
validation,147,26,26624,295,56640,83264
validation,148,32,32768,446,85632,118400
validation,149,17,17408,126,24192,41600
validation,150,40,40960,697,133824,174784
validation,151,25,25600,272,52224,77824
validation,152,9,9216,35,6720,15936
validation,153,12,12288,63,12096,24384
validation,154,21,21504,192,36864,58368
validation,155,7,7168,21,4032,11200
validation,156,10,10240,44,8448,18688
validation,157,25,25600,272,52224,77824
validation,158,25,25600,272,52224,77824
validation,159,11,11264,53,10176,21440
validation,160,14,14336,85,16320,30656
validation,161,19,19456,157,30144,49600
validation,162,21,21504,192,36864,58368
validation,163,32,32768,446,85632,118400
validation,164,9,9216,35,6720,15936
validation,165,18,18432,141,27072,45504
validation,166,29,29696,366,70272,99968
validation,167,27,27648,318,61056,88704
validation,168,10,10240,44,8448,18688
validation,169,9,9216,35,6720,15936
validation,170,18,18432,141,27072,45504
validation,171,21,21504,192,36864,58368
validation,172,23,23552,230,44160,67712
validation,173,23,23552,230,44160,67712
validation,174,22,22528,211,40512,63040
validation,175,44,45056,843,161856,206912
validation,176,9,9216,35,6720,15936
validation,177,23,23552,230,44160,67712
validation,178,33,33792,474,91008,124800
validation,179,22,22528,211,40512,63040
validation,180,24,24576,251,48192,72768
validation,181,33,33792,474,91008,124800
validation,182,19,19456,157,30144,49600
validation,183,18,18432,141,27072,45504
validation,184,27,27648,318,61056,88704
validation,185,9,9216,35,6720,15936
validation,186,22,22528,211,40512,63040
validation,187,33,33792,474,91008,124800
validation,188,20,20480,174,33408,53888
validation,189,14,14336,85,16320,30656
validation,190,36,36864,565,108480,145344
validation,191,25,25600,272,52224,77824
validation,192,31,31744,419,80448,112192
validation,193,16,16384,112,21504,37888
validation,194,15,15360,98,18816,34176
validation,195,9,9216,35,6720,15936
validation,196,12,12288,63,12096,24384
validation,197,19,19456,157,30144,49600
validation,198,41,41984,732,140544,182528
validation,199,17,17408,126,24192,41600
validation,200,33,33792,474,91008,124800
validation,201,34,34816,504,96768,131584
validation,202,8,8192,28,5376,13568
validation,203,9,9216,35,6720,15936
validation,204,25,25600,272,52224,77824
validation,205,17,17408,126,24192,41600
validation,206,16,16384,112,21504,37888
validation,207,31,31744,419,80448,112192
validation,208,45,46080,882,169344,215424
validation,209,3,3072,4,768,3840
validation,210,19,19456,157,30144,49600
validation,211,10,10240,44,8448,18688
validation,212,13,13312,74,14208,27520
validation,213,28,28672,342,65664,94336
validation,214,23,23552,230,44160,67712
validation,215,10,10240,44,8448,18688
validation,216,34,34816,504,96768,131584
validation,217,37,37888,596,114432,152320
validation,218,27,27648,318,61056,88704
validation,219,25,25600,272,52224,77824
validation,220,21,21504,192,36864,58368
validation,221,17,17408,126,24192,41600
validation,222,20,20480,174,33408,53888
validation,223,37,37888,596,114432,152320
validation,224,43,44032,805,154560,198592
validation,225,23,23552,230,44160,67712
validation,226,24,24576,251,48192,72768
validation,227,20,20480,174,33408,53888
validation,228,36,36864,565,108480,145344
validation,229,17,17408,126,24192,41600
validation,230,23,23552,230,44160,67712
validation,231,12,12288,63,12096,24384
validation,232,6,6144,16,3072,9216
validation,233,23,23552,230,44160,67712
validation,234,9,9216,35,6720,15936
validation,235,23,23552,230,44160,67712
validation,236,26,26624,295,56640,83264
validation,237,21,21504,192,36864,58368
validation,238,13,13312,74,14208,27520
validation,239,20,20480,174,33408,53888
validation,240,14,14336,85,16320,30656
validation,241,14,14336,85,16320,30656
validation,242,13,13312,74,14208,27520
validation,243,7,7168,21,4032,11200
validation,244,9,9216,35,6720,15936
validation,245,25,25600,272,52224,77824
validation,246,8,8192,28,5376,13568
validation,247,17,17408,126,24192,41600
validation,248,17,17408,126,24192,41600
validation,249,46,47104,922,177024,224128
validation,250,18,18432,141,27072,45504
validation,251,35,35840,534,102528,138368
validation,252,25,25600,272,52224,77824
validation,253,37,37888,596,114432,152320
validation,254,24,24576,251,48192,72768
validation,255,14,14336,85,16320,30656
validation,256,13,13312,74,14208,27520
validation,257,45,46080,882,169344,215424
validation,258,16,16384,112,21504,37888
validation,259,25,25600,272,52224,77824
validation,260,35,35840,534,102528,138368
validation,261,19,19456,157,30144,49600
validation,262,26,26624,295,56640,83264
validation,263,18,18432,141,27072,45504
validation,264,17,17408,126,24192,41600
validation,265,8,8192,28,5376,13568
validation,266,33,33792,474,91008,124800
validation,267,19,19456,157,30144,49600
validation,268,22,22528,211,40512,63040
validation,269,26,26624,295,56640,83264
validation,270,23,23552,230,44160,67712
validation,271,11,11264,53,10176,21440
validation,272,18,18432,141,27072,45504
validation,273,19,19456,157,30144,49600
validation,274,7,7168,21,4032,11200
validation,275,8,8192,28,5376,13568
validation,276,27,27648,318,61056,88704
validation,277,29,29696,366,70272,99968
validation,278,42,43008,768,147456,190464
validation,279,21,21504,192,36864,58368
validation,280,16,16384,112,21504,37888
validation,281,36,36864,565,108480,145344
validation,282,26,26624,295,56640,83264
validation,283,9,9216,35,6720,15936
validation,284,17,17408,126,24192,41600
validation,285,40,40960,697,133824,174784
validation,286,12,12288,63,12096,24384
validation,287,17,17408,126,24192,41600
validation,288,28,28672,342,65664,94336
validation,289,25,25600,272,52224,77824
validation,290,23,23552,230,44160,67712
validation,291,19,19456,157,30144,49600
validation,292,8,8192,28,5376,13568
validation,293,12,12288,63,12096,24384
validation,294,27,27648,318,61056,88704
validation,295,33,33792,474,91008,124800
validation,296,29,29696,366,70272,99968
validation,297,10,10240,44,8448,18688
validation,298,16,16384,112,21504,37888
validation,299,22,22528,211,40512,63040
validation,300,12,12288,63,12096,24384
validation,301,24,24576,251,48192,72768
validation,302,11,11264,53,10176,21440
validation,303,32,32768,446,85632,118400
validation,304,28,28672,342,65664,94336
validation,305,7,7168,21,4032,11200
validation,306,18,18432,141,27072,45504
validation,307,20,20480,174,33408,53888
validation,308,38,38912,629,120768,159680
validation,309,13,13312,74,14208,27520
validation,310,14,14336,85,16320,30656
validation,311,26,26624,295,56640,83264
validation,312,24,24576,251,48192,72768
validation,313,17,17408,126,24192,41600
validation,314,21,21504,192,36864,58368
validation,315,19,19456,157,30144,49600
validation,316,15,15360,98,18816,34176
validation,317,24,24576,251,48192,72768
validation,318,24,24576,251,48192,72768
validation,319,25,25600,272,52224,77824
validation,320,35,35840,534,102528,138368
validation,321,14,14336,85,16320,30656
validation,322,10,10240,44,8448,18688
validation,323,19,19456,157,30144,49600
validation,324,16,16384,112,21504,37888
validation,325,29,29696,366,70272,99968
validation,326,36,36864,565,108480,145344
validation,327,14,14336,85,16320,30656
validation,328,14,14336,85,16320,30656
validation,329,14,14336,85,16320,30656
validation,330,18,18432,141,27072,45504
validation,331,24,24576,251,48192,72768
validation,332,22,22528,211,40512,63040
validation,333,19,19456,157,30144,49600
validation,334,27,27648,318,61056,88704
validation,335,26,26624,295,56640,83264
validation,336,29,29696,366,70272,99968
validation,337,16,16384,112,21504,37888
validation,338,39,39936,663,127296,167232
validation,339,40,40960,697,133824,174784
validation,340,7,7168,21,4032,11200
validation,341,23,23552,230,44160,67712
validation,342,26,26624,295,56640,83264
validation,343,28,28672,342,65664,94336
validation,344,11,11264,53,10176,21440
validation,345,25,25600,272,52224,77824
validation,346,10,10240,44,8448,18688
validation,347,14,14336,85,16320,30656
validation,348,9,9216,35,6720,15936
validation,349,19,19456,157,30144,49600
validation,350,24,24576,251,48192,72768
validation,351,21,21504,192,36864,58368
validation,352,23,23552,230,44160,67712
validation,353,14,14336,85,16320,30656
validation,354,13,13312,74,14208,27520
validation,355,2,2048,2,384,2432
validation,356,6,6144,16,3072,9216
validation,357,35,35840,534,102528,138368
validation,358,15,15360,98,18816,34176
validation,359,32,32768,446,85632,118400
validation,360,22,22528,211,40512,63040
validation,361,8,8192,28,5376,13568
validation,362,38,38912,629,120768,159680
validation,363,23,23552,230,44160,67712
validation,364,17,17408,126,24192,41600
validation,365,43,44032,805,154560,198592
validation,366,8,8192,28,5376,13568
validation,367,51,52224,1133,217536,269760
validation,368,9,9216,35,6720,15936
validation,369,27,27648,318,61056,88704
validation,370,16,16384,112,21504,37888
validation,371,26,26624,295,56640,83264
validation,372,28,28672,342,65664,94336
validation,373,32,32768,446,85632,118400
validation,374,23,23552,230,44160,67712
validation,375,39,39936,663,127296,167232
validation,376,24,24576,251,48192,72768
validation,377,28,28672,342,65664,94336
validation,378,5,5120,11,2112,7232
validation,379,20,20480,174,33408,53888
validation,380,34,34816,504,96768,131584
validation,381,26,26624,295,56640,83264
validation,382,43,44032,805,154560,198592
validation,383,20,20480,174,33408,53888
validation,384,18,18432,141,27072,45504
validation,385,45,46080,882,169344,215424
validation,386,15,15360,98,18816,34176
validation,387,14,14336,85,16320,30656
validation,388,6,6144,16,3072,9216
validation,389,20,20480,174,33408,53888
validation,390,13,13312,74,14208,27520
validation,391,22,22528,211,40512,63040
validation,392,6,6144,16,3072,9216
validation,393,33,33792,474,91008,124800
validation,394,26,26624,295,56640,83264
validation,395,31,31744,419,80448,112192
validation,396,20,20480,174,33408,53888
validation,397,13,13312,74,14208,27520
validation,398,24,24576,251,48192,72768
validation,399,7,7168,21,4032,11200
validation,400,6,6144,16,3072,9216
validation,401,37,37888,596,114432,152320
validation,402,28,28672,342,65664,94336
validation,403,28,28672,342,65664,94336
validation,404,27,27648,318,61056,88704
validation,405,20,20480,174,33408,53888
validation,406,13,13312,74,14208,27520
validation,407,17,17408,126,24192,41600
validation,408,27,27648,318,61056,88704
validation,409,6,6144,16,3072,9216
validation,410,18,18432,141,27072,45504
validation,411,32,32768,446,85632,118400
validation,412,22,22528,211,40512,63040
validation,413,7,7168,21,4032,11200
validation,414,13,13312,74,14208,27520
validation,415,37,37888,596,114432,152320
validation,416,34,34816,504,96768,131584
validation,417,11,11264,53,10176,21440
validation,418,26,26624,295,56640,83264
validation,419,17,17408,126,24192,41600
validation,420,35,35840,534,102528,138368
validation,421,25,25600,272,52224,77824
validation,422,36,36864,565,108480,145344
validation,423,32,32768,446,85632,118400
validation,424,28,28672,342,65664,94336
validation,425,11,11264,53,10176,21440
validation,426,33,33792,474,91008,124800
validation,427,25,25600,272,52224,77824
validation,428,50,51200,1089,209088,260288
validation,429,17,17408,126,24192,41600
validation,430,30,30720,392,75264,105984
validation,431,22,22528,211,40512,63040
validation,432,9,9216,35,6720,15936
validation,433,19,19456,157,30144,49600
validation,434,15,15360,98,18816,34176
validation,435,24,24576,251,48192,72768
validation,436,14,14336,85,16320,30656
validation,437,24,24576,251,48192,72768
validation,438,15,15360,98,18816,34176
validation,439,18,18432,141,27072,45504
validation,440,11,11264,53,10176,21440
validation,441,21,21504,192,36864,58368
validation,442,8,8192,28,5376,13568
validation,443,22,22528,211,40512,63040
validation,444,37,37888,596,114432,152320
validation,445,37,37888,596,114432,152320
validation,446,17,17408,126,24192,41600
validation,447,13,13312,74,14208,27520
validation,448,14,14336,85,16320,30656
validation,449,7,7168,21,4032,11200
validation,450,36,36864,565,108480,145344
validation,451,31,31744,419,80448,112192
validation,452,33,33792,474,91008,124800
validation,453,36,36864,565,108480,145344
validation,454,19,19456,157,30144,49600
validation,455,14,14336,85,16320,30656
validation,456,24,24576,251,48192,72768
validation,457,10,10240,44,8448,18688
validation,458,24,24576,251,48192,72768
validation,459,34,34816,504,96768,131584
validation,460,15,15360,98,18816,34176
validation,461,15,15360,98,18816,34176
validation,462,36,36864,565,108480,145344
validation,463,22,22528,211,40512,63040
validation,464,16,16384,112,21504,37888
validation,465,22,22528,211,40512,63040
validation,466,22,22528,211,40512,63040
validation,467,13,13312,74,14208,27520
validation,468,9,9216,35,6720,15936
validation,469,32,32768,446,85632,118400
validation,470,34,34816,504,96768,131584
validation,471,27,27648,318,61056,88704
validation,472,10,10240,44,8448,18688
validation,473,22,22528,211,40512,63040
validation,474,29,29696,366,70272,99968
validation,475,22,22528,211,40512,63040
validation,476,29,29696,366,70272,99968
validation,477,34,34816,504,96768,131584
validation,478,25,25600,272,52224,77824
validation,479,22,22528,211,40512,63040
validation,480,28,28672,342,65664,94336
validation,481,30,30720,392,75264,105984
validation,482,7,7168,21,4032,11200
validation,483,26,26624,295,56640,83264
validation,484,40,40960,697,133824,174784
validation,485,23,23552,230,44160,67712
validation,486,9,9216,35,6720,15936
validation,487,31,31744,419,80448,112192
validation,488,11,11264,53,10176,21440
validation,489,23,23552,230,44160,67712
validation,490,17,17408,126,24192,41600
validation,491,8,8192,28,5376,13568
validation,492,24,24576,251,48192,72768
validation,493,19,19456,157,30144,49600
validation,494,21,21504,192,36864,58368
validation,495,16,16384,112,21504,37888
validation,496,34,34816,504,96768,131584
validation,497,15,15360,98,18816,34176
validation,498,34,34816,504,96768,131584
validation,499,36,36864,565,108480,145344
validation,500,23,23552,230,44160,67712
validation,501,26,26624,295,56640,83264
validation,502,10,10240,44,8448,18688
validation,503,21,21504,192,36864,58368
validation,504,27,27648,318,61056,88704
validation,505,24,24576,251,48192,72768
validation,506,10,10240,44,8448,18688
validation,507,25,25600,272,52224,77824
validation,508,20,20480,174,33408,53888
validation,509,39,39936,663,127296,167232
validation,510,21,21504,192,36864,58368
validation,511,23,23552,230,44160,67712
validation,512,21,21504,192,36864,58368
validation,513,14,14336,85,16320,30656
validation,514,26,26624,295,56640,83264
validation,515,9,9216,35,6720,15936
validation,516,15,15360,98,18816,34176
validation,517,15,15360,98,18816,34176
validation,518,19,19456,157,30144,49600
validation,519,49,50176,1046,200832,251008
validation,520,36,36864,565,108480,145344
validation,521,11,11264,53,10176,21440
validation,522,30,30720,392,75264,105984
validation,523,33,33792,474,91008,124800
validation,524,29,29696,366,70272,99968
validation,525,22,22528,211,40512,63040
validation,526,25,25600,272,52224,77824
validation,527,8,8192,28,5376,13568
validation,528,20,20480,174,33408,53888
validation,529,19,19456,157,30144,49600
validation,530,27,27648,318,61056,88704
validation,531,23,23552,230,44160,67712
validation,532,45,46080,882,169344,215424
validation,533,37,37888,596,114432,152320
validation,534,24,24576,251,48192,72768
validation,535,29,29696,366,70272,99968
validation,536,26,26624,295,56640,83264
validation,537,30,30720,392,75264,105984
validation,538,15,15360,98,18816,34176
validation,539,18,18432,141,27072,45504
validation,540,25,25600,272,52224,77824
validation,541,19,19456,157,30144,49600
validation,542,15,15360,98,18816,34176
validation,543,13,13312,74,14208,27520
validation,544,17,17408,126,24192,41600
validation,545,18,18432,141,27072,45504
validation,546,23,23552,230,44160,67712
validation,547,13,13312,74,14208,27520
validation,548,7,7168,21,4032,11200
validation,549,36,36864,565,108480,145344
validation,550,16,16384,112,21504,37888
validation,551,34,34816,504,96768,131584
validation,552,19,19456,157,30144,49600
validation,553,30,30720,392,75264,105984
validation,554,26,26624,295,56640,83264
validation,555,36,36864,565,108480,145344
validation,556,40,40960,697,133824,174784
validation,557,37,37888,596,114432,152320
validation,558,23,23552,230,44160,67712
validation,559,17,17408,126,24192,41600
validation,560,28,28672,342,65664,94336
validation,561,19,19456,157,30144,49600
validation,562,31,31744,419,80448,112192
validation,563,20,20480,174,33408,53888
validation,564,2,2048,2,384,2432
validation,565,10,10240,44,8448,18688
validation,566,14,14336,85,16320,30656
validation,567,13,13312,74,14208,27520
validation,568,22,22528,211,40512,63040
validation,569,35,35840,534,102528,138368
validation,570,16,16384,112,21504,37888
validation,571,18,18432,141,27072,45504
validation,572,13,13312,74,14208,27520
validation,573,30,30720,392,75264,105984
validation,574,19,19456,157,30144,49600
validation,575,25,25600,272,52224,77824
validation,576,27,27648,318,61056,88704
validation,577,5,5120,11,2112,7232
validation,578,28,28672,342,65664,94336
validation,579,19,19456,157,30144,49600
validation,580,28,28672,342,65664,94336
validation,581,6,6144,16,3072,9216
validation,582,46,47104,922,177024,224128
validation,583,22,22528,211,40512,63040
validation,584,31,31744,419,80448,112192
validation,585,13,13312,74,14208,27520
validation,586,24,24576,251,48192,72768
validation,587,44,45056,843,161856,206912
validation,588,14,14336,85,16320,30656
validation,589,6,6144,16,3072,9216
validation,590,25,25600,272,52224,77824
validation,591,20,20480,174,33408,53888
validation,592,23,23552,230,44160,67712
validation,593,13,13312,74,14208,27520
validation,594,20,20480,174,33408,53888
validation,595,10,10240,44,8448,18688
validation,596,9,9216,35,6720,15936
validation,597,13,13312,74,14208,27520
validation,598,20,20480,174,33408,53888
validation,599,5,5120,11,2112,7232
validation,600,29,29696,366,70272,99968
validation,601,34,34816,504,96768,131584
validation,602,10,10240,44,8448,18688
validation,603,24,24576,251,48192,72768
validation,604,27,27648,318,61056,88704
validation,605,21,21504,192,36864,58368
validation,606,15,15360,98,18816,34176
validation,607,27,27648,318,61056,88704
validation,608,28,28672,342,65664,94336
validation,609,34,34816,504,96768,131584
validation,610,25,25600,272,52224,77824
validation,611,29,29696,366,70272,99968
validation,612,33,33792,474,91008,124800
validation,613,15,15360,98,18816,34176
validation,614,11,11264,53,10176,21440
validation,615,38,38912,629,120768,159680
validation,616,21,21504,192,36864,58368
validation,617,33,33792,474,91008,124800
validation,618,15,15360,98,18816,34176
validation,619,11,11264,53,10176,21440
validation,620,23,23552,230,44160,67712
validation,621,10,10240,44,8448,18688
validation,622,21,21504,192,36864,58368
validation,623,25,25600,272,52224,77824
validation,624,24,24576,251,48192,72768
validation,625,13,13312,74,14208,27520
validation,626,45,46080,882,169344,215424
validation,627,30,30720,392,75264,105984
validation,628,10,10240,44,8448,18688
validation,629,29,29696,366,70272,99968
validation,630,12,12288,63,12096,24384
validation,631,33,33792,474,91008,124800
validation,632,32,32768,446,85632,118400
validation,633,17,17408,126,24192,41600
validation,634,19,19456,157,30144,49600
validation,635,8,8192,28,5376,13568
validation,636,9,9216,35,6720,15936
validation,637,25,25600,272,52224,77824
validation,638,28,28672,342,65664,94336
validation,639,35,35840,534,102528,138368
validation,640,33,33792,474,91008,124800
validation,641,24,24576,251,48192,72768
validation,642,29,29696,366,70272,99968
validation,643,12,12288,63,12096,24384
validation,644,32,32768,446,85632,118400
validation,645,19,19456,157,30144,49600
validation,646,37,37888,596,114432,152320
validation,647,18,18432,141,27072,45504
validation,648,8,8192,28,5376,13568
validation,649,36,36864,565,108480,145344
validation,650,32,32768,446,85632,118400
validation,651,30,30720,392,75264,105984
validation,652,42,43008,768,147456,190464
validation,653,7,7168,21,4032,11200
validation,654,25,25600,272,52224,77824
validation,655,29,29696,366,70272,99968
validation,656,22,22528,211,40512,63040
validation,657,51,52224,1133,217536,269760
validation,658,16,16384,112,21504,37888
validation,659,41,41984,732,140544,182528
validation,660,33,33792,474,91008,124800
validation,661,50,51200,1089,209088,260288
validation,662,29,29696,366,70272,99968
validation,663,29,29696,366,70272,99968
validation,664,31,31744,419,80448,112192
validation,665,31,31744,419,80448,112192
validation,666,19,19456,157,30144,49600
validation,667,13,13312,74,14208,27520
validation,668,25,25600,272,52224,77824
validation,669,33,33792,474,91008,124800
validation,670,17,17408,126,24192,41600
validation,671,22,22528,211,40512,63040
validation,672,7,7168,21,4032,11200
validation,673,7,7168,21,4032,11200
validation,674,22,22528,211,40512,63040
validation,675,39,39936,663,127296,167232
validation,676,24,24576,251,48192,72768
validation,677,41,41984,732,140544,182528
validation,678,25,25600,272,52224,77824
validation,679,15,15360,98,18816,34176
validation,680,11,11264,53,10176,21440
validation,681,26,26624,295,56640,83264
validation,682,38,38912,629,120768,159680
validation,683,31,31744,419,80448,112192
validation,684,33,33792,474,91008,124800
validation,685,35,35840,534,102528,138368
validation,686,23,23552,230,44160,67712
validation,687,13,13312,74,14208,27520
validation,688,11,11264,53,10176,21440
validation,689,10,10240,44,8448,18688
validation,690,18,18432,141,27072,45504
validation,691,17,17408,126,24192,41600
validation,692,16,16384,112,21504,37888
validation,693,24,24576,251,48192,72768
validation,694,9,9216,35,6720,15936
validation,695,30,30720,392,75264,105984
validation,696,30,30720,392,75264,105984
validation,697,25,25600,272,52224,77824
validation,698,27,27648,318,61056,88704
validation,699,14,14336,85,16320,30656
validation,700,4,4096,7,1344,5440
validation,701,36,36864,565,108480,145344
validation,702,16,16384,112,21504,37888
validation,703,23,23552,230,44160,67712
validation,704,17,17408,126,24192,41600
validation,705,10,10240,44,8448,18688
validation,706,19,19456,157,30144,49600
validation,707,26,26624,295,56640,83264
validation,708,23,23552,230,44160,67712
validation,709,15,15360,98,18816,34176
validation,710,10,10240,44,8448,18688
validation,711,16,16384,112,21504,37888
validation,712,24,24576,251,48192,72768
validation,713,30,30720,392,75264,105984
validation,714,12,12288,63,12096,24384
validation,715,23,23552,230,44160,67712
validation,716,19,19456,157,30144,49600
validation,717,28,28672,342,65664,94336
validation,718,22,22528,211,40512,63040
validation,719,41,41984,732,140544,182528
validation,720,19,19456,157,30144,49600
validation,721,18,18432,141,27072,45504
validation,722,24,24576,251,48192,72768
validation,723,12,12288,63,12096,24384
validation,724,20,20480,174,33408,53888
validation,725,12,12288,63,12096,24384
validation,726,44,45056,843,161856,206912
validation,727,29,29696,366,70272,99968
validation,728,9,9216,35,6720,15936
validation,729,27,27648,318,61056,88704
validation,730,21,21504,192,36864,58368
validation,731,22,22528,211,40512,63040
validation,732,22,22528,211,40512,63040
validation,733,36,36864,565,108480,145344
validation,734,4,4096,7,1344,5440
validation,735,29,29696,366,70272,99968
validation,736,6,6144,16,3072,9216
validation,737,18,18432,141,27072,45504
validation,738,21,21504,192,36864,58368
validation,739,15,15360,98,18816,34176
validation,740,17,17408,126,24192,41600
validation,741,40,40960,697,133824,174784
validation,742,25,25600,272,52224,77824
validation,743,8,8192,28,5376,13568
validation,744,41,41984,732,140544,182528
validation,745,46,47104,922,177024,224128
validation,746,37,37888,596,114432,152320
validation,747,25,25600,272,52224,77824
validation,748,30,30720,392,75264,105984
validation,749,32,32768,446,85632,118400
validation,750,23,23552,230,44160,67712
validation,751,26,26624,295,56640,83264
validation,752,9,9216,35,6720,15936
validation,753,33,33792,474,91008,124800
validation,754,24,24576,251,48192,72768
validation,755,38,38912,629,120768,159680
validation,756,18,18432,141,27072,45504
validation,757,16,16384,112,21504,37888
validation,758,24,24576,251,48192,72768
validation,759,13,13312,74,14208,27520
validation,760,18,18432,141,27072,45504
validation,761,25,25600,272,52224,77824
validation,762,11,11264,53,10176,21440
validation,763,35,35840,534,102528,138368
validation,764,29,29696,366,70272,99968
validation,765,9,9216,35,6720,15936
validation,766,39,39936,663,127296,167232
validation,767,42,43008,768,147456,190464
validation,768,15,15360,98,18816,34176
validation,769,12,12288,63,12096,24384
validation,770,35,35840,534,102528,138368
validation,771,27,27648,318,61056,88704
validation,772,15,15360,98,18816,34176
validation,773,18,18432,141,27072,45504
validation,774,36,36864,565,108480,145344
validation,775,12,12288,63,12096,24384
validation,776,20,20480,174,33408,53888
validation,777,10,10240,44,8448,18688
validation,778,23,23552,230,44160,67712
validation,779,14,14336,85,16320,30656
validation,780,22,22528,211,40512,63040
validation,781,17,17408,126,24192,41600
validation,782,24,24576,251,48192,72768
validation,783,47,48128,962,184704,232832
validation,784,20,20480,174,33408,53888
validation,785,29,29696,366,70272,99968
validation,786,21,21504,192,36864,58368
validation,787,5,5120,11,2112,7232
validation,788,28,28672,342,65664,94336
validation,789,8,8192,28,5376,13568
validation,790,14,14336,85,16320,30656
validation,791,29,29696,366,70272,99968
validation,792,48,49152,1004,192768,241920
validation,793,19,19456,157,30144,49600
validation,794,9,9216,35,6720,15936
validation,795,26,26624,295,56640,83264
validation,796,20,20480,174,33408,53888
validation,797,22,22528,211,40512,63040
validation,798,14,14336,85,16320,30656
validation,799,17,17408,126,24192,41600
validation,800,37,37888,596,114432,152320
validation,801,11,11264,53,10176,21440
validation,802,36,36864,565,108480,145344
validation,803,16,16384,112,21504,37888
validation,804,9,9216,35,6720,15936
validation,805,11,11264,53,10176,21440
validation,806,42,43008,768,147456,190464
validation,807,10,10240,44,8448,18688
validation,808,16,16384,112,21504,37888
validation,809,24,24576,251,48192,72768
validation,810,29,29696,366,70272,99968
validation,811,28,28672,342,65664,94336
validation,812,25,25600,272,52224,77824
validation,813,28,28672,342,65664,94336
validation,814,15,15360,98,18816,34176
validation,815,23,23552,230,44160,67712
validation,816,16,16384,112,21504,37888
validation,817,14,14336,85,16320,30656
validation,818,26,26624,295,56640,83264
validation,819,17,17408,126,24192,41600
validation,820,25,25600,272,52224,77824
validation,821,10,10240,44,8448,18688
validation,822,23,23552,230,44160,67712
validation,823,15,15360,98,18816,34176
validation,824,16,16384,112,21504,37888
validation,825,10,10240,44,8448,18688
validation,826,42,43008,768,147456,190464
validation,827,18,18432,141,27072,45504
validation,828,16,16384,112,21504,37888
validation,829,31,31744,419,80448,112192
validation,830,41,41984,732,140544,182528
validation,831,32,32768,446,85632,118400
validation,832,24,24576,251,48192,72768
validation,833,37,37888,596,114432,152320
validation,834,16,16384,112,21504,37888
validation,835,17,17408,126,24192,41600
validation,836,34,34816,504,96768,131584
validation,837,37,37888,596,114432,152320
validation,838,10,10240,44,8448,18688
validation,839,6,6144,16,3072,9216
validation,840,11,11264,53,10176,21440
validation,841,9,9216,35,6720,15936
validation,842,23,23552,230,44160,67712
validation,843,15,15360,98,18816,34176
validation,844,29,29696,366,70272,99968
validation,845,13,13312,74,14208,27520
validation,846,33,33792,474,91008,124800
validation,847,38,38912,629,120768,159680
validation,848,21,21504,192,36864,58368
validation,849,24,24576,251,48192,72768
validation,850,32,32768,446,85632,118400
validation,851,10,10240,44,8448,18688
validation,852,10,10240,44,8448,18688
validation,853,18,18432,141,27072,45504
validation,854,7,7168,21,4032,11200
validation,855,12,12288,63,12096,24384
validation,856,24,24576,251,48192,72768
validation,857,15,15360,98,18816,34176
validation,858,18,18432,141,27072,45504
validation,859,20,20480,174,33408,53888
validation,860,24,24576,251,48192,72768
validation,861,8,8192,28,5376,13568
validation,862,30,30720,392,75264,105984
validation,863,11,11264,53,10176,21440
validation,864,37,37888,596,114432,152320
validation,865,41,41984,732,140544,182528
validation,866,15,15360,98,18816,34176
validation,867,19,19456,157,30144,49600
validation,868,24,24576,251,48192,72768
validation,869,42,43008,768,147456,190464
validation,870,46,47104,922,177024,224128
validation,871,27,27648,318,61056,88704
test,0,16,16384,112,21504,37888
test,1,13,13312,74,14208,27520
test,2,41,41984,732,140544,182528
test,3,25,25600,272,52224,77824
test,4,23,23552,230,44160,67712
test,5,32,32768,446,85632,118400
test,6,30,30720,392,75264,105984
test,7,8,8192,28,5376,13568
test,8,11,11264,53,10176,21440
test,9,25,25600,272,52224,77824
test,10,15,15360,98,18816,34176
test,11,22,22528,211,40512,63040
test,12,5,5120,11,2112,7232
test,13,24,24576,251,48192,72768
test,14,33,33792,474,91008,124800
test,15,39,39936,663,127296,167232
test,16,11,11264,53,10176,21440
test,17,5,5120,11,2112,7232
test,18,40,40960,697,133824,174784
test,19,27,27648,318,61056,88704
test,20,25,25600,272,52224,77824
test,21,16,16384,112,21504,37888
test,22,15,15360,98,18816,34176
test,23,14,14336,85,16320,30656
test,24,27,27648,318,61056,88704
test,25,22,22528,211,40512,63040
test,26,23,23552,230,44160,67712
test,27,9,9216,35,6720,15936
test,28,7,7168,21,4032,11200
test,29,14,14336,85,16320,30656
test,30,17,17408,126,24192,41600
test,31,15,15360,98,18816,34176
test,32,10,10240,44,8448,18688
test,33,24,24576,251,48192,72768
test,34,19,19456,157,30144,49600
test,35,23,23552,230,44160,67712
test,36,10,10240,44,8448,18688
test,37,16,16384,112,21504,37888
test,38,37,37888,596,114432,152320
test,39,13,13312,74,14208,27520
test,40,30,30720,392,75264,105984
test,41,8,8192,28,5376,13568
test,42,38,38912,629,120768,159680
test,43,28,28672,342,65664,94336
test,44,28,28672,342,65664,94336
test,45,30,30720,392,75264,105984
test,46,32,32768,446,85632,118400
test,47,17,17408,126,24192,41600
test,48,22,22528,211,40512,63040
test,49,31,31744,419,80448,112192
test,50,14,14336,85,16320,30656
test,51,20,20480,174,33408,53888
test,52,38,38912,629,120768,159680
test,53,23,23552,230,44160,67712
test,54,31,31744,419,80448,112192
test,55,25,25600,272,52224,77824
test,56,25,25600,272,52224,77824
test,57,11,11264,53,10176,21440
test,58,30,30720,392,75264,105984
test,59,9,9216,35,6720,15936
test,60,18,18432,141,27072,45504
test,61,25,25600,272,52224,77824
test,62,25,25600,272,52224,77824
test,63,16,16384,112,21504,37888
test,64,31,31744,419,80448,112192
test,65,38,38912,629,120768,159680
test,66,19,19456,157,30144,49600
test,67,25,25600,272,52224,77824
test,68,17,17408,126,24192,41600
test,69,11,11264,53,10176,21440
test,70,37,37888,596,114432,152320
test,71,30,30720,392,75264,105984
test,72,12,12288,63,12096,24384
test,73,13,13312,74,14208,27520
test,74,16,16384,112,21504,37888
test,75,25,25600,272,52224,77824
test,76,25,25600,272,52224,77824
test,77,19,19456,157,30144,49600
test,78,8,8192,28,5376,13568
test,79,7,7168,21,4032,11200
test,80,25,25600,272,52224,77824
test,81,30,30720,392,75264,105984
test,82,25,25600,272,52224,77824
test,83,36,36864,565,108480,145344
test,84,7,7168,21,4032,11200
test,85,32,32768,446,85632,118400
test,86,30,30720,392,75264,105984
test,87,22,22528,211,40512,63040
test,88,12,12288,63,12096,24384
test,89,26,26624,295,56640,83264
test,90,35,35840,534,102528,138368
test,91,27,27648,318,61056,88704
test,92,37,37888,596,114432,152320
test,93,14,14336,85,16320,30656
test,94,15,15360,98,18816,34176
test,95,17,17408,126,24192,41600
test,96,32,32768,446,85632,118400
test,97,34,34816,504,96768,131584
test,98,35,35840,534,102528,138368
test,99,16,16384,112,21504,37888
test,100,25,25600,272,52224,77824
test,101,24,24576,251,48192,72768
test,102,35,35840,534,102528,138368
test,103,23,23552,230,44160,67712
test,104,25,25600,272,52224,77824
test,105,30,30720,392,75264,105984
test,106,35,35840,534,102528,138368
test,107,10,10240,44,8448,18688
test,108,22,22528,211,40512,63040
test,109,20,20480,174,33408,53888
test,110,33,33792,474,91008,124800
test,111,37,37888,596,114432,152320
test,112,22,22528,211,40512,63040
test,113,52,53248,1178,226176,279424
test,114,19,19456,157,30144,49600
test,115,12,12288,63,12096,24384
test,116,7,7168,21,4032,11200
test,117,10,10240,44,8448,18688
test,118,30,30720,392,75264,105984
test,119,14,14336,85,16320,30656
test,120,25,25600,272,52224,77824
test,121,21,21504,192,36864,58368
test,122,9,9216,35,6720,15936
test,123,31,31744,419,80448,112192
test,124,14,14336,85,16320,30656
test,125,45,46080,882,169344,215424
test,126,28,28672,342,65664,94336
test,127,19,19456,157,30144,49600
test,128,17,17408,126,24192,41600
test,129,17,17408,126,24192,41600
test,130,9,9216,35,6720,15936
test,131,14,14336,85,16320,30656
test,132,11,11264,53,10176,21440
test,133,17,17408,126,24192,41600
test,134,36,36864,565,108480,145344
test,135,25,25600,272,52224,77824
test,136,10,10240,44,8448,18688
test,137,30,30720,392,75264,105984
test,138,34,34816,504,96768,131584
test,139,22,22528,211,40512,63040
test,140,11,11264,53,10176,21440
test,141,36,36864,565,108480,145344
test,142,16,16384,112,21504,37888
test,143,21,21504,192,36864,58368
test,144,17,17408,126,24192,41600
test,145,8,8192,28,5376,13568
test,146,19,19456,157,30144,49600
test,147,26,26624,295,56640,83264
test,148,46,47104,922,177024,224128
test,149,23,23552,230,44160,67712
test,150,21,21504,192,36864,58368
test,151,39,39936,663,127296,167232
test,152,19,19456,157,30144,49600
test,153,24,24576,251,48192,72768
test,154,12,12288,63,12096,24384
test,155,22,22528,211,40512,63040
test,156,23,23552,230,44160,67712
test,157,15,15360,98,18816,34176
test,158,30,30720,392,75264,105984
test,159,32,32768,446,85632,118400
test,160,11,11264,53,10176,21440
test,161,36,36864,565,108480,145344
test,162,28,28672,342,65664,94336
test,163,16,16384,112,21504,37888
test,164,24,24576,251,48192,72768
test,165,53,54272,1224,235008,289280
test,166,17,17408,126,24192,41600
test,167,5,5120,11,2112,7232
test,168,16,16384,112,21504,37888
test,169,9,9216,35,6720,15936
test,170,14,14336,85,16320,30656
test,171,13,13312,74,14208,27520
test,172,47,48128,962,184704,232832
test,173,23,23552,230,44160,67712
test,174,20,20480,174,33408,53888
test,175,32,32768,446,85632,118400
test,176,13,13312,74,14208,27520
test,177,44,45056,843,161856,206912
test,178,26,26624,295,56640,83264
test,179,25,25600,272,52224,77824
test,180,25,25600,272,52224,77824
test,181,39,39936,663,127296,167232
test,182,22,22528,211,40512,63040
test,183,30,30720,392,75264,105984
test,184,26,26624,295,56640,83264
test,185,40,40960,697,133824,174784
test,186,20,20480,174,33408,53888
test,187,28,28672,342,65664,94336
test,188,12,12288,63,12096,24384
test,189,18,18432,141,27072,45504
test,190,29,29696,366,70272,99968
test,191,47,48128,962,184704,232832
test,192,31,31744,419,80448,112192
test,193,11,11264,53,10176,21440
test,194,43,44032,805,154560,198592
test,195,13,13312,74,14208,27520
test,196,10,10240,44,8448,18688
test,197,28,28672,342,65664,94336
test,198,12,12288,63,12096,24384
test,199,39,39936,663,127296,167232
test,200,24,24576,251,48192,72768
test,201,12,12288,63,12096,24384
test,202,10,10240,44,8448,18688
test,203,12,12288,63,12096,24384
test,204,31,31744,419,80448,112192
test,205,28,28672,342,65664,94336
test,206,14,14336,85,16320,30656
test,207,34,34816,504,96768,131584
test,208,17,17408,126,24192,41600
test,209,10,10240,44,8448,18688
test,210,5,5120,11,2112,7232
test,211,29,29696,366,70272,99968
test,212,37,37888,596,114432,152320
test,213,19,19456,157,30144,49600
test,214,32,32768,446,85632,118400
test,215,9,9216,35,6720,15936
test,216,38,38912,629,120768,159680
test,217,7,7168,21,4032,11200
test,218,35,35840,534,102528,138368
test,219,6,6144,16,3072,9216
test,220,19,19456,157,30144,49600
test,221,19,19456,157,30144,49600
test,222,10,10240,44,8448,18688
test,223,39,39936,663,127296,167232
test,224,5,5120,11,2112,7232
test,225,38,38912,629,120768,159680
test,226,11,11264,53,10176,21440
test,227,23,23552,230,44160,67712
test,228,21,21504,192,36864,58368
test,229,16,16384,112,21504,37888
test,230,29,29696,366,70272,99968
test,231,13,13312,74,14208,27520
test,232,15,15360,98,18816,34176
test,233,28,28672,342,65664,94336
test,234,12,12288,63,12096,24384
test,235,14,14336,85,16320,30656
test,236,30,30720,392,75264,105984
test,237,13,13312,74,14208,27520
test,238,8,8192,28,5376,13568
test,239,23,23552,230,44160,67712
test,240,21,21504,192,36864,58368
test,241,36,36864,565,108480,145344
test,242,13,13312,74,14208,27520
test,243,36,36864,565,108480,145344
test,244,9,9216,35,6720,15936
test,245,19,19456,157,30144,49600
test,246,22,22528,211,40512,63040
test,247,30,30720,392,75264,105984
test,248,21,21504,192,36864,58368
test,249,4,4096,7,1344,5440
test,250,18,18432,141,27072,45504
test,251,16,16384,112,21504,37888
test,252,32,32768,446,85632,118400
test,253,34,34816,504,96768,131584
test,254,20,20480,174,33408,53888
test,255,7,7168,21,4032,11200
test,256,7,7168,21,4032,11200
test,257,21,21504,192,36864,58368
test,258,31,31744,419,80448,112192
test,259,33,33792,474,91008,124800
test,260,23,23552,230,44160,67712
test,261,28,28672,342,65664,94336
test,262,29,29696,366,70272,99968
test,263,11,11264,53,10176,21440
test,264,26,26624,295,56640,83264
test,265,43,44032,805,154560,198592
test,266,25,25600,272,52224,77824
test,267,25,25600,272,52224,77824
test,268,13,13312,74,14208,27520
test,269,22,22528,211,40512,63040
test,270,22,22528,211,40512,63040
test,271,25,25600,272,52224,77824
test,272,41,41984,732,140544,182528
test,273,23,23552,230,44160,67712
test,274,21,21504,192,36864,58368
test,275,17,17408,126,24192,41600
test,276,28,28672,342,65664,94336
test,277,9,9216,35,6720,15936
test,278,15,15360,98,18816,34176
test,279,38,38912,629,120768,159680
test,280,15,15360,98,18816,34176
test,281,34,34816,504,96768,131584
test,282,18,18432,141,27072,45504
test,283,35,35840,534,102528,138368
test,284,9,9216,35,6720,15936
test,285,31,31744,419,80448,112192
test,286,37,37888,596,114432,152320
test,287,17,17408,126,24192,41600
test,288,11,11264,53,10176,21440
test,289,18,18432,141,27072,45504
test,290,13,13312,74,14208,27520
test,291,15,15360,98,18816,34176
test,292,18,18432,141,27072,45504
test,293,7,7168,21,4032,11200
test,294,40,40960,697,133824,174784
test,295,25,25600,272,52224,77824
test,296,35,35840,534,102528,138368
test,297,34,34816,504,96768,131584
test,298,39,39936,663,127296,167232
test,299,21,21504,192,36864,58368
test,300,27,27648,318,61056,88704
test,301,55,56320,1318,253056,309376
test,302,31,31744,419,80448,112192
test,303,11,11264,53,10176,21440
test,304,24,24576,251,48192,72768
test,305,29,29696,366,70272,99968
test,306,31,31744,419,80448,112192
test,307,22,22528,211,40512,63040
test,308,22,22528,211,40512,63040
test,309,14,14336,85,16320,30656
test,310,10,10240,44,8448,18688
test,311,17,17408,126,24192,41600
test,312,28,28672,342,65664,94336
test,313,16,16384,112,21504,37888
test,314,20,20480,174,33408,53888
test,315,23,23552,230,44160,67712
test,316,23,23552,230,44160,67712
test,317,31,31744,419,80448,112192
test,318,29,29696,366,70272,99968
test,319,18,18432,141,27072,45504
test,320,22,22528,211,40512,63040
test,321,12,12288,63,12096,24384
test,322,28,28672,342,65664,94336
test,323,15,15360,98,18816,34176
test,324,28,28672,342,65664,94336
test,325,27,27648,318,61056,88704
test,326,27,27648,318,61056,88704
test,327,8,8192,28,5376,13568
test,328,26,26624,295,56640,83264
test,329,22,22528,211,40512,63040
test,330,27,27648,318,61056,88704
test,331,17,17408,126,24192,41600
test,332,10,10240,44,8448,18688
test,333,8,8192,28,5376,13568
test,334,16,16384,112,21504,37888
test,335,22,22528,211,40512,63040
test,336,15,15360,98,18816,34176
test,337,17,17408,126,24192,41600
test,338,40,40960,697,133824,174784
test,339,41,41984,732,140544,182528
test,340,19,19456,157,30144,49600
test,341,15,15360,98,18816,34176
test,342,34,34816,504,96768,131584
test,343,52,53248,1178,226176,279424
test,344,29,29696,366,70272,99968
test,345,16,16384,112,21504,37888
test,346,34,34816,504,96768,131584
test,347,15,15360,98,18816,34176
test,348,24,24576,251,48192,72768
test,349,31,31744,419,80448,112192
test,350,26,26624,295,56640,83264
test,351,33,33792,474,91008,124800
test,352,36,36864,565,108480,145344
test,353,32,32768,446,85632,118400
test,354,16,16384,112,21504,37888
test,355,16,16384,112,21504,37888
test,356,26,26624,295,56640,83264
test,357,40,40960,697,133824,174784
test,358,24,24576,251,48192,72768
test,359,18,18432,141,27072,45504
test,360,37,37888,596,114432,152320
test,361,19,19456,157,30144,49600
test,362,29,29696,366,70272,99968
test,363,24,24576,251,48192,72768
test,364,10,10240,44,8448,18688
test,365,15,15360,98,18816,34176
test,366,36,36864,565,108480,145344
test,367,8,8192,28,5376,13568
test,368,18,18432,141,27072,45504
test,369,23,23552,230,44160,67712
test,370,38,38912,629,120768,159680
test,371,17,17408,126,24192,41600
test,372,19,19456,157,30144,49600
test,373,23,23552,230,44160,67712
test,374,28,28672,342,65664,94336
test,375,32,32768,446,85632,118400
test,376,24,24576,251,48192,72768
test,377,27,27648,318,61056,88704
test,378,26,26624,295,56640,83264
test,379,11,11264,53,10176,21440
test,380,19,19456,157,30144,49600
test,381,20,20480,174,33408,53888
test,382,18,18432,141,27072,45504
test,383,8,8192,28,5376,13568
test,384,11,11264,53,10176,21440
test,385,21,21504,192,36864,58368
test,386,22,22528,211,40512,63040
test,387,33,33792,474,91008,124800
test,388,16,16384,112,21504,37888
test,389,17,17408,126,24192,41600
test,390,33,33792,474,91008,124800
test,391,30,30720,392,75264,105984
test,392,11,11264,53,10176,21440
test,393,29,29696,366,70272,99968
test,394,20,20480,174,33408,53888
test,395,23,23552,230,44160,67712
test,396,13,13312,74,14208,27520
test,397,19,19456,157,30144,49600
test,398,40,40960,697,133824,174784
test,399,11,11264,53,10176,21440
test,400,30,30720,392,75264,105984
test,401,20,20480,174,33408,53888
test,402,20,20480,174,33408,53888
test,403,4,4096,7,1344,5440
test,404,20,20480,174,33408,53888
test,405,34,34816,504,96768,131584
test,406,28,28672,342,65664,94336
test,407,5,5120,11,2112,7232
test,408,26,26624,295,56640,83264
test,409,13,13312,74,14208,27520
test,410,22,22528,211,40512,63040
test,411,12,12288,63,12096,24384
test,412,20,20480,174,33408,53888
test,413,25,25600,272,52224,77824
test,414,9,9216,35,6720,15936
test,415,12,12288,63,12096,24384
test,416,38,38912,629,120768,159680
test,417,26,26624,295,56640,83264
test,418,20,20480,174,33408,53888
test,419,10,10240,44,8448,18688
test,420,27,27648,318,61056,88704
test,421,15,15360,98,18816,34176
test,422,34,34816,504,96768,131584
test,423,18,18432,141,27072,45504
test,424,35,35840,534,102528,138368
test,425,21,21504,192,36864,58368
test,426,19,19456,157,30144,49600
test,427,8,8192,28,5376,13568
test,428,24,24576,251,48192,72768
test,429,36,36864,565,108480,145344
test,430,17,17408,126,24192,41600
test,431,11,11264,53,10176,21440
test,432,25,25600,272,52224,77824
test,433,9,9216,35,6720,15936
test,434,36,36864,565,108480,145344
test,435,7,7168,21,4032,11200
test,436,15,15360,98,18816,34176
test,437,9,9216,35,6720,15936
test,438,29,29696,366,70272,99968
test,439,33,33792,474,91008,124800
test,440,7,7168,21,4032,11200
test,441,20,20480,174,33408,53888
test,442,31,31744,419,80448,112192
test,443,14,14336,85,16320,30656
test,444,19,19456,157,30144,49600
test,445,13,13312,74,14208,27520
test,446,18,18432,141,27072,45504
test,447,35,35840,534,102528,138368
test,448,8,8192,28,5376,13568
test,449,31,31744,419,80448,112192
test,450,17,17408,126,24192,41600
test,451,9,9216,35,6720,15936
test,452,50,51200,1089,209088,260288
test,453,40,40960,697,133824,174784
test,454,23,23552,230,44160,67712
test,455,21,21504,192,36864,58368
test,456,23,23552,230,44160,67712
test,457,16,16384,112,21504,37888
test,458,17,17408,126,24192,41600
test,459,33,33792,474,91008,124800
test,460,11,11264,53,10176,21440
test,461,18,18432,141,27072,45504
test,462,24,24576,251,48192,72768
test,463,24,24576,251,48192,72768
test,464,10,10240,44,8448,18688
test,465,14,14336,85,16320,30656
test,466,23,23552,230,44160,67712
test,467,7,7168,21,4032,11200
test,468,21,21504,192,36864,58368
test,469,20,20480,174,33408,53888
test,470,20,20480,174,33408,53888
test,471,42,43008,768,147456,190464
test,472,33,33792,474,91008,124800
test,473,29,29696,366,70272,99968
test,474,21,21504,192,36864,58368
test,475,36,36864,565,108480,145344
test,476,8,8192,28,5376,13568
test,477,34,34816,504,96768,131584
test,478,28,28672,342,65664,94336
test,479,22,22528,211,40512,63040
test,480,12,12288,63,12096,24384
test,481,39,39936,663,127296,167232
test,482,24,24576,251,48192,72768
test,483,45,46080,882,169344,215424
test,484,19,19456,157,30144,49600
test,485,24,24576,251,48192,72768
test,486,21,21504,192,36864,58368
test,487,10,10240,44,8448,18688
test,488,17,17408,126,24192,41600
test,489,27,27648,318,61056,88704
test,490,19,19456,157,30144,49600
test,491,13,13312,74,14208,27520
test,492,13,13312,74,14208,27520
test,493,41,41984,732,140544,182528
test,494,9,9216,35,6720,15936
test,495,44,45056,843,161856,206912
test,496,12,12288,63,12096,24384
test,497,17,17408,126,24192,41600
test,498,23,23552,230,44160,67712
test,499,27,27648,318,61056,88704
test,500,16,16384,112,21504,37888
test,501,38,38912,629,120768,159680
test,502,28,28672,342,65664,94336
test,503,14,14336,85,16320,30656
test,504,12,12288,63,12096,24384
test,505,17,17408,126,24192,41600
test,506,39,39936,663,127296,167232
test,507,7,7168,21,4032,11200
test,508,24,24576,251,48192,72768
test,509,29,29696,366,70272,99968
test,510,35,35840,534,102528,138368
test,511,11,11264,53,10176,21440
test,512,13,13312,74,14208,27520
test,513,25,25600,272,52224,77824
test,514,33,33792,474,91008,124800
test,515,9,9216,35,6720,15936
test,516,36,36864,565,108480,145344
test,517,16,16384,112,21504,37888
test,518,33,33792,474,91008,124800
test,519,14,14336,85,16320,30656
test,520,11,11264,53,10176,21440
test,521,34,34816,504,96768,131584
test,522,16,16384,112,21504,37888
test,523,14,14336,85,16320,30656
test,524,25,25600,272,52224,77824
test,525,10,10240,44,8448,18688
test,526,28,28672,342,65664,94336
test,527,14,14336,85,16320,30656
test,528,17,17408,126,24192,41600
test,529,18,18432,141,27072,45504
test,530,32,32768,446,85632,118400
test,531,28,28672,342,65664,94336
test,532,42,43008,768,147456,190464
test,533,11,11264,53,10176,21440
test,534,50,51200,1089,209088,260288
test,535,18,18432,141,27072,45504
test,536,29,29696,366,70272,99968
test,537,8,8192,28,5376,13568
test,538,23,23552,230,44160,67712
test,539,15,15360,98,18816,34176
test,540,39,39936,663,127296,167232
test,541,25,25600,272,52224,77824
test,542,15,15360,98,18816,34176
test,543,18,18432,141,27072,45504
test,544,24,24576,251,48192,72768
test,545,32,32768,446,85632,118400
test,546,38,38912,629,120768,159680
test,547,22,22528,211,40512,63040
test,548,12,12288,63,12096,24384
test,549,43,44032,805,154560,198592
test,550,36,36864,565,108480,145344
test,551,8,8192,28,5376,13568
test,552,12,12288,63,12096,24384
test,553,27,27648,318,61056,88704
test,554,22,22528,211,40512,63040
test,555,27,27648,318,61056,88704
test,556,27,27648,318,61056,88704
test,557,35,35840,534,102528,138368
test,558,31,31744,419,80448,112192
test,559,18,18432,141,27072,45504
test,560,16,16384,112,21504,37888
test,561,14,14336,85,16320,30656
test,562,36,36864,565,108480,145344
test,563,10,10240,44,8448,18688
test,564,5,5120,11,2112,7232
test,565,15,15360,98,18816,34176
test,566,7,7168,21,4032,11200
test,567,7,7168,21,4032,11200
test,568,29,29696,366,70272,99968
test,569,20,20480,174,33408,53888
test,570,10,10240,44,8448,18688
test,571,12,12288,63,12096,24384
test,572,7,7168,21,4032,11200
test,573,14,14336,85,16320,30656
test,574,20,20480,174,33408,53888
test,575,23,23552,230,44160,67712
test,576,28,28672,342,65664,94336
test,577,7,7168,21,4032,11200
test,578,7,7168,21,4032,11200
test,579,23,23552,230,44160,67712
test,580,8,8192,28,5376,13568
test,581,27,27648,318,61056,88704
test,582,17,17408,126,24192,41600
test,583,31,31744,419,80448,112192
test,584,6,6144,16,3072,9216
test,585,18,18432,141,27072,45504
test,586,6,6144,16,3072,9216
test,587,41,41984,732,140544,182528
test,588,24,24576,251,48192,72768
test,589,25,25600,272,52224,77824
test,590,17,17408,126,24192,41600
test,591,51,52224,1133,217536,269760
test,592,50,51200,1089,209088,260288
test,593,30,30720,392,75264,105984
test,594,19,19456,157,30144,49600
test,595,26,26624,295,56640,83264
test,596,21,21504,192,36864,58368
test,597,12,12288,63,12096,24384
test,598,10,10240,44,8448,18688
test,599,7,7168,21,4032,11200
test,600,34,34816,504,96768,131584
test,601,28,28672,342,65664,94336
test,602,9,9216,35,6720,15936
test,603,34,34816,504,96768,131584
test,604,9,9216,35,6720,15936
test,605,10,10240,44,8448,18688
test,606,19,19456,157,30144,49600
test,607,22,22528,211,40512,63040
test,608,24,24576,251,48192,72768
test,609,27,27648,318,61056,88704
test,610,14,14336,85,16320,30656
test,611,11,11264,53,10176,21440
test,612,10,10240,44,8448,18688
test,613,24,24576,251,48192,72768
test,614,51,52224,1133,217536,269760
test,615,8,8192,28,5376,13568
test,616,34,34816,504,96768,131584
test,617,12,12288,63,12096,24384
test,618,9,9216,35,6720,15936
test,619,8,8192,28,5376,13568
test,620,14,14336,85,16320,30656
test,621,9,9216,35,6720,15936
test,622,24,24576,251,48192,72768
test,623,25,25600,272,52224,77824
test,624,25,25600,272,52224,77824
test,625,31,31744,419,80448,112192
test,626,13,13312,74,14208,27520
test,627,17,17408,126,24192,41600
test,628,23,23552,230,44160,67712
test,629,15,15360,98,18816,34176
test,630,31,31744,419,80448,112192
test,631,26,26624,295,56640,83264
test,632,15,15360,98,18816,34176
test,633,31,31744,419,80448,112192
test,634,24,24576,251,48192,72768
test,635,28,28672,342,65664,94336
test,636,31,31744,419,80448,112192
test,637,6,6144,16,3072,9216
test,638,10,10240,44,8448,18688
test,639,27,27648,318,61056,88704
test,640,12,12288,63,12096,24384
test,641,37,37888,596,114432,152320
test,642,13,13312,74,14208,27520
test,643,12,12288,63,12096,24384
test,644,18,18432,141,27072,45504
test,645,11,11264,53,10176,21440
test,646,17,17408,126,24192,41600
test,647,12,12288,63,12096,24384
test,648,40,40960,697,133824,174784
test,649,12,12288,63,12096,24384
test,650,22,22528,211,40512,63040
test,651,19,19456,157,30144,49600
test,652,30,30720,392,75264,105984
test,653,14,14336,85,16320,30656
test,654,19,19456,157,30144,49600
test,655,40,40960,697,133824,174784
test,656,39,39936,663,127296,167232
test,657,12,12288,63,12096,24384
test,658,19,19456,157,30144,49600
test,659,16,16384,112,21504,37888
test,660,14,14336,85,16320,30656
test,661,27,27648,318,61056,88704
test,662,27,27648,318,61056,88704
test,663,50,51200,1089,209088,260288
test,664,18,18432,141,27072,45504
test,665,35,35840,534,102528,138368
test,666,29,29696,366,70272,99968
test,667,27,27648,318,61056,88704
test,668,34,34816,504,96768,131584
test,669,18,18432,141,27072,45504
test,670,11,11264,53,10176,21440
test,671,25,25600,272,52224,77824
test,672,22,22528,211,40512,63040
test,673,9,9216,35,6720,15936
test,674,21,21504,192,36864,58368
test,675,20,20480,174,33408,53888
test,676,26,26624,295,56640,83264
test,677,15,15360,98,18816,34176
test,678,24,24576,251,48192,72768
test,679,32,32768,446,85632,118400
test,680,22,22528,211,40512,63040
test,681,21,21504,192,36864,58368
test,682,29,29696,366,70272,99968
test,683,5,5120,11,2112,7232
test,684,14,14336,85,16320,30656
test,685,13,13312,74,14208,27520
test,686,26,26624,295,56640,83264
test,687,58,59392,1465,281280,340672
test,688,23,23552,230,44160,67712
test,689,13,13312,74,14208,27520
test,690,35,35840,534,102528,138368
test,691,28,28672,342,65664,94336
test,692,22,22528,211,40512,63040
test,693,35,35840,534,102528,138368
test,694,22,22528,211,40512,63040
test,695,30,30720,392,75264,105984
test,696,13,13312,74,14208,27520
test,697,15,15360,98,18816,34176
test,698,21,21504,192,36864,58368
test,699,30,30720,392,75264,105984
test,700,15,15360,98,18816,34176
test,701,21,21504,192,36864,58368
test,702,10,10240,44,8448,18688
test,703,23,23552,230,44160,67712
test,704,13,13312,74,14208,27520
test,705,27,27648,318,61056,88704
test,706,52,53248,1178,226176,279424
test,707,8,8192,28,5376,13568
test,708,11,11264,53,10176,21440
test,709,23,23552,230,44160,67712
test,710,49,50176,1046,200832,251008
test,711,31,31744,419,80448,112192
test,712,11,11264,53,10176,21440
test,713,9,9216,35,6720,15936
test,714,34,34816,504,96768,131584
test,715,26,26624,295,56640,83264
test,716,18,18432,141,27072,45504
test,717,5,5120,11,2112,7232
test,718,21,21504,192,36864,58368
test,719,18,18432,141,27072,45504
test,720,17,17408,126,24192,41600
test,721,23,23552,230,44160,67712
test,722,12,12288,63,12096,24384
test,723,9,9216,35,6720,15936
test,724,18,18432,141,27072,45504
test,725,33,33792,474,91008,124800
test,726,36,36864,565,108480,145344
test,727,23,23552,230,44160,67712
test,728,15,15360,98,18816,34176
test,729,21,21504,192,36864,58368
test,730,18,18432,141,27072,45504
test,731,10,10240,44,8448,18688
test,732,21,21504,192,36864,58368
test,733,17,17408,126,24192,41600
test,734,20,20480,174,33408,53888
test,735,7,7168,21,4032,11200
test,736,16,16384,112,21504,37888
test,737,8,8192,28,5376,13568
test,738,16,16384,112,21504,37888
test,739,26,26624,295,56640,83264
test,740,9,9216,35,6720,15936
test,741,21,21504,192,36864,58368
test,742,35,35840,534,102528,138368
test,743,22,22528,211,40512,63040
test,744,33,33792,474,91008,124800
test,745,19,19456,157,30144,49600
test,746,36,36864,565,108480,145344
test,747,18,18432,141,27072,45504
test,748,22,22528,211,40512,63040
test,749,13,13312,74,14208,27520
test,750,26,26624,295,56640,83264
test,751,44,45056,843,161856,206912
test,752,47,48128,962,184704,232832
test,753,7,7168,21,4032,11200
test,754,15,15360,98,18816,34176
test,755,43,44032,805,154560,198592
test,756,13,13312,74,14208,27520
test,757,36,36864,565,108480,145344
test,758,29,29696,366,70272,99968
test,759,18,18432,141,27072,45504
test,760,30,30720,392,75264,105984
test,761,34,34816,504,96768,131584
test,762,27,27648,318,61056,88704
test,763,29,29696,366,70272,99968
test,764,21,21504,192,36864,58368
test,765,41,41984,732,140544,182528
test,766,10,10240,44,8448,18688
test,767,20,20480,174,33408,53888
test,768,22,22528,211,40512,63040
test,769,13,13312,74,14208,27520
test,770,22,22528,211,40512,63040
test,771,5,5120,11,2112,7232
test,772,22,22528,211,40512,63040
test,773,11,11264,53,10176,21440
test,774,34,34816,504,96768,131584
test,775,14,14336,85,16320,30656
test,776,15,15360,98,18816,34176
test,777,35,35840,534,102528,138368
test,778,11,11264,53,10176,21440
test,779,32,32768,446,85632,118400
test,780,11,11264,53,10176,21440
test,781,31,31744,419,80448,112192
test,782,17,17408,126,24192,41600
test,783,26,26624,295,56640,83264
test,784,14,14336,85,16320,30656
test,785,45,46080,882,169344,215424
test,786,13,13312,74,14208,27520
test,787,21,21504,192,36864,58368
test,788,19,19456,157,30144,49600
test,789,25,25600,272,52224,77824
test,790,15,15360,98,18816,34176
test,791,16,16384,112,21504,37888
test,792,12,12288,63,12096,24384
test,793,25,25600,272,52224,77824
test,794,18,18432,141,27072,45504
test,795,14,14336,85,16320,30656
test,796,21,21504,192,36864,58368
test,797,7,7168,21,4032,11200
test,798,10,10240,44,8448,18688
test,799,14,14336,85,16320,30656
test,800,37,37888,596,114432,152320
test,801,24,24576,251,48192,72768
test,802,40,40960,697,133824,174784
test,803,16,16384,112,21504,37888
test,804,10,10240,44,8448,18688
test,805,8,8192,28,5376,13568
test,806,20,20480,174,33408,53888
test,807,8,8192,28,5376,13568
test,808,16,16384,112,21504,37888
test,809,17,17408,126,24192,41600
test,810,20,20480,174,33408,53888
test,811,31,31744,419,80448,112192
test,812,29,29696,366,70272,99968
test,813,18,18432,141,27072,45504
test,814,23,23552,230,44160,67712
test,815,4,4096,7,1344,5440
test,816,19,19456,157,30144,49600
test,817,27,27648,318,61056,88704
test,818,18,18432,141,27072,45504
test,819,9,9216,35,6720,15936
test,820,5,5120,11,2112,7232
test,821,19,19456,157,30144,49600
test,822,12,12288,63,12096,24384
test,823,14,14336,85,16320,30656
test,824,21,21504,192,36864,58368
test,825,23,23552,230,44160,67712
test,826,25,25600,272,52224,77824
test,827,28,28672,342,65664,94336
test,828,20,20480,174,33408,53888
test,829,19,19456,157,30144,49600
test,830,10,10240,44,8448,18688
test,831,27,27648,318,61056,88704
test,832,17,17408,126,24192,41600
test,833,12,12288,63,12096,24384
test,834,47,48128,962,184704,232832
test,835,22,22528,211,40512,63040
test,836,32,32768,446,85632,118400
test,837,17,17408,126,24192,41600
test,838,9,9216,35,6720,15936
test,839,13,13312,74,14208,27520
test,840,17,17408,126,24192,41600
test,841,26,26624,295,56640,83264
test,842,33,33792,474,91008,124800
test,843,41,41984,732,140544,182528
test,844,22,22528,211,40512,63040
test,845,34,34816,504,96768,131584
test,846,13,13312,74,14208,27520
test,847,13,13312,74,14208,27520
test,848,20,20480,174,33408,53888
test,849,17,17408,126,24192,41600
test,850,38,38912,629,120768,159680
test,851,45,46080,882,169344,215424
test,852,23,23552,230,44160,67712
test,853,7,7168,21,4032,11200
test,854,25,25600,272,52224,77824
test,855,37,37888,596,114432,152320
test,856,37,37888,596,114432,152320
test,857,25,25600,272,52224,77824
test,858,14,14336,85,16320,30656
test,859,17,17408,126,24192,41600
test,860,23,23552,230,44160,67712
test,861,21,21504,192,36864,58368
test,862,41,41984,732,140544,182528
test,863,26,26624,295,56640,83264
test,864,31,31744,419,80448,112192
test,865,25,25600,272,52224,77824
test,866,30,30720,392,75264,105984
test,867,52,53248,1178,226176,279424
test,868,16,16384,112,21504,37888
test,869,21,21504,192,36864,58368
test,870,8,8192,28,5376,13568
test,871,34,34816,504,96768,131584
test,872,6,6144,16,3072,9216
test,873,18,18432,141,27072,45504
test,874,37,37888,596,114432,152320
test,875,23,23552,230,44160,67712
test,876,16,16384,112,21504,37888
test,877,40,40960,697,133824,174784
test,878,37,37888,596,114432,152320
test,879,23,23552,230,44160,67712
test,880,35,35840,534,102528,138368
test,881,5,5120,11,2112,7232
test,882,39,39936,663,127296,167232
test,883,30,30720,392,75264,105984
test,884,9,9216,35,6720,15936
test,885,28,28672,342,65664,94336
test,886,9,9216,35,6720,15936
test,887,11,11264,53,10176,21440
test,888,21,21504,192,36864,58368
test,889,26,26624,295,56640,83264
test,890,16,16384,112,21504,37888
test,891,30,30720,392,75264,105984
test,892,29,29696,366,70272,99968
test,893,35,35840,534,102528,138368
test,894,26,26624,295,56640,83264
test,895,5,5120,11,2112,7232
test,896,26,26624,295,56640,83264
test,897,30,30720,392,75264,105984
test,898,18,18432,141,27072,45504
test,899,12,12288,63,12096,24384
test,900,16,16384,112,21504,37888
test,901,30,30720,392,75264,105984
test,902,35,35840,534,102528,138368
test,903,39,39936,663,127296,167232
test,904,15,15360,98,18816,34176
test,905,24,24576,251,48192,72768
test,906,19,19456,157,30144,49600
test,907,15,15360,98,18816,34176
test,908,15,15360,98,18816,34176
test,909,15,15360,98,18816,34176
test,910,27,27648,318,61056,88704
test,911,41,41984,732,140544,182528
test,912,8,8192,28,5376,13568
test,913,17,17408,126,24192,41600
test,914,20,20480,174,33408,53888
test,915,26,26624,295,56640,83264
test,916,26,26624,295,56640,83264
test,917,32,32768,446,85632,118400
test,918,17,17408,126,24192,41600
test,919,16,16384,112,21504,37888
test,920,16,16384,112,21504,37888
test,921,28,28672,342,65664,94336
test,922,36,36864,565,108480,145344
test,923,11,11264,53,10176,21440
test,924,35,35840,534,102528,138368
test,925,41,41984,732,140544,182528
test,926,36,36864,565,108480,145344
test,927,37,37888,596,114432,152320
test,928,9,9216,35,6720,15936
test,929,18,18432,141,27072,45504
test,930,44,45056,843,161856,206912
test,931,18,18432,141,27072,45504
test,932,18,18432,141,27072,45504
test,933,8,8192,28,5376,13568
test,934,49,50176,1046,200832,251008
test,935,15,15360,98,18816,34176
test,936,17,17408,126,24192,41600
test,937,10,10240,44,8448,18688
test,938,15,15360,98,18816,34176
test,939,47,48128,962,184704,232832
test,940,29,29696,366,70272,99968
test,941,38,38912,629,120768,159680
test,942,33,33792,474,91008,124800
test,943,19,19456,157,30144,49600
test,944,24,24576,251,48192,72768
test,945,23,23552,230,44160,67712
test,946,50,51200,1089,209088,260288
test,947,41,41984,732,140544,182528
test,948,38,38912,629,120768,159680
test,949,16,16384,112,21504,37888
test,950,34,34816,504,96768,131584
test,951,25,25600,272,52224,77824
test,952,22,22528,211,40512,63040
test,953,18,18432,141,27072,45504
test,954,11,11264,53,10176,21440
test,955,33,33792,474,91008,124800
test,956,17,17408,126,24192,41600
test,957,29,29696,366,70272,99968
test,958,29,29696,366,70272,99968
test,959,35,35840,534,102528,138368
test,960,15,15360,98,18816,34176
test,961,9,9216,35,6720,15936
test,962,19,19456,157,30144,49600
test,963,23,23552,230,44160,67712
test,964,15,15360,98,18816,34176
test,965,13,13312,74,14208,27520
test,966,30,30720,392,75264,105984
test,967,22,22528,211,40512,63040
test,968,25,25600,272,52224,77824
test,969,8,8192,28,5376,13568
test,970,8,8192,28,5376,13568
test,971,39,39936,663,127296,167232
test,972,34,34816,504,96768,131584
test,973,21,21504,192,36864,58368
test,974,9,9216,35,6720,15936
test,975,11,11264,53,10176,21440
test,976,7,7168,21,4032,11200
test,977,21,21504,192,36864,58368
test,978,18,18432,141,27072,45504
test,979,19,19456,157,30144,49600
test,980,28,28672,342,65664,94336
test,981,42,43008,768,147456,190464
test,982,27,27648,318,61056,88704
test,983,7,7168,21,4032,11200
test,984,14,14336,85,16320,30656
test,985,11,11264,53,10176,21440
test,986,12,12288,63,12096,24384
test,987,30,30720,392,75264,105984
test,988,10,10240,44,8448,18688
test,989,25,25600,272,52224,77824
test,990,34,34816,504,96768,131584
test,991,16,16384,112,21504,37888
test,992,26,26624,295,56640,83264
test,993,46,47104,922,177024,224128
test,994,14,14336,85,16320,30656
test,995,35,35840,534,102528,138368
test,996,18,18432,141,27072,45504
test,997,11,11264,53,10176,21440
test,998,21,21504,192,36864,58368
test,999,29,29696,366,70272,99968
test,1000,13,13312,74,14208,27520
test,1001,20,20480,174,33408,53888
test,1002,11,11264,53,10176,21440
test,1003,11,11264,53,10176,21440
test,1004,34,34816,504,96768,131584
test,1005,39,39936,663,127296,167232
test,1006,30,30720,392,75264,105984
test,1007,20,20480,174,33408,53888
test,1008,25,25600,272,52224,77824
test,1009,32,32768,446,85632,118400
test,1010,7,7168,21,4032,11200
test,1011,22,22528,211,40512,63040
test,1012,7,7168,21,4032,11200
test,1013,9,9216,35,6720,15936
test,1014,12,12288,63,12096,24384
test,1015,12,12288,63,12096,24384
test,1016,26,26624,295,56640,83264
test,1017,10,10240,44,8448,18688
test,1018,8,8192,28,5376,13568
test,1019,41,41984,732,140544,182528
test,1020,39,39936,663,127296,167232
test,1021,29,29696,366,70272,99968
test,1022,22,22528,211,40512,63040
test,1023,4,4096,7,1344,5440
test,1024,20,20480,174,33408,53888
test,1025,10,10240,44,8448,18688
test,1026,19,19456,157,30144,49600
test,1027,13,13312,74,14208,27520
test,1028,13,13312,74,14208,27520
test,1029,13,13312,74,14208,27520
test,1030,18,18432,141,27072,45504
test,1031,42,43008,768,147456,190464
test,1032,27,27648,318,61056,88704
test,1033,21,21504,192,36864,58368
test,1034,21,21504,192,36864,58368
test,1035,16,16384,112,21504,37888
test,1036,24,24576,251,48192,72768
test,1037,29,29696,366,70272,99968
test,1038,24,24576,251,48192,72768
test,1039,17,17408,126,24192,41600
test,1040,19,19456,157,30144,49600
test,1041,8,8192,28,5376,13568
test,1042,25,25600,272,52224,77824
test,1043,31,31744,419,80448,112192
test,1044,17,17408,126,24192,41600
test,1045,23,23552,230,44160,67712
test,1046,23,23552,230,44160,67712
test,1047,17,17408,126,24192,41600
test,1048,8,8192,28,5376,13568
test,1049,41,41984,732,140544,182528
test,1050,13,13312,74,14208,27520
test,1051,26,26624,295,56640,83264
test,1052,38,38912,629,120768,159680
test,1053,47,48128,962,184704,232832
test,1054,28,28672,342,65664,94336
test,1055,10,10240,44,8448,18688
test,1056,11,11264,53,10176,21440
test,1057,6,6144,16,3072,9216
test,1058,7,7168,21,4032,11200
test,1059,3,3072,4,768,3840
test,1060,32,32768,446,85632,118400
test,1061,24,24576,251,48192,72768
test,1062,13,13312,74,14208,27520
test,1063,23,23552,230,44160,67712
test,1064,22,22528,211,40512,63040
test,1065,25,25600,272,52224,77824
test,1066,17,17408,126,24192,41600
test,1067,29,29696,366,70272,99968
test,1068,25,25600,272,52224,77824
test,1069,29,29696,366,70272,99968
test,1070,19,19456,157,30144,49600
test,1071,37,37888,596,114432,152320
test,1072,27,27648,318,61056,88704
test,1073,44,45056,843,161856,206912
test,1074,25,25600,272,52224,77824
test,1075,11,11264,53,10176,21440
test,1076,17,17408,126,24192,41600
test,1077,15,15360,98,18816,34176
test,1078,18,18432,141,27072,45504
test,1079,29,29696,366,70272,99968
test,1080,14,14336,85,16320,30656
test,1081,22,22528,211,40512,63040
test,1082,4,4096,7,1344,5440
test,1083,10,10240,44,8448,18688
test,1084,27,27648,318,61056,88704
test,1085,5,5120,11,2112,7232
test,1086,22,22528,211,40512,63040
test,1087,36,36864,565,108480,145344
test,1088,23,23552,230,44160,67712
test,1089,23,23552,230,44160,67712
test,1090,22,22528,211,40512,63040
test,1091,9,9216,35,6720,15936
test,1092,20,20480,174,33408,53888
test,1093,6,6144,16,3072,9216
test,1094,18,18432,141,27072,45504
test,1095,10,10240,44,8448,18688
test,1096,21,21504,192,36864,58368
test,1097,19,19456,157,30144,49600
test,1098,50,51200,1089,209088,260288
test,1099,13,13312,74,14208,27520
test,1100,14,14336,85,16320,30656
test,1101,23,23552,230,44160,67712
test,1102,26,26624,295,56640,83264
test,1103,35,35840,534,102528,138368
test,1104,19,19456,157,30144,49600
test,1105,11,11264,53,10176,21440
test,1106,28,28672,342,65664,94336
test,1107,32,32768,446,85632,118400
test,1108,27,27648,318,61056,88704
test,1109,11,11264,53,10176,21440
test,1110,20,20480,174,33408,53888
test,1111,31,31744,419,80448,112192
test,1112,25,25600,272,52224,77824
test,1113,35,35840,534,102528,138368
test,1114,25,25600,272,52224,77824
test,1115,8,8192,28,5376,13568
test,1116,25,25600,272,52224,77824
test,1117,22,22528,211,40512,63040
test,1118,9,9216,35,6720,15936
test,1119,30,30720,392,75264,105984
test,1120,8,8192,28,5376,13568
test,1121,17,17408,126,24192,41600
test,1122,30,30720,392,75264,105984
test,1123,31,31744,419,80448,112192
test,1124,31,31744,419,80448,112192
test,1125,25,25600,272,52224,77824
test,1126,11,11264,53,10176,21440
test,1127,16,16384,112,21504,37888
test,1128,10,10240,44,8448,18688
test,1129,21,21504,192,36864,58368
test,1130,26,26624,295,56640,83264
test,1131,14,14336,85,16320,30656
test,1132,21,21504,192,36864,58368
test,1133,4,4096,7,1344,5440
test,1134,16,16384,112,21504,37888
test,1135,29,29696,366,70272,99968
test,1136,40,40960,697,133824,174784
test,1137,14,14336,85,16320,30656
test,1138,26,26624,295,56640,83264
test,1139,37,37888,596,114432,152320
test,1140,10,10240,44,8448,18688
test,1141,22,22528,211,40512,63040
test,1142,24,24576,251,48192,72768
test,1143,29,29696,366,70272,99968
test,1144,53,54272,1224,235008,289280
test,1145,49,50176,1046,200832,251008
test,1146,17,17408,126,24192,41600
test,1147,45,46080,882,169344,215424
test,1148,19,19456,157,30144,49600
test,1149,10,10240,44,8448,18688
test,1150,25,25600,272,52224,77824
test,1151,21,21504,192,36864,58368
test,1152,25,25600,272,52224,77824
test,1153,13,13312,74,14208,27520
test,1154,34,34816,504,96768,131584
test,1155,24,24576,251,48192,72768
test,1156,7,7168,21,4032,11200
test,1157,11,11264,53,10176,21440
test,1158,36,36864,565,108480,145344
test,1159,39,39936,663,127296,167232
test,1160,12,12288,63,12096,24384
test,1161,20,20480,174,33408,53888
test,1162,22,22528,211,40512,63040
test,1163,8,8192,28,5376,13568
test,1164,33,33792,474,91008,124800
test,1165,29,29696,366,70272,99968
test,1166,29,29696,366,70272,99968
test,1167,36,36864,565,108480,145344
test,1168,13,13312,74,14208,27520
test,1169,28,28672,342,65664,94336
test,1170,46,47104,922,177024,224128
test,1171,34,34816,504,96768,131584
test,1172,34,34816,504,96768,131584
test,1173,25,25600,272,52224,77824
test,1174,14,14336,85,16320,30656
test,1175,16,16384,112,21504,37888
test,1176,28,28672,342,65664,94336
test,1177,33,33792,474,91008,124800
test,1178,25,25600,272,52224,77824
test,1179,13,13312,74,14208,27520
test,1180,9,9216,35,6720,15936
test,1181,22,22528,211,40512,63040
test,1182,18,18432,141,27072,45504
test,1183,22,22528,211,40512,63040
test,1184,16,16384,112,21504,37888
test,1185,26,26624,295,56640,83264
test,1186,15,15360,98,18816,34176
test,1187,18,18432,141,27072,45504
test,1188,27,27648,318,61056,88704
test,1189,23,23552,230,44160,67712
test,1190,29,29696,366,70272,99968
test,1191,7,7168,21,4032,11200
test,1192,14,14336,85,16320,30656
test,1193,23,23552,230,44160,67712
test,1194,15,15360,98,18816,34176
test,1195,24,24576,251,48192,72768
test,1196,28,28672,342,65664,94336
test,1197,10,10240,44,8448,18688
test,1198,14,14336,85,16320,30656
test,1199,23,23552,230,44160,67712
test,1200,16,16384,112,21504,37888
test,1201,18,18432,141,27072,45504
test,1202,15,15360,98,18816,34176
test,1203,31,31744,419,80448,112192
test,1204,49,50176,1046,200832,251008
test,1205,13,13312,74,14208,27520
test,1206,33,33792,474,91008,124800
test,1207,21,21504,192,36864,58368
test,1208,32,32768,446,85632,118400
test,1209,39,39936,663,127296,167232
test,1210,27,27648,318,61056,88704
test,1211,30,30720,392,75264,105984
test,1212,7,7168,21,4032,11200
test,1213,42,43008,768,147456,190464
test,1214,28,28672,342,65664,94336
test,1215,27,27648,318,61056,88704
test,1216,28,28672,342,65664,94336
test,1217,7,7168,21,4032,11200
test,1218,41,41984,732,140544,182528
test,1219,17,17408,126,24192,41600
test,1220,15,15360,98,18816,34176
test,1221,9,9216,35,6720,15936
test,1222,50,51200,1089,209088,260288
test,1223,9,9216,35,6720,15936
test,1224,21,21504,192,36864,58368
test,1225,27,27648,318,61056,88704
test,1226,34,34816,504,96768,131584
test,1227,48,49152,1004,192768,241920
test,1228,31,31744,419,80448,112192
test,1229,7,7168,21,4032,11200
test,1230,22,22528,211,40512,63040
test,1231,25,25600,272,52224,77824
test,1232,16,16384,112,21504,37888
test,1233,29,29696,366,70272,99968
test,1234,14,14336,85,16320,30656
test,1235,13,13312,74,14208,27520
test,1236,27,27648,318,61056,88704
test,1237,31,31744,419,80448,112192
test,1238,12,12288,63,12096,24384
test,1239,28,28672,342,65664,94336
test,1240,13,13312,74,14208,27520
test,1241,19,19456,157,30144,49600
test,1242,27,27648,318,61056,88704
test,1243,37,37888,596,114432,152320
test,1244,27,27648,318,61056,88704
test,1245,42,43008,768,147456,190464
test,1246,22,22528,211,40512,63040
test,1247,14,14336,85,16320,30656
test,1248,38,38912,629,120768,159680
test,1249,21,21504,192,36864,58368
test,1250,20,20480,174,33408,53888
test,1251,25,25600,272,52224,77824
test,1252,12,12288,63,12096,24384
test,1253,26,26624,295,56640,83264
test,1254,36,36864,565,108480,145344
test,1255,19,19456,157,30144,49600
test,1256,25,25600,272,52224,77824
test,1257,8,8192,28,5376,13568
test,1258,35,35840,534,102528,138368
test,1259,18,18432,141,27072,45504
test,1260,15,15360,98,18816,34176
test,1261,9,9216,35,6720,15936
test,1262,17,17408,126,24192,41600
test,1263,33,33792,474,91008,124800
test,1264,33,33792,474,91008,124800
test,1265,31,31744,419,80448,112192
test,1266,30,30720,392,75264,105984
test,1267,16,16384,112,21504,37888
test,1268,17,17408,126,24192,41600
test,1269,31,31744,419,80448,112192
test,1270,13,13312,74,14208,27520
test,1271,14,14336,85,16320,30656
test,1272,12,12288,63,12096,24384
test,1273,24,24576,251,48192,72768
test,1274,26,26624,295,56640,83264
test,1275,29,29696,366,70272,99968
test,1276,29,29696,366,70272,99968
test,1277,34,34816,504,96768,131584
test,1278,7,7168,21,4032,11200
test,1279,15,15360,98,18816,34176
test,1280,24,24576,251,48192,72768
test,1281,16,16384,112,21504,37888
test,1282,14,14336,85,16320,30656
test,1283,19,19456,157,30144,49600
test,1284,11,11264,53,10176,21440
test,1285,34,34816,504,96768,131584
test,1286,15,15360,98,18816,34176
test,1287,36,36864,565,108480,145344
test,1288,34,34816,504,96768,131584
test,1289,7,7168,21,4032,11200
test,1290,37,37888,596,114432,152320
test,1291,20,20480,174,33408,53888
test,1292,25,25600,272,52224,77824
test,1293,21,21504,192,36864,58368
test,1294,3,3072,4,768,3840
test,1295,20,20480,174,33408,53888
test,1296,11,11264,53,10176,21440
test,1297,32,32768,446,85632,118400
test,1298,17,17408,126,24192,41600
test,1299,44,45056,843,161856,206912
test,1300,25,25600,272,52224,77824
test,1301,23,23552,230,44160,67712
test,1302,21,21504,192,36864,58368
test,1303,18,18432,141,27072,45504
test,1304,9,9216,35,6720,15936
test,1305,28,28672,342,65664,94336
test,1306,23,23552,230,44160,67712
test,1307,18,18432,141,27072,45504
test,1308,8,8192,28,5376,13568
test,1309,12,12288,63,12096,24384
test,1310,9,9216,35,6720,15936
test,1311,34,34816,504,96768,131584
test,1312,19,19456,157,30144,49600
test,1313,13,13312,74,14208,27520
test,1314,24,24576,251,48192,72768
test,1315,29,29696,366,70272,99968
test,1316,35,35840,534,102528,138368
test,1317,26,26624,295,56640,83264
test,1318,12,12288,63,12096,24384
test,1319,25,25600,272,52224,77824
test,1320,29,29696,366,70272,99968
test,1321,17,17408,126,24192,41600
test,1322,17,17408,126,24192,41600
test,1323,37,37888,596,114432,152320
test,1324,17,17408,126,24192,41600
test,1325,7,7168,21,4032,11200
test,1326,47,48128,962,184704,232832
test,1327,5,5120,11,2112,7232
test,1328,18,18432,141,27072,45504
test,1329,19,19456,157,30144,49600
test,1330,21,21504,192,36864,58368
test,1331,10,10240,44,8448,18688
test,1332,11,11264,53,10176,21440
test,1333,40,40960,697,133824,174784
test,1334,18,18432,141,27072,45504
test,1335,25,25600,272,52224,77824
test,1336,43,44032,805,154560,198592
test,1337,10,10240,44,8448,18688
test,1338,22,22528,211,40512,63040
test,1339,19,19456,157,30144,49600
test,1340,17,17408,126,24192,41600
test,1341,26,26624,295,56640,83264
test,1342,10,10240,44,8448,18688
test,1343,27,27648,318,61056,88704
test,1344,13,13312,74,14208,27520
test,1345,22,22528,211,40512,63040
test,1346,41,41984,732,140544,182528
test,1347,23,23552,230,44160,67712
test,1348,27,27648,318,61056,88704
test,1349,30,30720,392,75264,105984
test,1350,17,17408,126,24192,41600
test,1351,31,31744,419,80448,112192
test,1352,22,22528,211,40512,63040
test,1353,20,20480,174,33408,53888
test,1354,16,16384,112,21504,37888
test,1355,8,8192,28,5376,13568
test,1356,16,16384,112,21504,37888
test,1357,23,23552,230,44160,67712
test,1358,30,30720,392,75264,105984
test,1359,50,51200,1089,209088,260288
test,1360,19,19456,157,30144,49600
test,1361,20,20480,174,33408,53888
test,1362,5,5120,11,2112,7232
test,1363,31,31744,419,80448,112192
test,1364,9,9216,35,6720,15936
test,1365,25,25600,272,52224,77824
test,1366,12,12288,63,12096,24384
test,1367,23,23552,230,44160,67712
test,1368,22,22528,211,40512,63040
test,1369,14,14336,85,16320,30656
test,1370,21,21504,192,36864,58368
test,1371,28,28672,342,65664,94336
test,1372,25,25600,272,52224,77824
test,1373,20,20480,174,33408,53888
test,1374,25,25600,272,52224,77824
test,1375,10,10240,44,8448,18688
test,1376,11,11264,53,10176,21440
test,1377,44,45056,843,161856,206912
test,1378,31,31744,419,80448,112192
test,1379,28,28672,342,65664,94336
test,1380,19,19456,157,30144,49600
test,1381,23,23552,230,44160,67712
test,1382,33,33792,474,91008,124800
test,1383,32,32768,446,85632,118400
test,1384,15,15360,98,18816,34176
test,1385,19,19456,157,30144,49600
test,1386,21,21504,192,36864,58368
test,1387,25,25600,272,52224,77824
test,1388,16,16384,112,21504,37888
test,1389,6,6144,16,3072,9216
test,1390,22,22528,211,40512,63040
test,1391,8,8192,28,5376,13568
test,1392,16,16384,112,21504,37888
test,1393,50,51200,1089,209088,260288
test,1394,34,34816,504,96768,131584
test,1395,14,14336,85,16320,30656
test,1396,11,11264,53,10176,21440
test,1397,14,14336,85,16320,30656
test,1398,21,21504,192,36864,58368
test,1399,15,15360,98,18816,34176
test,1400,13,13312,74,14208,27520
test,1401,15,15360,98,18816,34176
test,1402,25,25600,272,52224,77824
test,1403,31,31744,419,80448,112192
test,1404,30,30720,392,75264,105984
test,1405,29,29696,366,70272,99968
test,1406,26,26624,295,56640,83264
test,1407,9,9216,35,6720,15936
test,1408,25,25600,272,52224,77824
test,1409,29,29696,366,70272,99968
test,1410,18,18432,141,27072,45504
test,1411,19,19456,157,30144,49600
test,1412,29,29696,366,70272,99968
test,1413,6,6144,16,3072,9216
test,1414,16,16384,112,21504,37888
test,1415,7,7168,21,4032,11200
test,1416,25,25600,272,52224,77824
test,1417,26,26624,295,56640,83264
test,1418,27,27648,318,61056,88704
test,1419,19,19456,157,30144,49600
test,1420,13,13312,74,14208,27520
test,1421,43,44032,805,154560,198592
test,1422,12,12288,63,12096,24384
test,1423,25,25600,272,52224,77824
test,1424,25,25600,272,52224,77824
test,1425,16,16384,112,21504,37888
test,1426,20,20480,174,33408,53888
test,1427,30,30720,392,75264,105984
test,1428,10,10240,44,8448,18688
test,1429,22,22528,211,40512,63040
test,1430,24,24576,251,48192,72768
test,1431,11,11264,53,10176,21440
test,1432,42,43008,768,147456,190464
test,1433,19,19456,157,30144,49600
test,1434,49,50176,1046,200832,251008
test,1435,22,22528,211,40512,63040
test,1436,34,34816,504,96768,131584
test,1437,32,32768,446,85632,118400
test,1438,31,31744,419,80448,112192
test,1439,24,24576,251,48192,72768
test,1440,36,36864,565,108480,145344
test,1441,17,17408,126,24192,41600
test,1442,14,14336,85,16320,30656
test,1443,9,9216,35,6720,15936
test,1444,25,25600,272,52224,77824
test,1445,60,61440,1568,301056,362496
test,1446,49,50176,1046,200832,251008
test,1447,21,21504,192,36864,58368
test,1448,15,15360,98,18816,34176
test,1449,32,32768,446,85632,118400
test,1450,26,26624,295,56640,83264
test,1451,39,39936,663,127296,167232
test,1452,39,39936,663,127296,167232
test,1453,34,34816,504,96768,131584
test,1454,32,32768,446,85632,118400
test,1455,19,19456,157,30144,49600
test,1456,29,29696,366,70272,99968
test,1457,7,7168,21,4032,11200
test,1458,23,23552,230,44160,67712
test,1459,7,7168,21,4032,11200
test,1460,36,36864,565,108480,145344
test,1461,12,12288,63,12096,24384
test,1462,25,25600,272,52224,77824
test,1463,19,19456,157,30144,49600
test,1464,16,16384,112,21504,37888
test,1465,33,33792,474,91008,124800
test,1466,47,48128,962,184704,232832
test,1467,25,25600,272,52224,77824
test,1468,31,31744,419,80448,112192
test,1469,38,38912,629,120768,159680
test,1470,15,15360,98,18816,34176
test,1471,19,19456,157,30144,49600
test,1472,9,9216,35,6720,15936
test,1473,28,28672,342,65664,94336
test,1474,16,16384,112,21504,37888
test,1475,13,13312,74,14208,27520
test,1476,21,21504,192,36864,58368
test,1477,25,25600,272,52224,77824
test,1478,12,12288,63,12096,24384
test,1479,24,24576,251,48192,72768
test,1480,22,22528,211,40512,63040
test,1481,15,15360,98,18816,34176
test,1482,31,31744,419,80448,112192
test,1483,18,18432,141,27072,45504
test,1484,23,23552,230,44160,67712
test,1485,14,14336,85,16320,30656
test,1486,12,12288,63,12096,24384
test,1487,22,22528,211,40512,63040
test,1488,34,34816,504,96768,131584
test,1489,19,19456,157,30144,49600
test,1490,15,15360,98,18816,34176
test,1491,31,31744,419,80448,112192
test,1492,36,36864,565,108480,145344
test,1493,28,28672,342,65664,94336
test,1494,27,27648,318,61056,88704
test,1495,8,8192,28,5376,13568
test,1496,10,10240,44,8448,18688
test,1497,7,7168,21,4032,11200
test,1498,23,23552,230,44160,67712
test,1499,9,9216,35,6720,15936
test,1500,9,9216,35,6720,15936
test,1501,54,55296,1270,243840,299136
test,1502,23,23552,230,44160,67712
test,1503,25,25600,272,52224,77824
test,1504,49,50176,1046,200832,251008
test,1505,15,15360,98,18816,34176
test,1506,6,6144,16,3072,9216
test,1507,37,37888,596,114432,152320
test,1508,25,25600,272,52224,77824
test,1509,27,27648,318,61056,88704
test,1510,20,20480,174,33408,53888
test,1511,27,27648,318,61056,88704
test,1512,12,12288,63,12096,24384
test,1513,16,16384,112,21504,37888
test,1514,10,10240,44,8448,18688
test,1515,27,27648,318,61056,88704
test,1516,18,18432,141,27072,45504
test,1517,17,17408,126,24192,41600
test,1518,51,52224,1133,217536,269760
test,1519,29,29696,366,70272,99968
test,1520,40,40960,697,133824,174784
test,1521,37,37888,596,114432,152320
test,1522,32,32768,446,85632,118400
test,1523,9,9216,35,6720,15936
test,1524,32,32768,446,85632,118400
test,1525,7,7168,21,4032,11200
test,1526,32,32768,446,85632,118400
test,1527,16,16384,112,21504,37888
test,1528,28,28672,342,65664,94336
test,1529,15,15360,98,18816,34176
test,1530,29,29696,366,70272,99968
test,1531,10,10240,44,8448,18688
test,1532,46,47104,922,177024,224128
test,1533,24,24576,251,48192,72768
test,1534,17,17408,126,24192,41600
test,1535,28,28672,342,65664,94336
test,1536,17,17408,126,24192,41600
test,1537,16,16384,112,21504,37888
test,1538,19,19456,157,30144,49600
test,1539,27,27648,318,61056,88704
test,1540,11,11264,53,10176,21440
test,1541,26,26624,295,56640,83264
test,1542,21,21504,192,36864,58368
test,1543,18,18432,141,27072,45504
test,1544,20,20480,174,33408,53888
test,1545,9,9216,35,6720,15936
test,1546,17,17408,126,24192,41600
test,1547,14,14336,85,16320,30656
test,1548,32,32768,446,85632,118400
test,1549,22,22528,211,40512,63040
test,1550,11,11264,53,10176,21440
test,1551,25,25600,272,52224,77824
test,1552,23,23552,230,44160,67712
test,1553,27,27648,318,61056,88704
test,1554,13,13312,74,14208,27520
test,1555,40,40960,697,133824,174784
test,1556,10,10240,44,8448,18688
test,1557,15,15360,98,18816,34176
test,1558,55,56320,1318,253056,309376
test,1559,20,20480,174,33408,53888
test,1560,7,7168,21,4032,11200
test,1561,19,19456,157,30144,49600
test,1562,11,11264,53,10176,21440
test,1563,50,51200,1089,209088,260288
test,1564,10,10240,44,8448,18688
test,1565,19,19456,157,30144,49600
test,1566,19,19456,157,30144,49600
test,1567,13,13312,74,14208,27520
test,1568,12,12288,63,12096,24384
test,1569,11,11264,53,10176,21440
test,1570,16,16384,112,21504,37888
test,1571,10,10240,44,8448,18688
test,1572,22,22528,211,40512,63040
test,1573,30,30720,392,75264,105984
test,1574,38,38912,629,120768,159680
test,1575,11,11264,53,10176,21440
test,1576,32,32768,446,85632,118400
test,1577,11,11264,53,10176,21440
test,1578,18,18432,141,27072,45504
test,1579,32,32768,446,85632,118400
test,1580,7,7168,21,4032,11200
test,1581,23,23552,230,44160,67712
test,1582,20,20480,174,33408,53888
test,1583,21,21504,192,36864,58368
test,1584,27,27648,318,61056,88704
test,1585,8,8192,28,5376,13568
test,1586,24,24576,251,48192,72768
test,1587,17,17408,126,24192,41600
test,1588,19,19456,157,30144,49600
test,1589,26,26624,295,56640,83264
test,1590,22,22528,211,40512,63040
test,1591,14,14336,85,16320,30656
test,1592,32,32768,446,85632,118400
test,1593,13,13312,74,14208,27520
test,1594,28,28672,342,65664,94336
test,1595,30,30720,392,75264,105984
test,1596,13,13312,74,14208,27520
test,1597,8,8192,28,5376,13568
test,1598,40,40960,697,133824,174784
test,1599,31,31744,419,80448,112192
test,1600,18,18432,141,27072,45504
test,1601,19,19456,157,30144,49600
test,1602,14,14336,85,16320,30656
test,1603,6,6144,16,3072,9216
test,1604,7,7168,21,4032,11200
test,1605,18,18432,141,27072,45504
test,1606,10,10240,44,8448,18688
test,1607,16,16384,112,21504,37888
test,1608,13,13312,74,14208,27520
test,1609,15,15360,98,18816,34176
test,1610,20,20480,174,33408,53888
test,1611,11,11264,53,10176,21440
test,1612,26,26624,295,56640,83264
test,1613,20,20480,174,33408,53888
test,1614,18,18432,141,27072,45504
test,1615,19,19456,157,30144,49600
test,1616,28,28672,342,65664,94336
test,1617,15,15360,98,18816,34176
test,1618,36,36864,565,108480,145344
test,1619,28,28672,342,65664,94336
test,1620,21,21504,192,36864,58368
test,1621,7,7168,21,4032,11200
test,1622,26,26624,295,56640,83264
test,1623,34,34816,504,96768,131584
test,1624,10,10240,44,8448,18688
test,1625,22,22528,211,40512,63040
test,1626,26,26624,295,56640,83264
test,1627,23,23552,230,44160,67712
test,1628,32,32768,446,85632,118400
test,1629,39,39936,663,127296,167232
test,1630,24,24576,251,48192,72768
test,1631,22,22528,211,40512,63040
test,1632,31,31744,419,80448,112192
test,1633,15,15360,98,18816,34176
test,1634,39,39936,663,127296,167232
test,1635,22,22528,211,40512,63040
test,1636,50,51200,1089,209088,260288
test,1637,12,12288,63,12096,24384
test,1638,29,29696,366,70272,99968
test,1639,12,12288,63,12096,24384
test,1640,28,28672,342,65664,94336
test,1641,9,9216,35,6720,15936
test,1642,47,48128,962,184704,232832
test,1643,17,17408,126,24192,41600
test,1644,34,34816,504,96768,131584
test,1645,18,18432,141,27072,45504
test,1646,14,14336,85,16320,30656
test,1647,33,33792,474,91008,124800
test,1648,25,25600,272,52224,77824
test,1649,22,22528,211,40512,63040
test,1650,33,33792,474,91008,124800
test,1651,24,24576,251,48192,72768
test,1652,25,25600,272,52224,77824
test,1653,25,25600,272,52224,77824
test,1654,14,14336,85,16320,30656
test,1655,35,35840,534,102528,138368
test,1656,38,38912,629,120768,159680
test,1657,7,7168,21,4032,11200
test,1658,10,10240,44,8448,18688
test,1659,35,35840,534,102528,138368
test,1660,27,27648,318,61056,88704
test,1661,37,37888,596,114432,152320
test,1662,26,26624,295,56640,83264
test,1663,15,15360,98,18816,34176
test,1664,24,24576,251,48192,72768
test,1665,18,18432,141,27072,45504
test,1666,19,19456,157,30144,49600
test,1667,41,41984,732,140544,182528
test,1668,44,45056,843,161856,206912
test,1669,19,19456,157,30144,49600
test,1670,30,30720,392,75264,105984
test,1671,16,16384,112,21504,37888
test,1672,33,33792,474,91008,124800
test,1673,27,27648,318,61056,88704
test,1674,31,31744,419,80448,112192
test,1675,20,20480,174,33408,53888
test,1676,28,28672,342,65664,94336
test,1677,38,38912,629,120768,159680
test,1678,9,9216,35,6720,15936
test,1679,29,29696,366,70272,99968
test,1680,3,3072,4,768,3840
test,1681,19,19456,157,30144,49600
test,1682,42,43008,768,147456,190464
test,1683,32,32768,446,85632,118400
test,1684,18,18432,141,27072,45504
test,1685,13,13312,74,14208,27520
test,1686,36,36864,565,108480,145344
test,1687,40,40960,697,133824,174784
test,1688,14,14336,85,16320,30656
test,1689,30,30720,392,75264,105984
test,1690,17,17408,126,24192,41600
test,1691,7,7168,21,4032,11200
test,1692,30,30720,392,75264,105984
test,1693,37,37888,596,114432,152320
test,1694,20,20480,174,33408,53888
test,1695,10,10240,44,8448,18688
test,1696,37,37888,596,114432,152320
test,1697,25,25600,272,52224,77824
test,1698,19,19456,157,30144,49600
test,1699,16,16384,112,21504,37888
test,1700,21,21504,192,36864,58368
test,1701,26,26624,295,56640,83264
test,1702,25,25600,272,52224,77824
test,1703,12,12288,63,12096,24384
test,1704,25,25600,272,52224,77824
test,1705,26,26624,295,56640,83264
test,1706,31,31744,419,80448,112192
test,1707,23,23552,230,44160,67712
test,1708,20,20480,174,33408,53888
test,1709,36,36864,565,108480,145344
test,1710,7,7168,21,4032,11200
test,1711,30,30720,392,75264,105984
test,1712,21,21504,192,36864,58368
test,1713,13,13312,74,14208,27520
test,1714,25,25600,272,52224,77824
test,1715,21,21504,192,36864,58368
test,1716,33,33792,474,91008,124800
test,1717,23,23552,230,44160,67712
test,1718,8,8192,28,5376,13568
test,1719,17,17408,126,24192,41600
test,1720,35,35840,534,102528,138368
test,1721,8,8192,28,5376,13568
test,1722,25,25600,272,52224,77824
test,1723,20,20480,174,33408,53888
test,1724,6,6144,16,3072,9216
test,1725,32,32768,446,85632,118400
test,1726,10,10240,44,8448,18688
test,1727,6,6144,16,3072,9216
test,1728,38,38912,629,120768,159680
test,1729,27,27648,318,61056,88704
test,1730,18,18432,141,27072,45504
test,1731,17,17408,126,24192,41600
test,1732,25,25600,272,52224,77824
test,1733,3,3072,4,768,3840
test,1734,14,14336,85,16320,30656
test,1735,22,22528,211,40512,63040
test,1736,13,13312,74,14208,27520
test,1737,32,32768,446,85632,118400
test,1738,18,18432,141,27072,45504
test,1739,25,25600,272,52224,77824
test,1740,44,45056,843,161856,206912
test,1741,25,25600,272,52224,77824
test,1742,34,34816,504,96768,131584
test,1743,13,13312,74,14208,27520
test,1744,30,30720,392,75264,105984
test,1745,24,24576,251,48192,72768
test,1746,51,52224,1133,217536,269760
test,1747,33,33792,474,91008,124800
test,1748,25,25600,272,52224,77824
test,1749,35,35840,534,102528,138368
test,1750,22,22528,211,40512,63040
test,1751,3,3072,4,768,3840
test,1752,38,38912,629,120768,159680
test,1753,36,36864,565,108480,145344
test,1754,7,7168,21,4032,11200
test,1755,23,23552,230,44160,67712
test,1756,7,7168,21,4032,11200
test,1757,11,11264,53,10176,21440
test,1758,15,15360,98,18816,34176
test,1759,22,22528,211,40512,63040
test,1760,6,6144,16,3072,9216
test,1761,37,37888,596,114432,152320
test,1762,19,19456,157,30144,49600
test,1763,12,12288,63,12096,24384
test,1764,16,16384,112,21504,37888
test,1765,24,24576,251,48192,72768
test,1766,20,20480,174,33408,53888
test,1767,18,18432,141,27072,45504
test,1768,32,32768,446,85632,118400
test,1769,38,38912,629,120768,159680
test,1770,20,20480,174,33408,53888
test,1771,13,13312,74,14208,27520
test,1772,26,26624,295,56640,83264
test,1773,20,20480,174,33408,53888
test,1774,27,27648,318,61056,88704
test,1775,37,37888,596,114432,152320
test,1776,8,8192,28,5376,13568
test,1777,34,34816,504,96768,131584
test,1778,22,22528,211,40512,63040
test,1779,28,28672,342,65664,94336
test,1780,30,30720,392,75264,105984
test,1781,15,15360,98,18816,34176
test,1782,19,19456,157,30144,49600
test,1783,8,8192,28,5376,13568
test,1784,15,15360,98,18816,34176
test,1785,15,15360,98,18816,34176
test,1786,19,19456,157,30144,49600
test,1787,38,38912,629,120768,159680
test,1788,22,22528,211,40512,63040
test,1789,36,36864,565,108480,145344
test,1790,36,36864,565,108480,145344
test,1791,37,37888,596,114432,152320
test,1792,15,15360,98,18816,34176
test,1793,33,33792,474,91008,124800
test,1794,8,8192,28,5376,13568
test,1795,41,41984,732,140544,182528
test,1796,39,39936,663,127296,167232
test,1797,36,36864,565,108480,145344
test,1798,27,27648,318,61056,88704
test,1799,13,13312,74,14208,27520
test,1800,9,9216,35,6720,15936
test,1801,19,19456,157,30144,49600
test,1802,8,8192,28,5376,13568
test,1803,33,33792,474,91008,124800
test,1804,38,38912,629,120768,159680
test,1805,15,15360,98,18816,34176
test,1806,31,31744,419,80448,112192
test,1807,29,29696,366,70272,99968
test,1808,6,6144,16,3072,9216
test,1809,8,8192,28,5376,13568
test,1810,19,19456,157,30144,49600
test,1811,34,34816,504,96768,131584
test,1812,41,41984,732,140544,182528
test,1813,30,30720,392,75264,105984
test,1814,14,14336,85,16320,30656
test,1815,33,33792,474,91008,124800
test,1816,40,40960,697,133824,174784
test,1817,21,21504,192,36864,58368
test,1818,31,31744,419,80448,112192
test,1819,4,4096,7,1344,5440
test,1820,28,28672,342,65664,94336
