split,index,nodes,total_values_for_nodes,edges,total_values_for_edges,total_values_for_graph
train,0,170,130560,3916,563904,694464
train,1,187,143616,4738,682272,825888
train,2,188,144384,4789,689616,834000
train,3,148,113664,2968,427392,541056
train,4,87,66816,1026,147744,214560
train,5,145,111360,2849,410256,521616
train,6,74,56832,742,106848,163680
train,7,192,147456,4304,619776,767232
train,8,105,80640,1494,215136,295776
train,9,137,105216,2543,366192,471408
train,10,125,96000,2117,304848,400848
train,11,78,59904,825,118800,178704
train,12,171,131328,3962,570528,701856
train,13,142,109056,2732,393408,502464
train,14,155,119040,3255,468720,587760
train,15,96,73728,1249,179856,253584
train,16,171,131328,3962,570528,701856
train,17,131,100608,2325,334800,435408
train,18,171,131328,3962,570528,701856
train,19,67,51456,609,87696,139152
train,20,118,90624,1887,271728,362352
train,21,94,72192,1198,172512,244704
train,22,116,89088,1823,262512,351600
train,23,96,73728,1249,179856,253584
train,24,181,139008,4439,639216,778224
train,25,151,115968,3090,444960,560928
train,26,133,102144,2397,345168,447312
train,27,189,145152,4840,696960,842112
train,28,116,89088,1823,262512,351600
train,29,86,66048,1002,144288,210336
train,30,87,66816,1026,147744,214560
train,31,157,120576,3340,480960,601536
train,32,210,161280,5975,860400,1021680
train,33,222,170496,6196,892224,1062720
train,34,192,147456,4995,719280,866736
train,35,144,110592,2810,404640,515232
train,36,135,103680,2470,355680,459360
train,37,139,106752,2618,376992,483744
train,38,99,76032,1328,191232,267264
train,39,173,132864,4055,583920,716784
train,40,178,136704,4293,618192,754896
train,41,145,111360,2849,410256,521616
train,42,91,69888,1122,161568,231456
train,43,141,108288,2694,387936,496224
train,44,120,92160,1951,280944,373104
train,45,144,110592,2810,404640,515232
train,46,159,122112,3426,493344,615456
train,47,185,142080,4637,667728,809808
train,48,122,93696,2017,290448,384144
train,49,122,93696,2017,290448,384144
train,50,164,125952,3644,524736,650688
train,51,128,98304,2220,319680,417984
train,52,143,109824,2771,399024,508848
train,53,181,139008,4439,639216,778224
train,54,63,48384,538,77472,125856
train,55,103,79104,1438,207072,286176
train,56,106,81408,1523,219312,300720
train,57,166,127488,3734,537696,665184
train,58,219,168192,6498,935712,1103904
train,59,186,142848,4522,651168,794016
train,60,125,96000,2117,304848,400848
train,61,117,89856,1855,267120,356976
train,62,194,148992,5100,734400,883392
train,63,179,137472,4341,625104,762576
train,64,152,116736,3131,450864,567600
train,65,132,101376,2361,339984,441360
train,66,68,52224,627,90288,142512
train,67,70,53760,664,95616,149376
train,68,131,100608,2325,334800,435408
train,69,190,145920,4891,704304,850224
train,70,136,104448,2506,360864,465312
train,71,114,87552,1761,253584,341136
train,72,66,50688,591,85104,135792
train,73,136,104448,2506,360864,465312
train,74,98,75264,1302,187488,262752
train,75,57,43776,441,63504,107280
train,76,184,141312,4587,660528,801840
train,77,158,121344,3383,487152,608496
train,78,201,154368,5474,788256,942624
train,79,127,97536,2186,314784,412320
train,80,197,151296,5258,757152,908448
train,81,164,125952,3644,524736,650688
train,82,121,92928,1984,285696,378624
train,83,223,171264,6738,970272,1141536
train,84,191,146688,4943,711792,858480
train,85,82,62976,911,131184,194160
train,86,164,125952,3644,524736,650688
train,87,111,85248,1670,240480,325728
train,88,166,127488,3734,537696,665184
train,89,203,155904,5584,804096,960000
train,90,167,128256,3779,544176,672432
train,91,142,109056,2732,393408,502464
train,92,232,178176,6317,909648,1087824
train,93,126,96768,2151,309744,406512
train,94,91,69888,1122,161568,231456
train,95,195,149760,5152,741888,891648
train,96,171,131328,3962,570528,701856
train,97,96,73728,1249,179856,253584
train,98,174,133632,4102,590688,724320
train,99,88,67584,1050,151200,218784
train,100,163,125184,3600,518400,643584
train,101,120,92160,1951,280944,373104
train,102,134,102912,2433,350352,453264
train,103,134,102912,2433,350352,453264
train,104,180,138240,4390,632160,770400
train,105,164,125952,3644,524736,650688
train,106,89,68352,1074,154656,223008
train,107,125,96000,2117,304848,400848
train,108,132,101376,2361,339984,441360
train,109,115,88320,1792,258048,346368
train,110,113,86784,1730,249120,335904
train,111,95,72960,1223,176112,249072
train,112,188,144384,4789,689616,834000
train,113,174,133632,4102,590688,724320
train,114,97,74496,1275,183600,258096
train,115,207,158976,5806,836064,995040
train,116,198,152064,5312,764928,916992
train,117,169,129792,3870,557280,687072
train,118,97,74496,1275,183600,258096
train,119,175,134400,4150,597600,732000
train,120,169,129792,3610,519840,649632
train,121,118,90624,1887,271728,362352
train,122,108,82944,1581,227664,310608
train,123,150,115200,3049,439056,554256
train,124,155,119040,3255,468720,587760
train,125,100,76800,1355,195120,271920
train,126,72,55296,703,101232,156528
train,127,101,77568,1382,199008,276576
train,128,119,91392,1919,276336,367728
train,129,194,148992,5100,734400,883392
train,130,121,92928,1984,285696,378624
train,131,177,135936,4245,611280,747216
train,132,125,96000,2117,304848,400848
train,133,140,107520,2656,382464,489984
train,134,89,68352,1074,154656,223008
train,135,86,66048,1002,144288,210336
train,136,106,81408,1523,219312,300720
train,137,167,128256,3779,544176,672432
train,138,179,137472,3776,543744,681216
train,139,185,142080,4637,667728,809808
train,140,162,124416,3556,512064,636480
train,141,114,87552,1761,253584,341136
train,142,120,92160,1951,280944,373104
train,143,116,89088,1823,262512,351600
train,144,164,125952,3644,524736,650688
train,145,147,112896,2928,421632,534528
train,146,62,47616,521,75024,122640
train,147,105,80640,1494,215136,295776
train,148,151,115968,3090,444960,560928
train,149,118,90624,1887,271728,362352
train,150,149,114432,3008,433152,547584
train,151,68,52224,627,90288,142512
train,152,134,102912,2433,350352,453264
train,153,186,142848,4688,675072,817920
train,154,135,103680,2470,355680,459360
train,155,130,99840,2290,329760,429600
train,156,150,115200,3049,439056,554256
train,157,221,169728,6618,952992,1122720
train,158,148,113664,2968,427392,541056
train,159,139,106752,2618,376992,483744
train,160,78,59904,825,118800,178704
train,161,105,80640,1494,215136,295776
train,162,108,82944,1581,227664,310608
train,163,83,63744,934,134496,198240
train,164,209,160512,5919,852336,1012848
train,165,184,141312,4587,660528,801840
train,166,177,135936,4245,611280,747216
train,167,95,72960,1223,176112,249072
train,168,77,59136,804,115776,174912
train,169,55,42240,410,59040,101280
train,170,91,69888,1122,161568,231456
train,171,169,129792,3870,557280,687072
train,172,98,75264,1302,187488,262752
train,173,187,143616,4738,682272,825888
train,174,158,121344,3383,487152,608496
train,175,154,118272,3214,462816,581088
train,176,138,105984,2581,371664,477648
train,177,176,135168,4197,604368,739536
train,178,191,146688,4943,711792,858480
train,179,146,112128,2888,415872,528000
train,180,154,118272,3214,462816,581088
train,181,53,40704,381,54864,95568
train,182,76,58368,783,112752,171120
train,183,136,104448,2506,360864,465312
train,184,130,99840,2290,329760,429600
train,185,174,133632,4102,590688,724320
train,186,131,100608,2325,334800,435408
train,187,165,126720,3689,531216,657936
train,188,152,116736,3131,450864,567600
train,189,129,99072,2255,324720,423792
train,190,219,168192,6498,935712,1103904
train,191,152,116736,3131,450864,567600
train,192,149,114432,3008,433152,547584
train,193,204,156672,5639,812016,968688
train,194,112,86016,1700,244800,330816
train,195,136,104448,2506,360864,465312
train,196,170,130560,3916,563904,694464
train,197,65,49920,573,82512,132432
train,198,114,87552,1761,253584,341136
train,199,129,99072,2255,324720,423792
train,200,155,119040,3255,468720,587760
train,201,161,123648,3512,505728,629376
train,202,177,135936,4245,611280,747216
train,203,174,133632,4102,590688,724320
train,204,136,104448,2506,360864,465312
train,205,156,119808,3298,474912,594720
train,206,141,108288,2694,387936,496224
train,207,266,204288,9047,1302768,1507056
train,208,153,117504,3172,456768,574272
train,209,168,129024,3824,550656,679680
train,210,153,117504,3172,456768,574272
train,211,152,116736,3131,450864,567600
train,212,98,75264,1302,187488,262752
train,213,151,115968,3090,444960,560928
train,214,105,80640,1494,215136,295776
train,215,176,135168,4197,604368,739536
train,216,133,102144,2397,345168,447312
train,217,129,99072,2255,324720,423792
train,218,120,92160,1951,280944,373104
train,219,58,44544,456,65664,110208
train,220,150,115200,3049,439056,554256
train,221,129,99072,2255,324720,423792
train,222,151,115968,3090,444960,560928
train,223,58,44544,456,65664,110208
train,224,128,98304,2220,319680,417984
train,225,153,117504,3172,456768,574272
train,226,123,94464,2050,295200,389664
train,227,159,122112,3426,493344,615456
train,228,137,105216,2543,366192,471408
train,229,91,69888,1122,161568,231456
train,230,82,62976,911,131184,194160
train,231,224,172032,5816,837504,1009536
train,232,159,122112,3426,493344,615456
train,233,158,121344,3383,487152,608496
train,234,99,76032,1328,191232,267264
train,235,109,83712,1610,231840,315552
train,236,144,110592,2810,404640,515232
train,237,129,99072,2255,324720,423792
train,238,185,142080,4637,667728,809808
train,239,234,179712,7419,1068336,1248048
train,240,159,122112,3426,493344,615456
train,241,279,214272,9307,1340208,1554480
train,242,143,109824,2771,399024,508848
train,243,139,106752,2618,376992,483744
train,244,147,112896,2928,421632,534528
train,245,117,89856,1855,267120,356976
train,246,156,119808,3298,474912,594720
train,247,73,56064,722,103968,160032
train,248,175,134400,4150,597600,732000
train,249,92,70656,1147,165168,235824
train,250,130,99840,2290,329760,429600
train,251,171,131328,3962,570528,701856
train,252,78,59904,825,118800,178704
train,253,150,115200,3049,439056,554256
train,254,126,96768,2151,309744,406512
train,255,129,99072,2255,324720,423792
train,256,128,98304,2220,319680,417984
train,257,136,104448,2506,360864,465312
train,258,132,101376,2361,339984,441360
train,259,146,112128,2888,415872,528000
train,260,70,53760,664,95616,149376
train,261,107,82176,1552,223488,305664
train,262,151,115968,3090,444960,560928
train,263,143,109824,2771,399024,508848
train,264,141,108288,2694,387936,496224
train,265,88,67584,1050,151200,218784
train,266,212,162816,6090,876960,1039776
train,267,109,83712,1610,231840,315552
train,268,204,156672,5639,812016,968688
train,269,152,116736,3131,450864,567600
train,270,164,125952,3644,524736,650688
train,271,125,96000,2117,304848,400848
train,272,171,131328,3962,570528,701856
train,273,157,120576,3340,480960,601536
train,274,99,76032,1328,191232,267264
train,275,137,105216,2543,366192,471408
train,276,109,83712,1610,231840,315552
train,277,120,92160,1951,280944,373104
train,278,127,97536,2186,314784,412320
train,279,266,204288,8645,1244880,1449168
train,280,144,110592,2810,404640,515232
train,281,133,102144,2397,345168,447312
train,282,115,88320,1792,258048,346368
train,283,149,114432,3008,433152,547584
train,284,112,86016,1700,244800,330816
train,285,174,133632,4102,590688,724320
train,286,193,148224,5047,726768,874992
train,287,191,146688,4943,711792,858480
train,288,150,115200,3049,439056,554256
train,289,55,42240,410,59040,101280
train,290,202,155136,5529,796176,951312
train,291,115,88320,1792,258048,346368
train,292,151,115968,3090,444960,560928
train,293,149,114432,3008,433152,547584
train,294,165,126720,3689,531216,657936
train,295,165,126720,3689,531216,657936
train,296,163,125184,3600,518400,643584
train,297,159,122112,3426,493344,615456
train,298,101,77568,1382,199008,276576
train,299,145,111360,2849,410256,521616
train,300,92,70656,1147,165168,235824
train,301,80,61440,867,124848,186288
train,302,158,121344,3383,487152,608496
train,303,84,64512,956,137664,202176
train,304,112,86016,1700,244800,330816
train,305,153,117504,3172,456768,574272
train,306,205,157440,5694,819936,977376
train,307,202,155136,5529,796176,951312
train,308,144,110592,2810,404640,515232
train,309,74,56832,742,106848,163680
train,310,134,102912,2433,350352,453264
train,311,149,114432,3008,433152,547584
train,312,163,125184,3600,518400,643584
train,313,162,124416,3556,512064,636480
train,314,172,132096,3713,534672,666768
train,315,102,78336,1410,203040,281376
train,316,164,125952,3644,524736,650688
train,317,122,93696,2017,290448,384144
train,318,164,125952,3644,524736,650688
train,319,139,106752,2618,376992,483744
train,320,83,63744,934,134496,198240
train,321,206,158208,5750,828000,986208
train,322,191,146688,4943,711792,858480
train,323,158,121344,3383,487152,608496
train,324,108,82944,1581,227664,310608
train,325,151,115968,3090,444960,560928
train,326,91,69888,1122,161568,231456
train,327,79,60672,846,121824,182496
train,328,184,141312,4587,660528,801840
train,329,109,83712,1610,231840,315552
train,330,100,76800,1355,195120,271920
train,331,73,56064,722,103968,160032
train,332,159,122112,3426,493344,615456
train,333,139,106752,2618,376992,483744
train,334,102,78336,1410,203040,281376
train,335,95,72960,1223,176112,249072
train,336,126,96768,2151,309744,406512
train,337,52,39936,367,52848,92784
train,338,179,137472,4341,625104,762576
train,339,291,223488,9978,1436832,1660320
train,340,117,89856,1855,267120,356976
train,341,197,151296,5258,757152,908448
train,342,121,92928,1984,285696,378624
train,343,76,58368,783,112752,171120
train,344,132,101376,2361,339984,441360
train,345,226,173568,6389,920016,1093584
train,346,176,135168,4197,604368,739536
train,347,153,117504,3172,456768,574272
train,348,89,68352,1074,154656,223008
train,349,175,134400,4150,597600,732000
train,350,182,139776,4488,646272,786048
train,351,148,113664,2968,427392,541056
train,352,129,99072,2255,324720,423792
train,353,148,113664,2968,427392,541056
train,354,179,137472,4341,625104,762576
train,355,113,86784,1730,249120,335904
train,356,254,195072,8224,1184256,1379328
train,357,125,96000,2117,304848,400848
train,358,119,91392,1919,276336,367728
train,359,177,135936,4245,611280,747216
train,360,96,73728,1249,179856,253584
train,361,117,89856,1855,267120,356976
train,362,112,86016,1700,244800,330816
train,363,126,96768,2151,309744,406512
train,364,82,62976,911,131184,194160
train,365,199,152832,5366,772704,925536
train,366,127,97536,2186,314784,412320
train,367,195,149760,4668,672192,821952
train,368,118,90624,1887,271728,362352
train,369,114,87552,1761,253584,341136
train,370,117,89856,1855,267120,356976
train,371,152,116736,3131,450864,567600
train,372,111,85248,1670,240480,325728
train,373,181,139008,4439,639216,778224
train,374,121,92928,1984,285696,378624
train,375,170,130560,3916,563904,694464
train,376,150,115200,3049,439056,554256
train,377,231,177408,7230,1041120,1218528
train,378,100,76800,1355,195120,271920
train,379,142,109056,2732,393408,502464
train,380,122,93696,2017,290448,384144
train,381,197,151296,5258,757152,908448
train,382,176,135168,4197,604368,739536
train,383,107,82176,1552,223488,305664
train,384,91,69888,1122,161568,231456
train,385,79,60672,846,121824,182496
train,386,78,59904,825,118800,178704
train,387,177,135936,4245,611280,747216
train,388,205,157440,5694,819936,977376
train,389,80,61440,867,124848,186288
train,390,136,104448,2506,360864,465312
train,391,114,87552,1761,253584,341136
train,392,117,89856,1855,267120,356976
train,393,36,27648,176,25344,52992
train,394,94,72192,1198,172512,244704
train,395,91,69888,1122,161568,231456
train,396,124,95232,2084,300096,395328
train,397,135,103680,2470,355680,459360
train,398,59,45312,472,67968,113280
train,399,239,183552,7739,1114416,1297968
train,400,154,118272,3214,462816,581088
train,401,102,78336,1410,203040,281376
train,402,106,81408,1523,219312,300720
train,403,154,118272,3214,462816,581088
train,404,107,82176,1552,223488,305664
train,405,145,111360,2849,410256,521616
train,406,129,99072,2255,324720,423792
train,407,148,113664,2968,427392,541056
train,408,149,114432,3008,433152,547584
train,409,154,118272,3214,462816,581088
train,410,142,109056,2732,393408,502464
train,411,168,129024,3824,550656,679680
train,412,116,89088,1823,262512,351600
train,413,64,49152,555,79920,129072
train,414,169,129792,3870,557280,687072
train,415,191,146688,4943,711792,858480
train,416,109,83712,1610,231840,315552
train,417,75,57600,762,109728,167328
train,418,165,126720,3689,531216,657936
train,419,180,138240,4390,632160,770400
train,420,90,69120,1098,158112,227232
train,421,195,149760,5152,741888,891648
train,422,144,110592,2810,404640,515232
train,423,125,96000,2117,304848,400848
train,424,113,86784,1730,249120,335904
train,425,137,105216,2543,366192,471408
train,426,236,181248,6213,894672,1075920
train,427,156,119808,3298,474912,594720
train,428,86,66048,1002,144288,210336
train,429,157,120576,3340,480960,601536
train,430,161,123648,3512,505728,629376
train,431,92,70656,1147,165168,235824
train,432,55,42240,410,59040,101280
train,433,166,127488,3734,537696,665184
train,434,112,86016,1700,244800,330816
train,435,249,191232,7157,1030608,1221840
train,436,66,50688,591,85104,135792
train,437,65,49920,573,82512,132432
train,438,154,118272,3214,462816,581088
train,439,125,96000,2117,304848,400848
train,440,191,146688,4943,711792,858480
train,441,180,138240,4390,632160,770400
train,442,129,99072,2255,324720,423792
train,443,83,63744,934,134496,198240
train,444,193,148224,5047,726768,874992
train,445,131,100608,2325,334800,435408
train,446,177,135936,4245,611280,747216
train,447,145,111360,2849,410256,521616
train,448,95,72960,1223,176112,249072
train,449,188,144384,4789,689616,834000
train,450,88,67584,1050,151200,218784
train,451,161,123648,3512,505728,629376
train,452,113,86784,1730,249120,335904
train,453,159,122112,3426,493344,615456
train,454,141,108288,2694,387936,496224
train,455,73,56064,722,103968,160032
train,456,132,101376,2361,339984,441360
train,457,115,88320,1792,258048,346368
train,458,170,130560,3916,563904,694464
train,459,53,40704,381,54864,95568
train,460,152,116736,3131,450864,567600
train,461,110,84480,1640,236160,320640
train,462,139,106752,2618,376992,483744
train,463,165,126720,3689,531216,657936
train,464,81,62208,889,128016,190224
train,465,110,84480,1640,236160,320640
train,466,154,118272,3214,462816,581088
train,467,208,159744,5862,844128,1003872
train,468,170,130560,3916,563904,694464
train,469,205,157440,5694,819936,977376
train,470,61,46848,505,72720,119568
train,471,101,77568,1382,199008,276576
train,472,150,115200,3049,439056,554256
train,473,100,76800,1355,195120,271920
train,474,127,97536,2186,314784,412320
train,475,166,127488,3734,537696,665184
train,476,162,124416,3556,512064,636480
train,477,109,83712,1610,231840,315552
train,478,110,84480,1640,236160,320640
train,479,67,51456,609,87696,139152
train,480,107,82176,1552,223488,305664
train,481,151,115968,3090,444960,560928
train,482,134,102912,2433,350352,453264
train,483,64,49152,555,79920,129072
train,484,121,92928,1984,285696,378624
train,485,204,156672,5639,812016,968688
train,486,119,91392,1919,276336,367728
train,487,162,124416,3556,512064,636480
train,488,195,149760,5152,741888,891648
train,489,174,133632,4102,590688,724320
train,490,87,66816,1026,147744,214560
train,491,150,115200,3049,439056,554256
train,492,192,147456,4995,719280,866736
train,493,130,99840,2290,329760,429600
train,494,168,129024,3824,550656,679680
train,495,182,139776,4488,646272,786048
train,496,200,153600,5420,780480,934080
train,497,83,63744,934,134496,198240
train,498,132,101376,2361,339984,441360
train,499,195,149760,5152,741888,891648
train,500,149,114432,3008,433152,547584
train,501,108,82944,1581,227664,310608
train,502,124,95232,2084,300096,395328
train,503,198,152064,5312,764928,916992
train,504,193,148224,4433,638352,786576
train,505,174,133632,4102,590688,724320
train,506,132,101376,2361,339984,441360
train,507,165,126720,3689,531216,657936
train,508,172,132096,4009,577296,709392
train,509,88,67584,1050,151200,218784
train,510,66,50688,591,85104,135792
train,511,89,68352,1074,154656,223008
train,512,177,135936,4245,611280,747216
train,513,150,115200,3049,439056,554256
train,514,76,58368,783,112752,171120
train,515,190,145920,4891,704304,850224
train,516,97,74496,1275,183600,258096
train,517,128,98304,2220,319680,417984
train,518,95,72960,1223,176112,249072
train,519,170,130560,3916,563904,694464
train,520,48,36864,313,45072,81936
train,521,140,107520,2656,382464,489984
train,522,152,116736,3131,450864,567600
train,523,192,147456,4995,719280,866736
train,524,87,66816,1026,147744,214560
train,525,192,147456,4995,719280,866736
train,526,100,76800,1355,195120,271920
train,527,191,146688,4943,711792,858480
train,528,54,41472,395,56880,98352
train,529,114,87552,1761,253584,341136
train,530,134,102912,2433,350352,453264
train,531,105,80640,1494,215136,295776
train,532,174,133632,4102,590688,724320
train,533,146,112128,2888,415872,528000
train,534,160,122880,3469,499536,622416
train,535,154,118272,3214,462816,581088
train,536,156,119808,3298,474912,594720
train,537,94,72192,1198,172512,244704
train,538,112,86016,1700,244800,330816
train,539,149,114432,3008,433152,547584
train,540,181,139008,4439,639216,778224
train,541,138,105984,2581,371664,477648
train,542,162,124416,3556,512064,636480
train,543,56,43008,425,61200,104208
train,544,245,188160,8133,1171152,1359312
train,545,165,126720,3689,531216,657936
train,546,272,208896,8893,1280592,1489488
train,547,115,88320,1792,258048,346368
train,548,101,77568,1382,199008,276576
train,549,96,73728,1249,179856,253584
train,550,118,90624,1887,271728,362352
train,551,153,117504,3172,456768,574272
train,552,138,105984,2581,371664,477648
train,553,185,142080,4637,667728,809808
train,554,58,44544,456,65664,110208
train,555,57,43776,441,63504,107280
train,556,181,139008,4439,639216,778224
train,557,179,137472,4341,625104,762576
train,558,138,105984,2581,371664,477648
train,559,127,97536,2186,314784,412320
train,560,227,174336,6517,938448,1112784
train,561,84,64512,956,137664,202176
train,562,142,109056,2732,393408,502464
train,563,160,122880,3469,499536,622416
train,564,114,87552,1761,253584,341136
train,565,157,120576,3340,480960,601536
train,566,138,105984,2581,371664,477648
train,567,196,150528,5205,749520,900048
train,568,91,69888,1122,161568,231456
train,569,112,86016,1700,244800,330816
train,570,173,132864,4055,583920,716784
train,571,72,55296,703,101232,156528
train,572,112,86016,1700,244800,330816
train,573,173,132864,4055,583920,716784
train,574,175,134400,4150,597600,732000
train,575,183,140544,4538,653472,794016
train,576,170,130560,3916,563904,694464
train,577,146,112128,2888,415872,528000
train,578,223,171264,5671,816624,987888
train,579,159,122112,3426,493344,615456
train,580,122,93696,2017,290448,384144
train,581,145,111360,2849,410256,521616
train,582,179,137472,4341,625104,762576
train,583,187,143616,4738,682272,825888
train,584,110,84480,1640,236160,320640
train,585,127,97536,2186,314784,412320
train,586,177,135936,4245,611280,747216
train,587,59,45312,472,67968,113280
train,588,111,85248,1670,240480,325728
train,589,52,39936,367,52848,92784
train,590,164,125952,3644,524736,650688
train,591,71,54528,683,98352,152880
train,592,97,74496,1275,183600,258096
train,593,136,104448,2506,360864,465312
train,594,146,112128,2888,415872,528000
train,595,111,85248,1670,240480,325728
train,596,98,75264,1302,187488,262752
train,597,150,115200,3049,439056,554256
train,598,159,122112,3426,493344,615456
train,599,146,112128,2888,415872,528000
train,600,113,86784,1730,249120,335904
train,601,130,99840,2290,329760,429600
train,602,103,79104,1438,207072,286176
train,603,200,153600,5420,780480,934080
train,604,91,69888,1122,161568,231456
train,605,129,99072,2255,324720,423792
train,606,78,59904,825,118800,178704
train,607,185,142080,4637,667728,809808
train,608,127,97536,2186,314784,412320
train,609,57,43776,441,63504,107280
train,610,55,42240,410,59040,101280
train,611,203,155904,5584,804096,960000
train,612,151,115968,3090,444960,560928
train,613,92,70656,1147,165168,235824
train,614,152,116736,3131,450864,567600
train,615,136,104448,2506,360864,465312
train,616,124,95232,2084,300096,395328
train,617,111,85248,1670,240480,325728
train,618,193,148224,4969,715536,863760
train,619,91,69888,1122,161568,231456
train,620,163,125184,3600,518400,643584
train,621,106,81408,1523,219312,300720
train,622,75,57600,762,109728,167328
train,623,97,74496,1275,183600,258096
train,624,162,124416,3556,512064,636480
train,625,213,163584,6147,885168,1048752
train,626,133,102144,2397,345168,447312
train,627,77,59136,804,115776,174912
train,628,107,82176,1552,223488,305664
train,629,202,155136,5529,796176,951312
train,630,113,86784,1730,249120,335904
train,631,120,92160,1951,280944,373104
train,632,150,115200,3049,439056,554256
train,633,137,105216,2543,366192,471408
train,634,128,98304,2220,319680,417984
train,635,108,82944,1581,227664,310608
train,636,160,122880,3469,499536,622416
train,637,84,64512,956,137664,202176
train,638,155,119040,3255,468720,587760
train,639,64,49152,555,79920,129072
train,640,134,102912,2433,350352,453264
train,641,158,121344,3383,487152,608496
train,642,87,66816,1026,147744,214560
train,643,169,129792,3870,557280,687072
train,644,106,81408,1523,219312,300720
train,645,154,118272,3214,462816,581088
train,646,116,89088,1823,262512,351600
train,647,80,61440,867,124848,186288
train,648,145,111360,2849,410256,521616
train,649,125,96000,2117,304848,400848
train,650,107,82176,1552,223488,305664
train,651,72,55296,703,101232,156528
train,652,114,87552,1761,253584,341136
train,653,125,96000,2117,304848,400848
train,654,93,71424,1172,168768,240192
train,655,169,129792,3870,557280,687072
train,656,82,62976,911,131184,194160
train,657,223,171264,6738,970272,1141536
train,658,168,129024,3824,550656,679680
train,659,125,96000,2117,304848,400848
train,660,169,129792,3870,557280,687072
train,661,84,64512,956,137664,202176
train,662,128,98304,2220,319680,417984
train,663,121,92928,1984,285696,378624
train,664,126,96768,2151,309744,406512
train,665,106,81408,1523,219312,300720
train,666,128,98304,2220,319680,417984
train,667,105,80640,1494,215136,295776
train,668,139,106752,2618,376992,483744
train,669,71,54528,683,98352,152880
train,670,63,48384,538,77472,125856
train,671,132,101376,2361,339984,441360
train,672,95,72960,1223,176112,249072
train,673,142,109056,2732,393408,502464
train,674,142,109056,2732,393408,502464
train,675,127,97536,2186,314784,412320
train,676,89,68352,1074,154656,223008
train,677,192,147456,4995,719280,866736
train,678,165,126720,3689,531216,657936
train,679,176,135168,4197,604368,739536
train,680,142,109056,2732,393408,502464
train,681,122,93696,2017,290448,384144
train,682,94,72192,1198,172512,244704
train,683,97,74496,1275,183600,258096
train,684,167,128256,3779,544176,672432
train,685,90,69120,1098,158112,227232
train,686,140,107520,2656,382464,489984
train,687,240,184320,7804,1123776,1308096
train,688,138,105984,2581,371664,477648
train,689,170,130560,3916,563904,694464
train,690,124,95232,2084,300096,395328
train,691,145,111360,2849,410256,521616
train,692,173,132864,4055,583920,716784
train,693,116,89088,1823,262512,351600
train,694,55,42240,410,59040,101280
train,695,138,105984,2581,371664,477648
train,696,97,74496,1275,183600,258096
train,697,142,109056,2732,393408,502464
train,698,172,132096,4009,577296,709392
train,699,202,155136,5529,796176,951312
train,700,212,162816,6090,876960,1039776
train,701,154,118272,3214,462816,581088
train,702,88,67584,1050,151200,218784
train,703,109,83712,1610,231840,315552
train,704,147,112896,2928,421632,534528
train,705,106,81408,1523,219312,300720
train,706,99,76032,1328,191232,267264
train,707,145,111360,2849,410256,521616
train,708,90,69120,1098,158112,227232
train,709,159,122112,3426,493344,615456
train,710,172,132096,4009,577296,709392
train,711,116,89088,1823,262512,351600
train,712,117,89856,1855,267120,356976
train,713,117,89856,1855,267120,356976
train,714,166,127488,3734,537696,665184
train,715,139,106752,2618,376992,483744
train,716,95,72960,1223,176112,249072
train,717,142,109056,2732,393408,502464
train,718,156,119808,3298,474912,594720
train,719,193,148224,5047,726768,874992
train,720,117,89856,1855,267120,356976
train,721,161,123648,3512,505728,629376
train,722,124,95232,2084,300096,395328
train,723,83,63744,934,134496,198240
train,724,156,119808,3298,474912,594720
train,725,119,91392,1919,276336,367728
train,726,119,91392,1919,276336,367728
train,727,136,104448,2506,360864,465312
train,728,109,83712,1610,231840,315552
train,729,149,114432,3008,433152,547584
train,730,102,78336,1410,203040,281376
train,731,108,82944,1581,227664,310608
train,732,126,96768,2151,309744,406512
train,733,176,135168,4197,604368,739536
train,734,192,147456,4995,719280,866736
train,735,232,178176,7293,1050192,1228368
train,736,143,109824,2771,399024,508848
train,737,73,56064,722,103968,160032
train,738,164,125952,3644,524736,650688
train,739,110,84480,1640,236160,320640
train,740,135,103680,2470,355680,459360
train,741,94,72192,1198,172512,244704
train,742,200,153600,5420,780480,934080
train,743,194,148992,5100,734400,883392
train,744,95,72960,1223,176112,249072
train,745,110,84480,1640,236160,320640
train,746,141,108288,2694,387936,496224
train,747,87,66816,1026,147744,214560
train,748,97,74496,1275,183600,258096
train,749,129,99072,2255,324720,423792
train,750,148,113664,2968,427392,541056
train,751,170,130560,3916,563904,694464
train,752,91,69888,1122,161568,231456
train,753,137,105216,2543,366192,471408
train,754,109,83712,1610,231840,315552
train,755,121,92928,1984,285696,378624
train,756,124,95232,2084,300096,395328
train,757,152,116736,3131,450864,567600
train,758,161,123648,3512,505728,629376
train,759,121,92928,1984,285696,378624
train,760,145,111360,2849,410256,521616
train,761,182,139776,4488,646272,786048
train,762,57,43776,441,63504,107280
train,763,73,56064,722,103968,160032
train,764,54,41472,395,56880,98352
train,765,140,107520,2656,382464,489984
train,766,154,118272,3214,462816,581088
train,767,191,146688,4943,711792,858480
train,768,183,140544,4538,653472,794016
train,769,98,75264,1302,187488,262752
train,770,86,66048,1002,144288,210336
train,771,120,92160,1951,280944,373104
train,772,171,131328,3962,570528,701856
train,773,161,123648,3512,505728,629376
train,774,150,115200,3049,439056,554256
train,775,179,137472,4341,625104,762576
train,776,121,92928,1984,285696,378624
train,777,107,82176,1552,223488,305664
train,778,91,69888,1122,161568,231456
train,779,97,74496,1275,183600,258096
train,780,142,109056,2732,393408,502464
train,781,80,61440,867,124848,186288
train,782,124,95232,2084,300096,395328
train,783,118,90624,1887,271728,362352
train,784,105,80640,1494,215136,295776
train,785,70,53760,664,95616,149376
train,786,140,107520,2656,382464,489984
train,787,157,120576,3340,480960,601536
train,788,55,42240,410,59040,101280
train,789,140,107520,2656,382464,489984
train,790,180,138240,4390,632160,770400
train,791,119,91392,1919,276336,367728
train,792,65,49920,573,82512,132432
train,793,183,140544,4538,653472,794016
train,794,144,110592,2810,404640,515232
train,795,89,68352,1074,154656,223008
train,796,128,98304,2220,319680,417984
train,797,103,79104,1438,207072,286176
train,798,83,63744,934,134496,198240
train,799,173,132864,4055,583920,716784
train,800,117,89856,1855,267120,356976
train,801,144,110592,2810,404640,515232
train,802,99,76032,1328,191232,267264
train,803,144,110592,2810,404640,515232
train,804,187,143616,4738,682272,825888
train,805,153,117504,3172,456768,574272
train,806,139,106752,2618,376992,483744
train,807,183,140544,4538,653472,794016
train,808,152,116736,3131,450864,567600
train,809,63,48384,538,77472,125856
train,810,112,86016,1700,244800,330816
train,811,194,148992,5100,734400,883392
train,812,82,62976,911,131184,194160
train,813,55,42240,410,59040,101280
train,814,195,149760,5152,741888,891648
train,815,169,129792,3870,557280,687072
train,816,180,138240,4390,632160,770400
train,817,212,162816,6090,876960,1039776
train,818,66,50688,591,85104,135792
train,819,211,162048,6032,868608,1030656
train,820,177,135936,4245,611280,747216
train,821,145,111360,2849,410256,521616
train,822,125,96000,2117,304848,400848
train,823,144,110592,2810,404640,515232
train,824,157,120576,3340,480960,601536
train,825,159,122112,3426,493344,615456
train,826,109,83712,1610,231840,315552
train,827,183,140544,4538,653472,794016
train,828,180,138240,4390,632160,770400
train,829,114,87552,1761,253584,341136
train,830,188,144384,4789,689616,834000
train,831,80,61440,867,124848,186288
train,832,152,116736,3131,450864,567600
train,833,178,136704,4293,618192,754896
train,834,160,122880,3469,499536,622416
train,835,162,124416,3556,512064,636480
train,836,175,134400,4150,597600,732000
train,837,115,88320,1792,258048,346368
train,838,83,63744,934,134496,198240
train,839,188,144384,4789,689616,834000
train,840,65,49920,573,82512,132432
train,841,147,112896,2928,421632,534528
train,842,83,63744,934,134496,198240
train,843,98,75264,1302,187488,262752
train,844,93,71424,1172,168768,240192
train,845,137,105216,2543,366192,471408
train,846,164,125952,3644,524736,650688
train,847,137,105216,2543,366192,471408
train,848,135,103680,2470,355680,459360
train,849,182,139776,4488,646272,786048
train,850,138,105984,2581,371664,477648
train,851,121,92928,1984,285696,378624
train,852,87,66816,1026,147744,214560
train,853,124,95232,2084,300096,395328
train,854,121,92928,1984,285696,378624
train,855,103,79104,1438,207072,286176
train,856,165,126720,3689,531216,657936
train,857,57,43776,441,63504,107280
train,858,110,84480,1640,236160,320640
train,859,198,152064,5236,753984,906048
train,860,216,165888,6322,910368,1076256
train,861,100,76800,1355,195120,271920
train,862,120,92160,1951,280944,373104
train,863,213,163584,5752,828288,991872
train,864,164,125952,3644,524736,650688
train,865,139,106752,2618,376992,483744
train,866,74,56832,742,106848,163680
train,867,99,76032,1328,191232,267264
train,868,83,63744,934,134496,198240
train,869,144,110592,2810,404640,515232
train,870,111,85248,1670,240480,325728
train,871,106,81408,1523,219312,300720
train,872,94,72192,1198,172512,244704
train,873,100,76800,1355,195120,271920
train,874,145,111360,2849,410256,521616
train,875,82,62976,911,131184,194160
train,876,170,130560,3916,563904,694464
train,877,192,147456,4995,719280,866736
train,878,132,101376,2361,339984,441360
train,879,143,109824,2771,399024,508848
train,880,143,109824,2771,399024,508848
train,881,77,59136,804,115776,174912
train,882,121,92928,1984,285696,378624
train,883,157,120576,3340,480960,601536
train,884,143,109824,2771,399024,508848
train,885,109,83712,1610,231840,315552
train,886,192,147456,4995,719280,866736
train,887,107,82176,1552,223488,305664
train,888,97,74496,1275,183600,258096
train,889,112,86016,1700,244800,330816
train,890,162,124416,3556,512064,636480
train,891,73,56064,722,103968,160032
train,892,138,105984,2581,371664,477648
train,893,159,122112,3426,493344,615456
train,894,163,125184,3600,518400,643584
train,895,175,134400,4150,597600,732000
train,896,67,51456,609,87696,139152
train,897,159,122112,3426,493344,615456
train,898,183,140544,4538,653472,794016
train,899,95,72960,1223,176112,249072
train,900,146,112128,2888,415872,528000
train,901,114,87552,1761,253584,341136
train,902,116,89088,1823,262512,351600
train,903,121,92928,1984,285696,378624
train,904,42,32256,239,34416,66672
train,905,79,60672,846,121824,182496
train,906,209,160512,5919,852336,1012848
train,907,166,127488,3734,537696,665184
train,908,209,160512,5919,852336,1012848
train,909,125,96000,2117,304848,400848
train,910,199,152832,5366,772704,925536
train,911,123,94464,2050,295200,389664
train,912,63,48384,538,77472,125856
train,913,124,95232,2084,300096,395328
train,914,119,91392,1919,276336,367728
train,915,124,95232,2084,300096,395328
train,916,140,107520,2656,382464,489984
train,917,118,90624,1887,271728,362352
train,918,90,69120,1098,158112,227232
train,919,151,115968,3090,444960,560928
train,920,140,107520,2656,382464,489984
train,921,137,105216,2543,366192,471408
train,922,88,67584,1050,151200,218784
train,923,135,103680,2470,355680,459360
train,924,162,124416,3556,512064,636480
train,925,181,139008,4439,639216,778224
train,926,116,89088,1823,262512,351600
train,927,107,82176,1552,223488,305664
train,928,77,59136,804,115776,174912
train,929,110,84480,1640,236160,320640
train,930,53,40704,381,54864,95568
train,931,130,99840,2290,329760,429600
train,932,216,165888,6322,910368,1076256
train,933,137,105216,2543,366192,471408
train,934,139,106752,2618,376992,483744
train,935,73,56064,722,103968,160032
train,936,148,113664,2968,427392,541056
train,937,133,102144,2397,345168,447312
train,938,125,96000,2117,304848,400848
train,939,149,114432,3008,433152,547584
train,940,106,81408,1523,219312,300720
train,941,207,158976,5806,836064,995040
train,942,156,119808,3298,474912,594720
train,943,155,119040,3255,468720,587760
train,944,85,65280,979,140976,206256
train,945,127,97536,2186,314784,412320
train,946,132,101376,2361,339984,441360
train,947,90,69120,1098,158112,227232
train,948,121,92928,1984,285696,378624
train,949,73,56064,722,103968,160032
train,950,186,142848,4646,669024,811872
train,951,180,138240,4390,632160,770400
train,952,146,112128,2888,415872,528000
train,953,154,118272,3214,462816,581088
train,954,182,139776,4488,646272,786048
train,955,125,96000,2117,304848,400848
train,956,79,60672,846,121824,182496
train,957,112,86016,1700,244800,330816
train,958,169,129792,3870,557280,687072
train,959,65,49920,573,82512,132432
train,960,119,91392,1919,276336,367728
train,961,84,64512,956,137664,202176
train,962,128,98304,2220,319680,417984
train,963,154,118272,3214,462816,581088
train,964,100,76800,1355,195120,271920
train,965,107,82176,1552,223488,305664
train,966,238,182784,7675,1105200,1287984
train,967,149,114432,3008,433152,547584
train,968,167,128256,3779,544176,672432
train,969,103,79104,1438,207072,286176
train,970,176,135168,4197,604368,739536
train,971,169,129792,3870,557280,687072
train,972,85,65280,979,140976,206256
train,973,196,150528,5205,749520,900048
train,974,122,93696,2017,290448,384144
train,975,184,141312,4587,660528,801840
train,976,118,90624,1887,271728,362352
train,977,148,113664,2968,427392,541056
train,978,121,92928,1984,285696,378624
train,979,179,137472,4341,625104,762576
train,980,224,172032,6752,972288,1144320
train,981,142,109056,2732,393408,502464
train,982,66,50688,591,85104,135792
train,983,85,65280,979,140976,206256
train,984,150,115200,3049,439056,554256
train,985,203,155904,5584,804096,960000
train,986,96,73728,1249,179856,253584
train,987,167,128256,3779,544176,672432
train,988,169,129792,3870,557280,687072
train,989,114,87552,1761,253584,341136
train,990,93,71424,1172,168768,240192
train,991,139,106752,2618,376992,483744
train,992,112,86016,1700,244800,330816
train,993,64,49152,555,79920,129072
train,994,152,116736,3131,450864,567600
train,995,142,109056,2732,393408,502464
train,996,168,129024,3824,550656,679680
train,997,111,85248,1670,240480,325728
train,998,170,130560,3916,563904,694464
train,999,122,93696,2017,290448,384144
train,1000,83,63744,934,134496,198240
train,1001,90,69120,1098,158112,227232
train,1002,119,91392,1919,276336,367728
train,1003,145,111360,2849,410256,521616
train,1004,117,89856,1855,267120,356976
train,1005,142,109056,2732,393408,502464
train,1006,99,76032,1328,191232,267264
train,1007,160,122880,3469,499536,622416
train,1008,156,119808,3298,474912,594720
train,1009,114,87552,1761,253584,341136
train,1010,127,97536,2186,314784,412320
train,1011,100,76800,1355,195120,271920
train,1012,117,89856,1855,267120,356976
train,1013,117,89856,1855,267120,356976
train,1014,138,105984,2581,371664,477648
train,1015,105,80640,1494,215136,295776
train,1016,103,79104,1438,207072,286176
train,1017,109,83712,1610,231840,315552
train,1018,159,122112,3426,493344,615456
train,1019,142,109056,2732,393408,502464
train,1020,129,99072,2255,324720,423792
train,1021,155,119040,3255,468720,587760
train,1022,138,105984,2581,371664,477648
train,1023,186,142848,4434,638496,781344
train,1024,127,97536,2186,314784,412320
train,1025,116,89088,1823,262512,351600
train,1026,163,125184,3600,518400,643584
train,1027,141,108288,2694,387936,496224
train,1028,88,67584,1050,151200,218784
train,1029,119,91392,1919,276336,367728
train,1030,66,50688,591,85104,135792
train,1031,118,90624,1887,271728,362352
train,1032,180,138240,4390,632160,770400
train,1033,165,126720,3689,531216,657936
train,1034,180,138240,4390,632160,770400
train,1035,125,96000,2117,304848,400848
train,1036,121,92928,1984,285696,378624
train,1037,135,103680,2470,355680,459360
train,1038,108,82944,1581,227664,310608
train,1039,145,111360,2849,410256,521616
train,1040,147,112896,2928,421632,534528
train,1041,117,89856,1855,267120,356976
train,1042,79,60672,846,121824,182496
train,1043,111,85248,1670,240480,325728
train,1044,114,87552,1761,253584,341136
train,1045,82,62976,911,131184,194160
train,1046,123,94464,2050,295200,389664
train,1047,92,70656,1147,165168,235824
train,1048,113,86784,1730,249120,335904
train,1049,143,109824,2771,399024,508848
train,1050,112,86016,1700,244800,330816
train,1051,172,132096,4009,577296,709392
train,1052,115,88320,1792,258048,346368
train,1053,145,111360,2849,410256,521616
train,1054,149,114432,3008,433152,547584
train,1055,128,98304,2220,319680,417984
train,1056,90,69120,1098,158112,227232
train,1057,122,93696,2017,290448,384144
train,1058,78,59904,825,118800,178704
train,1059,103,79104,1438,207072,286176
train,1060,82,62976,911,131184,194160
train,1061,163,125184,3600,518400,643584
train,1062,121,92928,1984,285696,378624
train,1063,164,125952,3644,524736,650688
train,1064,169,129792,3870,557280,687072
train,1065,69,52992,645,92880,145872
train,1066,133,102144,2397,345168,447312
train,1067,113,86784,1730,249120,335904
train,1068,160,122880,3469,499536,622416
train,1069,117,89856,1855,267120,356976
train,1070,169,129792,3870,557280,687072
train,1071,118,90624,1887,271728,362352
train,1072,128,98304,2220,319680,417984
train,1073,100,76800,1355,195120,271920
train,1074,80,61440,867,124848,186288
train,1075,121,92928,1984,285696,378624
train,1076,167,128256,3779,544176,672432
train,1077,159,122112,3426,493344,615456
train,1078,98,75264,1302,187488,262752
train,1079,178,136704,4293,618192,754896
train,1080,145,111360,2849,410256,521616
train,1081,152,116736,3131,450864,567600
train,1082,118,90624,1887,271728,362352
train,1083,88,67584,1050,151200,218784
train,1084,111,85248,1670,240480,325728
train,1085,94,72192,1198,172512,244704
train,1086,91,69888,1122,161568,231456
train,1087,55,42240,410,59040,101280
train,1088,58,44544,456,65664,110208
train,1089,130,99840,2290,329760,429600
train,1090,172,132096,4009,577296,709392
train,1091,113,86784,1730,249120,335904
train,1092,127,97536,2186,314784,412320
train,1093,214,164352,5876,846144,1010496
train,1094,130,99840,2290,329760,429600
train,1095,82,62976,911,131184,194160
train,1096,155,119040,3255,468720,587760
train,1097,206,158208,5750,828000,986208
train,1098,182,139776,4488,646272,786048
train,1099,152,116736,3131,450864,567600
train,1100,200,153600,5420,780480,934080
train,1101,90,69120,1098,158112,227232
train,1102,137,105216,2543,366192,471408
train,1103,191,146688,4943,711792,858480
train,1104,100,76800,1355,195120,271920
train,1105,56,43008,425,61200,104208
train,1106,140,107520,2656,382464,489984
train,1107,171,131328,3962,570528,701856
train,1108,59,45312,472,67968,113280
train,1109,198,152064,5312,764928,916992
train,1110,140,107520,2656,382464,489984
train,1111,100,76800,1355,195120,271920
train,1112,164,125952,3644,524736,650688
train,1113,119,91392,1919,276336,367728
train,1114,151,115968,3090,444960,560928
train,1115,140,107520,2656,382464,489984
train,1116,72,55296,703,101232,156528
train,1117,203,155904,5584,804096,960000
train,1118,125,96000,2117,304848,400848
train,1119,126,96768,2151,309744,406512
train,1120,127,97536,2186,314784,412320
train,1121,87,66816,1026,147744,214560
train,1122,144,110592,2810,404640,515232
train,1123,86,66048,1002,144288,210336
train,1124,51,39168,353,50832,90000
train,1125,129,99072,2255,324720,423792
train,1126,199,152832,5366,772704,925536
train,1127,216,165888,6322,910368,1076256
train,1128,66,50688,591,85104,135792
train,1129,80,61440,867,124848,186288
train,1130,142,109056,2732,393408,502464
train,1131,131,100608,2325,334800,435408
train,1132,116,89088,1823,262512,351600
train,1133,199,152832,5077,731088,883920
train,1134,68,52224,627,90288,142512
train,1135,62,47616,521,75024,122640
train,1136,132,101376,2361,339984,441360
train,1137,140,107520,2656,382464,489984
train,1138,162,124416,3556,512064,636480
train,1139,74,56832,742,106848,163680
train,1140,188,144384,4789,689616,834000
train,1141,88,67584,1050,151200,218784
train,1142,76,58368,783,112752,171120
train,1143,182,139776,4488,646272,786048
train,1144,145,111360,2849,410256,521616
train,1145,138,105984,2581,371664,477648
train,1146,100,76800,1355,195120,271920
train,1147,133,102144,2397,345168,447312
train,1148,134,102912,2433,350352,453264
train,1149,164,125952,3644,524736,650688
train,1150,166,127488,3734,537696,665184
train,1151,141,108288,2694,387936,496224
train,1152,148,113664,2968,427392,541056
train,1153,128,98304,2220,319680,417984
train,1154,104,79872,1466,211104,290976
train,1155,200,153600,5420,780480,934080
train,1156,135,103680,2470,355680,459360
train,1157,164,125952,3644,524736,650688
train,1158,156,119808,3298,474912,594720
train,1159,96,73728,1249,179856,253584
train,1160,70,53760,664,95616,149376
train,1161,179,137472,4341,625104,762576
train,1162,172,132096,4009,577296,709392
train,1163,138,105984,2581,371664,477648
train,1164,202,155136,4886,703584,858720
train,1165,104,79872,1466,211104,290976
train,1166,123,94464,2050,295200,389664
train,1167,88,67584,1050,151200,218784
train,1168,64,49152,555,79920,129072
train,1169,104,79872,1466,211104,290976
train,1170,131,100608,2325,334800,435408
train,1171,125,96000,2117,304848,400848
train,1172,93,71424,1172,168768,240192
train,1173,221,169728,5908,850752,1020480
train,1174,79,60672,846,121824,182496
train,1175,172,132096,4009,577296,709392
train,1176,137,105216,2543,366192,471408
train,1177,148,113664,2968,427392,541056
train,1178,92,70656,1147,165168,235824
train,1179,175,134400,4150,597600,732000
train,1180,61,46848,505,72720,119568
train,1181,36,27648,176,25344,52992
train,1182,102,78336,1410,203040,281376
train,1183,253,194304,8254,1188576,1382880
train,1184,107,82176,1552,223488,305664
train,1185,143,109824,2771,399024,508848
train,1186,139,106752,2410,347040,453792
train,1187,174,133632,4102,590688,724320
train,1188,214,164352,6205,893520,1057872
train,1189,119,91392,1919,276336,367728
train,1190,163,125184,3600,518400,643584
train,1191,154,118272,3214,462816,581088
train,1192,92,70656,1147,165168,235824
train,1193,165,126720,3689,531216,657936
train,1194,151,115968,3090,444960,560928
train,1195,107,82176,1552,223488,305664
train,1196,104,79872,1466,211104,290976
train,1197,135,103680,2470,355680,459360
train,1198,127,97536,2186,314784,412320
train,1199,148,113664,2968,427392,541056
train,1200,100,76800,1355,195120,271920
train,1201,164,125952,3644,524736,650688
train,1202,121,92928,1984,285696,378624
train,1203,181,139008,4439,639216,778224
train,1204,141,108288,2694,387936,496224
train,1205,51,39168,353,50832,90000
train,1206,99,76032,1328,191232,267264
train,1207,101,77568,1382,199008,276576
train,1208,135,103680,2470,355680,459360
train,1209,175,134400,4150,597600,732000
train,1210,141,108288,2694,387936,496224
train,1211,98,75264,1302,187488,262752
train,1212,144,110592,2810,404640,515232
train,1213,220,168960,6262,901728,1070688
train,1214,166,127488,3734,537696,665184
train,1215,93,71424,1172,168768,240192
train,1216,106,81408,1523,219312,300720
train,1217,142,109056,2732,393408,502464
train,1218,161,123648,3512,505728,629376
train,1219,92,70656,1147,165168,235824
train,1220,139,106752,2618,376992,483744
train,1221,205,157440,5051,727344,884784
train,1222,109,83712,1610,231840,315552
train,1223,132,101376,2361,339984,441360
train,1224,127,97536,2186,314784,412320
train,1225,45,34560,275,39600,74160
train,1226,147,112896,2928,421632,534528
train,1227,157,120576,3340,480960,601536
train,1228,223,171264,6237,898128,1069392
train,1229,76,58368,783,112752,171120
train,1230,151,115968,3090,444960,560928
train,1231,74,56832,742,106848,163680
train,1232,160,122880,3469,499536,622416
train,1233,185,142080,4637,667728,809808
train,1234,142,109056,2732,393408,502464
train,1235,162,124416,3556,512064,636480
train,1236,61,46848,505,72720,119568
train,1237,130,99840,2290,329760,429600
train,1238,121,92928,1984,285696,378624
train,1239,103,79104,1438,207072,286176
train,1240,132,101376,2361,339984,441360
train,1241,143,109824,2771,399024,508848
train,1242,119,91392,1919,276336,367728
train,1243,80,61440,867,124848,186288
train,1244,104,79872,1466,211104,290976
train,1245,170,130560,3916,563904,694464
train,1246,111,85248,1670,240480,325728
train,1247,138,105984,2581,371664,477648
train,1248,47,36096,300,43200,79296
train,1249,128,98304,2220,319680,417984
train,1250,122,93696,2017,290448,384144
train,1251,60,46080,488,70272,116352
train,1252,242,185856,7168,1032192,1218048
train,1253,142,109056,2732,393408,502464
train,1254,77,59136,804,115776,174912
train,1255,150,115200,3049,439056,554256
train,1256,39,29952,206,29664,59616
train,1257,97,74496,1275,183600,258096
train,1258,97,74496,1275,183600,258096
train,1259,138,105984,2581,371664,477648
train,1260,123,94464,2050,295200,389664
train,1261,165,126720,3689,531216,657936
train,1262,148,113664,2968,427392,541056
train,1263,170,130560,3916,563904,694464
train,1264,126,96768,2151,309744,406512
train,1265,143,109824,2771,399024,508848
train,1266,112,86016,1700,244800,330816
train,1267,136,104448,2506,360864,465312
train,1268,169,129792,3870,557280,687072
train,1269,133,102144,2397,345168,447312
train,1270,81,62208,889,128016,190224
train,1271,124,95232,2084,300096,395328
train,1272,101,77568,1382,199008,276576
train,1273,135,103680,2470,355680,459360
train,1274,78,59904,825,118800,178704
train,1275,123,94464,2050,295200,389664
train,1276,88,67584,1050,151200,218784
train,1277,120,92160,1951,280944,373104
train,1278,170,130560,3916,563904,694464
train,1279,120,92160,1951,280944,373104
train,1280,185,142080,4637,667728,809808
train,1281,134,102912,2433,350352,453264
train,1282,108,82944,1581,227664,310608
train,1283,126,96768,2151,309744,406512
train,1284,98,75264,1302,187488,262752
train,1285,109,83712,1610,231840,315552
train,1286,186,142848,4688,675072,817920
train,1287,157,120576,3340,480960,601536
train,1288,65,49920,573,82512,132432
train,1289,115,88320,1792,258048,346368
train,1290,187,143616,4554,655776,799392
train,1291,168,129024,3824,550656,679680
train,1292,51,39168,353,50832,90000
train,1293,134,102912,2433,350352,453264
train,1294,104,79872,1466,211104,290976
train,1295,110,84480,1640,236160,320640
train,1296,94,72192,1198,172512,244704
train,1297,113,86784,1730,249120,335904
train,1298,96,73728,1249,179856,253584
train,1299,145,111360,2849,410256,521616
train,1300,119,91392,1919,276336,367728
train,1301,105,80640,1494,215136,295776
train,1302,153,117504,3172,456768,574272
train,1303,145,111360,2849,410256,521616
train,1304,103,79104,1438,207072,286176
train,1305,173,132864,4055,583920,716784
train,1306,129,99072,2255,324720,423792
train,1307,77,59136,804,115776,174912
train,1308,71,54528,683,98352,152880
train,1309,122,93696,2017,290448,384144
train,1310,100,76800,1355,195120,271920
train,1311,198,152064,5312,764928,916992
train,1312,194,148992,4409,634896,783888
train,1313,120,92160,1951,280944,373104
train,1314,174,133632,4102,590688,724320
train,1315,179,137472,4341,625104,762576
train,1316,102,78336,1410,203040,281376
train,1317,207,158976,5074,730656,889632
train,1318,159,122112,3426,493344,615456
train,1319,228,175104,6166,887904,1063008
train,1320,106,81408,1523,219312,300720
train,1321,156,119808,3298,474912,594720
train,1322,125,96000,2117,304848,400848
train,1323,97,74496,1275,183600,258096
train,1324,163,125184,3600,518400,643584
train,1325,93,71424,1172,168768,240192
train,1326,165,126720,3689,531216,657936
train,1327,136,104448,2506,360864,465312
train,1328,193,148224,4826,694944,843168
train,1329,153,117504,3172,456768,574272
train,1330,156,119808,3298,474912,594720
train,1331,62,47616,521,75024,122640
train,1332,115,88320,1792,258048,346368
train,1333,211,162048,6032,868608,1030656
train,1334,133,102144,2397,345168,447312
train,1335,116,89088,1823,262512,351600
train,1336,130,99840,2290,329760,429600
train,1337,162,124416,3556,512064,636480
train,1338,106,81408,1523,219312,300720
train,1339,160,122880,3469,499536,622416
train,1340,198,152064,5312,764928,916992
train,1341,162,124416,3556,512064,636480
train,1342,102,78336,1410,203040,281376
train,1343,36,27648,176,25344,52992
train,1344,157,120576,3340,480960,601536
train,1345,125,96000,2117,304848,400848
train,1346,54,41472,395,56880,98352
train,1347,129,99072,2255,324720,423792
train,1348,130,99840,2290,329760,429600
train,1349,81,62208,889,128016,190224
train,1350,177,135936,4245,611280,747216
train,1351,111,85248,1670,240480,325728
train,1352,181,139008,4439,639216,778224
train,1353,42,32256,239,34416,66672
train,1354,142,109056,2732,393408,502464
train,1355,98,75264,1302,187488,262752
train,1356,186,142848,4688,675072,817920
train,1357,165,126720,3689,531216,657936
train,1358,86,66048,1002,144288,210336
train,1359,70,53760,664,95616,149376
train,1360,145,111360,2849,410256,521616
train,1361,165,126720,3689,531216,657936
train,1362,82,62976,911,131184,194160
train,1363,63,48384,538,77472,125856
train,1364,236,181248,7000,1008000,1189248
train,1365,139,106752,2618,376992,483744
train,1366,111,85248,1670,240480,325728
train,1367,113,86784,1730,249120,335904
train,1368,134,102912,2433,350352,453264
train,1369,56,43008,425,61200,104208
train,1370,126,96768,2151,309744,406512
train,1371,129,99072,2255,324720,423792
train,1372,244,187392,8067,1161648,1349040
train,1373,223,171264,6267,902448,1073712
train,1374,105,80640,1494,215136,295776
train,1375,116,89088,1823,262512,351600
train,1376,171,131328,3962,570528,701856
train,1377,190,145920,4891,704304,850224
train,1378,145,111360,2849,410256,521616
train,1379,123,94464,2050,295200,389664
train,1380,149,114432,3008,433152,547584
train,1381,146,112128,2888,415872,528000
train,1382,103,79104,1438,207072,286176
train,1383,173,132864,4055,583920,716784
train,1384,113,86784,1730,249120,335904
train,1385,116,89088,1823,262512,351600
train,1386,109,83712,1610,231840,315552
train,1387,35,26880,166,23904,50784
train,1388,93,71424,1172,168768,240192
train,1389,168,129024,3824,550656,679680
train,1390,143,109824,2771,399024,508848
train,1391,182,139776,4488,646272,786048
train,1392,181,139008,4439,639216,778224
train,1393,59,45312,472,67968,113280
train,1394,140,107520,2656,382464,489984
train,1395,197,151296,5258,757152,908448
train,1396,96,73728,1249,179856,253584
train,1397,170,130560,3916,563904,694464
train,1398,58,44544,456,65664,110208
train,1399,80,61440,867,124848,186288
train,1400,227,174336,6386,919584,1093920
train,1401,76,58368,783,112752,171120
train,1402,199,152832,5252,756288,909120
train,1403,204,156672,5639,812016,968688
train,1404,64,49152,555,79920,129072
train,1405,176,135168,4197,604368,739536
train,1406,109,83712,1610,231840,315552
train,1407,200,153600,5420,780480,934080
train,1408,147,112896,2928,421632,534528
train,1409,175,134400,4150,597600,732000
train,1410,152,116736,3131,450864,567600
train,1411,106,81408,1523,219312,300720
train,1412,81,62208,889,128016,190224
train,1413,103,79104,1438,207072,286176
train,1414,126,96768,2151,309744,406512
train,1415,147,112896,2928,421632,534528
train,1416,246,188928,7853,1130832,1319760
train,1417,125,96000,2117,304848,400848
train,1418,181,139008,4439,639216,778224
train,1419,160,122880,3469,499536,622416
train,1420,163,125184,3600,518400,643584
train,1421,151,115968,3090,444960,560928
train,1422,211,162048,5696,820224,982272
train,1423,101,77568,1382,199008,276576
train,1424,149,114432,3008,433152,547584
train,1425,157,120576,3340,480960,601536
train,1426,165,126720,3689,531216,657936
train,1427,149,114432,3008,433152,547584
train,1428,106,81408,1523,219312,300720
train,1429,91,69888,1122,161568,231456
train,1430,177,135936,4245,611280,747216
train,1431,129,99072,2255,324720,423792
train,1432,145,111360,2849,410256,521616
train,1433,186,142848,4688,675072,817920
train,1434,167,128256,3779,544176,672432
train,1435,116,89088,1823,262512,351600
train,1436,174,133632,4102,590688,724320
train,1437,208,159744,5862,844128,1003872
train,1438,165,126720,3689,531216,657936
train,1439,174,133632,4102,590688,724320
train,1440,97,74496,1275,183600,258096
train,1441,136,104448,2506,360864,465312
train,1442,189,145152,4840,696960,842112
train,1443,159,122112,3426,493344,615456
train,1444,155,119040,3255,468720,587760
train,1445,56,43008,425,61200,104208
train,1446,179,137472,4341,625104,762576
train,1447,126,96768,2151,309744,406512
train,1448,100,76800,1355,195120,271920
train,1449,184,141312,4232,609408,750720
train,1450,186,142848,4688,675072,817920
train,1451,141,108288,2694,387936,496224
train,1452,172,132096,4009,577296,709392
train,1453,156,119808,3298,474912,594720
train,1454,133,102144,2397,345168,447312
train,1455,204,156672,5639,812016,968688
train,1456,156,119808,3298,474912,594720
train,1457,205,157440,5694,819936,977376
train,1458,138,105984,2581,371664,477648
train,1459,143,109824,2771,399024,508848
train,1460,191,146688,4943,711792,858480
train,1461,123,94464,2050,295200,389664
train,1462,174,133632,4102,590688,724320
train,1463,106,81408,1523,219312,300720
train,1464,91,69888,1122,161568,231456
train,1465,120,92160,1951,280944,373104
train,1466,210,161280,5975,860400,1021680
train,1467,144,110592,2810,404640,515232
train,1468,151,115968,3090,444960,560928
train,1469,187,143616,4738,682272,825888
train,1470,81,62208,889,128016,190224
train,1471,50,38400,339,48816,87216
train,1472,170,130560,3916,563904,694464
train,1473,212,162816,5216,751104,913920
train,1474,163,125184,3600,518400,643584
train,1475,144,110592,2810,404640,515232
train,1476,174,133632,4102,590688,724320
train,1477,109,83712,1610,231840,315552
train,1478,104,79872,1466,211104,290976
train,1479,145,111360,2849,410256,521616
train,1480,102,78336,1410,203040,281376
train,1481,167,128256,3779,544176,672432
train,1482,187,143616,4738,682272,825888
train,1483,159,122112,3426,493344,615456
train,1484,119,91392,1919,276336,367728
train,1485,143,109824,2771,399024,508848
train,1486,101,77568,1382,199008,276576
train,1487,115,88320,1792,258048,346368
train,1488,210,161280,5975,860400,1021680
train,1489,130,99840,2290,329760,429600
train,1490,109,83712,1610,231840,315552
train,1491,126,96768,2151,309744,406512
train,1492,159,122112,3426,493344,615456
train,1493,80,61440,867,124848,186288
train,1494,152,116736,3131,450864,567600
train,1495,50,38400,339,48816,87216
train,1496,137,105216,2543,366192,471408
train,1497,207,158976,5806,836064,995040
train,1498,188,144384,4789,689616,834000
train,1499,208,159744,5862,844128,1003872
train,1500,135,103680,2470,355680,459360
train,1501,127,97536,2186,314784,412320
train,1502,160,122880,3469,499536,622416
train,1503,190,145920,4891,704304,850224
train,1504,70,53760,664,95616,149376
train,1505,71,54528,683,98352,152880
train,1506,193,148224,5047,726768,874992
train,1507,168,129024,3824,550656,679680
train,1508,160,122880,3469,499536,622416
train,1509,191,146688,4943,711792,858480
train,1510,246,188928,7601,1094544,1283472
train,1511,148,113664,2968,427392,541056
train,1512,193,148224,5047,726768,874992
train,1513,203,155904,5584,804096,960000
train,1514,114,87552,1761,253584,341136
train,1515,143,109824,2771,399024,508848
train,1516,126,96768,2151,309744,406512
train,1517,191,146688,4841,697104,843792
train,1518,67,51456,609,87696,139152
train,1519,50,38400,339,48816,87216
train,1520,128,98304,2220,319680,417984
train,1521,155,119040,3255,468720,587760
train,1522,169,129792,3870,557280,687072
train,1523,117,89856,1855,267120,356976
train,1524,138,105984,2581,371664,477648
train,1525,117,89856,1855,267120,356976
train,1526,62,47616,521,75024,122640
train,1527,161,123648,3512,505728,629376
train,1528,136,104448,2506,360864,465312
train,1529,138,105984,2581,371664,477648
train,1530,232,178176,7293,1050192,1228368
train,1531,165,126720,3689,531216,657936
train,1532,163,125184,3600,518400,643584
train,1533,129,99072,2255,324720,423792
train,1534,161,123648,3512,505728,629376
train,1535,153,117504,3172,456768,574272
train,1536,126,96768,2151,309744,406512
train,1537,158,121344,3383,487152,608496
train,1538,202,155136,5529,796176,951312
train,1539,129,99072,2255,324720,423792
train,1540,119,91392,1919,276336,367728
train,1541,67,51456,609,87696,139152
train,1542,145,111360,2849,410256,521616
train,1543,79,60672,846,121824,182496
train,1544,157,120576,3340,480960,601536
train,1545,123,94464,2050,295200,389664
train,1546,177,135936,4245,611280,747216
train,1547,154,118272,3214,462816,581088
train,1548,185,142080,4637,667728,809808
train,1549,146,112128,2888,415872,528000
train,1550,197,151296,5258,757152,908448
train,1551,188,144384,4370,629280,773664
train,1552,210,161280,5975,860400,1021680
train,1553,127,97536,2186,314784,412320
train,1554,83,63744,934,134496,198240
train,1555,199,152832,5366,772704,925536
train,1556,153,117504,3172,456768,574272
train,1557,199,152832,5366,772704,925536
train,1558,143,109824,2771,399024,508848
train,1559,131,100608,2325,334800,435408
train,1560,164,125952,3644,524736,650688
train,1561,157,120576,3340,480960,601536
train,1562,154,118272,3214,462816,581088
train,1563,121,92928,1984,285696,378624
train,1564,79,60672,846,121824,182496
train,1565,181,139008,4439,639216,778224
train,1566,52,39936,367,52848,92784
train,1567,156,119808,3214,462816,582624
train,1568,138,105984,2581,371664,477648
train,1569,173,132864,4055,583920,716784
train,1570,168,129024,3824,550656,679680
train,1571,144,110592,2810,404640,515232
train,1572,126,96768,2151,309744,406512
train,1573,136,104448,2506,360864,465312
train,1574,122,93696,2017,290448,384144
train,1575,100,76800,1355,195120,271920
train,1576,126,96768,2151,309744,406512
train,1577,168,129024,3824,550656,679680
train,1578,114,87552,1761,253584,341136
train,1579,66,50688,591,85104,135792
train,1580,95,72960,1223,176112,249072
train,1581,183,140544,4538,653472,794016
train,1582,109,83712,1610,231840,315552
train,1583,115,88320,1792,258048,346368
train,1584,45,34560,275,39600,74160
train,1585,125,96000,2117,304848,400848
train,1586,102,78336,1410,203040,281376
train,1587,95,72960,1223,176112,249072
train,1588,186,142848,4688,675072,817920
train,1589,91,69888,1122,161568,231456
train,1590,188,144384,4789,689616,834000
train,1591,156,119808,3298,474912,594720
train,1592,157,120576,3340,480960,601536
train,1593,128,98304,2220,319680,417984
train,1594,127,97536,2186,314784,412320
train,1595,107,82176,1552,223488,305664
train,1596,96,73728,1249,179856,253584
train,1597,88,67584,1050,151200,218784
train,1598,107,82176,1552,223488,305664
train,1599,128,98304,2220,319680,417984
train,1600,155,119040,3255,468720,587760
train,1601,131,100608,2325,334800,435408
train,1602,84,64512,956,137664,202176
train,1603,180,138240,4390,632160,770400
train,1604,161,123648,3512,505728,629376
train,1605,137,105216,2543,366192,471408
train,1606,201,154368,5474,788256,942624
train,1607,206,158208,5750,828000,986208
train,1608,148,113664,2968,427392,541056
train,1609,127,97536,2186,314784,412320
train,1610,140,107520,2656,382464,489984
train,1611,108,82944,1581,227664,310608
train,1612,65,49920,573,82512,132432
train,1613,101,77568,1382,199008,276576
train,1614,203,155904,4924,709056,864960
train,1615,148,113664,2968,427392,541056
train,1616,71,54528,683,98352,152880
train,1617,222,170496,5553,799632,970128
train,1618,232,178176,7293,1050192,1228368
train,1619,135,103680,2470,355680,459360
train,1620,139,106752,2618,376992,483744
train,1621,188,144384,4789,689616,834000
train,1622,151,115968,3090,444960,560928
train,1623,118,90624,1887,271728,362352
train,1624,165,126720,3689,531216,657936
train,1625,132,101376,2361,339984,441360
train,1626,166,127488,3734,537696,665184
train,1627,131,100608,2325,334800,435408
train,1628,106,81408,1523,219312,300720
train,1629,129,99072,2255,324720,423792
train,1630,181,139008,4439,639216,778224
train,1631,70,53760,664,95616,149376
train,1632,118,90624,1887,271728,362352
train,1633,105,80640,1494,215136,295776
train,1634,195,149760,5152,741888,891648
train,1635,50,38400,339,48816,87216
train,1636,113,86784,1730,249120,335904
train,1637,195,149760,5152,741888,891648
train,1638,160,122880,3469,499536,622416
train,1639,135,103680,2470,355680,459360
train,1640,151,115968,3090,444960,560928
train,1641,140,107520,2656,382464,489984
train,1642,79,60672,846,121824,182496
train,1643,173,132864,4055,583920,716784
train,1644,126,96768,2151,309744,406512
train,1645,133,102144,2397,345168,447312
train,1646,196,150528,5205,749520,900048
train,1647,63,48384,538,77472,125856
train,1648,171,131328,3962,570528,701856
train,1649,180,138240,4390,632160,770400
train,1650,101,77568,1382,199008,276576
train,1651,158,121344,3383,487152,608496
train,1652,102,78336,1410,203040,281376
train,1653,125,96000,2117,304848,400848
train,1654,191,146688,4943,711792,858480
train,1655,129,99072,2255,324720,423792
train,1656,119,91392,1919,276336,367728
train,1657,165,126720,3689,531216,657936
train,1658,143,109824,2771,399024,508848
train,1659,94,72192,1198,172512,244704
train,1660,174,133632,4102,590688,724320
train,1661,65,49920,573,82512,132432
train,1662,98,75264,1302,187488,262752
train,1663,170,130560,3916,563904,694464
train,1664,143,109824,2771,399024,508848
train,1665,173,132864,4055,583920,716784
train,1666,184,141312,4587,660528,801840
train,1667,176,135168,4197,604368,739536
train,1668,111,85248,1670,240480,325728
train,1669,202,155136,5529,796176,951312
train,1670,68,52224,627,90288,142512
train,1671,125,96000,2117,304848,400848
train,1672,135,103680,2470,355680,459360
train,1673,127,97536,2186,314784,412320
train,1674,103,79104,1438,207072,286176
train,1675,131,100608,2325,334800,435408
train,1676,157,120576,3340,480960,601536
train,1677,207,158976,5806,836064,995040
train,1678,177,135936,4245,611280,747216
train,1679,37,28416,186,26784,55200
train,1680,62,47616,521,75024,122640
train,1681,45,34560,275,39600,74160
train,1682,126,96768,2151,309744,406512
train,1683,178,136704,4293,618192,754896
train,1684,137,105216,2543,366192,471408
train,1685,164,125952,3644,524736,650688
train,1686,226,173568,6920,996480,1170048
train,1687,148,113664,2968,427392,541056
train,1688,139,106752,2618,376992,483744
train,1689,147,112896,2928,421632,534528
train,1690,135,103680,2470,355680,459360
train,1691,203,155904,5584,804096,960000
train,1692,118,90624,1887,271728,362352
train,1693,164,125952,3644,524736,650688
train,1694,114,87552,1761,253584,341136
train,1695,45,34560,275,39600,74160
train,1696,39,29952,206,29664,59616
train,1697,105,80640,1494,215136,295776
train,1698,248,190464,8333,1199952,1390416
train,1699,170,130560,3916,563904,694464
train,1700,114,87552,1761,253584,341136
train,1701,163,125184,3600,518400,643584
train,1702,134,102912,2433,350352,453264
train,1703,172,132096,4009,577296,709392
train,1704,145,111360,2849,410256,521616
train,1705,156,119808,3298,474912,594720
train,1706,56,43008,425,61200,104208
train,1707,118,90624,1887,271728,362352
train,1708,65,49920,573,82512,132432
train,1709,161,123648,3512,505728,629376
train,1710,174,133632,4102,590688,724320
train,1711,114,87552,1761,253584,341136
train,1712,79,60672,846,121824,182496
train,1713,187,143616,4738,682272,825888
train,1714,194,148992,5100,734400,883392
train,1715,80,61440,867,124848,186288
train,1716,183,140544,4538,653472,794016
train,1717,112,86016,1700,244800,330816
train,1718,88,67584,1050,151200,218784
train,1719,166,127488,3734,537696,665184
train,1720,192,147456,4461,642384,789840
train,1721,149,114432,3008,433152,547584
train,1722,145,111360,2849,410256,521616
train,1723,190,145920,4891,704304,850224
train,1724,148,113664,2968,427392,541056
train,1725,186,142848,4688,675072,817920
train,1726,160,122880,3469,499536,622416
train,1727,164,125952,3644,524736,650688
train,1728,123,94464,2050,295200,389664
train,1729,100,76800,1355,195120,271920
train,1730,126,96768,2151,309744,406512
train,1731,62,47616,521,75024,122640
train,1732,157,120576,3340,480960,601536
train,1733,163,125184,3600,518400,643584
train,1734,128,98304,2220,319680,417984
train,1735,76,58368,783,112752,171120
train,1736,150,115200,3049,439056,554256
train,1737,202,155136,4831,695664,850800
train,1738,171,131328,3962,570528,701856
train,1739,93,71424,1172,168768,240192
train,1740,155,119040,3255,468720,587760
train,1741,170,130560,3916,563904,694464
train,1742,129,99072,2255,324720,423792
train,1743,165,126720,3658,526752,653472
train,1744,99,76032,1328,191232,267264
train,1745,132,101376,2361,339984,441360
train,1746,85,65280,979,140976,206256
train,1747,150,115200,3049,439056,554256
train,1748,182,139776,4488,646272,786048
train,1749,104,79872,1466,211104,290976
train,1750,195,149760,4795,690480,840240
train,1751,98,75264,1302,187488,262752
train,1752,32,24576,139,20016,44592
train,1753,121,92928,1984,285696,378624
train,1754,149,114432,3008,433152,547584
train,1755,74,56832,742,106848,163680
train,1756,74,56832,742,106848,163680
train,1757,144,110592,2810,404640,515232
train,1758,108,82944,1581,227664,310608
train,1759,100,76800,1355,195120,271920
train,1760,178,136704,4293,618192,754896
train,1761,108,82944,1581,227664,310608
train,1762,79,60672,846,121824,182496
train,1763,110,84480,1640,236160,320640
train,1764,145,111360,2849,410256,521616
train,1765,76,58368,783,112752,171120
train,1766,151,115968,3090,444960,560928
train,1767,119,91392,1919,276336,367728
train,1768,177,135936,4245,611280,747216
train,1769,126,96768,2151,309744,406512
train,1770,162,124416,3556,512064,636480
train,1771,172,132096,4009,577296,709392
train,1772,216,165888,6322,910368,1076256
train,1773,207,158976,5050,727200,886176
train,1774,122,93696,2017,290448,384144
train,1775,95,72960,1223,176112,249072
train,1776,151,115968,3090,444960,560928
train,1777,197,151296,5258,757152,908448
train,1778,105,80640,1494,215136,295776
train,1779,179,137472,4341,625104,762576
train,1780,83,63744,934,134496,198240
train,1781,142,109056,2732,393408,502464
train,1782,176,135168,3396,489024,624192
train,1783,187,143616,4738,682272,825888
train,1784,84,64512,956,137664,202176
train,1785,168,129024,3824,550656,679680
train,1786,224,172032,5735,825840,997872
train,1787,100,76800,1355,195120,271920
train,1788,138,105984,2581,371664,477648
train,1789,197,151296,5258,757152,908448
train,1790,128,98304,2220,319680,417984
train,1791,125,96000,2117,304848,400848
train,1792,174,133632,4102,590688,724320
train,1793,137,105216,2543,366192,471408
train,1794,122,93696,2017,290448,384144
train,1795,109,83712,1610,231840,315552
train,1796,80,61440,867,124848,186288
train,1797,76,58368,783,112752,171120
train,1798,128,98304,2220,319680,417984
train,1799,178,136704,4293,618192,754896
train,1800,135,103680,2470,355680,459360
train,1801,166,127488,3734,537696,665184
train,1802,213,163584,6147,885168,1048752
train,1803,185,142080,4637,667728,809808
train,1804,185,142080,4637,667728,809808
train,1805,114,87552,1761,253584,341136
train,1806,95,72960,1223,176112,249072
train,1807,131,100608,2325,334800,435408
train,1808,227,174336,6982,1005408,1179744
train,1809,56,43008,425,61200,104208
train,1810,165,126720,3689,531216,657936
train,1811,109,83712,1610,231840,315552
train,1812,177,135936,4245,611280,747216
train,1813,99,76032,1328,191232,267264
train,1814,79,60672,846,121824,182496
train,1815,112,86016,1700,244800,330816
train,1816,116,89088,1823,262512,351600
train,1817,92,70656,1147,165168,235824
train,1818,54,41472,395,56880,98352
train,1819,114,87552,1761,253584,341136
train,1820,65,49920,573,82512,132432
train,1821,185,142080,4637,667728,809808
train,1822,56,43008,425,61200,104208
train,1823,128,98304,2220,319680,417984
train,1824,171,131328,3962,570528,701856
train,1825,148,113664,2968,427392,541056
train,1826,175,134400,4150,597600,732000
train,1827,146,112128,2888,415872,528000
train,1828,75,57600,762,109728,167328
train,1829,164,125952,3644,524736,650688
train,1830,173,132864,4055,583920,716784
train,1831,142,109056,2732,393408,502464
train,1832,165,126720,3689,531216,657936
train,1833,105,80640,1494,215136,295776
train,1834,86,66048,1002,144288,210336
train,1835,149,114432,3008,433152,547584
train,1836,174,133632,4102,590688,724320
train,1837,170,130560,3916,563904,694464
train,1838,189,145152,4661,671184,816336
train,1839,162,124416,3556,512064,636480
train,1840,94,72192,1198,172512,244704
train,1841,129,99072,2255,324720,423792
train,1842,158,121344,3383,487152,608496
train,1843,193,148224,5047,726768,874992
train,1844,112,86016,1700,244800,330816
train,1845,133,102144,2397,345168,447312
train,1846,137,105216,2543,366192,471408
train,1847,129,99072,2255,324720,423792
train,1848,215,165120,6263,901872,1066992
train,1849,201,154368,5474,788256,942624
train,1850,117,89856,1855,267120,356976
train,1851,134,102912,2433,350352,453264
train,1852,121,92928,1984,285696,378624
train,1853,132,101376,2361,339984,441360
train,1854,144,110592,2810,404640,515232
train,1855,124,95232,2084,300096,395328
train,1856,167,128256,3779,544176,672432
train,1857,67,51456,609,87696,139152
train,1858,162,124416,3556,512064,636480
train,1859,143,109824,2771,399024,508848
train,1860,98,75264,1302,187488,262752
train,1861,163,125184,3600,518400,643584
train,1862,173,132864,4055,583920,716784
train,1863,148,113664,2968,427392,541056
train,1864,174,133632,4102,590688,724320
train,1865,133,102144,2397,345168,447312
train,1866,113,86784,1730,249120,335904
train,1867,185,142080,4637,667728,809808
train,1868,113,86784,1730,249120,335904
train,1869,176,135168,4197,604368,739536
train,1870,52,39936,367,52848,92784
train,1871,120,92160,1951,280944,373104
train,1872,189,145152,4840,696960,842112
train,1873,173,132864,3587,516528,649392
train,1874,158,121344,3383,487152,608496
train,1875,171,131328,3962,570528,701856
train,1876,132,101376,2361,339984,441360
train,1877,124,95232,2084,300096,395328
train,1878,93,71424,1172,168768,240192
train,1879,37,28416,186,26784,55200
train,1880,145,111360,2849,410256,521616
train,1881,95,72960,1223,176112,249072
train,1882,108,82944,1581,227664,310608
train,1883,128,98304,2220,319680,417984
train,1884,103,79104,1438,207072,286176
train,1885,77,59136,804,115776,174912
train,1886,86,66048,1002,144288,210336
train,1887,116,89088,1823,262512,351600
train,1888,197,151296,4538,653472,804768
train,1889,63,48384,538,77472,125856
train,1890,165,126720,3689,531216,657936
train,1891,109,83712,1610,231840,315552
train,1892,149,114432,3008,433152,547584
train,1893,139,106752,2618,376992,483744
train,1894,108,82944,1581,227664,310608
train,1895,98,75264,1302,187488,262752
train,1896,108,82944,1581,227664,310608
train,1897,203,155904,5584,804096,960000
train,1898,152,116736,3131,450864,567600
train,1899,168,129024,3824,550656,679680
train,1900,220,168960,5786,833184,1002144
train,1901,151,115968,3090,444960,560928
train,1902,155,119040,3255,468720,587760
train,1903,133,102144,2397,345168,447312
train,1904,151,115968,3090,444960,560928
train,1905,108,82944,1581,227664,310608
train,1906,187,143616,4738,682272,825888
train,1907,179,137472,4341,625104,762576
train,1908,173,132864,4055,583920,716784
train,1909,164,125952,3644,524736,650688
train,1910,193,148224,5047,726768,874992
train,1911,112,86016,1700,244800,330816
train,1912,144,110592,2810,404640,515232
train,1913,201,154368,5474,788256,942624
train,1914,215,165120,6263,901872,1066992
train,1915,204,156672,5184,746496,903168
train,1916,203,155904,5544,798336,954240
train,1917,168,129024,3824,550656,679680
train,1918,113,86784,1730,249120,335904
train,1919,68,52224,627,90288,142512
train,1920,124,95232,2084,300096,395328
train,1921,135,103680,2470,355680,459360
train,1922,91,69888,1122,161568,231456
train,1923,196,150528,5205,749520,900048
train,1924,103,79104,1438,207072,286176
train,1925,111,85248,1670,240480,325728
train,1926,169,129792,3870,557280,687072
train,1927,204,156672,5639,812016,968688
train,1928,138,105984,2581,371664,477648
train,1929,159,122112,3426,493344,615456
train,1930,126,96768,2151,309744,406512
train,1931,107,82176,1552,223488,305664
train,1932,215,165120,6263,901872,1066992
train,1933,133,102144,2397,345168,447312
train,1934,177,135936,4245,611280,747216
train,1935,73,56064,722,103968,160032
train,1936,139,106752,2618,376992,483744
train,1937,119,91392,1919,276336,367728
train,1938,119,91392,1919,276336,367728
train,1939,96,73728,1249,179856,253584
train,1940,159,122112,3426,493344,615456
train,1941,105,80640,1494,215136,295776
train,1942,192,147456,4995,719280,866736
train,1943,216,165888,6322,910368,1076256
train,1944,53,40704,381,54864,95568
train,1945,132,101376,2361,339984,441360
train,1946,50,38400,339,48816,87216
train,1947,66,50688,591,85104,135792
train,1948,200,153600,5420,780480,934080
train,1949,167,128256,3779,544176,672432
train,1950,174,133632,4102,590688,724320
train,1951,71,54528,683,98352,152880
train,1952,139,106752,2618,376992,483744
train,1953,150,115200,3049,439056,554256
train,1954,207,158976,5806,836064,995040
train,1955,51,39168,353,50832,90000
train,1956,173,132864,4055,583920,716784
train,1957,64,49152,555,79920,129072
train,1958,164,125952,3644,524736,650688
train,1959,145,111360,2849,410256,521616
train,1960,117,89856,1855,267120,356976
train,1961,191,146688,4833,695952,842640
train,1962,120,92160,1951,280944,373104
train,1963,132,101376,2361,339984,441360
train,1964,132,101376,2361,339984,441360
train,1965,111,85248,1670,240480,325728
train,1966,198,152064,5312,764928,916992
train,1967,288,221184,8808,1268352,1489536
train,1968,72,55296,703,101232,156528
train,1969,111,85248,1670,240480,325728
train,1970,106,81408,1523,219312,300720
train,1971,104,79872,1466,211104,290976
train,1972,129,99072,2255,324720,423792
train,1973,58,44544,456,65664,110208
train,1974,63,48384,538,77472,125856
train,1975,91,69888,1122,161568,231456
train,1976,117,89856,1855,267120,356976
train,1977,75,57600,762,109728,167328
train,1978,161,123648,3512,505728,629376
train,1979,187,143616,4738,682272,825888
train,1980,187,143616,4738,682272,825888
train,1981,156,119808,3298,474912,594720
train,1982,189,145152,4203,605232,750384
train,1983,89,68352,1074,154656,223008
train,1984,157,120576,3340,480960,601536
train,1985,218,167424,6439,927216,1094640
train,1986,129,99072,2255,324720,423792
train,1987,126,96768,2151,309744,406512
train,1988,101,77568,1382,199008,276576
train,1989,78,59904,825,118800,178704
train,1990,113,86784,1730,249120,335904
train,1991,77,59136,804,115776,174912
train,1992,200,153600,5420,780480,934080
train,1993,116,89088,1823,262512,351600
train,1994,149,114432,3008,433152,547584
train,1995,127,97536,2186,314784,412320
train,1996,117,89856,1855,267120,356976
train,1997,99,76032,1328,191232,267264
train,1998,126,96768,2151,309744,406512
train,1999,203,155904,5584,804096,960000
train,2000,110,84480,1640,236160,320640
train,2001,113,86784,1730,249120,335904
train,2002,203,155904,5329,767376,923280
train,2003,114,87552,1761,253584,341136
train,2004,187,143616,4738,682272,825888
train,2005,125,96000,2117,304848,400848
train,2006,151,115968,3090,444960,560928
train,2007,96,73728,1249,179856,253584
train,2008,82,62976,911,131184,194160
train,2009,154,118272,3214,462816,581088
train,2010,171,131328,3962,570528,701856
train,2011,159,122112,3426,493344,615456
train,2012,95,72960,1223,176112,249072
train,2013,182,139776,4488,646272,786048
train,2014,123,94464,2050,295200,389664
train,2015,88,67584,1050,151200,218784
train,2016,152,116736,3131,450864,567600
train,2017,60,46080,488,70272,116352
train,2018,49,37632,326,46944,84576
train,2019,126,96768,2151,309744,406512
train,2020,198,152064,5312,764928,916992
train,2021,198,152064,5312,764928,916992
train,2022,114,87552,1761,253584,341136
train,2023,197,151296,5258,757152,908448
train,2024,113,86784,1730,249120,335904
train,2025,160,122880,3469,499536,622416
train,2026,176,135168,4197,604368,739536
train,2027,101,77568,1382,199008,276576
train,2028,177,135936,4245,611280,747216
train,2029,222,170496,6163,887472,1057968
train,2030,173,132864,4055,583920,716784
train,2031,184,141312,4587,660528,801840
train,2032,29,22272,114,16416,38688
train,2033,68,52224,627,90288,142512
train,2034,264,202752,8858,1275552,1478304
train,2035,117,89856,1855,267120,356976
train,2036,217,166656,6380,918720,1085376
train,2037,136,104448,2506,360864,465312
train,2038,156,119808,3298,474912,594720
train,2039,143,109824,2771,399024,508848
train,2040,86,66048,1002,144288,210336
train,2041,122,93696,2017,290448,384144
train,2042,133,102144,2397,345168,447312
train,2043,116,89088,1823,262512,351600
train,2044,126,96768,2151,309744,406512
train,2045,68,52224,627,90288,142512
train,2046,102,78336,1410,203040,281376
train,2047,205,157440,5371,773424,930864
train,2048,129,99072,2255,324720,423792
train,2049,158,121344,3383,487152,608496
train,2050,115,88320,1792,258048,346368
train,2051,164,125952,3644,524736,650688
train,2052,127,97536,2186,314784,412320
train,2053,158,121344,3383,487152,608496
train,2054,192,147456,4995,719280,866736
train,2055,58,44544,456,65664,110208
train,2056,175,134400,4150,597600,732000
train,2057,102,78336,1410,203040,281376
train,2058,97,74496,1275,183600,258096
train,2059,126,96768,2151,309744,406512
train,2060,204,156672,5639,812016,968688
train,2061,117,89856,1855,267120,356976
train,2062,148,113664,2968,427392,541056
train,2063,119,91392,1919,276336,367728
train,2064,137,105216,2543,366192,471408
train,2065,77,59136,804,115776,174912
train,2066,107,82176,1552,223488,305664
train,2067,111,85248,1670,240480,325728
train,2068,183,140544,4538,653472,794016
train,2069,152,116736,3131,450864,567600
train,2070,144,110592,2810,404640,515232
train,2071,211,162048,5587,804528,966576
train,2072,129,99072,2255,324720,423792
train,2073,135,103680,2470,355680,459360
train,2074,126,96768,2151,309744,406512
train,2075,66,50688,591,85104,135792
train,2076,85,65280,979,140976,206256
train,2077,176,135168,4197,604368,739536
train,2078,210,161280,5975,860400,1021680
train,2079,92,70656,1147,165168,235824
train,2080,86,66048,1002,144288,210336
train,2081,267,205056,9659,1390896,1595952
train,2082,152,116736,3131,450864,567600
train,2083,88,67584,1050,151200,218784
train,2084,171,131328,3962,570528,701856
train,2085,181,139008,4439,639216,778224
train,2086,92,70656,1147,165168,235824
train,2087,108,82944,1581,227664,310608
train,2088,137,105216,2543,366192,471408
train,2089,184,141312,4297,618768,760080
train,2090,125,96000,2117,304848,400848
train,2091,207,158976,5806,836064,995040
train,2092,89,68352,1074,154656,223008
train,2093,106,81408,1523,219312,300720
train,2094,152,116736,3131,450864,567600
train,2095,163,125184,3600,518400,643584
train,2096,154,118272,3214,462816,581088
train,2097,166,127488,3734,537696,665184
train,2098,152,116736,3131,450864,567600
train,2099,154,118272,3214,462816,581088
train,2100,140,107520,2656,382464,489984
train,2101,72,55296,703,101232,156528
train,2102,97,74496,1275,183600,258096
train,2103,90,69120,1098,158112,227232
train,2104,166,127488,3734,537696,665184
train,2105,137,105216,2543,366192,471408
train,2106,169,129792,3870,557280,687072
train,2107,112,86016,1700,244800,330816
train,2108,122,93696,2017,290448,384144
train,2109,170,130560,3916,563904,694464
train,2110,85,65280,979,140976,206256
train,2111,95,72960,1223,176112,249072
train,2112,148,113664,2968,427392,541056
train,2113,123,94464,2050,295200,389664
train,2114,136,104448,2506,360864,465312
train,2115,128,98304,2220,319680,417984
train,2116,111,85248,1670,240480,325728
train,2117,169,129792,3870,557280,687072
train,2118,149,114432,3008,433152,547584
train,2119,154,118272,3214,462816,581088
train,2120,190,145920,4891,704304,850224
train,2121,168,129024,3751,540144,669168
train,2122,134,102912,2433,350352,453264
train,2123,54,41472,395,56880,98352
train,2124,99,76032,1328,191232,267264
train,2125,163,125184,3600,518400,643584
train,2126,185,142080,4637,667728,809808
train,2127,55,42240,410,59040,101280
train,2128,85,65280,979,140976,206256
train,2129,117,89856,1855,267120,356976
train,2130,98,75264,1302,187488,262752
train,2131,79,60672,846,121824,182496
train,2132,161,123648,3512,505728,629376
train,2133,150,115200,3049,439056,554256
train,2134,75,57600,762,109728,167328
train,2135,153,117504,3172,456768,574272
train,2136,90,69120,1098,158112,227232
train,2137,173,132864,4055,583920,716784
train,2138,153,117504,2958,425952,543456
train,2139,116,89088,1823,262512,351600
train,2140,172,132096,4009,577296,709392
train,2141,77,59136,804,115776,174912
train,2142,67,51456,609,87696,139152
train,2143,159,122112,3426,493344,615456
train,2144,147,112896,2928,421632,534528
train,2145,162,124416,3556,512064,636480
train,2146,175,134400,4150,597600,732000
train,2147,94,72192,1198,172512,244704
train,2148,86,66048,1002,144288,210336
train,2149,158,121344,3383,487152,608496
train,2150,126,96768,2151,309744,406512
train,2151,60,46080,488,70272,116352
train,2152,70,53760,664,95616,149376
train,2153,106,81408,1523,219312,300720
train,2154,134,102912,2433,350352,453264
train,2155,236,181248,6828,983232,1164480
train,2156,81,62208,889,128016,190224
train,2157,88,67584,1050,151200,218784
train,2158,189,145152,4840,696960,842112
train,2159,138,105984,2581,371664,477648
train,2160,95,72960,1223,176112,249072
train,2161,131,100608,2325,334800,435408
train,2162,163,125184,3600,518400,643584
train,2163,111,85248,1670,240480,325728
train,2164,107,82176,1552,223488,305664
train,2165,69,52992,645,92880,145872
train,2166,63,48384,538,77472,125856
train,2167,130,99840,2290,329760,429600
train,2168,109,83712,1610,231840,315552
train,2169,160,122880,3469,499536,622416
train,2170,103,79104,1438,207072,286176
train,2171,142,109056,2732,393408,502464
train,2172,90,69120,1098,158112,227232
train,2173,115,88320,1792,258048,346368
train,2174,91,69888,1122,161568,231456
train,2175,135,103680,2470,355680,459360
train,2176,118,90624,1887,271728,362352
train,2177,243,186624,7125,1026000,1212624
train,2178,164,125952,3644,524736,650688
train,2179,139,106752,2618,376992,483744
train,2180,132,101376,2361,339984,441360
train,2181,133,102144,2397,345168,447312
train,2182,148,113664,2968,427392,541056
train,2183,149,114432,3008,433152,547584
train,2184,126,96768,2151,309744,406512
train,2185,79,60672,846,121824,182496
train,2186,161,123648,3512,505728,629376
train,2187,144,110592,2810,404640,515232
train,2188,78,59904,825,118800,178704
train,2189,181,139008,4439,639216,778224
train,2190,99,76032,1328,191232,267264
train,2191,136,104448,2506,360864,465312
train,2192,118,90624,1887,271728,362352
train,2193,164,125952,3644,524736,650688
train,2194,162,124416,3556,512064,636480
train,2195,203,155904,5584,804096,960000
train,2196,149,114432,3008,433152,547584
train,2197,87,66816,1026,147744,214560
train,2198,101,77568,1382,199008,276576
train,2199,137,105216,2543,366192,471408
train,2200,126,96768,2151,309744,406512
train,2201,190,145920,4891,704304,850224
train,2202,152,116736,3131,450864,567600
train,2203,177,135936,4245,611280,747216
train,2204,151,115968,3090,444960,560928
train,2205,153,117504,3172,456768,574272
train,2206,129,99072,2255,324720,423792
train,2207,70,53760,664,95616,149376
train,2208,141,108288,2694,387936,496224
train,2209,212,162816,6090,876960,1039776
train,2210,117,89856,1855,267120,356976
train,2211,150,115200,3049,439056,554256
train,2212,106,81408,1523,219312,300720
train,2213,147,112896,2928,421632,534528
train,2214,147,112896,2928,421632,534528
train,2215,108,82944,1581,227664,310608
train,2216,238,182784,7675,1105200,1287984
train,2217,125,96000,2117,304848,400848
train,2218,166,127488,3734,537696,665184
train,2219,170,130560,3916,563904,694464
train,2220,172,132096,4009,577296,709392
train,2221,197,151296,5258,757152,908448
train,2222,61,46848,505,72720,119568
train,2223,134,102912,2433,350352,453264
train,2224,186,142848,4688,675072,817920
train,2225,167,128256,3779,544176,672432
train,2226,158,121344,3383,487152,608496
train,2227,61,46848,505,72720,119568
train,2228,155,119040,3255,468720,587760
train,2229,129,99072,2255,324720,423792
train,2230,157,120576,3340,480960,601536
train,2231,118,90624,1887,271728,362352
train,2232,54,41472,395,56880,98352
train,2233,147,112896,2928,421632,534528
train,2234,174,133632,4102,590688,724320
train,2235,71,54528,683,98352,152880
train,2236,193,148224,5047,726768,874992
train,2237,75,57600,762,109728,167328
train,2238,112,86016,1700,244800,330816
train,2239,99,76032,1328,191232,267264
train,2240,128,98304,2220,319680,417984
train,2241,98,75264,1302,187488,262752
train,2242,121,92928,1984,285696,378624
train,2243,150,115200,3049,439056,554256
train,2244,116,89088,1823,262512,351600
train,2245,188,144384,4789,689616,834000
train,2246,119,91392,1919,276336,367728
train,2247,142,109056,2732,393408,502464
train,2248,175,134400,4150,597600,732000
train,2249,112,86016,1700,244800,330816
train,2250,228,175104,7043,1014192,1189296
train,2251,64,49152,555,79920,129072
train,2252,107,82176,1552,223488,305664
train,2253,97,74496,1275,183600,258096
train,2254,186,142848,4688,675072,817920
train,2255,188,144384,4789,689616,834000
train,2256,154,118272,3214,462816,581088
train,2257,180,138240,4390,632160,770400
train,2258,136,104448,2506,360864,465312
train,2259,166,127488,3734,537696,665184
train,2260,111,85248,1670,240480,325728
train,2261,178,136704,4293,618192,754896
train,2262,203,155904,5584,804096,960000
train,2263,90,69120,1098,158112,227232
train,2264,126,96768,2151,309744,406512
train,2265,124,95232,2084,300096,395328
train,2266,239,183552,7072,1018368,1201920
train,2267,135,103680,2470,355680,459360
train,2268,94,72192,1198,172512,244704
train,2269,87,66816,1026,147744,214560
train,2270,133,102144,2397,345168,447312
train,2271,141,108288,2694,387936,496224
train,2272,124,95232,2084,300096,395328
train,2273,54,41472,395,56880,98352
train,2274,182,139776,4488,646272,786048
train,2275,159,122112,3426,493344,615456
train,2276,169,129792,3870,557280,687072
train,2277,158,121344,3383,487152,608496
train,2278,227,174336,6175,889200,1063536
train,2279,139,106752,2618,376992,483744
train,2280,153,117504,3172,456768,574272
train,2281,194,148992,5100,734400,883392
train,2282,153,117504,3172,456768,574272
train,2283,198,152064,5312,764928,916992
train,2284,98,75264,1302,187488,262752
train,2285,231,177408,6698,964512,1141920
train,2286,116,89088,1823,262512,351600
train,2287,159,122112,3426,493344,615456
train,2288,116,89088,1823,262512,351600
train,2289,98,75264,1302,187488,262752
train,2290,34,26112,157,22608,48720
train,2291,175,134400,4150,597600,732000
train,2292,58,44544,456,65664,110208
train,2293,131,100608,2325,334800,435408
train,2294,160,122880,3469,499536,622416
train,2295,75,57600,762,109728,167328
train,2296,140,107520,2656,382464,489984
train,2297,108,82944,1581,227664,310608
train,2298,131,100608,2325,334800,435408
train,2299,133,102144,2397,345168,447312
train,2300,114,87552,1761,253584,341136
train,2301,120,92160,1951,280944,373104
train,2302,98,75264,1302,187488,262752
train,2303,139,106752,2618,376992,483744
train,2304,188,144384,4789,689616,834000
train,2305,132,101376,2361,339984,441360
train,2306,214,164352,5614,808416,972768
train,2307,82,62976,911,131184,194160
train,2308,110,84480,1640,236160,320640
train,2309,134,102912,2433,350352,453264
train,2310,164,125952,3644,524736,650688
train,2311,116,89088,1823,262512,351600
train,2312,153,117504,3172,456768,574272
train,2313,144,110592,2810,404640,515232
train,2314,174,133632,4102,590688,724320
train,2315,172,132096,4009,577296,709392
train,2316,131,100608,2325,334800,435408
train,2317,128,98304,2220,319680,417984
train,2318,124,95232,2084,300096,395328
train,2319,125,96000,2117,304848,400848
train,2320,94,72192,1198,172512,244704
train,2321,155,119040,3255,468720,587760
train,2322,169,129792,3870,557280,687072
train,2323,118,90624,1887,271728,362352
train,2324,142,109056,2732,393408,502464
train,2325,116,89088,1823,262512,351600
train,2326,149,114432,3008,433152,547584
train,2327,183,140544,4538,653472,794016
train,2328,110,84480,1640,236160,320640
train,2329,134,102912,2433,350352,453264
train,2330,75,57600,762,109728,167328
train,2331,99,76032,1328,191232,267264
train,2332,148,113664,2968,427392,541056
train,2333,121,92928,1984,285696,378624
train,2334,142,109056,2732,393408,502464
train,2335,126,96768,2151,309744,406512
train,2336,192,147456,4995,719280,866736
train,2337,168,129024,3824,550656,679680
train,2338,193,148224,5047,726768,874992
train,2339,118,90624,1887,271728,362352
train,2340,118,90624,1887,271728,362352
train,2341,198,152064,5312,764928,916992
train,2342,134,102912,2433,350352,453264
train,2343,165,126720,3689,531216,657936
train,2344,100,76800,1355,195120,271920
train,2345,125,96000,2117,304848,400848
train,2346,138,105984,2581,371664,477648
train,2347,166,127488,3734,537696,665184
train,2348,89,68352,1074,154656,223008
train,2349,100,76800,1355,195120,271920
train,2350,135,103680,2470,355680,459360
train,2351,175,134400,4150,597600,732000
train,2352,191,146688,4943,711792,858480
train,2353,69,52992,645,92880,145872
train,2354,127,97536,2186,314784,412320
train,2355,79,60672,846,121824,182496
train,2356,103,79104,1438,207072,286176
train,2357,179,137472,4341,625104,762576
train,2358,118,90624,1887,271728,362352
train,2359,125,96000,2117,304848,400848
train,2360,95,72960,1223,176112,249072
train,2361,193,148224,5047,726768,874992
train,2362,158,121344,3383,487152,608496
train,2363,87,66816,1026,147744,214560
train,2364,172,132096,3911,563184,695280
train,2365,108,82944,1581,227664,310608
train,2366,197,151296,5258,757152,908448
train,2367,187,143616,4738,682272,825888
train,2368,141,108288,2694,387936,496224
train,2369,154,118272,3214,462816,581088
train,2370,169,129792,3870,557280,687072
train,2371,138,105984,2581,371664,477648
train,2372,84,64512,956,137664,202176
train,2373,184,141312,4587,660528,801840
train,2374,176,135168,4197,604368,739536
train,2375,191,146688,4943,711792,858480
train,2376,118,90624,1887,271728,362352
train,2377,109,83712,1610,231840,315552
train,2378,76,58368,783,112752,171120
train,2379,123,94464,2050,295200,389664
train,2380,164,125952,3644,524736,650688
train,2381,125,96000,2117,304848,400848
train,2382,74,56832,742,106848,163680
train,2383,198,152064,5312,764928,916992
train,2384,91,69888,1122,161568,231456
train,2385,183,140544,4538,653472,794016
train,2386,125,96000,2117,304848,400848
train,2387,59,45312,472,67968,113280
train,2388,77,59136,804,115776,174912
train,2389,121,92928,1984,285696,378624
train,2390,159,122112,3426,493344,615456
train,2391,42,32256,239,34416,66672
train,2392,76,58368,783,112752,171120
train,2393,133,102144,2397,345168,447312
train,2394,125,96000,2117,304848,400848
train,2395,104,79872,1466,211104,290976
train,2396,96,73728,1249,179856,253584
train,2397,126,96768,2151,309744,406512
train,2398,114,87552,1761,253584,341136
train,2399,124,95232,2084,300096,395328
train,2400,123,94464,2050,295200,389664
train,2401,105,80640,1494,215136,295776
train,2402,148,113664,2968,427392,541056
train,2403,142,109056,2732,393408,502464
train,2404,169,129792,3870,557280,687072
train,2405,117,89856,1855,267120,356976
train,2406,61,46848,505,72720,119568
train,2407,145,111360,2849,410256,521616
train,2408,85,65280,979,140976,206256
train,2409,161,123648,3512,505728,629376
train,2410,87,66816,1026,147744,214560
train,2411,127,97536,2186,314784,412320
train,2412,125,96000,2117,304848,400848
train,2413,166,127488,3734,537696,665184
train,2414,145,111360,2849,410256,521616
train,2415,179,137472,4341,625104,762576
train,2416,132,101376,2361,339984,441360
train,2417,130,99840,2290,329760,429600
train,2418,178,136704,4293,618192,754896
train,2419,153,117504,3172,456768,574272
train,2420,175,134400,4150,597600,732000
train,2421,123,94464,2050,295200,389664
train,2422,120,92160,1951,280944,373104
train,2423,252,193536,7421,1068624,1262160
train,2424,202,155136,5529,796176,951312
train,2425,106,81408,1523,219312,300720
train,2426,172,132096,4009,577296,709392
train,2427,138,105984,2581,371664,477648
train,2428,122,93696,2017,290448,384144
train,2429,31,23808,131,18864,42672
train,2430,139,106752,2618,376992,483744
train,2431,90,69120,1098,158112,227232
train,2432,135,103680,2395,344880,448560
train,2433,197,151296,5258,757152,908448
train,2434,173,132864,4055,583920,716784
train,2435,94,72192,1198,172512,244704
train,2436,162,124416,3556,512064,636480
train,2437,121,92928,1984,285696,378624
train,2438,113,86784,1730,249120,335904
train,2439,89,68352,1074,154656,223008
train,2440,142,109056,2732,393408,502464
train,2441,139,106752,2618,376992,483744
train,2442,112,86016,1700,244800,330816
train,2443,148,113664,2968,427392,541056
train,2444,121,92928,1984,285696,378624
train,2445,63,48384,538,77472,125856
train,2446,91,69888,1122,161568,231456
train,2447,92,70656,1147,165168,235824
train,2448,99,76032,1328,191232,267264
train,2449,182,139776,4488,646272,786048
train,2450,120,92160,1951,280944,373104
train,2451,129,99072,2255,324720,423792
train,2452,122,93696,2017,290448,384144
train,2453,198,152064,5312,764928,916992
train,2454,158,121344,3383,487152,608496
train,2455,129,99072,2255,324720,423792
train,2456,135,103680,2470,355680,459360
train,2457,177,135936,4245,611280,747216
train,2458,93,71424,1172,168768,240192
train,2459,142,109056,2732,393408,502464
train,2460,102,78336,1410,203040,281376
train,2461,127,97536,2186,314784,412320
train,2462,139,106752,2618,376992,483744
train,2463,176,135168,4197,604368,739536
train,2464,154,118272,3214,462816,581088
train,2465,88,67584,1050,151200,218784
train,2466,199,152832,5366,772704,925536
train,2467,125,96000,2117,304848,400848
train,2468,64,49152,555,79920,129072
train,2469,159,122112,3426,493344,615456
train,2470,92,70656,1147,165168,235824
train,2471,93,71424,1172,168768,240192
train,2472,90,69120,1098,158112,227232
train,2473,49,37632,326,46944,84576
train,2474,159,122112,3426,493344,615456
train,2475,112,86016,1700,244800,330816
train,2476,189,145152,4840,696960,842112
train,2477,147,112896,2928,421632,534528
train,2478,124,95232,2084,300096,395328
train,2479,98,75264,1302,187488,262752
train,2480,174,133632,4102,590688,724320
train,2481,135,103680,2470,355680,459360
train,2482,138,105984,2581,371664,477648
train,2483,120,92160,1951,280944,373104
train,2484,163,125184,3600,518400,643584
train,2485,78,59904,825,118800,178704
train,2486,59,45312,472,67968,113280
train,2487,106,81408,1523,219312,300720
train,2488,126,96768,2151,309744,406512
train,2489,170,130560,3916,563904,694464
train,2490,106,81408,1523,219312,300720
train,2491,191,146688,4943,711792,858480
train,2492,98,75264,1302,187488,262752
train,2493,45,34560,275,39600,74160
train,2494,93,71424,1172,168768,240192
train,2495,122,93696,2017,290448,384144
train,2496,162,124416,3556,512064,636480
train,2497,65,49920,573,82512,132432
train,2498,145,111360,2849,410256,521616
train,2499,148,113664,2968,427392,541056
train,2500,183,140544,4538,653472,794016
train,2501,89,68352,1074,154656,223008
train,2502,145,111360,2849,410256,521616
train,2503,115,88320,1792,258048,346368
train,2504,158,121344,3383,487152,608496
train,2505,135,103680,2470,355680,459360
train,2506,148,113664,2968,427392,541056
train,2507,127,97536,2186,314784,412320
train,2508,142,109056,2732,393408,502464
train,2509,66,50688,591,85104,135792
train,2510,113,86784,1730,249120,335904
train,2511,173,132864,4055,583920,716784
train,2512,120,92160,1951,280944,373104
train,2513,85,65280,979,140976,206256
train,2514,230,176640,5811,836784,1013424
train,2515,155,119040,3255,468720,587760
train,2516,170,130560,3916,563904,694464
train,2517,226,173568,6458,929952,1103520
train,2518,148,113664,2968,427392,541056
train,2519,71,54528,683,98352,152880
train,2520,64,49152,555,79920,129072
train,2521,149,114432,3008,433152,547584
train,2522,176,135168,4197,604368,739536
train,2523,105,80640,1494,215136,295776
train,2524,110,84480,1640,236160,320640
train,2525,189,145152,4840,696960,842112
train,2526,58,44544,456,65664,110208
train,2527,157,120576,3340,480960,601536
train,2528,79,60672,846,121824,182496
train,2529,122,93696,2017,290448,384144
train,2530,132,101376,2361,339984,441360
train,2531,104,79872,1466,211104,290976
train,2532,136,104448,2506,360864,465312
train,2533,72,55296,703,101232,156528
train,2534,125,96000,2117,304848,400848
train,2535,50,38400,339,48816,87216
train,2536,54,41472,395,56880,98352
train,2537,103,79104,1438,207072,286176
train,2538,137,105216,2543,366192,471408
train,2539,64,49152,555,79920,129072
train,2540,42,32256,239,34416,66672
train,2541,139,106752,2618,376992,483744
train,2542,119,91392,1919,276336,367728
train,2543,158,121344,3383,487152,608496
train,2544,138,105984,2581,371664,477648
train,2545,122,93696,2017,290448,384144
train,2546,161,123648,3512,505728,629376
train,2547,139,106752,2618,376992,483744
train,2548,153,117504,3172,456768,574272
train,2549,65,49920,573,82512,132432
train,2550,152,116736,3131,450864,567600
train,2551,142,109056,2732,393408,502464
train,2552,73,56064,722,103968,160032
train,2553,183,140544,4538,653472,794016
train,2554,100,76800,1355,195120,271920
train,2555,182,139776,4488,646272,786048
train,2556,148,113664,2968,427392,541056
train,2557,79,60672,846,121824,182496
train,2558,166,127488,3734,537696,665184
train,2559,88,67584,1050,151200,218784
train,2560,90,69120,1098,158112,227232
train,2561,154,118272,3214,462816,581088
train,2562,148,113664,2968,427392,541056
train,2563,131,100608,2325,334800,435408
train,2564,54,41472,395,56880,98352
train,2565,106,81408,1523,219312,300720
train,2566,55,42240,410,59040,101280
train,2567,145,111360,2849,410256,521616
train,2568,128,98304,2220,319680,417984
train,2569,115,88320,1792,258048,346368
train,2570,195,149760,5152,741888,891648
train,2571,179,137472,4341,625104,762576
train,2572,120,92160,1951,280944,373104
train,2573,165,126720,3689,531216,657936
train,2574,132,101376,2361,339984,441360
train,2575,223,171264,6738,970272,1141536
train,2576,152,116736,3131,450864,567600
train,2577,109,83712,1610,231840,315552
train,2578,94,72192,1198,172512,244704
train,2579,126,96768,2151,309744,406512
train,2580,106,81408,1523,219312,300720
train,2581,125,96000,2117,304848,400848
train,2582,113,86784,1730,249120,335904
train,2583,164,125952,3644,524736,650688
train,2584,152,116736,3131,450864,567600
train,2585,146,112128,2888,415872,528000
train,2586,158,121344,3383,487152,608496
train,2587,175,134400,4150,597600,732000
train,2588,186,142848,4688,675072,817920
train,2589,81,62208,889,128016,190224
train,2590,106,81408,1523,219312,300720
train,2591,123,94464,2050,295200,389664
train,2592,176,135168,4197,604368,739536
train,2593,142,109056,2732,393408,502464
train,2594,207,158976,5806,836064,995040
train,2595,154,118272,3214,462816,581088
train,2596,198,152064,4805,691920,843984
train,2597,224,172032,6799,979056,1151088
train,2598,140,107520,2656,382464,489984
train,2599,155,119040,3255,468720,587760
train,2600,124,95232,2084,300096,395328
train,2601,119,91392,1919,276336,367728
train,2602,135,103680,2470,355680,459360
train,2603,72,55296,703,101232,156528
train,2604,174,133632,4102,590688,724320
train,2605,173,132864,4055,583920,716784
train,2606,163,125184,3600,518400,643584
train,2607,108,82944,1581,227664,310608
train,2608,65,49920,573,82512,132432
train,2609,142,109056,2732,393408,502464
train,2610,106,81408,1523,219312,300720
train,2611,99,76032,1328,191232,267264
train,2612,187,143616,4738,682272,825888
train,2613,140,107520,2656,382464,489984
train,2614,174,133632,4102,590688,724320
train,2615,136,104448,2506,360864,465312
train,2616,223,171264,6738,970272,1141536
train,2617,59,45312,472,67968,113280
train,2618,86,66048,1002,144288,210336
train,2619,143,109824,2771,399024,508848
train,2620,143,109824,2771,399024,508848
train,2621,140,107520,2656,382464,489984
train,2622,111,85248,1670,240480,325728
train,2623,165,126720,3689,531216,657936
train,2624,135,103680,2470,355680,459360
train,2625,208,159744,5862,844128,1003872
train,2626,170,130560,3916,563904,694464
train,2627,122,93696,2017,290448,384144
train,2628,208,159744,5862,844128,1003872
train,2629,223,171264,6648,957312,1128576
train,2630,157,120576,3340,480960,601536
train,2631,162,124416,3556,512064,636480
train,2632,157,120576,3340,480960,601536
train,2633,100,76800,1355,195120,271920
train,2634,106,81408,1523,219312,300720
train,2635,140,107520,2656,382464,489984
train,2636,119,91392,1919,276336,367728
train,2637,172,132096,4009,577296,709392
train,2638,235,180480,7035,1013040,1193520
train,2639,76,58368,783,112752,171120
train,2640,154,118272,3214,462816,581088
train,2641,200,153600,5420,780480,934080
train,2642,55,42240,410,59040,101280
train,2643,124,95232,2084,300096,395328
train,2644,155,119040,3255,468720,587760
train,2645,184,141312,4587,660528,801840
train,2646,62,47616,521,75024,122640
train,2647,95,72960,1223,176112,249072
train,2648,100,76800,1355,195120,271920
train,2649,183,140544,4538,653472,794016
train,2650,109,83712,1610,231840,315552
train,2651,113,86784,1730,249120,335904
train,2652,115,88320,1792,258048,346368
train,2653,111,85248,1670,240480,325728
train,2654,165,126720,3689,531216,657936
train,2655,129,99072,2255,324720,423792
train,2656,159,122112,3426,493344,615456
train,2657,111,85248,1670,240480,325728
train,2658,92,70656,1147,165168,235824
train,2659,49,37632,326,46944,84576
train,2660,103,79104,1438,207072,286176
train,2661,162,124416,3556,512064,636480
train,2662,111,85248,1670,240480,325728
train,2663,165,126720,3689,531216,657936
train,2664,162,124416,3556,512064,636480
train,2665,84,64512,956,137664,202176
train,2666,101,77568,1382,199008,276576
train,2667,148,113664,2968,427392,541056
train,2668,135,103680,2470,355680,459360
train,2669,133,102144,2397,345168,447312
train,2670,144,110592,2810,404640,515232
train,2671,149,114432,3008,433152,547584
train,2672,108,82944,1581,227664,310608
train,2673,103,79104,1438,207072,286176
train,2674,136,104448,2506,360864,465312
train,2675,81,62208,889,128016,190224
train,2676,126,96768,2151,309744,406512
train,2677,85,65280,979,140976,206256
train,2678,152,116736,3131,450864,567600
train,2679,115,88320,1792,258048,346368
train,2680,90,69120,1098,158112,227232
train,2681,130,99840,2290,329760,429600
train,2682,143,109824,2771,399024,508848
train,2683,140,107520,2656,382464,489984
train,2684,157,120576,3340,480960,601536
validation,0,95,72960,1223,176112,249072
validation,1,79,60672,846,121824,182496
validation,2,80,61440,867,124848,186288
validation,3,101,77568,1382,199008,276576
validation,4,150,115200,3049,439056,554256
validation,5,204,156672,5639,812016,968688
validation,6,213,163584,5196,748224,911808
validation,7,183,140544,4538,653472,794016
validation,8,160,122880,3469,499536,622416
validation,9,163,125184,3600,518400,643584
validation,10,170,130560,3916,563904,694464
validation,11,121,92928,1984,285696,378624
validation,12,78,59904,825,118800,178704
validation,13,127,97536,2186,314784,412320
validation,14,199,152832,5366,772704,925536
validation,15,204,156672,5639,812016,968688
validation,16,145,111360,2849,410256,521616
validation,17,161,123648,3512,505728,629376
validation,18,196,150528,5205,749520,900048
validation,19,162,124416,3556,512064,636480
validation,20,111,85248,1670,240480,325728
validation,21,142,109056,2732,393408,502464
validation,22,198,152064,5312,764928,916992
validation,23,137,105216,2543,366192,471408
validation,24,117,89856,1855,267120,356976
validation,25,167,128256,3779,544176,672432
validation,26,98,75264,1302,187488,262752
validation,27,49,37632,326,46944,84576
validation,28,124,95232,2084,300096,395328
validation,29,118,90624,1887,271728,362352
validation,30,185,142080,4637,667728,809808
validation,31,142,109056,2732,393408,502464
validation,32,136,104448,2506,360864,465312
validation,33,161,123648,3512,505728,629376
validation,34,181,139008,4439,639216,778224
validation,35,57,43776,441,63504,107280
validation,36,109,83712,1610,231840,315552
validation,37,103,79104,1438,207072,286176
validation,38,135,103680,2470,355680,459360
validation,39,158,121344,3383,487152,608496
validation,40,153,117504,3172,456768,574272
validation,41,150,115200,3049,439056,554256
validation,42,153,117504,3172,456768,574272
validation,43,73,56064,722,103968,160032
validation,44,102,78336,1410,203040,281376
validation,45,156,119808,3298,474912,594720
validation,46,181,139008,4439,639216,778224
validation,47,121,92928,1984,285696,378624
validation,48,184,141312,4587,660528,801840
validation,49,108,82944,1581,227664,310608
validation,50,131,100608,2325,334800,435408
validation,51,140,107520,2656,382464,489984
validation,52,127,97536,2186,314784,412320
validation,53,90,69120,1098,158112,227232
validation,54,147,112896,2928,421632,534528
validation,55,140,107520,2656,382464,489984
validation,56,142,109056,2732,393408,502464
validation,57,124,95232,2084,300096,395328
validation,58,91,69888,1122,161568,231456
validation,59,101,77568,1382,199008,276576
validation,60,142,109056,2732,393408,502464
validation,61,174,133632,4102,590688,724320
validation,62,177,135936,4245,611280,747216
validation,63,172,132096,4009,577296,709392
validation,64,246,188928,7023,1011312,1200240
validation,65,185,142080,4637,667728,809808
validation,66,104,79872,1466,211104,290976
validation,67,110,84480,1640,236160,320640
validation,68,135,103680,2470,355680,459360
validation,69,98,75264,1302,187488,262752
validation,70,111,85248,1670,240480,325728
validation,71,62,47616,521,75024,122640
validation,72,196,150528,5205,749520,900048
validation,73,141,108288,2694,387936,496224
validation,74,123,94464,2050,295200,389664
validation,75,211,162048,6032,868608,1030656
validation,76,97,74496,1275,183600,258096
validation,77,108,82944,1581,227664,310608
validation,78,186,142848,4688,675072,817920
validation,79,104,79872,1466,211104,290976
validation,80,36,27648,176,25344,52992
validation,81,186,142848,4688,675072,817920
validation,82,172,132096,4009,577296,709392
validation,83,185,142080,4637,667728,809808
validation,84,123,94464,2050,295200,389664
validation,85,128,98304,2220,319680,417984
validation,86,200,153600,5420,780480,934080
validation,87,106,81408,1523,219312,300720
validation,88,157,120576,3340,480960,601536
validation,89,115,88320,1792,258048,346368
validation,90,57,43776,441,63504,107280
validation,91,143,109824,2771,399024,508848
validation,92,88,67584,1050,151200,218784
validation,93,119,91392,1919,276336,367728
validation,94,134,102912,2433,350352,453264
validation,95,131,100608,2325,334800,435408
validation,96,67,51456,609,87696,139152
validation,97,86,66048,1002,144288,210336
validation,98,81,62208,889,128016,190224
validation,99,186,142848,4688,675072,817920
validation,100,143,109824,2771,399024,508848
validation,101,126,96768,2151,309744,406512
validation,102,134,102912,2433,350352,453264
validation,103,50,38400,339,48816,87216
validation,104,132,101376,2361,339984,441360
validation,105,181,139008,4439,639216,778224
validation,106,113,86784,1730,249120,335904
validation,107,73,56064,722,103968,160032
validation,108,212,162816,6090,876960,1039776
validation,109,130,99840,2290,329760,429600
validation,110,159,122112,3426,493344,615456
validation,111,133,102144,2397,345168,447312
validation,112,110,84480,1640,236160,320640
validation,113,61,46848,505,72720,119568
validation,114,173,132864,4055,583920,716784
validation,115,109,83712,1610,231840,315552
validation,116,153,117504,3172,456768,574272
validation,117,93,71424,1172,168768,240192
validation,118,112,86016,1700,244800,330816
validation,119,153,117504,3172,456768,574272
validation,120,149,114432,3008,433152,547584
validation,121,126,96768,2151,309744,406512
validation,122,189,145152,4840,696960,842112
validation,123,65,49920,573,82512,132432
validation,124,184,141312,4587,660528,801840
validation,125,150,115200,3049,439056,554256
validation,126,96,73728,1249,179856,253584
validation,127,187,143616,4738,682272,825888
validation,128,167,128256,3779,544176,672432
validation,129,141,108288,2694,387936,496224
validation,130,142,109056,2732,393408,502464
validation,131,127,97536,2186,314784,412320
validation,132,143,109824,2771,399024,508848
validation,133,135,103680,2470,355680,459360
validation,134,123,94464,2050,295200,389664
validation,135,166,127488,3734,537696,665184
validation,136,86,66048,1002,144288,210336
validation,137,138,105984,2581,371664,477648
validation,138,73,56064,722,103968,160032
validation,139,140,107520,2656,382464,489984
validation,140,136,104448,2506,360864,465312
validation,141,137,105216,2543,366192,471408
validation,142,120,92160,1951,280944,373104
validation,143,204,156672,5639,812016,968688
validation,144,89,68352,1074,154656,223008
validation,145,117,89856,1855,267120,356976
validation,146,156,119808,3298,474912,594720
validation,147,197,151296,5258,757152,908448
validation,148,100,76800,1355,195120,271920
validation,149,125,96000,2117,304848,400848
validation,150,109,83712,1610,231840,315552
validation,151,126,96768,2151,309744,406512
validation,152,152,116736,3131,450864,567600
validation,153,159,122112,3426,493344,615456
validation,154,59,45312,472,67968,113280
validation,155,115,88320,1792,258048,346368
validation,156,153,117504,3172,456768,574272
validation,157,158,121344,3383,487152,608496
validation,158,159,122112,3426,493344,615456
validation,159,120,92160,1951,280944,373104
validation,160,111,85248,1670,240480,325728
validation,161,94,72192,1198,172512,244704
validation,162,123,94464,2050,295200,389664
validation,163,86,66048,1002,144288,210336
validation,164,166,127488,3734,537696,665184
validation,165,222,170496,6200,892800,1063296
validation,166,92,70656,1147,165168,235824
validation,167,139,106752,2618,376992,483744
validation,168,185,142080,4637,667728,809808
validation,169,86,66048,1002,144288,210336
validation,170,155,119040,3255,468720,587760
validation,171,65,49920,573,82512,132432
validation,172,157,120576,3340,480960,601536
validation,173,137,105216,2543,366192,471408
validation,174,176,135168,4197,604368,739536
validation,175,174,133632,4102,590688,724320
validation,176,148,113664,2968,427392,541056
validation,177,39,29952,206,29664,59616
validation,178,47,36096,300,43200,79296
validation,179,164,125952,3644,524736,650688
validation,180,212,162816,6090,876960,1039776
validation,181,131,100608,2325,334800,435408
validation,182,172,132096,4009,577296,709392
validation,183,137,105216,2543,366192,471408
validation,184,91,69888,1122,161568,231456
validation,185,97,74496,1275,183600,258096
validation,186,143,109824,2771,399024,508848
validation,187,137,105216,2543,366192,471408
validation,188,117,89856,1855,267120,356976
validation,189,145,111360,2849,410256,521616
validation,190,119,91392,1919,276336,367728
validation,191,127,97536,2186,314784,412320
validation,192,159,122112,3426,493344,615456
validation,193,162,124416,3556,512064,636480
validation,194,90,69120,1098,158112,227232
validation,195,156,119808,3298,474912,594720
validation,196,137,105216,2543,366192,471408
validation,197,111,85248,1670,240480,325728
validation,198,121,92928,1984,285696,378624
validation,199,192,147456,4995,719280,866736
validation,200,110,84480,1640,236160,320640
validation,201,200,153600,5420,780480,934080
validation,202,67,51456,609,87696,139152
validation,203,60,46080,488,70272,116352
validation,204,186,142848,4688,675072,817920
validation,205,136,104448,2506,360864,465312
validation,206,190,145920,4891,704304,850224
validation,207,170,130560,3916,563904,694464
validation,208,135,103680,2470,355680,459360
validation,209,100,76800,1355,195120,271920
validation,210,142,109056,2732,393408,502464
validation,211,119,91392,1919,276336,367728
validation,212,150,115200,3049,439056,554256
validation,213,112,86016,1700,244800,330816
validation,214,125,96000,2117,304848,400848
validation,215,99,76032,1328,191232,267264
validation,216,147,112896,2928,421632,534528
validation,217,177,135936,4245,611280,747216
validation,218,164,125952,3644,524736,650688
validation,219,172,132096,4009,577296,709392
validation,220,113,86784,1730,249120,335904
validation,221,158,121344,3383,487152,608496
validation,222,153,117504,3172,456768,574272
validation,223,129,99072,2255,324720,423792
validation,224,177,135936,4245,611280,747216
validation,225,95,72960,1223,176112,249072
validation,226,40,30720,217,31248,61968
validation,227,109,83712,1610,231840,315552
validation,228,135,103680,2470,355680,459360
validation,229,163,125184,3600,518400,643584
validation,230,132,101376,2361,339984,441360
validation,231,113,86784,1730,249120,335904
validation,232,94,72192,1198,172512,244704
validation,233,117,89856,1855,267120,356976
validation,234,65,49920,573,82512,132432
validation,235,179,137472,4341,625104,762576
validation,236,127,97536,2186,314784,412320
validation,237,176,135168,4197,604368,739536
validation,238,114,87552,1761,253584,341136
validation,239,170,130560,3916,563904,694464
validation,240,127,97536,2186,314784,412320
validation,241,136,104448,2506,360864,465312
validation,242,64,49152,555,79920,129072
validation,243,110,84480,1640,236160,320640
validation,244,174,133632,4102,590688,724320
validation,245,63,48384,538,77472,125856
validation,246,89,68352,1074,154656,223008
validation,247,103,79104,1438,207072,286176
validation,248,163,125184,3600,518400,643584
validation,249,129,99072,2255,324720,423792
validation,250,216,165888,6322,910368,1076256
validation,251,131,100608,2325,334800,435408
validation,252,148,113664,2968,427392,541056
validation,253,185,142080,4637,667728,809808
validation,254,138,105984,2581,371664,477648
validation,255,187,143616,4738,682272,825888
validation,256,207,158976,5806,836064,995040
validation,257,188,144384,4789,689616,834000
validation,258,184,141312,4587,660528,801840
validation,259,69,52992,645,92880,145872
validation,260,133,102144,2397,345168,447312
validation,261,134,102912,2433,350352,453264
validation,262,156,119808,3298,474912,594720
validation,263,178,136704,4293,618192,754896
validation,264,118,90624,1887,271728,362352
validation,265,85,65280,979,140976,206256
validation,266,209,160512,5919,852336,1012848
validation,267,167,128256,3779,544176,672432
validation,268,76,58368,783,112752,171120
validation,269,150,115200,3049,439056,554256
validation,270,166,127488,3734,537696,665184
validation,271,96,73728,1249,179856,253584
validation,272,67,51456,609,87696,139152
validation,273,128,98304,2220,319680,417984
validation,274,66,50688,591,85104,135792
validation,275,105,80640,1494,215136,295776
validation,276,85,65280,979,140976,206256
validation,277,43,33024,251,36144,69168
validation,278,160,122880,3469,499536,622416
validation,279,131,100608,2325,334800,435408
validation,280,72,55296,703,101232,156528
validation,281,54,41472,395,56880,98352
validation,282,138,105984,2581,371664,477648
validation,283,162,124416,3556,512064,636480
validation,284,155,119040,3255,468720,587760
validation,285,146,112128,2888,415872,528000
validation,286,184,141312,4587,660528,801840
validation,287,73,56064,722,103968,160032
validation,288,104,79872,1466,211104,290976
validation,289,145,111360,2849,410256,521616
validation,290,127,97536,2186,314784,412320
validation,291,98,75264,1302,187488,262752
validation,292,44,33792,263,37872,71664
validation,293,158,121344,3383,487152,608496
validation,294,159,122112,3426,493344,615456
validation,295,182,139776,4488,646272,786048
validation,296,190,145920,4891,704304,850224
validation,297,171,131328,3962,570528,701856
validation,298,139,106752,2618,376992,483744
validation,299,155,119040,3255,468720,587760
validation,300,154,118272,3214,462816,581088
validation,301,130,99840,2290,329760,429600
validation,302,138,105984,2581,371664,477648
validation,303,190,145920,4891,704304,850224
validation,304,104,79872,1466,211104,290976
validation,305,84,64512,956,137664,202176
validation,306,109,83712,1610,231840,315552
validation,307,150,115200,3049,439056,554256
validation,308,121,92928,1984,285696,378624
validation,309,68,52224,627,90288,142512
validation,310,162,124416,3556,512064,636480
validation,311,126,96768,2151,309744,406512
validation,312,99,76032,1328,191232,267264
validation,313,128,98304,2220,319680,417984
validation,314,159,122112,3426,493344,615456
validation,315,137,105216,2543,366192,471408
validation,316,83,63744,934,134496,198240
validation,317,99,76032,1328,191232,267264
validation,318,131,100608,2325,334800,435408
validation,319,222,170496,5875,846000,1016496
validation,320,98,75264,1302,187488,262752
validation,321,69,52992,645,92880,145872
validation,322,163,125184,3600,518400,643584
validation,323,123,94464,2050,295200,389664
validation,324,111,85248,1670,240480,325728
validation,325,252,193536,6797,978768,1172304
validation,326,78,59904,825,118800,178704
validation,327,148,113664,2968,427392,541056
validation,328,146,112128,2888,415872,528000
validation,329,159,122112,3426,493344,615456
validation,330,114,87552,1761,253584,341136
validation,331,165,126720,3689,531216,657936
validation,332,213,163584,4996,719424,883008
validation,333,128,98304,2220,319680,417984
validation,334,148,113664,2968,427392,541056
validation,335,66,50688,591,85104,135792
validation,336,180,138240,4390,632160,770400
validation,337,111,85248,1670,240480,325728
validation,338,155,119040,3255,468720,587760
validation,339,164,125952,3644,524736,650688
validation,340,194,148992,5100,734400,883392
validation,341,129,99072,2255,324720,423792
validation,342,117,89856,1855,267120,356976
validation,343,108,82944,1581,227664,310608
validation,344,188,144384,4789,689616,834000
validation,345,165,126720,3689,531216,657936
validation,346,166,127488,3734,537696,665184
validation,347,124,95232,2084,300096,395328
validation,348,129,99072,2255,324720,423792
validation,349,185,142080,4637,667728,809808
validation,350,79,60672,846,121824,182496
validation,351,134,102912,2433,350352,453264
validation,352,122,93696,2017,290448,384144
validation,353,163,125184,3600,518400,643584
validation,354,131,100608,2325,334800,435408
validation,355,153,117504,3172,456768,574272
validation,356,82,62976,911,131184,194160
validation,357,97,74496,1275,183600,258096
validation,358,130,99840,2290,329760,429600
validation,359,148,113664,2968,427392,541056
validation,360,107,82176,1552,223488,305664
validation,361,171,131328,3962,570528,701856
validation,362,170,130560,3916,563904,694464
validation,363,126,96768,2151,309744,406512
validation,364,125,96000,2117,304848,400848
validation,365,175,134400,4150,597600,732000
validation,366,146,112128,2888,415872,528000
validation,367,101,77568,1382,199008,276576
validation,368,174,133632,4102,590688,724320
validation,369,138,105984,2581,371664,477648
validation,370,132,101376,2361,339984,441360
validation,371,45,34560,275,39600,74160
validation,372,125,96000,2117,304848,400848
validation,373,201,154368,5474,788256,942624
validation,374,190,145920,4891,704304,850224
validation,375,136,104448,2506,360864,465312
validation,376,173,132864,4055,583920,716784
validation,377,114,87552,1761,253584,341136
validation,378,155,119040,3255,468720,587760
validation,379,107,82176,1552,223488,305664
validation,380,226,173568,5788,833472,1007040
validation,381,178,136704,4293,618192,754896
validation,382,191,146688,4943,711792,858480
validation,383,261,200448,7905,1138320,1338768
validation,384,168,129024,3824,550656,679680
validation,385,147,112896,2928,421632,534528
validation,386,118,90624,1887,271728,362352
validation,387,144,110592,2810,404640,515232
validation,388,117,89856,1855,267120,356976
validation,389,69,52992,645,92880,145872
validation,390,127,97536,2186,314784,412320
validation,391,109,83712,1610,231840,315552
validation,392,175,134400,4150,597600,732000
validation,393,147,112896,2928,421632,534528
validation,394,237,182016,6323,910512,1092528
validation,395,162,124416,3556,512064,636480
validation,396,89,68352,1074,154656,223008
validation,397,134,102912,2433,350352,453264
validation,398,116,89088,1823,262512,351600
validation,399,172,132096,4009,577296,709392
validation,400,153,117504,3172,456768,574272
validation,401,110,84480,1640,236160,320640
validation,402,163,125184,3600,518400,643584
validation,403,56,43008,425,61200,104208
validation,404,109,83712,1610,231840,315552
validation,405,192,147456,4995,719280,866736
validation,406,131,100608,2325,334800,435408
validation,407,87,66816,1026,147744,214560
validation,408,104,79872,1466,211104,290976
validation,409,168,129024,3824,550656,679680
validation,410,102,78336,1410,203040,281376
validation,411,205,157440,5114,736416,893856
validation,412,112,86016,1700,244800,330816
validation,413,151,115968,3090,444960,560928
validation,414,131,100608,2325,334800,435408
validation,415,113,86784,1730,249120,335904
validation,416,135,103680,2470,355680,459360
validation,417,92,70656,1147,165168,235824
validation,418,82,62976,911,131184,194160
validation,419,186,142848,4688,675072,817920
validation,420,224,172032,6799,979056,1151088
validation,421,55,42240,410,59040,101280
validation,422,197,151296,5258,757152,908448
validation,423,164,125952,3644,524736,650688
validation,424,99,76032,1328,191232,267264
validation,425,75,57600,762,109728,167328
validation,426,166,127488,3734,537696,665184
validation,427,94,72192,1198,172512,244704
validation,428,165,126720,3689,531216,657936
validation,429,76,58368,783,112752,171120
validation,430,96,73728,1249,179856,253584
validation,431,123,94464,2050,295200,389664
validation,432,146,112128,2888,415872,528000
validation,433,116,89088,1823,262512,351600
validation,434,191,146688,4943,711792,858480
validation,435,183,140544,4538,653472,794016
validation,436,240,184320,7804,1123776,1308096
validation,437,67,51456,609,87696,139152
validation,438,127,97536,2186,314784,412320
validation,439,76,58368,783,112752,171120
validation,440,98,75264,1302,187488,262752
validation,441,49,37632,326,46944,84576
validation,442,161,123648,3512,505728,629376
validation,443,178,136704,4293,618192,754896
validation,444,79,60672,846,121824,182496
validation,445,97,74496,1275,183600,258096
validation,446,151,115968,3090,444960,560928
validation,447,68,52224,627,90288,142512
validation,448,147,112896,2928,421632,534528
validation,449,156,119808,3298,474912,594720
validation,450,95,72960,1223,176112,249072
validation,451,110,84480,1640,236160,320640
validation,452,81,62208,889,128016,190224
validation,453,111,85248,1670,240480,325728
validation,454,111,85248,1670,240480,325728
validation,455,166,127488,3734,537696,665184
validation,456,73,56064,722,103968,160032
validation,457,170,130560,3916,563904,694464
validation,458,100,76800,1355,195120,271920
validation,459,138,105984,2581,371664,477648
validation,460,113,86784,1730,249120,335904
validation,461,78,59904,825,118800,178704
validation,462,122,93696,2017,290448,384144
validation,463,107,82176,1552,223488,305664
validation,464,153,117504,3172,456768,574272
validation,465,176,135168,4197,604368,739536
validation,466,160,122880,3469,499536,622416
validation,467,162,124416,3556,512064,636480
validation,468,82,62976,911,131184,194160
validation,469,166,127488,3734,537696,665184
validation,470,99,76032,1328,191232,267264
validation,471,116,89088,1823,262512,351600
validation,472,161,123648,3512,505728,629376
validation,473,148,113664,2968,427392,541056
validation,474,141,108288,2694,387936,496224
validation,475,153,117504,3172,456768,574272
validation,476,203,155904,5584,804096,960000
validation,477,83,63744,934,134496,198240
validation,478,138,105984,2581,371664,477648
validation,479,152,116736,3131,450864,567600
validation,480,157,120576,3340,480960,601536
validation,481,157,120576,3340,480960,601536
validation,482,182,139776,4488,646272,786048
validation,483,126,96768,2151,309744,406512
validation,484,62,47616,521,75024,122640
validation,485,136,104448,2506,360864,465312
validation,486,113,86784,1730,249120,335904
validation,487,132,101376,2361,339984,441360
validation,488,157,120576,3340,480960,601536
validation,489,101,77568,1382,199008,276576
validation,490,98,75264,1302,187488,262752
validation,491,212,162816,6090,876960,1039776
validation,492,144,110592,2810,404640,515232
validation,493,173,132864,4055,583920,716784
validation,494,126,96768,2151,309744,406512
validation,495,147,112896,2928,421632,534528
validation,496,136,104448,2506,360864,465312
validation,497,165,126720,3689,531216,657936
validation,498,102,78336,1410,203040,281376
validation,499,190,145920,4891,704304,850224
validation,500,151,115968,3090,444960,560928
validation,501,179,137472,4220,607680,745152
validation,502,135,103680,2470,355680,459360
validation,503,156,119808,3298,474912,594720
validation,504,175,134400,4150,597600,732000
validation,505,90,69120,1098,158112,227232
validation,506,123,94464,2050,295200,389664
validation,507,136,104448,2506,360864,465312
validation,508,160,122880,3469,499536,622416
validation,509,155,119040,3255,468720,587760
validation,510,208,159744,5862,844128,1003872
validation,511,95,72960,1223,176112,249072
validation,512,99,76032,1328,191232,267264
validation,513,146,112128,2888,415872,528000
validation,514,108,82944,1581,227664,310608
validation,515,191,146688,4943,711792,858480
validation,516,149,114432,3008,433152,547584
validation,517,141,108288,2694,387936,496224
validation,518,145,111360,2849,410256,521616
validation,519,77,59136,804,115776,174912
validation,520,104,79872,1466,211104,290976
validation,521,131,100608,2325,334800,435408
validation,522,85,65280,979,140976,206256
validation,523,183,140544,4538,653472,794016
validation,524,104,79872,1466,211104,290976
validation,525,144,110592,2810,404640,515232
validation,526,100,76800,1355,195120,271920
validation,527,206,158208,5750,828000,986208
validation,528,82,62976,911,131184,194160
validation,529,110,84480,1640,236160,320640
validation,530,113,86784,1730,249120,335904
validation,531,138,105984,2581,371664,477648
validation,532,162,124416,3556,512064,636480
validation,533,198,152064,5312,764928,916992
validation,534,146,112128,2888,415872,528000
validation,535,130,99840,2290,329760,429600
validation,536,152,116736,3131,450864,567600
validation,537,167,128256,3779,544176,672432
validation,538,149,114432,3008,433152,547584
validation,539,181,139008,4439,639216,778224
validation,540,149,114432,3008,433152,547584
validation,541,144,110592,2810,404640,515232
validation,542,152,116736,3131,450864,567600
validation,543,124,95232,2084,300096,395328
validation,544,144,110592,2810,404640,515232
validation,545,150,115200,3049,439056,554256
validation,546,115,88320,1792,258048,346368
validation,547,147,112896,2928,421632,534528
validation,548,131,100608,2325,334800,435408
validation,549,189,145152,3721,535824,680976
validation,550,155,119040,3255,468720,587760
validation,551,183,140544,4538,653472,794016
validation,552,87,66816,1026,147744,214560
validation,553,203,155904,5584,804096,960000
validation,554,127,97536,2186,314784,412320
validation,555,129,99072,2255,324720,423792
validation,556,66,50688,591,85104,135792
validation,557,116,89088,1823,262512,351600
validation,558,82,62976,911,131184,194160
validation,559,162,124416,3556,512064,636480
validation,560,147,112896,2928,421632,534528
validation,561,117,89856,1855,267120,356976
validation,562,77,59136,804,115776,174912
validation,563,182,139776,4488,646272,786048
validation,564,201,154368,5474,788256,942624
validation,565,143,109824,2771,399024,508848
validation,566,155,119040,3255,468720,587760
validation,567,204,156672,4780,688320,844992
validation,568,150,115200,3049,439056,554256
validation,569,137,105216,2543,366192,471408
validation,570,232,178176,6422,924768,1102944
validation,571,77,59136,804,115776,174912
validation,572,221,169728,6093,877392,1047120
validation,573,125,96000,2117,304848,400848
validation,574,161,123648,3512,505728,629376
validation,575,33,25344,148,21312,46656
validation,576,121,92928,1984,285696,378624
validation,577,171,131328,3962,570528,701856
validation,578,153,117504,3172,456768,574272
validation,579,97,74496,1275,183600,258096
validation,580,94,72192,1198,172512,244704
validation,581,194,148992,5100,734400,883392
validation,582,136,104448,2506,360864,465312
validation,583,77,59136,804,115776,174912
validation,584,121,92928,1984,285696,378624
validation,585,132,101376,2361,339984,441360
validation,586,140,107520,2656,382464,489984
validation,587,146,112128,2888,415872,528000
validation,588,139,106752,2618,376992,483744
validation,589,120,92160,1951,280944,373104
validation,590,147,112896,2928,421632,534528
validation,591,118,90624,1887,271728,362352
validation,592,93,71424,1172,168768,240192
validation,593,130,99840,2290,329760,429600
validation,594,173,132864,4055,583920,716784
validation,595,86,66048,1002,144288,210336
validation,596,168,129024,3824,550656,679680
validation,597,144,110592,2810,404640,515232
validation,598,56,43008,425,61200,104208
validation,599,61,46848,505,72720,119568
validation,600,79,60672,846,121824,182496
validation,601,111,85248,1670,240480,325728
validation,602,66,50688,591,85104,135792
validation,603,214,164352,6205,893520,1057872
validation,604,140,107520,2656,382464,489984
validation,605,100,76800,1355,195120,271920
validation,606,128,98304,2220,319680,417984
validation,607,131,100608,2325,334800,435408
validation,608,150,115200,3049,439056,554256
validation,609,106,81408,1523,219312,300720
validation,610,208,159744,5862,844128,1003872
validation,611,144,110592,2810,404640,515232
validation,612,157,120576,3340,480960,601536
validation,613,78,59904,825,118800,178704
validation,614,140,107520,2656,382464,489984
validation,615,125,96000,2117,304848,400848
validation,616,143,109824,2771,399024,508848
validation,617,67,51456,609,87696,139152
validation,618,120,92160,1951,280944,373104
validation,619,92,70656,1147,165168,235824
validation,620,197,151296,5258,757152,908448
validation,621,153,117504,3172,456768,574272
validation,622,149,114432,3008,433152,547584
validation,623,55,42240,410,59040,101280
validation,624,143,109824,2771,399024,508848
validation,625,193,148224,5047,726768,874992
validation,626,73,56064,722,103968,160032
validation,627,148,113664,2968,427392,541056
validation,628,102,78336,1410,203040,281376
validation,629,182,139776,4488,646272,786048
validation,630,138,105984,2581,371664,477648
validation,631,139,106752,2618,376992,483744
validation,632,128,98304,2220,319680,417984
validation,633,225,172800,6859,987696,1160496
validation,634,205,157440,5694,819936,977376
validation,635,125,96000,2117,304848,400848
validation,636,54,41472,395,56880,98352
validation,637,201,154368,4720,679680,834048
validation,638,173,132864,4055,583920,716784
validation,639,259,198912,7911,1139184,1338096
validation,640,63,48384,538,77472,125856
validation,641,153,117504,3172,456768,574272
validation,642,195,149760,5152,741888,891648
validation,643,100,76800,1355,195120,271920
validation,644,123,94464,2050,295200,389664
validation,645,86,66048,1002,144288,210336
validation,646,144,110592,2810,404640,515232
validation,647,148,113664,2968,427392,541056
validation,648,117,89856,1855,267120,356976
validation,649,217,166656,6380,918720,1085376
validation,650,152,116736,3131,450864,567600
validation,651,184,141312,4587,660528,801840
validation,652,61,46848,505,72720,119568
validation,653,171,131328,3962,570528,701856
validation,654,163,125184,3600,518400,643584
validation,655,165,126720,3689,531216,657936
validation,656,137,105216,2543,366192,471408
validation,657,172,132096,4009,577296,709392
validation,658,115,88320,1792,258048,346368
validation,659,186,142848,4688,675072,817920
validation,660,168,129024,3824,550656,679680
validation,661,153,117504,3172,456768,574272
validation,662,169,129792,3870,557280,687072
validation,663,93,71424,1172,168768,240192
validation,664,93,71424,1172,168768,240192
validation,665,87,66816,1026,147744,214560
validation,666,98,75264,1302,187488,262752
validation,667,171,131328,3962,570528,701856
validation,668,109,83712,1610,231840,315552
validation,669,122,93696,2017,290448,384144
validation,670,114,87552,1761,253584,341136
validation,671,161,123648,3512,505728,629376
test,0,109,83712,1610,231840,315552
test,1,138,105984,2581,371664,477648
test,2,116,89088,1823,262512,351600
test,3,145,111360,2849,410256,521616
test,4,133,102144,2397,345168,447312
test,5,209,160512,5919,852336,1012848
test,6,219,168192,6498,935712,1103904
test,7,163,125184,3600,518400,643584
test,8,219,168192,5557,800208,968400
test,9,208,159744,5565,801360,961104
test,10,122,93696,2017,290448,384144
test,11,168,129024,3824,550656,679680
test,12,120,92160,1951,280944,373104
test,13,94,72192,1198,172512,244704
test,14,58,44544,456,65664,110208
test,15,125,96000,2117,304848,400848
test,16,127,97536,2186,314784,412320
test,17,94,72192,1198,172512,244704
test,18,133,102144,2397,345168,447312
test,19,188,144384,4789,689616,834000
test,20,132,101376,2361,339984,441360
test,21,106,81408,1523,219312,300720
test,22,155,119040,3255,468720,587760
test,23,259,198912,7107,1023408,1222320
test,24,170,130560,3916,563904,694464
test,25,177,135936,4245,611280,747216
test,26,194,148992,5100,734400,883392
test,27,132,101376,2361,339984,441360
test,28,74,56832,742,106848,163680
test,29,44,33792,263,37872,71664
test,30,159,122112,3426,493344,615456
test,31,64,49152,555,79920,129072
test,32,114,87552,1761,253584,341136
test,33,153,117504,3172,456768,574272
test,34,92,70656,1147,165168,235824
test,35,145,111360,2849,410256,521616
test,36,67,51456,609,87696,139152
test,37,88,67584,1050,151200,218784
test,38,99,76032,1328,191232,267264
test,39,145,111360,2849,410256,521616
test,40,171,131328,3962,570528,701856
test,41,90,69120,1098,158112,227232
test,42,174,133632,4102,590688,724320
test,43,109,83712,1610,231840,315552
test,44,59,45312,472,67968,113280
test,45,130,99840,2290,329760,429600
test,46,137,105216,2543,366192,471408
test,47,194,148992,5100,734400,883392
test,48,174,133632,4102,590688,724320
test,49,118,90624,1887,271728,362352
test,50,131,100608,2325,334800,435408
test,51,120,92160,1951,280944,373104
test,52,124,95232,2084,300096,395328
test,53,110,84480,1640,236160,320640
test,54,149,114432,3008,433152,547584
test,55,90,69120,1098,158112,227232
test,56,134,102912,2433,350352,453264
test,57,170,130560,3916,563904,694464
test,58,125,96000,2117,304848,400848
test,59,127,97536,2186,314784,412320
test,60,166,127488,3734,537696,665184
test,61,126,96768,2151,309744,406512
test,62,130,99840,2290,329760,429600
test,63,123,94464,2050,295200,389664
test,64,197,151296,5258,757152,908448
test,65,225,172800,6859,987696,1160496
test,66,143,109824,2771,399024,508848
test,67,84,64512,956,137664,202176
test,68,193,148224,5047,726768,874992
test,69,132,101376,2361,339984,441360
test,70,104,79872,1466,211104,290976
test,71,123,94464,2050,295200,389664
test,72,166,127488,3734,537696,665184
test,73,66,50688,591,85104,135792
test,74,175,134400,4150,597600,732000
test,75,178,136704,4293,618192,754896
test,76,147,112896,2928,421632,534528
test,77,149,114432,3008,433152,547584
test,78,169,129792,3870,557280,687072
test,79,114,87552,1761,253584,341136
test,80,73,56064,722,103968,160032
test,81,72,55296,703,101232,156528
test,82,163,125184,3600,518400,643584
test,83,158,121344,3383,487152,608496
test,84,161,123648,3512,505728,629376
test,85,112,86016,1700,244800,330816
test,86,101,77568,1382,199008,276576
test,87,134,102912,2433,350352,453264
test,88,183,140544,4538,653472,794016
test,89,81,62208,889,128016,190224
test,90,150,115200,3049,439056,554256
test,91,177,135936,4245,611280,747216
test,92,174,133632,4102,590688,724320
test,93,117,89856,1855,267120,356976
test,94,160,122880,3469,499536,622416
test,95,214,164352,6205,893520,1057872
test,96,83,63744,934,134496,198240
test,97,94,72192,1198,172512,244704
test,98,177,135936,4245,611280,747216
test,99,143,109824,2771,399024,508848
test,100,164,125952,3644,524736,650688
test,101,111,85248,1670,240480,325728
test,102,165,126720,3689,531216,657936
test,103,120,92160,1951,280944,373104
test,104,47,36096,300,43200,79296
test,105,166,127488,3734,537696,665184
test,106,141,108288,2694,387936,496224
test,107,124,95232,2084,300096,395328
test,108,139,106752,2618,376992,483744
test,109,205,157440,5694,819936,977376
test,110,126,96768,2151,309744,406512
test,111,167,128256,3779,544176,672432
test,112,178,136704,4293,618192,754896
test,113,196,150528,5205,749520,900048
test,114,193,148224,5047,726768,874992
test,115,155,119040,3255,468720,587760
test,116,173,132864,4055,583920,716784
test,117,122,93696,2017,290448,384144
test,118,257,197376,7177,1033488,1230864
test,119,121,92928,1984,285696,378624
test,120,145,111360,2849,410256,521616
test,121,141,108288,2694,387936,496224
test,122,159,122112,3426,493344,615456
test,123,228,175104,7043,1014192,1189296
test,124,85,65280,979,140976,206256
test,125,202,155136,5529,796176,951312
test,126,43,33024,251,36144,69168
test,127,125,96000,2117,304848,400848
test,128,134,102912,2433,350352,453264
test,129,181,139008,4439,639216,778224
test,130,119,91392,1919,276336,367728
test,131,64,49152,555,79920,129072
test,132,101,77568,1382,199008,276576
test,133,82,62976,911,131184,194160
test,134,187,143616,4738,682272,825888
test,135,114,87552,1761,253584,341136
test,136,167,128256,3779,544176,672432
test,137,178,136704,4293,618192,754896
test,138,158,121344,3383,487152,608496
test,139,149,114432,3008,433152,547584
test,140,167,128256,3779,544176,672432
test,141,74,56832,742,106848,163680
test,142,97,74496,1275,183600,258096
test,143,72,55296,703,101232,156528
test,144,148,113664,2968,427392,541056
test,145,104,79872,1466,211104,290976
test,146,131,100608,2325,334800,435408
test,147,92,70656,1147,165168,235824
test,148,126,96768,2151,309744,406512
test,149,149,114432,3008,433152,547584
test,150,59,45312,472,67968,113280
test,151,140,107520,2656,382464,489984
test,152,128,98304,2220,319680,417984
test,153,188,144384,4789,689616,834000
test,154,170,130560,3916,563904,694464
test,155,227,174336,6982,1005408,1179744
test,156,155,119040,2953,425232,544272
test,157,156,119808,3298,474912,594720
test,158,114,87552,1761,253584,341136
test,159,115,88320,1792,258048,346368
test,160,173,132864,4055,583920,716784
test,161,188,144384,4353,626832,771216
test,162,158,121344,3383,487152,608496
test,163,136,104448,2506,360864,465312
test,164,153,117504,3172,456768,574272
test,165,91,69888,1122,161568,231456
test,166,87,66816,1026,147744,214560
test,167,59,45312,472,67968,113280
test,168,143,109824,2771,399024,508848
test,169,128,98304,2220,319680,417984
test,170,143,109824,2771,399024,508848
test,171,84,64512,956,137664,202176
test,172,121,92928,1984,285696,378624
test,173,168,129024,3824,550656,679680
test,174,132,101376,2361,339984,441360
test,175,91,69888,1122,161568,231456
test,176,130,99840,2290,329760,429600
test,177,139,106752,2618,376992,483744
test,178,97,74496,1275,183600,258096
test,179,97,74496,1275,183600,258096
test,180,193,148224,5047,726768,874992
test,181,142,109056,2732,393408,502464
test,182,45,34560,275,39600,74160
test,183,106,81408,1523,219312,300720
test,184,132,101376,2361,339984,441360
test,185,161,123648,3512,505728,629376
test,186,157,120576,3340,480960,601536
test,187,90,69120,1098,158112,227232
test,188,164,125952,3644,524736,650688
test,189,132,101376,2361,339984,441360
test,190,102,78336,1410,203040,281376
test,191,144,110592,2810,404640,515232
test,192,164,125952,3644,524736,650688
test,193,136,104448,2506,360864,465312
test,194,116,89088,1823,262512,351600
test,195,131,100608,2325,334800,435408
test,196,73,56064,722,103968,160032
test,197,116,89088,1823,262512,351600
test,198,138,105984,2581,371664,477648
test,199,158,121344,3383,487152,608496
test,200,191,146688,4943,711792,858480
test,201,112,86016,1700,244800,330816
test,202,142,109056,2732,393408,502464
test,203,197,151296,5258,757152,908448
test,204,115,88320,1792,258048,346368
test,205,173,132864,4055,583920,716784
test,206,140,107520,2656,382464,489984
test,207,76,58368,783,112752,171120
test,208,161,123648,3512,505728,629376
test,209,83,63744,934,134496,198240
test,210,128,98304,2220,319680,417984
test,211,151,115968,3090,444960,560928
test,212,128,98304,2220,319680,417984
test,213,144,110592,2810,404640,515232
test,214,152,116736,3131,450864,567600
test,215,152,116736,3131,450864,567600
test,216,125,96000,2117,304848,400848
test,217,207,158976,5685,818640,977616
test,218,148,113664,2968,427392,541056
test,219,201,154368,5144,740736,895104
test,220,117,89856,1855,267120,356976
test,221,178,136704,4293,618192,754896
test,222,66,50688,591,85104,135792
test,223,177,135936,4245,611280,747216
test,224,136,104448,2506,360864,465312
test,225,114,87552,1761,253584,341136
test,226,98,75264,1302,187488,262752
test,227,209,160512,5919,852336,1012848
test,228,171,131328,3962,570528,701856
test,229,102,78336,1410,203040,281376
test,230,107,82176,1552,223488,305664
test,231,171,131328,3962,570528,701856
test,232,145,111360,2849,410256,521616
test,233,128,98304,2220,319680,417984
test,234,92,70656,1147,165168,235824
test,235,88,67584,1050,151200,218784
test,236,149,114432,3008,433152,547584
test,237,106,81408,1523,219312,300720
test,238,147,112896,2928,421632,534528
test,239,168,129024,3824,550656,679680
test,240,120,92160,1951,280944,373104
test,241,142,109056,2732,393408,502464
test,242,91,69888,1122,161568,231456
test,243,163,125184,3600,518400,643584
test,244,135,103680,2470,355680,459360
test,245,112,86016,1700,244800,330816
test,246,238,182784,7675,1105200,1287984
test,247,142,109056,2732,393408,502464
test,248,167,128256,3779,544176,672432
test,249,107,82176,1552,223488,305664
test,250,136,104448,2506,360864,465312
test,251,90,69120,1098,158112,227232
test,252,121,92928,1984,285696,378624
test,253,153,117504,3172,456768,574272
test,254,135,103680,2470,355680,459360
test,255,100,76800,1355,195120,271920
test,256,119,91392,1919,276336,367728
test,257,147,112896,2928,421632,534528
test,258,211,162048,6032,868608,1030656
test,259,154,118272,3214,462816,581088
test,260,113,86784,1730,249120,335904
test,261,173,132864,4055,583920,716784
test,262,152,116736,3131,450864,567600
test,263,140,107520,2656,382464,489984
test,264,106,81408,1523,219312,300720
test,265,147,112896,2928,421632,534528
test,266,201,154368,5474,788256,942624
test,267,140,107520,2656,382464,489984
test,268,149,114432,3008,433152,547584
test,269,122,93696,2017,290448,384144
test,270,102,78336,1410,203040,281376
test,271,163,125184,3600,518400,643584
test,272,263,201984,9372,1349568,1551552
test,273,90,69120,1098,158112,227232
test,274,114,87552,1761,253584,341136
test,275,109,83712,1610,231840,315552
test,276,84,64512,956,137664,202176
test,277,102,78336,1410,203040,281376
test,278,141,108288,2694,387936,496224
test,279,78,59904,825,118800,178704
test,280,121,92928,1984,285696,378624
test,281,143,109824,2771,399024,508848
test,282,64,49152,555,79920,129072
test,283,106,81408,1523,219312,300720
test,284,150,115200,3049,439056,554256
test,285,126,96768,2151,309744,406512
test,286,105,80640,1494,215136,295776
test,287,189,145152,4840,696960,842112
test,288,125,96000,2117,304848,400848
test,289,136,104448,2506,360864,465312
test,290,193,148224,5047,726768,874992
test,291,85,65280,979,140976,206256
test,292,164,125952,3644,524736,650688
test,293,174,133632,4102,590688,724320
test,294,214,164352,6205,893520,1057872
test,295,159,122112,3426,493344,615456
test,296,84,64512,956,137664,202176
test,297,183,140544,4538,653472,794016
test,298,155,119040,3255,468720,587760
test,299,193,148224,5047,726768,874992
test,300,177,135936,4245,611280,747216
test,301,63,48384,538,77472,125856
test,302,132,101376,2361,339984,441360
test,303,204,156672,5639,812016,968688
test,304,192,147456,4995,719280,866736
test,305,169,129792,3870,557280,687072
test,306,148,113664,2968,427392,541056
test,307,156,119808,3298,474912,594720
test,308,98,75264,1302,187488,262752
test,309,125,96000,2117,304848,400848
test,310,67,51456,609,87696,139152
test,311,66,50688,591,85104,135792
test,312,113,86784,1730,249120,335904
test,313,67,51456,609,87696,139152
test,314,132,101376,2361,339984,441360
test,315,98,75264,1302,187488,262752
test,316,190,145920,4891,704304,850224
test,317,86,66048,1002,144288,210336
test,318,132,101376,2361,339984,441360
test,319,40,30720,217,31248,61968
test,320,132,101376,2361,339984,441360
test,321,156,119808,3298,474912,594720
test,322,190,145920,4891,704304,850224
test,323,144,110592,2810,404640,515232
test,324,122,93696,2017,290448,384144
test,325,72,55296,703,101232,156528
test,326,165,126720,3689,531216,657936
test,327,145,111360,2849,410256,521616
test,328,83,63744,934,134496,198240
test,329,203,155904,5584,804096,960000
test,330,117,89856,1855,267120,356976
test,331,122,93696,2017,290448,384144
test,332,92,70656,1147,165168,235824
test,333,163,125184,3600,518400,643584
test,334,91,69888,1122,161568,231456
test,335,213,163584,5590,804960,968544
test,336,70,53760,664,95616,149376
test,337,114,87552,1761,253584,341136
test,338,143,109824,2771,399024,508848
test,339,44,33792,263,37872,71664
test,340,46,35328,287,41328,76656
test,341,93,71424,1172,168768,240192
test,342,105,80640,1494,215136,295776
test,343,170,130560,3916,563904,694464
test,344,145,111360,2849,410256,521616
test,345,120,92160,1951,280944,373104
test,346,164,125952,3644,524736,650688
test,347,185,142080,4637,667728,809808
test,348,155,119040,3255,468720,587760
test,349,120,92160,1951,280944,373104
test,350,129,99072,2255,324720,423792
test,351,96,73728,1249,179856,253584
test,352,166,127488,3734,537696,665184
test,353,141,108288,2694,387936,496224
test,354,76,58368,783,112752,171120
test,355,276,211968,8414,1211616,1423584
test,356,126,96768,2151,309744,406512
test,357,112,86016,1700,244800,330816
test,358,135,103680,2470,355680,459360
test,359,169,129792,3870,557280,687072
test,360,143,109824,2771,399024,508848
test,361,161,123648,3512,505728,629376
test,362,59,45312,472,67968,113280
test,363,115,88320,1792,258048,346368
test,364,41,31488,228,32832,64320
test,365,96,73728,1249,179856,253584
test,366,77,59136,804,115776,174912
test,367,116,89088,1823,262512,351600
test,368,153,117504,3172,456768,574272
test,369,81,62208,889,128016,190224
test,370,173,132864,4055,583920,716784
test,371,144,110592,2810,404640,515232
test,372,69,52992,645,92880,145872
test,373,140,107520,2656,382464,489984
test,374,171,131328,3962,570528,701856
test,375,238,182784,6698,964512,1147296
test,376,133,102144,2397,345168,447312
test,377,148,113664,2968,427392,541056
test,378,128,98304,2220,319680,417984
test,379,74,56832,742,106848,163680
test,380,82,62976,911,131184,194160
test,381,157,120576,3340,480960,601536
test,382,158,121344,3383,487152,608496
test,383,63,48384,538,77472,125856
test,384,86,66048,1002,144288,210336
test,385,116,89088,1823,262512,351600
test,386,114,87552,1761,253584,341136
test,387,153,117504,3172,456768,574272
test,388,132,101376,2361,339984,441360
test,389,99,76032,1328,191232,267264
test,390,134,102912,2433,350352,453264
test,391,58,44544,456,65664,110208
test,392,173,132864,4055,583920,716784
test,393,169,129792,3870,557280,687072
test,394,185,142080,4637,667728,809808
test,395,127,97536,2186,314784,412320
test,396,176,135168,4197,604368,739536
test,397,101,77568,1382,199008,276576
test,398,165,126720,3689,531216,657936
test,399,100,76800,1355,195120,271920
test,400,196,150528,5205,749520,900048
test,401,88,67584,1050,151200,218784
test,402,135,103680,2470,355680,459360
test,403,218,167424,6439,927216,1094640
test,404,123,94464,2050,295200,389664
test,405,123,94464,2050,295200,389664
test,406,117,89856,1855,267120,356976
test,407,163,125184,3600,518400,643584
test,408,201,154368,5474,788256,942624
test,409,191,146688,4943,711792,858480
test,410,155,119040,3255,468720,587760
test,411,139,106752,2618,376992,483744
test,412,76,58368,783,112752,171120
test,413,193,148224,5047,726768,874992
test,414,115,88320,1792,258048,346368
test,415,174,133632,4102,590688,724320
test,416,213,163584,6147,885168,1048752
test,417,203,155904,5584,804096,960000
test,418,181,139008,4439,639216,778224
test,419,100,76800,1355,195120,271920
test,420,117,89856,1855,267120,356976
test,421,91,69888,1122,161568,231456
test,422,124,95232,2084,300096,395328
test,423,96,73728,1249,179856,253584
test,424,153,117504,3144,452736,570240
test,425,80,61440,867,124848,186288
test,426,114,87552,1761,253584,341136
test,427,98,75264,1302,187488,262752
test,428,121,92928,1984,285696,378624
test,429,89,68352,1074,154656,223008
test,430,125,96000,2117,304848,400848
test,431,94,72192,1198,172512,244704
test,432,157,120576,3340,480960,601536
test,433,167,128256,3779,544176,672432
test,434,144,110592,2810,404640,515232
test,435,115,88320,1792,258048,346368
test,436,136,104448,2506,360864,465312
test,437,181,139008,3976,572544,711552
test,438,163,125184,3600,518400,643584
test,439,137,105216,2543,366192,471408
test,440,219,168192,5420,780480,948672
test,441,167,128256,3779,544176,672432
test,442,130,99840,2290,329760,429600
test,443,140,107520,2656,382464,489984
test,444,61,46848,505,72720,119568
test,445,170,130560,3916,563904,694464
test,446,185,142080,4637,667728,809808
test,447,135,103680,2470,355680,459360
test,448,161,123648,3512,505728,629376
test,449,148,113664,2968,427392,541056
test,450,191,146688,4943,711792,858480
test,451,170,130560,3916,563904,694464
test,452,179,137472,4341,625104,762576
test,453,172,132096,4009,577296,709392
test,454,124,95232,2084,300096,395328
test,455,127,97536,2186,314784,412320
test,456,186,142848,4688,675072,817920
test,457,196,150528,5205,749520,900048
test,458,160,122880,3469,499536,622416
test,459,118,90624,1887,271728,362352
test,460,150,115200,3049,439056,554256
test,461,164,125952,3644,524736,650688
test,462,131,100608,2325,334800,435408
test,463,127,97536,2186,314784,412320
test,464,73,56064,722,103968,160032
test,465,156,119808,3298,474912,594720
test,466,78,59904,825,118800,178704
test,467,189,145152,4840,696960,842112
test,468,172,132096,4009,577296,709392
test,469,123,94464,2050,295200,389664
test,470,116,89088,1824,262656,351744
test,471,133,102144,2397,345168,447312
test,472,87,66816,1026,147744,214560
test,473,170,130560,3916,563904,694464
test,474,135,103680,2470,355680,459360
test,475,229,175872,5981,861264,1037136
test,476,84,64512,956,137664,202176
test,477,181,139008,4439,639216,778224
test,478,72,55296,703,101232,156528
test,479,92,70656,1147,165168,235824
test,480,157,120576,3340,480960,601536
test,481,188,144384,4789,689616,834000
test,482,148,113664,2968,427392,541056
test,483,68,52224,627,90288,142512
test,484,164,125952,3644,524736,650688
test,485,79,60672,846,121824,182496
test,486,83,63744,934,134496,198240
test,487,142,109056,2732,393408,502464
test,488,193,148224,5047,726768,874992
test,489,162,124416,3520,506880,631296
test,490,120,92160,1951,280944,373104
test,491,179,137472,4341,625104,762576
test,492,131,100608,2325,334800,435408
test,493,136,104448,2506,360864,465312
test,494,75,57600,762,109728,167328
test,495,108,82944,1581,227664,310608
test,496,138,105984,2581,371664,477648
test,497,209,160512,5403,778032,938544
test,498,142,109056,2732,393408,502464
test,499,157,120576,3340,480960,601536
test,500,74,56832,742,106848,163680
test,501,113,86784,1730,249120,335904
test,502,109,83712,1610,231840,315552
test,503,103,79104,1438,207072,286176
test,504,101,77568,1382,199008,276576
test,505,166,127488,3734,537696,665184
test,506,111,85248,1670,240480,325728
test,507,156,119808,3298,474912,594720
test,508,197,151296,5258,757152,908448
test,509,256,196608,7516,1082304,1278912
test,510,112,86016,1700,244800,330816
test,511,104,79872,1466,211104,290976
test,512,125,96000,2117,304848,400848
test,513,161,123648,3512,505728,629376
test,514,73,56064,722,103968,160032
test,515,132,101376,2361,339984,441360
test,516,109,83712,1610,231840,315552
test,517,112,86016,1700,244800,330816
test,518,176,135168,4197,604368,739536
test,519,130,99840,2290,329760,429600
test,520,77,59136,804,115776,174912
test,521,80,61440,867,124848,186288
test,522,81,62208,889,128016,190224
test,523,169,129792,3870,557280,687072
test,524,230,176640,7000,1008000,1184640
test,525,118,90624,1887,271728,362352
test,526,212,162816,5060,728640,891456
test,527,170,130560,3916,563904,694464
test,528,45,34560,275,39600,74160
test,529,40,30720,217,31248,61968
test,530,200,153600,5420,780480,934080
test,531,121,92928,1984,285696,378624
test,532,74,56832,742,106848,163680
test,533,104,79872,1466,211104,290976
test,534,169,129792,3870,557280,687072
test,535,233,178944,6785,977040,1155984
test,536,77,59136,804,115776,174912
test,537,88,67584,1050,151200,218784
test,538,156,119808,3298,474912,594720
test,539,151,115968,3090,444960,560928
test,540,128,98304,2220,319680,417984
test,541,93,71424,1172,168768,240192
test,542,126,96768,2151,309744,406512
test,543,134,102912,2433,350352,453264
test,544,80,61440,867,124848,186288
test,545,168,129024,3824,550656,679680
test,546,125,96000,2117,304848,400848
test,547,149,114432,3008,433152,547584
test,548,195,149760,4803,691632,841392
test,549,93,71424,1172,168768,240192
test,550,117,89856,1855,267120,356976
test,551,144,110592,2810,404640,515232
test,552,102,78336,1410,203040,281376
test,553,90,69120,1098,158112,227232
test,554,111,85248,1670,240480,325728
test,555,76,58368,783,112752,171120
test,556,112,86016,1700,244800,330816
test,557,190,145920,4891,704304,850224
test,558,198,152064,5312,764928,916992
test,559,133,102144,2397,345168,447312
test,560,189,145152,4840,696960,842112
test,561,120,92160,1951,280944,373104
test,562,86,66048,1002,144288,210336
test,563,223,171264,6738,970272,1141536
test,564,134,102912,2433,350352,453264
test,565,145,111360,2849,410256,521616
test,566,216,165888,5580,803520,969408
test,567,184,141312,4587,660528,801840
test,568,146,112128,2888,415872,528000
test,569,104,79872,1466,211104,290976
test,570,118,90624,1887,271728,362352
test,571,126,96768,2151,309744,406512
test,572,126,96768,2151,309744,406512
test,573,140,107520,2656,382464,489984
test,574,70,53760,664,95616,149376
test,575,108,82944,1581,227664,310608
test,576,195,149760,5152,741888,891648
test,577,76,58368,783,112752,171120
test,578,123,94464,2050,295200,389664
test,579,95,72960,1223,176112,249072
test,580,167,128256,3779,544176,672432
test,581,83,63744,934,134496,198240
test,582,150,115200,3049,439056,554256
test,583,107,82176,1552,223488,305664
test,584,254,195072,7555,1087920,1282992
test,585,188,144384,4789,689616,834000
test,586,136,104448,2506,360864,465312
test,587,96,73728,1249,179856,253584
test,588,52,39936,367,52848,92784
test,589,165,126720,3689,531216,657936
test,590,166,127488,3734,537696,665184
test,591,122,93696,2017,290448,384144
test,592,152,116736,3131,450864,567600
test,593,157,120576,3340,480960,601536
test,594,153,117504,3172,456768,574272
test,595,115,88320,1792,258048,346368
test,596,249,191232,8097,1165968,1357200
test,597,148,113664,2968,427392,541056
test,598,66,50688,591,85104,135792
test,599,115,88320,1792,258048,346368
test,600,78,59904,825,118800,178704
test,601,130,99840,2290,329760,429600
test,602,107,82176,1552,223488,305664
test,603,106,81408,1523,219312,300720
test,604,167,128256,3779,544176,672432
test,605,197,151296,5258,757152,908448
test,606,204,156672,5598,806112,962784
test,607,169,129792,3870,557280,687072
test,608,136,104448,2506,360864,465312
test,609,78,59904,825,118800,178704
test,610,141,108288,2694,387936,496224
test,611,157,120576,3340,480960,601536
test,612,162,124416,3556,512064,636480
test,613,239,183552,7739,1114416,1297968
test,614,210,161280,5975,860400,1021680
test,615,172,132096,4009,577296,709392
test,616,78,59904,825,118800,178704
test,617,84,64512,956,137664,202176
test,618,131,100608,2325,334800,435408
test,619,149,114432,3008,433152,547584
test,620,105,80640,1494,215136,295776
test,621,160,122880,3469,499536,622416
test,622,194,148992,5100,734400,883392
test,623,188,144384,4789,689616,834000
test,624,68,52224,627,90288,142512
test,625,162,124416,3556,512064,636480
test,626,165,126720,3689,531216,657936
test,627,97,74496,1275,183600,258096
test,628,116,89088,1823,262512,351600
test,629,113,86784,1730,249120,335904
test,630,180,138240,4390,632160,770400
test,631,199,152832,5366,772704,925536
test,632,105,80640,1494,215136,295776
test,633,193,148224,5047,726768,874992
test,634,140,107520,2656,382464,489984
test,635,135,103680,2470,355680,459360
test,636,156,119808,3298,474912,594720
test,637,168,129024,3824,550656,679680
test,638,159,122112,3426,493344,615456
test,639,124,95232,2084,300096,395328
test,640,143,109824,2771,399024,508848
test,641,189,145152,4840,696960,842112
test,642,67,51456,609,87696,139152
test,643,127,97536,2186,314784,412320
test,644,161,123648,3512,505728,629376
test,645,149,114432,3008,433152,547584
test,646,227,174336,6626,954144,1128480
test,647,62,47616,521,75024,122640
test,648,167,128256,3779,544176,672432
test,649,50,38400,339,48816,87216
test,650,78,59904,825,118800,178704
test,651,198,152064,5312,764928,916992
test,652,139,106752,2618,376992,483744
test,653,109,83712,1610,231840,315552
test,654,106,81408,1523,219312,300720
test,655,180,138240,4390,632160,770400
test,656,165,126720,3689,531216,657936
test,657,159,122112,3426,493344,615456
test,658,156,119808,3298,474912,594720
test,659,113,86784,1730,249120,335904
test,660,157,120576,3340,480960,601536
test,661,161,123648,3512,505728,629376
test,662,160,122880,3469,499536,622416
test,663,162,124416,3556,512064,636480
test,664,131,100608,2325,334800,435408
test,665,142,109056,2732,393408,502464
test,666,179,137472,4341,625104,762576
test,667,118,90624,1887,271728,362352
test,668,226,173568,6086,876384,1049952
test,669,104,79872,1466,211104,290976
test,670,143,109824,2771,399024,508848
test,671,143,109824,2771,399024,508848
test,672,179,137472,4341,625104,762576
test,673,156,119808,3298,474912,594720
test,674,140,107520,2656,382464,489984
test,675,117,89856,1855,267120,356976
test,676,120,92160,1951,280944,373104
test,677,96,73728,1249,179856,253584
test,678,192,147456,4995,719280,866736
test,679,100,76800,1355,195120,271920
test,680,80,61440,867,124848,186288
test,681,127,97536,2186,314784,412320
test,682,177,135936,4245,611280,747216
test,683,167,128256,3779,544176,672432
test,684,142,109056,2732,393408,502464
test,685,226,173568,5820,838080,1011648
test,686,118,90624,1887,271728,362352
test,687,127,97536,2186,314784,412320
test,688,94,72192,1198,172512,244704
test,689,112,86016,1700,244800,330816
test,690,191,146688,4943,711792,858480
test,691,115,88320,1792,258048,346368
test,692,178,136704,4293,618192,754896
test,693,146,112128,2888,415872,528000
test,694,111,85248,1670,240480,325728
test,695,162,124416,3556,512064,636480
test,696,168,129024,3824,550656,679680
test,697,137,105216,2543,366192,471408
test,698,188,144384,4789,689616,834000
test,699,142,109056,2732,393408,502464
test,700,147,112896,2928,421632,534528
test,701,119,91392,1919,276336,367728
test,702,139,106752,2618,376992,483744
test,703,130,99840,2290,329760,429600
test,704,189,145152,4840,696960,842112
test,705,136,104448,2506,360864,465312
test,706,159,122112,3426,493344,615456
test,707,80,61440,867,124848,186288
test,708,94,72192,1198,172512,244704
test,709,123,94464,2050,295200,389664
test,710,117,89856,1855,267120,356976
test,711,81,62208,889,128016,190224
test,712,180,138240,4390,632160,770400
test,713,58,44544,456,65664,110208
test,714,165,126720,3689,531216,657936
test,715,61,46848,505,72720,119568
test,716,122,93696,2017,290448,384144
test,717,61,46848,505,72720,119568
test,718,82,62976,911,131184,194160
test,719,58,44544,456,65664,110208
test,720,94,72192,1198,172512,244704
test,721,145,111360,2849,410256,521616
test,722,80,61440,867,124848,186288
test,723,134,102912,2433,350352,453264
test,724,181,139008,4439,639216,778224
test,725,148,113664,2968,427392,541056
test,726,170,130560,3916,563904,694464
test,727,151,115968,3090,444960,560928
test,728,83,63744,934,134496,198240
test,729,151,115968,3090,444960,560928
test,730,195,149760,5152,741888,891648
test,731,133,102144,2397,345168,447312
test,732,180,138240,4323,622512,760752
test,733,123,94464,2050,295200,389664
test,734,111,85248,1670,240480,325728
test,735,65,49920,573,82512,132432
test,736,57,43776,441,63504,107280
test,737,146,112128,2888,415872,528000
test,738,79,60672,846,121824,182496
test,739,193,148224,5047,726768,874992
test,740,70,53760,664,95616,149376
test,741,205,157440,5612,808128,965568
test,742,191,146688,4943,711792,858480
test,743,105,80640,1494,215136,295776
test,744,77,59136,804,115776,174912
test,745,152,116736,3131,450864,567600
test,746,83,63744,934,134496,198240
test,747,102,78336,1410,203040,281376
test,748,135,103680,2470,355680,459360
test,749,101,77568,1382,199008,276576
test,750,273,209664,8399,1209456,1419120
test,751,180,138240,4390,632160,770400
test,752,129,99072,2255,324720,423792
test,753,125,96000,2117,304848,400848
test,754,91,69888,1122,161568,231456
test,755,207,158976,5806,836064,995040
test,756,113,86784,1730,249120,335904
test,757,141,108288,2694,387936,496224
test,758,105,80640,1494,215136,295776
test,759,82,62976,911,131184,194160
test,760,146,112128,2888,415872,528000
test,761,95,72960,1223,176112,249072
test,762,131,100608,2325,334800,435408
test,763,140,107520,2656,382464,489984
test,764,181,139008,4439,639216,778224
test,765,129,99072,2255,324720,423792
test,766,109,83712,1610,231840,315552
test,767,62,47616,521,75024,122640
test,768,60,46080,488,70272,116352
test,769,120,92160,1951,280944,373104
test,770,111,85248,1670,240480,325728
test,771,100,76800,1355,195120,271920
test,772,164,125952,3644,524736,650688
test,773,172,132096,4009,577296,709392
test,774,135,103680,2470,355680,459360
test,775,71,54528,683,98352,152880
test,776,84,64512,956,137664,202176
test,777,132,101376,2361,339984,441360
test,778,125,96000,2117,304848,400848
test,779,61,46848,505,72720,119568
test,780,172,132096,4009,577296,709392
test,781,229,175872,6649,957456,1133328
test,782,157,120576,3340,480960,601536
test,783,57,43776,441,63504,107280
test,784,167,128256,3779,544176,672432
test,785,164,125952,3644,524736,650688
test,786,106,81408,1523,219312,300720
test,787,109,83712,1610,231840,315552
test,788,169,129792,3870,557280,687072
test,789,129,99072,2255,324720,423792
test,790,115,88320,1792,258048,346368
test,791,70,53760,664,95616,149376
test,792,127,97536,2186,314784,412320
test,793,143,109824,2771,399024,508848
test,794,171,131328,3962,570528,701856
test,795,47,36096,300,43200,79296
test,796,108,82944,1581,227664,310608
test,797,93,71424,1172,168768,240192
test,798,129,99072,2255,324720,423792
test,799,98,75264,1302,187488,262752
test,800,93,71424,1172,168768,240192
test,801,235,180480,6037,869328,1049808
test,802,137,105216,2543,366192,471408
test,803,112,86016,1700,244800,330816
test,804,94,72192,1198,172512,244704
test,805,114,87552,1761,253584,341136
test,806,190,145920,4891,704304,850224
test,807,179,137472,4341,625104,762576
test,808,177,135936,4245,611280,747216
test,809,140,107520,2656,382464,489984
test,810,107,82176,1552,223488,305664
test,811,35,26880,166,23904,50784
test,812,70,53760,664,95616,149376
test,813,166,127488,3734,537696,665184
test,814,193,148224,5047,726768,874992
test,815,49,37632,326,46944,84576
test,816,126,96768,2151,309744,406512
test,817,67,51456,609,87696,139152
test,818,113,86784,1730,249120,335904
test,819,215,165120,6263,901872,1066992
test,820,188,144384,4789,689616,834000
test,821,84,64512,956,137664,202176
test,822,197,151296,4553,655632,806928
test,823,118,90624,1887,271728,362352
test,824,214,164352,6205,893520,1057872
test,825,161,123648,3512,505728,629376
test,826,163,125184,3600,518400,643584
test,827,166,127488,3734,537696,665184
test,828,156,119808,3298,474912,594720
test,829,81,62208,889,128016,190224
test,830,133,102144,2397,345168,447312
test,831,136,104448,2506,360864,465312
test,832,116,89088,1823,262512,351600
test,833,76,58368,783,112752,171120
test,834,57,43776,441,63504,107280
test,835,90,69120,1098,158112,227232
test,836,175,134400,4052,583488,717888
test,837,211,162048,5497,791568,953616
test,838,161,123648,3512,505728,629376
test,839,121,92928,1984,285696,378624
test,840,96,73728,1249,179856,253584
test,841,145,111360,2849,410256,521616
test,842,93,71424,1172,168768,240192
test,843,138,105984,2581,371664,477648
test,844,73,56064,722,103968,160032
test,845,60,46080,488,70272,116352
test,846,156,119808,3298,474912,594720
test,847,142,109056,2732,393408,502464
test,848,163,125184,3600,518400,643584
test,849,151,115968,3090,444960,560928
test,850,155,119040,3255,468720,587760
test,851,129,99072,2255,324720,423792
test,852,109,83712,1610,231840,315552
test,853,116,89088,1823,262512,351600
test,854,109,83712,1610,231840,315552
test,855,182,139776,4488,646272,786048
test,856,129,99072,2255,324720,423792
test,857,111,85248,1670,240480,325728
test,858,171,131328,3962,570528,701856
test,859,127,97536,2186,314784,412320
test,860,97,74496,1275,183600,258096
test,861,160,122880,3469,499536,622416
test,862,168,129024,3824,550656,679680
test,863,229,175872,6358,915552,1091424
test,864,80,61440,867,124848,186288
test,865,145,111360,2849,410256,521616
test,866,160,122880,3469,499536,622416
test,867,180,138240,4390,632160,770400
test,868,79,60672,846,121824,182496
test,869,172,132096,4009,577296,709392
test,870,97,74496,1275,183600,258096
test,871,80,61440,867,124848,186288
test,872,130,99840,2290,329760,429600
test,873,136,104448,2453,353232,457680
test,874,141,108288,2694,387936,496224
test,875,53,40704,381,54864,95568
test,876,190,145920,4891,704304,850224
test,877,78,59904,825,118800,178704
test,878,133,102144,2397,345168,447312
test,879,111,85248,1670,240480,325728
test,880,183,140544,4538,653472,794016
test,881,144,110592,2810,404640,515232
test,882,90,69120,1098,158112,227232
test,883,165,126720,3689,531216,657936
test,884,119,91392,1919,276336,367728
test,885,162,124416,3556,512064,636480
test,886,113,86784,1730,249120,335904
test,887,162,124416,3556,512064,636480
test,888,59,45312,472,67968,113280
test,889,177,135936,4245,611280,747216
test,890,83,63744,934,134496,198240
test,891,143,109824,2771,399024,508848
test,892,149,114432,3008,433152,547584
test,893,140,107520,2656,382464,489984
test,894,145,111360,2849,410256,521616
test,895,83,63744,934,134496,198240
test,896,101,77568,1382,199008,276576
test,897,152,116736,3131,450864,567600
test,898,82,62976,911,131184,194160
test,899,197,151296,5258,757152,908448
test,900,242,185856,7935,1142640,1328496
test,901,128,98304,2220,319680,417984
test,902,132,101376,2361,339984,441360
test,903,136,104448,2506,360864,465312
test,904,93,71424,1172,168768,240192
test,905,166,127488,3734,537696,665184
test,906,110,84480,1640,236160,320640
test,907,87,66816,1026,147744,214560
test,908,101,77568,1382,199008,276576
test,909,54,41472,395,56880,98352
test,910,142,109056,2732,393408,502464
test,911,113,86784,1730,249120,335904
test,912,129,99072,2255,324720,423792
test,913,117,89856,1855,267120,356976
test,914,138,105984,2581,371664,477648
test,915,152,116736,3131,450864,567600
test,916,146,112128,2888,415872,528000
test,917,61,46848,505,72720,119568
test,918,167,128256,3779,544176,672432
test,919,127,97536,2186,314784,412320
test,920,140,107520,2656,382464,489984
test,921,101,77568,1382,199008,276576
test,922,156,119808,3298,474912,594720
test,923,96,73728,1249,179856,253584
test,924,144,110592,2810,404640,515232
test,925,64,49152,555,79920,129072
test,926,150,115200,3049,439056,554256
test,927,164,125952,3644,524736,650688
test,928,135,103680,2470,355680,459360
test,929,80,61440,867,124848,186288
test,930,143,109824,2771,399024,508848
test,931,95,72960,1223,176112,249072
test,932,121,92928,1984,285696,378624
test,933,179,137472,4341,625104,762576
test,934,115,88320,1792,258048,346368
test,935,113,86784,1730,249120,335904
test,936,129,99072,2255,324720,423792
test,937,213,163584,5666,815904,979488
test,938,147,112896,2928,421632,534528
test,939,98,75264,1302,187488,262752
test,940,131,100608,2325,334800,435408
test,941,152,116736,3131,450864,567600
test,942,54,41472,395,56880,98352
test,943,149,114432,2929,421776,536208
test,944,158,121344,3383,487152,608496
test,945,136,104448,2506,360864,465312
test,946,88,67584,1050,151200,218784
test,947,133,102144,2397,345168,447312
test,948,138,105984,2581,371664,477648
test,949,127,97536,2186,314784,412320
test,950,108,82944,1581,227664,310608
test,951,143,109824,2771,399024,508848
test,952,218,167424,6439,927216,1094640
test,953,128,98304,2220,319680,417984
test,954,143,109824,2771,399024,508848
test,955,230,176640,7168,1032192,1208832
test,956,98,75264,1302,187488,262752
test,957,170,130560,3916,563904,694464
test,958,113,86784,1730,249120,335904
test,959,92,70656,1147,165168,235824
test,960,168,129024,3824,550656,679680
test,961,91,69888,1122,161568,231456
test,962,117,89856,1855,267120,356976
test,963,106,81408,1523,219312,300720
test,964,127,97536,2186,314784,412320
test,965,114,87552,1761,253584,341136
test,966,99,76032,1328,191232,267264
test,967,187,143616,4738,682272,825888
test,968,181,139008,4439,639216,778224
test,969,110,84480,1640,236160,320640
test,970,97,74496,1275,183600,258096
test,971,145,111360,2849,410256,521616
test,972,129,99072,2255,324720,423792
test,973,93,71424,1172,168768,240192
test,974,113,86784,1730,249120,335904
test,975,219,168192,6498,935712,1103904
test,976,130,99840,2290,329760,429600
test,977,95,72960,1223,176112,249072
test,978,203,155904,5584,804096,960000
test,979,203,155904,5584,804096,960000
test,980,121,92928,1984,285696,378624
test,981,134,102912,2433,350352,453264
test,982,172,132096,4009,577296,709392
test,983,133,102144,2397,345168,447312
test,984,167,128256,3779,544176,672432
test,985,48,36864,313,45072,81936
test,986,73,56064,722,103968,160032
test,987,148,113664,2968,427392,541056
test,988,145,111360,2849,410256,521616
test,989,218,167424,6439,927216,1094640
test,990,115,88320,1792,258048,346368
test,991,61,46848,505,72720,119568
test,992,115,88320,1792,258048,346368
test,993,185,142080,4637,667728,809808
test,994,135,103680,2470,355680,459360
test,995,77,59136,804,115776,174912
test,996,215,165120,5347,769968,935088
test,997,141,108288,2694,387936,496224
test,998,124,95232,2084,300096,395328
test,999,190,145920,4891,704304,850224
test,1000,141,108288,2694,387936,496224
test,1001,125,96000,2117,304848,400848
test,1002,95,72960,1223,176112,249072
test,1003,110,84480,1640,236160,320640
test,1004,166,127488,3734,537696,665184
test,1005,107,82176,1552,223488,305664
test,1006,86,66048,1002,144288,210336
test,1007,188,144384,4472,643968,788352
test,1008,121,92928,1984,285696,378624
test,1009,175,134400,4150,597600,732000
test,1010,118,90624,1887,271728,362352
test,1011,150,115200,3049,439056,554256
test,1012,155,119040,3255,468720,587760
test,1013,131,100608,2325,334800,435408
test,1014,148,113664,2968,427392,541056
test,1015,108,82944,1581,227664,310608
test,1016,105,80640,1494,215136,295776
test,1017,169,129792,3870,557280,687072
test,1018,90,69120,1098,158112,227232
test,1019,139,106752,2618,376992,483744
test,1020,151,115968,3090,444960,560928
test,1021,140,107520,2656,382464,489984
test,1022,71,54528,683,98352,152880
test,1023,88,67584,1050,151200,218784
test,1024,145,111360,2849,410256,521616
test,1025,154,118272,3214,462816,581088
test,1026,46,35328,287,41328,76656
test,1027,129,99072,2255,324720,423792
test,1028,144,110592,2810,404640,515232
test,1029,100,76800,1355,195120,271920
test,1030,98,75264,1302,187488,262752
test,1031,57,43776,441,63504,107280
test,1032,142,109056,2732,393408,502464
test,1033,138,105984,2581,371664,477648
test,1034,155,119040,3255,468720,587760
test,1035,123,94464,2050,295200,389664
test,1036,67,51456,609,87696,139152
test,1037,120,92160,1951,280944,373104
test,1038,121,92928,1984,285696,378624
test,1039,47,36096,300,43200,79296
test,1040,57,43776,441,63504,107280
test,1041,184,141312,4587,660528,801840
test,1042,115,88320,1792,258048,346368
test,1043,110,84480,1640,236160,320640
test,1044,165,126720,3689,531216,657936
test,1045,185,142080,4637,667728,809808
test,1046,196,150528,5205,749520,900048
test,1047,190,145920,4891,704304,850224
test,1048,140,107520,2656,382464,489984
test,1049,170,130560,3916,563904,694464
test,1050,119,91392,1919,276336,367728
test,1051,135,103680,2470,355680,459360
test,1052,103,79104,1438,207072,286176
test,1053,133,102144,2397,345168,447312
test,1054,197,151296,5258,757152,908448
test,1055,181,139008,4439,639216,778224
test,1056,132,101376,2361,339984,441360
test,1057,209,160512,5624,809856,970368
test,1058,66,50688,591,85104,135792
test,1059,77,59136,804,115776,174912
test,1060,91,69888,1122,161568,231456
test,1061,230,176640,6643,956592,1133232
test,1062,140,107520,2656,382464,489984
test,1063,219,168192,6333,911952,1080144
test,1064,105,80640,1494,215136,295776
test,1065,181,139008,4439,639216,778224
test,1066,126,96768,2151,309744,406512
test,1067,94,72192,1198,172512,244704
test,1068,106,81408,1523,219312,300720
test,1069,146,112128,2888,415872,528000
test,1070,156,119808,3298,474912,594720
test,1071,129,99072,2255,324720,423792
test,1072,154,118272,3214,462816,581088
test,1073,114,87552,1761,253584,341136
test,1074,148,113664,2968,427392,541056
test,1075,226,173568,6447,928368,1101936
test,1076,133,102144,2397,345168,447312
test,1077,186,142848,4688,675072,817920
test,1078,167,128256,3779,544176,672432
test,1079,269,206592,8619,1241136,1447728
test,1080,220,168960,6558,944352,1113312
test,1081,138,105984,2581,371664,477648
test,1082,96,73728,1249,179856,253584
test,1083,184,141312,4587,660528,801840
test,1084,162,124416,3556,512064,636480
test,1085,152,116736,3131,450864,567600
test,1086,142,109056,2732,393408,502464
test,1087,172,132096,4009,577296,709392
test,1088,147,112896,2928,421632,534528
test,1089,152,116736,3131,450864,567600
test,1090,50,38400,339,48816,87216
test,1091,160,122880,3469,499536,622416
test,1092,115,88320,1792,258048,346368
test,1093,57,43776,441,63504,107280
test,1094,141,108288,2694,387936,496224
test,1095,170,130560,3916,563904,694464
test,1096,188,144384,4428,637632,782016
test,1097,185,142080,4637,667728,809808
test,1098,173,132864,4055,583920,716784
test,1099,231,177408,6845,985680,1163088
test,1100,151,115968,3090,444960,560928
test,1101,162,124416,3556,512064,636480
test,1102,85,65280,979,140976,206256
test,1103,81,62208,889,128016,190224
test,1104,148,113664,2968,427392,541056
test,1105,210,161280,5685,818640,979920
test,1106,145,111360,2849,410256,521616
test,1107,221,169728,6618,952992,1122720
test,1108,124,95232,2084,300096,395328
test,1109,122,93696,2017,290448,384144
test,1110,161,123648,3512,505728,629376
test,1111,126,96768,2151,309744,406512
test,1112,112,86016,1700,244800,330816
test,1113,100,76800,1355,195120,271920
test,1114,184,141312,4587,660528,801840
test,1115,122,93696,2017,290448,384144
test,1116,160,122880,3469,499536,622416
test,1117,84,64512,956,137664,202176
test,1118,160,122880,3469,499536,622416
test,1119,113,86784,1730,249120,335904
test,1120,141,108288,2694,387936,496224
test,1121,128,98304,2220,319680,417984
test,1122,126,96768,2151,309744,406512
test,1123,62,47616,521,75024,122640
test,1124,129,99072,2255,324720,423792
test,1125,232,178176,7293,1050192,1228368
test,1126,123,94464,2050,295200,389664
test,1127,176,135168,4197,604368,739536
test,1128,116,89088,1823,262512,351600
test,1129,144,110592,2810,404640,515232
test,1130,138,105984,2581,371664,477648
test,1131,137,105216,2543,366192,471408
test,1132,162,124416,3556,512064,636480
test,1133,108,82944,1581,227664,310608
test,1134,163,125184,3600,518400,643584
test,1135,193,148224,5047,726768,874992
test,1136,153,117504,3172,456768,574272
test,1137,165,126720,3689,531216,657936
test,1138,161,123648,3512,505728,629376
test,1139,118,90624,1887,271728,362352
test,1140,138,105984,2581,371664,477648
test,1141,84,64512,956,137664,202176
test,1142,140,107520,2656,382464,489984
test,1143,162,124416,3556,512064,636480
test,1144,183,140544,4538,653472,794016
test,1145,141,108288,2694,387936,496224
test,1146,190,145920,4236,609984,755904
test,1147,89,68352,1074,154656,223008
test,1148,188,144384,4789,689616,834000
test,1149,205,157440,5694,819936,977376
test,1150,175,134400,4150,597600,732000
test,1151,54,41472,395,56880,98352
test,1152,47,36096,300,43200,79296
test,1153,71,54528,683,98352,152880
test,1154,154,118272,3214,462816,581088
test,1155,168,129024,3824,550656,679680
test,1156,183,140544,4538,653472,794016
test,1157,68,52224,627,90288,142512
test,1158,151,115968,3090,444960,560928
test,1159,201,154368,5474,788256,942624
test,1160,172,132096,4009,577296,709392
test,1161,162,124416,3556,512064,636480
test,1162,53,40704,381,54864,95568
test,1163,64,49152,555,79920,129072
test,1164,95,72960,1223,176112,249072
test,1165,121,92928,1984,285696,378624
test,1166,99,76032,1328,191232,267264
test,1167,155,119040,3255,468720,587760
test,1168,95,72960,1223,176112,249072
test,1169,87,66816,1026,147744,214560
test,1170,217,166656,6380,918720,1085376
test,1171,132,101376,2361,339984,441360
test,1172,109,83712,1610,231840,315552
test,1173,175,134400,4150,597600,732000
test,1174,155,119040,3255,468720,587760
test,1175,105,80640,1494,215136,295776
test,1176,155,119040,3255,468720,587760
test,1177,77,59136,804,115776,174912
test,1178,119,91392,1919,276336,367728
test,1179,153,117504,3172,456768,574272
test,1180,119,91392,1919,276336,367728
test,1181,184,141312,4587,660528,801840
test,1182,111,85248,1670,240480,325728
test,1183,113,86784,1730,249120,335904
test,1184,85,65280,979,140976,206256
test,1185,150,115200,3049,439056,554256
test,1186,169,129792,3870,557280,687072
test,1187,140,107520,2656,382464,489984
test,1188,112,86016,1700,244800,330816
test,1189,61,46848,505,72720,119568
test,1190,127,97536,2186,314784,412320
test,1191,182,139776,4488,646272,786048
test,1192,149,114432,3008,433152,547584
test,1193,133,102144,2397,345168,447312
test,1194,160,122880,3469,499536,622416
test,1195,174,133632,4102,590688,724320
test,1196,159,122112,3426,493344,615456
test,1197,149,114432,3008,433152,547584
test,1198,110,84480,1640,236160,320640
test,1199,125,96000,2117,304848,400848
test,1200,165,126720,3689,531216,657936
test,1201,112,86016,1700,244800,330816
test,1202,56,43008,425,61200,104208
test,1203,139,106752,2618,376992,483744
test,1204,126,96768,2151,309744,406512
test,1205,115,88320,1792,258048,346368
test,1206,207,158976,5806,836064,995040
test,1207,142,109056,2732,393408,502464
test,1208,160,122880,3469,499536,622416
test,1209,195,149760,5152,741888,891648
test,1210,92,70656,1147,165168,235824
test,1211,100,76800,1355,195120,271920
test,1212,247,189696,7957,1145808,1335504
test,1213,39,29952,206,29664,59616
test,1214,208,159744,5862,844128,1003872
test,1215,169,129792,3870,557280,687072
test,1216,110,84480,1640,236160,320640
test,1217,114,87552,1761,253584,341136
test,1218,133,102144,2397,345168,447312
test,1219,177,135936,4245,611280,747216
test,1220,180,138240,4390,632160,770400
test,1221,185,142080,4637,667728,809808
test,1222,130,99840,2290,329760,429600
test,1223,81,62208,889,128016,190224
test,1224,191,146688,4943,711792,858480
test,1225,164,125952,3644,524736,650688
test,1226,180,138240,4390,632160,770400
test,1227,136,104448,2506,360864,465312
test,1228,184,141312,4587,660528,801840
test,1229,177,135936,4245,611280,747216
test,1230,243,186624,7809,1124496,1311120
test,1231,140,107520,2656,382464,489984
test,1232,56,43008,425,61200,104208
test,1233,152,116736,3131,450864,567600
test,1234,175,134400,4150,597600,732000
test,1235,29,22272,114,16416,38688
test,1236,92,70656,1147,165168,235824
test,1237,57,43776,441,63504,107280
test,1238,97,74496,1275,183600,258096
test,1239,157,120576,3340,480960,601536
test,1240,181,139008,4439,639216,778224
test,1241,170,130560,3916,563904,694464
test,1242,164,125952,3644,524736,650688
test,1243,156,119808,3298,474912,594720
test,1244,68,52224,627,90288,142512
test,1245,66,50688,591,85104,135792
test,1246,119,91392,1919,276336,367728
test,1247,141,108288,2694,387936,496224
test,1248,80,61440,867,124848,186288
test,1249,172,132096,4009,577296,709392
test,1250,146,112128,2888,415872,528000
test,1251,166,127488,3734,537696,665184
test,1252,112,86016,1700,244800,330816
test,1253,145,111360,2849,410256,521616
test,1254,153,117504,3172,456768,574272
test,1255,136,104448,2506,360864,465312
test,1256,161,123648,3512,505728,629376
test,1257,100,76800,1355,195120,271920
test,1258,143,109824,2771,399024,508848
test,1259,170,130560,3916,563904,694464
test,1260,63,48384,538,77472,125856
test,1261,116,89088,1823,262512,351600
test,1262,150,115200,3049,439056,554256
test,1263,187,143616,4738,682272,825888
test,1264,104,79872,1466,211104,290976
test,1265,121,92928,1984,285696,378624
test,1266,125,96000,2117,304848,400848
test,1267,141,108288,2694,387936,496224
test,1268,227,174336,6982,1005408,1179744
test,1269,166,127488,3734,537696,665184
test,1270,173,132864,4055,583920,716784
test,1271,110,84480,1640,236160,320640
test,1272,46,35328,287,41328,76656
test,1273,120,92160,1951,280944,373104
test,1274,134,102912,2433,350352,453264
test,1275,146,112128,2888,415872,528000
test,1276,171,131328,3962,570528,701856
test,1277,203,155904,5584,804096,960000
test,1278,170,130560,3916,563904,694464
test,1279,171,131328,3962,570528,701856
test,1280,115,88320,1792,258048,346368
test,1281,129,99072,2255,324720,423792
test,1282,193,148224,5047,726768,874992
test,1283,128,98304,2220,319680,417984
test,1284,148,113664,2968,427392,541056
test,1285,91,69888,1122,161568,231456
test,1286,220,168960,5658,814752,983712
test,1287,64,49152,555,79920,129072
test,1288,43,33024,251,36144,69168
test,1289,123,94464,2050,295200,389664
test,1290,148,113664,2968,427392,541056
test,1291,109,83712,1610,231840,315552
test,1292,89,68352,1074,154656,223008
test,1293,163,125184,3600,518400,643584
test,1294,50,38400,339,48816,87216
test,1295,117,89856,1855,267120,356976
test,1296,162,124416,3556,512064,636480
test,1297,210,161280,5689,819216,980496
test,1298,127,97536,2186,314784,412320
test,1299,133,102144,2397,345168,447312
test,1300,85,65280,979,140976,206256
test,1301,90,69120,1098,158112,227232
test,1302,122,93696,2017,290448,384144
test,1303,59,45312,472,67968,113280
test,1304,228,175104,7043,1014192,1189296
test,1305,139,106752,2618,376992,483744
test,1306,153,117504,3172,456768,574272
test,1307,43,33024,251,36144,69168
test,1308,170,130560,3916,563904,694464
test,1309,190,145920,4891,704304,850224
test,1310,69,52992,645,92880,145872
test,1311,141,108288,2694,387936,496224
test,1312,119,91392,1919,276336,367728
test,1313,116,89088,1823,262512,351600
test,1314,102,78336,1410,203040,281376
test,1315,150,115200,3049,439056,554256
test,1316,192,147456,4995,719280,866736
test,1317,163,125184,3600,518400,643584
test,1318,99,76032,1328,191232,267264
test,1319,45,34560,275,39600,74160
test,1320,64,49152,555,79920,129072
test,1321,162,124416,3556,512064,636480
test,1322,76,58368,783,112752,171120
test,1323,165,126720,3689,531216,657936
test,1324,120,92160,1951,280944,373104
test,1325,169,129792,3870,557280,687072
test,1326,123,94464,2050,295200,389664
test,1327,92,70656,1147,165168,235824
test,1328,221,169728,6618,952992,1122720
test,1329,94,72192,1198,172512,244704
test,1330,231,177408,6633,955152,1132560
test,1331,149,114432,3008,433152,547584
test,1332,115,88320,1792,258048,346368
test,1333,166,127488,3734,537696,665184
test,1334,210,161280,5975,860400,1021680
test,1335,123,94464,2050,295200,389664
test,1336,156,119808,3298,474912,594720
test,1337,104,79872,1466,211104,290976
test,1338,143,109824,2771,399024,508848
test,1339,158,121344,3383,487152,608496
test,1340,80,61440,867,124848,186288
test,1341,131,100608,2325,334800,435408
test,1342,130,99840,2290,329760,429600
test,1343,198,152064,5312,764928,916992
test,1344,132,101376,2361,339984,441360
test,1345,131,100608,2325,334800,435408
test,1346,147,112896,2928,421632,534528
test,1347,71,54528,683,98352,152880
test,1348,104,79872,1466,211104,290976
test,1349,76,58368,783,112752,171120
test,1350,177,135936,4245,611280,747216
test,1351,132,101376,2361,339984,441360
test,1352,79,60672,846,121824,182496
test,1353,97,74496,1275,183600,258096
test,1354,106,81408,1523,219312,300720
test,1355,208,159744,5602,806688,966432
test,1356,127,97536,2186,314784,412320
test,1357,57,43776,441,63504,107280
test,1358,133,102144,2397,345168,447312
test,1359,115,88320,1792,258048,346368
test,1360,134,102912,2433,350352,453264
test,1361,107,82176,1552,223488,305664
test,1362,129,99072,2255,324720,423792
test,1363,104,79872,1466,211104,290976
test,1364,233,178944,7356,1059264,1238208
test,1365,161,123648,3512,505728,629376
test,1366,152,116736,3131,450864,567600
test,1367,185,142080,4637,667728,809808
test,1368,118,90624,1887,271728,362352
test,1369,129,99072,2255,324720,423792
test,1370,124,95232,2084,300096,395328
test,1371,117,89856,1855,267120,356976
test,1372,122,93696,2017,290448,384144
test,1373,109,83712,1610,231840,315552
test,1374,170,130560,3916,563904,694464
test,1375,130,99840,2290,329760,429600
test,1376,36,27648,176,25344,52992
test,1377,224,172032,5992,862848,1034880
test,1378,134,102912,2433,350352,453264
test,1379,39,29952,206,29664,59616
test,1380,135,103680,2470,355680,459360
test,1381,80,61440,867,124848,186288
test,1382,136,104448,2506,360864,465312
test,1383,63,48384,538,77472,125856
test,1384,116,89088,1823,262512,351600
test,1385,110,84480,1640,236160,320640
test,1386,178,136704,4293,618192,754896
test,1387,99,76032,1328,191232,267264
test,1388,137,105216,2543,366192,471408
test,1389,106,81408,1523,219312,300720
test,1390,123,94464,2050,295200,389664
test,1391,211,162048,6032,868608,1030656
test,1392,147,112896,2928,421632,534528
test,1393,173,132864,4055,583920,716784
test,1394,58,44544,456,65664,110208
test,1395,187,143616,4738,682272,825888
test,1396,123,94464,2050,295200,389664
test,1397,163,125184,3272,471168,596352
test,1398,85,65280,979,140976,206256
test,1399,161,123648,3512,505728,629376
test,1400,124,95232,2084,300096,395328
test,1401,100,76800,1355,195120,271920
test,1402,103,79104,1438,207072,286176
test,1403,157,120576,3340,480960,601536
test,1404,35,26880,166,23904,50784
test,1405,117,89856,1855,267120,356976
test,1406,108,82944,1581,227664,310608
test,1407,188,144384,4789,689616,834000
test,1408,167,128256,3779,544176,672432
test,1409,85,65280,979,140976,206256
test,1410,179,137472,4341,625104,762576
test,1411,127,97536,2186,314784,412320
test,1412,144,110592,2810,404640,515232
test,1413,150,115200,3049,439056,554256
test,1414,128,98304,2220,319680,417984
test,1415,203,155904,5584,804096,960000
test,1416,119,91392,1919,276336,367728
test,1417,163,125184,3600,518400,643584
test,1418,256,196608,7502,1080288,1276896
test,1419,144,110592,2810,404640,515232
test,1420,154,118272,3214,462816,581088
test,1421,114,87552,1761,253584,341136
test,1422,124,95232,2084,300096,395328
test,1423,263,201984,7752,1116288,1318272
test,1424,92,70656,1147,165168,235824
test,1425,200,153600,5065,729360,882960
test,1426,155,119040,3255,468720,587760
test,1427,178,136704,4293,618192,754896
test,1428,155,119040,3255,468720,587760
test,1429,148,113664,2968,427392,541056
test,1430,186,142848,4688,675072,817920
test,1431,141,108288,2694,387936,496224
test,1432,122,93696,2017,290448,384144
test,1433,177,135936,4245,611280,747216
test,1434,69,52992,645,92880,145872
test,1435,158,121344,3383,487152,608496
test,1436,179,137472,4341,625104,762576
test,1437,158,121344,3383,487152,608496
test,1438,134,102912,2433,350352,453264
test,1439,47,36096,300,43200,79296
test,1440,142,109056,2732,393408,502464
test,1441,88,67584,1050,151200,218784
test,1442,141,108288,2694,387936,496224
test,1443,76,58368,783,112752,171120
test,1444,215,165120,6263,901872,1066992
test,1445,92,70656,1147,165168,235824
test,1446,80,61440,867,124848,186288
test,1447,166,127488,3734,537696,665184
test,1448,112,86016,1700,244800,330816
test,1449,97,74496,1275,183600,258096
test,1450,140,107520,2656,382464,489984
test,1451,81,62208,889,128016,190224
test,1452,114,87552,1761,253584,341136
test,1453,71,54528,683,98352,152880
test,1454,180,138240,4390,632160,770400
test,1455,208,159744,4862,700128,859872
test,1456,125,96000,2117,304848,400848
test,1457,124,95232,2084,300096,395328
test,1458,72,55296,703,101232,156528
test,1459,95,72960,1223,176112,249072
test,1460,178,136704,4293,618192,754896
test,1461,75,57600,762,109728,167328
test,1462,142,109056,2732,393408,502464
test,1463,160,122880,3469,499536,622416
test,1464,99,76032,1328,191232,267264
test,1465,150,115200,3049,439056,554256
test,1466,69,52992,645,92880,145872
test,1467,179,137472,4341,625104,762576
test,1468,198,152064,5312,764928,916992
test,1469,127,97536,2186,314784,412320
test,1470,145,111360,2849,410256,521616
test,1471,186,142848,4688,675072,817920
test,1472,144,110592,2810,404640,515232
test,1473,131,100608,2325,334800,435408
test,1474,164,125952,3644,524736,650688
test,1475,103,79104,1438,207072,286176
test,1476,80,61440,867,124848,186288
test,1477,127,97536,2186,314784,412320
test,1478,174,133632,4102,590688,724320
test,1479,126,96768,2151,309744,406512
test,1480,158,121344,3264,470016,591360
test,1481,128,98304,2220,319680,417984
test,1482,120,92160,1951,280944,373104
test,1483,197,151296,5258,757152,908448
test,1484,99,76032,1328,191232,267264
test,1485,87,66816,1026,147744,214560
test,1486,129,99072,2255,324720,423792
test,1487,178,136704,4293,618192,754896
test,1488,144,110592,2810,404640,515232
test,1489,131,100608,2325,334800,435408
test,1490,73,56064,722,103968,160032
test,1491,52,39936,367,52848,92784
test,1492,71,54528,683,98352,152880
test,1493,108,82944,1581,227664,310608
test,1494,149,114432,3008,433152,547584
test,1495,190,145920,4891,704304,850224
test,1496,236,181248,6575,946800,1128048
test,1497,147,112896,2929,421776,534672
test,1498,178,136704,4293,618192,754896
test,1499,196,150528,5205,749520,900048
test,1500,101,77568,1382,199008,276576
test,1501,173,132864,4055,583920,716784
test,1502,69,52992,645,92880,145872
test,1503,139,106752,2618,376992,483744
test,1504,140,107520,2656,382464,489984
test,1505,137,105216,2543,366192,471408
test,1506,74,56832,742,106848,163680
test,1507,151,115968,2823,406512,522480
test,1508,119,91392,1919,276336,367728
test,1509,161,123648,3512,505728,629376
test,1510,44,33792,263,37872,71664
test,1511,162,124416,3556,512064,636480
test,1512,62,47616,521,75024,122640
test,1513,85,65280,979,140976,206256
test,1514,96,73728,1249,179856,253584
test,1515,126,96768,2151,309744,406512
test,1516,148,113664,2968,427392,541056
test,1517,150,115200,3049,439056,554256
test,1518,70,53760,664,95616,149376
test,1519,111,85248,1670,240480,325728
test,1520,146,112128,2888,415872,528000
test,1521,126,96768,2151,309744,406512
test,1522,156,119808,3298,474912,594720
test,1523,163,125184,3600,518400,643584
test,1524,55,42240,410,59040,101280
test,1525,98,75264,1302,187488,262752
test,1526,151,115968,3090,444960,560928
test,1527,131,100608,2325,334800,435408
test,1528,164,125952,3644,524736,650688
test,1529,119,91392,1920,276480,367872
test,1530,190,145920,4891,704304,850224
test,1531,168,129024,3824,550656,679680
test,1532,145,111360,2849,410256,521616
test,1533,98,75264,1302,187488,262752
test,1534,123,94464,2050,295200,389664
test,1535,163,125184,3600,518400,643584
test,1536,101,77568,1382,199008,276576
test,1537,141,108288,2694,387936,496224
test,1538,186,142848,4688,675072,817920
test,1539,146,112128,2888,415872,528000
test,1540,187,143616,4738,682272,825888
test,1541,192,147456,4959,714096,861552
test,1542,144,110592,2810,404640,515232
test,1543,148,113664,2968,427392,541056
test,1544,109,83712,1610,231840,315552
test,1545,127,97536,2186,314784,412320
test,1546,172,132096,4009,577296,709392
test,1547,132,101376,2361,339984,441360
test,1548,83,63744,934,134496,198240
test,1549,141,108288,2694,387936,496224
test,1550,66,50688,591,85104,135792
test,1551,171,131328,3962,570528,701856
test,1552,114,87552,1761,253584,341136
test,1553,154,118272,3214,462816,581088
test,1554,103,79104,1438,207072,286176
test,1555,148,113664,2968,427392,541056
test,1556,198,152064,5312,764928,916992
test,1557,147,112896,2928,421632,534528
test,1558,196,150528,5205,749520,900048
test,1559,86,66048,1002,144288,210336
test,1560,201,154368,5474,788256,942624
test,1561,66,50688,591,85104,135792
test,1562,145,111360,2849,410256,521616
test,1563,176,135168,4197,604368,739536
test,1564,143,109824,2771,399024,508848
test,1565,140,107520,2656,382464,489984
test,1566,150,115200,3049,439056,554256
test,1567,133,102144,2397,345168,447312
test,1568,150,115200,3049,439056,554256
test,1569,70,53760,664,95616,149376
test,1570,101,77568,1382,199008,276576
test,1571,142,109056,2732,393408,502464
test,1572,133,102144,2397,345168,447312
test,1573,98,75264,1302,187488,262752
test,1574,126,96768,2151,309744,406512
test,1575,66,50688,591,85104,135792
test,1576,109,83712,1610,231840,315552
test,1577,150,115200,3049,439056,554256
test,1578,155,119040,3255,468720,587760
test,1579,152,116736,3131,450864,567600
test,1580,199,152832,5366,772704,925536
test,1581,98,75264,1302,187488,262752
test,1582,166,127488,3734,537696,665184
test,1583,201,154368,5280,760320,914688
test,1584,98,75264,1302,187488,262752
test,1585,113,86784,1730,249120,335904
test,1586,62,47616,521,75024,122640
test,1587,114,87552,1761,253584,341136
test,1588,115,88320,1792,258048,346368
test,1589,178,136704,4293,618192,754896
test,1590,110,84480,1640,236160,320640
test,1591,161,123648,3512,505728,629376
test,1592,92,70656,1147,165168,235824
test,1593,64,49152,555,79920,129072
test,1594,177,135936,4245,611280,747216
test,1595,195,149760,5152,741888,891648
test,1596,93,71424,1172,168768,240192
test,1597,194,148992,5100,734400,883392
test,1598,78,59904,825,118800,178704
test,1599,139,106752,2618,376992,483744
test,1600,142,109056,2732,393408,502464
test,1601,110,84480,1640,236160,320640
test,1602,150,115200,3049,439056,554256
test,1603,168,129024,3824,550656,679680
test,1604,122,93696,2017,290448,384144
test,1605,110,84480,1640,236160,320640
test,1606,183,140544,4538,653472,794016
test,1607,207,158976,5806,836064,995040
test,1608,208,159744,5862,844128,1003872
test,1609,142,109056,2732,393408,502464
test,1610,122,93696,2017,290448,384144
test,1611,104,79872,1466,211104,290976
test,1612,102,78336,1410,203040,281376
test,1613,85,65280,979,140976,206256
test,1614,169,129792,3870,557280,687072
test,1615,84,64512,956,137664,202176
test,1616,138,105984,2581,371664,477648
test,1617,107,82176,1552,223488,305664
test,1618,75,57600,762,109728,167328
test,1619,148,113664,2968,427392,541056
test,1620,156,119808,3298,474912,594720
test,1621,128,98304,2220,319680,417984
test,1622,136,104448,2506,360864,465312
test,1623,129,99072,2255,324720,423792
test,1624,94,72192,1198,172512,244704
test,1625,158,121344,3383,487152,608496
test,1626,81,62208,889,128016,190224
test,1627,150,115200,3049,439056,554256
test,1628,140,107520,2656,382464,489984
test,1629,190,145920,4891,704304,850224
test,1630,83,63744,934,134496,198240
test,1631,113,86784,1730,249120,335904
test,1632,183,140544,4538,653472,794016
test,1633,78,59904,825,118800,178704
test,1634,158,121344,3383,487152,608496
test,1635,154,118272,3214,462816,581088
test,1636,125,96000,2117,304848,400848
test,1637,127,97536,2186,314784,412320
test,1638,141,108288,2694,387936,496224
test,1639,122,93696,2017,290448,384144
test,1640,190,145920,4891,704304,850224
test,1641,188,144384,4789,689616,834000
test,1642,151,115968,3090,444960,560928
test,1643,83,63744,934,134496,198240
test,1644,171,131328,3962,570528,701856
test,1645,163,125184,3600,518400,643584
test,1646,124,95232,2084,300096,395328
test,1647,192,147456,4995,719280,866736
test,1648,127,97536,2186,314784,412320
test,1649,72,55296,703,101232,156528
test,1650,112,86016,1700,244800,330816
test,1651,93,71424,1172,168768,240192
test,1652,96,73728,1249,179856,253584
test,1653,144,110592,2810,404640,515232
test,1654,53,40704,381,54864,95568
test,1655,114,87552,1761,253584,341136
test,1656,67,51456,609,87696,139152
test,1657,121,92928,1984,285696,378624
test,1658,118,90624,1887,271728,362352
test,1659,39,29952,206,29664,59616
test,1660,255,195840,7789,1121616,1317456
test,1661,150,115200,3049,439056,554256
test,1662,120,92160,1951,280944,373104
test,1663,196,150528,5205,749520,900048
test,1664,84,64512,956,137664,202176
test,1665,83,63744,934,134496,198240
test,1666,252,193536,7981,1149264,1342800
test,1667,105,80640,1494,215136,295776
test,1668,148,113664,2968,427392,541056
test,1669,119,91392,1919,276336,367728
test,1670,160,122880,3469,499536,622416
test,1671,79,60672,846,121824,182496
test,1672,153,117504,3172,456768,574272
test,1673,99,76032,1328,191232,267264
test,1674,207,158976,5806,836064,995040
test,1675,128,98304,2220,319680,417984
test,1676,111,85248,1670,240480,325728
test,1677,144,110592,2810,404640,515232
test,1678,182,139776,4488,646272,786048
test,1679,145,111360,2849,410256,521616
test,1680,109,83712,1610,231840,315552
test,1681,62,47616,521,75024,122640
test,1682,96,73728,1249,179856,253584
test,1683,130,99840,2290,329760,429600
test,1684,88,67584,1050,151200,218784
test,1685,120,92160,1951,280944,373104
test,1686,144,110592,2810,404640,515232
test,1687,138,105984,2581,371664,477648
test,1688,144,110592,2810,404640,515232
test,1689,105,80640,1494,215136,295776
test,1690,100,76800,1355,195120,271920
test,1691,129,99072,2255,324720,423792
test,1692,125,96000,2117,304848,400848
test,1693,209,160512,5589,804816,965328
test,1694,137,105216,2543,366192,471408
test,1695,156,119808,3298,474912,594720
test,1696,93,71424,1172,168768,240192
test,1697,219,168192,6455,929520,1097712
test,1698,156,119808,3298,474912,594720
test,1699,75,57600,762,109728,167328
test,1700,162,124416,3556,512064,636480
test,1701,143,109824,2771,399024,508848
test,1702,214,164352,6205,893520,1057872
test,1703,147,112896,2928,421632,534528
test,1704,118,90624,1887,271728,362352
test,1705,92,70656,1147,165168,235824
test,1706,172,132096,4009,577296,709392
test,1707,146,112128,2888,415872,528000
test,1708,171,131328,3962,570528,701856
test,1709,204,156672,5639,812016,968688
test,1710,171,131328,3962,570528,701856
test,1711,124,95232,2084,300096,395328
test,1712,146,112128,2888,415872,528000
test,1713,150,115200,3049,439056,554256
test,1714,166,127488,3734,537696,665184
test,1715,91,69888,1122,161568,231456
test,1716,142,109056,2732,393408,502464
test,1717,140,107520,2656,382464,489984
test,1718,56,43008,425,61200,104208
test,1719,96,73728,1249,179856,253584
test,1720,108,82944,1581,227664,310608
test,1721,156,119808,3298,474912,594720
test,1722,147,112896,2928,421632,534528
test,1723,143,109824,2771,399024,508848
test,1724,187,143616,4629,666576,810192
test,1725,66,50688,591,85104,135792
test,1726,125,96000,2117,304848,400848
test,1727,117,89856,1855,267120,356976
test,1728,213,163584,6147,885168,1048752
test,1729,196,150528,5205,749520,900048
test,1730,129,99072,2255,324720,423792
test,1731,78,59904,825,118800,178704
test,1732,107,82176,1552,223488,305664
test,1733,121,92928,1984,285696,378624
test,1734,110,84480,1640,236160,320640
test,1735,97,74496,1275,183600,258096
test,1736,34,26112,157,22608,48720
test,1737,234,179712,6435,926640,1106352
test,1738,92,70656,1147,165168,235824
test,1739,126,96768,2151,309744,406512
test,1740,85,65280,979,140976,206256
test,1741,168,129024,3824,550656,679680
test,1742,170,130560,3916,563904,694464
test,1743,103,79104,1438,207072,286176
test,1744,168,129024,3824,550656,679680
test,1745,113,86784,1730,249120,335904
test,1746,130,99840,2290,329760,429600
test,1747,137,105216,2543,366192,471408
test,1748,148,113664,2968,427392,541056
test,1749,125,96000,2117,304848,400848
test,1750,139,106752,2618,376992,483744
test,1751,141,108288,2694,387936,496224
test,1752,131,100608,2325,334800,435408
test,1753,159,122112,3426,493344,615456
test,1754,62,47616,521,75024,122640
test,1755,97,74496,1275,183600,258096
test,1756,119,91392,1919,276336,367728
test,1757,96,73728,1249,179856,253584
test,1758,155,119040,3255,468720,587760
test,1759,85,65280,979,140976,206256
test,1760,133,102144,2397,345168,447312
test,1761,180,138240,4390,632160,770400
test,1762,109,83712,1610,231840,315552
test,1763,68,52224,627,90288,142512
test,1764,138,105984,2581,371664,477648
test,1765,111,85248,1670,240480,325728
test,1766,184,141312,4587,660528,801840
test,1767,124,95232,2084,300096,395328
test,1768,94,72192,1198,172512,244704
test,1769,80,61440,867,124848,186288
test,1770,104,79872,1466,211104,290976
test,1771,134,102912,2433,350352,453264
test,1772,93,71424,1172,168768,240192
test,1773,162,124416,3556,512064,636480
test,1774,59,45312,472,67968,113280
test,1775,244,187392,8067,1161648,1349040
test,1776,129,99072,2255,324720,423792
test,1777,184,141312,4587,660528,801840
test,1778,208,159744,5862,844128,1003872
test,1779,56,43008,425,61200,104208
test,1780,209,160512,5919,852336,1012848
test,1781,140,107520,2656,382464,489984
test,1782,97,74496,1275,183600,258096
test,1783,179,137472,4341,625104,762576
test,1784,155,119040,3255,468720,587760
test,1785,76,58368,783,112752,171120
test,1786,162,124416,3556,512064,636480
test,1787,144,110592,2810,404640,515232
test,1788,168,129024,3824,550656,679680
test,1789,149,114432,3008,433152,547584
test,1790,55,42240,410,59040,101280
test,1791,69,52992,645,92880,145872
test,1792,208,159744,5778,832032,991776
test,1793,164,125952,3644,524736,650688
test,1794,77,59136,804,115776,174912
test,1795,208,159744,5862,844128,1003872
test,1796,131,100608,2325,334800,435408
test,1797,82,62976,911,131184,194160
test,1798,45,34560,275,39600,74160
test,1799,177,135936,4245,611280,747216
test,1800,124,95232,2084,300096,395328
test,1801,123,94464,2050,295200,389664
test,1802,110,84480,1640,236160,320640
test,1803,203,155904,5584,804096,960000
test,1804,129,99072,2255,324720,423792
test,1805,148,113664,2968,427392,541056
test,1806,151,115968,3090,444960,560928
test,1807,176,135168,4197,604368,739536
test,1808,158,121344,3383,487152,608496
test,1809,56,43008,425,61200,104208
test,1810,169,129792,3870,557280,687072
test,1811,171,131328,3962,570528,701856
test,1812,165,126720,3689,531216,657936
test,1813,95,72960,1223,176112,249072
test,1814,106,81408,1523,219312,300720
test,1815,197,151296,5258,757152,908448
test,1816,108,82944,1581,227664,310608
test,1817,162,124416,3556,512064,636480
test,1818,200,153600,5420,780480,934080
test,1819,142,109056,2732,393408,502464
test,1820,86,66048,1002,144288,210336
test,1821,212,162816,5398,777312,940128
test,1822,108,82944,1581,227664,310608
test,1823,147,112896,2928,421632,534528
test,1824,119,91392,1919,276336,367728
test,1825,64,49152,555,79920,129072
test,1826,127,97536,2186,314784,412320
test,1827,73,56064,722,103968,160032
test,1828,122,93696,2017,290448,384144
test,1829,80,61440,867,124848,186288
test,1830,103,79104,1438,207072,286176
test,1831,221,169728,6618,952992,1122720
test,1832,160,122880,3469,499536,622416
test,1833,183,140544,4538,653472,794016
test,1834,71,54528,683,98352,152880
test,1835,126,96768,2151,309744,406512
test,1836,153,117504,3172,456768,574272
test,1837,98,75264,1302,187488,262752
test,1838,141,108288,2694,387936,496224
test,1839,189,145152,4840,696960,842112
test,1840,159,122112,3426,493344,615456
test,1841,131,100608,2325,334800,435408
test,1842,176,135168,4197,604368,739536
test,1843,203,155904,5584,804096,960000
test,1844,97,74496,1275,183600,258096
test,1845,117,89856,1855,267120,356976
test,1846,109,83712,1610,231840,315552
test,1847,157,120576,3340,480960,601536
test,1848,135,103680,2470,355680,459360
test,1849,168,129024,3824,550656,679680
test,1850,138,105984,2581,371664,477648
test,1851,188,144384,4464,642816,787200
test,1852,191,146688,4943,711792,858480
test,1853,59,45312,472,67968,113280
test,1854,143,109824,2771,399024,508848
test,1855,98,75264,1302,187488,262752
test,1856,147,112896,2928,421632,534528
test,1857,239,183552,6260,901440,1084992
test,1858,203,155904,5584,804096,960000
test,1859,162,124416,3556,512064,636480
test,1860,95,72960,1223,176112,249072
test,1861,152,116736,3131,450864,567600
test,1862,156,119808,3298,474912,594720
test,1863,163,125184,3600,518400,643584
test,1864,65,49920,573,82512,132432
test,1865,114,87552,1761,253584,341136
test,1866,144,110592,2810,404640,515232
test,1867,177,135936,4245,611280,747216
test,1868,183,140544,4538,653472,794016
test,1869,108,82944,1581,227664,310608
test,1870,184,141312,4587,660528,801840
test,1871,130,99840,2290,329760,429600
test,1872,96,73728,1249,179856,253584
test,1873,143,109824,2771,399024,508848
test,1874,150,115200,3049,439056,554256
test,1875,163,125184,3600,518400,643584
test,1876,91,69888,1122,161568,231456
test,1877,136,104448,2506,360864,465312
test,1878,129,99072,2255,324720,423792
test,1879,155,119040,3255,468720,587760
test,1880,95,72960,1223,176112,249072
test,1881,85,65280,979,140976,206256
test,1882,81,62208,889,128016,190224
test,1883,114,87552,1761,253584,341136
test,1884,120,92160,1951,280944,373104
test,1885,139,106752,2618,376992,483744
test,1886,230,176640,7168,1032192,1208832
test,1887,224,172032,6799,979056,1151088
test,1888,167,128256,3779,544176,672432
test,1889,150,115200,3049,439056,554256
test,1890,135,103680,2470,355680,459360
test,1891,95,72960,1223,176112,249072
test,1892,110,84480,1640,236160,320640
test,1893,216,165888,6322,910368,1076256
test,1894,141,108288,2694,387936,496224
test,1895,138,105984,2581,371664,477648
test,1896,104,79872,1466,211104,290976
test,1897,81,62208,889,128016,190224
test,1898,135,103680,2470,355680,459360
test,1899,185,142080,4637,667728,809808
test,1900,113,86784,1730,249120,335904
test,1901,190,145920,4891,704304,850224
test,1902,172,132096,4009,577296,709392
test,1903,199,152832,5366,772704,925536
test,1904,116,89088,1823,262512,351600
test,1905,74,56832,742,106848,163680
test,1906,140,107520,2656,382464,489984
test,1907,151,115968,3090,444960,560928
test,1908,161,123648,3512,505728,629376
test,1909,119,91392,1919,276336,367728
test,1910,180,138240,4390,632160,770400
test,1911,69,52992,645,92880,145872
test,1912,193,148224,4536,653184,801408
test,1913,122,93696,2017,290448,384144
test,1914,124,95232,2084,300096,395328
test,1915,147,112896,2928,421632,534528
test,1916,146,112128,2888,415872,528000
test,1917,141,108288,2694,387936,496224
test,1918,112,86016,1700,244800,330816
test,1919,270,207360,8366,1204704,1412064
test,1920,130,99840,2290,329760,429600
test,1921,144,110592,2810,404640,515232
test,1922,161,123648,3512,505728,629376
test,1923,184,141312,4587,660528,801840
test,1924,167,128256,3779,544176,672432
test,1925,161,123648,3512,505728,629376
test,1926,138,105984,2581,371664,477648
test,1927,142,109056,2732,393408,502464
test,1928,77,59136,804,115776,174912
test,1929,112,86016,1700,244800,330816
test,1930,68,52224,627,90288,142512
test,1931,63,48384,538,77472,125856
test,1932,144,110592,2810,404640,515232
test,1933,115,88320,1792,258048,346368
test,1934,59,45312,472,67968,113280
test,1935,189,145152,4840,696960,842112
test,1936,120,92160,1951,280944,373104
test,1937,108,82944,1581,227664,310608
test,1938,116,89088,1823,262512,351600
test,1939,187,143616,4738,682272,825888
test,1940,117,89856,1855,267120,356976
test,1941,151,115968,3090,444960,560928
test,1942,85,65280,979,140976,206256
test,1943,149,114432,3008,433152,547584
test,1944,141,108288,2694,387936,496224
test,1945,159,122112,3426,493344,615456
test,1946,132,101376,2361,339984,441360
test,1947,204,156672,5639,812016,968688
test,1948,145,111360,2849,410256,521616
test,1949,93,71424,1172,168768,240192
test,1950,202,155136,5529,796176,951312
test,1951,81,62208,889,128016,190224
test,1952,145,111360,2849,410256,521616
test,1953,100,76800,1355,195120,271920
test,1954,118,90624,1887,271728,362352
test,1955,183,140544,4538,653472,794016
test,1956,181,139008,4439,639216,778224
test,1957,113,86784,1730,249120,335904
test,1958,227,174336,5777,831888,1006224
test,1959,135,103680,2470,355680,459360
test,1960,117,89856,1855,267120,356976
test,1961,140,107520,2656,382464,489984
test,1962,69,52992,645,92880,145872
test,1963,83,63744,934,134496,198240
test,1964,151,115968,3090,444960,560928
test,1965,258,198144,7710,1110240,1308384
test,1966,122,93696,2017,290448,384144
test,1967,117,89856,1855,267120,356976
test,1968,136,104448,2506,360864,465312
test,1969,127,97536,2186,314784,412320
test,1970,108,82944,1581,227664,310608
test,1971,82,62976,911,131184,194160
test,1972,129,99072,2255,324720,423792
test,1973,130,99840,2290,329760,429600
test,1974,78,59904,825,118800,178704
test,1975,96,73728,1249,179856,253584
test,1976,71,54528,683,98352,152880
test,1977,55,42240,410,59040,101280
test,1978,151,115968,3090,444960,560928
test,1979,43,33024,251,36144,69168
test,1980,140,107520,2656,382464,489984
test,1981,79,60672,846,121824,182496
test,1982,83,63744,934,134496,198240
test,1983,72,55296,703,101232,156528
test,1984,157,120576,3340,480960,601536
test,1985,154,118272,3214,462816,581088
test,1986,119,91392,1919,276336,367728
test,1987,253,194304,8169,1176336,1370640
test,1988,188,144384,4789,689616,834000
test,1989,60,46080,488,70272,116352
test,1990,141,108288,2694,387936,496224
test,1991,179,137472,4341,625104,762576
test,1992,118,90624,1887,271728,362352
test,1993,111,85248,1670,240480,325728
test,1994,127,97536,2186,314784,412320
test,1995,112,86016,1700,244800,330816
test,1996,158,121344,3383,487152,608496
test,1997,114,87552,1761,253584,341136
test,1998,164,125952,3644,524736,650688
test,1999,131,100608,2325,334800,435408
test,2000,149,114432,3008,433152,547584
test,2001,145,111360,2849,410256,521616
test,2002,147,112896,2928,421632,534528
test,2003,127,97536,2186,314784,412320
test,2004,94,72192,1198,172512,244704
test,2005,157,120576,3340,480960,601536
test,2006,118,90624,1887,271728,362352
test,2007,54,41472,395,56880,98352
test,2008,80,61440,867,124848,186288
test,2009,127,97536,2186,314784,412320
test,2010,132,101376,2361,339984,441360
test,2011,94,72192,1198,172512,244704
test,2012,123,94464,2050,295200,389664
test,2013,126,96768,2151,309744,406512
test,2014,174,133632,4102,590688,724320
test,2015,112,86016,1700,244800,330816
test,2016,130,99840,2290,329760,429600
test,2017,211,162048,6032,868608,1030656
test,2018,62,47616,521,75024,122640
test,2019,143,109824,2771,399024,508848
test,2020,136,104448,2506,360864,465312
test,2021,133,102144,2397,345168,447312
test,2022,84,64512,956,137664,202176
test,2023,181,139008,4439,639216,778224
test,2024,86,66048,1002,144288,210336
test,2025,100,76800,1355,195120,271920
test,2026,108,82944,1581,227664,310608
test,2027,158,121344,3383,487152,608496
test,2028,120,92160,1951,280944,373104
test,2029,112,86016,1700,244800,330816
test,2030,105,80640,1494,215136,295776
test,2031,145,111360,2849,410256,521616
test,2032,126,96768,2151,309744,406512
test,2033,94,72192,1198,172512,244704
test,2034,96,73728,1249,179856,253584
test,2035,157,120576,3340,480960,601536
test,2036,54,41472,395,56880,98352
test,2037,161,123648,3512,505728,629376
test,2038,162,124416,3556,512064,636480
test,2039,158,121344,3383,487152,608496
test,2040,82,62976,911,131184,194160
test,2041,147,112896,2928,421632,534528
test,2042,125,96000,2117,304848,400848
test,2043,74,56832,742,106848,163680
test,2044,179,137472,4341,625104,762576
test,2045,177,135936,4020,578880,714816
test,2046,120,92160,1951,280944,373104
test,2047,130,99840,2290,329760,429600
test,2048,111,85248,1670,240480,325728
test,2049,96,73728,1249,179856,253584
test,2050,168,129024,3824,550656,679680
test,2051,104,79872,1466,211104,290976
test,2052,162,124416,3556,512064,636480
test,2053,139,106752,2618,376992,483744
test,2054,143,109824,2771,399024,508848
test,2055,97,74496,1275,183600,258096
test,2056,127,97536,2186,314784,412320
test,2057,116,89088,1823,262512,351600
test,2058,150,115200,3049,439056,554256
test,2059,107,82176,1552,223488,305664
test,2060,178,136704,4293,618192,754896
test,2061,150,115200,3049,439056,554256
test,2062,124,95232,2084,300096,395328
test,2063,117,89856,1855,267120,356976
test,2064,189,145152,4805,691920,837072
test,2065,129,99072,2255,324720,423792
test,2066,110,84480,1640,236160,320640
test,2067,123,94464,2050,295200,389664
test,2068,224,172032,6799,979056,1151088
test,2069,143,109824,2771,399024,508848
test,2070,174,133632,4102,590688,724320
test,2071,112,86016,1700,244800,330816
test,2072,76,58368,783,112752,171120
test,2073,106,81408,1523,219312,300720
test,2074,108,82944,1581,227664,310608
test,2075,132,101376,2361,339984,441360
test,2076,159,122112,3426,493344,615456
test,2077,53,40704,381,54864,95568
test,2078,104,79872,1466,211104,290976
test,2079,97,74496,1275,183600,258096
test,2080,117,89856,1855,267120,356976
test,2081,109,83712,1610,231840,315552
test,2082,122,93696,2017,290448,384144
test,2083,71,54528,683,98352,152880
test,2084,163,125184,3600,518400,643584
test,2085,111,85248,1670,240480,325728
test,2086,112,86016,1700,244800,330816
test,2087,150,115200,3049,439056,554256
test,2088,94,72192,1198,172512,244704
test,2089,186,142848,4688,675072,817920
test,2090,56,43008,425,61200,104208
test,2091,142,109056,2732,393408,502464
test,2092,104,79872,1466,211104,290976
test,2093,89,68352,1074,154656,223008
test,2094,91,69888,1122,161568,231456
test,2095,132,101376,2361,339984,441360
test,2096,196,150528,5205,749520,900048
test,2097,188,144384,4789,689616,834000
test,2098,181,139008,4439,639216,778224
test,2099,132,101376,2361,339984,441360
test,2100,89,68352,1074,154656,223008
test,2101,231,177408,7230,1041120,1218528
test,2102,163,125184,3600,518400,643584
test,2103,192,147456,4995,719280,866736
test,2104,165,126720,3689,531216,657936
test,2105,54,41472,395,56880,98352
test,2106,130,99840,2290,329760,429600
test,2107,165,126720,3689,531216,657936
test,2108,237,182016,7134,1027296,1209312
test,2109,154,118272,3214,462816,581088
test,2110,177,135936,4245,611280,747216
test,2111,142,109056,2732,393408,502464
test,2112,138,105984,2581,371664,477648
test,2113,106,81408,1523,219312,300720
test,2114,212,162816,6090,876960,1039776
test,2115,214,164352,6205,893520,1057872
test,2116,51,39168,353,50832,90000
test,2117,131,100608,2325,334800,435408
test,2118,104,79872,1466,211104,290976
test,2119,116,89088,1823,262512,351600
test,2120,62,47616,521,75024,122640
test,2121,216,165888,5755,828720,994608
test,2122,135,103680,2470,355680,459360
test,2123,100,76800,1355,195120,271920
test,2124,112,86016,1700,244800,330816
test,2125,158,121344,3383,487152,608496
test,2126,161,123648,3512,505728,629376
test,2127,57,43776,441,63504,107280
test,2128,135,103680,2470,355680,459360
test,2129,130,99840,2290,329760,429600
test,2130,160,122880,3469,499536,622416
test,2131,151,115968,3090,444960,560928
test,2132,163,125184,3600,518400,643584
test,2133,74,56832,742,106848,163680
test,2134,177,135936,4245,611280,747216
test,2135,109,83712,1610,231840,315552
test,2136,86,66048,1002,144288,210336
test,2137,150,115200,3049,439056,554256
test,2138,85,65280,979,140976,206256
test,2139,181,139008,4439,639216,778224
test,2140,111,85248,1670,240480,325728
test,2141,139,106752,2618,376992,483744
test,2142,119,91392,1919,276336,367728
test,2143,214,164352,6205,893520,1057872
test,2144,209,160512,5919,852336,1012848
test,2145,178,136704,4293,618192,754896
test,2146,97,74496,1275,183600,258096
test,2147,172,132096,4009,577296,709392
test,2148,153,117504,3172,456768,574272
test,2149,132,101376,2361,339984,441360
test,2150,120,92160,1951,280944,373104
test,2151,185,142080,4637,667728,809808
test,2152,119,91392,1919,276336,367728
test,2153,127,97536,2186,314784,412320
test,2154,98,75264,1302,187488,262752
test,2155,214,164352,6205,893520,1057872
test,2156,154,118272,3214,462816,581088
test,2157,216,165888,6233,897552,1063440
test,2158,61,46848,505,72720,119568
test,2159,127,97536,2186,314784,412320
test,2160,115,88320,1792,258048,346368
test,2161,167,128256,3779,544176,672432
test,2162,192,147456,4995,719280,866736
test,2163,168,129024,3824,550656,679680
test,2164,131,100608,2325,334800,435408
test,2165,104,79872,1466,211104,290976
test,2166,189,145152,4840,696960,842112
test,2167,159,122112,3426,493344,615456
test,2168,193,148224,4900,705600,853824
test,2169,143,109824,2771,399024,508848
test,2170,136,104448,2506,360864,465312
test,2171,145,111360,2849,410256,521616
test,2172,138,105984,2581,371664,477648
test,2173,147,112896,2928,421632,534528
test,2174,129,99072,2255,324720,423792
test,2175,216,165888,5813,837072,1002960
test,2176,144,110592,2810,404640,515232
test,2177,68,52224,627,90288,142512
test,2178,188,144384,4789,689616,834000
test,2179,164,125952,3644,524736,650688
test,2180,80,61440,867,124848,186288
test,2181,148,113664,2968,427392,541056
test,2182,122,93696,2017,290448,384144
test,2183,184,141312,4587,660528,801840
test,2184,176,135168,4197,604368,739536
test,2185,162,124416,3556,512064,636480
test,2186,256,196608,7161,1031184,1227792
test,2187,118,90624,1887,271728,362352
test,2188,169,129792,3870,557280,687072
test,2189,124,95232,2084,300096,395328
test,2190,113,86784,1730,249120,335904
test,2191,80,61440,867,124848,186288
test,2192,95,72960,1223,176112,249072
test,2193,134,102912,2433,350352,453264
test,2194,86,66048,1002,144288,210336
test,2195,155,119040,3255,468720,587760
test,2196,126,96768,2151,309744,406512
test,2197,110,84480,1640,236160,320640
test,2198,226,173568,6920,996480,1170048
test,2199,98,75264,1302,187488,262752
test,2200,107,82176,1552,223488,305664
test,2201,104,79872,1466,211104,290976
test,2202,69,52992,645,92880,145872
test,2203,54,41472,395,56880,98352
test,2204,124,95232,2084,300096,395328
test,2205,159,122112,3426,493344,615456
test,2206,111,85248,1670,240480,325728
test,2207,89,68352,1074,154656,223008
test,2208,191,146688,4943,711792,858480
test,2209,103,79104,1438,207072,286176
test,2210,139,106752,2618,376992,483744
test,2211,141,108288,2694,387936,496224
test,2212,141,108288,2694,387936,496224
test,2213,123,94464,2050,295200,389664
test,2214,99,76032,1328,191232,267264
test,2215,60,46080,488,70272,116352
test,2216,107,82176,1552,223488,305664
test,2217,64,49152,555,79920,129072
test,2218,145,111360,2849,410256,521616
test,2219,175,134400,4150,597600,732000
test,2220,179,137472,4341,625104,762576
test,2221,196,150528,5205,749520,900048
test,2222,139,106752,2618,376992,483744
test,2223,114,87552,1761,253584,341136
test,2224,150,115200,3049,439056,554256
test,2225,29,22272,114,16416,38688
test,2226,124,95232,2084,300096,395328
test,2227,224,172032,5807,836208,1008240
test,2228,111,85248,1670,240480,325728
test,2229,141,108288,2694,387936,496224
test,2230,153,117504,3172,456768,574272
test,2231,59,45312,472,67968,113280
test,2232,114,87552,1761,253584,341136
test,2233,145,111360,2849,410256,521616
test,2234,157,120576,3340,480960,601536
test,2235,110,84480,1640,236160,320640
test,2236,139,106752,2618,376992,483744
test,2237,194,148992,5100,734400,883392
test,2238,147,112896,2928,421632,534528
test,2239,128,98304,2220,319680,417984
test,2240,72,55296,703,101232,156528
test,2241,107,82176,1552,223488,305664
test,2242,149,114432,3008,433152,547584
test,2243,147,112896,2928,421632,534528
test,2244,83,63744,934,134496,198240
test,2245,89,68352,1074,154656,223008
test,2246,175,134400,4150,597600,732000
test,2247,186,142848,4688,675072,817920
test,2248,164,125952,3644,524736,650688
test,2249,136,104448,2506,360864,465312
test,2250,175,134400,4150,597600,732000
test,2251,60,46080,488,70272,116352
test,2252,152,116736,3131,450864,567600
test,2253,146,112128,2888,415872,528000
test,2254,85,65280,979,140976,206256
test,2255,188,144384,4789,689616,834000
test,2256,117,89856,1855,267120,356976
test,2257,100,76800,1355,195120,271920
test,2258,179,137472,4341,625104,762576
test,2259,65,49920,573,82512,132432
test,2260,154,118272,3214,462816,581088
test,2261,110,84480,1640,236160,320640
test,2262,134,102912,2433,350352,453264
test,2263,208,159744,5862,844128,1003872
test,2264,150,115200,3049,439056,554256
test,2265,70,53760,664,95616,149376
test,2266,208,159744,5615,808560,968304
test,2267,100,76800,1355,195120,271920
test,2268,149,114432,3008,433152,547584
test,2269,87,66816,1026,147744,214560
test,2270,217,166656,6380,918720,1085376
test,2271,136,104448,2506,360864,465312
test,2272,163,125184,3600,518400,643584
test,2273,109,83712,1610,231840,315552
test,2274,155,119040,3255,468720,587760
test,2275,134,102912,2433,350352,453264
test,2276,229,175872,6860,987840,1163712
test,2277,171,131328,3962,570528,701856
test,2278,160,122880,3469,499536,622416
test,2279,85,65280,979,140976,206256
test,2280,216,165888,5111,735984,901872
test,2281,141,108288,2694,387936,496224
test,2282,206,158208,5593,805392,963600
test,2283,165,126720,3689,531216,657936
test,2284,134,102912,2433,350352,453264
test,2285,128,98304,2220,319680,417984
test,2286,97,74496,1275,183600,258096
test,2287,178,136704,4293,618192,754896
test,2288,113,86784,1730,249120,335904
test,2289,83,63744,934,134496,198240
test,2290,158,121344,3383,487152,608496
test,2291,139,106752,2618,376992,483744
test,2292,131,100608,2325,334800,435408
test,2293,178,136704,4293,618192,754896
test,2294,175,134400,4150,597600,732000
test,2295,116,89088,1823,262512,351600
test,2296,142,109056,2732,393408,502464
test,2297,134,102912,2433,350352,453264
test,2298,143,109824,2771,399024,508848
test,2299,142,109056,2732,393408,502464
test,2300,147,112896,2928,421632,534528
test,2301,62,47616,521,75024,122640
test,2302,184,141312,4587,660528,801840
test,2303,69,52992,645,92880,145872
test,2304,166,127488,3734,537696,665184
test,2305,138,105984,2581,371664,477648
test,2306,192,147456,4995,719280,866736
test,2307,96,73728,1249,179856,253584
test,2308,68,52224,627,90288,142512
test,2309,180,138240,4390,632160,770400
test,2310,273,209664,8053,1159632,1369296
test,2311,191,146688,4943,711792,858480
test,2312,142,109056,2732,393408,502464
test,2313,169,129792,3870,557280,687072
test,2314,99,76032,1328,191232,267264
test,2315,160,122880,3469,499536,622416
test,2316,119,91392,1919,276336,367728
test,2317,139,106752,2618,376992,483744
test,2318,186,142848,4688,675072,817920
test,2319,81,62208,889,128016,190224
test,2320,170,130560,3916,563904,694464
test,2321,189,145152,4840,696960,842112
test,2322,119,91392,1919,276336,367728
test,2323,177,135936,4245,611280,747216
test,2324,59,45312,472,67968,113280
test,2325,179,137472,4341,625104,762576
test,2326,134,102912,2433,350352,453264
test,2327,101,77568,1382,199008,276576
test,2328,149,114432,3008,433152,547584
test,2329,125,96000,2117,304848,400848
test,2330,139,106752,2618,376992,483744
test,2331,137,105216,2543,366192,471408
test,2332,85,65280,979,140976,206256
test,2333,169,129792,3870,557280,687072
test,2334,139,106752,2618,376992,483744
test,2335,90,69120,1098,158112,227232
test,2336,151,115968,3090,444960,560928
test,2337,80,61440,867,124848,186288
test,2338,187,143616,4738,682272,825888
test,2339,127,97536,2186,314784,412320
test,2340,70,53760,664,95616,149376
test,2341,171,131328,3962,570528,701856
test,2342,117,89856,1855,267120,356976
test,2343,103,79104,1438,207072,286176
test,2344,101,77568,1382,199008,276576
test,2345,139,106752,2618,376992,483744
test,2346,127,97536,2186,314784,412320
test,2347,168,129024,3824,550656,679680
test,2348,112,86016,1700,244800,330816
test,2349,112,86016,1700,244800,330816
test,2350,188,144384,4789,689616,834000
test,2351,105,80640,1494,215136,295776
test,2352,138,105984,2581,371664,477648
test,2353,146,112128,2888,415872,528000
test,2354,122,93696,2017,290448,384144
test,2355,140,107520,2656,382464,489984
test,2356,138,105984,2581,371664,477648
test,2357,190,145920,4891,704304,850224
test,2358,90,69120,1098,158112,227232
test,2359,97,74496,1275,183600,258096
test,2360,181,139008,4439,639216,778224
test,2361,163,125184,3600,518400,643584
test,2362,156,119808,3298,474912,594720
test,2363,257,197376,7915,1139760,1337136
test,2364,128,98304,2220,319680,417984
test,2365,90,69120,1098,158112,227232
test,2366,164,125952,3644,524736,650688
test,2367,149,114432,3008,433152,547584
test,2368,204,156672,5639,812016,968688
test,2369,117,89856,1855,267120,356976
test,2370,130,99840,2290,329760,429600
test,2371,52,39936,367,52848,92784
test,2372,143,109824,2771,399024,508848
test,2373,53,40704,381,54864,95568
test,2374,97,74496,1275,183600,258096
test,2375,106,81408,1523,219312,300720
test,2376,147,112896,2928,421632,534528
test,2377,66,50688,591,85104,135792
test,2378,197,151296,5258,757152,908448
test,2379,99,76032,1328,191232,267264
test,2380,131,100608,2325,334800,435408
test,2381,128,98304,2220,319680,417984
test,2382,211,162048,6032,868608,1030656
test,2383,156,119808,3298,474912,594720
test,2384,136,104448,2506,360864,465312
test,2385,81,62208,889,128016,190224
test,2386,131,100608,2325,334800,435408
test,2387,162,124416,3556,512064,636480
test,2388,161,123648,3512,505728,629376
test,2389,122,93696,2017,290448,384144
test,2390,220,168960,6033,868752,1037712
test,2391,182,139776,4338,624672,764448
test,2392,120,92160,1951,280944,373104
test,2393,99,76032,1328,191232,267264
test,2394,107,82176,1552,223488,305664
test,2395,142,109056,2732,393408,502464
test,2396,108,82944,1581,227664,310608
test,2397,223,171264,6512,937728,1108992
test,2398,165,126720,3689,531216,657936
test,2399,180,138240,4390,632160,770400
test,2400,131,100608,2325,334800,435408
test,2401,163,125184,3600,518400,643584
test,2402,178,136704,4293,618192,754896
test,2403,167,128256,3779,544176,672432
test,2404,123,94464,2050,295200,389664
test,2405,161,123648,3512,505728,629376
test,2406,103,79104,1438,207072,286176
test,2407,143,109824,2771,399024,508848
test,2408,217,166656,6380,918720,1085376
test,2409,179,137472,4341,625104,762576
test,2410,128,98304,2220,319680,417984
test,2411,109,83712,1610,231840,315552
test,2412,155,119040,3255,468720,587760
test,2413,191,146688,4943,711792,858480
test,2414,194,148992,5100,734400,883392
test,2415,220,168960,6558,944352,1113312
test,2416,123,94464,2050,295200,389664
test,2417,191,146688,4943,711792,858480
test,2418,241,185088,7060,1016640,1201728
test,2419,140,107520,2656,382464,489984
test,2420,137,105216,2543,366192,471408
test,2421,97,74496,1275,183600,258096
test,2422,165,126720,3689,531216,657936
test,2423,89,68352,1074,154656,223008
test,2424,132,101376,2361,339984,441360
test,2425,149,114432,3008,433152,547584
test,2426,166,127488,3734,537696,665184
test,2427,183,140544,4538,653472,794016
test,2428,159,122112,3426,493344,615456
test,2429,196,150528,5205,749520,900048
test,2430,289,221952,10173,1464912,1686864
test,2431,152,116736,3131,450864,567600
test,2432,259,198912,7852,1130688,1329600
test,2433,124,95232,2084,300096,395328
test,2434,105,80640,1494,215136,295776
test,2435,189,145152,4840,696960,842112
test,2436,117,89856,1855,267120,356976
test,2437,78,59904,825,118800,178704
test,2438,165,126720,3689,531216,657936
test,2439,72,55296,703,101232,156528
test,2440,187,143616,4738,682272,825888
test,2441,189,145152,4840,696960,842112
test,2442,177,135936,4245,611280,747216
test,2443,181,139008,4439,639216,778224
test,2444,120,92160,1951,280944,373104
test,2445,64,49152,555,79920,129072
test,2446,164,125952,3644,524736,650688
test,2447,235,180480,7483,1077552,1258032
test,2448,141,108288,2694,387936,496224
test,2449,116,89088,1824,262656,351744
test,2450,89,68352,1074,154656,223008
test,2451,203,155904,5584,804096,960000
test,2452,85,65280,979,140976,206256
test,2453,58,44544,456,65664,110208
test,2454,161,123648,3512,505728,629376
test,2455,124,95232,2084,300096,395328
test,2456,118,90624,1887,271728,362352
test,2457,81,62208,889,128016,190224
test,2458,157,120576,3340,480960,601536
test,2459,183,140544,4538,653472,794016
test,2460,117,89856,1855,267120,356976
test,2461,161,123648,3512,505728,629376
test,2462,177,135936,4245,611280,747216
test,2463,172,132096,4009,577296,709392
test,2464,185,142080,4370,629280,771360
test,2465,150,115200,3049,439056,554256
test,2466,135,103680,2470,355680,459360
test,2467,154,118272,3214,462816,581088
test,2468,52,39936,367,52848,92784
test,2469,260,199680,7359,1059696,1259376
test,2470,166,127488,3734,537696,665184
test,2471,130,99840,2290,329760,429600
test,2472,71,54528,683,98352,152880
test,2473,89,68352,1074,154656,223008
test,2474,124,95232,2084,300096,395328
test,2475,161,123648,3512,505728,629376
test,2476,142,109056,2732,393408,502464
test,2477,91,69888,1122,161568,231456
test,2478,126,96768,2151,309744,406512
test,2479,89,68352,1074,154656,223008
test,2480,128,98304,2220,319680,417984
test,2481,79,60672,846,121824,182496
test,2482,108,82944,1581,227664,310608
test,2483,113,86784,1730,249120,335904
test,2484,160,122880,3469,499536,622416
test,2485,139,106752,2618,376992,483744
test,2486,161,123648,3512,505728,629376
test,2487,170,130560,3916,563904,694464
test,2488,154,118272,3214,462816,581088
test,2489,98,75264,1302,187488,262752
test,2490,116,89088,1823,262512,351600
test,2491,178,136704,4293,618192,754896
test,2492,56,43008,425,61200,104208
test,2493,128,98304,2220,319680,417984
test,2494,165,126720,3689,531216,657936
test,2495,186,142848,4449,640656,783504
test,2496,204,156672,5639,812016,968688
test,2497,169,129792,3870,557280,687072
test,2498,110,84480,1640,236160,320640
test,2499,152,116736,3131,450864,567600
test,2500,105,80640,1494,215136,295776
test,2501,58,44544,456,65664,110208
test,2502,137,105216,2543,366192,471408
test,2503,160,122880,3469,499536,622416
test,2504,85,65280,979,140976,206256
test,2505,119,91392,1919,276336,367728
test,2506,85,65280,979,140976,206256
test,2507,138,105984,2581,371664,477648
test,2508,174,133632,4102,590688,724320
test,2509,41,31488,228,32832,64320
test,2510,129,99072,2255,324720,423792
test,2511,178,136704,4293,618192,754896
test,2512,162,124416,3556,512064,636480
test,2513,179,137472,4341,625104,762576
test,2514,89,68352,1074,154656,223008
test,2515,193,148224,5047,726768,874992
test,2516,59,45312,472,67968,113280
test,2517,180,138240,4390,632160,770400
test,2518,137,105216,2543,366192,471408
test,2519,72,55296,703,101232,156528
test,2520,93,71424,1172,168768,240192
test,2521,196,150528,5205,749520,900048
test,2522,100,76800,1355,195120,271920
test,2523,134,102912,2433,350352,453264
test,2524,191,146688,4943,711792,858480
test,2525,149,114432,3008,433152,547584
test,2526,143,109824,2771,399024,508848
test,2527,92,70656,1147,165168,235824
test,2528,236,181248,5862,844128,1025376
test,2529,70,53760,664,95616,149376
test,2530,134,102912,2433,350352,453264
test,2531,48,36864,313,45072,81936
test,2532,126,96768,2151,309744,406512
test,2533,123,94464,2050,295200,389664
test,2534,128,98304,2220,319680,417984
test,2535,150,115200,3049,439056,554256
test,2536,77,59136,804,115776,174912
test,2537,125,96000,2117,304848,400848
test,2538,186,142848,4688,675072,817920
test,2539,98,75264,1302,187488,262752
test,2540,98,75264,1302,187488,262752
test,2541,167,128256,3779,544176,672432
test,2542,194,148992,5100,734400,883392
test,2543,159,122112,3426,493344,615456
test,2544,148,113664,2968,427392,541056
test,2545,208,159744,5862,844128,1003872
test,2546,153,117504,3172,456768,574272
test,2547,78,59904,825,118800,178704
test,2548,110,84480,1640,236160,320640
test,2549,160,122880,3469,499536,622416
test,2550,178,136704,4293,618192,754896
test,2551,74,56832,742,106848,163680
test,2552,129,99072,2255,324720,423792
test,2553,124,95232,2084,300096,395328
test,2554,88,67584,1050,151200,218784
test,2555,178,136704,4293,618192,754896
test,2556,142,109056,2732,393408,502464
test,2557,169,129792,3870,557280,687072
test,2558,106,81408,1523,219312,300720
test,2559,103,79104,1438,207072,286176
test,2560,141,108288,2694,387936,496224
test,2561,124,95232,2084,300096,395328
test,2562,147,112896,2928,421632,534528
test,2563,111,85248,1670,240480,325728
test,2564,83,63744,934,134496,198240
test,2565,100,76800,1355,195120,271920
test,2566,119,91392,1919,276336,367728
test,2567,149,114432,3008,433152,547584
test,2568,126,96768,2151,309744,406512
test,2569,136,104448,2506,360864,465312
test,2570,136,104448,2506,360864,465312
test,2571,98,75264,1302,187488,262752
test,2572,50,38400,339,48816,87216
test,2573,186,142848,4688,675072,817920
test,2574,185,142080,4637,667728,809808
test,2575,75,57600,762,109728,167328
test,2576,164,125952,3644,524736,650688
test,2577,45,34560,275,39600,74160
test,2578,116,89088,1823,262512,351600
test,2579,103,79104,1438,207072,286176
test,2580,169,129792,3870,557280,687072
test,2581,114,87552,1761,253584,341136
test,2582,122,93696,2017,290448,384144
test,2583,98,75264,1302,187488,262752
test,2584,126,96768,2151,309744,406512
test,2585,244,187392,7227,1040688,1228080
test,2586,112,86016,1700,244800,330816
test,2587,117,89856,1855,267120,356976
test,2588,100,76800,1355,195120,271920
test,2589,235,180480,7483,1077552,1258032
test,2590,144,110592,2810,404640,515232
test,2591,95,72960,1223,176112,249072
test,2592,190,145920,4891,704304,850224
test,2593,192,147456,4995,719280,866736
test,2594,152,116736,3131,450864,567600
test,2595,109,83712,1610,231840,315552
test,2596,154,118272,3214,462816,581088
test,2597,57,43776,441,63504,107280
test,2598,145,111360,2849,410256,521616
test,2599,136,104448,2506,360864,465312
test,2600,154,118272,3214,462816,581088
test,2601,167,128256,3779,544176,672432
test,2602,76,58368,783,112752,171120
test,2603,56,43008,425,61200,104208
test,2604,185,142080,4637,667728,809808
test,2605,37,28416,186,26784,55200
test,2606,134,102912,2433,350352,453264
test,2607,91,69888,1122,161568,231456
test,2608,248,190464,7648,1101312,1291776
test,2609,175,134400,4150,597600,732000
test,2610,72,55296,703,101232,156528
test,2611,153,117504,3172,456768,574272
test,2612,136,104448,2506,360864,465312
test,2613,91,69888,1122,161568,231456
test,2614,185,142080,4637,667728,809808
test,2615,122,93696,2017,290448,384144
test,2616,109,83712,1610,231840,315552
test,2617,187,143616,4738,682272,825888
test,2618,148,113664,2968,427392,541056
test,2619,191,146688,4943,711792,858480
test,2620,50,38400,339,48816,87216
test,2621,51,39168,353,50832,90000
test,2622,162,124416,3556,512064,636480
test,2623,154,118272,3214,462816,581088
test,2624,176,135168,4197,604368,739536
test,2625,143,109824,2771,399024,508848
test,2626,171,131328,3962,570528,701856
test,2627,110,84480,1640,236160,320640
test,2628,72,55296,703,101232,156528
test,2629,149,114432,3008,433152,547584
test,2630,63,48384,538,77472,125856
test,2631,105,80640,1494,215136,295776
test,2632,153,117504,3172,456768,574272
test,2633,151,115968,3090,444960,560928
test,2634,174,133632,4102,590688,724320
test,2635,109,83712,1610,231840,315552
test,2636,169,129792,3870,557280,687072
test,2637,74,56832,742,106848,163680
test,2638,52,39936,367,52848,92784
test,2639,180,138240,4390,632160,770400
test,2640,174,133632,4102,590688,724320
test,2641,189,145152,4840,696960,842112
test,2642,85,65280,979,140976,206256
test,2643,195,149760,5152,741888,891648
test,2644,149,114432,3008,433152,547584
test,2645,137,105216,2543,366192,471408
test,2646,135,103680,2470,355680,459360
test,2647,126,96768,2151,309744,406512
test,2648,187,143616,4738,682272,825888
test,2649,66,50688,591,85104,135792
test,2650,160,122880,3469,499536,622416
test,2651,149,114432,3008,433152,547584
test,2652,73,56064,722,103968,160032
test,2653,170,130560,3916,563904,694464
test,2654,99,76032,1328,191232,267264
test,2655,244,187392,8067,1161648,1349040
test,2656,153,117504,3172,456768,574272
test,2657,137,105216,2543,366192,471408
test,2658,168,129024,3824,550656,679680
test,2659,88,67584,1050,151200,218784
test,2660,225,172800,6859,987696,1160496
test,2661,178,136704,4293,618192,754896
test,2662,147,112896,2928,421632,534528
test,2663,80,61440,867,124848,186288
test,2664,133,102144,2397,345168,447312
test,2665,145,111360,2849,410256,521616
test,2666,94,72192,1198,172512,244704
test,2667,134,102912,2433,350352,453264
test,2668,97,74496,1275,183600,258096
test,2669,180,138240,4390,632160,770400
test,2670,156,119808,3298,474912,594720
test,2671,136,104448,2506,360864,465312
test,2672,116,89088,1823,262512,351600
test,2673,312,239616,10459,1506096,1745712
test,2674,97,74496,1275,183600,258096
test,2675,57,43776,441,63504,107280
test,2676,99,76032,1328,191232,267264
test,2677,111,85248,1670,240480,325728
test,2678,200,153600,5420,780480,934080
test,2679,184,141312,4587,660528,801840
test,2680,152,116736,3131,450864,567600
test,2681,99,76032,1328,191232,267264
test,2682,162,124416,3556,512064,636480
test,2683,182,139776,4488,646272,786048
test,2684,114,87552,1761,253584,341136
test,2685,176,135168,4197,604368,739536
test,2686,99,76032,1328,191232,267264
test,2687,125,96000,2117,304848,400848
test,2688,119,91392,1919,276336,367728
test,2689,154,118272,3214,462816,581088
test,2690,47,36096,300,43200,79296
test,2691,152,116736,3131,450864,567600
test,2692,196,150528,5205,749520,900048
test,2693,103,79104,1438,207072,286176
test,2694,167,128256,3779,544176,672432
test,2695,155,119040,3255,468720,587760
test,2696,156,119808,3298,474912,594720
test,2697,143,109824,2771,399024,508848
test,2698,146,112128,2888,415872,528000
test,2699,180,138240,4390,632160,770400
test,2700,170,130560,3916,563904,694464
test,2701,187,143616,4738,682272,825888
test,2702,214,164352,5563,801072,965424
test,2703,147,112896,2928,421632,534528
test,2704,184,141312,4587,660528,801840
test,2705,117,89856,1855,267120,356976
test,2706,56,43008,425,61200,104208
test,2707,138,105984,2581,371664,477648
test,2708,162,124416,3556,512064,636480
test,2709,117,89856,1855,267120,356976
test,2710,127,97536,2186,314784,412320
test,2711,119,91392,1919,276336,367728
test,2712,44,33792,263,37872,71664
test,2713,149,114432,3008,433152,547584
test,2714,111,85248,1670,240480,325728
test,2715,153,117504,3172,456768,574272
test,2716,134,102912,2433,350352,453264
test,2717,142,109056,2732,393408,502464
test,2718,175,134400,4150,597600,732000
test,2719,120,92160,1951,280944,373104
test,2720,142,109056,2732,393408,502464
test,2721,330,253440,12697,1828368,2081808
test,2722,240,184320,6651,957744,1142064
test,2723,162,124416,3556,512064,636480
test,2724,167,128256,3779,544176,672432
test,2725,82,62976,911,131184,194160
test,2726,98,75264,1302,187488,262752
test,2727,148,113664,2968,427392,541056
test,2728,211,162048,5041,725904,887952
test,2729,176,135168,4197,604368,739536
test,2730,162,124416,3556,512064,636480
test,2731,111,85248,1670,240480,325728
test,2732,48,36864,313,45072,81936
test,2733,42,32256,239,34416,66672
test,2734,214,164352,6205,893520,1057872
test,2735,137,105216,2543,366192,471408
test,2736,169,129792,3870,557280,687072
test,2737,124,95232,2084,300096,395328
test,2738,83,63744,934,134496,198240
test,2739,136,104448,2506,360864,465312
test,2740,162,124416,3556,512064,636480
test,2741,141,108288,2694,387936,496224
test,2742,167,128256,3779,544176,672432
test,2743,144,110592,2810,404640,515232
test,2744,146,112128,2888,415872,528000
test,2745,124,95232,2084,300096,395328
test,2746,161,123648,3512,505728,629376
test,2747,149,114432,3008,433152,547584
test,2748,147,112896,2928,421632,534528
test,2749,51,39168,353,50832,90000
test,2750,122,93696,2017,290448,384144
test,2751,173,132864,3867,556848,689712
test,2752,184,141312,4587,660528,801840
test,2753,94,72192,1198,172512,244704
test,2754,74,56832,742,106848,163680
test,2755,110,84480,1640,236160,320640
test,2756,74,56832,742,106848,163680
test,2757,57,43776,441,63504,107280
test,2758,207,158976,5806,836064,995040
test,2759,159,122112,3426,493344,615456
test,2760,150,115200,3049,439056,554256
test,2761,49,37632,326,46944,84576
test,2762,102,78336,1410,203040,281376
test,2763,189,145152,4840,696960,842112
test,2764,75,57600,762,109728,167328
test,2765,222,170496,6678,961632,1132128
test,2766,182,139776,4208,605952,745728
test,2767,152,116736,3131,450864,567600
test,2768,167,128256,3779,544176,672432
test,2769,218,167424,6439,927216,1094640
test,2770,84,64512,956,137664,202176
test,2771,128,98304,2220,319680,417984
test,2772,91,69888,1122,161568,231456
test,2773,110,84480,1640,236160,320640
test,2774,129,99072,2255,324720,423792
test,2775,114,87552,1761,253584,341136
test,2776,209,160512,5919,852336,1012848
test,2777,142,109056,2732,393408,502464
test,2778,111,85248,1670,240480,325728
test,2779,235,180480,7387,1063728,1244208
test,2780,169,129792,3870,557280,687072
test,2781,136,104448,2506,360864,465312
test,2782,87,66816,1026,147744,214560
test,2783,216,165888,5708,821952,987840
test,2784,111,85248,1670,240480,325728
test,2785,72,55296,703,101232,156528
test,2786,125,96000,2117,304848,400848
test,2787,115,88320,1792,258048,346368
test,2788,110,84480,1640,236160,320640
test,2789,104,79872,1466,211104,290976
test,2790,140,107520,2656,382464,489984
test,2791,97,74496,1275,183600,258096
test,2792,140,107520,2656,382464,489984
test,2793,63,48384,538,77472,125856
test,2794,166,127488,3734,537696,665184
test,2795,143,109824,2771,399024,508848
test,2796,46,35328,287,41328,76656
test,2797,145,111360,2849,410256,521616
test,2798,144,110592,2810,404640,515232
test,2799,199,152832,5019,722736,875568
test,2800,141,108288,2694,387936,496224
test,2801,164,125952,3644,524736,650688
test,2802,66,50688,591,85104,135792
test,2803,72,55296,703,101232,156528
test,2804,105,80640,1494,215136,295776
test,2805,129,99072,2255,324720,423792
test,2806,174,133632,4102,590688,724320
test,2807,95,72960,1223,176112,249072
test,2808,114,87552,1761,253584,341136
test,2809,93,71424,1172,168768,240192
test,2810,129,99072,2255,324720,423792
test,2811,65,49920,573,82512,132432
test,2812,115,88320,1792,258048,346368
test,2813,108,82944,1581,227664,310608
test,2814,115,88320,1792,258048,346368
test,2815,69,52992,645,92880,145872
test,2816,91,69888,1122,161568,231456
test,2817,148,113664,2968,427392,541056
test,2818,52,39936,367,52848,92784
test,2819,214,164352,6205,893520,1057872
test,2820,195,149760,5152,741888,891648
test,2821,151,115968,3090,444960,560928
test,2822,202,155136,5529,796176,951312
test,2823,73,56064,722,103968,160032
test,2824,109,83712,1610,231840,315552
test,2825,96,73728,1249,179856,253584
test,2826,144,110592,2810,404640,515232
test,2827,168,129024,3824,550656,679680
test,2828,146,112128,2888,415872,528000
test,2829,119,91392,1919,276336,367728
test,2830,162,124416,3556,512064,636480
test,2831,121,92928,1984,285696,378624
test,2832,77,59136,804,115776,174912
test,2833,76,58368,783,112752,171120
test,2834,146,112128,2888,415872,528000
test,2835,147,112896,2928,421632,534528
test,2836,115,88320,1792,258048,346368
test,2837,195,149760,5152,741888,891648
test,2838,60,46080,488,70272,116352
test,2839,104,79872,1466,211104,290976
test,2840,150,115200,3049,439056,554256
test,2841,173,132864,4055,583920,716784
test,2842,110,84480,1640,236160,320640
test,2843,100,76800,1355,195120,271920
test,2844,237,182016,7610,1095840,1277856
test,2845,143,109824,2771,399024,508848
test,2846,144,110592,2810,404640,515232
test,2847,222,170496,6678,961632,1132128
test,2848,123,94464,2050,295200,389664
test,2849,43,33024,251,36144,69168
test,2850,118,90624,1887,271728,362352
test,2851,142,109056,2732,393408,502464
test,2852,183,140544,4538,653472,794016
test,2853,89,68352,1074,154656,223008
test,2854,155,119040,3255,468720,587760
test,2855,123,94464,2050,295200,389664
test,2856,88,67584,1050,151200,218784
test,2857,127,97536,2186,314784,412320
test,2858,155,119040,3255,468720,587760
test,2859,109,83712,1610,231840,315552
test,2860,159,122112,3426,493344,615456
test,2861,164,125952,3644,524736,650688
test,2862,216,165888,6322,910368,1076256
test,2863,173,132864,4055,583920,716784
test,2864,159,122112,3426,493344,615456
test,2865,50,38400,339,48816,87216
test,2866,180,138240,4390,632160,770400
test,2867,129,99072,2255,324720,423792
test,2868,59,45312,472,67968,113280
test,2869,129,99072,2255,324720,423792
test,2870,149,114432,3008,433152,547584
test,2871,78,59904,825,118800,178704
test,2872,127,97536,2186,314784,412320
test,2873,160,122880,3469,499536,622416
test,2874,67,51456,609,87696,139152
test,2875,122,93696,2017,290448,384144
test,2876,151,115968,3090,444960,560928
test,2877,140,107520,2656,382464,489984
test,2878,190,145920,4891,704304,850224
test,2879,130,99840,2290,329760,429600
test,2880,128,98304,2220,319680,417984
test,2881,152,116736,3131,450864,567600
test,2882,213,163584,6147,885168,1048752
test,2883,103,79104,1438,207072,286176
test,2884,173,132864,4055,583920,716784
test,2885,160,122880,3469,499536,622416
test,2886,125,96000,2117,304848,400848
test,2887,136,104448,2506,360864,465312
test,2888,171,131328,3962,570528,701856
test,2889,230,176640,7168,1032192,1208832
test,2890,129,99072,2255,324720,423792
test,2891,63,48384,538,77472,125856
test,2892,103,79104,1438,207072,286176
test,2893,166,127488,3734,537696,665184
test,2894,115,88320,1792,258048,346368
test,2895,161,123648,3512,505728,629376
test,2896,163,125184,3600,518400,643584
test,2897,110,84480,1640,236160,320640
test,2898,119,91392,1919,276336,367728
test,2899,193,148224,5047,726768,874992
test,2900,160,122880,3469,499536,622416
test,2901,64,49152,555,79920,129072
test,2902,147,112896,2928,421632,534528
test,2903,127,97536,2186,314784,412320
test,2904,145,111360,2849,410256,521616
test,2905,159,122112,3426,493344,615456
test,2906,165,126720,3689,531216,657936
test,2907,139,106752,2618,376992,483744
test,2908,49,37632,326,46944,84576
test,2909,96,73728,1249,179856,253584
test,2910,170,130560,3916,563904,694464
test,2911,115,88320,1792,258048,346368
test,2912,45,34560,275,39600,74160
test,2913,231,177408,7230,1041120,1218528
test,2914,197,151296,5258,757152,908448
test,2915,167,128256,3779,544176,672432
test,2916,190,145920,4891,704304,850224
test,2917,177,135936,4245,611280,747216
test,2918,92,70656,1147,165168,235824
test,2919,185,142080,4637,667728,809808
test,2920,65,49920,573,82512,132432
test,2921,150,115200,3049,439056,554256
test,2922,122,93696,2017,290448,384144
test,2923,198,152064,5312,764928,916992
test,2924,162,124416,3556,512064,636480
test,2925,79,60672,846,121824,182496
test,2926,182,139776,4488,646272,786048
test,2927,151,115968,3090,444960,560928
test,2928,133,102144,2397,345168,447312
test,2929,133,102144,2397,345168,447312
test,2930,144,110592,2810,404640,515232
test,2931,171,131328,3962,570528,701856
test,2932,147,112896,2928,421632,534528
test,2933,127,97536,2186,314784,412320
test,2934,122,93696,2017,290448,384144
test,2935,187,143616,4738,682272,825888
test,2936,165,126720,3689,531216,657936
test,2937,159,122112,3426,493344,615456
test,2938,168,129024,3824,550656,679680
test,2939,113,86784,1730,249120,335904
test,2940,89,68352,1074,154656,223008
test,2941,118,90624,1887,271728,362352
test,2942,147,112896,2928,421632,534528
test,2943,91,69888,1122,161568,231456
test,2944,149,114432,3008,433152,547584
test,2945,181,139008,4439,639216,778224
test,2946,127,97536,2186,314784,412320
test,2947,68,52224,627,90288,142512
test,2948,221,169728,6618,952992,1122720
test,2949,58,44544,456,65664,110208
test,2950,107,82176,1552,223488,305664
test,2951,148,113664,2745,395280,508944
test,2952,195,149760,5152,741888,891648
test,2953,190,145920,4891,704304,850224
test,2954,81,62208,889,128016,190224
test,2955,170,130560,3916,563904,694464
test,2956,158,121344,3383,487152,608496
test,2957,139,106752,2618,376992,483744
test,2958,146,112128,2888,415872,528000
test,2959,97,74496,1275,183600,258096
test,2960,153,117504,3172,456768,574272
test,2961,110,84480,1640,236160,320640
test,2962,163,125184,3600,518400,643584
test,2963,103,79104,1438,207072,286176
test,2964,96,73728,1249,179856,253584
test,2965,178,136704,4293,618192,754896
test,2966,111,85248,1670,240480,325728
test,2967,186,142848,4688,675072,817920
test,2968,166,127488,3734,537696,665184
test,2969,160,122880,3469,499536,622416
test,2970,88,67584,1050,151200,218784
test,2971,168,129024,3824,550656,679680
test,2972,128,98304,2220,319680,417984
test,2973,192,147456,4995,719280,866736
test,2974,90,69120,1098,158112,227232
test,2975,62,47616,521,75024,122640
test,2976,143,109824,2771,399024,508848
test,2977,109,83712,1610,231840,315552
test,2978,73,56064,722,103968,160032
test,2979,56,43008,425,61200,104208
test,2980,153,117504,3172,456768,574272
test,2981,171,131328,3962,570528,701856
test,2982,80,61440,867,124848,186288
test,2983,167,128256,3779,544176,672432
test,2984,85,65280,979,140976,206256
test,2985,109,83712,1610,231840,315552
test,2986,114,87552,1761,253584,341136
test,2987,172,132096,4009,577296,709392
test,2988,265,203520,7801,1123344,1326864
test,2989,138,105984,2581,371664,477648
test,2990,163,125184,3600,518400,643584
test,2991,62,47616,521,75024,122640
test,2992,136,104448,2506,360864,465312
test,2993,107,82176,1552,223488,305664
test,2994,149,114432,3008,433152,547584
test,2995,271,208128,8523,1227312,1435440
test,2996,147,112896,2928,421632,534528
test,2997,178,136704,4293,618192,754896
test,2998,96,73728,1249,179856,253584
test,2999,142,109056,2732,393408,502464
test,3000,135,103680,2470,355680,459360
test,3001,127,97536,2186,314784,412320
test,3002,173,132864,4055,583920,716784
test,3003,169,129792,3870,557280,687072
test,3004,164,125952,3644,524736,650688
test,3005,91,69888,1122,161568,231456
test,3006,87,66816,1026,147744,214560
test,3007,50,38400,339,48816,87216
test,3008,173,132864,4055,583920,716784
test,3009,74,56832,742,106848,163680
test,3010,53,40704,381,54864,95568
test,3011,128,98304,2220,319680,417984
test,3012,134,102912,2433,350352,453264
test,3013,143,109824,2771,399024,508848
test,3014,101,77568,1382,199008,276576
test,3015,158,121344,3383,487152,608496
test,3016,124,95232,2084,300096,395328
test,3017,147,112896,2928,421632,534528
test,3018,119,91392,1919,276336,367728
test,3019,145,111360,2849,410256,521616
test,3020,201,154368,5474,788256,942624
test,3021,164,125952,3644,524736,650688
test,3022,188,144384,4789,689616,834000
test,3023,141,108288,2694,387936,496224
test,3024,140,107520,2656,382464,489984
test,3025,117,89856,1855,267120,356976
test,3026,130,99840,2290,329760,429600
test,3027,124,95232,2084,300096,395328
test,3028,106,81408,1523,219312,300720
test,3029,181,139008,4439,639216,778224
test,3030,155,119040,3255,468720,587760
test,3031,99,76032,1328,191232,267264
test,3032,99,76032,1328,191232,267264
test,3033,94,72192,1198,172512,244704
test,3034,78,59904,825,118800,178704
test,3035,207,158976,5806,836064,995040
test,3036,167,128256,3779,544176,672432
test,3037,194,148992,5100,734400,883392
test,3038,108,82944,1581,227664,310608
test,3039,127,97536,2186,314784,412320
test,3040,144,110592,2810,404640,515232
test,3041,115,88320,1792,258048,346368
test,3042,122,93696,2017,290448,384144
test,3043,108,82944,1581,227664,310608
test,3044,174,133632,4102,590688,724320
test,3045,167,128256,3779,544176,672432
test,3046,169,129792,3870,557280,687072
test,3047,132,101376,2361,339984,441360
test,3048,185,142080,4637,667728,809808
test,3049,208,159744,5862,844128,1003872
test,3050,125,96000,2117,304848,400848
test,3051,158,121344,3383,487152,608496
test,3052,124,95232,2084,300096,395328
test,3053,48,36864,313,45072,81936
test,3054,119,91392,1919,276336,367728
test,3055,223,171264,6649,957456,1128720
test,3056,106,81408,1523,219312,300720
test,3057,172,132096,3783,544752,676848
test,3058,108,82944,1581,227664,310608
test,3059,49,37632,326,46944,84576
test,3060,221,169728,6327,911088,1080816
test,3061,120,92160,1951,280944,373104
test,3062,92,70656,1147,165168,235824
test,3063,146,112128,2888,415872,528000
test,3064,112,86016,1700,244800,330816
test,3065,105,80640,1494,215136,295776
test,3066,210,161280,5394,776736,938016
test,3067,103,79104,1438,207072,286176
test,3068,179,137472,4341,625104,762576
test,3069,52,39936,367,52848,92784
test,3070,184,141312,4587,660528,801840
test,3071,88,67584,1050,151200,218784
test,3072,130,99840,2290,329760,429600
test,3073,123,94464,2050,295200,389664
test,3074,164,125952,3644,524736,650688
test,3075,173,132864,4055,583920,716784
test,3076,122,93696,2017,290448,384144
test,3077,98,75264,1302,187488,262752
test,3078,183,140544,4538,653472,794016
test,3079,154,118272,3214,462816,581088
test,3080,196,150528,5205,749520,900048
test,3081,149,114432,3008,433152,547584
test,3082,117,89856,1855,267120,356976
test,3083,176,135168,4197,604368,739536
test,3084,141,108288,2694,387936,496224
test,3085,192,147456,4995,719280,866736
test,3086,135,103680,2470,355680,459360
test,3087,180,138240,4390,632160,770400
test,3088,262,201216,9301,1339344,1540560
test,3089,150,115200,3049,439056,554256
test,3090,128,98304,2220,319680,417984
test,3091,210,161280,5975,860400,1021680
test,3092,151,115968,3090,444960,560928
test,3093,137,105216,2543,366192,471408
test,3094,151,115968,3090,444960,560928
test,3095,143,109824,2771,399024,508848
test,3096,123,94464,2050,295200,389664
test,3097,182,139776,4488,646272,786048
test,3098,81,62208,889,128016,190224
test,3099,178,136704,4293,618192,754896
test,3100,158,121344,3383,487152,608496
test,3101,137,105216,2543,366192,471408
test,3102,183,140544,4538,653472,794016
test,3103,130,99840,2290,329760,429600
test,3104,113,86784,1730,249120,335904
test,3105,142,109056,2732,393408,502464
test,3106,132,101376,2361,339984,441360
test,3107,174,133632,4102,590688,724320
test,3108,110,84480,1640,236160,320640
test,3109,75,57600,762,109728,167328
test,3110,157,120576,3340,480960,601536
test,3111,101,77568,1382,199008,276576
test,3112,140,107520,2656,382464,489984
test,3113,83,63744,934,134496,198240
test,3114,123,94464,2050,295200,389664
test,3115,118,90624,1887,271728,362352
test,3116,171,131328,3962,570528,701856
test,3117,143,109824,2771,399024,508848
test,3118,118,90624,1887,271728,362352
test,3119,42,32256,239,34416,66672
test,3120,34,26112,157,22608,48720
test,3121,94,72192,1198,172512,244704
test,3122,150,115200,3049,439056,554256
test,3123,100,76800,1355,195120,271920
test,3124,182,139776,4488,646272,786048
test,3125,44,33792,263,37872,71664
test,3126,129,99072,2255,324720,423792
test,3127,178,136704,4293,618192,754896
test,3128,87,66816,1026,147744,214560
test,3129,138,105984,2581,371664,477648
test,3130,128,98304,2220,319680,417984
test,3131,162,124416,3556,512064,636480
test,3132,77,59136,804,115776,174912
test,3133,196,150528,5205,749520,900048
test,3134,131,100608,2325,334800,435408
test,3135,89,68352,1074,154656,223008
test,3136,143,109824,2771,399024,508848
test,3137,168,129024,3824,550656,679680
test,3138,179,137472,4341,625104,762576
test,3139,133,102144,2397,345168,447312
test,3140,143,109824,2771,399024,508848
test,3141,47,36096,300,43200,79296
test,3142,154,118272,3214,462816,581088
test,3143,76,58368,783,112752,171120
test,3144,174,133632,4102,590688,724320
test,3145,155,119040,3255,468720,587760
test,3146,108,82944,1581,227664,310608
test,3147,166,127488,3734,537696,665184
test,3148,47,36096,300,43200,79296
test,3149,185,142080,4501,648144,790224
test,3150,185,142080,4147,597168,739248
test,3151,140,107520,2656,382464,489984
test,3152,120,92160,1951,280944,373104
test,3153,162,124416,3556,512064,636480
test,3154,180,138240,4390,632160,770400
test,3155,80,61440,867,124848,186288
test,3156,152,116736,3131,450864,567600
test,3157,162,124416,3556,512064,636480
test,3158,105,80640,1494,215136,295776
test,3159,54,41472,395,56880,98352
test,3160,208,159744,5140,740160,899904
test,3161,146,112128,2888,415872,528000
test,3162,97,74496,1275,183600,258096
test,3163,145,111360,2849,410256,521616
test,3164,202,155136,5529,796176,951312
test,3165,156,119808,3298,474912,594720
test,3166,169,129792,3870,557280,687072
test,3167,130,99840,2290,329760,429600
test,3168,127,97536,2186,314784,412320
test,3169,83,63744,934,134496,198240
test,3170,85,65280,979,140976,206256
test,3171,141,108288,2694,387936,496224
test,3172,104,79872,1466,211104,290976
test,3173,74,56832,742,106848,163680
test,3174,65,49920,573,82512,132432
test,3175,205,157440,5694,819936,977376
test,3176,140,107520,2656,382464,489984
test,3177,165,126720,3689,531216,657936
test,3178,137,105216,2543,366192,471408
test,3179,208,159744,5862,844128,1003872
test,3180,129,99072,2255,324720,423792
test,3181,143,109824,2771,399024,508848
test,3182,163,125184,3600,518400,643584
test,3183,149,114432,3008,433152,547584
test,3184,98,75264,1302,187488,262752
test,3185,52,39936,367,52848,92784
test,3186,164,125952,3644,524736,650688
test,3187,130,99840,2290,329760,429600
test,3188,142,109056,2732,393408,502464
test,3189,83,63744,934,134496,198240
test,3190,76,58368,783,112752,171120
test,3191,180,138240,4390,632160,770400
test,3192,87,66816,1026,147744,214560
test,3193,204,156672,5639,812016,968688
test,3194,84,64512,956,137664,202176
test,3195,55,42240,410,59040,101280
test,3196,126,96768,2151,309744,406512
test,3197,83,63744,934,134496,198240
test,3198,142,109056,2732,393408,502464
test,3199,156,119808,3298,474912,594720
test,3200,165,126720,3689,531216,657936
test,3201,97,74496,1275,183600,258096
test,3202,128,98304,2220,319680,417984
test,3203,143,109824,2771,399024,508848
test,3204,106,81408,1523,219312,300720
test,3205,87,66816,1026,147744,214560
test,3206,82,62976,911,131184,194160
test,3207,127,97536,2186,314784,412320
test,3208,132,101376,2361,339984,441360
test,3209,159,122112,3426,493344,615456
test,3210,118,90624,1887,271728,362352
test,3211,103,79104,1438,207072,286176
test,3212,145,111360,2849,410256,521616
test,3213,132,101376,2361,339984,441360
test,3214,140,107520,2656,382464,489984
test,3215,71,54528,683,98352,152880
test,3216,91,69888,1122,161568,231456
test,3217,175,134400,4150,597600,732000
test,3218,172,132096,4009,577296,709392
test,3219,138,105984,2581,371664,477648
test,3220,170,130560,3916,563904,694464
test,3221,136,104448,2506,360864,465312
test,3222,181,139008,4439,639216,778224
test,3223,105,80640,1494,215136,295776
test,3224,173,132864,4055,583920,716784
test,3225,70,53760,664,95616,149376
test,3226,124,95232,2084,300096,395328
test,3227,225,172800,6859,987696,1160496
test,3228,71,54528,683,98352,152880
test,3229,207,158976,5806,836064,995040
test,3230,109,83712,1610,231840,315552
test,3231,152,116736,3131,450864,567600
test,3232,141,108288,2694,387936,496224
test,3233,139,106752,2618,376992,483744
test,3234,186,142848,4688,675072,817920
test,3235,135,103680,2470,355680,459360
test,3236,64,49152,555,79920,129072
test,3237,138,105984,2581,371664,477648
test,3238,85,65280,979,140976,206256
test,3239,247,189696,8266,1190304,1380000
test,3240,39,29952,206,29664,59616
test,3241,166,127488,3734,537696,665184
test,3242,62,47616,521,75024,122640
test,3243,119,91392,1919,276336,367728
test,3244,123,94464,2050,295200,389664
test,3245,98,75264,1302,187488,262752
test,3246,161,123648,3512,505728,629376
test,3247,127,97536,2186,314784,412320
test,3248,193,148224,5047,726768,874992
test,3249,117,89856,1855,267120,356976
test,3250,132,101376,2361,339984,441360
test,3251,157,120576,3340,480960,601536
test,3252,95,72960,1223,176112,249072
test,3253,132,101376,2361,339984,441360
test,3254,159,122112,3426,493344,615456
test,3255,147,112896,2928,421632,534528
test,3256,84,64512,956,137664,202176
test,3257,154,118272,3214,462816,581088
test,3258,53,40704,381,54864,95568
test,3259,129,99072,2255,324720,423792
test,3260,148,113664,2968,427392,541056
test,3261,143,109824,2771,399024,508848
test,3262,63,48384,538,77472,125856
test,3263,194,148992,5100,734400,883392
test,3264,105,80640,1494,215136,295776
test,3265,209,160512,5165,743760,904272
test,3266,134,102912,2433,350352,453264
test,3267,75,57600,762,109728,167328
test,3268,133,102144,2397,345168,447312
test,3269,130,99840,2290,329760,429600
test,3270,187,143616,4738,682272,825888
test,3271,113,86784,1730,249120,335904
test,3272,89,68352,1074,154656,223008
test,3273,125,96000,2117,304848,400848
test,3274,207,158976,5806,836064,995040
test,3275,198,152064,5312,764928,916992
test,3276,138,105984,2581,371664,477648
test,3277,140,107520,2656,382464,489984
test,3278,100,76800,1355,195120,271920
test,3279,93,71424,1172,168768,240192
test,3280,187,143616,4738,682272,825888
test,3281,189,145152,4840,696960,842112
test,3282,107,82176,1552,223488,305664
test,3283,113,86784,1730,249120,335904
test,3284,228,175104,7043,1014192,1189296
test,3285,153,117504,3172,456768,574272
test,3286,135,103680,2470,355680,459360
test,3287,176,135168,4197,604368,739536
test,3288,160,122880,3410,491040,613920
test,3289,84,64512,956,137664,202176
test,3290,165,126720,3689,531216,657936
test,3291,181,139008,4439,639216,778224
test,3292,119,91392,1919,276336,367728
test,3293,121,92928,1984,285696,378624
test,3294,169,129792,3870,557280,687072
test,3295,162,124416,3556,512064,636480
test,3296,60,46080,488,70272,116352
test,3297,105,80640,1494,215136,295776
test,3298,177,135936,4245,611280,747216
test,3299,137,105216,2543,366192,471408
test,3300,179,137472,4341,625104,762576
test,3301,51,39168,353,50832,90000
test,3302,152,116736,3131,450864,567600
test,3303,180,138240,4390,632160,770400
test,3304,148,113664,2968,427392,541056
test,3305,72,55296,703,101232,156528
test,3306,85,65280,979,140976,206256
test,3307,143,109824,2771,399024,508848
test,3308,149,114432,3008,433152,547584
test,3309,197,151296,5258,757152,908448
test,3310,194,148992,5100,734400,883392
test,3311,125,96000,2117,304848,400848
test,3312,174,133632,4102,590688,724320
test,3313,148,113664,2968,427392,541056
test,3314,133,102144,2397,345168,447312
test,3315,89,68352,1074,154656,223008
test,3316,109,83712,1610,231840,315552
test,3317,170,130560,3916,563904,694464
test,3318,96,73728,1249,179856,253584
test,3319,96,73728,1249,179856,253584
test,3320,109,83712,1610,231840,315552
test,3321,144,110592,2810,404640,515232
test,3322,86,66048,1002,144288,210336
test,3323,93,71424,1172,168768,240192
test,3324,107,82176,1552,223488,305664
test,3325,128,98304,2220,319680,417984
test,3326,157,120576,3340,480960,601536
test,3327,138,105984,2581,371664,477648
test,3328,55,42240,410,59040,101280
test,3329,71,54528,683,98352,152880
test,3330,150,115200,3049,439056,554256
test,3331,178,136704,4293,618192,754896
test,3332,101,77568,1382,199008,276576
test,3333,125,96000,2117,304848,400848
test,3334,130,99840,2290,329760,429600
test,3335,114,87552,1761,253584,341136
test,3336,62,47616,521,75024,122640
test,3337,135,103680,2470,355680,459360
test,3338,212,162816,6090,876960,1039776
test,3339,136,104448,2506,360864,465312
test,3340,93,71424,1172,168768,240192
test,3341,87,66816,1026,147744,214560
test,3342,168,129024,3824,550656,679680
test,3343,141,108288,2694,387936,496224
test,3344,190,145920,4891,704304,850224
test,3345,78,59904,825,118800,178704
test,3346,68,52224,627,90288,142512
test,3347,84,64512,956,137664,202176
test,3348,155,119040,3255,468720,587760
test,3349,68,52224,627,90288,142512
test,3350,110,84480,1640,236160,320640
test,3351,137,105216,2543,366192,471408
test,3352,143,109824,2771,399024,508848
test,3353,234,179712,7419,1068336,1248048
test,3354,100,76800,1355,195120,271920
test,3355,131,100608,2325,334800,435408
test,3356,95,72960,1223,176112,249072
test,3357,97,74496,1275,183600,258096
test,3358,76,58368,783,112752,171120
test,3359,126,96768,2151,309744,406512
test,3360,118,90624,1887,271728,362352
test,3361,52,39936,367,52848,92784
test,3362,58,44544,456,65664,110208
test,3363,161,123648,3512,505728,629376
test,3364,154,118272,3214,462816,581088
test,3365,104,79872,1466,211104,290976
test,3366,126,96768,2151,309744,406512
test,3367,98,75264,1302,187488,262752
test,3368,55,42240,410,59040,101280
test,3369,145,111360,2849,410256,521616
test,3370,148,113664,2968,427392,541056
test,3371,101,77568,1382,199008,276576
test,3372,147,112896,2928,421632,534528
test,3373,125,96000,2117,304848,400848
test,3374,81,62208,889,128016,190224
test,3375,113,86784,1730,249120,335904
test,3376,204,156672,5639,812016,968688
test,3377,165,126720,3418,492192,618912
test,3378,156,119808,3298,474912,594720
test,3379,126,96768,2151,309744,406512
test,3380,102,78336,1410,203040,281376
test,3381,152,116736,3131,450864,567600
test,3382,128,98304,2220,319680,417984
test,3383,212,162816,6090,876960,1039776
test,3384,137,105216,2543,366192,471408
test,3385,102,78336,1410,203040,281376
test,3386,170,130560,3916,563904,694464
test,3387,97,74496,1275,183600,258096
test,3388,122,93696,2017,290448,384144
test,3389,164,125952,3644,524736,650688
test,3390,187,143616,4738,682272,825888
test,3391,84,64512,956,137664,202176
test,3392,97,74496,1275,183600,258096
test,3393,149,114432,3008,433152,547584
test,3394,161,123648,3512,505728,629376
test,3395,114,87552,1761,253584,341136
test,3396,99,76032,1328,191232,267264
test,3397,120,92160,1951,280944,373104
test,3398,144,110592,2810,404640,515232
test,3399,99,76032,1328,191232,267264
test,3400,66,50688,591,85104,135792
test,3401,213,163584,6147,885168,1048752
test,3402,119,91392,1919,276336,367728
test,3403,101,77568,1382,199008,276576
test,3404,42,32256,239,34416,66672
test,3405,160,122880,3469,499536,622416
test,3406,199,152832,4919,708336,861168
test,3407,120,92160,1951,280944,373104
test,3408,125,96000,2117,304848,400848
test,3409,163,125184,3600,518400,643584
test,3410,124,95232,2084,300096,395328
test,3411,122,93696,2017,290448,384144
test,3412,145,111360,2849,410256,521616
test,3413,233,178944,7356,1059264,1238208
test,3414,149,114432,3008,433152,547584
test,3415,95,72960,1223,176112,249072
test,3416,85,65280,979,140976,206256
test,3417,118,90624,1887,271728,362352
test,3418,198,152064,5312,764928,916992
test,3419,149,114432,3008,433152,547584
test,3420,148,113664,2968,427392,541056
test,3421,188,144384,4789,689616,834000
test,3422,87,66816,1026,147744,214560
test,3423,273,209664,8710,1254240,1463904
test,3424,106,81408,1523,219312,300720
test,3425,126,96768,2151,309744,406512
test,3426,187,143616,4738,682272,825888
test,3427,84,64512,956,137664,202176
test,3428,179,137472,4341,625104,762576
test,3429,135,103680,2470,355680,459360
test,3430,163,125184,3600,518400,643584
test,3431,76,58368,783,112752,171120
test,3432,116,89088,1823,262512,351600
test,3433,46,35328,287,41328,76656
test,3434,143,109824,2771,399024,508848
test,3435,126,96768,2151,309744,406512
test,3436,186,142848,4688,675072,817920
test,3437,150,115200,3049,439056,554256
test,3438,99,76032,1328,191232,267264
test,3439,186,142848,4688,675072,817920
test,3440,276,211968,8641,1244304,1456272
test,3441,106,81408,1523,219312,300720
test,3442,159,122112,3426,493344,615456
test,3443,193,148224,5047,726768,874992
test,3444,102,78336,1410,203040,281376
test,3445,205,157440,5694,819936,977376
test,3446,161,123648,3512,505728,629376
test,3447,121,92928,1984,285696,378624
test,3448,135,103680,2470,355680,459360
test,3449,105,80640,1494,215136,295776
test,3450,167,128256,3779,544176,672432
test,3451,166,127488,3734,537696,665184
test,3452,99,76032,1328,191232,267264
test,3453,194,148992,5100,734400,883392
test,3454,61,46848,505,72720,119568
test,3455,135,103680,2470,355680,459360
test,3456,166,127488,3734,537696,665184
test,3457,115,88320,1792,258048,346368
test,3458,231,177408,7230,1041120,1218528
test,3459,170,130560,3916,563904,694464
test,3460,75,57600,762,109728,167328
test,3461,137,105216,2543,366192,471408
test,3462,150,115200,3049,439056,554256
test,3463,124,95232,2084,300096,395328
test,3464,272,208896,8715,1254960,1463856
test,3465,124,95232,2084,300096,395328
test,3466,157,120576,3340,480960,601536
test,3467,166,127488,3734,537696,665184
test,3468,106,81408,1523,219312,300720
test,3469,116,89088,1823,262512,351600
test,3470,106,81408,1523,219312,300720
test,3471,153,117504,3172,456768,574272
test,3472,144,110592,2810,404640,515232
test,3473,156,119808,3298,474912,594720
test,3474,115,88320,1792,258048,346368
test,3475,185,142080,4637,667728,809808
test,3476,138,105984,2581,371664,477648
test,3477,143,109824,2771,399024,508848
test,3478,72,55296,703,101232,156528
test,3479,51,39168,353,50832,90000
test,3480,149,114432,3008,433152,547584
test,3481,140,107520,2656,382464,489984
test,3482,128,98304,2220,319680,417984
test,3483,142,109056,2732,393408,502464
test,3484,130,99840,2290,329760,429600
test,3485,81,62208,889,128016,190224
test,3486,153,117504,3172,456768,574272
test,3487,128,98304,2220,319680,417984
test,3488,220,168960,5587,804528,973488
test,3489,76,58368,783,112752,171120
test,3490,172,132096,4009,577296,709392
test,3491,122,93696,2017,290448,384144
test,3492,173,132864,4055,583920,716784
test,3493,132,101376,2361,339984,441360
test,3494,323,248064,12840,1848960,2097024
test,3495,127,97536,2186,314784,412320
test,3496,90,69120,1098,158112,227232
test,3497,164,125952,3644,524736,650688
test,3498,210,161280,5931,854064,1015344
test,3499,172,132096,4009,577296,709392
test,3500,139,106752,2618,376992,483744
test,3501,138,105984,2581,371664,477648
test,3502,101,77568,1382,199008,276576
test,3503,111,85248,1670,240480,325728
test,3504,210,161280,5975,860400,1021680
test,3505,170,130560,3916,563904,694464
test,3506,75,57600,762,109728,167328
test,3507,168,129024,3824,550656,679680
test,3508,187,143616,4443,639792,783408
test,3509,139,106752,2618,376992,483744
test,3510,135,103680,2470,355680,459360
test,3511,126,96768,2151,309744,406512
test,3512,160,122880,3469,499536,622416
test,3513,147,112896,2928,421632,534528
test,3514,103,79104,1438,207072,286176
test,3515,100,76800,1355,195120,271920
test,3516,184,141312,4587,660528,801840
test,3517,84,64512,956,137664,202176
test,3518,54,41472,395,56880,98352
test,3519,156,119808,3298,474912,594720
test,3520,59,45312,472,67968,113280
test,3521,168,129024,3824,550656,679680
test,3522,255,195840,8300,1195200,1391040
test,3523,114,87552,1761,253584,341136
test,3524,131,100608,2325,334800,435408
test,3525,98,75264,1302,187488,262752
test,3526,138,105984,2581,371664,477648
test,3527,134,102912,2433,350352,453264
test,3528,195,149760,5152,741888,891648
test,3529,127,97536,2186,314784,412320
test,3530,146,112128,2888,415872,528000
test,3531,114,87552,1761,253584,341136
test,3532,138,105984,2581,371664,477648
test,3533,55,42240,410,59040,101280
test,3534,200,153600,5420,780480,934080
test,3535,117,89856,1855,267120,356976
test,3536,163,125184,3600,518400,643584
test,3537,130,99840,2290,329760,429600
test,3538,162,124416,3556,512064,636480
test,3539,145,111360,2849,410256,521616
test,3540,157,120576,3340,480960,601536
test,3541,54,41472,395,56880,98352
test,3542,88,67584,1050,151200,218784
test,3543,95,72960,1223,176112,249072
test,3544,154,118272,3214,462816,581088
test,3545,138,105984,2581,371664,477648
test,3546,163,125184,3600,518400,643584
test,3547,134,102912,2433,350352,453264
test,3548,113,86784,1730,249120,335904
test,3549,51,39168,353,50832,90000
test,3550,46,35328,287,41328,76656
test,3551,105,80640,1494,215136,295776
test,3552,196,150528,5205,749520,900048
test,3553,172,132096,4009,577296,709392
test,3554,116,89088,1823,262512,351600
test,3555,180,138240,4390,632160,770400
test,3556,155,119040,3255,468720,587760
test,3557,112,86016,1700,244800,330816
test,3558,172,132096,4009,577296,709392
test,3559,108,82944,1581,227664,310608
test,3560,25,19200,85,12240,31440
test,3561,151,115968,3090,444960,560928
test,3562,105,80640,1494,215136,295776
test,3563,111,85248,1670,240480,325728
test,3564,144,110592,2810,404640,515232
test,3565,254,195072,7578,1091232,1286304
test,3566,116,89088,1823,262512,351600
test,3567,101,77568,1382,199008,276576
test,3568,68,52224,627,90288,142512
test,3569,155,119040,3255,468720,587760
test,3570,126,96768,2151,309744,406512
test,3571,143,109824,2771,399024,508848
test,3572,166,127488,3734,537696,665184
test,3573,186,142848,4688,675072,817920
test,3574,176,135168,4197,604368,739536
test,3575,84,64512,956,137664,202176
test,3576,133,102144,2397,345168,447312
test,3577,210,161280,5975,860400,1021680
test,3578,180,138240,4390,632160,770400
test,3579,92,70656,1147,165168,235824
test,3580,115,88320,1792,258048,346368
test,3581,199,152832,5366,772704,925536
test,3582,179,137472,4341,625104,762576
test,3583,149,114432,3008,433152,547584
test,3584,105,80640,1494,215136,295776
test,3585,147,112896,2928,421632,534528
test,3586,96,73728,1249,179856,253584
test,3587,184,141312,4587,660528,801840
test,3588,107,82176,1552,223488,305664
test,3589,142,109056,2732,393408,502464
test,3590,106,81408,1523,219312,300720
test,3591,203,155904,5584,804096,960000
test,3592,195,149760,5152,741888,891648
test,3593,151,115968,3090,444960,560928
test,3594,143,109824,2771,399024,508848
test,3595,157,120576,3340,480960,601536
test,3596,100,76800,1355,195120,271920
test,3597,143,109824,2771,399024,508848
test,3598,112,86016,1700,244800,330816
test,3599,239,183552,7739,1114416,1297968
test,3600,118,90624,1887,271728,362352
test,3601,270,207360,8282,1192608,1399968
test,3602,142,109056,2732,393408,502464
test,3603,129,99072,2255,324720,423792
test,3604,194,148992,5100,734400,883392
test,3605,99,76032,1328,191232,267264
test,3606,121,92928,1984,285696,378624
test,3607,163,125184,3600,518400,643584
test,3608,169,129792,3870,557280,687072
test,3609,204,156672,5639,812016,968688
test,3610,187,143616,4738,682272,825888
test,3611,93,71424,1172,168768,240192
test,3612,192,147456,4995,719280,866736
test,3613,172,132096,4009,577296,709392
test,3614,141,108288,2694,387936,496224
test,3615,121,92928,1984,285696,378624
test,3616,94,72192,1198,172512,244704
test,3617,161,123648,3512,505728,629376
test,3618,88,67584,1050,151200,218784
test,3619,124,95232,2084,300096,395328
test,3620,63,48384,538,77472,125856
test,3621,166,127488,3734,537696,665184
test,3622,110,84480,1640,236160,320640
test,3623,132,101376,2361,339984,441360
test,3624,191,146688,4943,711792,858480
test,3625,51,39168,353,50832,90000
test,3626,102,78336,1410,203040,281376
test,3627,138,105984,2581,371664,477648
test,3628,85,65280,979,140976,206256
test,3629,95,72960,1223,176112,249072
test,3630,176,135168,4197,604368,739536
test,3631,187,143616,4738,682272,825888
test,3632,144,110592,2810,404640,515232
test,3633,135,103680,2470,355680,459360
test,3634,130,99840,2290,329760,429600
test,3635,140,107520,2656,382464,489984
test,3636,114,87552,1761,253584,341136
test,3637,99,76032,1328,191232,267264
test,3638,210,161280,5891,848304,1009584
test,3639,202,155136,5529,796176,951312
test,3640,99,76032,1328,191232,267264
test,3641,111,85248,1670,240480,325728
test,3642,114,87552,1761,253584,341136
test,3643,231,177408,7230,1041120,1218528
test,3644,130,99840,2290,329760,429600
test,3645,117,89856,1855,267120,356976
test,3646,100,76800,1355,195120,271920
test,3647,131,100608,2325,334800,435408
test,3648,161,123648,3512,505728,629376
test,3649,199,152832,5366,772704,925536
test,3650,175,134400,4150,597600,732000
test,3651,139,106752,2618,376992,483744
test,3652,59,45312,472,67968,113280
test,3653,176,135168,4197,604368,739536
test,3654,197,151296,4615,664560,815856
test,3655,124,95232,2084,300096,395328
test,3656,210,161280,5975,860400,1021680
test,3657,100,76800,1355,195120,271920
test,3658,98,75264,1302,187488,262752
test,3659,127,97536,2186,314784,412320
test,3660,72,55296,703,101232,156528
test,3661,106,81408,1523,219312,300720
test,3662,117,89856,1855,267120,356976
test,3663,147,112896,2928,421632,534528
test,3664,100,76800,1355,195120,271920
test,3665,165,126720,3689,531216,657936
test,3666,145,111360,2849,410256,521616
test,3667,197,151296,5258,757152,908448
test,3668,79,60672,846,121824,182496
test,3669,136,104448,2506,360864,465312
test,3670,193,148224,5047,726768,874992
test,3671,45,34560,275,39600,74160
test,3672,110,84480,1640,236160,320640
test,3673,193,148224,5047,726768,874992
test,3674,179,137472,4341,625104,762576
test,3675,193,148224,5047,726768,874992
test,3676,94,72192,1198,172512,244704
test,3677,107,82176,1552,223488,305664
test,3678,104,79872,1466,211104,290976
test,3679,203,155904,5584,804096,960000
test,3680,175,134400,4150,597600,732000
test,3681,125,96000,2117,304848,400848
test,3682,180,138240,4390,632160,770400
test,3683,132,101376,2361,339984,441360
test,3684,163,125184,3600,518400,643584
test,3685,145,111360,2849,410256,521616
test,3686,95,72960,1223,176112,249072
test,3687,161,123648,3512,505728,629376
test,3688,49,37632,326,46944,84576
test,3689,161,123648,3512,505728,629376
test,3690,137,105216,2543,366192,471408
test,3691,113,86784,1730,249120,335904
test,3692,131,100608,2325,334800,435408
test,3693,127,97536,2186,314784,412320
test,3694,176,135168,4197,604368,739536
test,3695,61,46848,505,72720,119568
test,3696,91,69888,1122,161568,231456
test,3697,240,184320,6305,907920,1092240
test,3698,53,40704,381,54864,95568
test,3699,126,96768,2151,309744,406512
test,3700,151,115968,3090,444960,560928
test,3701,122,93696,2017,290448,384144
test,3702,193,148224,5047,726768,874992
test,3703,109,83712,1610,231840,315552
test,3704,58,44544,456,65664,110208
test,3705,147,112896,2928,421632,534528
test,3706,178,136704,4293,618192,754896
test,3707,103,79104,1438,207072,286176
test,3708,151,115968,3090,444960,560928
test,3709,115,88320,1792,258048,346368
test,3710,111,85248,1670,240480,325728
test,3711,187,143616,4738,682272,825888
test,3712,131,100608,2325,334800,435408
test,3713,75,57600,762,109728,167328
test,3714,113,86784,1730,249120,335904
test,3715,217,166656,6041,869904,1036560
test,3716,106,81408,1523,219312,300720
test,3717,146,112128,2888,415872,528000
test,3718,129,99072,2255,324720,423792
test,3719,195,149760,5152,741888,891648
test,3720,163,125184,3600,518400,643584
test,3721,107,82176,1552,223488,305664
test,3722,182,139776,4032,580608,720384
test,3723,74,56832,742,106848,163680
test,3724,111,85248,1670,240480,325728
test,3725,106,81408,1523,219312,300720
test,3726,73,56064,722,103968,160032
test,3727,107,82176,1552,223488,305664
test,3728,115,88320,1792,258048,346368
test,3729,218,167424,6121,881424,1048848
test,3730,75,57600,762,109728,167328
test,3731,159,122112,3426,493344,615456
test,3732,166,127488,3734,537696,665184
test,3733,232,178176,7293,1050192,1228368
test,3734,118,90624,1887,271728,362352
test,3735,120,92160,1951,280944,373104
test,3736,203,155904,5584,804096,960000
test,3737,136,104448,2506,360864,465312
test,3738,65,49920,573,82512,132432
test,3739,144,110592,2810,404640,515232
test,3740,149,114432,3008,433152,547584
test,3741,155,119040,3255,468720,587760
test,3742,153,117504,3172,456768,574272
test,3743,77,59136,804,115776,174912
test,3744,66,50688,591,85104,135792
test,3745,146,112128,2888,415872,528000
test,3746,63,48384,538,77472,125856
test,3747,107,82176,1552,223488,305664
test,3748,194,148992,5100,734400,883392
test,3749,107,82176,1552,223488,305664
test,3750,152,116736,3131,450864,567600
test,3751,105,80640,1494,215136,295776
test,3752,188,144384,4789,689616,834000
test,3753,125,96000,2117,304848,400848
test,3754,160,122880,3469,499536,622416
test,3755,174,133632,4102,590688,724320
test,3756,141,108288,2694,387936,496224
test,3757,149,114432,3008,433152,547584
test,3758,141,108288,2694,387936,496224
test,3759,141,108288,2694,387936,496224
test,3760,132,101376,2361,339984,441360
test,3761,94,72192,1198,172512,244704
test,3762,118,90624,1887,271728,362352
test,3763,121,92928,1984,285696,378624
test,3764,70,53760,664,95616,149376
test,3765,94,72192,1198,172512,244704
test,3766,225,172800,6859,987696,1160496
test,3767,150,115200,3049,439056,554256
test,3768,38,29184,196,28224,57408
test,3769,193,148224,5047,726768,874992
test,3770,120,92160,1951,280944,373104
test,3771,138,105984,2581,371664,477648
test,3772,88,67584,1050,151200,218784
test,3773,112,86016,1700,244800,330816
test,3774,143,109824,2771,399024,508848
test,3775,117,89856,1855,267120,356976
test,3776,136,104448,2506,360864,465312
test,3777,100,76800,1355,195120,271920
test,3778,96,73728,1249,179856,253584
test,3779,95,72960,1223,176112,249072
test,3780,166,127488,3734,537696,665184
test,3781,64,49152,555,79920,129072
test,3782,90,69120,1098,158112,227232
test,3783,157,120576,3340,480960,601536
test,3784,130,99840,2290,329760,429600
test,3785,92,70656,1147,165168,235824
test,3786,151,115968,3090,444960,560928
test,3787,180,138240,4390,632160,770400
test,3788,83,63744,934,134496,198240
test,3789,138,105984,2581,371664,477648
test,3790,68,52224,627,90288,142512
test,3791,199,152832,5366,772704,925536
test,3792,74,56832,742,106848,163680
test,3793,108,82944,1581,227664,310608
test,3794,83,63744,934,134496,198240
test,3795,126,96768,2151,309744,406512
test,3796,45,34560,275,39600,74160
test,3797,119,91392,1919,276336,367728
test,3798,56,43008,425,61200,104208
test,3799,205,157440,5694,819936,977376
test,3800,153,117504,3172,456768,574272
test,3801,123,94464,2050,295200,389664
test,3802,71,54528,683,98352,152880
test,3803,134,102912,2433,350352,453264
test,3804,145,111360,2849,410256,521616
test,3805,222,170496,6678,961632,1132128
test,3806,94,72192,1198,172512,244704
test,3807,220,168960,6558,944352,1113312
test,3808,176,135168,4197,604368,739536
test,3809,112,86016,1700,244800,330816
test,3810,114,87552,1761,253584,341136
test,3811,182,139776,4488,646272,786048
test,3812,140,107520,2656,382464,489984
test,3813,52,39936,367,52848,92784
test,3814,124,95232,2084,300096,395328
test,3815,92,70656,1147,165168,235824
test,3816,183,140544,4538,653472,794016
test,3817,100,76800,1355,195120,271920
test,3818,159,122112,3426,493344,615456
test,3819,115,88320,1792,258048,346368
test,3820,176,135168,4197,604368,739536
test,3821,86,66048,1002,144288,210336
test,3822,158,121344,3383,487152,608496
test,3823,232,178176,6736,969984,1148160
test,3824,121,92928,1984,285696,378624
test,3825,118,90624,1887,271728,362352
test,3826,118,90624,1887,271728,362352
test,3827,175,134400,4150,597600,732000
test,3828,79,60672,846,121824,182496
test,3829,130,99840,2290,329760,429600
test,3830,158,121344,3383,487152,608496
test,3831,175,134400,4150,597600,732000
test,3832,98,75264,1302,187488,262752
test,3833,180,138240,4390,632160,770400
test,3834,139,106752,2618,376992,483744
test,3835,154,118272,3214,462816,581088
test,3836,160,122880,3469,499536,622416
test,3837,101,77568,1382,199008,276576
test,3838,50,38400,339,48816,87216
test,3839,174,133632,4102,590688,724320
test,3840,219,168192,5843,841392,1009584
test,3841,155,119040,3255,468720,587760
test,3842,123,94464,2050,295200,389664
test,3843,93,71424,1172,168768,240192
test,3844,107,82176,1552,223488,305664
test,3845,109,83712,1610,231840,315552
test,3846,143,109824,2771,399024,508848
test,3847,175,134400,4150,597600,732000
test,3848,128,98304,2220,319680,417984
test,3849,100,76800,1355,195120,271920
test,3850,127,97536,2186,314784,412320
test,3851,146,112128,2888,415872,528000
test,3852,63,48384,538,77472,125856
test,3853,208,159744,5862,844128,1003872
test,3854,69,52992,645,92880,145872
test,3855,66,50688,591,85104,135792
test,3856,169,129792,3870,557280,687072
test,3857,146,112128,2888,415872,528000
test,3858,59,45312,472,67968,113280
test,3859,168,129024,3824,550656,679680
test,3860,85,65280,979,140976,206256
test,3861,162,124416,3556,512064,636480
test,3862,90,69120,1098,158112,227232
test,3863,131,100608,2325,334800,435408
test,3864,198,152064,5312,764928,916992
test,3865,122,93696,2017,290448,384144
test,3866,54,41472,395,56880,98352
test,3867,142,109056,2732,393408,502464
test,3868,127,97536,2186,314784,412320
test,3869,182,139776,4488,646272,786048
test,3870,171,131328,3962,570528,701856
test,3871,181,139008,4439,639216,778224
test,3872,113,86784,1730,249120,335904
test,3873,109,83712,1610,231840,315552
test,3874,189,145152,4840,696960,842112
test,3875,69,52992,645,92880,145872
test,3876,90,69120,1098,158112,227232
test,3877,123,94464,2050,295200,389664
test,3878,63,48384,538,77472,125856
test,3879,178,136704,4293,618192,754896
test,3880,181,139008,4439,639216,778224
test,3881,132,101376,2361,339984,441360
test,3882,173,132864,4055,583920,716784
test,3883,178,136704,4293,618192,754896
test,3884,106,81408,1523,219312,300720
test,3885,202,155136,5529,796176,951312
test,3886,170,130560,3916,563904,694464
test,3887,158,121344,3383,487152,608496
test,3888,57,43776,441,63504,107280
test,3889,187,143616,4738,682272,825888
test,3890,73,56064,722,103968,160032
test,3891,154,118272,3214,462816,581088
test,3892,95,72960,1223,176112,249072
test,3893,139,106752,2618,376992,483744
test,3894,192,147456,4345,625680,773136
test,3895,116,89088,1823,262512,351600
test,3896,65,49920,573,82512,132432
test,3897,112,86016,1700,244800,330816
test,3898,79,60672,846,121824,182496
test,3899,114,87552,1761,253584,341136
test,3900,98,75264,1302,187488,262752
test,3901,119,91392,1919,276336,367728
test,3902,104,79872,1466,211104,290976
test,3903,200,153600,5420,780480,934080
test,3904,224,172032,6799,979056,1151088
test,3905,104,79872,1466,211104,290976
test,3906,121,92928,1984,285696,378624
test,3907,141,108288,2694,387936,496224
test,3908,159,122112,3426,493344,615456
test,3909,189,145152,4382,631008,776160
test,3910,285,218880,8407,1210608,1429488
test,3911,144,110592,2810,404640,515232
test,3912,155,119040,3255,468720,587760
test,3913,119,91392,1919,276336,367728
test,3914,144,110592,2810,404640,515232
test,3915,134,102912,2433,350352,453264
test,3916,178,136704,4293,618192,754896
test,3917,63,48384,538,77472,125856
test,3918,143,109824,2771,399024,508848
test,3919,145,111360,2849,410256,521616
test,3920,152,116736,3131,450864,567600
test,3921,169,129792,3870,557280,687072
test,3922,165,126720,3689,531216,657936
test,3923,133,102144,2397,345168,447312
test,3924,172,132096,4009,577296,709392
test,3925,105,80640,1494,215136,295776
test,3926,143,109824,2771,399024,508848
test,3927,123,94464,2050,295200,389664
test,3928,127,97536,2186,314784,412320
test,3929,147,112896,2928,421632,534528
test,3930,116,89088,1823,262512,351600
test,3931,212,162816,6090,876960,1039776
test,3932,169,129792,3870,557280,687072
test,3933,151,115968,3090,444960,560928
test,3934,52,39936,367,52848,92784
test,3935,129,99072,2255,324720,423792
test,3936,168,129024,3824,550656,679680
test,3937,131,100608,2325,334800,435408
test,3938,144,110592,2810,404640,515232
test,3939,133,102144,2397,345168,447312
test,3940,92,70656,1147,165168,235824
test,3941,92,70656,1147,165168,235824
test,3942,130,99840,2290,329760,429600
test,3943,167,128256,3779,544176,672432
test,3944,128,98304,2220,319680,417984
test,3945,139,106752,2618,376992,483744
test,3946,37,28416,186,26784,55200
test,3947,127,97536,2186,314784,412320
test,3948,152,116736,3131,450864,567600
test,3949,107,82176,1552,223488,305664
test,3950,137,105216,2543,366192,471408
test,3951,185,142080,4637,667728,809808
test,3952,113,86784,1730,249120,335904
test,3953,100,76800,1355,195120,271920
test,3954,85,65280,979,140976,206256
test,3955,82,62976,911,131184,194160
test,3956,182,139776,4488,646272,786048
test,3957,215,165120,6263,901872,1066992
test,3958,90,69120,1098,158112,227232
test,3959,132,101376,2361,339984,441360
test,3960,172,132096,4009,577296,709392
test,3961,212,162816,5962,858528,1021344
test,3962,90,69120,1098,158112,227232
test,3963,141,108288,2694,387936,496224
test,3964,158,121344,3383,487152,608496
test,3965,54,41472,395,56880,98352
test,3966,93,71424,1172,168768,240192
test,3967,176,135168,4197,604368,739536
test,3968,115,88320,1792,258048,346368
test,3969,93,71424,1172,168768,240192
test,3970,198,152064,5312,764928,916992
test,3971,140,107520,2656,382464,489984
test,3972,223,171264,6738,970272,1141536
test,3973,237,182016,6882,991008,1173024
test,3974,125,96000,2117,304848,400848
test,3975,98,75264,1302,187488,262752
test,3976,142,109056,2732,393408,502464
test,3977,183,140544,4538,653472,794016
test,3978,128,98304,2220,319680,417984
test,3979,125,96000,2117,304848,400848
test,3980,224,172032,6166,887904,1059936
test,3981,114,87552,1761,253584,341136
test,3982,150,115200,3049,439056,554256
test,3983,119,91392,1919,276336,367728
test,3984,70,53760,664,95616,149376
test,3985,162,124416,3556,512064,636480
test,3986,214,164352,5624,809856,974208
test,3987,126,96768,2151,309744,406512
test,3988,148,113664,2968,427392,541056
test,3989,185,142080,4637,667728,809808
test,3990,107,82176,1552,223488,305664
test,3991,168,129024,3824,550656,679680
test,3992,232,178176,6932,998208,1176384
test,3993,154,118272,3214,462816,581088
test,3994,103,79104,1438,207072,286176
test,3995,179,137472,4341,625104,762576
test,3996,128,98304,2220,319680,417984
test,3997,96,73728,1249,179856,253584
test,3998,124,95232,2084,300096,395328
test,3999,171,131328,3962,570528,701856
test,4000,117,89856,1855,267120,356976
test,4001,189,145152,4840,696960,842112
test,4002,159,122112,3426,493344,615456
test,4003,173,132864,4055,583920,716784
test,4004,165,126720,3689,531216,657936
test,4005,184,141312,4587,660528,801840
test,4006,86,66048,1002,144288,210336
test,4007,175,134400,4150,597600,732000
test,4008,264,202752,9443,1359792,1562544
test,4009,154,118272,3214,462816,581088
test,4010,153,117504,3172,456768,574272
test,4011,157,120576,3340,480960,601536
test,4012,162,124416,3556,512064,636480
test,4013,92,70656,1147,165168,235824
test,4014,157,120576,3340,480960,601536
test,4015,155,119040,3255,468720,587760
test,4016,131,100608,2325,334800,435408
test,4017,111,85248,1670,240480,325728
test,4018,134,102912,2433,350352,453264
test,4019,60,46080,488,70272,116352
test,4020,174,133632,4102,590688,724320
test,4021,140,107520,2656,382464,489984
test,4022,113,86784,1730,249120,335904
test,4023,137,105216,2543,366192,471408
test,4024,188,144384,4789,689616,834000
test,4025,99,76032,1328,191232,267264
test,4026,202,155136,5338,768672,923808
test,4027,68,52224,627,90288,142512
test,4028,95,72960,1223,176112,249072
test,4029,143,109824,2771,399024,508848
test,4030,176,135168,4197,604368,739536
test,4031,123,94464,2050,295200,389664
test,4032,108,82944,1581,227664,310608
test,4033,207,158976,5806,836064,995040
test,4034,72,55296,703,101232,156528
test,4035,122,93696,2017,290448,384144
test,4036,100,76800,1355,195120,271920
test,4037,81,62208,889,128016,190224
test,4038,119,91392,1919,276336,367728
test,4039,162,124416,3556,512064,636480
test,4040,159,122112,3426,493344,615456
test,4041,169,129792,3870,557280,687072
test,4042,71,54528,683,98352,152880
