split,index,nodes,total_values_for_nodes,edges,total_values_for_edges,total_values_for_graph
train,0,22,16896,165,23760,40656
train,1,153,117504,7964,1146816,1264320
train,2,14,10752,67,9648,20400
train,3,57,43776,1105,159120,202896
train,4,41,31488,572,82368,113856
train,5,31,23808,327,47088,70896
train,6,265,203520,20069,2889936,3093456
train,7,24,18432,196,28224,46656
train,8,37,28416,466,67104,95520
train,9,169,129792,9716,1399104,1528896
train,10,33,25344,371,53424,78768
train,11,26,19968,230,33120,53088
train,12,37,28416,466,67104,95520
train,13,114,87552,4421,636624,724176
train,14,107,82176,3895,560880,643056
train,15,29,22272,286,41184,63456
train,16,48,36864,784,112896,149760
train,17,64,49152,1394,200736,249888
train,18,153,117504,7964,1146816,1264320
train,19,296,227328,24567,3537648,3764976
train,20,93,71424,2942,423648,495072
train,21,140,107520,6668,960192,1067712
train,22,146,112128,7252,1044288,1156416
train,23,28,21504,267,38448,59952
train,24,28,21504,267,38448,59952
train,25,19,14592,123,17712,32304
train,26,53,40704,956,137664,178368
train,27,20,15360,136,19584,34944
train,28,44,33792,659,94896,128688
train,29,36,27648,441,63504,91152
train,30,37,28416,466,67104,95520
train,31,192,147456,12541,1805904,1953360
train,32,20,15360,136,19584,34944
train,33,31,23808,327,47088,70896
train,34,104,79872,3680,529920,609792
train,35,53,40704,956,137664,178368
train,36,24,18432,196,28224,46656
train,37,22,16896,165,23760,40656
train,38,46,35328,720,103680,139008
train,39,212,162816,15290,2201760,2364576
train,40,21,16128,150,21600,37728
train,41,27,20736,248,35712,56448
train,42,34,26112,393,56592,82704
train,43,41,31488,572,82368,113856
train,44,26,19968,230,33120,53088
train,45,429,329472,43854,6314976,6644448
train,46,66,50688,1482,213408,264096
train,47,59,45312,1184,170496,215808
train,48,36,27648,441,63504,91152
train,49,21,16128,150,21600,37728
train,50,256,196608,19228,2768832,2965440
train,51,59,45312,1184,170496,215808
train,52,92,70656,2880,414720,485376
train,53,98,75264,3267,470448,545712
train,54,51,39168,885,127440,166608
train,55,171,131328,9948,1432512,1563840
train,56,44,33792,659,94896,128688
train,57,49,37632,817,117648,155280
train,58,30,23040,306,44064,67104
train,59,74,56832,1863,268272,325104
train,60,23,17664,180,25920,43584
train,61,54,41472,992,142848,184320
train,62,82,62976,2288,329472,392448
train,63,10,7680,34,4896,12576
train,64,48,36864,784,112896,149760
train,65,107,82176,3895,560880,643056
train,66,27,20736,248,35712,56448
train,67,68,52224,1573,226512,278736
train,68,86,66048,2516,362304,428352
train,69,41,31488,572,82368,113856
train,70,49,37632,817,117648,155280
train,71,23,17664,180,25920,43584
train,72,71,54528,1715,246960,301488
train,73,59,45312,1184,170496,215808
train,74,38,29184,491,70704,99888
train,75,16,12288,87,12528,24816
train,76,156,119808,8279,1192176,1311984
train,77,22,16896,165,23760,40656
train,78,44,33792,659,94896,128688
train,79,22,16896,165,23760,40656
train,80,77,59136,2017,290448,349584
train,81,32,24576,349,50256,74832
train,82,67,51456,1527,219888,271344
train,83,57,43776,1105,159120,202896
train,84,49,37632,817,117648,155280
train,85,35,26880,417,60048,86928
train,86,24,18432,196,28224,46656
train,87,158,121344,8493,1222992,1344336
train,88,60,46080,1225,176400,222480
train,89,20,15360,136,19584,34944
train,90,21,16128,150,21600,37728
train,91,10,7680,34,4896,12576
train,92,38,29184,491,70704,99888
train,93,113,86784,4344,625536,712320
train,94,24,18432,196,28224,46656
train,95,10,7680,34,4896,12576
train,96,70,53760,1667,240048,293808
train,97,221,169728,16174,2329056,2498784
train,98,24,18432,196,28224,46656
train,99,23,17664,180,25920,43584
train,100,68,52224,1573,226512,278736
train,101,37,28416,466,67104,95520
train,102,139,106752,6573,946512,1053264
train,103,48,36864,784,112896,149760
train,104,45,34560,689,99216,133776
train,105,135,103680,6200,892800,996480
train,106,35,26880,417,60048,86928
train,107,37,28416,466,67104,95520
train,108,10,7680,34,4896,12576
train,109,25,19200,213,30672,49872
train,110,26,19968,230,33120,53088
train,111,23,17664,180,25920,43584
train,112,72,55296,1764,254016,309312
train,113,22,16896,165,23760,40656
train,114,54,41472,992,142848,184320
train,115,19,14592,123,17712,32304
train,116,79,60672,2123,305712,366384
train,117,128,98304,5574,802656,900960
train,118,44,33792,659,94896,128688
train,119,47,36096,752,108288,144384
train,120,245,188160,18417,2652048,2840208
train,121,72,55296,1764,254016,309312
train,122,26,19968,230,33120,53088
train,123,20,15360,136,19584,34944
train,124,50,38400,851,122544,160944
train,125,85,65280,2458,353952,419232
train,126,28,21504,267,38448,59952
train,127,60,46080,1225,176400,222480
train,128,109,83712,4042,582048,665760
train,129,21,16128,150,21600,37728
train,130,77,59136,2017,290448,349584
train,131,36,27648,441,63504,91152
train,132,37,28416,466,67104,95520
train,133,40,30720,544,78336,109056
train,134,27,20736,248,35712,56448
train,135,56,43008,1067,153648,196656
train,136,146,112128,7252,1044288,1156416
train,137,49,37632,817,117648,155280
train,138,115,88320,4499,647856,736176
train,139,78,59904,2070,298080,357984
train,140,103,79104,3609,519696,598800
train,141,23,17664,180,25920,43584
train,142,46,35328,720,103680,139008
train,143,104,79872,3680,529920,609792
train,144,25,19200,213,30672,49872
train,145,73,56064,1813,261072,317136
train,146,75,57600,1914,275616,333216
train,147,148,113664,7452,1073088,1186752
train,148,16,12288,87,12528,24816
train,149,66,50688,1482,213408,264096
train,150,122,93696,5064,729216,822912
train,151,104,79872,3680,529920,609792
train,152,18,13824,110,15840,29664
train,153,19,14592,123,17712,32304
train,154,36,27648,441,63504,91152
train,155,54,41472,992,142848,184320
train,156,29,22272,286,41184,63456
train,157,51,39168,885,127440,166608
train,158,69,52992,1620,233280,286272
train,159,98,75264,3267,470448,545712
train,160,33,25344,371,53424,78768
train,161,14,10752,67,9648,20400
train,162,43,33024,629,90576,123600
train,163,31,23808,327,47088,70896
train,164,40,30720,544,78336,109056
train,165,266,204288,21480,3093120,3297408
train,166,34,26112,393,56592,82704
train,167,160,122880,8709,1254096,1376976
train,168,122,93696,5064,729216,822912
train,169,24,18432,196,28224,46656
train,170,30,23040,306,44064,67104
train,171,92,70656,2880,414720,485376
train,172,43,33024,629,90576,123600
train,173,13,9984,58,8352,18336
train,174,29,22272,286,41184,63456
train,175,20,15360,136,19584,34944
train,176,103,79104,3609,519696,598800
train,177,142,109056,6860,987840,1096896
train,178,38,29184,491,70704,99888
train,179,65,49920,1437,206928,256848
train,180,213,163584,15434,2222496,2386080
train,181,74,56832,1863,268272,325104
train,182,165,126720,9262,1333728,1460448
train,183,199,152832,13472,1939968,2092800
train,184,29,22272,286,41184,63456
train,185,74,56832,1863,268272,325104
train,186,99,76032,3334,480096,556128
train,187,25,19200,213,30672,49872
train,188,152,116736,7860,1131840,1248576
train,189,128,98304,5574,802656,900960
train,190,29,22272,286,41184,63456
train,191,171,131328,9948,1432512,1563840
train,192,198,152064,13337,1920528,2072592
train,193,21,16128,150,21600,37728
train,194,263,201984,22050,3175200,3377184
train,195,56,43008,1067,153648,196656
train,196,78,59904,2070,298080,357984
train,197,46,35328,720,103680,139008
train,198,118,90624,4737,682128,772752
train,199,80,61440,2177,313488,374928
train,200,51,39168,885,127440,166608
train,201,175,134400,10418,1500192,1634592
train,202,61,46848,1266,182304,229152
train,203,81,62208,2232,321408,383616
train,204,34,26112,393,56592,82704
train,205,124,95232,5231,753264,848496
train,206,34,26112,393,56592,82704
train,207,45,34560,689,99216,133776
train,208,82,62976,2288,329472,392448
train,209,38,29184,491,70704,99888
train,210,19,14592,123,17712,32304
train,211,27,20736,248,35712,56448
train,212,38,29184,491,70704,99888
train,213,22,16896,165,23760,40656
train,214,167,128256,9488,1366272,1494528
train,215,44,33792,659,94896,128688
train,216,17,13056,98,14112,27168
train,217,44,33792,659,94896,128688
train,218,68,52224,1573,226512,278736
train,219,73,56064,1813,261072,317136
train,220,31,23808,327,47088,70896
train,221,45,34560,689,99216,133776
train,222,61,46848,1266,182304,229152
train,223,66,50688,1482,213408,264096
train,224,76,58368,1965,282960,341328
train,225,44,33792,659,94896,128688
train,226,27,20736,248,35712,56448
train,227,17,13056,98,14112,27168
train,228,33,25344,371,53424,78768
train,229,25,19200,213,30672,49872
train,230,60,46080,1225,176400,222480
train,231,27,20736,248,35712,56448
train,232,21,16128,150,21600,37728
train,233,88,67584,2635,379440,447024
train,234,61,46848,1266,182304,229152
train,235,169,129792,9716,1399104,1528896
train,236,51,39168,885,127440,166608
train,237,83,63744,2344,337536,401280
train,238,14,10752,67,9648,20400
train,239,41,31488,572,82368,113856
train,240,28,21504,267,38448,59952
train,241,29,22272,286,41184,63456
train,242,21,16128,150,21600,37728
train,243,333,255744,31404,4522176,4777920
train,244,62,47616,1308,188352,235968
train,245,237,182016,18635,2683440,2865456
train,246,47,36096,752,108288,144384
train,247,84,64512,2401,345744,410256
train,248,85,65280,2458,353952,419232
train,249,42,32256,600,86400,118656
train,250,58,44544,1145,164880,209424
train,251,19,14592,123,17712,32304
train,252,64,49152,1394,200736,249888
train,253,25,19200,213,30672,49872
train,254,196,150528,13069,1881936,2032464
train,255,197,151296,13203,1901232,2052528
train,256,17,13056,98,14112,27168
train,257,62,47616,1308,188352,235968
train,258,22,16896,165,23760,40656
train,259,53,40704,956,137664,178368
train,260,13,9984,58,8352,18336
train,261,22,16896,165,23760,40656
train,262,130,99840,5749,827856,927696
train,263,20,15360,136,19584,34944
train,264,66,50688,1482,213408,264096
train,265,126,96768,5401,777744,874512
train,266,69,52992,1620,233280,286272
train,267,31,23808,327,47088,70896
train,268,116,89088,4578,659232,748320
train,269,59,45312,1184,170496,215808
train,270,155,119040,8173,1176912,1295952
train,271,32,24576,349,50256,74832
train,272,36,27648,441,63504,91152
train,273,37,28416,466,67104,95520
train,274,70,53760,1667,240048,293808
train,275,45,34560,689,99216,133776
train,276,21,16128,150,21600,37728
train,277,164,125952,9150,1317600,1443552
train,278,22,16896,165,23760,40656
train,279,74,56832,1863,268272,325104
train,280,21,16128,150,21600,37728
train,281,36,27648,441,63504,91152
train,282,152,116736,7860,1131840,1248576
train,283,46,35328,720,103680,139008
train,284,56,43008,1067,153648,196656
train,285,46,35328,720,103680,139008
train,286,84,64512,2401,345744,410256
train,287,63,48384,1350,194400,242784
train,288,30,23040,306,44064,67104
train,289,72,55296,1764,254016,309312
train,290,49,37632,817,117648,155280
train,291,140,107520,6668,960192,1067712
train,292,28,21504,267,38448,59952
train,293,53,40704,956,137664,178368
train,294,155,119040,8173,1176912,1295952
train,295,22,16896,165,23760,40656
train,296,58,44544,1145,164880,209424
train,297,78,59904,2070,298080,357984
train,298,52,39936,920,132480,172416
train,299,10,7680,34,4896,12576
train,300,31,23808,327,47088,70896
train,301,29,22272,286,41184,63456
train,302,140,107520,6668,960192,1067712
train,303,15,11520,77,11088,22608
train,304,12,9216,49,7056,16272
train,305,44,33792,659,94896,128688
train,306,26,19968,230,33120,53088
train,307,80,61440,2177,313488,374928
train,308,20,15360,136,19584,34944
train,309,81,62208,2232,321408,383616
train,310,61,46848,1266,182304,229152
train,311,170,130560,9832,1415808,1546368
train,312,81,62208,2232,321408,383616
train,313,62,47616,1308,188352,235968
train,314,34,26112,393,56592,82704
train,315,10,7680,34,4896,12576
train,316,25,19200,213,30672,49872
train,317,55,42240,1029,148176,190416
train,318,45,34560,689,99216,133776
train,319,75,57600,1914,275616,333216
train,320,22,16896,165,23760,40656
train,321,26,19968,230,33120,53088
train,322,63,48384,1350,194400,242784
train,323,38,29184,491,70704,99888
train,324,117,89856,4657,670608,760464
train,325,393,301824,42446,6112224,6414048
train,326,19,14592,123,17712,32304
train,327,156,119808,8279,1192176,1311984
train,328,142,109056,6860,987840,1096896
train,329,223,171264,16917,2436048,2607312
train,330,99,76032,3334,480096,556128
train,331,58,44544,1145,164880,209424
train,332,18,13824,110,15840,29664
train,333,20,15360,136,19584,34944
train,334,40,30720,544,78336,109056
train,335,16,12288,87,12528,24816
train,336,73,56064,1813,261072,317136
train,337,313,240384,27286,3929184,4169568
train,338,122,93696,5064,729216,822912
train,339,23,17664,180,25920,43584
train,340,14,10752,67,9648,20400
train,341,55,42240,1029,148176,190416
train,342,89,68352,2695,388080,456432
train,343,35,26880,417,60048,86928
train,344,91,69888,2817,405648,475536
train,345,76,58368,1965,282960,341328
train,346,44,33792,659,94896,128688
train,347,83,63744,2344,337536,401280
train,348,23,17664,180,25920,43584
train,349,87,66816,2575,370800,437616
train,350,47,36096,752,108288,144384
train,351,109,83712,4042,582048,665760
train,352,61,46848,1266,182304,229152
train,353,13,9984,58,8352,18336
train,354,63,48384,1350,194400,242784
train,355,64,49152,1394,200736,249888
train,356,13,9984,58,8352,18336
train,357,35,26880,417,60048,86928
train,358,29,22272,286,41184,63456
train,359,57,43776,1105,159120,202896
train,360,70,53760,1667,240048,293808
train,361,33,25344,371,53424,78768
train,362,123,94464,5147,741168,835632
train,363,22,16896,165,23760,40656
train,364,12,9216,49,7056,16272
train,365,72,55296,1764,254016,309312
train,366,297,228096,26698,3844512,4072608
train,367,67,51456,1527,219888,271344
train,368,16,12288,87,12528,24816
train,369,13,9984,58,8352,18336
train,370,20,15360,136,19584,34944
train,371,159,122112,8601,1238544,1360656
train,372,39,29952,518,74592,104544
train,373,72,55296,1764,254016,309312
train,374,14,10752,67,9648,20400
train,375,144,110592,7054,1015776,1126368
train,376,32,24576,349,50256,74832
train,377,19,14592,123,17712,32304
train,378,15,11520,77,11088,22608
train,379,22,16896,165,23760,40656
train,380,18,13824,110,15840,29664
train,381,58,44544,1145,164880,209424
train,382,31,23808,327,47088,70896
train,383,101,77568,3470,499680,577248
train,384,84,64512,2401,345744,410256
train,385,21,16128,150,21600,37728
train,386,52,39936,920,132480,172416
train,387,37,28416,466,67104,95520
train,388,34,26112,393,56592,82704
train,389,36,27648,441,63504,91152
train,390,8,6144,22,3168,9312
train,391,26,19968,230,33120,53088
train,392,102,78336,3539,509616,587952
train,393,102,78336,3539,509616,587952
train,394,66,50688,1482,213408,264096
train,395,22,16896,165,23760,40656
train,396,55,42240,1029,148176,190416
train,397,82,62976,2288,329472,392448
train,398,10,7680,34,4896,12576
train,399,71,54528,1715,246960,301488
train,400,35,26880,417,60048,86928
train,401,12,9216,49,7056,16272
train,402,60,46080,1225,176400,222480
train,403,23,17664,180,25920,43584
train,404,21,16128,150,21600,37728
train,405,93,71424,2942,423648,495072
train,406,132,101376,5928,853632,955008
train,407,261,200448,23174,3337056,3537504
train,408,229,175872,17840,2568960,2744832
train,409,71,54528,1715,246960,301488
train,410,75,57600,1914,275616,333216
train,411,50,38400,851,122544,160944
train,412,84,64512,2401,345744,410256
train,413,38,29184,491,70704,99888
train,414,42,32256,600,86400,118656
train,415,102,78336,3539,509616,587952
train,416,130,99840,5749,827856,927696
train,417,19,14592,123,17712,32304
train,418,22,16896,165,23760,40656
train,419,23,17664,180,25920,43584
train,420,22,16896,165,23760,40656
train,421,107,82176,3895,560880,643056
train,422,26,19968,230,33120,53088
train,423,66,50688,1482,213408,264096
train,424,306,235008,28454,4097376,4332384
train,425,76,58368,1965,282960,341328
train,426,189,145152,12152,1749888,1895040
train,427,71,54528,1715,246960,301488
train,428,88,67584,2635,379440,447024
train,429,37,28416,466,67104,95520
train,430,11,8448,41,5904,14352
train,431,53,40704,956,137664,178368
train,432,22,16896,165,23760,40656
train,433,174,133632,10300,1483200,1616832
train,434,48,36864,784,112896,149760
train,435,118,90624,4737,682128,772752
train,436,56,43008,1067,153648,196656
train,437,62,47616,1308,188352,235968
train,438,32,24576,349,50256,74832
train,439,58,44544,1145,164880,209424
train,440,51,39168,885,127440,166608
train,441,26,19968,230,33120,53088
train,442,64,49152,1394,200736,249888
train,443,77,59136,2017,290448,349584
train,444,33,25344,371,53424,78768
train,445,63,48384,1350,194400,242784
train,446,46,35328,720,103680,139008
train,447,47,36096,752,108288,144384
train,448,20,15360,136,19584,34944
train,449,104,79872,3680,529920,609792
train,450,76,58368,1965,282960,341328
train,451,20,15360,136,19584,34944
train,452,20,15360,136,19584,34944
train,453,60,46080,1225,176400,222480
train,454,81,62208,2232,321408,383616
train,455,96,73728,3135,451440,525168
train,456,99,76032,3334,480096,556128
train,457,73,56064,1813,261072,317136
train,458,16,12288,87,12528,24816
train,459,54,41472,992,142848,184320
train,460,72,55296,1764,254016,309312
train,461,36,27648,441,63504,91152
train,462,46,35328,720,103680,139008
train,463,12,9216,49,7056,16272
train,464,22,16896,165,23760,40656
train,465,48,36864,784,112896,149760
train,466,27,20736,248,35712,56448
train,467,12,9216,49,7056,16272
train,468,61,46848,1266,182304,229152
train,469,255,195840,20089,2892816,3088656
train,470,67,51456,1527,219888,271344
train,471,21,16128,150,21600,37728
train,472,222,170496,16766,2414304,2584800
train,473,106,81408,3823,550512,631920
train,474,40,30720,544,78336,109056
train,475,123,94464,5147,741168,835632
train,476,155,119040,8173,1176912,1295952
train,477,28,21504,267,38448,59952
train,478,34,26112,393,56592,82704
train,479,31,23808,327,47088,70896
train,480,184,141312,11518,1658592,1799904
train,481,150,115200,7654,1102176,1217376
train,482,24,18432,196,28224,46656
train,483,89,68352,2695,388080,456432
train,484,66,50688,1482,213408,264096
train,485,117,89856,4657,670608,760464
train,486,78,59904,2070,298080,357984
train,487,40,30720,544,78336,109056
train,488,37,28416,466,67104,95520
train,489,14,10752,67,9648,20400
train,490,216,165888,15872,2285568,2451456
train,491,31,23808,327,47088,70896
train,492,38,29184,491,70704,99888
train,493,90,69120,2756,396864,465984
train,494,41,31488,572,82368,113856
train,495,60,46080,1225,176400,222480
train,496,62,47616,1308,188352,235968
train,497,15,11520,77,11088,22608
train,498,91,69888,2817,405648,475536
train,499,62,47616,1308,188352,235968
train,500,356,273408,35395,5096880,5370288
train,501,73,56064,1813,261072,317136
train,502,39,29952,518,74592,104544
train,503,65,49920,1437,206928,256848
train,504,12,9216,49,7056,16272
train,505,153,117504,7964,1146816,1264320
train,506,77,59136,2017,290448,349584
train,507,36,27648,441,63504,91152
train,508,22,16896,165,23760,40656
train,509,42,32256,600,86400,118656
train,510,54,41472,992,142848,184320
train,511,47,36096,752,108288,144384
train,512,67,51456,1527,219888,271344
train,513,96,73728,3135,451440,525168
train,514,17,13056,98,14112,27168
train,515,23,17664,180,25920,43584
train,516,29,22272,286,41184,63456
train,517,24,18432,196,28224,46656
train,518,41,31488,572,82368,113856
train,519,27,20736,248,35712,56448
train,520,51,39168,885,127440,166608
train,521,33,25344,371,53424,78768
train,522,81,62208,2232,321408,383616
train,523,141,108288,6763,973872,1082160
train,524,57,43776,1105,159120,202896
train,525,22,16896,165,23760,40656
train,526,20,15360,136,19584,34944
train,527,41,31488,572,82368,113856
train,528,72,55296,1764,254016,309312
train,529,16,12288,87,12528,24816
train,530,44,33792,659,94896,128688
train,531,38,29184,491,70704,99888
train,532,23,17664,180,25920,43584
train,533,12,9216,49,7056,16272
train,534,49,37632,817,117648,155280
train,535,272,208896,22719,3271536,3480432
train,536,94,72192,3006,432864,505056
train,537,63,48384,1350,194400,242784
train,538,43,33024,629,90576,123600
train,539,43,33024,629,90576,123600
train,540,75,57600,1914,275616,333216
train,541,49,37632,817,117648,155280
train,542,295,226560,23961,3450384,3676944
train,543,97,74496,3201,460944,535440
train,544,165,126720,9262,1333728,1460448
train,545,26,19968,230,33120,53088
train,546,34,26112,393,56592,82704
train,547,41,31488,572,82368,113856
train,548,69,52992,1620,233280,286272
train,549,215,165120,15725,2264400,2429520
train,550,30,23040,306,44064,67104
train,551,266,204288,21172,3048768,3253056
train,552,43,33024,629,90576,123600
train,553,114,87552,4421,636624,724176
train,554,63,48384,1350,194400,242784
train,555,107,82176,3895,560880,643056
train,556,73,56064,1813,261072,317136
train,557,115,88320,4499,647856,736176
train,558,47,36096,752,108288,144384
train,559,319,244992,27627,3978288,4223280
train,560,34,26112,393,56592,82704
train,561,38,29184,491,70704,99888
train,562,172,132096,10064,1449216,1581312
train,563,44,33792,659,94896,128688
train,564,47,36096,752,108288,144384
train,565,66,50688,1482,213408,264096
train,566,47,36096,752,108288,144384
train,567,123,94464,5147,741168,835632
train,568,45,34560,689,99216,133776
train,569,70,53760,1667,240048,293808
train,570,20,15360,136,19584,34944
train,571,21,16128,150,21600,37728
train,572,40,30720,544,78336,109056
train,573,11,8448,41,5904,14352
train,574,65,49920,1437,206928,256848
train,575,34,26112,393,56592,82704
train,576,11,8448,41,5904,14352
train,577,24,18432,196,28224,46656
train,578,33,25344,371,53424,78768
train,579,43,33024,629,90576,123600
train,580,37,28416,466,67104,95520
train,581,30,23040,306,44064,67104
train,582,60,46080,1225,176400,222480
train,583,19,14592,123,17712,32304
train,584,15,11520,77,11088,22608
train,585,66,50688,1482,213408,264096
train,586,31,23808,327,47088,70896
train,587,23,17664,180,25920,43584
train,588,58,44544,1145,164880,209424
train,589,128,98304,5574,802656,900960
train,590,51,39168,885,127440,166608
train,591,45,34560,689,99216,133776
train,592,78,59904,2070,298080,357984
train,593,106,81408,3823,550512,631920
train,594,16,12288,87,12528,24816
train,595,12,9216,49,7056,16272
train,596,58,44544,1145,164880,209424
train,597,58,44544,1145,164880,209424
train,598,24,18432,196,28224,46656
train,599,61,46848,1266,182304,229152
train,600,34,26112,393,56592,82704
train,601,17,13056,98,14112,27168
train,602,10,7680,34,4896,12576
train,603,146,112128,7252,1044288,1156416
train,604,182,139776,11269,1622736,1762512
train,605,81,62208,2232,321408,383616
train,606,28,21504,267,38448,59952
train,607,52,39936,920,132480,172416
train,608,19,14592,123,17712,32304
train,609,100,76800,3402,489888,566688
train,610,27,20736,248,35712,56448
train,611,22,16896,165,23760,40656
train,612,50,38400,851,122544,160944
train,613,39,29952,518,74592,104544
train,614,17,13056,98,14112,27168
train,615,62,47616,1308,188352,235968
train,616,71,54528,1715,246960,301488
train,617,77,59136,2017,290448,349584
train,618,21,16128,150,21600,37728
train,619,48,36864,784,112896,149760
train,620,21,16128,150,21600,37728
train,621,22,16896,165,23760,40656
train,622,50,38400,851,122544,160944
train,623,44,33792,659,94896,128688
train,624,67,51456,1527,219888,271344
train,625,57,43776,1105,159120,202896
train,626,50,38400,851,122544,160944
train,627,24,18432,196,28224,46656
train,628,42,32256,600,86400,118656
train,629,47,36096,752,108288,144384
train,630,43,33024,629,90576,123600
train,631,42,32256,600,86400,118656
train,632,49,37632,817,117648,155280
train,633,38,29184,491,70704,99888
train,634,22,16896,165,23760,40656
train,635,79,60672,2123,305712,366384
train,636,29,22272,286,41184,63456
train,637,94,72192,3006,432864,505056
train,638,80,61440,2177,313488,374928
train,639,22,16896,165,23760,40656
train,640,103,79104,3609,519696,598800
train,641,21,16128,150,21600,37728
train,642,23,17664,180,25920,43584
train,643,23,17664,180,25920,43584
train,644,27,20736,248,35712,56448
train,645,11,8448,41,5904,14352
train,646,262,201216,21964,3162816,3364032
train,647,53,40704,956,137664,178368
train,648,17,13056,98,14112,27168
train,649,51,39168,885,127440,166608
train,650,29,22272,286,41184,63456
train,651,35,26880,417,60048,86928
train,652,21,16128,150,21600,37728
train,653,64,49152,1394,200736,249888
train,654,33,25344,371,53424,78768
train,655,23,17664,180,25920,43584
train,656,19,14592,123,17712,32304
train,657,19,14592,123,17712,32304
train,658,43,33024,629,90576,123600
train,659,67,51456,1527,219888,271344
train,660,28,21504,267,38448,59952
train,661,48,36864,784,112896,149760
train,662,41,31488,572,82368,113856
train,663,22,16896,165,23760,40656
train,664,76,58368,1965,282960,341328
train,665,189,145152,12152,1749888,1895040
train,666,127,97536,5487,790128,887664
train,667,26,19968,230,33120,53088
train,668,22,16896,165,23760,40656
train,669,62,47616,1308,188352,235968
train,670,24,18432,196,28224,46656
train,671,58,44544,1145,164880,209424
train,672,82,62976,2288,329472,392448
train,673,74,56832,1863,268272,325104
train,674,15,11520,77,11088,22608
train,675,54,41472,992,142848,184320
train,676,250,192000,21262,3061728,3253728
train,677,57,43776,1105,159120,202896
train,678,21,16128,150,21600,37728
train,679,26,19968,230,33120,53088
train,680,42,32256,600,86400,118656
train,681,21,16128,150,21600,37728
train,682,44,33792,659,94896,128688
train,683,24,18432,196,28224,46656
train,684,62,47616,1308,188352,235968
train,685,15,11520,77,11088,22608
train,686,28,21504,267,38448,59952
train,687,40,30720,544,78336,109056
train,688,15,11520,77,11088,22608
train,689,223,171264,16917,2436048,2607312
train,690,34,26112,393,56592,82704
train,691,44,33792,659,94896,128688
train,692,50,38400,851,122544,160944
train,693,118,90624,4737,682128,772752
train,694,24,18432,196,28224,46656
train,695,109,83712,4042,582048,665760
train,696,112,86016,4267,614448,700464
train,697,37,28416,466,67104,95520
train,698,20,15360,136,19584,34944
train,699,74,56832,1863,268272,325104
train,700,16,12288,87,12528,24816
train,701,35,26880,417,60048,86928
train,702,33,25344,371,53424,78768
train,703,46,35328,720,103680,139008
train,704,39,29952,518,74592,104544
train,705,199,152832,13472,1939968,2092800
train,706,20,15360,136,19584,34944
train,707,161,123648,8818,1269792,1393440
train,708,80,61440,2177,313488,374928
train,709,10,7680,34,4896,12576
train,710,335,257280,31335,4512240,4769520
train,711,28,21504,267,38448,59952
train,712,278,213504,22753,3276432,3489936
train,713,23,17664,180,25920,43584
train,714,46,35328,720,103680,139008
train,715,62,47616,1308,188352,235968
train,716,13,9984,58,8352,18336
train,717,59,45312,1184,170496,215808
train,718,66,50688,1482,213408,264096
train,719,77,59136,2017,290448,349584
train,720,44,33792,659,94896,128688
train,721,26,19968,230,33120,53088
train,722,24,18432,196,28224,46656
train,723,40,30720,544,78336,109056
train,724,42,32256,600,86400,118656
train,725,33,25344,371,53424,78768
train,726,20,15360,136,19584,34944
train,727,133,102144,6018,866592,968736
train,728,35,26880,417,60048,86928
train,729,21,16128,150,21600,37728
train,730,60,46080,1225,176400,222480
train,731,61,46848,1266,182304,229152
train,732,213,163584,15080,2171520,2335104
train,733,28,21504,267,38448,59952
train,734,52,39936,920,132480,172416
train,735,22,16896,165,23760,40656
train,736,171,131328,9948,1432512,1563840
train,737,69,52992,1620,233280,286272
train,738,56,43008,1067,153648,196656
train,739,124,95232,5231,753264,848496
train,740,60,46080,1225,176400,222480
train,741,36,27648,441,63504,91152
train,742,60,46080,1225,176400,222480
train,743,71,54528,1715,246960,301488
train,744,49,37632,817,117648,155280
train,745,110,84480,4116,592704,677184
train,746,48,36864,784,112896,149760
train,747,182,139776,11269,1622736,1762512
train,748,32,24576,349,50256,74832
train,749,63,48384,1350,194400,242784
train,750,64,49152,1394,200736,249888
train,751,51,39168,885,127440,166608
train,752,194,148992,12804,1843776,1992768
train,753,40,30720,544,78336,109056
train,754,52,39936,920,132480,172416
train,755,13,9984,58,8352,18336
train,756,34,26112,393,56592,82704
train,757,77,59136,2017,290448,349584
train,758,55,42240,1029,148176,190416
train,759,107,82176,3895,560880,643056
train,760,47,36096,752,108288,144384
train,761,131,100608,5838,840672,941280
train,762,77,59136,2017,290448,349584
train,763,37,28416,466,67104,95520
train,764,32,24576,349,50256,74832
train,765,20,15360,136,19584,34944
train,766,315,241920,29235,4209840,4451760
train,767,26,19968,230,33120,53088
train,768,48,36864,784,112896,149760
train,769,106,81408,3823,550512,631920
train,770,64,49152,1394,200736,249888
train,771,44,33792,659,94896,128688
train,772,240,184320,19595,2821680,3006000
train,773,140,107520,6668,960192,1067712
train,774,62,47616,1308,188352,235968
train,775,64,49152,1394,200736,249888
train,776,90,69120,2756,396864,465984
train,777,21,16128,150,21600,37728
train,778,7,5376,17,2448,7824
train,779,12,9216,49,7056,16272
train,780,68,52224,1573,226512,278736
train,781,57,43776,1105,159120,202896
train,782,65,49920,1437,206928,256848
train,783,64,49152,1394,200736,249888
train,784,22,16896,165,23760,40656
train,785,25,19200,213,30672,49872
train,786,73,56064,1813,261072,317136
train,787,73,56064,1813,261072,317136
train,788,43,33024,629,90576,123600
train,789,75,57600,1914,275616,333216
train,790,45,34560,689,99216,133776
train,791,129,99072,5661,815184,914256
train,792,47,36096,752,108288,144384
train,793,49,37632,817,117648,155280
train,794,112,86016,4267,614448,700464
train,795,55,42240,1029,148176,190416
train,796,74,56832,1863,268272,325104
train,797,55,42240,1029,148176,190416
train,798,125,96000,5317,765648,861648
train,799,45,34560,689,99216,133776
train,800,36,27648,441,63504,91152
train,801,28,21504,267,38448,59952
train,802,56,43008,1067,153648,196656
train,803,67,51456,1527,219888,271344
train,804,40,30720,544,78336,109056
train,805,26,19968,230,33120,53088
train,806,23,17664,180,25920,43584
train,807,34,26112,393,56592,82704
train,808,51,39168,885,127440,166608
train,809,34,26112,393,56592,82704
train,810,48,36864,784,112896,149760
train,811,24,18432,196,28224,46656
train,812,10,7680,34,4896,12576
train,813,86,66048,2516,362304,428352
train,814,22,16896,165,23760,40656
train,815,179,137472,10900,1569600,1707072
train,816,46,35328,720,103680,139008
train,817,54,41472,992,142848,184320
train,818,10,7680,34,4896,12576
train,819,42,32256,600,86400,118656
train,820,21,16128,150,21600,37728
train,821,96,73728,3135,451440,525168
train,822,14,10752,67,9648,20400
train,823,48,36864,784,112896,149760
train,824,20,15360,136,19584,34944
train,825,164,125952,9150,1317600,1443552
train,826,18,13824,110,15840,29664
train,827,46,35328,720,103680,139008
train,828,27,20736,248,35712,56448
train,829,22,16896,165,23760,40656
train,830,25,19200,213,30672,49872
train,831,24,18432,196,28224,46656
train,832,44,33792,659,94896,128688
train,833,83,63744,2344,337536,401280
train,834,143,109824,6957,1001808,1111632
train,835,75,57600,1914,275616,333216
train,836,25,19200,213,30672,49872
train,837,30,23040,306,44064,67104
train,838,21,16128,150,21600,37728
train,839,75,57600,1914,275616,333216
train,840,314,241152,27973,4028112,4269264
train,841,76,58368,1965,282960,341328
train,842,50,38400,851,122544,160944
train,843,16,12288,87,12528,24816
train,844,22,16896,165,23760,40656
train,845,319,244992,27553,3967632,4212624
train,846,24,18432,196,28224,46656
train,847,350,268800,33754,4860576,5129376
train,848,40,30720,544,78336,109056
train,849,112,86016,4267,614448,700464
train,850,46,35328,720,103680,139008
train,851,21,16128,150,21600,37728
train,852,29,22272,286,41184,63456
train,853,121,92928,4981,717264,810192
train,854,40,30720,544,78336,109056
train,855,15,11520,77,11088,22608
train,856,42,32256,600,86400,118656
train,857,279,214272,24838,3576672,3790944
train,858,147,112896,7351,1058544,1171440
train,859,26,19968,230,33120,53088
train,860,50,38400,851,122544,160944
train,861,40,30720,544,78336,109056
train,862,26,19968,230,33120,53088
train,863,21,16128,150,21600,37728
train,864,63,48384,1350,194400,242784
train,865,75,57600,1914,275616,333216
train,866,11,8448,41,5904,14352
train,867,34,26112,393,56592,82704
train,868,36,27648,441,63504,91152
train,869,39,29952,518,74592,104544
train,870,63,48384,1350,194400,242784
train,871,116,89088,4578,659232,748320
train,872,18,13824,110,15840,29664
train,873,26,19968,230,33120,53088
train,874,28,21504,267,38448,59952
train,875,27,20736,248,35712,56448
train,876,35,26880,417,60048,86928
train,877,24,18432,196,28224,46656
train,878,35,26880,417,60048,86928
train,879,186,142848,11769,1694736,1837584
train,880,11,8448,41,5904,14352
train,881,118,90624,4737,682128,772752
train,882,23,17664,180,25920,43584
train,883,20,15360,136,19584,34944
train,884,65,49920,1437,206928,256848
train,885,30,23040,306,44064,67104
train,886,77,59136,2017,290448,349584
train,887,22,16896,165,23760,40656
train,888,82,62976,2288,329472,392448
train,889,48,36864,784,112896,149760
train,890,25,19200,213,30672,49872
train,891,52,39936,920,132480,172416
train,892,45,34560,689,99216,133776
train,893,121,92928,4981,717264,810192
train,894,94,72192,3006,432864,505056
train,895,116,89088,4578,659232,748320
train,896,124,95232,5231,753264,848496
train,897,30,23040,306,44064,67104
train,898,39,29952,518,74592,104544
train,899,58,44544,1145,164880,209424
train,900,126,96768,5401,777744,874512
train,901,37,28416,466,67104,95520
train,902,130,99840,5749,827856,927696
train,903,58,44544,1145,164880,209424
train,904,140,107520,6668,960192,1067712
train,905,287,220416,23545,3390480,3610896
train,906,77,59136,2017,290448,349584
train,907,188,144384,12024,1731456,1875840
train,908,50,38400,851,122544,160944
train,909,41,31488,572,82368,113856
train,910,130,99840,5749,827856,927696
train,911,44,33792,659,94896,128688
train,912,36,27648,441,63504,91152
train,913,27,20736,248,35712,56448
train,914,66,50688,1482,213408,264096
train,915,52,39936,920,132480,172416
train,916,62,47616,1308,188352,235968
train,917,43,33024,629,90576,123600
train,918,151,115968,7757,1117008,1232976
train,919,150,115200,7654,1102176,1217376
train,920,14,10752,67,9648,20400
train,921,30,23040,306,44064,67104
train,922,74,56832,1863,268272,325104
train,923,61,46848,1266,182304,229152
train,924,217,166656,16019,2306736,2473392
train,925,65,49920,1437,206928,256848
train,926,41,31488,572,82368,113856
train,927,22,16896,165,23760,40656
train,928,258,198144,20451,2944944,3143088
train,929,51,39168,885,127440,166608
train,930,23,17664,180,25920,43584
train,931,42,32256,600,86400,118656
train,932,122,93696,5064,729216,822912
train,933,55,42240,1029,148176,190416
train,934,69,52992,1620,233280,286272
train,935,63,48384,1350,194400,242784
train,936,66,50688,1482,213408,264096
train,937,13,9984,58,8352,18336
train,938,22,16896,165,23760,40656
train,939,36,27648,441,63504,91152
train,940,20,15360,136,19584,34944
train,941,23,17664,180,25920,43584
train,942,79,60672,2123,305712,366384
train,943,27,20736,248,35712,56448
train,944,181,139008,11145,1604880,1743888
train,945,94,72192,3006,432864,505056
train,946,23,17664,180,25920,43584
train,947,14,10752,67,9648,20400
train,948,106,81408,3823,550512,631920
train,949,59,45312,1184,170496,215808
train,950,50,38400,851,122544,160944
train,951,46,35328,720,103680,139008
train,952,12,9216,49,7056,16272
train,953,55,42240,1029,148176,190416
train,954,23,17664,180,25920,43584
train,955,17,13056,98,14112,27168
train,956,39,29952,518,74592,104544
train,957,17,13056,98,14112,27168
train,958,79,60672,2123,305712,366384
train,959,23,17664,180,25920,43584
train,960,69,52992,1620,233280,286272
train,961,58,44544,1145,164880,209424
train,962,23,17664,180,25920,43584
train,963,27,20736,248,35712,56448
train,964,93,71424,2942,423648,495072
train,965,70,53760,1667,240048,293808
train,966,60,46080,1225,176400,222480
train,967,16,12288,87,12528,24816
train,968,26,19968,230,33120,53088
train,969,26,19968,230,33120,53088
train,970,144,110592,7054,1015776,1126368
train,971,15,11520,77,11088,22608
train,972,27,20736,248,35712,56448
train,973,58,44544,1145,164880,209424
train,974,19,14592,123,17712,32304
train,975,50,38400,851,122544,160944
train,976,58,44544,1145,164880,209424
train,977,12,9216,49,7056,16272
train,978,71,54528,1715,246960,301488
train,979,41,31488,572,82368,113856
train,980,17,13056,98,14112,27168
train,981,37,28416,466,67104,95520
train,982,20,15360,136,19584,34944
train,983,17,13056,98,14112,27168
train,984,24,18432,196,28224,46656
train,985,140,107520,6668,960192,1067712
train,986,48,36864,784,112896,149760
train,987,160,122880,8709,1254096,1376976
train,988,95,72960,3070,442080,515040
train,989,140,107520,6668,960192,1067712
train,990,22,16896,165,23760,40656
train,991,37,28416,466,67104,95520
train,992,52,39936,920,132480,172416
train,993,51,39168,885,127440,166608
train,994,107,82176,3895,560880,643056
train,995,21,16128,150,21600,37728
train,996,24,18432,196,28224,46656
train,997,12,9216,49,7056,16272
train,998,20,15360,136,19584,34944
train,999,21,16128,150,21600,37728
train,1000,39,29952,518,74592,104544
train,1001,78,59904,2070,298080,357984
train,1002,67,51456,1527,219888,271344
train,1003,119,91392,4818,693792,785184
train,1004,78,59904,2070,298080,357984
train,1005,52,39936,920,132480,172416
train,1006,105,80640,3751,540144,620784
train,1007,47,36096,752,108288,144384
train,1008,14,10752,67,9648,20400
train,1009,80,61440,2177,313488,374928
train,1010,42,32256,600,86400,118656
train,1011,200,153600,13608,1959552,2113152
train,1012,269,206592,23263,3349872,3556464
train,1013,66,50688,1482,213408,264096
train,1014,62,47616,1308,188352,235968
train,1015,22,16896,165,23760,40656
train,1016,40,30720,544,78336,109056
train,1017,86,66048,2516,362304,428352
train,1018,13,9984,58,8352,18336
train,1019,29,22272,286,41184,63456
train,1020,103,79104,3609,519696,598800
train,1021,292,224256,25144,3620736,3844992
train,1022,15,11520,77,11088,22608
train,1023,185,142080,11643,1676592,1818672
train,1024,10,7680,34,4896,12576
train,1025,26,19968,230,33120,53088
train,1026,78,59904,2070,298080,357984
train,1027,51,39168,885,127440,166608
train,1028,46,35328,720,103680,139008
train,1029,64,49152,1394,200736,249888
train,1030,40,30720,544,78336,109056
train,1031,23,17664,180,25920,43584
train,1032,99,76032,3334,480096,556128
train,1033,23,17664,180,25920,43584
train,1034,55,42240,1029,148176,190416
train,1035,35,26880,417,60048,86928
train,1036,71,54528,1715,246960,301488
train,1037,25,19200,213,30672,49872
train,1038,126,96768,5401,777744,874512
train,1039,60,46080,1225,176400,222480
train,1040,11,8448,41,5904,14352
train,1041,16,12288,87,12528,24816
train,1042,50,38400,851,122544,160944
train,1043,25,19200,213,30672,49872
train,1044,58,44544,1145,164880,209424
train,1045,77,59136,2017,290448,349584
train,1046,25,19200,213,30672,49872
train,1047,72,55296,1764,254016,309312
train,1048,69,52992,1620,233280,286272
train,1049,23,17664,180,25920,43584
train,1050,76,58368,1965,282960,341328
train,1051,111,85248,4192,603648,688896
train,1052,64,49152,1394,200736,249888
train,1053,61,46848,1266,182304,229152
train,1054,32,24576,349,50256,74832
train,1055,48,36864,784,112896,149760
train,1056,68,52224,1573,226512,278736
train,1057,55,42240,1029,148176,190416
train,1058,74,56832,1863,268272,325104
train,1059,27,20736,248,35712,56448
train,1060,19,14592,123,17712,32304
train,1061,58,44544,1145,164880,209424
train,1062,48,36864,784,112896,149760
train,1063,81,62208,2232,321408,383616
train,1064,147,112896,7351,1058544,1171440
train,1065,21,16128,150,21600,37728
train,1066,22,16896,165,23760,40656
train,1067,262,201216,22238,3202272,3403488
train,1068,96,73728,3135,451440,525168
train,1069,42,32256,600,86400,118656
train,1070,30,23040,306,44064,67104
train,1071,21,16128,150,21600,37728
train,1072,118,90624,4737,682128,772752
train,1073,50,38400,851,122544,160944
train,1074,85,65280,2458,353952,419232
train,1075,146,112128,7252,1044288,1156416
train,1076,9,6912,28,4032,10944
train,1077,29,22272,286,41184,63456
train,1078,18,13824,110,15840,29664
train,1079,10,7680,34,4896,12576
train,1080,20,15360,136,19584,34944
train,1081,18,13824,110,15840,29664
train,1082,44,33792,659,94896,128688
train,1083,55,42240,1029,148176,190416
train,1084,199,152832,13472,1939968,2092800
train,1085,35,26880,417,60048,86928
train,1086,153,117504,7964,1146816,1264320
train,1087,33,25344,371,53424,78768
train,1088,22,16896,165,23760,40656
train,1089,138,105984,6479,932976,1038960
train,1090,38,29184,491,70704,99888
train,1091,21,16128,150,21600,37728
train,1092,73,56064,1813,261072,317136
train,1093,23,17664,180,25920,43584
train,1094,46,35328,720,103680,139008
train,1095,127,97536,5487,790128,887664
train,1096,16,12288,87,12528,24816
train,1097,36,27648,441,63504,91152
train,1098,20,15360,136,19584,34944
train,1099,21,16128,150,21600,37728
train,1100,23,17664,180,25920,43584
train,1101,34,26112,393,56592,82704
train,1102,20,15360,136,19584,34944
train,1103,12,9216,49,7056,16272
train,1104,77,59136,2017,290448,349584
train,1105,24,18432,196,28224,46656
train,1106,104,79872,3680,529920,609792
train,1107,37,28416,466,67104,95520
train,1108,86,66048,2516,362304,428352
train,1109,41,31488,572,82368,113856
train,1110,20,15360,136,19584,34944
train,1111,23,17664,180,25920,43584
train,1112,54,41472,992,142848,184320
train,1113,40,30720,544,78336,109056
train,1114,18,13824,110,15840,29664
train,1115,130,99840,5749,827856,927696
train,1116,352,270336,34642,4988448,5258784
train,1117,15,11520,77,11088,22608
train,1118,67,51456,1527,219888,271344
train,1119,56,43008,1067,153648,196656
train,1120,49,37632,817,117648,155280
train,1121,33,25344,371,53424,78768
train,1122,131,100608,5838,840672,941280
train,1123,28,21504,267,38448,59952
train,1124,266,204288,20935,3014640,3218928
train,1125,48,36864,784,112896,149760
train,1126,23,17664,180,25920,43584
train,1127,36,27648,441,63504,91152
train,1128,74,56832,1863,268272,325104
train,1129,74,56832,1863,268272,325104
train,1130,141,108288,6763,973872,1082160
train,1131,19,14592,123,17712,32304
train,1132,29,22272,286,41184,63456
train,1133,13,9984,58,8352,18336
train,1134,45,34560,689,99216,133776
train,1135,24,18432,196,28224,46656
train,1136,68,52224,1573,226512,278736
train,1137,22,16896,165,23760,40656
train,1138,23,17664,180,25920,43584
train,1139,17,13056,98,14112,27168
train,1140,22,16896,165,23760,40656
train,1141,28,21504,267,38448,59952
train,1142,249,191232,19235,2769840,2961072
train,1143,8,6144,22,3168,9312
train,1144,142,109056,6860,987840,1096896
train,1145,94,72192,3006,432864,505056
train,1146,110,84480,4116,592704,677184
train,1147,71,54528,1715,246960,301488
train,1148,47,36096,752,108288,144384
train,1149,38,29184,491,70704,99888
train,1150,18,13824,110,15840,29664
train,1151,71,54528,1715,246960,301488
train,1152,59,45312,1184,170496,215808
train,1153,150,115200,7654,1102176,1217376
train,1154,71,54528,1715,246960,301488
train,1155,73,56064,1813,261072,317136
train,1156,54,41472,992,142848,184320
train,1157,18,13824,110,15840,29664
train,1158,48,36864,784,112896,149760
train,1159,70,53760,1667,240048,293808
train,1160,54,41472,992,142848,184320
train,1161,20,15360,136,19584,34944
train,1162,159,122112,8600,1238400,1360512
train,1163,25,19200,213,30672,49872
train,1164,50,38400,851,122544,160944
train,1165,70,53760,1667,240048,293808
train,1166,63,48384,1350,194400,242784
train,1167,23,17664,180,25920,43584
train,1168,24,18432,196,28224,46656
train,1169,24,18432,196,28224,46656
train,1170,32,24576,349,50256,74832
train,1171,96,73728,3135,451440,525168
train,1172,55,42240,1029,148176,190416
train,1173,95,72960,3070,442080,515040
train,1174,31,23808,327,47088,70896
train,1175,61,46848,1266,182304,229152
train,1176,28,21504,267,38448,59952
train,1177,53,40704,956,137664,178368
train,1178,75,57600,1914,275616,333216
train,1179,25,19200,213,30672,49872
train,1180,334,256512,31894,4592736,4849248
train,1181,19,14592,123,17712,32304
train,1182,43,33024,629,90576,123600
train,1183,23,17664,180,25920,43584
train,1184,170,130560,9832,1415808,1546368
train,1185,46,35328,720,103680,139008
train,1186,50,38400,851,122544,160944
train,1187,20,15360,136,19584,34944
train,1188,24,18432,196,28224,46656
train,1189,168,129024,9602,1382688,1511712
train,1190,176,135168,10538,1517472,1652640
train,1191,80,61440,2177,313488,374928
train,1192,12,9216,49,7056,16272
train,1193,65,49920,1437,206928,256848
train,1194,55,42240,1029,148176,190416
train,1195,12,9216,49,7056,16272
train,1196,110,84480,4116,592704,677184
train,1197,14,10752,67,9648,20400
train,1198,21,16128,150,21600,37728
train,1199,68,52224,1573,226512,278736
train,1200,35,26880,417,60048,86928
train,1201,44,33792,659,94896,128688
train,1202,60,46080,1225,176400,222480
train,1203,73,56064,1813,261072,317136
train,1204,56,43008,1067,153648,196656
train,1205,193,148224,12672,1824768,1972992
train,1206,275,211200,24008,3457152,3668352
train,1207,36,27648,441,63504,91152
train,1208,234,179712,18138,2611872,2791584
train,1209,56,43008,1067,153648,196656
train,1210,78,59904,2070,298080,357984
train,1211,30,23040,306,44064,67104
train,1212,49,37632,817,117648,155280
train,1213,69,52992,1620,233280,286272
train,1214,84,64512,2401,345744,410256
train,1215,13,9984,58,8352,18336
train,1216,157,120576,8385,1207440,1328016
train,1217,23,17664,180,25920,43584
train,1218,12,9216,49,7056,16272
train,1219,10,7680,34,4896,12576
train,1220,66,50688,1482,213408,264096
train,1221,61,46848,1266,182304,229152
train,1222,125,96000,5316,765504,861504
train,1223,131,100608,5838,840672,941280
train,1224,145,111360,7153,1030032,1141392
train,1225,25,19200,213,30672,49872
train,1226,40,30720,544,78336,109056
train,1227,135,103680,6200,892800,996480
train,1228,73,56064,1813,261072,317136
train,1229,154,118272,8068,1161792,1280064
train,1230,26,19968,230,33120,53088
train,1231,147,112896,7351,1058544,1171440
train,1232,120,92160,4899,705456,797616
train,1233,11,8448,41,5904,14352
train,1234,25,19200,213,30672,49872
train,1235,57,43776,1105,159120,202896
train,1236,72,55296,1764,254016,309312
train,1237,12,9216,49,7056,16272
train,1238,69,52992,1620,233280,286272
train,1239,23,17664,180,25920,43584
train,1240,171,131328,9948,1432512,1563840
train,1241,67,51456,1527,219888,271344
train,1242,33,25344,371,53424,78768
train,1243,55,42240,1029,148176,190416
train,1244,44,33792,659,94896,128688
train,1245,143,109824,6957,1001808,1111632
train,1246,62,47616,1308,188352,235968
train,1247,61,46848,1266,182304,229152
train,1248,348,267264,35121,5057424,5324688
train,1249,81,62208,2232,321408,383616
train,1250,86,66048,2516,362304,428352
train,1251,24,18432,196,28224,46656
train,1252,57,43776,1105,159120,202896
train,1253,78,59904,2070,298080,357984
train,1254,24,18432,196,28224,46656
train,1255,31,23808,327,47088,70896
train,1256,92,70656,2880,414720,485376
train,1257,21,16128,150,21600,37728
train,1258,38,29184,491,70704,99888
train,1259,99,76032,3334,480096,556128
train,1260,23,17664,180,25920,43584
train,1261,40,30720,544,78336,109056
train,1262,124,95232,5231,753264,848496
train,1263,27,20736,248,35712,56448
train,1264,23,17664,180,25920,43584
train,1265,80,61440,2177,313488,374928
train,1266,38,29184,491,70704,99888
train,1267,26,19968,230,33120,53088
train,1268,37,28416,466,67104,95520
train,1269,25,19200,213,30672,49872
train,1270,46,35328,720,103680,139008
train,1271,106,81408,3823,550512,631920
train,1272,37,28416,466,67104,95520
train,1273,88,67584,2635,379440,447024
train,1274,57,43776,1105,159120,202896
train,1275,64,49152,1394,200736,249888
train,1276,21,16128,150,21600,37728
train,1277,118,90624,4737,682128,772752
train,1278,159,122112,8600,1238400,1360512
train,1279,31,23808,327,47088,70896
train,1280,75,57600,1914,275616,333216
train,1281,25,19200,213,30672,49872
train,1282,16,12288,87,12528,24816
train,1283,64,49152,1394,200736,249888
train,1284,28,21504,267,38448,59952
train,1285,117,89856,4657,670608,760464
train,1286,37,28416,466,67104,95520
train,1287,64,49152,1394,200736,249888
train,1288,208,159744,14718,2119392,2279136
train,1289,142,109056,6860,987840,1096896
train,1290,34,26112,393,56592,82704
train,1291,29,22272,286,41184,63456
train,1292,24,18432,196,28224,46656
train,1293,53,40704,956,137664,178368
train,1294,36,27648,441,63504,91152
train,1295,27,20736,248,35712,56448
train,1296,79,60672,2123,305712,366384
train,1297,22,16896,165,23760,40656
train,1298,24,18432,196,28224,46656
train,1299,12,9216,49,7056,16272
train,1300,31,23808,327,47088,70896
train,1301,85,65280,2458,353952,419232
train,1302,25,19200,213,30672,49872
train,1303,14,10752,67,9648,20400
train,1304,21,16128,150,21600,37728
train,1305,224,172032,17070,2458080,2630112
train,1306,39,29952,518,74592,104544
train,1307,162,124416,8928,1285632,1410048
train,1308,35,26880,417,60048,86928
train,1309,23,17664,180,25920,43584
train,1310,24,18432,196,28224,46656
train,1311,22,16896,165,23760,40656
train,1312,391,300288,42050,6055200,6355488
train,1313,114,87552,4421,636624,724176
train,1314,21,16128,150,21600,37728
train,1315,42,32256,600,86400,118656
train,1316,45,34560,689,99216,133776
train,1317,16,12288,87,12528,24816
train,1318,67,51456,1527,219888,271344
train,1319,78,59904,2070,298080,357984
train,1320,128,98304,5574,802656,900960
train,1321,39,29952,518,74592,104544
train,1322,26,19968,230,33120,53088
train,1323,12,9216,49,7056,16272
train,1324,71,54528,1715,246960,301488
train,1325,35,26880,417,60048,86928
train,1326,72,55296,1764,254016,309312
train,1327,68,52224,1573,226512,278736
train,1328,25,19200,213,30672,49872
train,1329,212,162816,13591,1957104,2119920
train,1330,126,96768,5401,777744,874512
train,1331,36,27648,441,63504,91152
train,1332,146,112128,7252,1044288,1156416
train,1333,10,7680,34,4896,12576
train,1334,110,84480,4116,592704,677184
train,1335,65,49920,1437,206928,256848
train,1336,8,6144,22,3168,9312
train,1337,82,62976,2288,329472,392448
train,1338,31,23808,327,47088,70896
train,1339,50,38400,851,122544,160944
train,1340,47,36096,752,108288,144384
train,1341,50,38400,851,122544,160944
train,1342,92,70656,2880,414720,485376
train,1343,20,15360,136,19584,34944
train,1344,50,38400,851,122544,160944
train,1345,45,34560,689,99216,133776
train,1346,38,29184,491,70704,99888
train,1347,54,41472,992,142848,184320
train,1348,26,19968,230,33120,53088
train,1349,181,139008,11145,1604880,1743888
train,1350,101,77568,3470,499680,577248
train,1351,174,133632,10300,1483200,1616832
train,1352,50,38400,851,122544,160944
train,1353,30,23040,306,44064,67104
train,1354,20,15360,136,19584,34944
train,1355,56,43008,1067,153648,196656
train,1356,31,23808,327,47088,70896
train,1357,111,85248,4192,603648,688896
train,1358,35,26880,417,60048,86928
train,1359,109,83712,4042,582048,665760
train,1360,28,21504,267,38448,59952
train,1361,80,61440,2177,313488,374928
train,1362,54,41472,992,142848,184320
train,1363,54,41472,992,142848,184320
train,1364,129,99072,5661,815184,914256
train,1365,27,20736,248,35712,56448
train,1366,77,59136,2017,290448,349584
train,1367,48,36864,784,112896,149760
train,1368,185,142080,11643,1676592,1818672
train,1369,33,25344,371,53424,78768
train,1370,30,23040,306,44064,67104
train,1371,259,198912,20634,2971296,3170208
train,1372,144,110592,7054,1015776,1126368
train,1373,42,32256,600,86400,118656
train,1374,26,19968,230,33120,53088
train,1375,72,55296,1764,254016,309312
train,1376,62,47616,1308,188352,235968
train,1377,65,49920,1437,206928,256848
train,1378,52,39936,920,132480,172416
train,1379,33,25344,371,53424,78768
train,1380,49,37632,817,117648,155280
train,1381,21,16128,150,21600,37728
train,1382,26,19968,230,33120,53088
train,1383,55,42240,1029,148176,190416
train,1384,14,10752,67,9648,20400
train,1385,215,165120,15725,2264400,2429520
train,1386,64,49152,1394,200736,249888
train,1387,51,39168,885,127440,166608
train,1388,21,16128,150,21600,37728
train,1389,159,122112,8600,1238400,1360512
train,1390,20,15360,136,19584,34944
train,1391,68,52224,1573,226512,278736
train,1392,71,54528,1715,246960,301488
train,1393,73,56064,1813,261072,317136
train,1394,45,34560,689,99216,133776
train,1395,293,225024,26005,3744720,3969744
train,1396,20,15360,136,19584,34944
train,1397,162,124416,8928,1285632,1410048
train,1398,19,14592,123,17712,32304
train,1399,108,82944,3968,571392,654336
train,1400,54,41472,992,142848,184320
train,1401,24,18432,196,28224,46656
train,1402,139,106752,6573,946512,1053264
train,1403,24,18432,196,28224,46656
train,1404,13,9984,58,8352,18336
train,1405,80,61440,2177,313488,374928
train,1406,52,39936,920,132480,172416
train,1407,28,21504,267,38448,59952
train,1408,31,23808,327,47088,70896
train,1409,136,104448,6292,906048,1010496
train,1410,33,25344,371,53424,78768
train,1411,66,50688,1482,213408,264096
train,1412,152,116736,7860,1131840,1248576
train,1413,28,21504,267,38448,59952
train,1414,373,286464,36761,5293584,5580048
train,1415,52,39936,920,132480,172416
train,1416,113,86784,4344,625536,712320
train,1417,374,287232,38135,5491440,5778672
train,1418,22,16896,165,23760,40656
train,1419,61,46848,1266,182304,229152
train,1420,29,22272,286,41184,63456
train,1421,28,21504,267,38448,59952
train,1422,77,59136,2017,290448,349584
train,1423,40,30720,544,78336,109056
train,1424,27,20736,248,35712,56448
train,1425,64,49152,1394,200736,249888
train,1426,117,89856,4657,670608,760464
train,1427,37,28416,466,67104,95520
train,1428,107,82176,3895,560880,643056
train,1429,34,26112,393,56592,82704
train,1430,25,19200,213,30672,49872
train,1431,51,39168,885,127440,166608
train,1432,83,63744,2344,337536,401280
train,1433,66,50688,1482,213408,264096
train,1434,35,26880,417,60048,86928
train,1435,71,54528,1715,246960,301488
train,1436,76,58368,1965,282960,341328
train,1437,38,29184,491,70704,99888
train,1438,22,16896,165,23760,40656
train,1439,42,32256,600,86400,118656
train,1440,338,259584,30790,4433760,4693344
train,1441,55,42240,1029,148176,190416
train,1442,164,125952,9150,1317600,1443552
train,1443,12,9216,49,7056,16272
train,1444,36,27648,441,63504,91152
train,1445,24,18432,196,28224,46656
train,1446,68,52224,1573,226512,278736
train,1447,66,50688,1482,213408,264096
train,1448,26,19968,230,33120,53088
train,1449,209,160512,14860,2139840,2300352
train,1450,85,65280,2458,353952,419232
train,1451,89,68352,2695,388080,456432
train,1452,71,54528,1715,246960,301488
train,1453,41,31488,572,82368,113856
train,1454,24,18432,196,28224,46656
train,1455,57,43776,1105,159120,202896
train,1456,51,39168,885,127440,166608
train,1457,21,16128,150,21600,37728
train,1458,96,73728,3135,451440,525168
train,1459,36,27648,441,63504,91152
train,1460,32,24576,349,50256,74832
train,1461,83,63744,2344,337536,401280
train,1462,36,27648,441,63504,91152
train,1463,39,29952,518,74592,104544
train,1464,74,56832,1863,268272,325104
train,1465,19,14592,123,17712,32304
train,1466,41,31488,572,82368,113856
train,1467,32,24576,349,50256,74832
train,1468,142,109056,6860,987840,1096896
train,1469,56,43008,1067,153648,196656
train,1470,43,33024,629,90576,123600
train,1471,44,33792,659,94896,128688
train,1472,69,52992,1620,233280,286272
train,1473,103,79104,3609,519696,598800
train,1474,39,29952,518,74592,104544
train,1475,261,200448,21023,3027312,3227760
train,1476,26,19968,230,33120,53088
train,1477,85,65280,2458,353952,419232
train,1478,26,19968,230,33120,53088
train,1479,141,108288,6763,973872,1082160
train,1480,35,26880,417,60048,86928
train,1481,19,14592,123,17712,32304
train,1482,114,87552,4421,636624,724176
train,1483,9,6912,28,4032,10944
train,1484,272,208896,21670,3120480,3329376
train,1485,122,93696,5064,729216,822912
train,1486,7,5376,17,2448,7824
train,1487,15,11520,77,11088,22608
train,1488,33,25344,371,53424,78768
train,1489,52,39936,920,132480,172416
train,1490,39,29952,518,74592,104544
train,1491,34,26112,393,56592,82704
train,1492,79,60672,2123,305712,366384
train,1493,43,33024,629,90576,123600
train,1494,45,34560,689,99216,133776
train,1495,53,40704,956,137664,178368
train,1496,30,23040,306,44064,67104
train,1497,240,184320,19595,2821680,3006000
train,1498,57,43776,1105,159120,202896
train,1499,28,21504,267,38448,59952
train,1500,65,49920,1437,206928,256848
train,1501,17,13056,98,14112,27168
train,1502,31,23808,327,47088,70896
train,1503,39,29952,518,74592,104544
train,1504,104,79872,3680,529920,609792
train,1505,44,33792,659,94896,128688
train,1506,63,48384,1350,194400,242784
train,1507,162,124416,8928,1285632,1410048
train,1508,26,19968,230,33120,53088
train,1509,63,48384,1350,194400,242784
train,1510,307,235776,27263,3925872,4161648
train,1511,146,112128,7252,1044288,1156416
train,1512,69,52992,1620,233280,286272
train,1513,51,39168,885,127440,166608
train,1514,22,16896,165,23760,40656
train,1515,61,46848,1266,182304,229152
train,1516,38,29184,491,70704,99888
train,1517,66,50688,1482,213408,264096
train,1518,242,185856,19176,2761344,2947200
train,1519,314,241152,31435,4526640,4767792
train,1520,24,18432,196,28224,46656
train,1521,122,93696,5064,729216,822912
train,1522,239,183552,19432,2798208,2981760
train,1523,31,23808,327,47088,70896
train,1524,103,79104,3609,519696,598800
train,1525,142,109056,6860,987840,1096896
train,1526,24,18432,196,28224,46656
train,1527,27,20736,248,35712,56448
train,1528,65,49920,1437,206928,256848
train,1529,73,56064,1813,261072,317136
train,1530,103,79104,3609,519696,598800
train,1531,165,126720,9262,1333728,1460448
train,1532,80,61440,2177,313488,374928
train,1533,32,24576,349,50256,74832
train,1534,67,51456,1527,219888,271344
train,1535,35,26880,417,60048,86928
train,1536,38,29184,491,70704,99888
train,1537,136,104448,6292,906048,1010496
train,1538,19,14592,123,17712,32304
train,1539,96,73728,3135,451440,525168
train,1540,19,14592,123,17712,32304
train,1541,25,19200,213,30672,49872
train,1542,15,11520,77,11088,22608
train,1543,26,19968,230,33120,53088
train,1544,129,99072,5661,815184,914256
train,1545,96,73728,3135,451440,525168
train,1546,22,16896,165,23760,40656
train,1547,75,57600,1914,275616,333216
train,1548,27,20736,248,35712,56448
train,1549,74,56832,1863,268272,325104
train,1550,13,9984,58,8352,18336
train,1551,67,51456,1527,219888,271344
train,1552,36,27648,441,63504,91152
train,1553,34,26112,393,56592,82704
train,1554,68,52224,1573,226512,278736
train,1555,232,178176,18311,2636784,2814960
train,1556,33,25344,371,53424,78768
train,1557,40,30720,544,78336,109056
train,1558,34,26112,393,56592,82704
train,1559,63,48384,1350,194400,242784
train,1560,63,48384,1350,194400,242784
train,1561,65,49920,1437,206928,256848
train,1562,21,16128,150,21600,37728
train,1563,231,177408,18153,2614032,2791440
train,1564,12,9216,49,7056,16272
train,1565,69,52992,1620,233280,286272
train,1566,162,124416,8928,1285632,1410048
train,1567,101,77568,3470,499680,577248
train,1568,13,9984,58,8352,18336
train,1569,44,33792,659,94896,128688
train,1570,27,20736,248,35712,56448
train,1571,12,9216,49,7056,16272
train,1572,104,79872,3680,529920,609792
train,1573,22,16896,165,23760,40656
train,1574,79,60672,2123,305712,366384
train,1575,89,68352,2695,388080,456432
train,1576,35,26880,417,60048,86928
train,1577,168,129024,9602,1382688,1511712
train,1578,139,106752,6573,946512,1053264
train,1579,72,55296,1764,254016,309312
train,1580,65,49920,1437,206928,256848
train,1581,130,99840,5749,827856,927696
train,1582,10,7680,34,4896,12576
train,1583,77,59136,2017,290448,349584
train,1584,37,28416,466,67104,95520
train,1585,35,26880,417,60048,86928
train,1586,63,48384,1350,194400,242784
train,1587,112,86016,4267,614448,700464
train,1588,69,52992,1620,233280,286272
train,1589,51,39168,885,127440,166608
train,1590,29,22272,286,41184,63456
train,1591,153,117504,7964,1146816,1264320
train,1592,73,56064,1813,261072,317136
train,1593,99,76032,3334,480096,556128
train,1594,11,8448,41,5904,14352
train,1595,105,80640,3751,540144,620784
train,1596,38,29184,491,70704,99888
train,1597,30,23040,306,44064,67104
train,1598,46,35328,720,103680,139008
train,1599,90,69120,2756,396864,465984
train,1600,70,53760,1667,240048,293808
train,1601,183,140544,11393,1640592,1781136
train,1602,99,76032,3334,480096,556128
train,1603,63,48384,1350,194400,242784
train,1604,23,17664,180,25920,43584
train,1605,51,39168,885,127440,166608
train,1606,174,133632,10300,1483200,1616832
train,1607,25,19200,213,30672,49872
train,1608,23,17664,180,25920,43584
train,1609,55,42240,1029,148176,190416
train,1610,47,36096,752,108288,144384
train,1611,158,121344,8493,1222992,1344336
train,1612,50,38400,851,122544,160944
train,1613,31,23808,327,47088,70896
train,1614,66,50688,1482,213408,264096
train,1615,37,28416,466,67104,95520
train,1616,28,21504,267,38448,59952
train,1617,17,13056,98,14112,27168
train,1618,19,14592,123,17712,32304
train,1619,21,16128,150,21600,37728
train,1620,69,52992,1620,233280,286272
train,1621,161,123648,8818,1269792,1393440
train,1622,25,19200,213,30672,49872
train,1623,169,129792,9716,1399104,1528896
train,1624,14,10752,67,9648,20400
train,1625,52,39936,920,132480,172416
train,1626,46,35328,720,103680,139008
train,1627,22,16896,165,23760,40656
train,1628,137,105216,6385,919440,1024656
train,1629,65,49920,1437,206928,256848
train,1630,12,9216,49,7056,16272
train,1631,87,66816,2575,370800,437616
train,1632,42,32256,600,86400,118656
train,1633,111,85248,4192,603648,688896
train,1634,41,31488,572,82368,113856
train,1635,52,39936,920,132480,172416
train,1636,31,23808,327,47088,70896
train,1637,84,64512,2401,345744,410256
train,1638,19,14592,123,17712,32304
train,1639,94,72192,3006,432864,505056
train,1640,66,50688,1482,213408,264096
train,1641,56,43008,1067,153648,196656
train,1642,73,56064,1813,261072,317136
train,1643,47,36096,752,108288,144384
train,1644,69,52992,1620,233280,286272
train,1645,36,27648,441,63504,91152
train,1646,12,9216,49,7056,16272
train,1647,57,43776,1105,159120,202896
train,1648,29,22272,286,41184,63456
train,1649,68,52224,1573,226512,278736
train,1650,52,39936,920,132480,172416
train,1651,72,55296,1764,254016,309312
train,1652,24,18432,196,28224,46656
train,1653,52,39936,920,132480,172416
train,1654,50,38400,851,122544,160944
train,1655,36,27648,441,63504,91152
train,1656,292,224256,25148,3621312,3845568
train,1657,27,20736,248,35712,56448
train,1658,77,59136,2017,290448,349584
train,1659,88,67584,2635,379440,447024
train,1660,199,152832,13472,1939968,2092800
train,1661,38,29184,491,70704,99888
train,1662,72,55296,1764,254016,309312
train,1663,17,13056,98,14112,27168
train,1664,57,43776,1105,159120,202896
train,1665,177,135936,10658,1534752,1670688
train,1666,24,18432,196,28224,46656
train,1667,12,9216,49,7056,16272
train,1668,79,60672,2123,305712,366384
train,1669,52,39936,920,132480,172416
train,1670,71,54528,1715,246960,301488
train,1671,27,20736,248,35712,56448
train,1672,30,23040,306,44064,67104
train,1673,30,23040,306,44064,67104
train,1674,261,200448,23174,3337056,3537504
train,1675,10,7680,34,4896,12576
train,1676,78,59904,2070,298080,357984
train,1677,80,61440,2177,313488,374928
train,1678,230,176640,17996,2591424,2768064
train,1679,27,20736,248,35712,56448
train,1680,51,39168,885,127440,166608
train,1681,242,185856,19923,2868912,3054768
train,1682,22,16896,165,23760,40656
train,1683,21,16128,150,21600,37728
train,1684,62,47616,1308,188352,235968
train,1685,33,25344,371,53424,78768
train,1686,25,19200,213,30672,49872
train,1687,42,32256,600,86400,118656
train,1688,64,49152,1394,200736,249888
train,1689,53,40704,956,137664,178368
train,1690,76,58368,1965,282960,341328
train,1691,33,25344,371,53424,78768
train,1692,65,49920,1437,206928,256848
train,1693,16,12288,87,12528,24816
train,1694,69,52992,1620,233280,286272
train,1695,21,16128,150,21600,37728
train,1696,32,24576,349,50256,74832
train,1697,59,45312,1184,170496,215808
train,1698,22,16896,165,23760,40656
train,1699,164,125952,9150,1317600,1443552
train,1700,131,100608,5838,840672,941280
train,1701,104,79872,3680,529920,609792
train,1702,79,60672,2123,305712,366384
train,1703,12,9216,49,7056,16272
train,1704,20,15360,136,19584,34944
train,1705,13,9984,58,8352,18336
train,1706,22,16896,165,23760,40656
train,1707,162,124416,8928,1285632,1410048
train,1708,11,8448,41,5904,14352
train,1709,331,254208,30737,4426128,4680336
train,1710,42,32256,600,86400,118656
train,1711,44,33792,659,94896,128688
train,1712,37,28416,466,67104,95520
train,1713,73,56064,1813,261072,317136
train,1714,74,56832,1863,268272,325104
train,1715,74,56832,1863,268272,325104
train,1716,94,72192,3006,432864,505056
train,1717,14,10752,67,9648,20400
train,1718,97,74496,3201,460944,535440
train,1719,39,29952,518,74592,104544
train,1720,16,12288,87,12528,24816
train,1721,28,21504,267,38448,59952
train,1722,97,74496,3201,460944,535440
train,1723,37,28416,466,67104,95520
train,1724,161,123648,8818,1269792,1393440
train,1725,28,21504,267,38448,59952
train,1726,108,82944,3968,571392,654336
train,1727,115,88320,4499,647856,736176
train,1728,47,36096,752,108288,144384
train,1729,92,70656,2880,414720,485376
train,1730,34,26112,393,56592,82704
train,1731,34,26112,393,56592,82704
train,1732,52,39936,920,132480,172416
train,1733,51,39168,885,127440,166608
train,1734,21,16128,150,21600,37728
train,1735,51,39168,885,127440,166608
train,1736,103,79104,3609,519696,598800
train,1737,162,124416,8928,1285632,1410048
train,1738,16,12288,87,12528,24816
train,1739,53,40704,956,137664,178368
train,1740,35,26880,417,60048,86928
train,1741,80,61440,2177,313488,374928
train,1742,66,50688,1482,213408,264096
train,1743,88,67584,2635,379440,447024
train,1744,172,132096,10064,1449216,1581312
train,1745,41,31488,572,82368,113856
train,1746,79,60672,2123,305712,366384
train,1747,57,43776,1105,159120,202896
train,1748,68,52224,1573,226512,278736
train,1749,48,36864,784,112896,149760
train,1750,92,70656,2880,414720,485376
train,1751,12,9216,49,7056,16272
train,1752,56,43008,1067,153648,196656
train,1753,17,13056,98,14112,27168
train,1754,74,56832,1863,268272,325104
train,1755,31,23808,327,47088,70896
train,1756,27,20736,248,35712,56448
train,1757,24,18432,196,28224,46656
train,1758,120,92160,4899,705456,797616
train,1759,26,19968,230,33120,53088
train,1760,68,52224,1573,226512,278736
train,1761,34,26112,393,56592,82704
train,1762,31,23808,328,47232,71040
train,1763,25,19200,213,30672,49872
train,1764,45,34560,689,99216,133776
train,1765,52,39936,920,132480,172416
train,1766,20,15360,136,19584,34944
train,1767,53,40704,956,137664,178368
train,1768,96,73728,3135,451440,525168
train,1769,43,33024,629,90576,123600
train,1770,153,117504,7964,1146816,1264320
train,1771,186,142848,11769,1694736,1837584
train,1772,20,15360,136,19584,34944
train,1773,46,35328,720,103680,139008
train,1774,146,112128,7252,1044288,1156416
train,1775,11,8448,41,5904,14352
train,1776,17,13056,98,14112,27168
train,1777,45,34560,689,99216,133776
train,1778,44,33792,659,94896,128688
train,1779,55,42240,1029,148176,190416
train,1780,75,57600,1914,275616,333216
train,1781,288,221184,23835,3432240,3653424
train,1782,63,48384,1350,194400,242784
train,1783,64,49152,1394,200736,249888
train,1784,32,24576,349,50256,74832
train,1785,64,49152,1394,200736,249888
train,1786,45,34560,689,99216,133776
train,1787,38,29184,491,70704,99888
train,1788,25,19200,213,30672,49872
train,1789,108,82944,3968,571392,654336
train,1790,224,172032,17070,2458080,2630112
train,1791,46,35328,720,103680,139008
train,1792,97,74496,3201,460944,535440
train,1793,40,30720,544,78336,109056
train,1794,64,49152,1394,200736,249888
train,1795,118,90624,4737,682128,772752
train,1796,72,55296,1764,254016,309312
train,1797,43,33024,629,90576,123600
train,1798,114,87552,4421,636624,724176
train,1799,19,14592,123,17712,32304
train,1800,148,113664,7452,1073088,1186752
train,1801,18,13824,110,15840,29664
train,1802,69,52992,1620,233280,286272
train,1803,29,22272,286,41184,63456
train,1804,90,69120,2756,396864,465984
train,1805,97,74496,3201,460944,535440
train,1806,22,16896,165,23760,40656
train,1807,32,24576,349,50256,74832
train,1808,50,38400,851,122544,160944
train,1809,43,33024,629,90576,123600
train,1810,69,52992,1620,233280,286272
train,1811,106,81408,3823,550512,631920
train,1812,57,43776,1105,159120,202896
train,1813,112,86016,4267,614448,700464
train,1814,12,9216,49,7056,16272
train,1815,16,12288,87,12528,24816
train,1816,63,48384,1350,194400,242784
train,1817,250,192000,21262,3061728,3253728
train,1818,175,134400,10418,1500192,1634592
train,1819,38,29184,491,70704,99888
train,1820,96,73728,3135,451440,525168
train,1821,51,39168,885,127440,166608
train,1822,74,56832,1863,268272,325104
train,1823,23,17664,180,25920,43584
train,1824,105,80640,3751,540144,620784
train,1825,20,15360,136,19584,34944
train,1826,17,13056,98,14112,27168
train,1827,24,18432,196,28224,46656
train,1828,44,33792,659,94896,128688
train,1829,33,25344,371,53424,78768
train,1830,79,60672,2123,305712,366384
train,1831,23,17664,180,25920,43584
train,1832,29,22272,286,41184,63456
train,1833,232,178176,16520,2378880,2557056
train,1834,116,89088,4578,659232,748320
train,1835,90,69120,2756,396864,465984
train,1836,67,51456,1527,219888,271344
train,1837,151,115968,7757,1117008,1232976
train,1838,41,31488,572,82368,113856
train,1839,87,66816,2575,370800,437616
train,1840,246,188928,18563,2673072,2862000
train,1841,20,15360,136,19584,34944
train,1842,190,145920,12281,1768464,1914384
train,1843,15,11520,77,11088,22608
train,1844,43,33024,629,90576,123600
train,1845,121,92928,4981,717264,810192
train,1846,20,15360,136,19584,34944
train,1847,47,36096,752,108288,144384
train,1848,75,57600,1914,275616,333216
train,1849,317,243456,28287,4073328,4316784
train,1850,105,80640,3751,540144,620784
train,1851,220,168960,15043,2166192,2335152
train,1852,349,268032,33214,4782816,5050848
train,1853,24,18432,196,28224,46656
train,1854,49,37632,817,117648,155280
train,1855,66,50688,1482,213408,264096
train,1856,46,35328,720,103680,139008
train,1857,35,26880,417,60048,86928
train,1858,23,17664,180,25920,43584
train,1859,23,17664,180,25920,43584
train,1860,51,39168,885,127440,166608
train,1861,21,16128,150,21600,37728
train,1862,45,34560,689,99216,133776
train,1863,16,12288,87,12528,24816
train,1864,14,10752,67,9648,20400
train,1865,49,37632,817,117648,155280
train,1866,33,25344,371,53424,78768
train,1867,16,12288,87,12528,24816
train,1868,47,36096,752,108288,144384
train,1869,322,247296,29652,4269888,4517184
train,1870,18,13824,110,15840,29664
train,1871,71,54528,1715,246960,301488
train,1872,58,44544,1145,164880,209424
train,1873,44,33792,659,94896,128688
train,1874,12,9216,49,7056,16272
train,1875,224,172032,17070,2458080,2630112
train,1876,24,18432,196,28224,46656
train,1877,234,179712,18628,2682432,2862144
train,1878,150,115200,7654,1102176,1217376
train,1879,21,16128,150,21600,37728
train,1880,84,64512,2401,345744,410256
train,1881,74,56832,1863,268272,325104
train,1882,61,46848,1266,182304,229152
train,1883,103,79104,3609,519696,598800
train,1884,15,11520,77,11088,22608
train,1885,16,12288,87,12528,24816
train,1886,51,39168,885,127440,166608
train,1887,16,12288,87,12528,24816
train,1888,16,12288,87,12528,24816
train,1889,49,37632,817,117648,155280
train,1890,79,60672,2123,305712,366384
train,1891,32,24576,349,50256,74832
train,1892,78,59904,2070,298080,357984
train,1893,25,19200,213,30672,49872
train,1894,20,15360,136,19584,34944
train,1895,43,33024,629,90576,123600
train,1896,23,17664,180,25920,43584
train,1897,71,54528,1715,246960,301488
train,1898,56,43008,1067,153648,196656
train,1899,105,80640,3751,540144,620784
train,1900,42,32256,600,86400,118656
train,1901,120,92160,4899,705456,797616
train,1902,86,66048,2516,362304,428352
train,1903,48,36864,784,112896,149760
train,1904,20,15360,136,19584,34944
train,1905,17,13056,98,14112,27168
train,1906,55,42240,1029,148176,190416
train,1907,24,18432,196,28224,46656
train,1908,22,16896,165,23760,40656
train,1909,104,79872,3680,529920,609792
train,1910,42,32256,600,86400,118656
train,1911,64,49152,1394,200736,249888
train,1912,38,29184,491,70704,99888
train,1913,38,29184,491,70704,99888
train,1914,47,36096,752,108288,144384
train,1915,56,43008,1067,153648,196656
train,1916,68,52224,1573,226512,278736
train,1917,24,18432,196,28224,46656
train,1918,28,21504,267,38448,59952
train,1919,45,34560,689,99216,133776
train,1920,110,84480,4116,592704,677184
train,1921,107,82176,3895,560880,643056
train,1922,22,16896,165,23760,40656
train,1923,117,89856,4657,670608,760464
train,1924,160,122880,8709,1254096,1376976
train,1925,136,104448,6292,906048,1010496
train,1926,30,23040,306,44064,67104
train,1927,255,195840,22121,3185424,3381264
train,1928,31,23808,327,47088,70896
train,1929,110,84480,4116,592704,677184
train,1930,105,80640,3751,540144,620784
train,1931,38,29184,491,70704,99888
train,1932,83,63744,2344,337536,401280
train,1933,132,101376,5928,853632,955008
train,1934,68,52224,1573,226512,278736
train,1935,74,56832,1863,268272,325104
train,1936,28,21504,267,38448,59952
train,1937,47,36096,752,108288,144384
train,1938,82,62976,2288,329472,392448
train,1939,29,22272,286,41184,63456
train,1940,77,59136,2017,290448,349584
train,1941,159,122112,8600,1238400,1360512
train,1942,72,55296,1764,254016,309312
train,1943,15,11520,77,11088,22608
train,1944,28,21504,267,38448,59952
train,1945,45,34560,689,99216,133776
train,1946,53,40704,956,137664,178368
train,1947,21,16128,150,21600,37728
train,1948,22,16896,165,23760,40656
train,1949,50,38400,851,122544,160944
train,1950,50,38400,851,122544,160944
train,1951,74,56832,1863,268272,325104
train,1952,20,15360,136,19584,34944
train,1953,35,26880,417,60048,86928
train,1954,15,11520,77,11088,22608
train,1955,54,41472,992,142848,184320
train,1956,189,145152,12152,1749888,1895040
train,1957,123,94464,5147,741168,835632
train,1958,175,134400,10418,1500192,1634592
train,1959,87,66816,2575,370800,437616
train,1960,24,18432,196,28224,46656
train,1961,27,20736,248,35712,56448
train,1962,98,75264,3267,470448,545712
train,1963,134,102912,6109,879696,982608
train,1964,48,36864,784,112896,149760
train,1965,14,10752,67,9648,20400
train,1966,31,23808,327,47088,70896
train,1967,33,25344,371,53424,78768
train,1968,80,61440,2177,313488,374928
train,1969,25,19200,213,30672,49872
train,1970,21,16128,150,21600,37728
train,1971,130,99840,5749,827856,927696
train,1972,72,55296,1764,254016,309312
train,1973,65,49920,1437,206928,256848
train,1974,192,147456,10298,1482912,1630368
train,1975,92,70656,2880,414720,485376
train,1976,38,29184,491,70704,99888
train,1977,46,35328,720,103680,139008
train,1978,35,26880,417,60048,86928
train,1979,22,16896,165,23760,40656
train,1980,69,52992,1620,233280,286272
train,1981,38,29184,491,70704,99888
train,1982,25,19200,213,30672,49872
train,1983,28,21504,267,38448,59952
train,1984,13,9984,58,8352,18336
train,1985,67,51456,1527,219888,271344
train,1986,19,14592,123,17712,32304
train,1987,63,48384,1350,194400,242784
train,1988,19,14592,123,17712,32304
train,1989,77,59136,2017,290448,349584
train,1990,24,18432,196,28224,46656
train,1991,64,49152,1394,200736,249888
train,1992,78,59904,2070,298080,357984
train,1993,86,66048,2516,362304,428352
train,1994,41,31488,572,82368,113856
train,1995,129,99072,5661,815184,914256
train,1996,153,117504,7964,1146816,1264320
train,1997,58,44544,1145,164880,209424
train,1998,37,28416,466,67104,95520
train,1999,81,62208,2232,321408,383616
train,2000,10,7680,34,4896,12576
train,2001,21,16128,150,21600,37728
train,2002,80,61440,2177,313488,374928
train,2003,11,8448,41,5904,14352
train,2004,111,85248,4192,603648,688896
train,2005,71,54528,1715,246960,301488
train,2006,73,56064,1813,261072,317136
train,2007,9,6912,28,4032,10944
train,2008,79,60672,2123,305712,366384
train,2009,30,23040,306,44064,67104
train,2010,60,46080,1225,176400,222480
train,2011,74,56832,1863,268272,325104
train,2012,107,82176,3895,560880,643056
train,2013,121,92928,4981,717264,810192
train,2014,46,35328,720,103680,139008
train,2015,113,86784,4344,625536,712320
train,2016,33,25344,371,53424,78768
train,2017,141,108288,6763,973872,1082160
train,2018,49,37632,817,117648,155280
train,2019,146,112128,7252,1044288,1156416
train,2020,23,17664,180,25920,43584
train,2021,56,43008,1067,153648,196656
train,2022,22,16896,165,23760,40656
train,2023,44,33792,659,94896,128688
train,2024,54,41472,992,142848,184320
train,2025,63,48384,1350,194400,242784
train,2026,25,19200,213,30672,49872
train,2027,62,47616,1308,188352,235968
train,2028,22,16896,165,23760,40656
train,2029,76,58368,1965,282960,341328
train,2030,121,92928,4981,717264,810192
train,2031,34,26112,393,56592,82704
train,2032,23,17664,180,25920,43584
train,2033,106,81408,3823,550512,631920
train,2034,165,126720,9262,1333728,1460448
train,2035,83,63744,2344,337536,401280
train,2036,16,12288,87,12528,24816
train,2037,225,172800,17222,2479968,2652768
train,2038,77,59136,2017,290448,349584
train,2039,30,23040,306,44064,67104
train,2040,113,86784,4344,625536,712320
train,2041,17,13056,98,14112,27168
train,2042,43,33024,629,90576,123600
train,2043,45,34560,689,99216,133776
train,2044,49,37632,817,117648,155280
train,2045,37,28416,466,67104,95520
train,2046,58,44544,1145,164880,209424
train,2047,26,19968,230,33120,53088
train,2048,73,56064,1813,261072,317136
train,2049,43,33024,629,90576,123600
train,2050,17,13056,98,14112,27168
train,2051,33,25344,371,53424,78768
train,2052,37,28416,466,67104,95520
train,2053,34,26112,393,56592,82704
train,2054,60,46080,1225,176400,222480
train,2055,66,50688,1482,213408,264096
train,2056,21,16128,150,21600,37728
train,2057,118,90624,4737,682128,772752
train,2058,12,9216,49,7056,16272
train,2059,60,46080,1225,176400,222480
train,2060,95,72960,3070,442080,515040
train,2061,31,23808,327,47088,70896
train,2062,36,27648,441,63504,91152
train,2063,39,29952,518,74592,104544
train,2064,72,55296,1764,254016,309312
train,2065,38,29184,491,70704,99888
train,2066,52,39936,920,132480,172416
train,2067,53,40704,956,137664,178368
train,2068,48,36864,784,112896,149760
train,2069,16,12288,87,12528,24816
train,2070,23,17664,180,25920,43584
train,2071,172,132096,10064,1449216,1581312
train,2072,47,36096,752,108288,144384
train,2073,207,158976,14577,2099088,2258064
train,2074,345,264960,32453,4673232,4938192
train,2075,55,42240,1029,148176,190416
train,2076,66,50688,1482,213408,264096
train,2077,73,56064,1813,261072,317136
train,2078,56,43008,1067,153648,196656
train,2079,45,34560,689,99216,133776
train,2080,33,25344,371,53424,78768
train,2081,45,34560,689,99216,133776
train,2082,19,14592,123,17712,32304
train,2083,34,26112,393,56592,82704
train,2084,163,125184,9039,1301616,1426800
train,2085,72,55296,1764,254016,309312
train,2086,13,9984,58,8352,18336
train,2087,15,11520,77,11088,22608
train,2088,69,52992,1620,233280,286272
train,2089,65,49920,1437,206928,256848
train,2090,185,142080,11643,1676592,1818672
train,2091,32,24576,349,50256,74832
train,2092,36,27648,441,63504,91152
train,2093,11,8448,41,5904,14352
train,2094,110,84480,4116,592704,677184
train,2095,26,19968,230,33120,53088
train,2096,35,26880,417,60048,86928
train,2097,116,89088,4578,659232,748320
train,2098,22,16896,165,23760,40656
train,2099,17,13056,98,14112,27168
train,2100,12,9216,49,7056,16272
train,2101,25,19200,213,30672,49872
train,2102,56,43008,1067,153648,196656
train,2103,49,37632,817,117648,155280
train,2104,57,43776,1105,159120,202896
train,2105,46,35328,720,103680,139008
train,2106,37,28416,466,67104,95520
train,2107,21,16128,150,21600,37728
train,2108,65,49920,1437,206928,256848
train,2109,80,61440,2177,313488,374928
train,2110,41,31488,572,82368,113856
train,2111,61,46848,1266,182304,229152
train,2112,43,33024,629,90576,123600
train,2113,76,58368,1965,282960,341328
train,2114,171,131328,9948,1432512,1563840
train,2115,91,69888,2817,405648,475536
train,2116,22,16896,165,23760,40656
train,2117,71,54528,1715,246960,301488
train,2118,69,52992,1620,233280,286272
train,2119,68,52224,1573,226512,278736
train,2120,55,42240,1029,148176,190416
train,2121,36,27648,441,63504,91152
train,2122,49,37632,817,117648,155280
train,2123,172,132096,10064,1449216,1581312
train,2124,173,132864,10182,1466208,1599072
train,2125,61,46848,1266,182304,229152
train,2126,77,59136,2017,290448,349584
train,2127,67,51456,1527,219888,271344
train,2128,89,68352,2695,388080,456432
train,2129,19,14592,123,17712,32304
train,2130,15,11520,77,11088,22608
train,2131,66,50688,1482,213408,264096
train,2132,80,61440,2177,313488,374928
train,2133,85,65280,2458,353952,419232
train,2134,14,10752,67,9648,20400
train,2135,31,23808,327,47088,70896
train,2136,11,8448,41,5904,14352
train,2137,17,13056,98,14112,27168
train,2138,35,26880,417,60048,86928
train,2139,20,15360,136,19584,34944
train,2140,22,16896,165,23760,40656
train,2141,108,82944,3968,571392,654336
train,2142,25,19200,213,30672,49872
train,2143,48,36864,784,112896,149760
train,2144,39,29952,518,74592,104544
train,2145,23,17664,180,25920,43584
train,2146,14,10752,67,9648,20400
train,2147,85,65280,2458,353952,419232
train,2148,17,13056,98,14112,27168
train,2149,297,228096,25055,3607920,3836016
train,2150,22,16896,165,23760,40656
train,2151,137,105216,6385,919440,1024656
train,2152,37,28416,466,67104,95520
train,2153,92,70656,2880,414720,485376
train,2154,36,27648,441,63504,91152
train,2155,143,109824,6957,1001808,1111632
train,2156,25,19200,213,30672,49872
train,2157,34,26112,393,56592,82704
train,2158,83,63744,2344,337536,401280
train,2159,29,22272,286,41184,63456
train,2160,173,132864,10182,1466208,1599072
train,2161,63,48384,1350,194400,242784
train,2162,39,29952,518,74592,104544
train,2163,80,61440,2177,313488,374928
train,2164,66,50688,1482,213408,264096
train,2165,77,59136,2017,290448,349584
train,2166,77,59136,2017,290448,349584
train,2167,32,24576,349,50256,74832
train,2168,69,52992,1620,233280,286272
train,2169,41,31488,572,82368,113856
train,2170,96,73728,3135,451440,525168
train,2171,31,23808,327,47088,70896
train,2172,51,39168,885,127440,166608
train,2173,198,152064,13337,1920528,2072592
train,2174,295,226560,24800,3571200,3797760
train,2175,88,67584,2635,379440,447024
train,2176,65,49920,1437,206928,256848
train,2177,64,49152,1394,200736,249888
train,2178,33,25344,371,53424,78768
train,2179,51,39168,885,127440,166608
train,2180,136,104448,6292,906048,1010496
train,2181,138,105984,6479,932976,1038960
train,2182,113,86784,4344,625536,712320
train,2183,113,86784,4344,625536,712320
train,2184,94,72192,3006,432864,505056
train,2185,29,22272,286,41184,63456
train,2186,51,39168,885,127440,166608
train,2187,11,8448,41,5904,14352
train,2188,9,6912,28,4032,10944
train,2189,16,12288,87,12528,24816
train,2190,22,16896,165,23760,40656
train,2191,304,233472,26354,3794976,4028448
train,2192,171,131328,9948,1432512,1563840
train,2193,245,188160,20420,2940480,3128640
train,2194,44,33792,659,94896,128688
train,2195,59,45312,1184,170496,215808
train,2196,48,36864,784,112896,149760
train,2197,23,17664,180,25920,43584
train,2198,87,66816,2575,370800,437616
train,2199,172,132096,10064,1449216,1581312
train,2200,24,18432,196,28224,46656
train,2201,50,38400,851,122544,160944
train,2202,52,39936,920,132480,172416
train,2203,16,12288,87,12528,24816
train,2204,55,42240,1029,148176,190416
train,2205,200,153600,13608,1959552,2113152
train,2206,59,45312,1184,170496,215808
train,2207,37,28416,466,67104,95520
train,2208,159,122112,8600,1238400,1360512
train,2209,115,88320,4499,647856,736176
train,2210,317,243456,30264,4358016,4601472
train,2211,42,32256,600,86400,118656
train,2212,48,36864,784,112896,149760
train,2213,110,84480,4116,592704,677184
train,2214,49,37632,817,117648,155280
train,2215,263,201984,21871,3149424,3351408
train,2216,20,15360,136,19584,34944
train,2217,51,39168,885,127440,166608
train,2218,62,47616,1308,188352,235968
train,2219,58,44544,1145,164880,209424
train,2220,25,19200,213,30672,49872
train,2221,23,17664,180,25920,43584
train,2222,114,87552,4421,636624,724176
train,2223,25,19200,213,30672,49872
train,2224,188,144384,12024,1731456,1875840
train,2225,8,6144,22,3168,9312
train,2226,22,16896,165,23760,40656
train,2227,264,202752,23499,3383856,3586608
train,2228,30,23040,306,44064,67104
train,2229,76,58368,1965,282960,341328
train,2230,11,8448,41,5904,14352
train,2231,187,143616,11896,1713024,1856640
train,2232,34,26112,393,56592,82704
train,2233,137,105216,6385,919440,1024656
train,2234,26,19968,230,33120,53088
train,2235,14,10752,67,9648,20400
train,2236,35,26880,417,60048,86928
train,2237,170,130560,9832,1415808,1546368
train,2238,17,13056,98,14112,27168
train,2239,26,19968,230,33120,53088
train,2240,60,46080,1225,176400,222480
train,2241,205,157440,14297,2058768,2216208
train,2242,163,125184,9039,1301616,1426800
train,2243,127,97536,5487,790128,887664
train,2244,55,42240,1029,148176,190416
train,2245,23,17664,180,25920,43584
train,2246,69,52992,1620,233280,286272
train,2247,20,15360,136,19584,34944
train,2248,167,128256,9488,1366272,1494528
train,2249,40,30720,544,78336,109056
train,2250,74,56832,1863,268272,325104
train,2251,54,41472,992,142848,184320
train,2252,83,63744,2344,337536,401280
train,2253,42,32256,600,86400,118656
train,2254,14,10752,67,9648,20400
train,2255,57,43776,1105,159120,202896
train,2256,58,44544,1145,164880,209424
train,2257,127,97536,5487,790128,887664
train,2258,192,147456,12541,1805904,1953360
train,2259,69,52992,1620,233280,286272
train,2260,99,76032,3334,480096,556128
train,2261,28,21504,267,38448,59952
train,2262,31,23808,327,47088,70896
train,2263,37,28416,466,67104,95520
train,2264,85,65280,2458,353952,419232
train,2265,53,40704,956,137664,178368
train,2266,68,52224,1573,226512,278736
train,2267,26,19968,230,33120,53088
train,2268,25,19200,213,30672,49872
train,2269,21,16128,150,21600,37728
train,2270,11,8448,41,5904,14352
train,2271,17,13056,98,14112,27168
train,2272,43,33024,629,90576,123600
train,2273,129,99072,5661,815184,914256
train,2274,95,72960,3070,442080,515040
train,2275,18,13824,110,15840,29664
train,2276,129,99072,5661,815184,914256
train,2277,151,115968,7757,1117008,1232976
train,2278,66,50688,1482,213408,264096
train,2279,24,18432,196,28224,46656
train,2280,42,32256,600,86400,118656
train,2281,77,59136,2017,290448,349584
train,2282,62,47616,1308,188352,235968
train,2283,142,109056,6860,987840,1096896
train,2284,13,9984,58,8352,18336
train,2285,26,19968,230,33120,53088
train,2286,73,56064,1813,261072,317136
train,2287,13,9984,58,8352,18336
train,2288,37,28416,466,67104,95520
train,2289,283,217344,25813,3717072,3934416
train,2290,57,43776,1105,159120,202896
train,2291,137,105216,6385,919440,1024656
train,2292,35,26880,417,60048,86928
train,2293,183,140544,11393,1640592,1781136
train,2294,35,26880,417,60048,86928
train,2295,26,19968,230,33120,53088
train,2296,52,39936,920,132480,172416
train,2297,25,19200,213,30672,49872
train,2298,49,37632,817,117648,155280
train,2299,23,17664,180,25920,43584
train,2300,15,11520,77,11088,22608
train,2301,21,16128,150,21600,37728
train,2302,71,54528,1715,246960,301488
train,2303,157,120576,8385,1207440,1328016
train,2304,72,55296,1764,254016,309312
train,2305,309,237312,27420,3948480,4185792
train,2306,30,23040,306,44064,67104
train,2307,71,54528,1715,246960,301488
train,2308,30,23040,306,44064,67104
train,2309,348,267264,33483,4821552,5088816
train,2310,126,96768,5401,777744,874512
train,2311,72,55296,1764,254016,309312
train,2312,57,43776,1105,159120,202896
train,2313,24,18432,196,28224,46656
train,2314,32,24576,349,50256,74832
train,2315,23,17664,180,25920,43584
train,2316,292,224256,26720,3847680,4071936
train,2317,53,40704,956,137664,178368
train,2318,150,115200,7654,1102176,1217376
train,2319,44,33792,659,94896,128688
train,2320,58,44544,1145,164880,209424
train,2321,129,99072,5661,815184,914256
train,2322,23,17664,180,25920,43584
train,2323,75,57600,1914,275616,333216
train,2324,49,37632,817,117648,155280
train,2325,23,17664,180,25920,43584
train,2326,23,17664,180,25920,43584
train,2327,27,20736,248,35712,56448
train,2328,23,17664,180,25920,43584
train,2329,12,9216,49,7056,16272
train,2330,26,19968,230,33120,53088
train,2331,22,16896,165,23760,40656
train,2332,23,17664,180,25920,43584
train,2333,153,117504,7964,1146816,1264320
train,2334,46,35328,720,103680,139008
train,2335,123,94464,5147,741168,835632
train,2336,178,136704,10779,1552176,1688880
train,2337,38,29184,491,70704,99888
train,2338,40,30720,544,78336,109056
train,2339,43,33024,629,90576,123600
train,2340,24,18432,196,28224,46656
train,2341,146,112128,7252,1044288,1156416
train,2342,25,19200,213,30672,49872
train,2343,22,16896,165,23760,40656
train,2344,42,32256,600,86400,118656
train,2345,137,105216,6385,919440,1024656
train,2346,76,58368,1965,282960,341328
train,2347,13,9984,58,8352,18336
train,2348,79,60672,2123,305712,366384
train,2349,52,39936,920,132480,172416
train,2350,23,17664,180,25920,43584
train,2351,65,49920,1437,206928,256848
train,2352,363,278784,35771,5151024,5429808
train,2353,15,11520,77,11088,22608
train,2354,96,73728,3135,451440,525168
train,2355,72,55296,1764,254016,309312
train,2356,46,35328,720,103680,139008
train,2357,13,9984,58,8352,18336
train,2358,28,21504,267,38448,59952
train,2359,42,32256,600,86400,118656
train,2360,94,72192,3006,432864,505056
train,2361,101,77568,3470,499680,577248
train,2362,14,10752,67,9648,20400
train,2363,130,99840,5749,827856,927696
train,2364,50,38400,851,122544,160944
train,2365,13,9984,58,8352,18336
train,2366,46,35328,720,103680,139008
train,2367,76,58368,1965,282960,341328
train,2368,165,126720,9262,1333728,1460448
train,2369,23,17664,180,25920,43584
train,2370,55,42240,1029,148176,190416
train,2371,12,9216,49,7056,16272
train,2372,49,37632,817,117648,155280
train,2373,150,115200,7654,1102176,1217376
train,2374,28,21504,267,38448,59952
train,2375,100,76800,3402,489888,566688
train,2376,99,76032,3334,480096,556128
train,2377,117,89856,4657,670608,760464
train,2378,31,23808,327,47088,70896
train,2379,57,43776,1105,159120,202896
train,2380,63,48384,1350,194400,242784
train,2381,225,172800,17222,2479968,2652768
train,2382,96,73728,3135,451440,525168
train,2383,146,112128,7252,1044288,1156416
train,2384,89,68352,2695,388080,456432
train,2385,98,75264,3267,470448,545712
train,2386,57,43776,1105,159120,202896
train,2387,21,16128,150,21600,37728
train,2388,235,180480,18441,2655504,2835984
train,2389,64,49152,1394,200736,249888
train,2390,33,25344,371,53424,78768
train,2391,42,32256,600,86400,118656
train,2392,135,103680,6200,892800,996480
train,2393,23,17664,180,25920,43584
train,2394,26,19968,230,33120,53088
train,2395,97,74496,3201,460944,535440
train,2396,83,63744,2344,337536,401280
train,2397,55,42240,1029,148176,190416
train,2398,32,24576,349,50256,74832
train,2399,13,9984,58,8352,18336
train,2400,23,17664,180,25920,43584
train,2401,99,76032,3334,480096,556128
train,2402,42,32256,600,86400,118656
train,2403,12,9216,49,7056,16272
train,2404,28,21504,267,38448,59952
train,2405,65,49920,1437,206928,256848
train,2406,22,16896,165,23760,40656
train,2407,66,50688,1482,213408,264096
train,2408,25,19200,213,30672,49872
train,2409,86,66048,2516,362304,428352
train,2410,56,43008,1067,153648,196656
train,2411,203,155904,14019,2018736,2174640
train,2412,197,151296,13203,1901232,2052528
train,2413,33,25344,371,53424,78768
train,2414,57,43776,1105,159120,202896
train,2415,159,122112,8600,1238400,1360512
train,2416,106,81408,3823,550512,631920
train,2417,154,118272,8068,1161792,1280064
train,2418,11,8448,41,5904,14352
train,2419,8,6144,28,4032,10176
train,2420,26,19968,230,33120,53088
train,2421,33,25344,371,53424,78768
train,2422,50,38400,851,122544,160944
train,2423,24,18432,196,28224,46656
train,2424,82,62976,2288,329472,392448
train,2425,28,21504,267,38448,59952
train,2426,135,103680,6200,892800,996480
train,2427,15,11520,77,11088,22608
train,2428,70,53760,1667,240048,293808
train,2429,112,86016,4267,614448,700464
train,2430,90,69120,2756,396864,465984
train,2431,20,15360,136,19584,34944
train,2432,61,46848,1266,182304,229152
train,2433,23,17664,180,25920,43584
train,2434,11,8448,41,5904,14352
train,2435,49,37632,817,117648,155280
train,2436,38,29184,491,70704,99888
train,2437,34,26112,393,56592,82704
train,2438,209,160512,14860,2139840,2300352
train,2439,22,16896,165,23760,40656
train,2440,64,49152,1394,200736,249888
train,2441,28,21504,267,38448,59952
train,2442,52,39936,920,132480,172416
train,2443,48,36864,784,112896,149760
train,2444,20,15360,136,19584,34944
train,2445,89,68352,2695,388080,456432
train,2446,68,52224,1573,226512,278736
train,2447,31,23808,327,47088,70896
train,2448,264,202752,23710,3414240,3616992
train,2449,36,27648,441,63504,91152
train,2450,28,21504,267,38448,59952
train,2451,339,260352,30475,4388400,4648752
train,2452,38,29184,491,70704,99888
train,2453,42,32256,600,86400,118656
train,2454,144,110592,7054,1015776,1126368
train,2455,24,18432,196,28224,46656
train,2456,39,29952,518,74592,104544
train,2457,120,92160,4899,705456,797616
train,2458,65,49920,1437,206928,256848
train,2459,132,101376,5928,853632,955008
train,2460,54,41472,992,142848,184320
train,2461,24,18432,196,28224,46656
train,2462,50,38400,851,122544,160944
train,2463,93,71424,2942,423648,495072
train,2464,60,46080,1225,176400,222480
train,2465,59,45312,1184,170496,215808
train,2466,49,37632,817,117648,155280
train,2467,39,29952,518,74592,104544
train,2468,42,32256,600,86400,118656
train,2469,200,153600,13608,1959552,2113152
train,2470,13,9984,58,8352,18336
train,2471,13,9984,58,8352,18336
train,2472,54,41472,992,142848,184320
train,2473,78,59904,2070,298080,357984
train,2474,39,29952,518,74592,104544
train,2475,132,101376,5928,853632,955008
train,2476,39,29952,518,74592,104544
train,2477,47,36096,752,108288,144384
train,2478,12,9216,49,7056,16272
train,2479,25,19200,213,30672,49872
train,2480,70,53760,1667,240048,293808
train,2481,48,36864,784,112896,149760
train,2482,38,29184,491,70704,99888
train,2483,26,19968,230,33120,53088
train,2484,13,9984,58,8352,18336
train,2485,17,13056,98,14112,27168
train,2486,227,174336,17530,2524320,2698656
train,2487,10,7680,34,4896,12576
train,2488,19,14592,123,17712,32304
train,2489,58,44544,1145,164880,209424
train,2490,129,99072,5661,815184,914256
train,2491,70,53760,1667,240048,293808
train,2492,11,8448,41,5904,14352
train,2493,77,59136,2017,290448,349584
train,2494,41,31488,572,82368,113856
train,2495,67,51456,1527,219888,271344
train,2496,50,38400,851,122544,160944
train,2497,161,123648,8818,1269792,1393440
train,2498,72,55296,1764,254016,309312
train,2499,58,44544,1145,164880,209424
train,2500,159,122112,8600,1238400,1360512
train,2501,31,23808,327,47088,70896
train,2502,44,33792,659,94896,128688
train,2503,82,62976,2288,329472,392448
train,2504,192,147456,12541,1805904,1953360
train,2505,139,106752,6573,946512,1053264
train,2506,56,43008,1067,153648,196656
train,2507,23,17664,180,25920,43584
train,2508,62,47616,1308,188352,235968
train,2509,53,40704,956,137664,178368
train,2510,42,32256,600,86400,118656
train,2511,50,38400,851,122544,160944
train,2512,117,89856,4657,670608,760464
train,2513,17,13056,98,14112,27168
train,2514,124,95232,5231,753264,848496
train,2515,40,30720,544,78336,109056
train,2516,21,16128,150,21600,37728
train,2517,41,31488,572,82368,113856
train,2518,22,16896,165,23760,40656
train,2519,240,184320,19595,2821680,3006000
train,2520,45,34560,689,99216,133776
train,2521,22,16896,165,23760,40656
train,2522,55,42240,1029,148176,190416
train,2523,10,7680,34,4896,12576
train,2524,34,26112,393,56592,82704
train,2525,36,27648,441,63504,91152
train,2526,76,58368,1965,282960,341328
train,2527,147,112896,7351,1058544,1171440
train,2528,69,52992,1620,233280,286272
train,2529,54,41472,992,142848,184320
train,2530,153,117504,7964,1146816,1264320
train,2531,99,76032,3334,480096,556128
train,2532,41,31488,572,82368,113856
train,2533,22,16896,165,23760,40656
train,2534,22,16896,165,23760,40656
train,2535,87,66816,2575,370800,437616
train,2536,80,61440,2177,313488,374928
train,2537,43,33024,629,90576,123600
train,2538,32,24576,349,50256,74832
train,2539,38,29184,491,70704,99888
train,2540,12,9216,49,7056,16272
train,2541,114,87552,4421,636624,724176
train,2542,76,58368,1965,282960,341328
train,2543,26,19968,230,33120,53088
train,2544,13,9984,58,8352,18336
train,2545,33,25344,371,53424,78768
train,2546,30,23040,306,44064,67104
train,2547,62,47616,1308,188352,235968
train,2548,45,34560,689,99216,133776
train,2549,53,40704,956,137664,178368
train,2550,19,14592,123,17712,32304
train,2551,36,27648,441,63504,91152
train,2552,23,17664,180,25920,43584
train,2553,147,112896,7351,1058544,1171440
train,2554,22,16896,165,23760,40656
train,2555,135,103680,6200,892800,996480
train,2556,18,13824,110,15840,29664
train,2557,104,79872,3680,529920,609792
train,2558,69,52992,1620,233280,286272
train,2559,32,24576,349,50256,74832
train,2560,227,174336,17530,2524320,2698656
train,2561,115,88320,4499,647856,736176
train,2562,20,15360,136,19584,34944
train,2563,21,16128,150,21600,37728
train,2564,28,21504,267,38448,59952
train,2565,81,62208,2232,321408,383616
train,2566,89,68352,2695,388080,456432
train,2567,73,56064,1813,261072,317136
train,2568,134,102912,6109,879696,982608
train,2569,76,58368,1965,282960,341328
train,2570,78,59904,2070,298080,357984
train,2571,102,78336,3539,509616,587952
train,2572,55,42240,1029,148176,190416
train,2573,22,16896,165,23760,40656
train,2574,40,30720,544,78336,109056
train,2575,13,9984,58,8352,18336
train,2576,92,70656,2880,414720,485376
train,2577,203,155904,14019,2018736,2174640
train,2578,13,9984,58,8352,18336
train,2579,63,48384,1350,194400,242784
train,2580,121,92928,4981,717264,810192
train,2581,118,90624,4737,682128,772752
train,2582,64,49152,1394,200736,249888
train,2583,107,82176,3895,560880,643056
train,2584,45,34560,689,99216,133776
train,2585,35,26880,417,60048,86928
train,2586,41,31488,572,82368,113856
train,2587,12,9216,49,7056,16272
train,2588,53,40704,956,137664,178368
train,2589,21,16128,150,21600,37728
train,2590,23,17664,180,25920,43584
train,2591,57,43776,1105,159120,202896
train,2592,29,22272,286,41184,63456
train,2593,21,16128,150,21600,37728
train,2594,40,30720,544,78336,109056
train,2595,69,52992,1620,233280,286272
train,2596,53,40704,956,137664,178368
train,2597,73,56064,1813,261072,317136
train,2598,23,17664,180,25920,43584
train,2599,37,28416,466,67104,95520
train,2600,71,54528,1715,246960,301488
train,2601,51,39168,885,127440,166608
train,2602,124,95232,5231,753264,848496
train,2603,45,34560,689,99216,133776
train,2604,50,38400,851,122544,160944
train,2605,75,57600,1914,275616,333216
train,2606,26,19968,230,33120,53088
train,2607,59,45312,1184,170496,215808
train,2608,31,23808,327,47088,70896
train,2609,37,28416,466,67104,95520
train,2610,81,62208,2232,321408,383616
train,2611,112,86016,4267,614448,700464
train,2612,76,58368,1965,282960,341328
train,2613,28,21504,267,38448,59952
train,2614,74,56832,1863,268272,325104
train,2615,28,21504,267,38448,59952
train,2616,59,45312,1184,170496,215808
train,2617,15,11520,77,11088,22608
train,2618,96,73728,3135,451440,525168
train,2619,20,15360,136,19584,34944
train,2620,192,147456,12541,1805904,1953360
train,2621,53,40704,956,137664,178368
train,2622,50,38400,851,122544,160944
train,2623,42,32256,600,86400,118656
train,2624,71,54528,1715,246960,301488
train,2625,82,62976,2288,329472,392448
train,2626,46,35328,720,103680,139008
train,2627,226,173568,17376,2502144,2675712
train,2628,119,91392,4818,693792,785184
train,2629,35,26880,417,60048,86928
train,2630,115,88320,4499,647856,736176
train,2631,24,18432,196,28224,46656
train,2632,30,23040,306,44064,67104
train,2633,95,72960,3070,442080,515040
train,2634,43,33024,629,90576,123600
train,2635,78,59904,2070,298080,357984
train,2636,100,76800,3402,489888,566688
train,2637,58,44544,1145,164880,209424
train,2638,171,131328,9948,1432512,1563840
train,2639,85,65280,2458,353952,419232
train,2640,20,15360,136,19584,34944
train,2641,24,18432,196,28224,46656
train,2642,41,31488,572,82368,113856
train,2643,102,78336,3539,509616,587952
train,2644,39,29952,518,74592,104544
train,2645,165,126720,9262,1333728,1460448
train,2646,72,55296,1764,254016,309312
train,2647,42,32256,600,86400,118656
train,2648,19,14592,123,17712,32304
train,2649,21,16128,150,21600,37728
train,2650,32,24576,349,50256,74832
train,2651,61,46848,1266,182304,229152
train,2652,36,27648,441,63504,91152
train,2653,52,39936,920,132480,172416
train,2654,23,17664,180,25920,43584
train,2655,120,92160,4899,705456,797616
train,2656,162,124416,8928,1285632,1410048
train,2657,24,18432,196,28224,46656
train,2658,37,28416,466,67104,95520
train,2659,14,10752,67,9648,20400
train,2660,151,115968,7757,1117008,1232976
train,2661,118,90624,4737,682128,772752
train,2662,62,47616,1308,188352,235968
train,2663,64,49152,1394,200736,249888
train,2664,71,54528,1715,246960,301488
train,2665,55,42240,1029,148176,190416
train,2666,13,9984,58,8352,18336
train,2667,69,52992,1620,233280,286272
train,2668,28,21504,267,38448,59952
train,2669,12,9216,49,7056,16272
train,2670,133,102144,6018,866592,968736
train,2671,260,199680,22997,3311568,3511248
train,2672,87,66816,2575,370800,437616
train,2673,31,23808,327,47088,70896
train,2674,19,14592,123,17712,32304
train,2675,106,81408,3823,550512,631920
train,2676,103,79104,3609,519696,598800
train,2677,30,23040,306,44064,67104
train,2678,82,62976,2288,329472,392448
train,2679,20,15360,136,19584,34944
train,2680,94,72192,3006,432864,505056
train,2681,38,29184,491,70704,99888
train,2682,77,59136,2017,290448,349584
train,2683,52,39936,920,132480,172416
train,2684,54,41472,992,142848,184320
train,2685,25,19200,213,30672,49872
train,2686,45,34560,689,99216,133776
train,2687,52,39936,920,132480,172416
train,2688,36,27648,441,63504,91152
train,2689,38,29184,491,70704,99888
train,2690,137,105216,6385,919440,1024656
train,2691,76,58368,1965,282960,341328
train,2692,43,33024,629,90576,123600
train,2693,31,23808,327,47088,70896
train,2694,70,53760,1667,240048,293808
train,2695,29,22272,286,41184,63456
train,2696,226,173568,17376,2502144,2675712
train,2697,63,48384,1350,194400,242784
train,2698,24,18432,196,28224,46656
train,2699,21,16128,150,21600,37728
train,2700,38,29184,491,70704,99888
train,2701,36,27648,441,63504,91152
train,2702,226,173568,17123,2465712,2639280
train,2703,12,9216,49,7056,16272
train,2704,187,143616,11896,1713024,1856640
train,2705,39,29952,518,74592,104544
train,2706,18,13824,110,15840,29664
train,2707,17,13056,98,14112,27168
train,2708,26,19968,230,33120,53088
train,2709,24,18432,196,28224,46656
train,2710,73,56064,1813,261072,317136
train,2711,22,16896,165,23760,40656
train,2712,43,33024,629,90576,123600
train,2713,12,9216,49,7056,16272
train,2714,65,49920,1437,206928,256848
train,2715,11,8448,41,5904,14352
train,2716,149,114432,7553,1087632,1202064
train,2717,35,26880,417,60048,86928
train,2718,159,122112,8600,1238400,1360512
train,2719,78,59904,2070,298080,357984
train,2720,67,51456,1527,219888,271344
train,2721,19,14592,123,17712,32304
train,2722,57,43776,1105,159120,202896
train,2723,112,86016,4267,614448,700464
train,2724,33,25344,371,53424,78768
train,2725,163,125184,9039,1301616,1426800
train,2726,168,129024,9602,1382688,1511712
train,2727,65,49920,1437,206928,256848
train,2728,38,29184,491,70704,99888
train,2729,56,43008,1067,153648,196656
train,2730,33,25344,371,53424,78768
train,2731,29,22272,286,41184,63456
train,2732,47,36096,752,108288,144384
train,2733,67,51456,1527,219888,271344
train,2734,138,105984,6479,932976,1038960
train,2735,82,62976,2288,329472,392448
train,2736,38,29184,491,70704,99888
train,2737,29,22272,286,41184,63456
train,2738,45,34560,689,99216,133776
train,2739,72,55296,1764,254016,309312
train,2740,40,30720,544,78336,109056
train,2741,29,22272,286,41184,63456
train,2742,34,26112,393,56592,82704
train,2743,25,19200,213,30672,49872
train,2744,89,68352,2695,388080,456432
train,2745,28,21504,267,38448,59952
train,2746,15,11520,77,11088,22608
train,2747,35,26880,417,60048,86928
train,2748,67,51456,1527,219888,271344
train,2749,86,66048,2516,362304,428352
train,2750,39,29952,518,74592,104544
train,2751,444,340992,48624,7001856,7342848
train,2752,21,16128,150,21600,37728
train,2753,10,7680,34,4896,12576
train,2754,206,158208,14436,2078784,2236992
train,2755,113,86784,4344,625536,712320
train,2756,88,67584,2635,379440,447024
train,2757,132,101376,5928,853632,955008
train,2758,303,232704,27044,3894336,4127040
train,2759,21,16128,150,21600,37728
train,2760,47,36096,752,108288,144384
train,2761,10,7680,34,4896,12576
train,2762,54,41472,992,142848,184320
train,2763,53,40704,956,137664,178368
train,2764,88,67584,2635,379440,447024
train,2765,23,17664,180,25920,43584
train,2766,30,23040,306,44064,67104
train,2767,59,45312,1184,170496,215808
train,2768,54,41472,992,142848,184320
train,2769,42,32256,600,86400,118656
train,2770,159,122112,8600,1238400,1360512
train,2771,165,126720,9262,1333728,1460448
train,2772,15,11520,77,11088,22608
train,2773,87,66816,2575,370800,437616
train,2774,138,105984,6479,932976,1038960
train,2775,51,39168,885,127440,166608
train,2776,22,16896,165,23760,40656
train,2777,47,36096,752,108288,144384
train,2778,21,16128,150,21600,37728
train,2779,22,16896,165,23760,40656
train,2780,49,37632,817,117648,155280
train,2781,50,38400,851,122544,160944
train,2782,101,77568,3470,499680,577248
train,2783,84,64512,2401,345744,410256
train,2784,161,123648,8818,1269792,1393440
train,2785,96,73728,3135,451440,525168
train,2786,204,156672,14157,2038608,2195280
train,2787,56,43008,1067,153648,196656
train,2788,45,34560,689,99216,133776
train,2789,55,42240,1029,148176,190416
train,2790,67,51456,1527,219888,271344
train,2791,80,61440,2177,313488,374928
train,2792,45,34560,689,99216,133776
train,2793,207,158976,14577,2099088,2258064
train,2794,59,45312,1184,170496,215808
train,2795,36,27648,441,63504,91152
train,2796,51,39168,885,127440,166608
train,2797,61,46848,1266,182304,229152
train,2798,61,46848,1266,182304,229152
train,2799,239,183552,18735,2697840,2881392
train,2800,49,37632,817,117648,155280
train,2801,23,17664,180,25920,43584
train,2802,111,85248,4192,603648,688896
train,2803,38,29184,491,70704,99888
train,2804,140,107520,6668,960192,1067712
train,2805,58,44544,1145,164880,209424
train,2806,83,63744,2344,337536,401280
train,2807,118,90624,4737,682128,772752
train,2808,21,16128,150,21600,37728
train,2809,30,23040,306,44064,67104
train,2810,78,59904,2070,298080,357984
train,2811,60,46080,1225,176400,222480
train,2812,57,43776,1105,159120,202896
train,2813,96,73728,3135,451440,525168
train,2814,109,83712,4042,582048,665760
train,2815,134,102912,6109,879696,982608
train,2816,50,38400,851,122544,160944
train,2817,28,21504,267,38448,59952
train,2818,69,52992,1620,233280,286272
train,2819,70,53760,1667,240048,293808
train,2820,17,13056,98,14112,27168
train,2821,108,82944,3968,571392,654336
train,2822,132,101376,5928,853632,955008
train,2823,58,44544,1145,164880,209424
train,2824,12,9216,49,7056,16272
train,2825,26,19968,230,33120,53088
train,2826,14,10752,67,9648,20400
train,2827,61,46848,1266,182304,229152
train,2828,25,19200,213,30672,49872
train,2829,71,54528,1715,246960,301488
train,2830,179,137472,10900,1569600,1707072
train,2831,126,96768,5401,777744,874512
train,2832,23,17664,180,25920,43584
train,2833,44,33792,659,94896,128688
train,2834,196,150528,13069,1881936,2032464
train,2835,30,23040,306,44064,67104
train,2836,118,90624,4737,682128,772752
train,2837,60,46080,1225,176400,222480
train,2838,64,49152,1394,200736,249888
train,2839,120,92160,4899,705456,797616
train,2840,50,38400,851,122544,160944
train,2841,21,16128,150,21600,37728
train,2842,14,10752,67,9648,20400
train,2843,38,29184,491,70704,99888
train,2844,29,22272,286,41184,63456
train,2845,150,115200,7654,1102176,1217376
train,2846,19,14592,123,17712,32304
train,2847,19,14592,123,17712,32304
train,2848,186,142848,11769,1694736,1837584
train,2849,26,19968,230,33120,53088
train,2850,95,72960,3070,442080,515040
train,2851,28,21504,267,38448,59952
train,2852,77,59136,2017,290448,349584
train,2853,70,53760,1667,240048,293808
train,2854,39,29952,518,74592,104544
train,2855,25,19200,213,30672,49872
train,2856,23,17664,180,25920,43584
train,2857,71,54528,1715,246960,301488
train,2858,22,16896,165,23760,40656
train,2859,24,18432,196,28224,46656
train,2860,113,86784,4344,625536,712320
train,2861,61,46848,1266,182304,229152
train,2862,26,19968,230,33120,53088
train,2863,263,201984,22826,3286944,3488928
train,2864,31,23808,327,47088,70896
train,2865,36,27648,441,63504,91152
train,2866,22,16896,165,23760,40656
train,2867,55,42240,1029,148176,190416
train,2868,37,28416,466,67104,95520
train,2869,13,9984,58,8352,18336
train,2870,16,12288,87,12528,24816
train,2871,184,141312,11518,1658592,1799904
train,2872,54,41472,992,142848,184320
train,2873,70,53760,1667,240048,293808
train,2874,31,23808,327,47088,70896
train,2875,67,51456,1527,219888,271344
train,2876,67,51456,1527,219888,271344
train,2877,54,41472,992,142848,184320
train,2878,73,56064,1813,261072,317136
train,2879,136,104448,6292,906048,1010496
train,2880,67,51456,1527,219888,271344
train,2881,39,29952,518,74592,104544
train,2882,20,15360,136,19584,34944
train,2883,76,58368,1965,282960,341328
train,2884,60,46080,1225,176400,222480
train,2885,25,19200,213,30672,49872
train,2886,57,43776,1105,159120,202896
train,2887,24,18432,196,28224,46656
train,2888,51,39168,885,127440,166608
train,2889,165,126720,9262,1333728,1460448
train,2890,23,17664,180,25920,43584
train,2891,80,61440,2177,313488,374928
train,2892,27,20736,248,35712,56448
train,2893,94,72192,3006,432864,505056
train,2894,32,24576,349,50256,74832
train,2895,68,52224,1573,226512,278736
train,2896,12,9216,49,7056,16272
train,2897,27,20736,248,35712,56448
train,2898,50,38400,851,122544,160944
train,2899,13,9984,58,8352,18336
train,2900,52,39936,920,132480,172416
train,2901,61,46848,1266,182304,229152
train,2902,63,48384,1350,194400,242784
train,2903,88,67584,2635,379440,447024
train,2904,15,11520,77,11088,22608
train,2905,54,41472,992,142848,184320
train,2906,108,82944,3968,571392,654336
train,2907,47,36096,752,108288,144384
train,2908,40,30720,544,78336,109056
train,2909,45,34560,689,99216,133776
train,2910,148,113664,7452,1073088,1186752
train,2911,107,82176,3895,560880,643056
train,2912,72,55296,1764,254016,309312
train,2913,91,69888,2817,405648,475536
train,2914,71,54528,1715,246960,301488
train,2915,82,62976,2288,329472,392448
train,2916,25,19200,213,30672,49872
train,2917,46,35328,720,103680,139008
train,2918,40,30720,544,78336,109056
train,2919,37,28416,466,67104,95520
train,2920,23,17664,180,25920,43584
train,2921,22,16896,165,23760,40656
train,2922,34,26112,393,56592,82704
train,2923,55,42240,1029,148176,190416
train,2924,24,18432,196,28224,46656
train,2925,416,319488,45447,6544368,6863856
train,2926,47,36096,752,108288,144384
train,2927,55,42240,1029,148176,190416
train,2928,21,16128,150,21600,37728
train,2929,96,73728,3135,451440,525168
train,2930,9,6912,28,4032,10944
train,2931,213,163584,15434,2222496,2386080
train,2932,79,60672,2123,305712,366384
train,2933,12,9216,49,7056,16272
train,2934,337,258816,31825,4582800,4841616
train,2935,22,16896,165,23760,40656
train,2936,19,14592,123,17712,32304
train,2937,31,23808,327,47088,70896
train,2938,17,13056,98,14112,27168
train,2939,86,66048,2516,362304,428352
train,2940,55,42240,1029,148176,190416
train,2941,14,10752,67,9648,20400
train,2942,18,13824,110,15840,29664
train,2943,15,11520,77,11088,22608
train,2944,65,49920,1437,206928,256848
train,2945,28,21504,267,38448,59952
train,2946,74,56832,1863,268272,325104
train,2947,39,29952,518,74592,104544
train,2948,89,68352,2695,388080,456432
train,2949,12,9216,49,7056,16272
train,2950,84,64512,2401,345744,410256
train,2951,94,72192,3006,432864,505056
train,2952,47,36096,752,108288,144384
train,2953,57,43776,1105,159120,202896
train,2954,25,19200,213,30672,49872
train,2955,75,57600,1914,275616,333216
train,2956,13,9984,58,8352,18336
train,2957,110,84480,4116,592704,677184
train,2958,79,60672,2123,305712,366384
train,2959,51,39168,885,127440,166608
train,2960,79,60672,2123,305712,366384
train,2961,63,48384,1350,194400,242784
train,2962,13,9984,58,8352,18336
train,2963,56,43008,1067,153648,196656
train,2964,79,60672,2123,305712,366384
train,2965,42,32256,600,86400,118656
train,2966,21,16128,150,21600,37728
train,2967,49,37632,817,117648,155280
train,2968,16,12288,87,12528,24816
train,2969,28,21504,267,38448,59952
train,2970,25,19200,213,30672,49872
train,2971,39,29952,518,74592,104544
train,2972,85,65280,2458,353952,419232
train,2973,20,15360,136,19584,34944
train,2974,269,206592,24117,3472848,3679440
train,2975,27,20736,248,35712,56448
train,2976,24,18432,196,28224,46656
train,2977,44,33792,659,94896,128688
train,2978,92,70656,2880,414720,485376
train,2979,21,16128,150,21600,37728
train,2980,27,20736,248,35712,56448
train,2981,211,162048,15146,2181024,2343072
train,2982,73,56064,1813,261072,317136
train,2983,28,21504,267,38448,59952
train,2984,49,37632,817,117648,155280
train,2985,23,17664,180,25920,43584
train,2986,22,16896,165,23760,40656
train,2987,36,27648,441,63504,91152
train,2988,26,19968,230,33120,53088
train,2989,113,86784,4344,625536,712320
train,2990,65,49920,1437,206928,256848
train,2991,27,20736,248,35712,56448
train,2992,84,64512,2401,345744,410256
train,2993,15,11520,77,11088,22608
train,2994,70,53760,1667,240048,293808
train,2995,21,16128,150,21600,37728
train,2996,14,10752,67,9648,20400
train,2997,12,9216,49,7056,16272
train,2998,383,294144,38228,5504832,5798976
train,2999,175,134400,10418,1500192,1634592
train,3000,61,46848,1266,182304,229152
train,3001,205,157440,14297,2058768,2216208
train,3002,102,78336,3539,509616,587952
train,3003,23,17664,180,25920,43584
train,3004,74,56832,1863,268272,325104
train,3005,15,11520,77,11088,22608
train,3006,24,18432,196,28224,46656
train,3007,47,36096,752,108288,144384
train,3008,69,52992,1620,233280,286272
train,3009,14,10752,67,9648,20400
train,3010,160,122880,8709,1254096,1376976
train,3011,65,49920,1437,206928,256848
train,3012,38,29184,491,70704,99888
train,3013,80,61440,2177,313488,374928
train,3014,80,61440,2177,313488,374928
train,3015,37,28416,466,67104,95520
train,3016,75,57600,1914,275616,333216
train,3017,14,10752,67,9648,20400
train,3018,59,45312,1184,170496,215808
train,3019,33,25344,371,53424,78768
train,3020,40,30720,544,78336,109056
train,3021,14,10752,67,9648,20400
train,3022,279,214272,25399,3657456,3871728
train,3023,43,33024,629,90576,123600
train,3024,55,42240,1029,148176,190416
train,3025,67,51456,1527,219888,271344
train,3026,24,18432,196,28224,46656
train,3027,19,14592,123,17712,32304
train,3028,21,16128,150,21600,37728
train,3029,31,23808,327,47088,70896
train,3030,24,18432,196,28224,46656
train,3031,33,25344,371,53424,78768
train,3032,31,23808,327,47088,70896
train,3033,77,59136,2017,290448,349584
train,3034,88,67584,2635,379440,447024
train,3035,61,46848,1266,182304,229152
train,3036,43,33024,629,90576,123600
train,3037,22,16896,165,23760,40656
train,3038,22,16896,165,23760,40656
train,3039,68,52224,1573,226512,278736
train,3040,41,31488,572,82368,113856
train,3041,22,16896,165,23760,40656
train,3042,186,142848,11769,1694736,1837584
train,3043,56,43008,1067,153648,196656
train,3044,53,40704,956,137664,178368
train,3045,38,29184,491,70704,99888
train,3046,10,7680,34,4896,12576
train,3047,29,22272,286,41184,63456
train,3048,12,9216,49,7056,16272
train,3049,23,17664,180,25920,43584
train,3050,19,14592,123,17712,32304
train,3051,30,23040,306,44064,67104
train,3052,74,56832,1863,268272,325104
train,3053,34,26112,393,56592,82704
train,3054,21,16128,150,21600,37728
train,3055,25,19200,213,30672,49872
train,3056,42,32256,600,86400,118656
train,3057,21,16128,150,21600,37728
train,3058,43,33024,629,90576,123600
train,3059,31,23808,327,47088,70896
train,3060,71,54528,1715,246960,301488
train,3061,90,69120,2756,396864,465984
train,3062,74,56832,1863,268272,325104
train,3063,26,19968,230,33120,53088
train,3064,34,26112,393,56592,82704
train,3065,22,16896,165,23760,40656
train,3066,75,57600,1914,275616,333216
train,3067,22,16896,165,23760,40656
train,3068,69,52992,1620,233280,286272
train,3069,25,19200,213,30672,49872
train,3070,149,114432,7553,1087632,1202064
train,3071,43,33024,629,90576,123600
train,3072,34,26112,393,56592,82704
train,3073,188,144384,12024,1731456,1875840
train,3074,65,49920,1437,206928,256848
train,3075,71,54528,1715,246960,301488
train,3076,37,28416,466,67104,95520
train,3077,43,33024,629,90576,123600
train,3078,37,28416,466,67104,95520
train,3079,27,20736,248,35712,56448
train,3080,41,31488,572,82368,113856
train,3081,64,49152,1394,200736,249888
train,3082,10,7680,34,4896,12576
train,3083,72,55296,1764,254016,309312
train,3084,77,59136,2017,290448,349584
train,3085,136,104448,6292,906048,1010496
train,3086,30,23040,306,44064,67104
train,3087,133,102144,6018,866592,968736
train,3088,25,19200,213,30672,49872
train,3089,43,33024,629,90576,123600
train,3090,16,12288,87,12528,24816
train,3091,52,39936,920,132480,172416
train,3092,55,42240,1029,148176,190416
train,3093,106,81408,3823,550512,631920
train,3094,105,80640,3751,540144,620784
train,3095,18,13824,110,15840,29664
train,3096,62,47616,1308,188352,235968
train,3097,81,62208,2232,321408,383616
train,3098,26,19968,230,33120,53088
train,3099,24,18432,196,28224,46656
train,3100,82,62976,2288,329472,392448
train,3101,62,47616,1308,188352,235968
train,3102,12,9216,49,7056,16272
train,3103,66,50688,1482,213408,264096
train,3104,86,66048,2516,362304,428352
train,3105,52,39936,920,132480,172416
train,3106,29,22272,286,41184,63456
train,3107,336,258048,31987,4606128,4864176
train,3108,54,41472,992,142848,184320
train,3109,20,15360,136,19584,34944
train,3110,77,59136,2017,290448,349584
train,3111,58,44544,1145,164880,209424
train,3112,126,96768,5401,777744,874512
train,3113,66,50688,1482,213408,264096
train,3114,73,56064,1813,261072,317136
train,3115,41,31488,572,82368,113856
train,3116,202,155136,13881,1998864,2154000
train,3117,48,36864,784,112896,149760
train,3118,22,16896,165,23760,40656
train,3119,109,83712,4042,582048,665760
train,3120,31,23808,327,47088,70896
train,3121,127,97536,5487,790128,887664
train,3122,39,29952,518,74592,104544
train,3123,59,45312,1184,170496,215808
train,3124,65,49920,1437,206928,256848
train,3125,76,58368,1965,282960,341328
train,3126,22,16896,165,23760,40656
train,3127,68,52224,1573,226512,278736
train,3128,26,19968,230,33120,53088
train,3129,66,50688,1482,213408,264096
train,3130,41,31488,572,82368,113856
train,3131,16,12288,87,12528,24816
train,3132,75,57600,1914,275616,333216
train,3133,23,17664,180,25920,43584
train,3134,36,27648,441,63504,91152
train,3135,107,82176,3895,560880,643056
train,3136,57,43776,1105,159120,202896
train,3137,22,16896,165,23760,40656
train,3138,78,59904,2070,298080,357984
train,3139,47,36096,752,108288,144384
train,3140,41,31488,572,82368,113856
train,3141,41,31488,572,82368,113856
train,3142,25,19200,213,30672,49872
train,3143,50,38400,851,122544,160944
train,3144,66,50688,1482,213408,264096
train,3145,58,44544,1145,164880,209424
train,3146,60,46080,1225,176400,222480
train,3147,23,17664,180,25920,43584
train,3148,29,22272,286,41184,63456
train,3149,50,38400,851,122544,160944
train,3150,40,30720,544,78336,109056
train,3151,13,9984,58,8352,18336
train,3152,9,6912,28,4032,10944
train,3153,24,18432,196,28224,46656
train,3154,25,19200,213,30672,49872
train,3155,63,48384,1350,194400,242784
train,3156,18,13824,110,15840,29664
train,3157,42,32256,600,86400,118656
train,3158,26,19968,230,33120,53088
train,3159,145,111360,7153,1030032,1141392
train,3160,12,9216,49,7056,16272
train,3161,44,33792,659,94896,128688
train,3162,20,15360,136,19584,34944
train,3163,19,14592,123,17712,32304
train,3164,27,20736,248,35712,56448
train,3165,107,82176,3895,560880,643056
train,3166,25,19200,213,30672,49872
train,3167,41,31488,572,82368,113856
train,3168,122,93696,5064,729216,822912
train,3169,72,55296,1764,254016,309312
train,3170,12,9216,49,7056,16272
train,3171,40,30720,544,78336,109056
train,3172,122,93696,5064,729216,822912
train,3173,14,10752,67,9648,20400
train,3174,22,16896,165,23760,40656
train,3175,53,40704,956,137664,178368
train,3176,156,119808,8279,1192176,1311984
train,3177,52,39936,920,132480,172416
train,3178,54,41472,992,142848,184320
train,3179,21,16128,150,21600,37728
train,3180,23,17664,180,25920,43584
train,3181,114,87552,4421,636624,724176
train,3182,42,32256,600,86400,118656
train,3183,204,156672,14157,2038608,2195280
train,3184,10,7680,34,4896,12576
train,3185,117,89856,4657,670608,760464
train,3186,59,45312,1184,170496,215808
train,3187,22,16896,165,23760,40656
train,3188,13,9984,58,8352,18336
train,3189,109,83712,4042,582048,665760
train,3190,12,9216,49,7056,16272
train,3191,13,9984,58,8352,18336
train,3192,65,49920,1437,206928,256848
train,3193,138,105984,6479,932976,1038960
train,3194,58,44544,1145,164880,209424
train,3195,46,35328,720,103680,139008
train,3196,393,301824,40328,5807232,6109056
train,3197,37,28416,466,67104,95520
train,3198,75,57600,1914,275616,333216
train,3199,41,31488,572,82368,113856
train,3200,23,17664,180,25920,43584
train,3201,41,31488,572,82368,113856
train,3202,99,76032,3334,480096,556128
train,3203,12,9216,49,7056,16272
train,3204,13,9984,58,8352,18336
train,3205,11,8448,41,5904,14352
train,3206,7,5376,17,2448,7824
train,3207,11,8448,41,5904,14352
train,3208,54,41472,992,142848,184320
train,3209,127,97536,5487,790128,887664
train,3210,108,82944,3968,571392,654336
train,3211,49,37632,817,117648,155280
train,3212,24,18432,196,28224,46656
train,3213,25,19200,213,30672,49872
train,3214,76,58368,1965,282960,341328
train,3215,59,45312,1184,170496,215808
train,3216,61,46848,1266,182304,229152
train,3217,51,39168,885,127440,166608
train,3218,28,21504,267,38448,59952
train,3219,94,72192,3006,432864,505056
train,3220,34,26112,393,56592,82704
train,3221,11,8448,41,5904,14352
train,3222,13,9984,58,8352,18336
train,3223,174,133632,10300,1483200,1616832
train,3224,31,23808,327,47088,70896
train,3225,192,147456,12541,1805904,1953360
train,3226,85,65280,2458,353952,419232
train,3227,170,130560,9832,1415808,1546368
train,3228,26,19968,230,33120,53088
train,3229,23,17664,180,25920,43584
train,3230,181,139008,11145,1604880,1743888
train,3231,54,41472,992,142848,184320
train,3232,274,210432,22987,3310128,3520560
train,3233,97,74496,3201,460944,535440
train,3234,22,16896,165,23760,40656
train,3235,60,46080,1225,176400,222480
train,3236,61,46848,1266,182304,229152
train,3237,22,16896,165,23760,40656
train,3238,157,120576,8385,1207440,1328016
train,3239,91,69888,2817,405648,475536
train,3240,142,109056,6860,987840,1096896
train,3241,52,39936,920,132480,172416
train,3242,43,33024,629,90576,123600
train,3243,66,50688,1482,213408,264096
train,3244,163,125184,9039,1301616,1426800
train,3245,170,130560,9832,1415808,1546368
train,3246,22,16896,165,23760,40656
train,3247,41,31488,572,82368,113856
train,3248,67,51456,1527,219888,271344
train,3249,24,18432,196,28224,46656
train,3250,130,99840,5749,827856,927696
train,3251,40,30720,544,78336,109056
train,3252,20,15360,136,19584,34944
train,3253,75,57600,1914,275616,333216
train,3254,37,28416,466,67104,95520
train,3255,54,41472,992,142848,184320
train,3256,25,19200,213,30672,49872
train,3257,16,12288,87,12528,24816
train,3258,44,33792,659,94896,128688
train,3259,9,6912,28,4032,10944
train,3260,80,61440,2177,313488,374928
train,3261,144,110592,7054,1015776,1126368
train,3262,72,55296,1764,254016,309312
train,3263,74,56832,1863,268272,325104
train,3264,38,29184,491,70704,99888
train,3265,35,26880,417,60048,86928
train,3266,123,94464,5147,741168,835632
train,3267,14,10752,67,9648,20400
train,3268,58,44544,1145,164880,209424
train,3269,87,66816,2575,370800,437616
train,3270,65,49920,1437,206928,256848
train,3271,149,114432,7553,1087632,1202064
train,3272,31,23808,327,47088,70896
train,3273,30,23040,306,44064,67104
train,3274,14,10752,67,9648,20400
train,3275,153,117504,7964,1146816,1264320
train,3276,19,14592,123,17712,32304
train,3277,36,27648,441,63504,91152
train,3278,20,15360,136,19584,34944
train,3279,84,64512,2401,345744,410256
train,3280,68,52224,1573,226512,278736
train,3281,78,59904,2070,298080,357984
train,3282,23,17664,180,25920,43584
train,3283,56,43008,1067,153648,196656
train,3284,126,96768,5401,777744,874512
train,3285,57,43776,1105,159120,202896
train,3286,93,71424,2942,423648,495072
train,3287,45,34560,689,99216,133776
train,3288,161,123648,8818,1269792,1393440
train,3289,65,49920,1437,206928,256848
train,3290,10,7680,34,4896,12576
train,3291,59,45312,1184,170496,215808
train,3292,90,69120,2756,396864,465984
train,3293,51,39168,885,127440,166608
train,3294,11,8448,41,5904,14352
train,3295,48,36864,784,112896,149760
train,3296,41,31488,572,82368,113856
train,3297,129,99072,5661,815184,914256
train,3298,38,29184,491,70704,99888
train,3299,40,30720,544,78336,109056
train,3300,12,9216,49,7056,16272
train,3301,55,42240,1029,148176,190416
train,3302,47,36096,752,108288,144384
train,3303,123,94464,5147,741168,835632
train,3304,327,251136,30645,4412880,4664016
train,3305,13,9984,58,8352,18336
train,3306,59,45312,1184,170496,215808
train,3307,84,64512,2401,345744,410256
train,3308,17,13056,98,14112,27168
train,3309,70,53760,1667,240048,293808
train,3310,30,23040,306,44064,67104
train,3311,193,148224,12672,1824768,1972992
train,3312,106,81408,3823,550512,631920
train,3313,63,48384,1350,194400,242784
train,3314,13,9984,58,8352,18336
train,3315,166,127488,9374,1349856,1477344
train,3316,21,16128,150,21600,37728
train,3317,113,86784,4344,625536,712320
train,3318,50,38400,851,122544,160944
train,3319,119,91392,4818,693792,785184
train,3320,55,42240,1029,148176,190416
train,3321,66,50688,1482,213408,264096
train,3322,10,7680,34,4896,12576
train,3323,53,40704,956,137664,178368
train,3324,24,18432,196,28224,46656
train,3325,95,72960,3070,442080,515040
train,3326,34,26112,393,56592,82704
train,3327,13,9984,58,8352,18336
train,3328,64,49152,1394,200736,249888
train,3329,105,80640,3751,540144,620784
train,3330,54,41472,992,142848,184320
train,3331,12,9216,49,7056,16272
train,3332,11,8448,41,5904,14352
train,3333,101,77568,3470,499680,577248
train,3334,152,116736,7860,1131840,1248576
train,3335,148,113664,7452,1073088,1186752
train,3336,35,26880,417,60048,86928
train,3337,214,164352,15579,2243376,2407728
train,3338,47,36096,752,108288,144384
train,3339,65,49920,1437,206928,256848
train,3340,77,59136,2017,290448,349584
train,3341,19,14592,123,17712,32304
train,3342,11,8448,41,5904,14352
train,3343,64,49152,1394,200736,249888
train,3344,15,11520,77,11088,22608
train,3345,28,21504,267,38448,59952
train,3346,32,24576,349,50256,74832
train,3347,80,61440,2177,313488,374928
train,3348,117,89856,4657,670608,760464
train,3349,23,17664,180,25920,43584
train,3350,12,9216,49,7056,16272
train,3351,130,99840,5749,827856,927696
train,3352,61,46848,1266,182304,229152
train,3353,22,16896,165,23760,40656
train,3354,25,19200,213,30672,49872
train,3355,36,27648,441,63504,91152
train,3356,27,20736,248,35712,56448
train,3357,137,105216,6385,919440,1024656
train,3358,31,23808,327,47088,70896
train,3359,129,99072,5661,815184,914256
train,3360,166,127488,9374,1349856,1477344
train,3361,154,118272,8068,1161792,1280064
train,3362,23,17664,180,25920,43584
train,3363,281,215808,23947,3448368,3664176
train,3364,44,33792,659,94896,128688
train,3365,31,23808,327,47088,70896
train,3366,99,76032,3334,480096,556128
train,3367,18,13824,110,15840,29664
train,3368,99,76032,3334,480096,556128
train,3369,39,29952,518,74592,104544
train,3370,47,36096,752,108288,144384
train,3371,36,27648,441,63504,91152
train,3372,35,26880,417,60048,86928
train,3373,93,71424,2942,423648,495072
train,3374,56,43008,1067,153648,196656
train,3375,33,25344,371,53424,78768
train,3376,21,16128,150,21600,37728
train,3377,26,19968,230,33120,53088
train,3378,75,57600,1914,275616,333216
train,3379,384,294912,38678,5569632,5864544
train,3380,35,26880,417,60048,86928
train,3381,22,16896,165,23760,40656
train,3382,83,63744,2344,337536,401280
train,3383,52,39936,920,132480,172416
train,3384,37,28416,466,67104,95520
train,3385,15,11520,77,11088,22608
train,3386,48,36864,784,112896,149760
train,3387,68,52224,1573,226512,278736
train,3388,20,15360,136,19584,34944
train,3389,45,34560,689,99216,133776
train,3390,25,19200,213,30672,49872
train,3391,29,22272,286,41184,63456
train,3392,21,16128,150,21600,37728
train,3393,78,59904,2070,298080,357984
train,3394,47,36096,752,108288,144384
train,3395,173,132864,10182,1466208,1599072
train,3396,41,31488,572,82368,113856
train,3397,21,16128,150,21600,37728
train,3398,121,92928,4981,717264,810192
train,3399,13,9984,58,8352,18336
train,3400,199,152832,13472,1939968,2092800
train,3401,88,67584,2635,379440,447024
train,3402,137,105216,6385,919440,1024656
train,3403,48,36864,784,112896,149760
train,3404,47,36096,752,108288,144384
train,3405,49,37632,817,117648,155280
train,3406,167,128256,9488,1366272,1494528
train,3407,46,35328,720,103680,139008
train,3408,19,14592,123,17712,32304
train,3409,32,24576,349,50256,74832
train,3410,69,52992,1620,233280,286272
train,3411,70,53760,1667,240048,293808
train,3412,83,63744,2344,337536,401280
train,3413,44,33792,659,94896,128688
train,3414,341,261888,32427,4669488,4931376
train,3415,78,59904,2070,298080,357984
train,3416,25,19200,213,30672,49872
train,3417,76,58368,1965,282960,341328
train,3418,149,114432,7553,1087632,1202064
train,3419,41,31488,572,82368,113856
train,3420,25,19200,213,30672,49872
train,3421,127,97536,5487,790128,887664
train,3422,23,17664,180,25920,43584
train,3423,43,33024,629,90576,123600
train,3424,17,13056,98,14112,27168
train,3425,49,37632,817,117648,155280
train,3426,79,60672,2123,305712,366384
train,3427,91,69888,2817,405648,475536
train,3428,30,23040,306,44064,67104
train,3429,22,16896,165,23760,40656
train,3430,39,29952,518,74592,104544
train,3431,84,64512,2401,345744,410256
train,3432,137,105216,6385,919440,1024656
train,3433,190,145920,12281,1768464,1914384
train,3434,36,27648,441,63504,91152
train,3435,133,102144,6018,866592,968736
train,3436,14,10752,67,9648,20400
train,3437,130,99840,5749,827856,927696
train,3438,258,198144,22645,3260880,3459024
train,3439,80,61440,2177,313488,374928
train,3440,67,51456,1527,219888,271344
train,3441,49,37632,817,117648,155280
train,3442,71,54528,1715,246960,301488
train,3443,18,13824,110,15840,29664
train,3444,113,86784,4344,625536,712320
train,3445,61,46848,1266,182304,229152
train,3446,22,16896,165,23760,40656
train,3447,59,45312,1184,170496,215808
train,3448,120,92160,4899,705456,797616
train,3449,143,109824,6957,1001808,1111632
train,3450,11,8448,41,5904,14352
train,3451,15,11520,77,11088,22608
train,3452,16,12288,87,12528,24816
train,3453,23,17664,180,25920,43584
train,3454,92,70656,2880,414720,485376
train,3455,11,8448,41,5904,14352
train,3456,49,37632,817,117648,155280
train,3457,42,32256,600,86400,118656
train,3458,79,60672,2123,305712,366384
train,3459,21,16128,150,21600,37728
train,3460,56,43008,1067,153648,196656
train,3461,23,17664,180,25920,43584
train,3462,34,26112,393,56592,82704
train,3463,242,185856,19923,2868912,3054768
train,3464,49,37632,817,117648,155280
train,3465,12,9216,49,7056,16272
train,3466,74,56832,1863,268272,325104
train,3467,24,18432,196,28224,46656
train,3468,64,49152,1394,200736,249888
train,3469,76,58368,1965,282960,341328
train,3470,18,13824,110,15840,29664
train,3471,12,9216,49,7056,16272
train,3472,67,51456,1527,219888,271344
train,3473,345,264960,33946,4888224,5153184
train,3474,20,15360,136,19584,34944
train,3475,26,19968,230,33120,53088
train,3476,14,10752,67,9648,20400
train,3477,30,23040,306,44064,67104
train,3478,56,43008,1067,153648,196656
train,3479,62,47616,1308,188352,235968
train,3480,73,56064,1813,261072,317136
train,3481,93,71424,2942,423648,495072
train,3482,164,125952,9150,1317600,1443552
train,3483,29,22272,286,41184,63456
train,3484,61,46848,1266,182304,229152
train,3485,43,33024,629,90576,123600
train,3486,89,68352,2695,388080,456432
train,3487,136,104448,6292,906048,1010496
train,3488,67,51456,1527,219888,271344
train,3489,29,22272,286,41184,63456
train,3490,78,59904,2070,298080,357984
train,3491,39,29952,518,74592,104544
train,3492,47,36096,752,108288,144384
train,3493,21,16128,150,21600,37728
train,3494,84,64512,2401,345744,410256
train,3495,10,7680,34,4896,12576
train,3496,212,162816,15290,2201760,2364576
train,3497,133,102144,6018,866592,968736
train,3498,56,43008,1067,153648,196656
train,3499,97,74496,3201,460944,535440
train,3500,13,9984,58,8352,18336
train,3501,63,48384,1350,194400,242784
train,3502,23,17664,180,25920,43584
train,3503,129,99072,5661,815184,914256
train,3504,56,43008,1067,153648,196656
train,3505,250,192000,21262,3061728,3253728
train,3506,56,43008,1067,153648,196656
train,3507,23,17664,180,25920,43584
train,3508,129,99072,5661,815184,914256
train,3509,18,13824,110,15840,29664
train,3510,119,91392,4818,693792,785184
train,3511,259,198912,20439,2943216,3142128
train,3512,141,108288,6763,973872,1082160
train,3513,33,25344,371,53424,78768
train,3514,16,12288,87,12528,24816
train,3515,90,69120,2756,396864,465984
train,3516,60,46080,1225,176400,222480
train,3517,67,51456,1527,219888,271344
train,3518,198,152064,13337,1920528,2072592
train,3519,28,21504,267,38448,59952
train,3520,56,43008,1067,153648,196656
train,3521,73,56064,1813,261072,317136
train,3522,23,17664,180,25920,43584
train,3523,30,23040,306,44064,67104
train,3524,145,111360,7153,1030032,1141392
train,3525,58,44544,1145,164880,209424
train,3526,14,10752,67,9648,20400
train,3527,37,28416,466,67104,95520
train,3528,38,29184,491,70704,99888
train,3529,37,28416,466,67104,95520
train,3530,63,48384,1350,194400,242784
train,3531,46,35328,720,103680,139008
train,3532,72,55296,1764,254016,309312
train,3533,13,9984,58,8352,18336
train,3534,146,112128,7252,1044288,1156416
train,3535,54,41472,992,142848,184320
train,3536,69,52992,1620,233280,286272
train,3537,12,9216,49,7056,16272
train,3538,16,12288,87,12528,24816
train,3539,112,86016,4267,614448,700464
train,3540,38,29184,491,70704,99888
train,3541,17,13056,98,14112,27168
train,3542,20,15360,136,19584,34944
train,3543,37,28416,466,67104,95520
train,3544,34,26112,393,56592,82704
train,3545,253,194304,19694,2835936,3030240
train,3546,51,39168,885,127440,166608
train,3547,21,16128,150,21600,37728
train,3548,122,93696,5064,729216,822912
train,3549,45,34560,689,99216,133776
train,3550,22,16896,165,23760,40656
train,3551,13,9984,58,8352,18336
train,3552,31,23808,327,47088,70896
train,3553,100,76800,3402,489888,566688
train,3554,58,44544,1145,164880,209424
train,3555,34,26112,393,56592,82704
train,3556,32,24576,349,50256,74832
train,3557,134,102912,6109,879696,982608
train,3558,295,226560,25919,3732336,3958896
train,3559,69,52992,1620,233280,286272
train,3560,35,26880,417,60048,86928
train,3561,145,111360,7153,1030032,1141392
train,3562,63,48384,1350,194400,242784
train,3563,25,19200,213,30672,49872
train,3564,65,49920,1437,206928,256848
train,3565,156,119808,8279,1192176,1311984
train,3566,91,69888,2817,405648,475536
train,3567,86,66048,2516,362304,428352
train,3568,10,7680,34,4896,12576
train,3569,153,117504,7964,1146816,1264320
train,3570,39,29952,518,74592,104544
train,3571,31,23808,327,47088,70896
train,3572,43,33024,629,90576,123600
train,3573,42,32256,600,86400,118656
train,3574,178,136704,10779,1552176,1688880
train,3575,108,82944,3968,571392,654336
train,3576,21,16128,150,21600,37728
train,3577,17,13056,98,14112,27168
train,3578,38,29184,491,70704,99888
train,3579,23,17664,180,25920,43584
train,3580,72,55296,1764,254016,309312
train,3581,21,16128,150,21600,37728
train,3582,49,37632,817,117648,155280
train,3583,25,19200,213,30672,49872
train,3584,116,89088,4578,659232,748320
train,3585,135,103680,6200,892800,996480
train,3586,74,56832,1863,268272,325104
train,3587,211,162048,15146,2181024,2343072
train,3588,163,125184,9039,1301616,1426800
train,3589,44,33792,659,94896,128688
train,3590,26,19968,230,33120,53088
train,3591,56,43008,1067,153648,196656
train,3592,54,41472,992,142848,184320
train,3593,22,16896,165,23760,40656
train,3594,46,35328,720,103680,139008
train,3595,55,42240,1029,148176,190416
train,3596,44,33792,659,94896,128688
train,3597,63,48384,1350,194400,242784
train,3598,49,37632,817,117648,155280
train,3599,15,11520,77,11088,22608
train,3600,102,78336,3539,509616,587952
train,3601,138,105984,6479,932976,1038960
train,3602,26,19968,230,33120,53088
train,3603,25,19200,213,30672,49872
train,3604,63,48384,1350,194400,242784
train,3605,95,72960,3070,442080,515040
train,3606,66,50688,1482,213408,264096
train,3607,176,135168,10538,1517472,1652640
train,3608,42,32256,600,86400,118656
train,3609,71,54528,1715,246960,301488
train,3610,125,96000,5316,765504,861504
train,3611,328,251904,29588,4260672,4512576
train,3612,62,47616,1308,188352,235968
train,3613,24,18432,196,28224,46656
train,3614,195,149760,12936,1862784,2012544
train,3615,57,43776,1105,159120,202896
train,3616,91,69888,2817,405648,475536
train,3617,74,56832,1863,268272,325104
train,3618,39,29952,518,74592,104544
train,3619,118,90624,4737,682128,772752
train,3620,48,36864,784,112896,149760
train,3621,79,60672,2123,305712,366384
train,3622,23,17664,180,25920,43584
train,3623,70,53760,1667,240048,293808
train,3624,62,47616,1308,188352,235968
train,3625,62,47616,1308,188352,235968
train,3626,27,20736,248,35712,56448
train,3627,69,52992,1620,233280,286272
train,3628,40,30720,544,78336,109056
train,3629,64,49152,1394,200736,249888
train,3630,29,22272,286,41184,63456
train,3631,39,29952,518,74592,104544
train,3632,49,37632,817,117648,155280
train,3633,13,9984,58,8352,18336
train,3634,50,38400,851,122544,160944
train,3635,25,19200,213,30672,49872
train,3636,126,96768,5401,777744,874512
train,3637,47,36096,752,108288,144384
train,3638,24,18432,196,28224,46656
train,3639,378,290304,39882,5743008,6033312
train,3640,16,12288,87,12528,24816
train,3641,58,44544,1145,164880,209424
train,3642,102,78336,3539,509616,587952
train,3643,22,16896,165,23760,40656
train,3644,23,17664,180,25920,43584
train,3645,46,35328,720,103680,139008
train,3646,22,16896,165,23760,40656
train,3647,13,9984,58,8352,18336
train,3648,79,60672,2123,305712,366384
train,3649,75,57600,1914,275616,333216
train,3650,20,15360,136,19584,34944
train,3651,23,17664,180,25920,43584
train,3652,41,31488,572,82368,113856
train,3653,17,13056,98,14112,27168
train,3654,92,70656,2880,414720,485376
train,3655,32,24576,349,50256,74832
train,3656,53,40704,956,137664,178368
train,3657,34,26112,393,56592,82704
train,3658,20,15360,136,19584,34944
train,3659,98,75264,3267,470448,545712
train,3660,123,94464,5147,741168,835632
train,3661,13,9984,58,8352,18336
train,3662,148,113664,7452,1073088,1186752
train,3663,16,12288,87,12528,24816
train,3664,43,33024,629,90576,123600
train,3665,21,16128,150,21600,37728
train,3666,97,74496,3201,460944,535440
train,3667,29,22272,286,41184,63456
train,3668,21,16128,150,21600,37728
train,3669,44,33792,659,94896,128688
train,3670,172,132096,10064,1449216,1581312
train,3671,98,75264,3267,470448,545712
train,3672,96,73728,3135,451440,525168
train,3673,21,16128,150,21600,37728
train,3674,143,109824,6957,1001808,1111632
train,3675,31,23808,327,47088,70896
train,3676,122,93696,5064,729216,822912
train,3677,107,82176,3895,560880,643056
train,3678,38,29184,491,70704,99888
train,3679,20,15360,136,19584,34944
train,3680,122,93696,5064,729216,822912
train,3681,84,64512,2401,345744,410256
train,3682,59,45312,1184,170496,215808
train,3683,59,45312,1184,170496,215808
train,3684,15,11520,77,11088,22608
train,3685,76,58368,1965,282960,341328
train,3686,110,84480,4116,592704,677184
train,3687,24,18432,196,28224,46656
train,3688,14,10752,67,9648,20400
train,3689,81,62208,2232,321408,383616
train,3690,22,16896,165,23760,40656
train,3691,65,49920,1437,206928,256848
train,3692,23,17664,180,25920,43584
train,3693,10,7680,34,4896,12576
train,3694,81,62208,2232,321408,383616
train,3695,68,52224,1573,226512,278736
train,3696,41,31488,572,82368,113856
train,3697,55,42240,1029,148176,190416
train,3698,40,30720,544,78336,109056
train,3699,23,17664,180,25920,43584
train,3700,33,25344,371,53424,78768
train,3701,21,16128,150,21600,37728
train,3702,21,16128,150,21600,37728
train,3703,48,36864,784,112896,149760
train,3704,63,48384,1350,194400,242784
train,3705,107,82176,3895,560880,643056
train,3706,31,23808,327,47088,70896
train,3707,105,80640,3751,540144,620784
train,3708,13,9984,58,8352,18336
train,3709,129,99072,5661,815184,914256
train,3710,39,29952,518,74592,104544
train,3711,45,34560,689,99216,133776
train,3712,119,91392,4818,693792,785184
train,3713,74,56832,1863,268272,325104
train,3714,26,19968,230,33120,53088
train,3715,24,18432,196,28224,46656
train,3716,24,18432,196,28224,46656
train,3717,23,17664,180,25920,43584
train,3718,13,9984,58,8352,18336
train,3719,113,86784,4344,625536,712320
train,3720,71,54528,1715,246960,301488
train,3721,34,26112,393,56592,82704
train,3722,23,17664,180,25920,43584
train,3723,48,36864,784,112896,149760
train,3724,31,23808,327,47088,70896
train,3725,43,33024,629,90576,123600
train,3726,55,42240,1029,148176,190416
train,3727,34,26112,393,56592,82704
train,3728,149,114432,7553,1087632,1202064
train,3729,92,70656,2880,414720,485376
train,3730,46,35328,720,103680,139008
train,3731,27,20736,248,35712,56448
train,3732,53,40704,956,137664,178368
train,3733,47,36096,752,108288,144384
train,3734,326,250368,30745,4427280,4677648
train,3735,40,30720,544,78336,109056
train,3736,132,101376,5928,853632,955008
train,3737,20,15360,136,19584,34944
train,3738,49,37632,817,117648,155280
train,3739,90,69120,2756,396864,465984
train,3740,132,101376,5928,853632,955008
train,3741,12,9216,49,7056,16272
train,3742,19,14592,123,17712,32304
train,3743,47,36096,752,108288,144384
train,3744,36,27648,441,63504,91152
train,3745,118,90624,4737,682128,772752
train,3746,62,47616,1308,188352,235968
train,3747,127,97536,5487,790128,887664
train,3748,21,16128,150,21600,37728
train,3749,11,8448,41,5904,14352
train,3750,36,27648,441,63504,91152
train,3751,66,50688,1482,213408,264096
train,3752,25,19200,213,30672,49872
train,3753,63,48384,1350,194400,242784
train,3754,22,16896,165,23760,40656
train,3755,94,72192,3006,432864,505056
train,3756,32,24576,349,50256,74832
train,3757,30,23040,306,44064,67104
train,3758,24,18432,196,28224,46656
train,3759,64,49152,1394,200736,249888
train,3760,391,300288,41923,6036912,6337200
train,3761,291,223488,24388,3511872,3735360
train,3762,24,18432,196,28224,46656
train,3763,37,28416,466,67104,95520
train,3764,32,24576,349,50256,74832
train,3765,162,124416,8928,1285632,1410048
train,3766,184,141312,11518,1658592,1799904
train,3767,81,62208,2232,321408,383616
train,3768,117,89856,4657,670608,760464
train,3769,22,16896,165,23760,40656
train,3770,22,16896,165,23760,40656
train,3771,87,66816,2575,370800,437616
train,3772,20,15360,136,19584,34944
train,3773,42,32256,600,86400,118656
train,3774,24,18432,196,28224,46656
train,3775,42,32256,600,86400,118656
train,3776,68,52224,1573,226512,278736
train,3777,73,56064,1813,261072,317136
train,3778,35,26880,417,60048,86928
train,3779,41,31488,572,82368,113856
train,3780,86,66048,2516,362304,428352
train,3781,63,48384,1350,194400,242784
train,3782,41,31488,572,82368,113856
train,3783,125,96000,5316,765504,861504
train,3784,15,11520,77,11088,22608
train,3785,38,29184,491,70704,99888
train,3786,44,33792,659,94896,128688
train,3787,142,109056,6860,987840,1096896
train,3788,36,27648,441,63504,91152
train,3789,100,76800,3402,489888,566688
train,3790,82,62976,2288,329472,392448
train,3791,128,98304,5574,802656,900960
train,3792,73,56064,1813,261072,317136
train,3793,81,62208,2232,321408,383616
train,3794,181,139008,11145,1604880,1743888
train,3795,80,61440,2177,313488,374928
train,3796,41,31488,572,82368,113856
train,3797,58,44544,1145,164880,209424
train,3798,23,17664,180,25920,43584
train,3799,24,18432,196,28224,46656
train,3800,24,18432,196,28224,46656
train,3801,85,65280,2458,353952,419232
train,3802,18,13824,110,15840,29664
train,3803,14,10752,67,9648,20400
train,3804,23,17664,180,25920,43584
train,3805,46,35328,720,103680,139008
train,3806,53,40704,956,137664,178368
train,3807,64,49152,1394,200736,249888
train,3808,38,29184,491,70704,99888
train,3809,117,89856,4657,670608,760464
train,3810,100,76800,3402,489888,566688
train,3811,67,51456,1527,219888,271344
train,3812,12,9216,49,7056,16272
train,3813,50,38400,851,122544,160944
train,3814,101,77568,3470,499680,577248
train,3815,81,62208,2232,321408,383616
train,3816,131,100608,5838,840672,941280
train,3817,37,28416,466,67104,95520
train,3818,27,20736,248,35712,56448
train,3819,38,29184,491,70704,99888
train,3820,135,103680,6200,892800,996480
train,3821,72,55296,1764,254016,309312
train,3822,211,162048,15146,2181024,2343072
train,3823,13,9984,58,8352,18336
train,3824,72,55296,1764,254016,309312
train,3825,17,13056,98,14112,27168
train,3826,68,52224,1573,226512,278736
train,3827,63,48384,1350,194400,242784
train,3828,43,33024,629,90576,123600
train,3829,188,144384,12024,1731456,1875840
train,3830,7,5376,17,2448,7824
train,3831,319,244992,29621,4265424,4510416
train,3832,11,8448,41,5904,14352
train,3833,47,36096,752,108288,144384
train,3834,53,40704,956,137664,178368
train,3835,43,33024,629,90576,123600
train,3836,27,20736,248,35712,56448
train,3837,100,76800,3402,489888,566688
train,3838,53,40704,956,137664,178368
train,3839,23,17664,180,25920,43584
train,3840,73,56064,1813,261072,317136
train,3841,73,56064,1813,261072,317136
train,3842,9,6912,28,4032,10944
train,3843,26,19968,230,33120,53088
train,3844,35,26880,417,60048,86928
train,3845,35,26880,417,60048,86928
train,3846,181,139008,11145,1604880,1743888
train,3847,42,32256,600,86400,118656
train,3848,42,32256,600,86400,118656
train,3849,225,172800,17222,2479968,2652768
train,3850,26,19968,230,33120,53088
train,3851,23,17664,180,25920,43584
train,3852,136,104448,6292,906048,1010496
train,3853,39,29952,518,74592,104544
train,3854,31,23808,327,47088,70896
train,3855,12,9216,49,7056,16272
train,3856,108,82944,3968,571392,654336
train,3857,15,11520,77,11088,22608
train,3858,28,21504,267,38448,59952
train,3859,63,48384,1350,194400,242784
train,3860,13,9984,58,8352,18336
train,3861,12,9216,49,7056,16272
train,3862,20,15360,136,19584,34944
train,3863,88,67584,2635,379440,447024
train,3864,131,100608,5838,840672,941280
train,3865,28,21504,267,38448,59952
train,3866,47,36096,752,108288,144384
train,3867,35,26880,417,60048,86928
train,3868,33,25344,371,53424,78768
train,3869,43,33024,629,90576,123600
train,3870,24,18432,196,28224,46656
train,3871,15,11520,77,11088,22608
train,3872,47,36096,752,108288,144384
train,3873,41,31488,572,82368,113856
train,3874,250,192000,21262,3061728,3253728
train,3875,18,13824,110,15840,29664
train,3876,59,45312,1184,170496,215808
train,3877,35,26880,417,60048,86928
train,3878,109,83712,4042,582048,665760
train,3879,73,56064,1813,261072,317136
train,3880,27,20736,248,35712,56448
train,3881,17,13056,98,14112,27168
train,3882,13,9984,58,8352,18336
train,3883,112,86016,4267,614448,700464
train,3884,13,9984,58,8352,18336
train,3885,323,248064,30148,4341312,4589376
train,3886,19,14592,123,17712,32304
train,3887,28,21504,267,38448,59952
train,3888,35,26880,417,60048,86928
train,3889,69,52992,1620,233280,286272
train,3890,21,16128,150,21600,37728
train,3891,29,22272,286,41184,63456
train,3892,75,57600,1914,275616,333216
train,3893,215,165120,15725,2264400,2429520
train,3894,88,67584,2635,379440,447024
train,3895,19,14592,123,17712,32304
train,3896,22,16896,165,23760,40656
train,3897,30,23040,306,44064,67104
train,3898,60,46080,1225,176400,222480
train,3899,199,152832,13472,1939968,2092800
train,3900,44,33792,659,94896,128688
train,3901,73,56064,1813,261072,317136
train,3902,57,43776,1105,159120,202896
train,3903,61,46848,1266,182304,229152
train,3904,26,19968,230,33120,53088
train,3905,15,11520,77,11088,22608
train,3906,150,115200,7654,1102176,1217376
train,3907,125,96000,5316,765504,861504
train,3908,23,17664,180,25920,43584
train,3909,68,52224,1573,226512,278736
train,3910,21,16128,150,21600,37728
train,3911,29,22272,286,41184,63456
train,3912,47,36096,752,108288,144384
train,3913,117,89856,4657,670608,760464
train,3914,74,56832,1863,268272,325104
train,3915,128,98304,5574,802656,900960
train,3916,78,59904,2070,298080,357984
train,3917,53,40704,956,137664,178368
train,3918,144,110592,7054,1015776,1126368
train,3919,177,135936,10658,1534752,1670688
train,3920,152,116736,7860,1131840,1248576
train,3921,21,16128,150,21600,37728
train,3922,16,12288,87,12528,24816
train,3923,16,12288,87,12528,24816
train,3924,78,59904,2070,298080,357984
train,3925,41,31488,572,82368,113856
train,3926,103,79104,3609,519696,598800
train,3927,25,19200,213,30672,49872
train,3928,48,36864,784,112896,149760
train,3929,53,40704,956,137664,178368
train,3930,59,45312,1184,170496,215808
train,3931,115,88320,4499,647856,736176
train,3932,40,30720,544,78336,109056
train,3933,26,19968,230,33120,53088
train,3934,73,56064,1813,261072,317136
train,3935,193,148224,12672,1824768,1972992
train,3936,21,16128,150,21600,37728
train,3937,27,20736,248,35712,56448
train,3938,25,19200,213,30672,49872
train,3939,40,30720,544,78336,109056
train,3940,174,133632,10300,1483200,1616832
train,3941,25,19200,213,30672,49872
train,3942,329,252672,30895,4448880,4701552
train,3943,21,16128,150,21600,37728
train,3944,67,51456,1527,219888,271344
train,3945,74,56832,1863,268272,325104
train,3946,69,52992,1620,233280,286272
train,3947,9,6912,28,4032,10944
train,3948,24,18432,196,28224,46656
train,3949,13,9984,58,8352,18336
train,3950,12,9216,49,7056,16272
train,3951,49,37632,817,117648,155280
train,3952,34,26112,393,56592,82704
train,3953,59,45312,1184,170496,215808
train,3954,24,18432,196,28224,46656
train,3955,133,102144,6018,866592,968736
train,3956,141,108288,6763,973872,1082160
train,3957,96,73728,3135,451440,525168
train,3958,14,10752,67,9648,20400
train,3959,69,52992,1620,233280,286272
train,3960,28,21504,267,38448,59952
train,3961,21,16128,150,21600,37728
train,3962,25,19200,213,30672,49872
train,3963,157,120576,8385,1207440,1328016
train,3964,43,33024,629,90576,123600
train,3965,19,14592,123,17712,32304
train,3966,64,49152,1394,200736,249888
train,3967,57,43776,1105,159120,202896
train,3968,73,56064,1813,261072,317136
train,3969,49,37632,817,117648,155280
train,3970,93,71424,2942,423648,495072
train,3971,27,20736,248,35712,56448
train,3972,76,58368,1965,282960,341328
train,3973,77,59136,2017,290448,349584
train,3974,26,19968,230,33120,53088
train,3975,84,64512,2401,345744,410256
train,3976,87,66816,2575,370800,437616
train,3977,84,64512,2401,345744,410256
train,3978,70,53760,1667,240048,293808
train,3979,30,23040,306,44064,67104
train,3980,45,34560,689,99216,133776
train,3981,33,25344,371,53424,78768
train,3982,88,67584,2635,379440,447024
train,3983,68,52224,1573,226512,278736
train,3984,38,29184,491,70704,99888
train,3985,68,52224,1573,226512,278736
train,3986,121,92928,4981,717264,810192
train,3987,36,27648,441,63504,91152
train,3988,25,19200,213,30672,49872
train,3989,49,37632,817,117648,155280
train,3990,185,142080,11643,1676592,1818672
train,3991,17,13056,98,14112,27168
train,3992,164,125952,9150,1317600,1443552
train,3993,119,91392,4818,693792,785184
train,3994,69,52992,1620,233280,286272
train,3995,108,82944,3968,571392,654336
train,3996,67,51456,1527,219888,271344
train,3997,22,16896,165,23760,40656
train,3998,17,13056,98,14112,27168
train,3999,48,36864,784,112896,149760
train,4000,75,57600,1914,275616,333216
train,4001,63,48384,1350,194400,242784
train,4002,20,15360,136,19584,34944
train,4003,49,37632,817,117648,155280
train,4004,63,48384,1350,194400,242784
train,4005,39,29952,518,74592,104544
train,4006,28,21504,267,38448,59952
train,4007,145,111360,7153,1030032,1141392
train,4008,30,23040,306,44064,67104
train,4009,30,23040,306,44064,67104
train,4010,55,42240,1029,148176,190416
train,4011,102,78336,3539,509616,587952
train,4012,11,8448,41,5904,14352
train,4013,30,23040,306,44064,67104
train,4014,229,175872,17840,2568960,2744832
train,4015,34,26112,393,56592,82704
train,4016,91,69888,2817,405648,475536
train,4017,57,43776,1105,159120,202896
train,4018,69,52992,1620,233280,286272
train,4019,19,14592,123,17712,32304
train,4020,61,46848,1266,182304,229152
train,4021,101,77568,3470,499680,577248
train,4022,59,45312,1184,170496,215808
train,4023,57,43776,1105,159120,202896
train,4024,336,258048,32643,4700592,4958640
train,4025,28,21504,267,38448,59952
train,4026,136,104448,6292,906048,1010496
train,4027,36,27648,441,63504,91152
train,4028,156,119808,8279,1192176,1311984
train,4029,43,33024,629,90576,123600
train,4030,51,39168,885,127440,166608
train,4031,60,46080,1225,176400,222480
train,4032,29,22272,286,41184,63456
train,4033,26,19968,230,33120,53088
train,4034,41,31488,572,82368,113856
train,4035,16,12288,87,12528,24816
train,4036,221,169728,16283,2344752,2514480
train,4037,41,31488,572,82368,113856
train,4038,114,87552,4421,636624,724176
train,4039,43,33024,629,90576,123600
train,4040,20,15360,136,19584,34944
train,4041,55,42240,1029,148176,190416
train,4042,76,58368,1965,282960,341328
train,4043,102,78336,3539,509616,587952
train,4044,310,238080,27309,3932496,4170576
train,4045,78,59904,2070,298080,357984
train,4046,203,155904,14019,2018736,2174640
train,4047,19,14592,123,17712,32304
train,4048,55,42240,1029,148176,190416
train,4049,43,33024,629,90576,123600
train,4050,44,33792,659,94896,128688
train,4051,66,50688,1482,213408,264096
train,4052,141,108288,6763,973872,1082160
train,4053,89,68352,2695,388080,456432
train,4054,41,31488,572,82368,113856
train,4055,45,34560,689,99216,133776
train,4056,47,36096,752,108288,144384
train,4057,103,79104,3609,519696,598800
train,4058,26,19968,230,33120,53088
train,4059,59,45312,1184,170496,215808
train,4060,166,127488,9374,1349856,1477344
train,4061,11,8448,41,5904,14352
train,4062,28,21504,267,38448,59952
train,4063,68,52224,1573,226512,278736
train,4064,80,61440,2177,313488,374928
train,4065,79,60672,2123,305712,366384
train,4066,191,146688,12411,1787184,1933872
train,4067,105,80640,3751,540144,620784
train,4068,190,145920,12281,1768464,1914384
train,4069,41,31488,572,82368,113856
train,4070,34,26112,393,56592,82704
train,4071,44,33792,659,94896,128688
train,4072,11,8448,41,5904,14352
train,4073,23,17664,180,25920,43584
train,4074,196,150528,13069,1881936,2032464
train,4075,53,40704,956,137664,178368
train,4076,191,146688,12411,1787184,1933872
train,4077,68,52224,1573,226512,278736
train,4078,22,16896,165,23760,40656
train,4079,124,95232,5231,753264,848496
train,4080,27,20736,248,35712,56448
train,4081,23,17664,180,25920,43584
train,4082,40,30720,544,78336,109056
train,4083,44,33792,659,94896,128688
train,4084,103,79104,3609,519696,598800
train,4085,40,30720,544,78336,109056
train,4086,267,205056,23231,3345264,3550320
train,4087,24,18432,196,28224,46656
train,4088,70,53760,1667,240048,293808
train,4089,73,56064,1813,261072,317136
train,4090,40,30720,544,78336,109056
train,4091,28,21504,267,38448,59952
train,4092,13,9984,58,8352,18336
train,4093,142,109056,6860,987840,1096896
train,4094,215,165120,15116,2176704,2341824
train,4095,36,27648,441,63504,91152
train,4096,26,19968,230,33120,53088
train,4097,56,43008,1067,153648,196656
train,4098,60,46080,1225,176400,222480
train,4099,112,86016,4267,614448,700464
train,4100,66,50688,1482,213408,264096
train,4101,24,18432,196,28224,46656
train,4102,66,50688,1482,213408,264096
train,4103,62,47616,1308,188352,235968
train,4104,22,16896,165,23760,40656
train,4105,34,26112,393,56592,82704
train,4106,178,136704,10779,1552176,1688880
train,4107,60,46080,1225,176400,222480
train,4108,80,61440,2177,313488,374928
train,4109,147,112896,7351,1058544,1171440
train,4110,80,61440,2177,313488,374928
train,4111,22,16896,165,23760,40656
train,4112,129,99072,5661,815184,914256
train,4113,41,31488,572,82368,113856
train,4114,105,80640,3751,540144,620784
train,4115,250,192000,21262,3061728,3253728
train,4116,199,152832,13224,1904256,2057088
train,4117,105,80640,3751,540144,620784
train,4118,123,94464,5147,741168,835632
train,4119,206,158208,14436,2078784,2236992
train,4120,74,56832,1863,268272,325104
train,4121,21,16128,150,21600,37728
train,4122,129,99072,5661,815184,914256
train,4123,35,26880,417,60048,86928
train,4124,64,49152,1394,200736,249888
train,4125,21,16128,150,21600,37728
train,4126,22,16896,165,23760,40656
train,4127,105,80640,3751,540144,620784
train,4128,26,19968,230,33120,53088
train,4129,305,234240,27769,3998736,4232976
train,4130,71,54528,1715,246960,301488
train,4131,78,59904,2070,298080,357984
train,4132,115,88320,4499,647856,736176
train,4133,67,51456,1527,219888,271344
train,4134,15,11520,77,11088,22608
train,4135,37,28416,466,67104,95520
train,4136,67,51456,1527,219888,271344
train,4137,138,105984,6479,932976,1038960
train,4138,42,32256,600,86400,118656
train,4139,99,76032,3334,480096,556128
train,4140,189,145152,12152,1749888,1895040
train,4141,67,51456,1527,219888,271344
train,4142,105,80640,3751,540144,620784
train,4143,52,39936,920,132480,172416
train,4144,46,35328,720,103680,139008
train,4145,139,106752,6573,946512,1053264
train,4146,56,43008,1067,153648,196656
train,4147,58,44544,1145,164880,209424
train,4148,46,35328,720,103680,139008
train,4149,101,77568,3470,499680,577248
train,4150,98,75264,3267,470448,545712
train,4151,139,106752,6573,946512,1053264
train,4152,59,45312,1184,170496,215808
train,4153,13,9984,58,8352,18336
train,4154,52,39936,920,132480,172416
train,4155,15,11520,77,11088,22608
train,4156,82,62976,2288,329472,392448
train,4157,41,31488,572,82368,113856
train,4158,178,136704,10779,1552176,1688880
train,4159,37,28416,466,67104,95520
train,4160,33,25344,371,53424,78768
train,4161,69,52992,1620,233280,286272
train,4162,24,18432,196,28224,46656
train,4163,33,25344,371,53424,78768
train,4164,31,23808,327,47088,70896
train,4165,35,26880,417,60048,86928
train,4166,142,109056,6860,987840,1096896
train,4167,74,56832,1863,268272,325104
train,4168,19,14592,123,17712,32304
train,4169,25,19200,213,30672,49872
train,4170,22,16896,165,23760,40656
train,4171,68,52224,1573,226512,278736
train,4172,40,30720,544,78336,109056
train,4173,49,37632,817,117648,155280
train,4174,55,42240,1029,148176,190416
train,4175,53,40704,956,137664,178368
train,4176,32,24576,349,50256,74832
train,4177,25,19200,213,30672,49872
train,4178,25,19200,213,30672,49872
train,4179,48,36864,784,112896,149760
train,4180,204,156672,14157,2038608,2195280
train,4181,70,53760,1667,240048,293808
train,4182,46,35328,720,103680,139008
train,4183,35,26880,417,60048,86928
train,4184,101,77568,3470,499680,577248
train,4185,100,76800,3402,489888,566688
train,4186,208,159744,14718,2119392,2279136
train,4187,53,40704,956,137664,178368
train,4188,76,58368,1965,282960,341328
train,4189,107,82176,3895,560880,643056
train,4190,101,77568,3470,499680,577248
train,4191,50,38400,851,122544,160944
train,4192,32,24576,349,50256,74832
train,4193,55,42240,1029,148176,190416
train,4194,41,31488,572,82368,113856
train,4195,19,14592,123,17712,32304
train,4196,16,12288,87,12528,24816
train,4197,42,32256,600,86400,118656
train,4198,52,39936,920,132480,172416
train,4199,35,26880,417,60048,86928
train,4200,396,304128,42373,6101712,6405840
train,4201,68,52224,1573,226512,278736
train,4202,72,55296,1764,254016,309312
train,4203,250,192000,20160,2903040,3095040
train,4204,79,60672,2123,305712,366384
train,4205,54,41472,992,142848,184320
train,4206,66,50688,1482,213408,264096
train,4207,34,26112,393,56592,82704
train,4208,28,21504,267,38448,59952
train,4209,23,17664,180,25920,43584
train,4210,27,20736,248,35712,56448
train,4211,29,22272,286,41184,63456
train,4212,41,31488,572,82368,113856
train,4213,259,198912,22716,3271104,3470016
train,4214,41,31488,572,82368,113856
train,4215,40,30720,544,78336,109056
train,4216,77,59136,2017,290448,349584
train,4217,10,7680,34,4896,12576
train,4218,42,32256,600,86400,118656
train,4219,220,168960,16235,2337840,2506800
train,4220,28,21504,267,38448,59952
train,4221,42,32256,600,86400,118656
train,4222,31,23808,327,47088,70896
train,4223,37,28416,466,67104,95520
train,4224,23,17664,180,25920,43584
train,4225,71,54528,1715,246960,301488
train,4226,36,27648,441,63504,91152
train,4227,24,18432,196,28224,46656
train,4228,33,25344,371,53424,78768
train,4229,71,54528,1715,246960,301488
train,4230,36,27648,441,63504,91152
train,4231,129,99072,5661,815184,914256
train,4232,323,248064,29651,4269744,4517808
train,4233,78,59904,2070,298080,357984
train,4234,40,30720,544,78336,109056
train,4235,22,16896,165,23760,40656
train,4236,25,19200,213,30672,49872
train,4237,62,47616,1308,188352,235968
train,4238,36,27648,441,63504,91152
train,4239,23,17664,180,25920,43584
train,4240,153,117504,7964,1146816,1264320
train,4241,42,32256,600,86400,118656
train,4242,54,41472,992,142848,184320
train,4243,145,111360,7153,1030032,1141392
train,4244,42,32256,600,86400,118656
train,4245,27,20736,248,35712,56448
train,4246,58,44544,1145,164880,209424
train,4247,31,23808,327,47088,70896
train,4248,22,16896,165,23760,40656
train,4249,45,34560,689,99216,133776
train,4250,20,15360,136,19584,34944
train,4251,48,36864,784,112896,149760
train,4252,13,9984,58,8352,18336
train,4253,177,135936,10658,1534752,1670688
train,4254,165,126720,9262,1333728,1460448
train,4255,55,42240,1029,148176,190416
train,4256,117,89856,4657,670608,760464
train,4257,66,50688,1482,213408,264096
train,4258,31,23808,327,47088,70896
train,4259,52,39936,920,132480,172416
train,4260,98,75264,3267,470448,545712
train,4261,20,15360,136,19584,34944
train,4262,57,43776,1105,159120,202896
train,4263,21,16128,150,21600,37728
train,4264,12,9216,49,7056,16272
train,4265,74,56832,1863,268272,325104
train,4266,83,63744,2344,337536,401280
train,4267,32,24576,349,50256,74832
train,4268,107,82176,3895,560880,643056
train,4269,27,20736,248,35712,56448
train,4270,126,96768,5401,777744,874512
train,4271,45,34560,689,99216,133776
train,4272,127,97536,5487,790128,887664
train,4273,37,28416,466,67104,95520
train,4274,72,55296,1764,254016,309312
train,4275,47,36096,752,108288,144384
train,4276,12,9216,49,7056,16272
train,4277,34,26112,393,56592,82704
train,4278,88,67584,2635,379440,447024
train,4279,94,72192,3006,432864,505056
train,4280,28,21504,267,38448,59952
train,4281,37,28416,466,67104,95520
train,4282,67,51456,1527,219888,271344
train,4283,21,16128,150,21600,37728
train,4284,49,37632,817,117648,155280
train,4285,84,64512,2401,345744,410256
train,4286,61,46848,1266,182304,229152
train,4287,69,52992,1620,233280,286272
train,4288,74,56832,1863,268272,325104
train,4289,27,20736,248,35712,56448
train,4290,131,100608,5838,840672,941280
train,4291,244,187392,19507,2809008,2996400
train,4292,121,92928,4981,717264,810192
train,4293,39,29952,518,74592,104544
train,4294,67,51456,1527,219888,271344
train,4295,288,221184,26176,3769344,3990528
train,4296,119,91392,4818,693792,785184
train,4297,64,49152,1394,200736,249888
train,4298,112,86016,4268,614592,700608
train,4299,104,79872,3680,529920,609792
train,4300,32,24576,349,50256,74832
train,4301,47,36096,752,108288,144384
train,4302,11,8448,41,5904,14352
train,4303,102,78336,3539,509616,587952
train,4304,124,95232,5231,753264,848496
train,4305,134,102912,6109,879696,982608
train,4306,81,62208,2232,321408,383616
train,4307,311,238848,26437,3806928,4045776
train,4308,132,101376,5928,853632,955008
train,4309,60,46080,1225,176400,222480
train,4310,63,48384,1350,194400,242784
train,4311,46,35328,720,103680,139008
train,4312,49,37632,817,117648,155280
train,4313,26,19968,230,33120,53088
train,4314,23,17664,180,25920,43584
train,4315,44,33792,659,94896,128688
train,4316,30,23040,306,44064,67104
train,4317,93,71424,2942,423648,495072
train,4318,105,80640,3751,540144,620784
train,4319,117,89856,4657,670608,760464
train,4320,13,9984,58,8352,18336
train,4321,21,16128,150,21600,37728
train,4322,39,29952,518,74592,104544
train,4323,70,53760,1667,240048,293808
train,4324,86,66048,2516,362304,428352
train,4325,34,26112,393,56592,82704
train,4326,44,33792,659,94896,128688
train,4327,64,49152,1394,200736,249888
train,4328,52,39936,920,132480,172416
train,4329,60,46080,1225,176400,222480
train,4330,56,43008,1067,153648,196656
train,4331,47,36096,752,108288,144384
train,4332,36,27648,441,63504,91152
train,4333,73,56064,1813,261072,317136
train,4334,14,10752,67,9648,20400
train,4335,252,193536,19781,2848464,3042000
train,4336,58,44544,1145,164880,209424
train,4337,84,64512,2401,345744,410256
train,4338,64,49152,1394,200736,249888
train,4339,129,99072,5661,815184,914256
train,4340,28,21504,267,38448,59952
train,4341,49,37632,817,117648,155280
train,4342,120,92160,4899,705456,797616
train,4343,23,17664,180,25920,43584
train,4344,49,37632,817,117648,155280
train,4345,44,33792,659,94896,128688
train,4346,14,10752,67,9648,20400
train,4347,57,43776,1105,159120,202896
train,4348,143,109824,6957,1001808,1111632
train,4349,33,25344,371,53424,78768
train,4350,195,149760,12936,1862784,2012544
train,4351,20,15360,136,19584,34944
train,4352,46,35328,720,103680,139008
train,4353,15,11520,77,11088,22608
train,4354,127,97536,5487,790128,887664
train,4355,16,12288,87,12528,24816
train,4356,14,10752,67,9648,20400
train,4357,351,269568,34428,4957632,5227200
train,4358,47,36096,752,108288,144384
train,4359,51,39168,885,127440,166608
train,4360,53,40704,956,137664,178368
train,4361,47,36096,752,108288,144384
train,4362,77,59136,2017,290448,349584
train,4363,27,20736,248,35712,56448
train,4364,11,8448,41,5904,14352
train,4365,52,39936,920,132480,172416
train,4366,51,39168,885,127440,166608
train,4367,14,10752,67,9648,20400
train,4368,117,89856,4657,670608,760464
train,4369,71,54528,1715,246960,301488
train,4370,281,215808,24200,3484800,3700608
train,4371,80,61440,2177,313488,374928
train,4372,56,43008,1067,153648,196656
train,4373,163,125184,9039,1301616,1426800
train,4374,153,117504,7964,1146816,1264320
train,4375,16,12288,87,12528,24816
train,4376,59,45312,1184,170496,215808
train,4377,52,39936,920,132480,172416
train,4378,49,37632,817,117648,155280
train,4379,49,37632,817,117648,155280
train,4380,39,29952,518,74592,104544
train,4381,25,19200,213,30672,49872
train,4382,143,109824,6957,1001808,1111632
train,4383,109,83712,4042,582048,665760
train,4384,64,49152,1394,200736,249888
train,4385,95,72960,3070,442080,515040
train,4386,72,55296,1764,254016,309312
train,4387,62,47616,1308,188352,235968
validation,0,33,25344,371,53424,78768
validation,1,51,39168,885,127440,166608
validation,2,37,28416,466,67104,95520
validation,3,33,25344,371,53424,78768
validation,4,23,17664,180,25920,43584
validation,5,47,36096,752,108288,144384
validation,6,22,16896,165,23760,40656
validation,7,65,49920,1437,206928,256848
validation,8,35,26880,417,60048,86928
validation,9,23,17664,180,25920,43584
validation,10,39,29952,518,74592,104544
validation,11,27,20736,248,35712,56448
validation,12,14,10752,67,9648,20400
validation,13,19,14592,123,17712,32304
validation,14,60,46080,1225,176400,222480
validation,15,83,63744,2344,337536,401280
validation,16,51,39168,885,127440,166608
validation,17,24,18432,196,28224,46656
validation,18,18,13824,110,15840,29664
validation,19,63,48384,1350,194400,242784
validation,20,60,46080,1225,176400,222480
validation,21,230,176640,17996,2591424,2768064
validation,22,67,51456,1527,219888,271344
validation,23,15,11520,77,11088,22608
validation,24,210,161280,15003,2160432,2321712
validation,25,20,15360,136,19584,34944
validation,26,33,25344,371,53424,78768
validation,27,63,48384,1350,194400,242784
validation,28,80,61440,2177,313488,374928
validation,29,93,71424,2942,423648,495072
validation,30,30,23040,306,44064,67104
validation,31,106,81408,3823,550512,631920
validation,32,21,16128,150,21600,37728
validation,33,15,11520,77,11088,22608
validation,34,38,29184,491,70704,99888
validation,35,40,30720,544,78336,109056
validation,36,38,29184,491,70704,99888
validation,37,14,10752,67,9648,20400
validation,38,357,274176,34424,4957056,5231232
validation,39,216,165888,15872,2285568,2451456
validation,40,45,34560,689,99216,133776
validation,41,218,167424,16167,2328048,2495472
validation,42,144,110592,7054,1015776,1126368
validation,43,53,40704,956,137664,178368
validation,44,119,91392,4818,693792,785184
validation,45,193,148224,12672,1824768,1972992
validation,46,42,32256,600,86400,118656
validation,47,35,26880,417,60048,86928
validation,48,62,47616,1308,188352,235968
validation,49,54,41472,992,142848,184320
validation,50,40,30720,544,78336,109056
validation,51,49,37632,817,117648,155280
validation,52,23,17664,180,25920,43584
validation,53,317,243456,28217,4063248,4306704
validation,54,30,23040,306,44064,67104
validation,55,47,36096,752,108288,144384
validation,56,32,24576,349,50256,74832
validation,57,14,10752,67,9648,20400
validation,58,132,101376,5928,853632,955008
validation,59,297,228096,24570,3538080,3766176
validation,60,53,40704,956,137664,178368
validation,61,79,60672,2123,305712,366384
validation,62,43,33024,629,90576,123600
validation,63,12,9216,49,7056,16272
validation,64,40,30720,544,78336,109056
validation,65,46,35328,720,103680,139008
validation,66,44,33792,659,94896,128688
validation,67,27,20736,248,35712,56448
validation,68,40,30720,544,78336,109056
validation,69,43,33024,629,90576,123600
validation,70,46,35328,720,103680,139008
validation,71,114,87552,4421,636624,724176
validation,72,321,246528,29208,4205952,4452480
validation,73,191,146688,12411,1787184,1933872
validation,74,78,59904,2070,298080,357984
validation,75,97,74496,3201,460944,535440
validation,76,23,17664,180,25920,43584
validation,77,80,61440,2177,313488,374928
validation,78,172,132096,10064,1449216,1581312
validation,79,84,64512,2401,345744,410256
validation,80,205,157440,14297,2058768,2216208
validation,81,9,6912,28,4032,10944
validation,82,31,23808,327,47088,70896
validation,83,118,90624,4737,682128,772752
validation,84,27,20736,248,35712,56448
validation,85,17,13056,98,14112,27168
validation,86,160,122880,8709,1254096,1376976
validation,87,106,81408,3823,550512,631920
validation,88,92,70656,2880,414720,485376
validation,89,35,26880,417,60048,86928
validation,90,39,29952,518,74592,104544
validation,91,202,155136,13881,1998864,2154000
validation,92,48,36864,784,112896,149760
validation,93,48,36864,784,112896,149760
validation,94,296,227328,25091,3613104,3840432
validation,95,58,44544,1145,164880,209424
validation,96,22,16896,165,23760,40656
validation,97,56,43008,1067,153648,196656
validation,98,116,89088,4578,659232,748320
validation,99,21,16128,150,21600,37728
validation,100,34,26112,393,56592,82704
validation,101,31,23808,327,47088,70896
validation,102,169,129792,9716,1399104,1528896
validation,103,42,32256,600,86400,118656
validation,104,291,223488,23321,3358224,3581712
validation,105,182,139776,11269,1622736,1762512
validation,106,18,13824,110,15840,29664
validation,107,54,41472,992,142848,184320
validation,108,97,74496,3201,460944,535440
validation,109,9,6912,28,4032,10944
validation,110,64,49152,1394,200736,249888
validation,111,122,93696,5064,729216,822912
validation,112,30,23040,306,44064,67104
validation,113,27,20736,248,35712,56448
validation,114,38,29184,491,70704,99888
validation,115,12,9216,49,7056,16272
validation,116,13,9984,58,8352,18336
validation,117,340,261120,33920,4884480,5145600
validation,118,214,164352,15579,2243376,2407728
validation,119,44,33792,659,94896,128688
validation,120,89,68352,2695,388080,456432
validation,121,84,64512,2401,345744,410256
validation,122,127,97536,5487,790128,887664
validation,123,31,23808,327,47088,70896
validation,124,84,64512,2401,345744,410256
validation,125,286,219648,24234,3489696,3709344
validation,126,37,28416,466,67104,95520
validation,127,79,60672,2123,305712,366384
validation,128,175,134400,10418,1500192,1634592
validation,129,378,290304,39197,5644368,5934672
validation,130,50,38400,851,122544,160944
validation,131,107,82176,3895,560880,643056
validation,132,57,43776,1105,159120,202896
validation,133,233,178944,18469,2659536,2838480
validation,134,55,42240,1029,148176,190416
validation,135,106,81408,3823,550512,631920
validation,136,51,39168,885,127440,166608
validation,137,35,26880,417,60048,86928
validation,138,112,86016,4267,614448,700464
validation,139,53,40704,956,137664,178368
validation,140,112,86016,4267,614448,700464
validation,141,52,39936,920,132480,172416
validation,142,87,66816,2575,370800,437616
validation,143,62,47616,1308,188352,235968
validation,144,192,147456,12541,1805904,1953360
validation,145,62,47616,1308,188352,235968
validation,146,13,9984,58,8352,18336
validation,147,61,46848,1266,182304,229152
validation,148,16,12288,87,12528,24816
validation,149,32,24576,349,50256,74832
validation,150,22,16896,165,23760,40656
validation,151,319,244992,29251,4212144,4457136
validation,152,120,92160,4899,705456,797616
validation,153,154,118272,8068,1161792,1280064
validation,154,261,200448,19927,2869488,3069936
validation,155,45,34560,689,99216,133776
validation,156,402,308736,43656,6286464,6595200
validation,157,52,39936,920,132480,172416
validation,158,87,66816,2575,370800,437616
validation,159,11,8448,41,5904,14352
validation,160,85,65280,2458,353952,419232
validation,161,83,63744,2344,337536,401280
validation,162,52,39936,920,132480,172416
validation,163,35,26880,417,60048,86928
validation,164,54,41472,992,142848,184320
validation,165,74,56832,1863,268272,325104
validation,166,23,17664,180,25920,43584
validation,167,11,8448,41,5904,14352
validation,168,67,51456,1527,219888,271344
validation,169,200,153600,13608,1959552,2113152
validation,170,58,44544,1145,164880,209424
validation,171,104,79872,3680,529920,609792
validation,172,24,18432,196,28224,46656
validation,173,59,45312,1184,170496,215808
validation,174,51,39168,885,127440,166608
validation,175,65,49920,1437,206928,256848
validation,176,57,43776,1105,159120,202896
validation,177,46,35328,720,103680,139008
validation,178,60,46080,1225,176400,222480
validation,179,22,16896,165,23760,40656
validation,180,131,100608,5838,840672,941280
validation,181,36,27648,441,63504,91152
validation,182,95,72960,3070,442080,515040
validation,183,130,99840,5749,827856,927696
validation,184,20,15360,136,19584,34944
validation,185,61,46848,1266,182304,229152
validation,186,143,109824,6957,1001808,1111632
validation,187,27,20736,248,35712,56448
validation,188,13,9984,58,8352,18336
validation,189,36,27648,441,63504,91152
validation,190,19,14592,123,17712,32304
validation,191,43,33024,629,90576,123600
validation,192,77,59136,2017,290448,349584
validation,193,23,17664,180,25920,43584
validation,194,43,33024,629,90576,123600
validation,195,24,18432,196,28224,46656
validation,196,21,16128,150,21600,37728
validation,197,42,32256,600,86400,118656
validation,198,62,47616,1308,188352,235968
validation,199,22,16896,165,23760,40656
validation,200,21,16128,150,21600,37728
validation,201,15,11520,77,11088,22608
validation,202,23,17664,180,25920,43584
validation,203,13,9984,58,8352,18336
validation,204,198,152064,13337,1920528,2072592
validation,205,32,24576,349,50256,74832
validation,206,54,41472,992,142848,184320
validation,207,10,7680,34,4896,12576
validation,208,35,26880,417,60048,86928
validation,209,82,62976,2288,329472,392448
validation,210,41,31488,572,82368,113856
validation,211,19,14592,123,17712,32304
validation,212,45,34560,689,99216,133776
validation,213,52,39936,920,132480,172416
validation,214,89,68352,2695,388080,456432
validation,215,124,95232,5231,753264,848496
validation,216,22,16896,165,23760,40656
validation,217,45,34560,689,99216,133776
validation,218,37,28416,466,67104,95520
validation,219,15,11520,77,11088,22608
validation,220,63,48384,1350,194400,242784
validation,221,46,35328,720,103680,139008
validation,222,56,43008,1067,153648,196656
validation,223,47,36096,752,108288,144384
validation,224,30,23040,306,44064,67104
validation,225,25,19200,213,30672,49872
validation,226,38,29184,491,70704,99888
validation,227,11,8448,41,5904,14352
validation,228,51,39168,885,127440,166608
validation,229,52,39936,920,132480,172416
validation,230,43,33024,629,90576,123600
validation,231,69,52992,1620,233280,286272
validation,232,75,57600,1914,275616,333216
validation,233,56,43008,1067,153648,196656
validation,234,22,16896,165,23760,40656
validation,235,11,8448,41,5904,14352
validation,236,126,96768,5401,777744,874512
validation,237,51,39168,885,127440,166608
validation,238,25,19200,213,30672,49872
validation,239,47,36096,752,108288,144384
validation,240,86,66048,2516,362304,428352
validation,241,45,34560,689,99216,133776
validation,242,66,50688,1482,213408,264096
validation,243,12,9216,49,7056,16272
validation,244,56,43008,1067,153648,196656
validation,245,12,9216,49,7056,16272
validation,246,110,84480,4116,592704,677184
validation,247,22,16896,165,23760,40656
validation,248,158,121344,8493,1222992,1344336
validation,249,93,71424,2942,423648,495072
validation,250,50,38400,851,122544,160944
validation,251,25,19200,213,30672,49872
validation,252,79,60672,2123,305712,366384
validation,253,46,35328,720,103680,139008
validation,254,48,36864,784,112896,149760
validation,255,16,12288,87,12528,24816
validation,256,126,96768,5401,777744,874512
validation,257,25,19200,213,30672,49872
validation,258,197,151296,13203,1901232,2052528
validation,259,147,112896,7351,1058544,1171440
validation,260,24,18432,196,28224,46656
validation,261,44,33792,659,94896,128688
validation,262,45,34560,689,99216,133776
validation,263,54,41472,992,142848,184320
validation,264,55,42240,1029,148176,190416
validation,265,19,14592,123,17712,32304
validation,266,34,26112,393,56592,82704
validation,267,28,21504,267,38448,59952
validation,268,46,35328,720,103680,139008
validation,269,183,140544,11393,1640592,1781136
validation,270,23,17664,180,25920,43584
validation,271,53,40704,956,137664,178368
validation,272,60,46080,1225,176400,222480
validation,273,36,27648,441,63504,91152
validation,274,71,54528,1715,246960,301488
validation,275,113,86784,4344,625536,712320
validation,276,68,52224,1573,226512,278736
validation,277,147,112896,7351,1058544,1171440
validation,278,63,48384,1350,194400,242784
validation,279,84,64512,2401,345744,410256
validation,280,11,8448,41,5904,14352
validation,281,58,44544,1145,164880,209424
validation,282,64,49152,1394,200736,249888
validation,283,39,29952,518,74592,104544
validation,284,129,99072,5661,815184,914256
validation,285,76,58368,1965,282960,341328
validation,286,77,59136,2017,290448,349584
validation,287,79,60672,2123,305712,366384
validation,288,25,19200,213,30672,49872
validation,289,11,8448,41,5904,14352
validation,290,17,13056,98,14112,27168
validation,291,64,49152,1394,200736,249888
validation,292,31,23808,327,47088,70896
validation,293,39,29952,518,74592,104544
validation,294,47,36096,752,108288,144384
validation,295,18,13824,110,15840,29664
validation,296,32,24576,349,50256,74832
validation,297,137,105216,6385,919440,1024656
validation,298,19,14592,123,17712,32304
validation,299,88,67584,2635,379440,447024
validation,300,32,24576,349,50256,74832
validation,301,229,175872,17840,2568960,2744832
validation,302,97,74496,3201,460944,535440
validation,303,34,26112,393,56592,82704
validation,304,45,34560,689,99216,133776
validation,305,31,23808,327,47088,70896
validation,306,58,44544,1145,164880,209424
validation,307,21,16128,150,21600,37728
validation,308,9,6912,28,4032,10944
validation,309,69,52992,1620,233280,286272
validation,310,155,119040,8173,1176912,1295952
validation,311,80,61440,2177,313488,374928
validation,312,35,26880,417,60048,86928
validation,313,114,87552,4421,636624,724176
validation,314,59,45312,1184,170496,215808
validation,315,15,11520,77,11088,22608
validation,316,43,33024,629,90576,123600
validation,317,66,50688,1482,213408,264096
validation,318,171,131328,9948,1432512,1563840
validation,319,10,7680,34,4896,12576
validation,320,22,16896,165,23760,40656
validation,321,19,14592,123,17712,32304
validation,322,180,138240,11022,1587168,1725408
validation,323,41,31488,572,82368,113856
validation,324,13,9984,58,8352,18336
validation,325,48,36864,784,112896,149760
validation,326,25,19200,213,30672,49872
validation,327,80,61440,2177,313488,374928
validation,328,67,51456,1527,219888,271344
validation,329,254,195072,21567,3105648,3300720
validation,330,44,33792,659,94896,128688
validation,331,72,55296,1764,254016,309312
validation,332,48,36864,784,112896,149760
validation,333,27,20736,248,35712,56448
validation,334,129,99072,5661,815184,914256
validation,335,28,21504,267,38448,59952
validation,336,244,187392,20254,2916576,3103968
validation,337,30,23040,306,44064,67104
validation,338,19,14592,123,17712,32304
validation,339,39,29952,518,74592,104544
validation,340,15,11520,77,11088,22608
validation,341,84,64512,2401,345744,410256
validation,342,69,52992,1620,233280,286272
validation,343,57,43776,1105,159120,202896
validation,344,41,31488,572,82368,113856
validation,345,57,43776,1105,159120,202896
validation,346,135,103680,6200,892800,996480
validation,347,28,21504,267,38448,59952
validation,348,86,66048,2516,362304,428352
validation,349,39,29952,518,74592,104544
validation,350,36,27648,441,63504,91152
validation,351,32,24576,349,50256,74832
validation,352,76,58368,1965,282960,341328
validation,353,55,42240,1029,148176,190416
validation,354,276,211968,24467,3523248,3735216
validation,355,110,84480,4116,592704,677184
validation,356,34,26112,393,56592,82704
validation,357,19,14592,123,17712,32304
validation,358,22,16896,165,23760,40656
validation,359,57,43776,1105,159120,202896
validation,360,104,79872,3680,529920,609792
validation,361,56,43008,1067,153648,196656
validation,362,36,27648,441,63504,91152
validation,363,62,47616,1308,188352,235968
validation,364,33,25344,371,53424,78768
validation,365,113,86784,4344,625536,712320
validation,366,100,76800,3402,489888,566688
validation,367,186,142848,11769,1694736,1837584
validation,368,66,50688,1482,213408,264096
validation,369,23,17664,180,25920,43584
validation,370,161,123648,8818,1269792,1393440
validation,371,60,46080,1225,176400,222480
validation,372,96,73728,3135,451440,525168
validation,373,23,17664,180,25920,43584
validation,374,38,29184,491,70704,99888
validation,375,21,16128,150,21600,37728
validation,376,166,127488,9374,1349856,1477344
validation,377,21,16128,150,21600,37728
validation,378,10,7680,34,4896,12576
validation,379,122,93696,5064,729216,822912
validation,380,22,16896,165,23760,40656
validation,381,38,29184,491,70704,99888
validation,382,106,81408,3823,550512,631920
validation,383,52,39936,920,132480,172416
validation,384,99,76032,3334,480096,556128
validation,385,229,175872,17840,2568960,2744832
validation,386,56,43008,1067,153648,196656
validation,387,21,16128,150,21600,37728
validation,388,73,56064,1813,261072,317136
validation,389,49,37632,817,117648,155280
validation,390,49,37632,817,117648,155280
validation,391,27,20736,248,35712,56448
validation,392,48,36864,784,112896,149760
validation,393,49,37632,817,117648,155280
validation,394,52,39936,920,132480,172416
validation,395,23,17664,180,25920,43584
validation,396,77,59136,2017,290448,349584
validation,397,150,115200,7654,1102176,1217376
validation,398,82,62976,2288,329472,392448
validation,399,43,33024,629,90576,123600
validation,400,24,18432,196,28224,46656
validation,401,63,48384,1350,194400,242784
validation,402,44,33792,659,94896,128688
validation,403,48,36864,784,112896,149760
validation,404,153,117504,7964,1146816,1264320
validation,405,66,50688,1482,213408,264096
validation,406,22,16896,165,23760,40656
validation,407,92,70656,2880,414720,485376
validation,408,110,84480,4116,592704,677184
validation,409,20,15360,136,19584,34944
validation,410,42,32256,600,86400,118656
validation,411,21,16128,150,21600,37728
validation,412,39,29952,518,74592,104544
validation,413,72,55296,1764,254016,309312
validation,414,119,91392,4818,693792,785184
validation,415,7,5376,17,2448,7824
validation,416,22,16896,165,23760,40656
validation,417,50,38400,851,122544,160944
validation,418,22,16896,165,23760,40656
validation,419,32,24576,349,50256,74832
validation,420,77,59136,2017,290448,349584
validation,421,44,33792,659,94896,128688
validation,422,138,105984,6479,932976,1038960
validation,423,46,35328,720,103680,139008
validation,424,101,77568,3470,499680,577248
validation,425,67,51456,1527,219888,271344
validation,426,53,40704,956,137664,178368
validation,427,127,97536,5487,790128,887664
validation,428,50,38400,851,122544,160944
validation,429,86,66048,2516,362304,428352
validation,430,72,55296,1764,254016,309312
validation,431,74,56832,1863,268272,325104
validation,432,255,195840,22121,3185424,3381264
validation,433,23,17664,180,25920,43584
validation,434,61,46848,1266,182304,229152
validation,435,39,29952,518,74592,104544
validation,436,45,34560,689,99216,133776
validation,437,25,19200,213,30672,49872
validation,438,37,28416,466,67104,95520
validation,439,11,8448,41,5904,14352
validation,440,81,62208,2232,321408,383616
validation,441,47,36096,752,108288,144384
validation,442,56,43008,1067,153648,196656
validation,443,50,38400,851,122544,160944
validation,444,146,112128,7252,1044288,1156416
validation,445,17,13056,98,14112,27168
validation,446,20,15360,136,19584,34944
validation,447,61,46848,1266,182304,229152
validation,448,33,25344,371,53424,78768
validation,449,110,84480,4116,592704,677184
validation,450,24,18432,196,28224,46656
validation,451,14,10752,67,9648,20400
validation,452,32,24576,349,50256,74832
validation,453,131,100608,5838,840672,941280
validation,454,84,64512,2401,345744,410256
validation,455,14,10752,67,9648,20400
validation,456,73,56064,1813,261072,317136
validation,457,39,29952,518,74592,104544
validation,458,20,15360,136,19584,34944
validation,459,28,21504,267,38448,59952
validation,460,33,25344,371,53424,78768
validation,461,29,22272,286,41184,63456
validation,462,55,42240,1029,148176,190416
validation,463,121,92928,4981,717264,810192
validation,464,53,40704,956,137664,178368
validation,465,39,29952,518,74592,104544
validation,466,123,94464,5147,741168,835632
validation,467,20,15360,136,19584,34944
validation,468,18,13824,110,15840,29664
validation,469,35,26880,417,60048,86928
validation,470,24,18432,196,28224,46656
validation,471,52,39936,920,132480,172416
validation,472,71,54528,1715,246960,301488
validation,473,23,17664,180,25920,43584
validation,474,15,11520,77,11088,22608
validation,475,10,7680,34,4896,12576
validation,476,10,7680,34,4896,12576
validation,477,56,43008,1067,153648,196656
validation,478,212,162816,15290,2201760,2364576
validation,479,50,38400,851,122544,160944
validation,480,11,8448,41,5904,14352
validation,481,41,31488,572,82368,113856
validation,482,51,39168,885,127440,166608
validation,483,57,43776,1105,159120,202896
validation,484,86,66048,2516,362304,428352
validation,485,165,126720,9262,1333728,1460448
validation,486,57,43776,1105,159120,202896
validation,487,30,23040,306,44064,67104
validation,488,67,51456,1527,219888,271344
validation,489,45,34560,689,99216,133776
validation,490,13,9984,58,8352,18336
validation,491,15,11520,77,11088,22608
validation,492,14,10752,67,9648,20400
validation,493,61,46848,1266,182304,229152
validation,494,23,17664,180,25920,43584
validation,495,46,35328,720,103680,139008
validation,496,21,16128,150,21600,37728
validation,497,136,104448,6292,906048,1010496
validation,498,55,42240,1029,148176,190416
validation,499,66,50688,1482,213408,264096
validation,500,40,30720,544,78336,109056
validation,501,32,24576,349,50256,74832
validation,502,133,102144,6018,866592,968736
validation,503,20,15360,136,19584,34944
validation,504,24,18432,196,28224,46656
validation,505,56,43008,1067,153648,196656
validation,506,63,48384,1350,194400,242784
validation,507,56,43008,1067,153648,196656
validation,508,234,179712,18370,2645280,2824992
validation,509,144,110592,7054,1015776,1126368
validation,510,30,23040,306,44064,67104
validation,511,144,110592,7054,1015776,1126368
validation,512,72,55296,1764,254016,309312
validation,513,30,23040,306,44064,67104
validation,514,56,43008,1067,153648,196656
validation,515,186,142848,11769,1694736,1837584
validation,516,41,31488,572,82368,113856
validation,517,225,172800,17222,2479968,2652768
validation,518,66,50688,1482,213408,264096
validation,519,38,29184,491,70704,99888
validation,520,77,59136,2017,290448,349584
validation,521,21,16128,150,21600,37728
validation,522,22,16896,165,23760,40656
validation,523,19,14592,123,17712,32304
validation,524,48,36864,784,112896,149760
validation,525,110,84480,4116,592704,677184
validation,526,92,70656,2880,414720,485376
validation,527,46,35328,720,103680,139008
validation,528,252,193536,21604,3110976,3304512
validation,529,12,9216,49,7056,16272
validation,530,88,67584,2635,379440,447024
validation,531,46,35328,720,103680,139008
validation,532,38,29184,491,70704,99888
validation,533,68,52224,1573,226512,278736
validation,534,70,53760,1667,240048,293808
validation,535,122,93696,5064,729216,822912
validation,536,45,34560,689,99216,133776
validation,537,22,16896,165,23760,40656
validation,538,67,51456,1527,219888,271344
validation,539,53,40704,956,137664,178368
validation,540,42,32256,600,86400,118656
validation,541,151,115968,7757,1117008,1232976
validation,542,44,33792,659,94896,128688
validation,543,9,6912,28,4032,10944
validation,544,17,13056,98,14112,27168
validation,545,19,14592,123,17712,32304
validation,546,68,52224,1573,226512,278736
validation,547,56,43008,1067,153648,196656
validation,548,70,53760,1667,240048,293808
validation,549,48,36864,784,112896,149760
validation,550,38,29184,491,70704,99888
validation,551,281,215808,24272,3495168,3710976
validation,552,54,41472,992,142848,184320
validation,553,41,31488,572,82368,113856
validation,554,14,10752,67,9648,20400
validation,555,105,80640,3751,540144,620784
validation,556,45,34560,689,99216,133776
validation,557,56,43008,1067,153648,196656
validation,558,30,23040,306,44064,67104
validation,559,61,46848,1266,182304,229152
validation,560,28,21504,267,38448,59952
validation,561,65,49920,1437,206928,256848
validation,562,55,42240,1029,148176,190416
validation,563,35,26880,417,60048,86928
validation,564,86,66048,2516,362304,428352
validation,565,50,38400,851,122544,160944
validation,566,69,52992,1620,233280,286272
validation,567,29,22272,286,41184,63456
validation,568,23,17664,180,25920,43584
validation,569,18,13824,110,15840,29664
validation,570,36,27648,441,63504,91152
validation,571,94,72192,3006,432864,505056
validation,572,23,17664,180,25920,43584
validation,573,129,99072,5661,815184,914256
validation,574,21,16128,150,21600,37728
validation,575,88,67584,2635,379440,447024
validation,576,22,16896,165,23760,40656
validation,577,91,69888,2817,405648,475536
validation,578,55,42240,1029,148176,190416
validation,579,43,33024,629,90576,123600
validation,580,56,43008,1067,153648,196656
validation,581,22,16896,165,23760,40656
validation,582,109,83712,4042,582048,665760
validation,583,30,23040,306,44064,67104
validation,584,11,8448,41,5904,14352
validation,585,67,51456,1527,219888,271344
validation,586,177,135936,10658,1534752,1670688
validation,587,242,185856,19735,2841840,3027696
validation,588,50,38400,851,122544,160944
validation,589,17,13056,98,14112,27168
validation,590,129,99072,5661,815184,914256
validation,591,37,28416,466,67104,95520
validation,592,173,132864,10182,1466208,1599072
validation,593,186,142848,11769,1694736,1837584
validation,594,31,23808,327,47088,70896
validation,595,40,30720,544,78336,109056
validation,596,49,37632,817,117648,155280
validation,597,30,23040,306,44064,67104
validation,598,35,26880,417,60048,86928
validation,599,18,13824,110,15840,29664
validation,600,226,173568,16249,2339856,2513424
validation,601,76,58368,1965,282960,341328
validation,602,20,15360,136,19584,34944
validation,603,79,60672,2123,305712,366384
validation,604,14,10752,67,9648,20400
validation,605,53,40704,956,137664,178368
validation,606,33,25344,371,53424,78768
validation,607,11,8448,41,5904,14352
validation,608,40,30720,544,78336,109056
validation,609,59,45312,1184,170496,215808
validation,610,48,36864,784,112896,149760
validation,611,40,30720,544,78336,109056
validation,612,25,19200,213,30672,49872
validation,613,22,16896,165,23760,40656
validation,614,11,8448,41,5904,14352
validation,615,166,127488,9374,1349856,1477344
validation,616,68,52224,1573,226512,278736
validation,617,8,6144,22,3168,9312
validation,618,67,51456,1527,219888,271344
validation,619,26,19968,230,33120,53088
validation,620,82,62976,2288,329472,392448
validation,621,123,94464,5147,741168,835632
validation,622,31,23808,327,47088,70896
validation,623,61,46848,1266,182304,229152
validation,624,68,52224,1573,226512,278736
validation,625,39,29952,518,74592,104544
validation,626,23,17664,180,25920,43584
validation,627,48,36864,784,112896,149760
validation,628,162,124416,8928,1285632,1410048
validation,629,98,75264,3267,470448,545712
validation,630,46,35328,720,103680,139008
validation,631,25,19200,213,30672,49872
validation,632,135,103680,6200,892800,996480
validation,633,41,31488,572,82368,113856
validation,634,28,21504,267,38448,59952
validation,635,23,17664,180,25920,43584
validation,636,35,26880,417,60048,86928
validation,637,146,112128,7252,1044288,1156416
validation,638,109,83712,4042,582048,665760
validation,639,70,53760,1667,240048,293808
validation,640,36,27648,441,63504,91152
validation,641,30,23040,306,44064,67104
validation,642,24,18432,196,28224,46656
validation,643,66,50688,1482,213408,264096
validation,644,55,42240,1029,148176,190416
validation,645,24,18432,196,28224,46656
validation,646,84,64512,2401,345744,410256
validation,647,25,19200,213,30672,49872
validation,648,21,16128,150,21600,37728
validation,649,21,16128,150,21600,37728
validation,650,67,51456,1527,219888,271344
validation,651,22,16896,165,23760,40656
validation,652,57,43776,1105,159120,202896
validation,653,23,17664,180,25920,43584
validation,654,46,35328,720,103680,139008
validation,655,76,58368,1965,282960,341328
validation,656,58,44544,1145,164880,209424
validation,657,233,178944,18469,2659536,2838480
validation,658,48,36864,784,112896,149760
validation,659,13,9984,58,8352,18336
validation,660,54,41472,992,142848,184320
validation,661,25,19200,213,30672,49872
validation,662,31,23808,327,47088,70896
validation,663,89,68352,2695,388080,456432
validation,664,72,55296,1764,254016,309312
validation,665,51,39168,885,127440,166608
validation,666,23,17664,180,25920,43584
validation,667,165,126720,9262,1333728,1460448
validation,668,51,39168,885,127440,166608
validation,669,32,24576,349,50256,74832
validation,670,147,112896,7351,1058544,1171440
validation,671,83,63744,2344,337536,401280
validation,672,67,51456,1527,219888,271344
validation,673,69,52992,1620,233280,286272
validation,674,47,36096,752,108288,144384
validation,675,53,40704,956,137664,178368
validation,676,48,36864,784,112896,149760
validation,677,78,59904,2070,298080,357984
validation,678,382,293376,38611,5559984,5853360
validation,679,16,12288,87,12528,24816
validation,680,51,39168,885,127440,166608
validation,681,130,99840,5749,827856,927696
validation,682,204,156672,14157,2038608,2195280
validation,683,51,39168,885,127440,166608
validation,684,161,123648,8818,1269792,1393440
validation,685,97,74496,3201,460944,535440
validation,686,61,46848,1266,182304,229152
validation,687,83,63744,2344,337536,401280
validation,688,69,52992,1620,233280,286272
validation,689,55,42240,1029,148176,190416
validation,690,24,18432,196,28224,46656
validation,691,60,46080,1225,176400,222480
validation,692,93,71424,2942,423648,495072
validation,693,20,15360,136,19584,34944
validation,694,66,50688,1482,213408,264096
validation,695,38,29184,491,70704,99888
validation,696,72,55296,1764,254016,309312
validation,697,82,62976,2288,329472,392448
validation,698,97,74496,3201,460944,535440
validation,699,45,34560,689,99216,133776
validation,700,25,19200,213,30672,49872
validation,701,41,31488,572,82368,113856
validation,702,50,38400,851,122544,160944
validation,703,30,23040,306,44064,67104
validation,704,22,16896,165,23760,40656
validation,705,36,27648,441,63504,91152
validation,706,57,43776,1105,159120,202896
validation,707,150,115200,7654,1102176,1217376
validation,708,72,55296,1764,254016,309312
validation,709,24,18432,196,28224,46656
validation,710,34,26112,393,56592,82704
validation,711,151,115968,7757,1117008,1232976
validation,712,40,30720,544,78336,109056
validation,713,14,10752,67,9648,20400
validation,714,31,23808,327,47088,70896
validation,715,18,13824,110,15840,29664
validation,716,12,9216,49,7056,16272
validation,717,19,14592,123,17712,32304
validation,718,83,63744,2344,337536,401280
validation,719,43,33024,629,90576,123600
validation,720,45,34560,689,99216,133776
validation,721,37,28416,466,67104,95520
validation,722,9,6912,28,4032,10944
validation,723,53,40704,956,137664,178368
validation,724,115,88320,4499,647856,736176
validation,725,40,30720,544,78336,109056
validation,726,77,59136,2017,290448,349584
validation,727,80,61440,2177,313488,374928
validation,728,74,56832,1863,268272,325104
validation,729,59,45312,1184,170496,215808
validation,730,112,86016,4267,614448,700464
validation,731,264,202752,23499,3383856,3586608
validation,732,78,59904,2070,298080,357984
validation,733,74,56832,1863,268272,325104
validation,734,55,42240,1029,148176,190416
validation,735,16,12288,87,12528,24816
validation,736,155,119040,8173,1176912,1295952
validation,737,13,9984,58,8352,18336
validation,738,42,32256,600,86400,118656
validation,739,154,118272,8068,1161792,1280064
validation,740,108,82944,3968,571392,654336
validation,741,169,129792,9716,1399104,1528896
validation,742,135,103680,6200,892800,996480
validation,743,47,36096,752,108288,144384
validation,744,66,50688,1482,213408,264096
validation,745,113,86784,4344,625536,712320
validation,746,76,58368,1965,282960,341328
validation,747,57,43776,1105,159120,202896
validation,748,79,60672,2123,305712,366384
validation,749,48,36864,784,112896,149760
validation,750,64,49152,1394,200736,249888
validation,751,119,91392,4818,693792,785184
validation,752,26,19968,230,33120,53088
validation,753,76,58368,1965,282960,341328
validation,754,20,15360,136,19584,34944
validation,755,344,264192,32223,4640112,4904304
validation,756,22,16896,165,23760,40656
validation,757,33,25344,371,53424,78768
validation,758,15,11520,77,11088,22608
validation,759,84,64512,2401,345744,410256
validation,760,13,9984,58,8352,18336
validation,761,37,28416,466,67104,95520
validation,762,46,35328,720,103680,139008
validation,763,30,23040,306,44064,67104
validation,764,61,46848,1266,182304,229152
validation,765,44,33792,659,94896,128688
validation,766,201,154368,13744,1979136,2133504
validation,767,30,23040,306,44064,67104
validation,768,57,43776,1105,159120,202896
validation,769,28,21504,267,38448,59952
validation,770,36,27648,441,63504,91152
validation,771,29,22272,286,41184,63456
validation,772,85,65280,2458,353952,419232
validation,773,14,10752,67,9648,20400
validation,774,58,44544,1145,164880,209424
validation,775,37,28416,466,67104,95520
validation,776,37,28416,466,67104,95520
validation,777,27,20736,248,35712,56448
validation,778,22,16896,165,23760,40656
validation,779,15,11520,77,11088,22608
validation,780,168,129024,9602,1382688,1511712
validation,781,42,32256,600,86400,118656
validation,782,40,30720,544,78336,109056
validation,783,28,21504,267,38448,59952
validation,784,35,26880,417,60048,86928
validation,785,30,23040,306,44064,67104
validation,786,63,48384,1350,194400,242784
validation,787,13,9984,58,8352,18336
validation,788,251,192768,20232,2913408,3106176
validation,789,134,102912,6109,879696,982608
validation,790,23,17664,180,25920,43584
validation,791,242,185856,19923,2868912,3054768
validation,792,56,43008,1067,153648,196656
validation,793,41,31488,572,82368,113856
validation,794,39,29952,518,74592,104544
validation,795,61,46848,1266,182304,229152
validation,796,28,21504,267,38448,59952
validation,797,12,9216,49,7056,16272
validation,798,13,9984,58,8352,18336
validation,799,26,19968,230,33120,53088
validation,800,20,15360,136,19584,34944
validation,801,18,13824,110,15840,29664
validation,802,78,59904,2070,298080,357984
validation,803,41,31488,572,82368,113856
validation,804,61,46848,1266,182304,229152
validation,805,43,33024,629,90576,123600
validation,806,26,19968,230,33120,53088
validation,807,107,82176,3895,560880,643056
validation,808,38,29184,491,70704,99888
validation,809,36,27648,441,63504,91152
validation,810,45,34560,689,99216,133776
validation,811,90,69120,2756,396864,465984
validation,812,37,28416,466,67104,95520
validation,813,57,43776,1105,159120,202896
validation,814,41,31488,572,82368,113856
validation,815,55,42240,1029,148176,190416
validation,816,92,70656,2880,414720,485376
validation,817,74,56832,1863,268272,325104
validation,818,137,105216,6385,919440,1024656
validation,819,121,92928,4981,717264,810192
validation,820,51,39168,885,127440,166608
validation,821,23,17664,180,25920,43584
validation,822,129,99072,5661,815184,914256
validation,823,38,29184,491,70704,99888
validation,824,49,37632,817,117648,155280
validation,825,23,17664,180,25920,43584
validation,826,24,18432,196,28224,46656
validation,827,36,27648,441,63504,91152
validation,828,41,31488,572,82368,113856
validation,829,136,104448,6292,906048,1010496
validation,830,58,44544,1145,164880,209424
validation,831,41,31488,572,82368,113856
validation,832,44,33792,659,94896,128688
validation,833,27,20736,248,35712,56448
validation,834,39,29952,518,74592,104544
validation,835,184,141312,11518,1658592,1799904
validation,836,25,19200,213,30672,49872
validation,837,72,55296,1764,254016,309312
validation,838,282,216576,23248,3347712,3564288
validation,839,20,15360,136,19584,34944
validation,840,18,13824,110,15840,29664
validation,841,52,39936,920,132480,172416
validation,842,69,52992,1620,233280,286272
validation,843,26,19968,230,33120,53088
validation,844,39,29952,518,74592,104544
validation,845,42,32256,600,86400,118656
validation,846,46,35328,720,103680,139008
validation,847,32,24576,349,50256,74832
validation,848,42,32256,600,86400,118656
validation,849,63,48384,1350,194400,242784
validation,850,72,55296,1764,254016,309312
validation,851,38,29184,491,70704,99888
validation,852,88,67584,2635,379440,447024
validation,853,95,72960,3070,442080,515040
validation,854,43,33024,629,90576,123600
validation,855,65,49920,1437,206928,256848
validation,856,32,24576,349,50256,74832
validation,857,212,162816,14977,2156688,2319504
validation,858,36,27648,441,63504,91152
validation,859,64,49152,1394,200736,249888
validation,860,29,22272,286,41184,63456
validation,861,43,33024,629,90576,123600
validation,862,46,35328,720,103680,139008
validation,863,62,47616,1308,188352,235968
validation,864,125,96000,5316,765504,861504
validation,865,27,20736,248,35712,56448
validation,866,157,120576,8385,1207440,1328016
validation,867,72,55296,1764,254016,309312
validation,868,36,27648,441,63504,91152
validation,869,150,115200,7654,1102176,1217376
validation,870,36,27648,441,63504,91152
validation,871,66,50688,1482,213408,264096
validation,872,28,21504,267,38448,59952
validation,873,75,57600,1914,275616,333216
validation,874,108,82944,3968,571392,654336
validation,875,37,28416,466,67104,95520
validation,876,19,14592,123,17712,32304
validation,877,16,12288,87,12528,24816
validation,878,209,160512,14860,2139840,2300352
validation,879,24,18432,196,28224,46656
validation,880,12,9216,49,7056,16272
validation,881,63,48384,1350,194400,242784
validation,882,264,202752,22240,3202560,3405312
validation,883,36,27648,441,63504,91152
validation,884,21,16128,150,21600,37728
validation,885,39,29952,518,74592,104544
validation,886,19,14592,123,17712,32304
validation,887,26,19968,230,33120,53088
validation,888,50,38400,851,122544,160944
validation,889,64,49152,1394,200736,249888
validation,890,65,49920,1437,206928,256848
validation,891,91,69888,2817,405648,475536
validation,892,52,39936,920,132480,172416
validation,893,109,83712,4042,582048,665760
validation,894,35,26880,417,60048,86928
validation,895,181,139008,11145,1604880,1743888
validation,896,154,118272,8068,1161792,1280064
validation,897,59,45312,1184,170496,215808
validation,898,38,29184,491,70704,99888
validation,899,42,32256,600,86400,118656
validation,900,12,9216,49,7056,16272
validation,901,63,48384,1350,194400,242784
validation,902,41,31488,572,82368,113856
validation,903,19,14592,123,17712,32304
validation,904,29,22272,286,41184,63456
validation,905,116,89088,4578,659232,748320
validation,906,22,16896,165,23760,40656
validation,907,55,42240,1029,148176,190416
validation,908,18,13824,110,15840,29664
validation,909,33,25344,371,53424,78768
validation,910,98,75264,3267,470448,545712
validation,911,29,22272,286,41184,63456
validation,912,133,102144,6018,866592,968736
validation,913,32,24576,349,50256,74832
validation,914,27,20736,248,35712,56448
validation,915,45,34560,689,99216,133776
validation,916,28,21504,267,38448,59952
validation,917,79,60672,2123,305712,366384
validation,918,69,52992,1620,233280,286272
validation,919,32,24576,349,50256,74832
validation,920,41,31488,572,82368,113856
validation,921,37,28416,466,67104,95520
validation,922,34,26112,393,56592,82704
validation,923,21,16128,150,21600,37728
validation,924,31,23808,327,47088,70896
validation,925,40,30720,544,78336,109056
validation,926,22,16896,165,23760,40656
validation,927,26,19968,230,33120,53088
validation,928,157,120576,8385,1207440,1328016
validation,929,18,13824,110,15840,29664
validation,930,26,19968,230,33120,53088
validation,931,69,52992,1620,233280,286272
validation,932,55,42240,1029,148176,190416
validation,933,46,35328,720,103680,139008
validation,934,76,58368,1965,282960,341328
validation,935,12,9216,49,7056,16272
validation,936,98,75264,3267,470448,545712
validation,937,14,10752,67,9648,20400
validation,938,48,36864,784,112896,149760
validation,939,197,151296,13203,1901232,2052528
validation,940,63,48384,1350,194400,242784
validation,941,82,62976,2288,329472,392448
validation,942,118,90624,4737,682128,772752
validation,943,39,29952,518,74592,104544
validation,944,146,112128,7252,1044288,1156416
validation,945,27,20736,248,35712,56448
validation,946,26,19968,230,33120,53088
validation,947,46,35328,720,103680,139008
validation,948,40,30720,544,78336,109056
validation,949,270,207360,22209,3198096,3405456
validation,950,83,63744,2344,337536,401280
validation,951,24,18432,196,28224,46656
validation,952,99,76032,3334,480096,556128
validation,953,23,17664,180,25920,43584
validation,954,38,29184,491,70704,99888
validation,955,126,96768,5401,777744,874512
validation,956,65,49920,1437,206928,256848
validation,957,42,32256,600,86400,118656
validation,958,71,54528,1715,246960,301488
validation,959,42,32256,600,86400,118656
validation,960,19,14592,123,17712,32304
validation,961,30,23040,306,44064,67104
validation,962,21,16128,150,21600,37728
validation,963,46,35328,720,103680,139008
validation,964,73,56064,1813,261072,317136
validation,965,61,46848,1266,182304,229152
validation,966,46,35328,720,103680,139008
validation,967,18,13824,110,15840,29664
validation,968,65,49920,1437,206928,256848
validation,969,131,100608,5838,840672,941280
validation,970,27,20736,248,35712,56448
validation,971,46,35328,720,103680,139008
validation,972,21,16128,150,21600,37728
validation,973,36,27648,441,63504,91152
validation,974,56,43008,1067,153648,196656
validation,975,70,53760,1667,240048,293808
validation,976,24,18432,196,28224,46656
validation,977,102,78336,3539,509616,587952
validation,978,122,93696,5064,729216,822912
validation,979,21,16128,150,21600,37728
validation,980,63,48384,1350,194400,242784
validation,981,29,22272,286,41184,63456
validation,982,25,19200,213,30672,49872
validation,983,67,51456,1527,219888,271344
validation,984,10,7680,34,4896,12576
validation,985,46,35328,720,103680,139008
validation,986,150,115200,7654,1102176,1217376
validation,987,53,40704,956,137664,178368
validation,988,77,59136,2017,290448,349584
validation,989,33,25344,371,53424,78768
validation,990,57,43776,1105,159120,202896
validation,991,108,82944,3968,571392,654336
validation,992,30,23040,306,44064,67104
validation,993,81,62208,2232,321408,383616
validation,994,48,36864,784,112896,149760
validation,995,163,125184,9039,1301616,1426800
validation,996,17,13056,98,14112,27168
validation,997,56,43008,1067,153648,196656
validation,998,210,161280,15003,2160432,2321712
validation,999,51,39168,885,127440,166608
validation,1000,180,138240,11022,1587168,1725408
validation,1001,27,20736,248,35712,56448
validation,1002,51,39168,885,127440,166608
validation,1003,158,121344,8493,1222992,1344336
validation,1004,20,15360,136,19584,34944
validation,1005,96,73728,3135,451440,525168
validation,1006,18,13824,110,15840,29664
validation,1007,39,29952,518,74592,104544
validation,1008,217,166656,16019,2306736,2473392
validation,1009,16,12288,87,12528,24816
validation,1010,61,46848,1266,182304,229152
validation,1011,171,131328,9948,1432512,1563840
validation,1012,104,79872,3680,529920,609792
validation,1013,71,54528,1715,246960,301488
validation,1014,60,46080,1225,176400,222480
validation,1015,20,15360,136,19584,34944
validation,1016,153,117504,7964,1146816,1264320
validation,1017,87,66816,2575,370800,437616
validation,1018,28,21504,267,38448,59952
validation,1019,22,16896,165,23760,40656
validation,1020,205,157440,14297,2058768,2216208
validation,1021,160,122880,8709,1254096,1376976
validation,1022,39,29952,518,74592,104544
validation,1023,206,158208,14436,2078784,2236992
validation,1024,40,30720,544,78336,109056
validation,1025,83,63744,2344,337536,401280
validation,1026,26,19968,230,33120,53088
validation,1027,17,13056,98,14112,27168
validation,1028,23,17664,180,25920,43584
validation,1029,22,16896,165,23760,40656
validation,1030,67,51456,1527,219888,271344
validation,1031,160,122880,8709,1254096,1376976
validation,1032,23,17664,180,25920,43584
validation,1033,75,57600,1914,275616,333216
validation,1034,81,62208,2232,321408,383616
validation,1035,33,25344,371,53424,78768
validation,1036,44,33792,659,94896,128688
validation,1037,126,96768,5401,777744,874512
validation,1038,12,9216,49,7056,16272
validation,1039,31,23808,327,47088,70896
validation,1040,303,232704,26444,3807936,4040640
validation,1041,33,25344,371,53424,78768
validation,1042,362,278016,36772,5295168,5573184
validation,1043,74,56832,1863,268272,325104
validation,1044,49,37632,817,117648,155280
validation,1045,22,16896,165,23760,40656
validation,1046,89,68352,2695,388080,456432
validation,1047,54,41472,992,142848,184320
validation,1048,26,19968,230,33120,53088
validation,1049,23,17664,180,25920,43584
validation,1050,12,9216,49,7056,16272
validation,1051,69,52992,1620,233280,286272
validation,1052,59,45312,1184,170496,215808
validation,1053,73,56064,1813,261072,317136
validation,1054,18,13824,110,15840,29664
validation,1055,80,61440,2177,313488,374928
validation,1056,65,49920,1437,206928,256848
validation,1057,85,65280,2458,353952,419232
validation,1058,28,21504,267,38448,59952
validation,1059,111,85248,4192,603648,688896
validation,1060,63,48384,1350,194400,242784
validation,1061,20,15360,136,19584,34944
validation,1062,28,21504,267,38448,59952
validation,1063,125,96000,5316,765504,861504
validation,1064,46,35328,720,103680,139008
validation,1065,61,46848,1266,182304,229152
validation,1066,15,11520,77,11088,22608
validation,1067,11,8448,41,5904,14352
validation,1068,15,11520,77,11088,22608
validation,1069,30,23040,306,44064,67104
validation,1070,19,14592,123,17712,32304
validation,1071,168,129024,9602,1382688,1511712
validation,1072,29,22272,286,41184,63456
validation,1073,26,19968,230,33120,53088
validation,1074,24,18432,196,28224,46656
validation,1075,34,26112,393,56592,82704
validation,1076,185,142080,11643,1676592,1818672
validation,1077,54,41472,992,142848,184320
validation,1078,144,110592,7054,1015776,1126368
validation,1079,21,16128,150,21600,37728
validation,1080,14,10752,67,9648,20400
validation,1081,61,46848,1266,182304,229152
validation,1082,14,10752,67,9648,20400
validation,1083,109,83712,4042,582048,665760
validation,1084,100,76800,3402,489888,566688
validation,1085,25,19200,213,30672,49872
validation,1086,13,9984,58,8352,18336
validation,1087,23,17664,180,25920,43584
validation,1088,22,16896,165,23760,40656
validation,1089,135,103680,6200,892800,996480
validation,1090,30,23040,306,44064,67104
validation,1091,41,31488,572,82368,113856
validation,1092,156,119808,8279,1192176,1311984
validation,1093,59,45312,1184,170496,215808
validation,1094,75,57600,1914,275616,333216
validation,1095,22,16896,165,23760,40656
validation,1096,12,9216,49,7056,16272
test,0,62,47616,1308,188352,235968
test,1,42,32256,600,86400,118656
test,2,36,27648,441,63504,91152
test,3,41,31488,572,82368,113856
test,4,26,19968,230,33120,53088
test,5,24,18432,196,28224,46656
test,6,47,36096,752,108288,144384
test,7,32,24576,349,50256,74832
test,8,28,21504,267,38448,59952
test,9,68,52224,1573,226512,278736
test,10,10,7680,34,4896,12576
test,11,186,142848,11769,1694736,1837584
test,12,62,47616,1308,188352,235968
test,13,117,89856,4657,670608,760464
test,14,52,39936,920,132480,172416
test,15,149,114432,7553,1087632,1202064
test,16,125,96000,5316,765504,861504
test,17,20,15360,136,19584,34944
test,18,99,76032,3334,480096,556128
test,19,13,9984,58,8352,18336
test,20,76,58368,1965,282960,341328
test,21,21,16128,150,21600,37728
test,22,96,73728,3135,451440,525168
test,23,46,35328,720,103680,139008
test,24,24,18432,196,28224,46656
test,25,127,97536,5487,790128,887664
test,26,42,32256,600,86400,118656
test,27,63,48384,1350,194400,242784
test,28,66,50688,1482,213408,264096
test,29,75,57600,1914,275616,333216
test,30,83,63744,2344,337536,401280
test,31,30,23040,306,44064,67104
test,32,24,18432,196,28224,46656
test,33,120,92160,4899,705456,797616
test,34,11,8448,41,5904,14352
test,35,65,49920,1437,206928,256848
test,36,73,56064,1813,261072,317136
test,37,18,13824,110,15840,29664
test,38,67,51456,1527,219888,271344
test,39,34,26112,393,56592,82704
test,40,66,50688,1482,213408,264096
test,41,20,15360,136,19584,34944
test,42,69,52992,1620,233280,286272
test,43,40,30720,544,78336,109056
test,44,75,57600,1914,275616,333216
test,45,12,9216,49,7056,16272
test,46,49,37632,817,117648,155280
test,47,64,49152,1394,200736,249888
test,48,53,40704,956,137664,178368
test,49,40,30720,544,78336,109056
test,50,27,20736,248,35712,56448
test,51,70,53760,1667,240048,293808
test,52,24,18432,196,28224,46656
test,53,45,34560,689,99216,133776
test,54,47,36096,752,108288,144384
test,55,13,9984,58,8352,18336
test,56,21,16128,150,21600,37728
test,57,52,39936,920,132480,172416
test,58,58,44544,1145,164880,209424
test,59,27,20736,248,35712,56448
test,60,13,9984,58,8352,18336
test,61,128,98304,5574,802656,900960
test,62,30,23040,306,44064,67104
test,63,55,42240,1029,148176,190416
test,64,20,15360,136,19584,34944
test,65,39,29952,518,74592,104544
test,66,23,17664,180,25920,43584
test,67,78,59904,2070,298080,357984
test,68,24,18432,196,28224,46656
test,69,75,57600,1914,275616,333216
test,70,37,28416,466,67104,95520
test,71,30,23040,306,44064,67104
test,72,51,39168,885,127440,166608
test,73,75,57600,1914,275616,333216
test,74,30,23040,306,44064,67104
test,75,28,21504,267,38448,59952
test,76,22,16896,165,23760,40656
test,77,87,66816,2575,370800,437616
test,78,12,9216,49,7056,16272
test,79,53,40704,956,137664,178368
test,80,32,24576,349,50256,74832
test,81,47,36096,752,108288,144384
test,82,105,80640,3751,540144,620784
test,83,38,29184,491,70704,99888
test,84,77,59136,2017,290448,349584
test,85,64,49152,1394,200736,249888
test,86,49,37632,817,117648,155280
test,87,68,52224,1573,226512,278736
test,88,78,59904,2070,298080,357984
test,89,60,46080,1225,176400,222480
test,90,115,88320,4499,647856,736176
test,91,35,26880,417,60048,86928
test,92,26,19968,230,33120,53088
test,93,83,63744,2344,337536,401280
test,94,25,19200,213,30672,49872
test,95,99,76032,3334,480096,556128
test,96,52,39936,920,132480,172416
test,97,42,32256,600,86400,118656
test,98,86,66048,2516,362304,428352
test,99,29,22272,286,41184,63456
test,100,25,19200,213,30672,49872
test,101,235,180480,18787,2705328,2885808
test,102,67,51456,1527,219888,271344
test,103,28,21504,267,38448,59952
test,104,61,46848,1266,182304,229152
test,105,47,36096,752,108288,144384
test,106,63,48384,1350,194400,242784
test,107,78,59904,2070,298080,357984
test,108,24,18432,196,28224,46656
test,109,20,15360,136,19584,34944
test,110,50,38400,851,122544,160944
test,111,81,62208,2232,321408,383616
test,112,25,19200,213,30672,49872
test,113,42,32256,600,86400,118656
test,114,77,59136,2017,290448,349584
test,115,49,37632,817,117648,155280
test,116,108,82944,3968,571392,654336
test,117,120,92160,4899,705456,797616
test,118,110,84480,4116,592704,677184
test,119,69,52992,1620,233280,286272
test,120,58,44544,1145,164880,209424
test,121,16,12288,87,12528,24816
test,122,21,16128,150,21600,37728
test,123,15,11520,77,11088,22608
test,124,23,17664,180,25920,43584
test,125,22,16896,165,23760,40656
test,126,56,43008,1067,153648,196656
test,127,47,36096,752,108288,144384
test,128,188,144384,12024,1731456,1875840
test,129,168,129024,9602,1382688,1511712
test,130,9,6912,28,4032,10944
test,131,35,26880,417,60048,86928
test,132,50,38400,851,122544,160944
test,133,30,23040,306,44064,67104
test,134,31,23808,327,47088,70896
test,135,75,57600,1914,275616,333216
test,136,41,31488,572,82368,113856
test,137,44,33792,659,94896,128688
test,138,149,114432,7553,1087632,1202064
test,139,23,17664,180,25920,43584
test,140,141,108288,6763,973872,1082160
test,141,46,35328,720,103680,139008
test,142,43,33024,629,90576,123600
test,143,32,24576,349,50256,74832
test,144,49,37632,817,117648,155280
test,145,44,33792,659,94896,128688
test,146,57,43776,1105,159120,202896
test,147,25,19200,213,30672,49872
test,148,74,56832,1863,268272,325104
test,149,120,92160,4899,705456,797616
test,150,29,22272,286,41184,63456
test,151,24,18432,196,28224,46656
test,152,94,72192,3006,432864,505056
test,153,69,52992,1620,233280,286272
test,154,12,9216,49,7056,16272
test,155,103,79104,3609,519696,598800
test,156,112,86016,4267,614448,700464
test,157,24,18432,196,28224,46656
test,158,10,7680,34,4896,12576
test,159,157,120576,8385,1207440,1328016
test,160,108,82944,3968,571392,654336
test,161,24,18432,196,28224,46656
test,162,168,129024,9602,1382688,1511712
test,163,138,105984,6479,932976,1038960
test,164,165,126720,9262,1333728,1460448
test,165,139,106752,6573,946512,1053264
test,166,31,23808,327,47088,70896
test,167,26,19968,230,33120,53088
test,168,165,126720,9262,1333728,1460448
test,169,203,155904,14019,2018736,2174640
test,170,57,43776,1105,159120,202896
test,171,19,14592,123,17712,32304
test,172,22,16896,165,23760,40656
test,173,51,39168,885,127440,166608
test,174,8,6144,22,3168,9312
test,175,29,22272,286,41184,63456
test,176,34,26112,393,56592,82704
test,177,26,19968,230,33120,53088
test,178,46,35328,720,103680,139008
test,179,13,9984,58,8352,18336
test,180,40,30720,544,78336,109056
test,181,13,9984,58,8352,18336
test,182,45,34560,689,99216,133776
test,183,198,152064,13337,1920528,2072592
test,184,17,13056,98,14112,27168
test,185,37,28416,466,67104,95520
test,186,39,29952,518,74592,104544
test,187,11,8448,41,5904,14352
test,188,317,243456,29385,4231440,4474896
test,189,83,63744,2344,337536,401280
test,190,25,19200,213,30672,49872
test,191,35,26880,417,60048,86928
test,192,96,73728,3135,451440,525168
test,193,12,9216,49,7056,16272
test,194,56,43008,1067,153648,196656
test,195,64,49152,1394,200736,249888
test,196,208,159744,14718,2119392,2279136
test,197,74,56832,1863,268272,325104
test,198,76,58368,1965,282960,341328
test,199,23,17664,180,25920,43584
test,200,72,55296,1764,254016,309312
test,201,12,9216,49,7056,16272
test,202,21,16128,150,21600,37728
test,203,69,52992,1620,233280,286272
test,204,35,26880,417,60048,86928
test,205,142,109056,6860,987840,1096896
test,206,19,14592,123,17712,32304
test,207,29,22272,286,41184,63456
test,208,25,19200,213,30672,49872
test,209,293,225024,25919,3732336,3957360
test,210,25,19200,213,30672,49872
test,211,71,54528,1715,246960,301488
test,212,153,117504,7964,1146816,1264320
test,213,18,13824,110,15840,29664
test,214,121,92928,4981,717264,810192
test,215,28,21504,267,38448,59952
test,216,54,41472,992,142848,184320
test,217,102,78336,3539,509616,587952
test,218,27,20736,248,35712,56448
test,219,38,29184,491,70704,99888
test,220,19,14592,123,17712,32304
test,221,327,251136,31025,4467600,4718736
test,222,15,11520,77,11088,22608
test,223,13,9984,58,8352,18336
test,224,12,9216,49,7056,16272
test,225,46,35328,720,103680,139008
test,226,193,148224,12672,1824768,1972992
test,227,46,35328,720,103680,139008
test,228,24,18432,196,28224,46656
test,229,60,46080,1225,176400,222480
test,230,34,26112,393,56592,82704
test,231,57,43776,1105,159120,202896
test,232,25,19200,213,30672,49872
test,233,24,18432,196,28224,46656
test,234,85,65280,2458,353952,419232
test,235,263,201984,22661,3263184,3465168
test,236,93,71424,2942,423648,495072
test,237,83,63744,2344,337536,401280
test,238,104,79872,3680,529920,609792
test,239,42,32256,600,86400,118656
test,240,66,50688,1482,213408,264096
test,241,75,57600,1914,275616,333216
test,242,22,16896,165,23760,40656
test,243,44,33792,659,94896,128688
test,244,47,36096,752,108288,144384
test,245,34,26112,393,56592,82704
test,246,48,36864,784,112896,149760
test,247,153,117504,7964,1146816,1264320
test,248,130,99840,5749,827856,927696
test,249,54,41472,992,142848,184320
test,250,24,18432,196,28224,46656
test,251,35,26880,417,60048,86928
test,252,19,14592,123,17712,32304
test,253,113,86784,4344,625536,712320
test,254,26,19968,230,33120,53088
test,255,45,34560,689,99216,133776
test,256,42,32256,600,86400,118656
test,257,69,52992,1620,233280,286272
test,258,23,17664,180,25920,43584
test,259,99,76032,3334,480096,556128
test,260,75,57600,1914,275616,333216
test,261,23,17664,180,25920,43584
test,262,69,52992,1620,233280,286272
test,263,219,168192,15508,2233152,2401344
test,264,36,27648,441,63504,91152
test,265,57,43776,1105,159120,202896
test,266,58,44544,1145,164880,209424
test,267,17,13056,98,14112,27168
test,268,74,56832,1863,268272,325104
test,269,113,86784,4344,625536,712320
test,270,21,16128,150,21600,37728
test,271,11,8448,41,5904,14352
test,272,51,39168,885,127440,166608
test,273,21,16128,150,21600,37728
test,274,19,14592,123,17712,32304
test,275,54,41472,992,142848,184320
test,276,28,21504,267,38448,59952
test,277,35,26880,417,60048,86928
test,278,12,9216,49,7056,16272
test,279,200,153600,13608,1959552,2113152
test,280,18,13824,110,15840,29664
test,281,44,33792,659,94896,128688
test,282,18,13824,110,15840,29664
test,283,91,69888,2817,405648,475536
test,284,31,23808,327,47088,70896
test,285,40,30720,544,78336,109056
test,286,93,71424,2942,423648,495072
test,287,14,10752,67,9648,20400
test,288,65,49920,1437,206928,256848
test,289,72,55296,1764,254016,309312
test,290,13,9984,58,8352,18336
test,291,13,9984,58,8352,18336
test,292,22,16896,165,23760,40656
test,293,80,61440,2177,313488,374928
test,294,34,26112,393,56592,82704
test,295,27,20736,248,35712,56448
test,296,23,17664,180,25920,43584
test,297,16,12288,87,12528,24816
test,298,58,44544,1145,164880,209424
test,299,11,8448,41,5904,14352
test,300,23,17664,180,25920,43584
test,301,222,170496,16766,2414304,2584800
test,302,36,27648,441,63504,91152
test,303,34,26112,393,56592,82704
test,304,60,46080,1225,176400,222480
test,305,78,59904,2070,298080,357984
test,306,25,19200,213,30672,49872
test,307,44,33792,659,94896,128688
test,308,49,37632,817,117648,155280
test,309,12,9216,49,7056,16272
test,310,60,46080,1225,176400,222480
test,311,35,26880,417,60048,86928
test,312,77,59136,2017,290448,349584
test,313,68,52224,1573,226512,278736
test,314,101,77568,3470,499680,577248
test,315,48,36864,784,112896,149760
test,316,19,14592,123,17712,32304
test,317,15,11520,77,11088,22608
test,318,24,18432,196,28224,46656
test,319,30,23040,306,44064,67104
test,320,47,36096,752,108288,144384
test,321,26,19968,230,33120,53088
test,322,19,14592,123,17712,32304
test,323,70,53760,1667,240048,293808
test,324,53,40704,956,137664,178368
test,325,89,68352,2695,388080,456432
test,326,12,9216,49,7056,16272
test,327,36,27648,441,63504,91152
test,328,21,16128,150,21600,37728
test,329,19,14592,123,17712,32304
test,330,169,129792,9716,1399104,1528896
test,331,64,49152,1394,200736,249888
test,332,118,90624,4737,682128,772752
test,333,78,59904,2070,298080,357984
test,334,78,59904,2070,298080,357984
test,335,71,54528,1715,246960,301488
test,336,46,35328,720,103680,139008
test,337,179,137472,10900,1569600,1707072
test,338,43,33024,629,90576,123600
test,339,45,34560,689,99216,133776
test,340,40,30720,544,78336,109056
test,341,34,26112,393,56592,82704
test,342,21,16128,150,21600,37728
test,343,212,162816,15290,2201760,2364576
test,344,32,24576,349,50256,74832
test,345,40,30720,544,78336,109056
test,346,19,14592,123,17712,32304
test,347,15,11520,77,11088,22608
test,348,71,54528,1715,246960,301488
test,349,31,23808,327,47088,70896
test,350,22,16896,165,23760,40656
test,351,24,18432,196,28224,46656
test,352,144,110592,7054,1015776,1126368
test,353,32,24576,349,50256,74832
test,354,51,39168,885,127440,166608
test,355,21,16128,150,21600,37728
test,356,18,13824,110,15840,29664
test,357,15,11520,77,11088,22608
test,358,72,55296,1764,254016,309312
test,359,39,29952,518,74592,104544
test,360,148,113664,7452,1073088,1186752
test,361,84,64512,2401,345744,410256
test,362,31,23808,327,47088,70896
test,363,83,63744,2344,337536,401280
test,364,12,9216,49,7056,16272
test,365,41,31488,572,82368,113856
test,366,13,9984,58,8352,18336
test,367,96,73728,3135,451440,525168
test,368,134,102912,6109,879696,982608
test,369,30,23040,306,44064,67104
test,370,37,28416,466,67104,95520
test,371,25,19200,213,30672,49872
test,372,76,58368,1965,282960,341328
test,373,22,16896,165,23760,40656
test,374,22,16896,165,23760,40656
test,375,65,49920,1437,206928,256848
test,376,18,13824,110,15840,29664
test,377,58,44544,1145,164880,209424
test,378,15,11520,77,11088,22608
test,379,33,25344,371,53424,78768
test,380,86,66048,2516,362304,428352
test,381,21,16128,150,21600,37728
test,382,67,51456,1527,219888,271344
test,383,19,14592,123,17712,32304
test,384,145,111360,7153,1030032,1141392
test,385,27,20736,248,35712,56448
test,386,19,14592,123,17712,32304
test,387,37,28416,466,67104,95520
test,388,81,62208,2232,321408,383616
test,389,41,31488,572,82368,113856
test,390,23,17664,180,25920,43584
test,391,36,27648,441,63504,91152
test,392,116,89088,4578,659232,748320
test,393,20,15360,136,19584,34944
test,394,93,71424,2942,423648,495072
test,395,27,20736,248,35712,56448
test,396,32,24576,349,50256,74832
test,397,70,53760,1667,240048,293808
test,398,20,15360,136,19584,34944
test,399,58,44544,1145,164880,209424
test,400,121,92928,4981,717264,810192
test,401,47,36096,752,108288,144384
test,402,37,28416,466,67104,95520
test,403,83,63744,2344,337536,401280
test,404,25,19200,213,30672,49872
test,405,34,26112,393,56592,82704
test,406,33,25344,371,53424,78768
test,407,15,11520,77,11088,22608
test,408,46,35328,720,103680,139008
test,409,199,152832,13472,1939968,2092800
test,410,23,17664,180,25920,43584
test,411,34,26112,393,56592,82704
test,412,42,32256,600,86400,118656
test,413,51,39168,885,127440,166608
test,414,26,19968,230,33120,53088
test,415,62,47616,1308,188352,235968
test,416,22,16896,165,23760,40656
test,417,25,19200,213,30672,49872
test,418,31,23808,327,47088,70896
test,419,48,36864,784,112896,149760
test,420,18,13824,110,15840,29664
test,421,21,16128,150,21600,37728
test,422,211,162048,15146,2181024,2343072
test,423,28,21504,267,38448,59952
test,424,34,26112,393,56592,82704
test,425,78,59904,2070,298080,357984
test,426,40,30720,544,78336,109056
test,427,34,26112,393,56592,82704
test,428,17,13056,98,14112,27168
test,429,27,20736,248,35712,56448
test,430,30,23040,306,44064,67104
test,431,86,66048,2516,362304,428352
test,432,41,31488,572,82368,113856
test,433,15,11520,77,11088,22608
test,434,21,16128,150,21600,37728
test,435,67,51456,1527,219888,271344
test,436,120,92160,4899,705456,797616
test,437,72,55296,1764,254016,309312
test,438,177,135936,10658,1534752,1670688
test,439,80,61440,2177,313488,374928
test,440,24,18432,196,28224,46656
test,441,112,86016,4267,614448,700464
test,442,40,30720,544,78336,109056
test,443,80,61440,2177,313488,374928
test,444,51,39168,885,127440,166608
test,445,199,152832,13472,1939968,2092800
test,446,10,7680,34,4896,12576
test,447,48,36864,784,112896,149760
test,448,25,19200,213,30672,49872
test,449,63,48384,1350,194400,242784
test,450,23,17664,180,25920,43584
test,451,28,21504,267,38448,59952
test,452,25,19200,213,30672,49872
test,453,132,101376,5928,853632,955008
test,454,92,70656,2880,414720,485376
test,455,30,23040,306,44064,67104
test,456,132,101376,5928,853632,955008
test,457,28,21504,267,38448,59952
test,458,104,79872,3680,529920,609792
test,459,35,26880,417,60048,86928
test,460,31,23808,327,47088,70896
test,461,51,39168,885,127440,166608
test,462,63,48384,1350,194400,242784
test,463,47,36096,752,108288,144384
test,464,64,49152,1394,200736,249888
test,465,13,9984,58,8352,18336
test,466,65,49920,1437,206928,256848
test,467,15,11520,77,11088,22608
test,468,37,28416,466,67104,95520
test,469,41,31488,572,82368,113856
test,470,59,45312,1184,170496,215808
test,471,213,163584,15434,2222496,2386080
test,472,14,10752,67,9648,20400
test,473,48,36864,784,112896,149760
test,474,120,92160,4899,705456,797616
test,475,61,46848,1266,182304,229152
test,476,27,20736,248,35712,56448
test,477,71,54528,1715,246960,301488
test,478,55,42240,1029,148176,190416
test,479,49,37632,817,117648,155280
test,480,11,8448,41,5904,14352
test,481,119,91392,4818,693792,785184
test,482,88,67584,2635,379440,447024
test,483,86,66048,2516,362304,428352
test,484,43,33024,629,90576,123600
test,485,55,42240,1029,148176,190416
test,486,112,86016,4267,614448,700464
test,487,95,72960,3070,442080,515040
test,488,83,63744,2344,337536,401280
test,489,97,74496,3201,460944,535440
test,490,46,35328,720,103680,139008
test,491,40,30720,544,78336,109056
test,492,11,8448,41,5904,14352
test,493,32,24576,349,50256,74832
test,494,63,48384,1350,194400,242784
test,495,77,59136,2017,290448,349584
test,496,15,11520,77,11088,22608
test,497,26,19968,230,33120,53088
test,498,37,28416,466,67104,95520
test,499,38,29184,491,70704,99888
test,500,23,17664,180,25920,43584
test,501,20,15360,136,19584,34944
test,502,29,22272,286,41184,63456
test,503,48,36864,784,112896,149760
test,504,210,161280,15003,2160432,2321712
test,505,99,76032,3334,480096,556128
test,506,23,17664,180,25920,43584
test,507,48,36864,784,112896,149760
test,508,89,68352,2695,388080,456432
test,509,152,116736,7860,1131840,1248576
test,510,145,111360,7153,1030032,1141392
test,511,123,94464,5147,741168,835632
test,512,13,9984,58,8352,18336
test,513,73,56064,1813,261072,317136
test,514,28,21504,267,38448,59952
test,515,71,54528,1715,246960,301488
test,516,37,28416,466,67104,95520
test,517,19,14592,123,17712,32304
test,518,72,55296,1764,254016,309312
test,519,24,18432,196,28224,46656
test,520,155,119040,8173,1176912,1295952
test,521,51,39168,885,127440,166608
test,522,40,30720,544,78336,109056
test,523,60,46080,1225,176400,222480
test,524,66,50688,1482,213408,264096
test,525,47,36096,752,108288,144384
test,526,199,152832,13472,1939968,2092800
test,527,78,59904,2070,298080,357984
test,528,80,61440,2177,313488,374928
test,529,19,14592,123,17712,32304
test,530,34,26112,393,56592,82704
test,531,32,24576,349,50256,74832
test,532,185,142080,11643,1676592,1818672
test,533,357,274176,35149,5061456,5335632
test,534,38,29184,491,70704,99888
test,535,27,20736,248,35712,56448
test,536,59,45312,1184,170496,215808
test,537,26,19968,230,33120,53088
test,538,25,19200,213,30672,49872
test,539,68,52224,1573,226512,278736
test,540,15,11520,77,11088,22608
test,541,16,12288,87,12528,24816
test,542,10,7680,34,4896,12576
test,543,37,28416,466,67104,95520
test,544,28,21504,267,38448,59952
test,545,57,43776,1105,159120,202896
test,546,146,112128,7252,1044288,1156416
test,547,15,11520,77,11088,22608
test,548,41,31488,572,82368,113856
test,549,52,39936,920,132480,172416
test,550,147,112896,7351,1058544,1171440
test,551,21,16128,150,21600,37728
test,552,50,38400,851,122544,160944
test,553,38,29184,491,70704,99888
test,554,132,101376,5928,853632,955008
test,555,32,24576,349,50256,74832
test,556,28,21504,267,38448,59952
test,557,56,43008,1067,153648,196656
test,558,15,11520,77,11088,22608
test,559,36,27648,441,63504,91152
test,560,43,33024,629,90576,123600
test,561,34,26112,393,56592,82704
test,562,27,20736,248,35712,56448
test,563,24,18432,196,28224,46656
test,564,62,47616,1308,188352,235968
test,565,36,27648,441,63504,91152
test,566,24,18432,196,28224,46656
test,567,16,12288,87,12528,24816
test,568,31,23808,327,47088,70896
test,569,74,56832,1863,268272,325104
test,570,49,37632,817,117648,155280
test,571,23,17664,180,25920,43584
test,572,45,34560,689,99216,133776
test,573,103,79104,3609,519696,598800
test,574,59,45312,1184,170496,215808
test,575,13,9984,58,8352,18336
test,576,30,23040,306,44064,67104
test,577,95,72960,3070,442080,515040
test,578,122,93696,5064,729216,822912
test,579,24,18432,196,28224,46656
test,580,30,23040,306,44064,67104
test,581,51,39168,885,127440,166608
test,582,201,154368,13744,1979136,2133504
test,583,61,46848,1266,182304,229152
test,584,28,21504,267,38448,59952
test,585,247,189696,20026,2883744,3073440
test,586,22,16896,165,23760,40656
test,587,102,78336,3539,509616,587952
test,588,56,43008,1067,153648,196656
test,589,21,16128,150,21600,37728
test,590,81,62208,2232,321408,383616
test,591,13,9984,58,8352,18336
test,592,21,16128,150,21600,37728
test,593,236,181248,18770,2702880,2884128
test,594,65,49920,1437,206928,256848
test,595,69,52992,1620,233280,286272
test,596,22,16896,165,23760,40656
test,597,44,33792,659,94896,128688
test,598,51,39168,885,127440,166608
test,599,23,17664,180,25920,43584
test,600,26,19968,230,33120,53088
test,601,32,24576,349,50256,74832
test,602,21,16128,150,21600,37728
test,603,125,96000,5316,765504,861504
test,604,40,30720,544,78336,109056
test,605,23,17664,180,25920,43584
test,606,27,20736,248,35712,56448
test,607,26,19968,230,33120,53088
test,608,28,21504,267,38448,59952
test,609,52,39936,920,132480,172416
test,610,93,71424,2942,423648,495072
test,611,87,66816,2575,370800,437616
test,612,27,20736,248,35712,56448
test,613,25,19200,213,30672,49872
test,614,51,39168,885,127440,166608
test,615,42,32256,600,86400,118656
test,616,25,19200,213,30672,49872
test,617,53,40704,956,137664,178368
test,618,47,36096,752,108288,144384
test,619,68,52224,1573,226512,278736
test,620,55,42240,1029,148176,190416
test,621,124,95232,5231,753264,848496
test,622,69,52992,1620,233280,286272
test,623,25,19200,213,30672,49872
test,624,99,76032,3334,480096,556128
test,625,43,33024,629,90576,123600
test,626,21,16128,150,21600,37728
test,627,43,33024,629,90576,123600
test,628,34,26112,393,56592,82704
test,629,29,22272,286,41184,63456
test,630,95,72960,3070,442080,515040
test,631,19,14592,123,17712,32304
test,632,20,15360,136,19584,34944
test,633,49,37632,817,117648,155280
test,634,45,34560,689,99216,133776
test,635,71,54528,1715,246960,301488
test,636,47,36096,752,108288,144384
test,637,103,79104,3609,519696,598800
test,638,74,56832,1863,268272,325104
test,639,11,8448,41,5904,14352
test,640,143,109824,6957,1001808,1111632
test,641,90,69120,2756,396864,465984
test,642,15,11520,77,11088,22608
test,643,32,24576,349,50256,74832
test,644,88,67584,2635,379440,447024
test,645,28,21504,267,38448,59952
test,646,76,58368,1965,282960,341328
test,647,88,67584,2635,379440,447024
test,648,30,23040,306,44064,67104
test,649,21,16128,150,21600,37728
test,650,29,22272,286,41184,63456
test,651,59,45312,1184,170496,215808
test,652,70,53760,1667,240048,293808
test,653,33,25344,371,53424,78768
test,654,25,19200,213,30672,49872
test,655,387,297216,40603,5846832,6144048
test,656,126,96768,5401,777744,874512
test,657,77,59136,2017,290448,349584
test,658,40,30720,544,78336,109056
test,659,46,35328,720,103680,139008
test,660,84,64512,2401,345744,410256
test,661,50,38400,851,122544,160944
test,662,46,35328,720,103680,139008
test,663,26,19968,230,33120,53088
test,664,40,30720,544,78336,109056
test,665,123,94464,5147,741168,835632
test,666,28,21504,267,38448,59952
test,667,144,110592,7054,1015776,1126368
test,668,24,18432,196,28224,46656
test,669,97,74496,3201,460944,535440
test,670,72,55296,1764,254016,309312
test,671,16,12288,87,12528,24816
test,672,45,34560,689,99216,133776
test,673,154,118272,8068,1161792,1280064
test,674,64,49152,1394,200736,249888
test,675,39,29952,518,74592,104544
test,676,99,76032,3334,480096,556128
test,677,144,110592,7054,1015776,1126368
test,678,38,29184,491,70704,99888
test,679,42,32256,600,86400,118656
test,680,103,79104,3609,519696,598800
test,681,19,14592,123,17712,32304
test,682,47,36096,752,108288,144384
test,683,128,98304,5574,802656,900960
test,684,75,57600,1914,275616,333216
test,685,40,30720,544,78336,109056
test,686,35,26880,417,60048,86928
test,687,70,53760,1667,240048,293808
test,688,48,36864,784,112896,149760
test,689,82,62976,2288,329472,392448
test,690,33,25344,371,53424,78768
test,691,50,38400,851,122544,160944
test,692,70,53760,1667,240048,293808
test,693,86,66048,2516,362304,428352
test,694,28,21504,267,38448,59952
test,695,15,11520,77,11088,22608
test,696,26,19968,230,33120,53088
test,697,44,33792,659,94896,128688
test,698,25,19200,213,30672,49872
test,699,24,18432,196,28224,46656
test,700,66,50688,1482,213408,264096
test,701,94,72192,3006,432864,505056
test,702,11,8448,41,5904,14352
test,703,61,46848,1266,182304,229152
test,704,44,33792,659,94896,128688
test,705,13,9984,58,8352,18336
test,706,73,56064,1813,261072,317136
test,707,40,30720,544,78336,109056
test,708,204,156672,14157,2038608,2195280
test,709,22,16896,165,23760,40656
test,710,166,127488,9374,1349856,1477344
test,711,147,112896,7351,1058544,1171440
test,712,33,25344,371,53424,78768
test,713,300,230400,26556,3824064,4054464
test,714,165,126720,9262,1333728,1460448
test,715,41,31488,572,82368,113856
test,716,86,66048,2516,362304,428352
test,717,63,48384,1350,194400,242784
test,718,113,86784,4344,625536,712320
test,719,57,43776,1105,159120,202896
test,720,90,69120,2756,396864,465984
test,721,20,15360,136,19584,34944
test,722,55,42240,1029,148176,190416
test,723,66,50688,1482,213408,264096
test,724,23,17664,180,25920,43584
test,725,43,33024,629,90576,123600
test,726,43,33024,629,90576,123600
test,727,20,15360,136,19584,34944
test,728,37,28416,466,67104,95520
test,729,54,41472,992,142848,184320
test,730,24,18432,196,28224,46656
test,731,298,228864,28100,4046400,4275264
test,732,33,25344,371,53424,78768
test,733,124,95232,5231,753264,848496
test,734,48,36864,784,112896,149760
test,735,34,26112,393,56592,82704
test,736,134,102912,6109,879696,982608
test,737,16,12288,87,12528,24816
test,738,39,29952,518,74592,104544
test,739,43,33024,629,90576,123600
test,740,16,12288,87,12528,24816
test,741,250,192000,20609,2967696,3159696
test,742,41,31488,572,82368,113856
test,743,67,51456,1527,219888,271344
test,744,44,33792,659,94896,128688
test,745,98,75264,3267,470448,545712
test,746,25,19200,213,30672,49872
test,747,29,22272,286,41184,63456
test,748,56,43008,1067,153648,196656
test,749,89,68352,2695,388080,456432
test,750,10,7680,34,4896,12576
test,751,20,15360,136,19584,34944
test,752,11,8448,41,5904,14352
test,753,18,13824,110,15840,29664
test,754,59,45312,1184,170496,215808
test,755,123,94464,5147,741168,835632
test,756,140,107520,6668,960192,1067712
test,757,148,113664,7452,1073088,1186752
test,758,41,31488,572,82368,113856
test,759,70,53760,1667,240048,293808
test,760,55,42240,1029,148176,190416
test,761,32,24576,349,50256,74832
test,762,11,8448,41,5904,14352
test,763,181,139008,11145,1604880,1743888
test,764,64,49152,1394,200736,249888
test,765,26,19968,230,33120,53088
test,766,14,10752,67,9648,20400
test,767,31,23808,327,47088,70896
test,768,160,122880,8709,1254096,1376976
test,769,193,148224,12672,1824768,1972992
test,770,26,19968,230,33120,53088
test,771,35,26880,417,60048,86928
test,772,22,16896,165,23760,40656
test,773,70,53760,1667,240048,293808
test,774,63,48384,1350,194400,242784
test,775,78,59904,2070,298080,357984
test,776,49,37632,817,117648,155280
test,777,57,43776,1105,159120,202896
test,778,135,103680,6200,892800,996480
test,779,53,40704,956,137664,178368
test,780,37,28416,466,67104,95520
test,781,183,140544,11393,1640592,1781136
test,782,35,26880,417,60048,86928
test,783,30,23040,306,44064,67104
test,784,87,66816,2575,370800,437616
test,785,58,44544,1145,164880,209424
test,786,36,27648,441,63504,91152
test,787,66,50688,1482,213408,264096
test,788,146,112128,7252,1044288,1156416
test,789,214,164352,15579,2243376,2407728
test,790,21,16128,150,21600,37728
test,791,30,23040,306,44064,67104
test,792,105,80640,3751,540144,620784
test,793,70,53760,1667,240048,293808
test,794,24,18432,196,28224,46656
test,795,69,52992,1620,233280,286272
test,796,16,12288,87,12528,24816
test,797,11,8448,41,5904,14352
test,798,24,18432,196,28224,46656
test,799,40,30720,544,78336,109056
test,800,266,204288,21804,3139776,3344064
test,801,114,87552,4421,636624,724176
test,802,90,69120,2756,396864,465984
test,803,22,16896,165,23760,40656
test,804,60,46080,1225,176400,222480
test,805,251,192768,19828,2855232,3048000
test,806,14,10752,67,9648,20400
test,807,43,33024,629,90576,123600
test,808,112,86016,4267,614448,700464
test,809,25,19200,213,30672,49872
test,810,59,45312,1184,170496,215808
test,811,18,13824,110,15840,29664
test,812,34,26112,393,56592,82704
test,813,56,43008,1067,153648,196656
test,814,21,16128,150,21600,37728
test,815,32,24576,349,50256,74832
test,816,40,30720,544,78336,109056
test,817,109,83712,4042,582048,665760
test,818,62,47616,1308,188352,235968
test,819,72,55296,1764,254016,309312
test,820,413,317184,46439,6687216,7004400
test,821,44,33792,659,94896,128688
test,822,61,46848,1266,182304,229152
test,823,32,24576,349,50256,74832
test,824,67,51456,1527,219888,271344
test,825,61,46848,1266,182304,229152
test,826,32,24576,349,50256,74832
test,827,103,79104,3609,519696,598800
test,828,21,16128,150,21600,37728
test,829,64,49152,1394,200736,249888
test,830,25,19200,213,30672,49872
test,831,128,98304,5574,802656,900960
test,832,30,23040,306,44064,67104
test,833,110,84480,4116,592704,677184
test,834,30,23040,306,44064,67104
test,835,213,163584,15434,2222496,2386080
test,836,28,21504,267,38448,59952
test,837,10,7680,34,4896,12576
test,838,53,40704,956,137664,178368
test,839,216,165888,15872,2285568,2451456
test,840,39,29952,518,74592,104544
test,841,130,99840,5749,827856,927696
test,842,28,21504,267,38448,59952
test,843,25,19200,213,30672,49872
test,844,32,24576,349,50256,74832
test,845,77,59136,2017,290448,349584
test,846,56,43008,1067,153648,196656
test,847,13,9984,58,8352,18336
test,848,43,33024,629,90576,123600
test,849,136,104448,6292,906048,1010496
test,850,21,16128,150,21600,37728
test,851,48,36864,784,112896,149760
test,852,26,19968,230,33120,53088
test,853,27,20736,248,35712,56448
test,854,63,48384,1350,194400,242784
test,855,69,52992,1620,233280,286272
test,856,14,10752,67,9648,20400
test,857,25,19200,213,30672,49872
test,858,13,9984,58,8352,18336
test,859,31,23808,327,47088,70896
test,860,311,238848,29329,4223376,4462224
test,861,30,23040,306,44064,67104
test,862,52,39936,920,132480,172416
test,863,95,72960,3070,442080,515040
test,864,42,32256,600,86400,118656
test,865,35,26880,417,60048,86928
test,866,45,34560,689,99216,133776
test,867,53,40704,956,137664,178368
test,868,15,11520,77,11088,22608
test,869,23,17664,180,25920,43584
test,870,99,76032,3334,480096,556128
test,871,13,9984,58,8352,18336
test,872,23,17664,180,25920,43584
test,873,47,36096,752,108288,144384
test,874,65,49920,1437,206928,256848
test,875,27,20736,248,35712,56448
test,876,159,122112,8600,1238400,1360512
test,877,78,59904,2070,298080,357984
test,878,30,23040,306,44064,67104
test,879,70,53760,1667,240048,293808
test,880,96,73728,3135,451440,525168
test,881,24,18432,196,28224,46656
test,882,111,85248,4192,603648,688896
test,883,123,94464,5147,741168,835632
test,884,45,34560,689,99216,133776
test,885,13,9984,58,8352,18336
test,886,59,45312,1184,170496,215808
test,887,49,37632,817,117648,155280
test,888,42,32256,600,86400,118656
test,889,49,37632,817,117648,155280
test,890,92,70656,2880,414720,485376
test,891,29,22272,286,41184,63456
test,892,65,49920,1437,206928,256848
test,893,65,49920,1437,206928,256848
test,894,62,47616,1308,188352,235968
test,895,31,23808,327,47088,70896
test,896,47,36096,752,108288,144384
test,897,218,167424,15116,2176704,2344128
test,898,53,40704,956,137664,178368
test,899,29,22272,286,41184,63456
test,900,40,30720,544,78336,109056
test,901,40,30720,544,78336,109056
test,902,35,26880,417,60048,86928
test,903,51,39168,885,127440,166608
test,904,26,19968,230,33120,53088
test,905,34,26112,393,56592,82704
test,906,90,69120,2756,396864,465984
test,907,57,43776,1105,159120,202896
test,908,38,29184,491,70704,99888
test,909,65,49920,1437,206928,256848
test,910,34,26112,393,56592,82704
test,911,50,38400,851,122544,160944
test,912,72,55296,1764,254016,309312
test,913,26,19968,230,33120,53088
test,914,129,99072,5661,815184,914256
test,915,68,52224,1573,226512,278736
test,916,26,19968,230,33120,53088
test,917,45,34560,689,99216,133776
test,918,35,26880,417,60048,86928
test,919,115,88320,4499,647856,736176
test,920,79,60672,2123,305712,366384
test,921,25,19200,213,30672,49872
test,922,70,53760,1667,240048,293808
test,923,125,96000,5316,765504,861504
test,924,39,29952,518,74592,104544
test,925,236,181248,18770,2702880,2884128
test,926,73,56064,1813,261072,317136
test,927,22,16896,165,23760,40656
test,928,37,28416,466,67104,95520
test,929,27,20736,248,35712,56448
test,930,11,8448,41,5904,14352
test,931,23,17664,180,25920,43584
test,932,24,18432,196,28224,46656
test,933,35,26880,417,60048,86928
test,934,35,26880,417,60048,86928
test,935,51,39168,885,127440,166608
test,936,14,10752,67,9648,20400
test,937,45,34560,689,99216,133776
test,938,30,23040,306,44064,67104
test,939,122,93696,5064,729216,822912
test,940,56,43008,1067,153648,196656
test,941,75,57600,1914,275616,333216
test,942,22,16896,165,23760,40656
test,943,66,50688,1482,213408,264096
test,944,58,44544,1145,164880,209424
test,945,33,25344,371,53424,78768
test,946,49,37632,817,117648,155280
test,947,130,99840,5749,827856,927696
test,948,56,43008,1067,153648,196656
test,949,53,40704,956,137664,178368
test,950,23,17664,180,25920,43584
test,951,82,62976,2288,329472,392448
test,952,141,108288,6763,973872,1082160
test,953,60,46080,1225,176400,222480
test,954,25,19200,213,30672,49872
test,955,146,112128,7252,1044288,1156416
test,956,29,22272,286,41184,63456
test,957,12,9216,49,7056,16272
test,958,32,24576,349,50256,74832
test,959,33,25344,371,53424,78768
test,960,24,18432,196,28224,46656
test,961,81,62208,2232,321408,383616
test,962,59,45312,1184,170496,215808
test,963,80,61440,2177,313488,374928
test,964,282,216576,23686,3410784,3627360
test,965,91,69888,2817,405648,475536
test,966,31,23808,327,47088,70896
test,967,185,142080,11643,1676592,1818672
test,968,36,27648,441,63504,91152
test,969,38,29184,491,70704,99888
test,970,23,17664,180,25920,43584
test,971,30,23040,306,44064,67104
test,972,23,17664,180,25920,43584
test,973,143,109824,6957,1001808,1111632
test,974,152,116736,7860,1131840,1248576
test,975,43,33024,629,90576,123600
test,976,19,14592,123,17712,32304
test,977,157,120576,8385,1207440,1328016
test,978,51,39168,885,127440,166608
test,979,81,62208,2232,321408,383616
test,980,48,36864,784,112896,149760
test,981,47,36096,752,108288,144384
test,982,22,16896,165,23760,40656
test,983,56,43008,1067,153648,196656
test,984,117,89856,4657,670608,760464
test,985,61,46848,1266,182304,229152
test,986,43,33024,629,90576,123600
test,987,47,36096,752,108288,144384
test,988,216,165888,15872,2285568,2451456
test,989,11,8448,41,5904,14352
test,990,36,27648,441,63504,91152
test,991,51,39168,885,127440,166608
test,992,38,29184,491,70704,99888
test,993,89,68352,2695,388080,456432
test,994,29,22272,286,41184,63456
test,995,21,16128,150,21600,37728
test,996,70,53760,1667,240048,293808
test,997,56,43008,1067,153648,196656
test,998,132,101376,5928,853632,955008
test,999,128,98304,5574,802656,900960
test,1000,52,39936,920,132480,172416
test,1001,41,31488,572,82368,113856
test,1002,42,32256,600,86400,118656
test,1003,26,19968,230,33120,53088
test,1004,21,16128,150,21600,37728
test,1005,100,76800,3402,489888,566688
test,1006,63,48384,1350,194400,242784
test,1007,76,58368,1965,282960,341328
test,1008,34,26112,393,56592,82704
test,1009,45,34560,689,99216,133776
test,1010,41,31488,572,82368,113856
test,1011,105,80640,3751,540144,620784
test,1012,27,20736,248,35712,56448
test,1013,90,69120,2756,396864,465984
test,1014,10,7680,34,4896,12576
test,1015,51,39168,885,127440,166608
test,1016,127,97536,5487,790128,887664
test,1017,59,45312,1184,170496,215808
test,1018,123,94464,5147,741168,835632
test,1019,56,43008,1067,153648,196656
test,1020,12,9216,49,7056,16272
test,1021,236,181248,18947,2728368,2909616
test,1022,56,43008,1067,153648,196656
test,1023,39,29952,518,74592,104544
test,1024,22,16896,165,23760,40656
test,1025,55,42240,1029,148176,190416
test,1026,10,7680,34,4896,12576
test,1027,43,33024,629,90576,123600
test,1028,37,28416,466,67104,95520
test,1029,53,40704,956,137664,178368
test,1030,19,14592,123,17712,32304
test,1031,122,93696,5064,729216,822912
test,1032,158,121344,8493,1222992,1344336
test,1033,47,36096,752,108288,144384
test,1034,23,17664,180,25920,43584
test,1035,56,43008,1067,153648,196656
test,1036,27,20736,248,35712,56448
test,1037,30,23040,306,44064,67104
test,1038,43,33024,629,90576,123600
test,1039,30,23040,306,44064,67104
test,1040,32,24576,349,50256,74832
test,1041,50,38400,851,122544,160944
test,1042,63,48384,1350,194400,242784
test,1043,178,136704,10779,1552176,1688880
test,1044,67,51456,1527,219888,271344
test,1045,76,58368,1965,282960,341328
test,1046,36,27648,441,63504,91152
test,1047,25,19200,213,30672,49872
test,1048,183,140544,11393,1640592,1781136
test,1049,59,45312,1184,170496,215808
test,1050,33,25344,371,53424,78768
test,1051,22,16896,165,23760,40656
test,1052,26,19968,230,33120,53088
test,1053,27,20736,248,35712,56448
test,1054,36,27648,441,63504,91152
test,1055,77,59136,2017,290448,349584
test,1056,56,43008,1067,153648,196656
test,1057,71,54528,1715,246960,301488
test,1058,41,31488,572,82368,113856
test,1059,148,113664,7452,1073088,1186752
test,1060,28,21504,267,38448,59952
test,1061,106,81408,3823,550512,631920
test,1062,95,72960,3070,442080,515040
test,1063,51,39168,885,127440,166608
test,1064,73,56064,1813,261072,317136
test,1065,234,179712,18628,2682432,2862144
test,1066,121,92928,4981,717264,810192
test,1067,33,25344,371,53424,78768
test,1068,40,30720,544,78336,109056
test,1069,10,7680,34,4896,12576
test,1070,43,33024,629,90576,123600
test,1071,85,65280,2458,353952,419232
test,1072,70,53760,1667,240048,293808
test,1073,23,17664,180,25920,43584
test,1074,36,27648,441,63504,91152
test,1075,28,21504,267,38448,59952
test,1076,12,9216,49,7056,16272
test,1077,225,172800,16151,2325744,2498544
test,1078,31,23808,327,47088,70896
test,1079,91,69888,2817,405648,475536
test,1080,26,19968,230,33120,53088
test,1081,26,19968,230,33120,53088
test,1082,41,31488,572,82368,113856
test,1083,56,43008,1067,153648,196656
test,1084,58,44544,1145,164880,209424
test,1085,51,39168,885,127440,166608
test,1086,77,59136,2017,290448,349584
test,1087,21,16128,150,21600,37728
test,1088,65,49920,1437,206928,256848
test,1089,33,25344,371,53424,78768
test,1090,48,36864,784,112896,149760
test,1091,24,18432,196,28224,46656
test,1092,20,15360,136,19584,34944
test,1093,81,62208,2232,321408,383616
test,1094,25,19200,213,30672,49872
test,1095,127,97536,5487,790128,887664
test,1096,11,8448,41,5904,14352
test,1097,26,19968,230,33120,53088
test,1098,54,41472,992,142848,184320
test,1099,73,56064,1813,261072,317136
test,1100,72,55296,1764,254016,309312
test,1101,36,27648,441,63504,91152
test,1102,40,30720,544,78336,109056
test,1103,56,43008,1067,153648,196656
test,1104,27,20736,248,35712,56448
test,1105,60,46080,1225,176400,222480
test,1106,76,58368,1965,282960,341328
test,1107,129,99072,5661,815184,914256
test,1108,33,25344,371,53424,78768
test,1109,37,28416,466,67104,95520
test,1110,124,95232,5231,753264,848496
test,1111,22,16896,165,23760,40656
test,1112,374,287232,36562,5264928,5552160
test,1113,87,66816,2575,370800,437616
test,1114,48,36864,784,112896,149760
test,1115,201,154368,13744,1979136,2133504
test,1116,25,19200,213,30672,49872
test,1117,26,19968,230,33120,53088
test,1118,72,55296,1764,254016,309312
test,1119,221,169728,16615,2392560,2562288
test,1120,76,58368,1965,282960,341328
test,1121,28,21504,267,38448,59952
test,1122,69,52992,1620,233280,286272
test,1123,78,59904,2070,298080,357984
test,1124,71,54528,1715,246960,301488
test,1125,64,49152,1394,200736,249888
test,1126,26,19968,230,33120,53088
test,1127,24,18432,196,28224,46656
test,1128,33,25344,371,53424,78768
test,1129,147,112896,7351,1058544,1171440
test,1130,16,12288,87,12528,24816
test,1131,162,124416,8928,1285632,1410048
test,1132,19,14592,123,17712,32304
test,1133,92,70656,2880,414720,485376
test,1134,51,39168,885,127440,166608
test,1135,22,16896,165,23760,40656
test,1136,24,18432,196,28224,46656
test,1137,73,56064,1813,261072,317136
test,1138,13,9984,58,8352,18336
test,1139,17,13056,98,14112,27168
test,1140,34,26112,393,56592,82704
test,1141,65,49920,1437,206928,256848
test,1142,23,17664,180,25920,43584
test,1143,78,59904,2070,298080,357984
test,1144,60,46080,1225,176400,222480
test,1145,30,23040,306,44064,67104
test,1146,25,19200,213,30672,49872
test,1147,11,8448,41,5904,14352
test,1148,54,41472,992,142848,184320
test,1149,107,82176,3895,560880,643056
test,1150,15,11520,77,11088,22608
test,1151,24,18432,196,28224,46656
test,1152,46,35328,720,103680,139008
test,1153,108,82944,3968,571392,654336
test,1154,48,36864,784,112896,149760
test,1155,25,19200,213,30672,49872
test,1156,25,19200,213,30672,49872
test,1157,57,43776,1105,159120,202896
test,1158,21,16128,150,21600,37728
test,1159,36,27648,441,63504,91152
test,1160,156,119808,8279,1192176,1311984
test,1161,24,18432,196,28224,46656
test,1162,49,37632,817,117648,155280
test,1163,21,16128,150,21600,37728
test,1164,50,38400,851,122544,160944
test,1165,28,21504,267,38448,59952
test,1166,39,29952,518,74592,104544
test,1167,30,23040,306,44064,67104
test,1168,97,74496,3201,460944,535440
test,1169,135,103680,6200,892800,996480
test,1170,24,18432,196,28224,46656
test,1171,27,20736,248,35712,56448
test,1172,60,46080,1225,176400,222480
test,1173,82,62976,2288,329472,392448
test,1174,159,122112,8600,1238400,1360512
test,1175,40,30720,544,78336,109056
test,1176,46,35328,720,103680,139008
test,1177,16,12288,87,12528,24816
test,1178,63,48384,1350,194400,242784
test,1179,276,211968,21865,3148560,3360528
test,1180,29,22272,286,41184,63456
test,1181,24,18432,196,28224,46656
test,1182,82,62976,2288,329472,392448
test,1183,72,55296,1764,254016,309312
test,1184,88,67584,2635,379440,447024
test,1185,45,34560,689,99216,133776
test,1186,207,158976,14577,2099088,2258064
test,1187,151,115968,7757,1117008,1232976
test,1188,31,23808,327,47088,70896
test,1189,105,80640,3751,540144,620784
test,1190,44,33792,659,94896,128688
test,1191,86,66048,2516,362304,428352
test,1192,40,30720,544,78336,109056
test,1193,21,16128,150,21600,37728
test,1194,359,275712,36105,5199120,5474832
test,1195,65,49920,1437,206928,256848
test,1196,62,47616,1308,188352,235968
test,1197,51,39168,885,127440,166608
test,1198,311,238848,27980,4029120,4267968
test,1199,75,57600,1914,275616,333216
test,1200,38,29184,491,70704,99888
test,1201,29,22272,286,41184,63456
test,1202,199,152832,13472,1939968,2092800
test,1203,75,57600,1914,275616,333216
test,1204,144,110592,7054,1015776,1126368
test,1205,25,19200,213,30672,49872
test,1206,95,72960,3070,442080,515040
test,1207,13,9984,58,8352,18336
test,1208,59,45312,1184,170496,215808
test,1209,23,17664,180,25920,43584
test,1210,31,23808,327,47088,70896
test,1211,29,22272,286,41184,63456
test,1212,67,51456,1527,219888,271344
test,1213,47,36096,752,108288,144384
test,1214,35,26880,417,60048,86928
test,1215,51,39168,885,127440,166608
test,1216,51,39168,885,127440,166608
test,1217,37,28416,466,67104,95520
test,1218,49,37632,817,117648,155280
test,1219,21,16128,150,21600,37728
test,1220,30,23040,306,44064,67104
test,1221,24,18432,196,28224,46656
test,1222,26,19968,230,33120,53088
test,1223,78,59904,2070,298080,357984
test,1224,46,35328,720,103680,139008
test,1225,53,40704,956,137664,178368
test,1226,80,61440,2177,313488,374928
test,1227,47,36096,752,108288,144384
test,1228,62,47616,1308,188352,235968
test,1229,50,38400,851,122544,160944
test,1230,71,54528,1715,246960,301488
test,1231,50,38400,851,122544,160944
test,1232,66,50688,1482,213408,264096
test,1233,40,30720,544,78336,109056
test,1234,24,18432,196,28224,46656
test,1235,9,6912,28,4032,10944
test,1236,50,38400,851,122544,160944
test,1237,117,89856,4657,670608,760464
test,1238,58,44544,1145,164880,209424
test,1239,25,19200,213,30672,49872
test,1240,81,62208,2232,321408,383616
test,1241,24,18432,196,28224,46656
test,1242,324,248832,31760,4573440,4822272
test,1243,49,37632,817,117648,155280
test,1244,51,39168,885,127440,166608
test,1245,48,36864,784,112896,149760
test,1246,27,20736,248,35712,56448
test,1247,276,211968,22513,3241872,3453840
test,1248,60,46080,1225,176400,222480
test,1249,10,7680,34,4896,12576
test,1250,31,23808,327,47088,70896
test,1251,107,82176,3895,560880,643056
test,1252,175,134400,10418,1500192,1634592
test,1253,60,46080,1225,176400,222480
test,1254,108,82944,3968,571392,654336
test,1255,21,16128,150,21600,37728
test,1256,121,92928,4981,717264,810192
test,1257,25,19200,213,30672,49872
test,1258,20,15360,136,19584,34944
test,1259,80,61440,2177,313488,374928
test,1260,30,23040,306,44064,67104
test,1261,49,37632,817,117648,155280
test,1262,51,39168,885,127440,166608
test,1263,23,17664,180,25920,43584
test,1264,110,84480,4116,592704,677184
test,1265,105,80640,3751,540144,620784
test,1266,167,128256,9488,1366272,1494528
test,1267,137,105216,6385,919440,1024656
test,1268,49,37632,817,117648,155280
test,1269,35,26880,417,60048,86928
test,1270,48,36864,784,112896,149760
test,1271,31,23808,327,47088,70896
test,1272,25,19200,213,30672,49872
test,1273,45,34560,689,99216,133776
test,1274,56,43008,1067,153648,196656
test,1275,47,36096,752,108288,144384
test,1276,65,49920,1437,206928,256848
test,1277,70,53760,1667,240048,293808
test,1278,38,29184,491,70704,99888
test,1279,23,17664,180,25920,43584
test,1280,23,17664,180,25920,43584
test,1281,252,193536,20039,2885616,3079152
test,1282,52,39936,920,132480,172416
test,1283,10,7680,34,4896,12576
test,1284,64,49152,1394,200736,249888
test,1285,29,22272,286,41184,63456
test,1286,224,172032,17070,2458080,2630112
test,1287,64,49152,1394,200736,249888
test,1288,25,19200,213,30672,49872
test,1289,32,24576,349,50256,74832
test,1290,31,23808,327,47088,70896
test,1291,24,18432,196,28224,46656
test,1292,130,99840,5749,827856,927696
test,1293,115,88320,4499,647856,736176
test,1294,28,21504,267,38448,59952
test,1295,16,12288,87,12528,24816
test,1296,51,39168,885,127440,166608
test,1297,42,32256,600,86400,118656
test,1298,41,31488,572,82368,113856
test,1299,33,25344,371,53424,78768
test,1300,48,36864,784,112896,149760
test,1301,176,135168,10538,1517472,1652640
test,1302,81,62208,2232,321408,383616
test,1303,57,43776,1105,159120,202896
test,1304,10,7680,34,4896,12576
test,1305,45,34560,689,99216,133776
test,1306,76,58368,1965,282960,341328
test,1307,44,33792,659,94896,128688
test,1308,208,159744,14718,2119392,2279136
test,1309,23,17664,180,25920,43584
test,1310,24,18432,196,28224,46656
test,1311,62,47616,1308,188352,235968
test,1312,31,23808,327,47088,70896
test,1313,22,16896,165,23760,40656
test,1314,63,48384,1350,194400,242784
test,1315,41,31488,572,82368,113856
test,1316,69,52992,1620,233280,286272
test,1317,23,17664,180,25920,43584
test,1318,37,28416,466,67104,95520
test,1319,25,19200,213,30672,49872
test,1320,50,38400,851,122544,160944
test,1321,41,31488,572,82368,113856
test,1322,23,17664,180,25920,43584
test,1323,62,47616,1308,188352,235968
test,1324,48,36864,784,112896,149760
test,1325,12,9216,49,7056,16272
test,1326,63,48384,1350,194400,242784
test,1327,17,13056,98,14112,27168
test,1328,301,231168,24812,3572928,3804096
test,1329,156,119808,8279,1192176,1311984
test,1330,48,36864,784,112896,149760
test,1331,55,42240,1029,148176,190416
test,1332,146,112128,7252,1044288,1156416
test,1333,13,9984,58,8352,18336
test,1334,23,17664,180,25920,43584
test,1335,44,33792,659,94896,128688
test,1336,38,29184,491,70704,99888
test,1337,58,44544,1145,164880,209424
test,1338,32,24576,349,50256,74832
test,1339,31,23808,327,47088,70896
test,1340,147,112896,7351,1058544,1171440
test,1341,65,49920,1437,206928,256848
test,1342,142,109056,6860,987840,1096896
test,1343,107,82176,3895,560880,643056
test,1344,72,55296,1764,254016,309312
test,1345,52,39936,920,132480,172416
test,1346,50,38400,851,122544,160944
test,1347,38,29184,491,70704,99888
test,1348,28,21504,267,38448,59952
test,1349,61,46848,1266,182304,229152
test,1350,59,45312,1184,170496,215808
test,1351,51,39168,885,127440,166608
test,1352,33,25344,371,53424,78768
test,1353,48,36864,784,112896,149760
test,1354,123,94464,5147,741168,835632
test,1355,24,18432,196,28224,46656
test,1356,100,76800,3402,489888,566688
test,1357,48,36864,784,112896,149760
test,1358,28,21504,267,38448,59952
test,1359,85,65280,2458,353952,419232
test,1360,53,40704,956,137664,178368
test,1361,14,10752,67,9648,20400
test,1362,28,21504,267,38448,59952
test,1363,22,16896,165,23760,40656
test,1364,56,43008,1067,153648,196656
test,1365,43,33024,629,90576,123600
test,1366,9,6912,28,4032,10944
test,1367,150,115200,7654,1102176,1217376
test,1368,76,58368,1965,282960,341328
test,1369,9,6912,28,4032,10944
test,1370,113,86784,4344,625536,712320
test,1371,31,23808,327,47088,70896
test,1372,47,36096,752,108288,144384
test,1373,65,49920,1437,206928,256848
test,1374,373,286464,36789,5297616,5584080
test,1375,12,9216,49,7056,16272
test,1376,116,89088,4578,659232,748320
test,1377,138,105984,6479,932976,1038960
test,1378,24,18432,196,28224,46656
test,1379,21,16128,150,21600,37728
test,1380,52,39936,920,132480,172416
test,1381,15,11520,77,11088,22608
test,1382,51,39168,885,127440,166608
test,1383,152,116736,7860,1131840,1248576
test,1384,27,20736,248,35712,56448
test,1385,25,19200,213,30672,49872
test,1386,98,75264,3267,470448,545712
test,1387,37,28416,466,67104,95520
test,1388,24,18432,196,28224,46656
test,1389,22,16896,165,23760,40656
test,1390,40,30720,544,78336,109056
test,1391,74,56832,1863,268272,325104
test,1392,40,30720,544,78336,109056
test,1393,22,16896,165,23760,40656
test,1394,23,17664,180,25920,43584
test,1395,73,56064,1813,261072,317136
test,1396,66,50688,1482,213408,264096
test,1397,46,35328,720,103680,139008
test,1398,14,10752,67,9648,20400
test,1399,117,89856,4657,670608,760464
test,1400,15,11520,77,11088,22608
test,1401,37,28416,466,67104,95520
test,1402,47,36096,752,108288,144384
test,1403,136,104448,6292,906048,1010496
test,1404,217,166656,16019,2306736,2473392
test,1405,41,31488,572,82368,113856
test,1406,92,70656,2880,414720,485376
test,1407,24,18432,196,28224,46656
test,1408,67,51456,1527,219888,271344
test,1409,77,59136,2017,290448,349584
test,1410,88,67584,2635,379440,447024
test,1411,131,100608,5838,840672,941280
test,1412,48,36864,784,112896,149760
test,1413,40,30720,544,78336,109056
test,1414,57,43776,1105,159120,202896
test,1415,81,62208,2232,321408,383616
test,1416,94,72192,3006,432864,505056
test,1417,116,89088,4578,659232,748320
test,1418,36,27648,441,63504,91152
test,1419,56,43008,1067,153648,196656
test,1420,34,26112,393,56592,82704
test,1421,71,54528,1715,246960,301488
test,1422,33,25344,371,53424,78768
test,1423,65,49920,1437,206928,256848
test,1424,40,30720,544,78336,109056
test,1425,60,46080,1225,176400,222480
test,1426,54,41472,992,142848,184320
test,1427,43,33024,629,90576,123600
test,1428,12,9216,49,7056,16272
test,1429,17,13056,98,14112,27168
test,1430,33,25344,371,53424,78768
test,1431,34,26112,393,56592,82704
test,1432,31,23808,327,47088,70896
test,1433,42,32256,600,86400,118656
test,1434,12,9216,49,7056,16272
test,1435,69,52992,1620,233280,286272
test,1436,23,17664,180,25920,43584
test,1437,73,56064,1813,261072,317136
test,1438,66,50688,1482,213408,264096
test,1439,54,41472,992,142848,184320
test,1440,27,20736,248,35712,56448
test,1441,23,17664,180,25920,43584
test,1442,278,213504,25287,3641328,3854832
test,1443,66,50688,1482,213408,264096
test,1444,41,31488,572,82368,113856
test,1445,252,193536,19583,2819952,3013488
test,1446,23,17664,180,25920,43584
test,1447,23,17664,180,25920,43584
test,1448,74,56832,1863,268272,325104
test,1449,29,22272,286,41184,63456
test,1450,24,18432,196,28224,46656
test,1451,44,33792,659,94896,128688
test,1452,73,56064,1813,261072,317136
test,1453,68,52224,1573,226512,278736
test,1454,26,19968,230,33120,53088
test,1455,112,86016,4268,614592,700608
test,1456,150,115200,7654,1102176,1217376
test,1457,32,24576,349,50256,74832
test,1458,71,54528,1715,246960,301488
test,1459,46,35328,720,103680,139008
test,1460,33,25344,371,53424,78768
test,1461,18,13824,110,15840,29664
test,1462,25,19200,213,30672,49872
test,1463,7,5376,17,2448,7824
test,1464,26,19968,230,33120,53088
test,1465,65,49920,1437,206928,256848
test,1466,92,70656,2880,414720,485376
test,1467,45,34560,689,99216,133776
test,1468,26,19968,230,33120,53088
test,1469,44,33792,659,94896,128688
test,1470,30,23040,306,44064,67104
test,1471,12,9216,49,7056,16272
test,1472,77,59136,2017,290448,349584
test,1473,39,29952,518,74592,104544
test,1474,58,44544,1145,164880,209424
test,1475,59,45312,1184,170496,215808
test,1476,16,12288,87,12528,24816
test,1477,67,51456,1527,219888,271344
test,1478,124,95232,5231,753264,848496
test,1479,34,26112,393,56592,82704
test,1480,62,47616,1308,188352,235968
test,1481,104,79872,3680,529920,609792
test,1482,43,33024,629,90576,123600
test,1483,26,19968,230,33120,53088
test,1484,17,13056,98,14112,27168
test,1485,40,30720,544,78336,109056
test,1486,24,18432,196,28224,46656
test,1487,59,45312,1184,170496,215808
test,1488,64,49152,1394,200736,249888
test,1489,77,59136,2017,290448,349584
test,1490,21,16128,150,21600,37728
test,1491,22,16896,165,23760,40656
test,1492,348,267264,34351,4946544,5213808
test,1493,70,53760,1667,240048,293808
test,1494,27,20736,248,35712,56448
test,1495,105,80640,3751,540144,620784
test,1496,12,9216,49,7056,16272
test,1497,80,61440,2177,313488,374928
test,1498,41,31488,572,82368,113856
test,1499,29,22272,286,41184,63456
test,1500,35,26880,417,60048,86928
test,1501,12,9216,49,7056,16272
test,1502,74,56832,1863,268272,325104
test,1503,216,165888,15872,2285568,2451456
test,1504,28,21504,267,38448,59952
test,1505,44,33792,659,94896,128688
test,1506,23,17664,180,25920,43584
test,1507,23,17664,180,25920,43584
test,1508,18,13824,110,15840,29664
test,1509,49,37632,817,117648,155280
test,1510,98,75264,3267,470448,545712
test,1511,24,18432,196,28224,46656
test,1512,65,49920,1437,206928,256848
test,1513,86,66048,2516,362304,428352
test,1514,212,162816,15290,2201760,2364576
test,1515,17,13056,98,14112,27168
test,1516,72,55296,1764,254016,309312
test,1517,26,19968,230,33120,53088
test,1518,134,102912,6109,879696,982608
test,1519,49,37632,817,117648,155280
test,1520,33,25344,371,53424,78768
test,1521,27,20736,248,35712,56448
test,1522,15,11520,77,11088,22608
test,1523,179,137472,10900,1569600,1707072
test,1524,22,16896,165,23760,40656
test,1525,32,24576,349,50256,74832
test,1526,70,53760,1667,240048,293808
test,1527,14,10752,67,9648,20400
test,1528,10,7680,34,4896,12576
test,1529,246,188928,19281,2776464,2965392
test,1530,21,16128,150,21600,37728
test,1531,113,86784,4344,625536,712320
test,1532,25,19200,213,30672,49872
test,1533,70,53760,1667,240048,293808
test,1534,23,17664,180,25920,43584
test,1535,54,41472,992,142848,184320
test,1536,16,12288,87,12528,24816
test,1537,26,19968,230,33120,53088
test,1538,26,19968,230,33120,53088
test,1539,262,201216,20819,2997936,3199152
test,1540,131,100608,5838,840672,941280
test,1541,26,19968,230,33120,53088
test,1542,91,69888,2817,405648,475536
test,1543,34,26112,393,56592,82704
test,1544,70,53760,1667,240048,293808
test,1545,19,14592,123,17712,32304
test,1546,185,142080,11643,1676592,1818672
test,1547,24,18432,196,28224,46656
test,1548,32,24576,349,50256,74832
test,1549,23,17664,180,25920,43584
test,1550,35,26880,417,60048,86928
test,1551,89,68352,2695,388080,456432
test,1552,134,102912,6109,879696,982608
test,1553,29,22272,286,41184,63456
test,1554,13,9984,58,8352,18336
test,1555,12,9216,49,7056,16272
test,1556,23,17664,180,25920,43584
test,1557,83,63744,2344,337536,401280
test,1558,15,11520,77,11088,22608
test,1559,20,15360,136,19584,34944
test,1560,13,9984,58,8352,18336
test,1561,37,28416,466,67104,95520
test,1562,13,9984,58,8352,18336
test,1563,24,18432,196,28224,46656
test,1564,77,59136,2017,290448,349584
test,1565,77,59136,2017,290448,349584
test,1566,57,43776,1105,159120,202896
test,1567,25,19200,213,30672,49872
test,1568,24,18432,196,28224,46656
test,1569,26,19968,230,33120,53088
test,1570,228,175104,17137,2467728,2642832
test,1571,64,49152,1394,200736,249888
test,1572,16,12288,87,12528,24816
test,1573,27,20736,248,35712,56448
test,1574,102,78336,3539,509616,587952
test,1575,25,19200,213,30672,49872
test,1576,17,13056,98,14112,27168
test,1577,35,26880,417,60048,86928
test,1578,221,169728,16615,2392560,2562288
test,1579,23,17664,180,25920,43584
test,1580,76,58368,1965,282960,341328
test,1581,29,22272,286,41184,63456
test,1582,56,43008,1067,153648,196656
test,1583,25,19200,213,30672,49872
test,1584,20,15360,136,19584,34944
test,1585,22,16896,165,23760,40656
test,1586,26,19968,230,33120,53088
test,1587,46,35328,720,103680,139008
test,1588,33,25344,371,53424,78768
test,1589,13,9984,58,8352,18336
test,1590,98,75264,3267,470448,545712
test,1591,23,17664,180,25920,43584
test,1592,64,49152,1394,200736,249888
test,1593,23,17664,180,25920,43584
test,1594,33,25344,371,53424,78768
test,1595,84,64512,2401,345744,410256
test,1596,28,21504,267,38448,59952
test,1597,74,56832,1863,268272,325104
test,1598,139,106752,6573,946512,1053264
test,1599,24,18432,196,28224,46656
test,1600,45,34560,689,99216,133776
test,1601,42,32256,600,86400,118656
test,1602,79,60672,2123,305712,366384
test,1603,27,20736,248,35712,56448
test,1604,32,24576,349,50256,74832
test,1605,31,23808,327,47088,70896
test,1606,27,20736,248,35712,56448
test,1607,21,16128,150,21600,37728
test,1608,24,18432,196,28224,46656
test,1609,49,37632,817,117648,155280
test,1610,250,192000,20316,2925504,3117504
test,1611,35,26880,417,60048,86928
test,1612,29,22272,286,41184,63456
test,1613,74,56832,1863,268272,325104
test,1614,91,69888,2817,405648,475536
test,1615,39,29952,518,74592,104544
test,1616,93,71424,2942,423648,495072
test,1617,77,59136,2017,290448,349584
test,1618,35,26880,417,60048,86928
test,1619,41,31488,572,82368,113856
test,1620,61,46848,1266,182304,229152
test,1621,163,125184,9039,1301616,1426800
test,1622,65,49920,1437,206928,256848
test,1623,50,38400,851,122544,160944
test,1624,55,42240,1029,148176,190416
test,1625,38,29184,491,70704,99888
test,1626,27,20736,248,35712,56448
test,1627,56,43008,1067,153648,196656
test,1628,51,39168,885,127440,166608
test,1629,70,53760,1667,240048,293808
test,1630,115,88320,4499,647856,736176
test,1631,74,56832,1863,268272,325104
test,1632,35,26880,417,60048,86928
test,1633,21,16128,150,21600,37728
test,1634,118,90624,4737,682128,772752
test,1635,70,53760,1667,240048,293808
test,1636,49,37632,817,117648,155280
test,1637,51,39168,885,127440,166608
test,1638,98,75264,3267,470448,545712
test,1639,23,17664,180,25920,43584
test,1640,90,69120,2756,396864,465984
test,1641,33,25344,371,53424,78768
test,1642,130,99840,5749,827856,927696
test,1643,33,25344,371,53424,78768
test,1644,70,53760,1667,240048,293808
test,1645,32,24576,349,50256,74832
test,1646,81,62208,2232,321408,383616
test,1647,47,36096,752,108288,144384
test,1648,60,46080,1225,176400,222480
test,1649,67,51456,1527,219888,271344
test,1650,24,18432,196,28224,46656
test,1651,33,25344,371,53424,78768
test,1652,46,35328,720,103680,139008
test,1653,12,9216,49,7056,16272
test,1654,39,29952,518,74592,104544
test,1655,125,96000,5316,765504,861504
test,1656,61,46848,1266,182304,229152
test,1657,30,23040,306,44064,67104
test,1658,10,7680,34,4896,12576
test,1659,44,33792,659,94896,128688
test,1660,29,22272,286,41184,63456
test,1661,174,133632,10300,1483200,1616832
test,1662,121,92928,4981,717264,810192
test,1663,63,48384,1350,194400,242784
test,1664,21,16128,150,21600,37728
test,1665,76,58368,1965,282960,341328
test,1666,28,21504,267,38448,59952
test,1667,30,23040,306,44064,67104
test,1668,51,39168,885,127440,166608
test,1669,73,56064,1813,261072,317136
test,1670,26,19968,230,33120,53088
test,1671,23,17664,180,25920,43584
test,1672,61,46848,1266,182304,229152
test,1673,250,192000,21262,3061728,3253728
test,1674,16,12288,87,12528,24816
test,1675,52,39936,920,132480,172416
test,1676,21,16128,150,21600,37728
test,1677,127,97536,5487,790128,887664
test,1678,41,31488,572,82368,113856
test,1679,73,56064,1813,261072,317136
test,1680,24,18432,196,28224,46656
test,1681,23,17664,180,25920,43584
test,1682,62,47616,1308,188352,235968
test,1683,70,53760,1667,240048,293808
test,1684,28,21504,267,38448,59952
test,1685,31,23808,327,47088,70896
test,1686,36,27648,441,63504,91152
test,1687,73,56064,1813,261072,317136
test,1688,42,32256,600,86400,118656
test,1689,50,38400,851,122544,160944
test,1690,41,31488,572,82368,113856
test,1691,103,79104,3609,519696,598800
test,1692,61,46848,1266,182304,229152
test,1693,35,26880,417,60048,86928
test,1694,153,117504,7964,1146816,1264320
test,1695,145,111360,7153,1030032,1141392
test,1696,171,131328,9948,1432512,1563840
test,1697,63,48384,1350,194400,242784
test,1698,108,82944,3968,571392,654336
test,1699,31,23808,327,47088,70896
test,1700,33,25344,371,53424,78768
test,1701,241,185088,19759,2845296,3030384
test,1702,47,36096,752,108288,144384
test,1703,58,44544,1145,164880,209424
test,1704,132,101376,5928,853632,955008
test,1705,44,33792,659,94896,128688
test,1706,50,38400,851,122544,160944
test,1707,26,19968,230,33120,53088
test,1708,59,45312,1184,170496,215808
test,1709,201,154368,13744,1979136,2133504
test,1710,64,49152,1394,200736,249888
test,1711,37,28416,466,67104,95520
test,1712,65,49920,1437,206928,256848
test,1713,22,16896,165,23760,40656
test,1714,28,21504,267,38448,59952
test,1715,13,9984,58,8352,18336
test,1716,76,58368,1965,282960,341328
test,1717,139,106752,6573,946512,1053264
test,1718,52,39936,920,132480,172416
test,1719,65,49920,1437,206928,256848
test,1720,51,39168,885,127440,166608
test,1721,21,16128,150,21600,37728
test,1722,60,46080,1225,176400,222480
test,1723,31,23808,327,47088,70896
test,1724,125,96000,5316,765504,861504
test,1725,34,26112,393,56592,82704
test,1726,26,19968,230,33120,53088
test,1727,36,27648,441,63504,91152
test,1728,71,54528,1715,246960,301488
test,1729,63,48384,1350,194400,242784
test,1730,47,36096,752,108288,144384
test,1731,23,17664,180,25920,43584
test,1732,18,13824,110,15840,29664
test,1733,55,42240,1029,148176,190416
test,1734,65,49920,1437,206928,256848
test,1735,40,30720,544,78336,109056
test,1736,73,56064,1813,261072,317136
test,1737,78,59904,2070,298080,357984
test,1738,34,26112,393,56592,82704
test,1739,301,231168,26964,3882816,4113984
test,1740,30,23040,306,44064,67104
test,1741,27,20736,248,35712,56448
test,1742,33,25344,371,53424,78768
test,1743,16,12288,87,12528,24816
test,1744,60,46080,1225,176400,222480
test,1745,22,16896,165,23760,40656
test,1746,26,19968,230,33120,53088
test,1747,27,20736,248,35712,56448
test,1748,36,27648,441,63504,91152
test,1749,21,16128,150,21600,37728
test,1750,37,28416,466,67104,95520
test,1751,231,177408,18153,2614032,2791440
test,1752,123,94464,5147,741168,835632
test,1753,36,27648,441,63504,91152
test,1754,209,160512,14860,2139840,2300352
test,1755,22,16896,165,23760,40656
test,1756,28,21504,267,38448,59952
test,1757,82,62976,2288,329472,392448
test,1758,84,64512,2401,345744,410256
test,1759,79,60672,2123,305712,366384
test,1760,56,43008,1067,153648,196656
test,1761,123,94464,5147,741168,835632
test,1762,13,9984,58,8352,18336
test,1763,24,18432,196,28224,46656
test,1764,55,42240,1029,148176,190416
test,1765,51,39168,885,127440,166608
test,1766,28,21504,267,38448,59952
test,1767,18,13824,110,15840,29664
test,1768,178,136704,10779,1552176,1688880
test,1769,158,121344,8493,1222992,1344336
test,1770,106,81408,3823,550512,631920
test,1771,36,27648,441,63504,91152
test,1772,49,37632,817,117648,155280
test,1773,11,8448,41,5904,14352
test,1774,20,15360,136,19584,34944
test,1775,25,19200,213,30672,49872
test,1776,77,59136,2017,290448,349584
test,1777,88,67584,2635,379440,447024
test,1778,48,36864,784,112896,149760
test,1779,195,149760,12936,1862784,2012544
test,1780,76,58368,1965,282960,341328
test,1781,31,23808,327,47088,70896
test,1782,81,62208,2232,321408,383616
test,1783,207,158976,14577,2099088,2258064
test,1784,89,68352,2695,388080,456432
test,1785,71,54528,1715,246960,301488
test,1786,30,23040,306,44064,67104
test,1787,15,11520,77,11088,22608
test,1788,19,14592,123,17712,32304
test,1789,113,86784,4344,625536,712320
test,1790,63,48384,1350,194400,242784
test,1791,53,40704,956,137664,178368
test,1792,25,19200,213,30672,49872
test,1793,68,52224,1573,226512,278736
test,1794,22,16896,165,23760,40656
test,1795,24,18432,196,28224,46656
test,1796,144,110592,7054,1015776,1126368
test,1797,42,32256,600,86400,118656
test,1798,19,14592,123,17712,32304
test,1799,73,56064,1813,261072,317136
test,1800,58,44544,1145,164880,209424
test,1801,319,244992,29434,4238496,4483488
test,1802,11,8448,41,5904,14352
test,1803,168,129024,9602,1382688,1511712
test,1804,57,43776,1105,159120,202896
test,1805,43,33024,629,90576,123600
test,1806,171,131328,9948,1432512,1563840
test,1807,28,21504,267,38448,59952
test,1808,11,8448,41,5904,14352
test,1809,34,26112,393,56592,82704
test,1810,44,33792,659,94896,128688
test,1811,72,55296,1764,254016,309312
test,1812,53,40704,956,137664,178368
test,1813,111,85248,4192,603648,688896
test,1814,31,23808,327,47088,70896
test,1815,47,36096,752,108288,144384
test,1816,200,153600,13608,1959552,2113152
test,1817,58,44544,1145,164880,209424
test,1818,42,32256,600,86400,118656
test,1819,32,24576,349,50256,74832
test,1820,54,41472,992,142848,184320
test,1821,14,10752,67,9648,20400
test,1822,57,43776,1105,159120,202896
test,1823,32,24576,349,50256,74832
test,1824,81,62208,2232,321408,383616
test,1825,59,45312,1184,170496,215808
test,1826,30,23040,306,44064,67104
test,1827,21,16128,150,21600,37728
test,1828,36,27648,441,63504,91152
test,1829,22,16896,165,23760,40656
test,1830,50,38400,851,122544,160944
test,1831,79,60672,2123,305712,366384
test,1832,82,62976,2288,329472,392448
test,1833,29,22272,286,41184,63456
test,1834,46,35328,720,103680,139008
test,1835,123,94464,5147,741168,835632
test,1836,30,23040,306,44064,67104
test,1837,33,25344,371,53424,78768
test,1838,33,25344,371,53424,78768
test,1839,31,23808,327,47088,70896
test,1840,107,82176,3895,560880,643056
test,1841,16,12288,87,12528,24816
test,1842,41,31488,572,82368,113856
test,1843,25,19200,213,30672,49872
test,1844,63,48384,1350,194400,242784
test,1845,20,15360,136,19584,34944
test,1846,19,14592,123,17712,32304
test,1847,25,19200,213,30672,49872
test,1848,62,47616,1308,188352,235968
test,1849,21,16128,150,21600,37728
test,1850,58,44544,1145,164880,209424
test,1851,56,43008,1067,153648,196656
test,1852,17,13056,98,14112,27168
test,1853,119,91392,4818,693792,785184
test,1854,47,36096,752,108288,144384
test,1855,71,54528,1715,246960,301488
test,1856,18,13824,110,15840,29664
test,1857,11,8448,41,5904,14352
test,1858,32,24576,349,50256,74832
test,1859,71,54528,1715,246960,301488
test,1860,154,118272,8068,1161792,1280064
test,1861,13,9984,58,8352,18336
test,1862,53,40704,956,137664,178368
test,1863,121,92928,4981,717264,810192
test,1864,47,36096,752,108288,144384
test,1865,235,180480,17977,2588688,2769168
test,1866,84,64512,2401,345744,410256
test,1867,13,9984,58,8352,18336
test,1868,31,23808,327,47088,70896
test,1869,24,18432,196,28224,46656
test,1870,72,55296,1764,254016,309312
test,1871,218,167424,16018,2306592,2474016
test,1872,54,41472,992,142848,184320
test,1873,125,96000,5316,765504,861504
test,1874,28,21504,267,38448,59952
test,1875,122,93696,5064,729216,822912
test,1876,29,22272,286,41184,63456
test,1877,115,88320,4499,647856,736176
test,1878,66,50688,1482,213408,264096
test,1879,23,17664,180,25920,43584
test,1880,12,9216,49,7056,16272
test,1881,62,47616,1308,188352,235968
test,1882,59,45312,1184,170496,215808
test,1883,29,22272,286,41184,63456
test,1884,11,8448,41,5904,14352
test,1885,106,81408,3823,550512,631920
test,1886,14,10752,67,9648,20400
test,1887,53,40704,956,137664,178368
test,1888,123,94464,5147,741168,835632
test,1889,193,148224,12672,1824768,1972992
test,1890,41,31488,572,82368,113856
test,1891,63,48384,1350,194400,242784
test,1892,41,31488,572,82368,113856
test,1893,90,69120,2756,396864,465984
test,1894,55,42240,1029,148176,190416
test,1895,39,29952,518,74592,104544
test,1896,74,56832,1863,268272,325104
test,1897,23,17664,180,25920,43584
test,1898,52,39936,920,132480,172416
test,1899,44,33792,659,94896,128688
test,1900,84,64512,2401,345744,410256
test,1901,66,50688,1482,213408,264096
test,1902,55,42240,1029,148176,190416
test,1903,8,6144,22,3168,9312
test,1904,37,28416,466,67104,95520
test,1905,198,152064,13337,1920528,2072592
test,1906,23,17664,180,25920,43584
test,1907,64,49152,1394,200736,249888
test,1908,26,19968,230,33120,53088
test,1909,64,49152,1394,200736,249888
test,1910,26,19968,230,33120,53088
test,1911,35,26880,417,60048,86928
test,1912,39,29952,518,74592,104544
test,1913,61,46848,1266,182304,229152
test,1914,23,17664,180,25920,43584
test,1915,27,20736,248,35712,56448
test,1916,54,41472,992,142848,184320
test,1917,114,87552,4421,636624,724176
test,1918,138,105984,6479,932976,1038960
test,1919,171,131328,9948,1432512,1563840
test,1920,58,44544,1145,164880,209424
test,1921,10,7680,34,4896,12576
test,1922,139,106752,6573,946512,1053264
test,1923,86,66048,2516,362304,428352
test,1924,30,23040,306,44064,67104
test,1925,69,52992,1620,233280,286272
test,1926,46,35328,720,103680,139008
test,1927,23,17664,180,25920,43584
test,1928,35,26880,417,60048,86928
test,1929,12,9216,49,7056,16272
test,1930,30,23040,306,44064,67104
test,1931,58,44544,1145,164880,209424
test,1932,37,28416,466,67104,95520
test,1933,82,62976,2288,329472,392448
test,1934,38,29184,491,70704,99888
test,1935,134,102912,6109,879696,982608
test,1936,21,16128,150,21600,37728
test,1937,15,11520,77,11088,22608
test,1938,90,69120,2756,396864,465984
test,1939,73,56064,1813,261072,317136
test,1940,31,23808,327,47088,70896
test,1941,42,32256,600,86400,118656
test,1942,75,57600,1914,275616,333216
test,1943,144,110592,7054,1015776,1126368
test,1944,123,94464,5147,741168,835632
test,1945,64,49152,1394,200736,249888
test,1946,234,179712,18628,2682432,2862144
test,1947,69,52992,1620,233280,286272
test,1948,71,54528,1715,246960,301488
test,1949,156,119808,8279,1192176,1311984
test,1950,62,47616,1308,188352,235968
test,1951,21,16128,150,21600,37728
test,1952,48,36864,784,112896,149760
test,1953,66,50688,1482,213408,264096
test,1954,41,31488,572,82368,113856
test,1955,26,19968,230,33120,53088
test,1956,25,19200,213,30672,49872
test,1957,39,29952,518,74592,104544
test,1958,48,36864,784,112896,149760
test,1959,14,10752,67,9648,20400
test,1960,82,62976,2288,329472,392448
test,1961,52,39936,920,132480,172416
test,1962,13,9984,58,8352,18336
test,1963,59,45312,1184,170496,215808
test,1964,118,90624,4737,682128,772752
test,1965,98,75264,3267,470448,545712
test,1966,27,20736,248,35712,56448
test,1967,62,47616,1308,188352,235968
test,1968,27,20736,248,35712,56448
test,1969,41,31488,572,82368,113856
test,1970,33,25344,371,53424,78768
test,1971,41,31488,572,82368,113856
test,1972,49,37632,817,117648,155280
test,1973,68,52224,1573,226512,278736
test,1974,99,76032,3334,480096,556128
test,1975,59,45312,1184,170496,215808
test,1976,45,34560,689,99216,133776
test,1977,56,43008,1067,153648,196656
test,1978,157,120576,8385,1207440,1328016
test,1979,75,57600,1914,275616,333216
test,1980,38,29184,491,70704,99888
test,1981,25,19200,213,30672,49872
test,1982,61,46848,1266,182304,229152
test,1983,21,16128,150,21600,37728
test,1984,100,76800,3402,489888,566688
test,1985,62,47616,1308,188352,235968
test,1986,28,21504,267,38448,59952
test,1987,25,19200,213,30672,49872
test,1988,11,8448,41,5904,14352
test,1989,61,46848,1266,182304,229152
test,1990,28,21504,267,38448,59952
test,1991,151,115968,7757,1117008,1232976
test,1992,27,20736,248,35712,56448
test,1993,56,43008,1067,153648,196656
test,1994,74,56832,1863,268272,325104
test,1995,63,48384,1350,194400,242784
test,1996,142,109056,6860,987840,1096896
test,1997,114,87552,4421,636624,724176
test,1998,82,62976,2288,329472,392448
test,1999,44,33792,659,94896,128688
test,2000,19,14592,123,17712,32304
test,2001,25,19200,213,30672,49872
test,2002,165,126720,9262,1333728,1460448
test,2003,33,25344,371,53424,78768
test,2004,42,32256,600,86400,118656
test,2005,101,77568,3470,499680,577248
test,2006,33,25344,371,53424,78768
test,2007,57,43776,1105,159120,202896
test,2008,242,185856,19923,2868912,3054768
test,2009,81,62208,2232,321408,383616
test,2010,365,280320,37517,5402448,5682768
test,2011,24,18432,196,28224,46656
test,2012,112,86016,4267,614448,700464
test,2013,15,11520,77,11088,22608
test,2014,40,30720,544,78336,109056
test,2015,48,36864,784,112896,149760
test,2016,37,28416,466,67104,95520
test,2017,41,31488,572,82368,113856
test,2018,105,80640,3751,540144,620784
test,2019,41,31488,572,82368,113856
test,2020,77,59136,2017,290448,349584
test,2021,26,19968,230,33120,53088
test,2022,53,40704,956,137664,178368
test,2023,31,23808,327,47088,70896
test,2024,54,41472,992,142848,184320
test,2025,257,197376,22469,3235536,3432912
test,2026,32,24576,349,50256,74832
test,2027,104,79872,3680,529920,609792
test,2028,140,107520,6668,960192,1067712
test,2029,43,33024,629,90576,123600
test,2030,47,36096,752,108288,144384
test,2031,71,54528,1715,246960,301488
test,2032,39,29952,518,74592,104544
test,2033,101,77568,3470,499680,577248
test,2034,48,36864,784,112896,149760
test,2035,131,100608,5838,840672,941280
test,2036,23,17664,180,25920,43584
test,2037,49,37632,817,117648,155280
test,2038,23,17664,180,25920,43584
test,2039,34,26112,393,56592,82704
test,2040,33,25344,371,53424,78768
test,2041,66,50688,1482,213408,264096
test,2042,92,70656,2880,414720,485376
test,2043,120,92160,4899,705456,797616
test,2044,53,40704,956,137664,178368
test,2045,48,36864,784,112896,149760
test,2046,48,36864,784,112896,149760
test,2047,26,19968,230,33120,53088
test,2048,12,9216,49,7056,16272
test,2049,45,34560,689,99216,133776
test,2050,22,16896,165,23760,40656
test,2051,14,10752,67,9648,20400
test,2052,68,52224,1573,226512,278736
test,2053,93,71424,2942,423648,495072
test,2054,149,114432,7553,1087632,1202064
test,2055,49,37632,817,117648,155280
test,2056,15,11520,77,11088,22608
test,2057,153,117504,7964,1146816,1264320
test,2058,28,21504,267,38448,59952
test,2059,149,114432,7553,1087632,1202064
test,2060,315,241920,27363,3940272,4182192
test,2061,29,22272,286,41184,63456
test,2062,49,37632,817,117648,155280
test,2063,52,39936,920,132480,172416
test,2064,15,11520,77,11088,22608
test,2065,76,58368,1965,282960,341328
test,2066,10,7680,34,4896,12576
test,2067,30,23040,306,44064,67104
test,2068,230,176640,17996,2591424,2768064
test,2069,92,70656,2880,414720,485376
test,2070,27,20736,248,35712,56448
test,2071,100,76800,3402,489888,566688
test,2072,53,40704,956,137664,178368
test,2073,52,39936,920,132480,172416
test,2074,66,50688,1482,213408,264096
test,2075,22,16896,165,23760,40656
test,2076,33,25344,371,53424,78768
test,2077,64,49152,1394,200736,249888
test,2078,33,25344,371,53424,78768
test,2079,25,19200,213,30672,49872
test,2080,74,56832,1863,268272,325104
test,2081,41,31488,572,82368,113856
test,2082,33,25344,371,53424,78768
test,2083,75,57600,1914,275616,333216
test,2084,29,22272,286,41184,63456
test,2085,72,55296,1764,254016,309312
test,2086,59,45312,1184,170496,215808
test,2087,31,23808,327,47088,70896
test,2088,92,70656,2880,414720,485376
test,2089,52,39936,920,132480,172416
test,2090,28,21504,267,38448,59952
test,2091,169,129792,9716,1399104,1528896
test,2092,171,131328,9948,1432512,1563840
test,2093,34,26112,393,56592,82704
test,2094,60,46080,1225,176400,222480
test,2095,39,29952,518,74592,104544
test,2096,124,95232,5231,753264,848496
test,2097,88,67584,2635,379440,447024
test,2098,25,19200,213,30672,49872
test,2099,13,9984,58,8352,18336
test,2100,23,17664,180,25920,43584
test,2101,13,9984,58,8352,18336
test,2102,64,49152,1394,200736,249888
test,2103,45,34560,689,99216,133776
test,2104,36,27648,441,63504,91152
test,2105,29,22272,286,41184,63456
test,2106,52,39936,920,132480,172416
test,2107,34,26112,393,56592,82704
test,2108,10,7680,34,4896,12576
test,2109,28,21504,267,38448,59952
test,2110,94,72192,3006,432864,505056
test,2111,74,56832,1863,268272,325104
test,2112,59,45312,1184,170496,215808
test,2113,43,33024,629,90576,123600
test,2114,69,52992,1620,233280,286272
test,2115,117,89856,4657,670608,760464
test,2116,76,58368,1965,282960,341328
test,2117,25,19200,213,30672,49872
test,2118,23,17664,180,25920,43584
test,2119,59,45312,1184,170496,215808
test,2120,19,14592,123,17712,32304
test,2121,23,17664,180,25920,43584
test,2122,16,12288,87,12528,24816
test,2123,45,34560,689,99216,133776
test,2124,11,8448,41,5904,14352
test,2125,51,39168,885,127440,166608
test,2126,23,17664,180,25920,43584
test,2127,93,71424,2942,423648,495072
test,2128,34,26112,393,56592,82704
test,2129,20,15360,136,19584,34944
test,2130,84,64512,2401,345744,410256
test,2131,23,17664,180,25920,43584
test,2132,63,48384,1350,194400,242784
test,2133,59,45312,1184,170496,215808
test,2134,53,40704,956,137664,178368
test,2135,288,221184,24298,3498912,3720096
test,2136,148,113664,7452,1073088,1186752
test,2137,136,104448,6292,906048,1010496
test,2138,25,19200,213,30672,49872
test,2139,171,131328,9948,1432512,1563840
test,2140,30,23040,306,44064,67104
test,2141,15,11520,77,11088,22608
test,2142,19,14592,123,17712,32304
test,2143,50,38400,851,122544,160944
test,2144,99,76032,3334,480096,556128
test,2145,27,20736,248,35712,56448
test,2146,22,16896,165,23760,40656
test,2147,110,84480,4116,592704,677184
test,2148,16,12288,87,12528,24816
test,2149,65,49920,1437,206928,256848
test,2150,41,31488,572,82368,113856
test,2151,42,32256,600,86400,118656
test,2152,27,20736,248,35712,56448
test,2153,25,19200,213,30672,49872
test,2154,108,82944,3968,571392,654336
test,2155,75,57600,1914,275616,333216
test,2156,24,18432,196,28224,46656
test,2157,52,39936,920,132480,172416
test,2158,117,89856,4657,670608,760464
test,2159,176,135168,10538,1517472,1652640
test,2160,13,9984,58,8352,18336
test,2161,12,9216,49,7056,16272
test,2162,99,76032,3334,480096,556128
test,2163,24,18432,196,28224,46656
test,2164,111,85248,4192,603648,688896
test,2165,156,119808,8279,1192176,1311984
test,2166,47,36096,752,108288,144384
test,2167,269,206592,21398,3081312,3287904
test,2168,20,15360,136,19584,34944
test,2169,360,276480,35785,5153040,5429520
test,2170,42,32256,600,86400,118656
test,2171,31,23808,327,47088,70896
test,2172,66,50688,1482,213408,264096
test,2173,46,35328,720,103680,139008
test,2174,45,34560,689,99216,133776
test,2175,26,19968,230,33120,53088
test,2176,27,20736,248,35712,56448
test,2177,25,19200,213,30672,49872
test,2178,21,16128,150,21600,37728
test,2179,35,26880,417,60048,86928
test,2180,55,42240,1029,148176,190416
test,2181,50,38400,851,122544,160944
test,2182,130,99840,5749,827856,927696
test,2183,50,38400,851,122544,160944
test,2184,48,36864,784,112896,149760
test,2185,33,25344,371,53424,78768
test,2186,56,43008,1067,153648,196656
test,2187,87,66816,2575,370800,437616
test,2188,183,140544,11393,1640592,1781136
