split,index,nodes,total_values_for_nodes,edges,total_values_for_edges,total_values_for_graph
train,0,45,34560,862,124128,158688
train,1,15,11520,96,13824,25344
train,2,32,24576,436,62784,87360
train,3,19,14592,154,22176,36768
train,4,37,28416,583,83952,112368
train,5,20,15360,170,24480,39840
train,6,13,9984,72,10368,20352
train,7,19,14592,154,22176,36768
train,8,19,14592,154,22176,36768
train,9,27,20736,310,44640,65376
train,10,29,22272,358,51552,73824
train,11,22,16896,206,29664,46560
train,12,22,16896,206,29664,46560
train,13,10,7680,43,6192,13872
train,14,15,11520,96,13824,25344
train,15,17,13056,123,17712,30768
train,16,25,19200,266,38304,57504
train,17,8,6144,27,3888,10032
train,18,21,16128,188,27072,43200
train,19,31,23808,409,58896,82704
train,20,12,9216,61,8784,18000
train,21,3,2304,4,576,2880
train,22,34,26112,492,70848,96960
train,23,17,13056,123,17712,30768
train,24,12,9216,61,8784,18000
train,25,18,13824,138,19872,33696
train,26,19,14592,154,22176,36768
train,27,29,22272,358,51552,73824
train,28,19,14592,154,22176,36768
train,29,5,3840,11,1584,5424
train,30,32,24576,436,62784,87360
train,31,22,16896,206,29664,46560
train,32,5,3840,11,1584,5424
train,33,20,15360,170,24480,39840
train,34,35,26880,522,75168,102048
train,35,29,22272,358,51552,73824
train,36,30,23040,383,55152,78192
train,37,33,25344,464,66816,92160
train,38,34,26112,492,70848,96960
train,39,35,26880,522,75168,102048
train,40,26,19968,288,41472,61440
train,41,17,13056,123,17712,30768
train,42,12,9216,61,8784,18000
train,43,15,11520,96,13824,25344
train,44,29,22272,358,51552,73824
train,45,17,13056,123,17712,30768
train,46,21,16128,188,27072,43200
train,47,27,20736,310,44640,65376
train,48,37,28416,583,83952,112368
train,49,14,10752,84,12096,22848
train,50,13,9984,72,10368,20352
train,51,28,21504,334,48096,69600
train,52,29,22272,358,51552,73824
train,53,25,19200,266,38304,57504
train,54,16,12288,109,15696,27984
train,55,25,19200,266,38304,57504
train,56,13,9984,72,10368,20352
train,57,3,2304,4,576,2880
train,58,31,23808,409,58896,82704
train,59,26,19968,288,41472,61440
train,60,6,4608,15,2160,6768
train,61,29,22272,358,51552,73824
train,62,21,16128,188,27072,43200
train,63,16,12288,109,15696,27984
train,64,3,2304,4,576,2880
train,65,16,12288,109,15696,27984
train,66,20,15360,170,24480,39840
train,67,21,16128,188,27072,43200
train,68,20,15360,170,24480,39840
train,69,35,26880,522,75168,102048
train,70,7,5376,21,3024,8400
train,71,14,10752,84,12096,22848
train,72,22,16896,206,29664,46560
train,73,32,24576,436,62784,87360
train,74,9,6912,35,5040,11952
train,75,21,16128,188,27072,43200
train,76,15,11520,96,13824,25344
train,77,33,25344,464,66816,92160
train,78,19,14592,170,24480,39072
train,79,26,19968,288,41472,61440
train,80,14,10752,84,12096,22848
train,81,12,9216,61,8784,18000
train,82,20,15360,170,24480,39840
train,83,10,7680,43,6192,13872
train,84,31,23808,409,58896,82704
train,85,20,15360,170,24480,39840
train,86,24,18432,245,35280,53712
train,87,26,19968,288,41472,61440
train,88,32,24576,436,62784,87360
train,89,11,8448,52,7488,15936
train,90,6,4608,15,2160,6768
train,91,33,25344,464,66816,92160
train,92,16,12288,109,15696,27984
train,93,16,12288,109,15696,27984
train,94,9,6912,35,5040,11952
train,95,20,15360,170,24480,39840
train,96,32,24576,436,62784,87360
train,97,15,11520,96,13824,25344
train,98,16,12288,109,15696,27984
train,99,24,18432,266,38304,56736
train,100,18,13824,138,19872,33696
train,101,26,19968,288,41472,61440
train,102,29,22272,358,51552,73824
train,103,43,33024,787,113328,146352
train,104,18,13824,138,19872,33696
train,105,34,26112,492,70848,96960
train,106,18,13824,138,19872,33696
train,107,18,13824,138,19872,33696
train,108,19,14592,154,22176,36768
train,109,16,12288,109,15696,27984
train,110,16,12288,109,15696,27984
train,111,26,19968,288,41472,61440
train,112,31,23808,409,58896,82704
train,113,20,15360,170,24480,39840
train,114,15,11520,96,13824,25344
train,115,16,12288,109,15696,27984
train,116,5,3840,11,1584,5424
train,117,20,15360,170,24480,39840
train,118,10,7680,43,6192,13872
train,119,54,41472,1241,178704,220176
train,120,9,6912,35,5040,11952
train,121,21,16128,188,27072,43200
train,122,7,5376,21,3024,8400
train,123,26,19968,288,41472,61440
train,124,27,20736,334,48096,68832
train,125,25,19200,266,38304,57504
train,126,18,13824,138,19872,33696
train,127,29,22272,358,51552,73824
train,128,19,14592,154,22176,36768
train,129,28,21504,334,48096,69600
train,130,22,16896,206,29664,46560
train,131,32,24576,436,62784,87360
train,132,26,19968,288,41472,61440
train,133,34,26112,492,70848,96960
train,134,47,36096,940,135360,171456
train,135,35,26880,522,75168,102048
train,136,15,11520,96,13824,25344
train,137,38,29184,615,88560,117744
train,138,34,26112,492,70848,96960
train,139,14,10752,84,12096,22848
train,140,29,22272,358,51552,73824
train,141,7,5376,21,3024,8400
train,142,15,11520,96,13824,25344
train,143,13,9984,72,10368,20352
train,144,16,12288,109,15696,27984
train,145,24,18432,245,35280,53712
train,146,12,9216,72,10368,19584
train,147,21,16128,188,27072,43200
train,148,30,23040,383,55152,78192
train,149,12,9216,61,8784,18000
train,150,29,22272,358,51552,73824
train,151,12,9216,61,8784,18000
train,152,18,13824,138,19872,33696
train,153,24,18432,245,35280,53712
train,154,13,9984,72,10368,20352
train,155,11,8448,52,7488,15936
train,156,24,18432,245,35280,53712
train,157,22,16896,206,29664,46560
train,158,30,23040,383,55152,78192
train,159,7,5376,21,3024,8400
train,160,12,9216,61,8784,18000
train,161,23,17664,225,32400,50064
train,162,4,3072,7,1008,4080
train,163,7,5376,21,3024,8400
train,164,23,17664,225,32400,50064
train,165,11,8448,52,7488,15936
train,166,24,18432,245,35280,53712
train,167,7,5376,21,3024,8400
train,168,23,17664,225,32400,50064
train,169,19,14592,154,22176,36768
train,170,25,19200,266,38304,57504
train,171,30,23040,383,55152,78192
train,172,16,12288,109,15696,27984
train,173,11,8448,52,7488,15936
train,174,17,13056,123,17712,30768
train,175,32,24576,436,62784,87360
train,176,10,7680,43,6192,13872
train,177,27,20736,310,44640,65376
train,178,10,7680,43,6192,13872
train,179,31,23808,409,58896,82704
train,180,21,16128,188,27072,43200
train,181,34,26112,492,70848,96960
train,182,24,18432,245,35280,53712
train,183,16,12288,109,15696,27984
train,184,21,16128,188,27072,43200
train,185,18,13824,138,19872,33696
train,186,8,6144,27,3888,10032
train,187,20,15360,170,24480,39840
train,188,28,21504,334,48096,69600
train,189,36,27648,552,79488,107136
train,190,16,12288,109,15696,27984
train,191,10,7680,43,6192,13872
train,192,32,24576,436,62784,87360
train,193,16,12288,109,15696,27984
train,194,30,23040,383,55152,78192
train,195,23,17664,225,32400,50064
train,196,24,18432,245,35280,53712
train,197,11,8448,52,7488,15936
train,198,15,11520,96,13824,25344
train,199,15,11520,96,13824,25344
train,200,18,13824,138,19872,33696
train,201,29,22272,358,51552,73824
train,202,10,7680,43,6192,13872
train,203,14,10752,84,12096,22848
train,204,6,4608,15,2160,6768
train,205,20,15360,170,24480,39840
train,206,19,14592,154,22176,36768
train,207,33,25344,464,66816,92160
train,208,17,13056,123,17712,30768
train,209,17,13056,123,17712,30768
train,210,11,8448,52,7488,15936
train,211,31,23808,409,58896,82704
train,212,23,17664,225,32400,50064
train,213,28,21504,334,48096,69600
train,214,11,8448,52,7488,15936
train,215,25,19200,266,38304,57504
train,216,18,13824,138,19872,33696
train,217,29,22272,358,51552,73824
train,218,7,5376,21,3024,8400
train,219,25,19200,266,38304,57504
train,220,16,12288,109,15696,27984
train,221,23,17664,225,32400,50064
train,222,35,26880,522,75168,102048
train,223,25,19200,266,38304,57504
train,224,26,19968,288,41472,61440
train,225,6,4608,15,2160,6768
train,226,29,22272,358,51552,73824
train,227,29,22272,358,51552,73824
train,228,6,4608,21,3024,7632
train,229,46,35328,901,129744,165072
train,230,22,16896,206,29664,46560
train,231,12,9216,61,8784,18000
train,232,16,12288,109,15696,27984
train,233,11,8448,52,7488,15936
train,234,8,6144,27,3888,10032
train,235,16,12288,109,15696,27984
train,236,15,11520,96,13824,25344
train,237,21,16128,188,27072,43200
train,238,16,12288,109,15696,27984
train,239,6,4608,15,2160,6768
train,240,29,22272,358,51552,73824
train,241,14,10752,84,12096,22848
train,242,12,9216,61,8784,18000
train,243,12,9216,61,8784,18000
train,244,6,4608,15,2160,6768
train,245,24,18432,245,35280,53712
train,246,30,23040,383,55152,78192
train,247,27,20736,310,44640,65376
train,248,10,7680,43,6192,13872
train,249,24,18432,245,35280,53712
train,250,33,25344,464,66816,92160
train,251,7,5376,21,3024,8400
train,252,23,17664,225,32400,50064
train,253,16,12288,109,15696,27984
train,254,28,21504,334,48096,69600
train,255,5,3840,11,1584,5424
train,256,22,16896,206,29664,46560
train,257,11,8448,52,7488,15936
train,258,29,22272,358,51552,73824
train,259,14,10752,84,12096,22848
train,260,22,16896,206,29664,46560
train,261,24,18432,245,35280,53712
train,262,37,28416,583,83952,112368
train,263,34,26112,492,70848,96960
train,264,7,5376,21,3024,8400
train,265,21,16128,188,27072,43200
train,266,16,12288,109,15696,27984
train,267,27,20736,310,44640,65376
train,268,18,13824,138,19872,33696
train,269,36,27648,552,79488,107136
train,270,29,22272,358,51552,73824
train,271,12,9216,61,8784,18000
train,272,17,13056,123,17712,30768
train,273,27,20736,310,44640,65376
train,274,27,20736,310,44640,65376
train,275,29,22272,358,51552,73824
train,276,32,24576,436,62784,87360
train,277,19,14592,154,22176,36768
train,278,28,21504,334,48096,69600
train,279,4,3072,7,1008,4080
train,280,10,7680,43,6192,13872
train,281,21,16128,188,27072,43200
train,282,16,12288,109,15696,27984
train,283,17,13056,123,17712,30768
train,284,18,13824,138,19872,33696
train,285,26,19968,288,41472,61440
train,286,8,6144,27,3888,10032
train,287,38,29184,615,88560,117744
train,288,16,12288,109,15696,27984
train,289,24,18432,245,35280,53712
train,290,12,9216,61,8784,18000
train,291,37,28416,583,83952,112368
train,292,25,19200,266,38304,57504
train,293,43,33024,787,113328,146352
train,294,17,13056,123,17712,30768
train,295,8,6144,27,3888,10032
train,296,38,29184,615,88560,117744
train,297,25,19200,266,38304,57504
train,298,17,13056,123,17712,30768
train,299,7,5376,21,3024,8400
train,300,25,19200,266,38304,57504
train,301,19,14592,154,22176,36768
train,302,21,16128,188,27072,43200
train,303,19,14592,154,22176,36768
train,304,9,6912,35,5040,11952
train,305,5,3840,11,1584,5424
train,306,7,5376,21,3024,8400
train,307,19,14592,154,22176,36768
train,308,18,13824,138,19872,33696
train,309,20,15360,170,24480,39840
train,310,12,9216,61,8784,18000
train,311,26,19968,288,41472,61440
train,312,31,23808,436,62784,86592
train,313,37,28416,583,83952,112368
train,314,10,7680,43,6192,13872
train,315,34,26112,492,70848,96960
train,316,21,16128,188,27072,43200
train,317,22,16896,206,29664,46560
train,318,7,5376,21,3024,8400
train,319,31,23808,409,58896,82704
train,320,25,19200,266,38304,57504
train,321,25,19200,266,38304,57504
train,322,15,11520,96,13824,25344
train,323,18,13824,138,19872,33696
train,324,27,20736,310,44640,65376
train,325,19,14592,154,22176,36768
train,326,23,17664,225,32400,50064
train,327,20,15360,170,24480,39840
train,328,33,25344,464,66816,92160
train,329,11,8448,52,7488,15936
train,330,32,24576,436,62784,87360
train,331,16,12288,109,15696,27984
train,332,22,16896,206,29664,46560
train,333,24,18432,245,35280,53712
train,334,38,29184,615,88560,117744
train,335,38,29184,615,88560,117744
train,336,18,13824,138,19872,33696
train,337,10,7680,43,6192,13872
train,338,28,21504,334,48096,69600
train,339,6,4608,15,2160,6768
train,340,16,12288,109,15696,27984
train,341,41,31488,716,103104,134592
train,342,8,6144,27,3888,10032
train,343,5,3840,11,1584,5424
train,344,5,3840,11,1584,5424
train,345,24,18432,245,35280,53712
train,346,26,19968,288,41472,61440
train,347,14,10752,84,12096,22848
train,348,9,6912,35,5040,11952
train,349,9,6912,35,5040,11952
train,350,29,22272,358,51552,73824
train,351,17,13056,123,17712,30768
train,352,40,30720,681,98064,128784
train,353,11,8448,52,7488,15936
train,354,25,19200,266,38304,57504
train,355,20,15360,170,24480,39840
train,356,20,15360,170,24480,39840
train,357,23,17664,225,32400,50064
train,358,28,21504,334,48096,69600
train,359,16,12288,109,15696,27984
train,360,12,9216,61,8784,18000
train,361,22,16896,206,29664,46560
train,362,17,13056,123,17712,30768
train,363,21,16128,188,27072,43200
train,364,15,11520,96,13824,25344
train,365,21,16128,188,27072,43200
train,366,29,22272,358,51552,73824
train,367,19,14592,154,22176,36768
train,368,30,23040,383,55152,78192
train,369,45,34560,862,124128,158688
train,370,40,30720,681,98064,128784
train,371,11,8448,52,7488,15936
train,372,28,21504,334,48096,69600
train,373,10,7680,43,6192,13872
train,374,12,9216,61,8784,18000
train,375,19,14592,154,22176,36768
train,376,17,13056,138,19872,32928
train,377,14,10752,84,12096,22848
train,378,13,9984,72,10368,20352
train,379,31,23808,409,58896,82704
train,380,19,14592,154,22176,36768
train,381,8,6144,27,3888,10032
train,382,11,8448,52,7488,15936
train,383,9,6912,35,5040,11952
train,384,12,9216,61,8784,18000
train,385,8,6144,27,3888,10032
train,386,13,9984,72,10368,20352
train,387,8,6144,27,3888,10032
train,388,22,16896,206,29664,46560
train,389,28,21504,334,48096,69600
train,390,21,16128,188,27072,43200
train,391,5,3840,11,1584,5424
train,392,19,14592,154,22176,36768
train,393,23,17664,225,32400,50064
train,394,11,8448,52,7488,15936
train,395,21,16128,188,27072,43200
train,396,36,27648,552,79488,107136
train,397,13,9984,72,10368,20352
train,398,13,9984,72,10368,20352
train,399,30,23040,383,55152,78192
train,400,5,3840,15,2160,6000
train,401,35,26880,522,75168,102048
train,402,22,16896,206,29664,46560
train,403,36,27648,552,79488,107136
train,404,45,34560,862,124128,158688
train,405,30,23040,383,55152,78192
train,406,23,17664,225,32400,50064
train,407,11,8448,52,7488,15936
train,408,27,20736,310,44640,65376
train,409,14,10752,84,12096,22848
train,410,18,13824,138,19872,33696
train,411,9,6912,35,5040,11952
train,412,19,14592,154,22176,36768
train,413,25,19200,266,38304,57504
train,414,33,25344,464,66816,92160
train,415,9,6912,35,5040,11952
train,416,25,19200,266,38304,57504
train,417,15,11520,96,13824,25344
train,418,29,22272,358,51552,73824
train,419,16,12288,109,15696,27984
train,420,18,13824,138,19872,33696
train,421,27,20736,310,44640,65376
train,422,10,7680,43,6192,13872
train,423,14,10752,84,12096,22848
train,424,29,22272,358,51552,73824
train,425,11,8448,52,7488,15936
train,426,20,15360,170,24480,39840
train,427,20,15360,170,24480,39840
train,428,23,17664,225,32400,50064
train,429,25,19200,266,38304,57504
train,430,17,13056,123,17712,30768
train,431,25,19200,266,38304,57504
train,432,21,16128,188,27072,43200
train,433,18,13824,138,19872,33696
train,434,22,16896,225,32400,49296
train,435,19,14592,154,22176,36768
train,436,29,22272,358,51552,73824
train,437,18,13824,138,19872,33696
train,438,13,9984,72,10368,20352
train,439,11,8448,52,7488,15936
train,440,12,9216,61,8784,18000
train,441,32,24576,436,62784,87360
train,442,34,26112,492,70848,96960
train,443,9,6912,43,6192,13104
train,444,11,8448,52,7488,15936
train,445,34,26112,492,70848,96960
train,446,15,11520,96,13824,25344
train,447,34,26112,492,70848,96960
train,448,21,16128,188,27072,43200
train,449,30,23040,383,55152,78192
train,450,28,21504,334,48096,69600
train,451,21,16128,188,27072,43200
train,452,7,5376,21,3024,8400
train,453,14,10752,84,12096,22848
train,454,8,6144,27,3888,10032
train,455,12,9216,61,8784,18000
train,456,37,28416,583,83952,112368
train,457,28,21504,334,48096,69600
train,458,5,3840,11,1584,5424
train,459,25,19200,266,38304,57504
train,460,10,7680,43,6192,13872
train,461,31,23808,409,58896,82704
train,462,31,23808,409,58896,82704
train,463,22,16896,206,29664,46560
train,464,16,12288,109,15696,27984
train,465,31,23808,409,58896,82704
train,466,23,17664,225,32400,50064
train,467,27,20736,310,44640,65376
train,468,27,20736,310,44640,65376
train,469,14,10752,84,12096,22848
train,470,20,15360,170,24480,39840
train,471,24,18432,245,35280,53712
train,472,26,19968,288,41472,61440
train,473,16,12288,109,15696,27984
train,474,31,23808,409,58896,82704
train,475,26,19968,288,41472,61440
train,476,31,23808,409,58896,82704
train,477,42,32256,751,108144,140400
train,478,15,11520,96,13824,25344
train,479,22,16896,206,29664,46560
train,480,27,20736,310,44640,65376
train,481,32,24576,436,62784,87360
train,482,5,3840,11,1584,5424
train,483,9,6912,35,5040,11952
train,484,41,31488,716,103104,134592
train,485,16,12288,109,15696,27984
train,486,23,17664,225,32400,50064
train,487,13,9984,72,10368,20352
train,488,28,21504,334,48096,69600
train,489,34,26112,492,70848,96960
train,490,14,10752,84,12096,22848
train,491,29,22272,358,51552,73824
train,492,9,6912,35,5040,11952
train,493,23,17664,225,32400,50064
train,494,7,5376,21,3024,8400
train,495,17,13056,123,17712,30768
train,496,16,12288,109,15696,27984
train,497,18,13824,138,19872,33696
train,498,33,25344,464,66816,92160
train,499,15,11520,96,13824,25344
train,500,25,19200,266,38304,57504
train,501,8,6144,27,3888,10032
train,502,26,19968,288,41472,61440
train,503,43,33024,787,113328,146352
train,504,35,26880,522,75168,102048
train,505,21,16128,188,27072,43200
train,506,20,15360,170,24480,39840
train,507,30,23040,383,55152,78192
train,508,29,22272,358,51552,73824
train,509,29,22272,358,51552,73824
train,510,31,23808,409,58896,82704
train,511,18,13824,138,19872,33696
train,512,11,8448,52,7488,15936
train,513,18,13824,138,19872,33696
train,514,16,12288,109,15696,27984
train,515,14,10752,84,12096,22848
train,516,31,23808,409,58896,82704
train,517,20,15360,170,24480,39840
train,518,15,11520,96,13824,25344
train,519,14,10752,84,12096,22848
train,520,31,23808,436,62784,86592
train,521,17,13056,123,17712,30768
train,522,7,5376,21,3024,8400
train,523,10,7680,43,6192,13872
train,524,16,12288,109,15696,27984
train,525,9,6912,35,5040,11952
train,526,29,22272,358,51552,73824
train,527,29,22272,358,51552,73824
train,528,15,11520,96,13824,25344
train,529,21,16128,188,27072,43200
train,530,19,14592,154,22176,36768
train,531,23,17664,225,32400,50064
train,532,16,12288,109,15696,27984
train,533,23,17664,225,32400,50064
train,534,27,20736,310,44640,65376
train,535,20,15360,170,24480,39840
train,536,49,37632,1022,147168,184800
train,537,21,16128,188,27072,43200
train,538,9,6912,35,5040,11952
train,539,22,16896,206,29664,46560
train,540,15,11520,96,13824,25344
train,541,25,19200,266,38304,57504
train,542,5,3840,11,1584,5424
train,543,16,12288,109,15696,27984
train,544,32,24576,436,62784,87360
train,545,39,29952,648,93312,123264
train,546,24,18432,245,35280,53712
train,547,25,19200,288,41472,60672
train,548,21,16128,188,27072,43200
train,549,11,8448,52,7488,15936
train,550,14,10752,84,12096,22848
train,551,34,26112,492,70848,96960
train,552,14,10752,84,12096,22848
train,553,22,16896,206,29664,46560
train,554,22,16896,206,29664,46560
train,555,6,4608,15,2160,6768
train,556,24,18432,245,35280,53712
train,557,14,10752,84,12096,22848
train,558,29,22272,358,51552,73824
train,559,32,24576,436,62784,87360
train,560,14,10752,84,12096,22848
train,561,18,13824,138,19872,33696
train,562,8,6144,27,3888,10032
train,563,17,13056,123,17712,30768
train,564,33,25344,464,66816,92160
train,565,35,26880,522,75168,102048
train,566,39,29952,648,93312,123264
train,567,24,18432,245,35280,53712
train,568,10,7680,43,6192,13872
train,569,11,8448,52,7488,15936
train,570,9,6912,35,5040,11952
train,571,20,15360,170,24480,39840
train,572,21,16128,188,27072,43200
train,573,35,26880,522,75168,102048
train,574,10,7680,43,6192,13872
train,575,33,25344,464,66816,92160
train,576,26,19968,288,41472,61440
train,577,29,22272,358,51552,73824
train,578,19,14592,154,22176,36768
train,579,16,12288,109,15696,27984
train,580,16,12288,109,15696,27984
train,581,23,17664,225,32400,50064
train,582,22,16896,206,29664,46560
train,583,14,10752,84,12096,22848
train,584,25,19200,266,38304,57504
train,585,26,19968,288,41472,61440
train,586,17,13056,123,17712,30768
train,587,19,14592,154,22176,36768
train,588,22,16896,206,29664,46560
train,589,47,36096,940,135360,171456
train,590,23,17664,225,32400,50064
train,591,25,19200,266,38304,57504
train,592,25,19200,266,38304,57504
train,593,17,13056,123,17712,30768
train,594,31,23808,409,58896,82704
train,595,35,26880,522,75168,102048
train,596,14,10752,84,12096,22848
train,597,7,5376,21,3024,8400
train,598,30,23040,383,55152,78192
train,599,22,16896,206,29664,46560
train,600,20,15360,170,24480,39840
train,601,24,18432,245,35280,53712
train,602,7,5376,21,3024,8400
train,603,19,14592,154,22176,36768
train,604,7,5376,21,3024,8400
train,605,18,13824,138,19872,33696
train,606,11,8448,52,7488,15936
train,607,20,15360,170,24480,39840
train,608,19,14592,154,22176,36768
train,609,17,13056,123,17712,30768
train,610,13,9984,72,10368,20352
train,611,26,19968,288,41472,61440
train,612,9,6912,35,5040,11952
train,613,29,22272,358,51552,73824
train,614,11,8448,52,7488,15936
train,615,35,26880,522,75168,102048
train,616,26,19968,288,41472,61440
train,617,9,6912,35,5040,11952
train,618,34,26112,492,70848,96960
train,619,12,9216,61,8784,18000
train,620,34,26112,492,70848,96960
train,621,3,2304,4,576,2880
train,622,39,29952,648,93312,123264
train,623,11,8448,52,7488,15936
train,624,20,15360,170,24480,39840
train,625,16,12288,109,15696,27984
train,626,29,22272,358,51552,73824
train,627,28,21504,358,51552,73056
train,628,34,26112,492,70848,96960
train,629,7,5376,27,3888,9264
train,630,4,3072,7,1008,4080
train,631,36,27648,552,79488,107136
train,632,20,15360,170,24480,39840
train,633,22,16896,206,29664,46560
train,634,22,16896,206,29664,46560
train,635,7,5376,21,3024,8400
train,636,20,15360,170,24480,39840
train,637,17,13056,123,17712,30768
train,638,23,17664,225,32400,50064
train,639,20,15360,170,24480,39840
train,640,24,18432,245,35280,53712
train,641,37,28416,583,83952,112368
train,642,34,26112,492,70848,96960
train,643,46,35328,901,129744,165072
train,644,28,21504,334,48096,69600
train,645,28,21504,334,48096,69600
train,646,17,13056,123,17712,30768
train,647,15,11520,96,13824,25344
train,648,20,15360,170,24480,39840
train,649,19,14592,154,22176,36768
train,650,15,11520,96,13824,25344
train,651,35,26880,522,75168,102048
train,652,9,6912,35,5040,11952
train,653,19,14592,154,22176,36768
train,654,13,9984,72,10368,20352
train,655,27,20736,310,44640,65376
train,656,13,9984,72,10368,20352
train,657,21,16128,188,27072,43200
train,658,27,20736,310,44640,65376
train,659,4,3072,7,1008,4080
train,660,26,19968,288,41472,61440
train,661,17,13056,123,17712,30768
train,662,22,16896,206,29664,46560
train,663,2,1536,2,288,1824
train,664,12,9216,61,8784,18000
train,665,11,8448,52,7488,15936
train,666,15,11520,96,13824,25344
train,667,20,15360,170,24480,39840
train,668,8,6144,27,3888,10032
train,669,12,9216,61,8784,18000
train,670,30,23040,383,55152,78192
train,671,15,11520,96,13824,25344
train,672,17,13056,123,17712,30768
train,673,8,6144,27,3888,10032
train,674,15,11520,96,13824,25344
train,675,17,13056,123,17712,30768
train,676,37,28416,583,83952,112368
train,677,22,16896,206,29664,46560
train,678,16,12288,109,15696,27984
train,679,6,4608,15,2160,6768
train,680,10,7680,43,6192,13872
train,681,12,9216,61,8784,18000
train,682,7,5376,21,3024,8400
train,683,16,12288,109,15696,27984
train,684,14,10752,84,12096,22848
train,685,8,6144,27,3888,10032
train,686,7,5376,21,3024,8400
train,687,15,11520,96,13824,25344
train,688,13,9984,72,10368,20352
train,689,18,13824,138,19872,33696
train,690,11,8448,52,7488,15936
train,691,5,3840,11,1584,5424
train,692,12,9216,61,8784,18000
train,693,25,19200,266,38304,57504
train,694,8,6144,27,3888,10032
train,695,52,39936,1151,165744,205680
train,696,28,21504,334,48096,69600
train,697,27,20736,310,44640,65376
train,698,13,9984,72,10368,20352
train,699,14,10752,84,12096,22848
train,700,35,26880,522,75168,102048
train,701,13,9984,72,10368,20352
train,702,12,9216,61,8784,18000
train,703,16,12288,109,15696,27984
train,704,24,18432,245,35280,53712
train,705,23,17664,225,32400,50064
train,706,12,9216,61,8784,18000
train,707,32,24576,436,62784,87360
train,708,22,16896,206,29664,46560
train,709,16,12288,109,15696,27984
train,710,30,23040,383,55152,78192
train,711,22,16896,206,29664,46560
train,712,14,10752,84,12096,22848
train,713,21,16128,188,27072,43200
train,714,42,32256,751,108144,140400
train,715,22,16896,206,29664,46560
train,716,28,21504,334,48096,69600
train,717,19,14592,154,22176,36768
train,718,32,24576,464,66816,91392
train,719,27,20736,310,44640,65376
train,720,15,11520,96,13824,25344
train,721,32,24576,436,62784,87360
train,722,12,9216,61,8784,18000
train,723,32,24576,436,62784,87360
train,724,20,15360,170,24480,39840
train,725,16,12288,109,15696,27984
train,726,23,17664,225,32400,50064
train,727,6,4608,15,2160,6768
train,728,26,19968,288,41472,61440
train,729,28,21504,334,48096,69600
train,730,22,16896,206,29664,46560
train,731,18,13824,138,19872,33696
train,732,33,25344,464,66816,92160
train,733,29,22272,358,51552,73824
train,734,29,22272,358,51552,73824
train,735,36,27648,552,79488,107136
train,736,30,23040,383,55152,78192
train,737,4,3072,7,1008,4080
train,738,16,12288,109,15696,27984
train,739,11,8448,52,7488,15936
train,740,26,19968,288,41472,61440
train,741,12,9216,61,8784,18000
train,742,13,9984,72,10368,20352
train,743,14,10752,84,12096,22848
train,744,4,3072,7,1008,4080
train,745,12,9216,61,8784,18000
train,746,25,19200,266,38304,57504
train,747,31,23808,409,58896,82704
train,748,17,13056,123,17712,30768
train,749,16,12288,109,15696,27984
train,750,25,19200,266,38304,57504
train,751,23,17664,225,32400,50064
train,752,11,8448,52,7488,15936
train,753,23,17664,225,32400,50064
train,754,16,12288,109,15696,27984
train,755,24,18432,245,35280,53712
train,756,22,16896,206,29664,46560
train,757,18,13824,138,19872,33696
train,758,10,7680,43,6192,13872
train,759,25,19200,266,38304,57504
train,760,5,3840,11,1584,5424
train,761,26,19968,288,41472,61440
train,762,17,13056,123,17712,30768
train,763,31,23808,436,62784,86592
train,764,25,19200,266,38304,57504
train,765,24,18432,245,35280,53712
train,766,16,12288,109,15696,27984
train,767,14,10752,84,12096,22848
train,768,33,25344,464,66816,92160
train,769,22,16896,206,29664,46560
train,770,21,16128,188,27072,43200
train,771,12,9216,61,8784,18000
train,772,24,18432,245,35280,53712
train,773,25,19200,266,38304,57504
train,774,30,23040,383,55152,78192
train,775,21,16128,188,27072,43200
train,776,37,28416,583,83952,112368
train,777,30,23040,383,55152,78192
train,778,35,26880,522,75168,102048
train,779,36,27648,552,79488,107136
train,780,32,24576,436,62784,87360
train,781,32,24576,436,62784,87360
train,782,30,23040,383,55152,78192
train,783,24,18432,245,35280,53712
train,784,11,8448,52,7488,15936
train,785,10,7680,43,6192,13872
train,786,14,10752,84,12096,22848
train,787,29,22272,358,51552,73824
train,788,44,33792,824,118656,152448
train,789,8,6144,27,3888,10032
train,790,22,16896,206,29664,46560
train,791,11,8448,52,7488,15936
train,792,9,6912,35,5040,11952
train,793,24,18432,245,35280,53712
train,794,10,7680,43,6192,13872
train,795,36,27648,552,79488,107136
train,796,36,27648,552,79488,107136
train,797,8,6144,27,3888,10032
train,798,12,9216,61,8784,18000
train,799,18,13824,138,19872,33696
train,800,32,24576,436,62784,87360
train,801,16,12288,109,15696,27984
train,802,9,6912,35,5040,11952
train,803,24,18432,245,35280,53712
train,804,14,10752,84,12096,22848
train,805,23,17664,225,32400,50064
train,806,36,27648,552,79488,107136
train,807,27,20736,310,44640,65376
train,808,30,23040,383,55152,78192
train,809,5,3840,11,1584,5424
train,810,15,11520,96,13824,25344
train,811,5,3840,15,2160,6000
train,812,25,19200,266,38304,57504
train,813,31,23808,409,58896,82704
train,814,37,28416,615,88560,116976
train,815,37,28416,583,83952,112368
train,816,19,14592,154,22176,36768
train,817,34,26112,492,70848,96960
train,818,28,21504,334,48096,69600
train,819,18,13824,138,19872,33696
train,820,17,13056,123,17712,30768
train,821,20,15360,170,24480,39840
train,822,19,14592,154,22176,36768
train,823,15,11520,96,13824,25344
train,824,26,19968,288,41472,61440
train,825,27,20736,310,44640,65376
train,826,8,6144,27,3888,10032
train,827,37,28416,583,83952,112368
train,828,15,11520,96,13824,25344
train,829,27,20736,310,44640,65376
train,830,37,28416,583,83952,112368
train,831,24,18432,245,35280,53712
train,832,36,27648,552,79488,107136
train,833,11,8448,52,7488,15936
train,834,27,20736,310,44640,65376
train,835,21,16128,188,27072,43200
train,836,34,26112,492,70848,96960
train,837,18,13824,138,19872,33696
train,838,18,13824,138,19872,33696
train,839,25,19200,266,38304,57504
train,840,36,27648,552,79488,107136
train,841,26,19968,288,41472,61440
train,842,10,7680,43,6192,13872
train,843,11,8448,52,7488,15936
train,844,34,26112,492,70848,96960
train,845,7,5376,21,3024,8400
train,846,41,31488,716,103104,134592
train,847,26,19968,288,41472,61440
train,848,15,11520,96,13824,25344
train,849,12,9216,72,10368,19584
train,850,17,13056,123,17712,30768
train,851,8,6144,27,3888,10032
train,852,33,25344,464,66816,92160
train,853,14,10752,84,12096,22848
train,854,21,16128,188,27072,43200
train,855,14,10752,84,12096,22848
train,856,21,16128,188,27072,43200
train,857,40,30720,716,103104,133824
train,858,32,24576,436,62784,87360
train,859,32,24576,436,62784,87360
train,860,6,4608,15,2160,6768
train,861,33,25344,464,66816,92160
train,862,19,14592,154,22176,36768
train,863,9,6912,35,5040,11952
train,864,36,27648,552,79488,107136
train,865,18,13824,138,19872,33696
train,866,30,23040,383,55152,78192
train,867,14,10752,84,12096,22848
train,868,16,12288,109,15696,27984
train,869,31,23808,409,58896,82704
train,870,17,13056,123,17712,30768
train,871,21,16128,188,27072,43200
train,872,24,18432,245,35280,53712
train,873,17,13056,123,17712,30768
train,874,19,14592,154,22176,36768
train,875,39,29952,648,93312,123264
train,876,10,7680,43,6192,13872
train,877,28,21504,334,48096,69600
train,878,22,16896,206,29664,46560
train,879,21,16128,188,27072,43200
train,880,12,9216,61,8784,18000
train,881,11,8448,52,7488,15936
train,882,22,16896,206,29664,46560
train,883,13,9984,72,10368,20352
train,884,7,5376,21,3024,8400
train,885,8,6144,27,3888,10032
train,886,17,13056,123,17712,30768
train,887,17,13056,123,17712,30768
train,888,14,10752,84,12096,22848
train,889,19,14592,154,22176,36768
train,890,25,19200,266,38304,57504
train,891,7,5376,21,3024,8400
train,892,23,17664,225,32400,50064
train,893,20,15360,170,24480,39840
train,894,12,9216,61,8784,18000
train,895,29,22272,358,51552,73824
train,896,29,22272,358,51552,73824
train,897,19,14592,154,22176,36768
train,898,24,18432,245,35280,53712
train,899,16,12288,109,15696,27984
train,900,19,14592,170,24480,39072
train,901,17,13056,123,17712,30768
train,902,17,13056,123,17712,30768
train,903,19,14592,154,22176,36768
train,904,22,16896,206,29664,46560
train,905,9,6912,35,5040,11952
train,906,42,32256,751,108144,140400
train,907,27,20736,310,44640,65376
train,908,24,18432,245,35280,53712
train,909,9,6912,35,5040,11952
train,910,8,6144,27,3888,10032
train,911,23,17664,225,32400,50064
train,912,15,11520,96,13824,25344
train,913,31,23808,409,58896,82704
train,914,7,5376,21,3024,8400
train,915,16,12288,109,15696,27984
train,916,22,16896,206,29664,46560
train,917,25,19200,266,38304,57504
train,918,12,9216,61,8784,18000
train,919,36,27648,552,79488,107136
train,920,12,9216,61,8784,18000
train,921,27,20736,310,44640,65376
train,922,25,19200,266,38304,57504
train,923,10,7680,43,6192,13872
train,924,23,17664,225,32400,50064
train,925,14,10752,84,12096,22848
train,926,17,13056,123,17712,30768
train,927,22,16896,206,29664,46560
train,928,9,6912,35,5040,11952
train,929,28,21504,334,48096,69600
train,930,8,6144,27,3888,10032
train,931,27,20736,310,44640,65376
train,932,9,6912,35,5040,11952
train,933,31,23808,409,58896,82704
train,934,15,11520,96,13824,25344
train,935,27,20736,310,44640,65376
train,936,13,9984,72,10368,20352
train,937,20,15360,170,24480,39840
train,938,21,16128,188,27072,43200
train,939,8,6144,27,3888,10032
train,940,25,19200,266,38304,57504
train,941,26,19968,288,41472,61440
train,942,5,3840,11,1584,5424
train,943,9,6912,35,5040,11952
train,944,19,14592,154,22176,36768
train,945,5,3840,15,2160,6000
train,946,19,14592,154,22176,36768
train,947,19,14592,154,22176,36768
train,948,23,17664,225,32400,50064
train,949,22,16896,206,29664,46560
train,950,18,13824,138,19872,33696
train,951,7,5376,27,3888,9264
train,952,24,18432,245,35280,53712
train,953,10,7680,43,6192,13872
train,954,16,12288,109,15696,27984
train,955,38,29184,615,88560,117744
train,956,8,6144,27,3888,10032
train,957,6,4608,15,2160,6768
train,958,19,14592,154,22176,36768
train,959,24,18432,245,35280,53712
train,960,32,24576,436,62784,87360
train,961,9,6912,35,5040,11952
train,962,28,21504,334,48096,69600
train,963,10,7680,43,6192,13872
train,964,35,26880,522,75168,102048
train,965,8,6144,27,3888,10032
train,966,24,18432,245,35280,53712
train,967,22,16896,206,29664,46560
train,968,29,22272,358,51552,73824
train,969,9,6912,35,5040,11952
train,970,41,31488,716,103104,134592
train,971,19,14592,154,22176,36768
train,972,42,32256,751,108144,140400
train,973,29,22272,358,51552,73824
train,974,29,22272,358,51552,73824
train,975,40,30720,681,98064,128784
train,976,21,16128,188,27072,43200
train,977,13,9984,72,10368,20352
train,978,10,7680,43,6192,13872
train,979,29,22272,358,51552,73824
train,980,15,11520,96,13824,25344
train,981,11,8448,52,7488,15936
train,982,31,23808,409,58896,82704
train,983,3,2304,4,576,2880
train,984,22,16896,206,29664,46560
train,985,26,19968,288,41472,61440
train,986,34,26112,492,70848,96960
train,987,36,27648,552,79488,107136
train,988,26,19968,288,41472,61440
train,989,19,14592,154,22176,36768
train,990,20,15360,170,24480,39840
train,991,22,16896,206,29664,46560
train,992,41,31488,716,103104,134592
train,993,4,3072,7,1008,4080
train,994,14,10752,84,12096,22848
train,995,29,22272,383,55152,77424
train,996,14,10752,84,12096,22848
train,997,26,19968,288,41472,61440
train,998,30,23040,383,55152,78192
train,999,26,19968,288,41472,61440
train,1000,31,23808,409,58896,82704
train,1001,17,13056,123,17712,30768
train,1002,16,12288,109,15696,27984
train,1003,37,28416,583,83952,112368
train,1004,29,22272,358,51552,73824
train,1005,12,9216,61,8784,18000
train,1006,32,24576,436,62784,87360
train,1007,24,18432,245,35280,53712
train,1008,26,19968,288,41472,61440
train,1009,31,23808,409,58896,82704
train,1010,22,16896,206,29664,46560
train,1011,26,19968,288,41472,61440
train,1012,9,6912,35,5040,11952
train,1013,17,13056,123,17712,30768
train,1014,31,23808,409,58896,82704
train,1015,16,12288,109,15696,27984
train,1016,33,25344,464,66816,92160
train,1017,26,19968,288,41472,61440
train,1018,34,26112,492,70848,96960
train,1019,19,14592,154,22176,36768
train,1020,29,22272,358,51552,73824
train,1021,12,9216,61,8784,18000
train,1022,9,6912,35,5040,11952
train,1023,18,13824,138,19872,33696
train,1024,16,12288,109,15696,27984
train,1025,21,16128,188,27072,43200
train,1026,26,19968,288,41472,61440
train,1027,32,24576,436,62784,87360
train,1028,4,3072,7,1008,4080
train,1029,24,18432,245,35280,53712
train,1030,13,9984,72,10368,20352
train,1031,26,19968,288,41472,61440
train,1032,27,20736,310,44640,65376
train,1033,23,17664,225,32400,50064
train,1034,10,7680,43,6192,13872
train,1035,32,24576,436,62784,87360
train,1036,19,14592,154,22176,36768
train,1037,26,19968,288,41472,61440
train,1038,24,18432,245,35280,53712
train,1039,22,16896,206,29664,46560
train,1040,24,18432,245,35280,53712
train,1041,33,25344,464,66816,92160
train,1042,26,19968,288,41472,61440
train,1043,22,16896,206,29664,46560
train,1044,17,13056,123,17712,30768
train,1045,13,9984,72,10368,20352
train,1046,21,16128,188,27072,43200
train,1047,12,9216,61,8784,18000
train,1048,11,8448,52,7488,15936
train,1049,22,16896,206,29664,46560
train,1050,33,25344,464,66816,92160
train,1051,22,16896,206,29664,46560
train,1052,14,10752,84,12096,22848
train,1053,27,20736,310,44640,65376
train,1054,17,13056,123,17712,30768
train,1055,17,13056,123,17712,30768
train,1056,17,13056,123,17712,30768
train,1057,17,13056,123,17712,30768
train,1058,12,9216,61,8784,18000
train,1059,8,6144,27,3888,10032
train,1060,23,17664,225,32400,50064
train,1061,14,10752,84,12096,22848
train,1062,27,20736,310,44640,65376
train,1063,21,16128,188,27072,43200
train,1064,31,23808,409,58896,82704
train,1065,18,13824,138,19872,33696
train,1066,18,13824,138,19872,33696
train,1067,34,26112,492,70848,96960
train,1068,18,13824,138,19872,33696
train,1069,24,18432,245,35280,53712
train,1070,2,1536,2,288,1824
train,1071,23,17664,225,32400,50064
train,1072,22,16896,206,29664,46560
train,1073,29,22272,358,51552,73824
train,1074,11,8448,52,7488,15936
train,1075,33,25344,464,66816,92160
train,1076,28,21504,334,48096,69600
train,1077,12,9216,61,8784,18000
train,1078,9,6912,35,5040,11952
train,1079,36,27648,552,79488,107136
train,1080,14,10752,84,12096,22848
train,1081,18,13824,138,19872,33696
train,1082,10,7680,43,6192,13872
train,1083,7,5376,21,3024,8400
train,1084,14,10752,84,12096,22848
train,1085,23,17664,245,35280,52944
train,1086,15,11520,96,13824,25344
train,1087,20,15360,170,24480,39840
train,1088,10,7680,43,6192,13872
train,1089,24,18432,245,35280,53712
train,1090,31,23808,409,58896,82704
train,1091,33,25344,464,66816,92160
train,1092,24,18432,245,35280,53712
train,1093,12,9216,61,8784,18000
train,1094,16,12288,109,15696,27984
train,1095,18,13824,138,19872,33696
train,1096,39,29952,648,93312,123264
train,1097,26,19968,288,41472,61440
train,1098,26,19968,288,41472,61440
train,1099,30,23040,383,55152,78192
train,1100,18,13824,138,19872,33696
train,1101,23,17664,225,32400,50064
train,1102,28,21504,334,48096,69600
train,1103,12,9216,61,8784,18000
train,1104,26,19968,288,41472,61440
train,1105,27,20736,310,44640,65376
train,1106,17,13056,123,17712,30768
train,1107,4,3072,7,1008,4080
train,1108,20,15360,170,24480,39840
train,1109,9,6912,35,5040,11952
train,1110,8,6144,27,3888,10032
train,1111,40,30720,681,98064,128784
train,1112,19,14592,154,22176,36768
train,1113,14,10752,84,12096,22848
train,1114,42,32256,751,108144,140400
train,1115,36,27648,552,79488,107136
train,1116,8,6144,27,3888,10032
train,1117,29,22272,358,51552,73824
train,1118,37,28416,583,83952,112368
train,1119,11,8448,52,7488,15936
train,1120,18,13824,138,19872,33696
train,1121,22,16896,206,29664,46560
train,1122,21,16128,188,27072,43200
train,1123,11,8448,52,7488,15936
train,1124,14,10752,84,12096,22848
train,1125,20,15360,170,24480,39840
train,1126,17,13056,123,17712,30768
train,1127,32,24576,464,66816,91392
train,1128,23,17664,225,32400,50064
train,1129,19,14592,154,22176,36768
train,1130,11,8448,52,7488,15936
train,1131,40,30720,681,98064,128784
train,1132,11,8448,52,7488,15936
train,1133,35,26880,522,75168,102048
train,1134,31,23808,409,58896,82704
train,1135,25,19200,266,38304,57504
train,1136,31,23808,409,58896,82704
train,1137,23,17664,225,32400,50064
train,1138,23,17664,225,32400,50064
train,1139,30,23040,383,55152,78192
train,1140,14,10752,84,12096,22848
train,1141,7,5376,21,3024,8400
train,1142,12,9216,61,8784,18000
train,1143,6,4608,15,2160,6768
train,1144,8,6144,27,3888,10032
train,1145,16,12288,109,15696,27984
train,1146,35,26880,522,75168,102048
train,1147,15,11520,96,13824,25344
train,1148,4,3072,7,1008,4080
train,1149,30,23040,383,55152,78192
train,1150,6,4608,15,2160,6768
train,1151,15,11520,96,13824,25344
train,1152,10,7680,43,6192,13872
train,1153,17,13056,123,17712,30768
train,1154,20,15360,170,24480,39840
train,1155,20,15360,170,24480,39840
train,1156,40,30720,681,98064,128784
train,1157,8,6144,27,3888,10032
train,1158,34,26112,492,70848,96960
train,1159,20,15360,170,24480,39840
train,1160,13,9984,72,10368,20352
train,1161,24,18432,245,35280,53712
train,1162,35,26880,522,75168,102048
train,1163,21,16128,188,27072,43200
train,1164,16,12288,109,15696,27984
train,1165,22,16896,206,29664,46560
train,1166,16,12288,109,15696,27984
train,1167,25,19200,266,38304,57504
train,1168,10,7680,43,6192,13872
train,1169,27,20736,310,44640,65376
train,1170,32,24576,436,62784,87360
train,1171,15,11520,96,13824,25344
train,1172,35,26880,522,75168,102048
train,1173,18,13824,138,19872,33696
train,1174,14,10752,84,12096,22848
train,1175,9,6912,35,5040,11952
train,1176,22,16896,206,29664,46560
train,1177,10,7680,43,6192,13872
train,1178,17,13056,123,17712,30768
train,1179,9,6912,35,5040,11952
train,1180,26,19968,288,41472,61440
train,1181,9,6912,35,5040,11952
train,1182,7,5376,21,3024,8400
train,1183,14,10752,84,12096,22848
train,1184,22,16896,206,29664,46560
train,1185,12,9216,61,8784,18000
train,1186,11,8448,52,7488,15936
train,1187,20,15360,170,24480,39840
train,1188,25,19200,266,38304,57504
train,1189,34,26112,492,70848,96960
train,1190,17,13056,138,19872,32928
train,1191,20,15360,170,24480,39840
train,1192,33,25344,464,66816,92160
train,1193,19,14592,154,22176,36768
train,1194,16,12288,109,15696,27984
train,1195,13,9984,72,10368,20352
train,1196,28,21504,334,48096,69600
train,1197,17,13056,123,17712,30768
train,1198,6,4608,15,2160,6768
train,1199,29,22272,358,51552,73824
train,1200,29,22272,358,51552,73824
train,1201,12,9216,61,8784,18000
train,1202,7,5376,21,3024,8400
train,1203,30,23040,383,55152,78192
train,1204,34,26112,492,70848,96960
train,1205,26,19968,288,41472,61440
train,1206,22,16896,206,29664,46560
train,1207,13,9984,72,10368,20352
train,1208,13,9984,72,10368,20352
train,1209,14,10752,84,12096,22848
train,1210,36,27648,552,79488,107136
train,1211,22,16896,206,29664,46560
train,1212,11,8448,52,7488,15936
train,1213,30,23040,383,55152,78192
train,1214,10,7680,43,6192,13872
train,1215,27,20736,310,44640,65376
train,1216,10,7680,43,6192,13872
train,1217,7,5376,21,3024,8400
train,1218,14,10752,84,12096,22848
train,1219,23,17664,225,32400,50064
train,1220,15,11520,96,13824,25344
train,1221,28,21504,334,48096,69600
train,1222,4,3072,11,1584,4656
train,1223,11,8448,52,7488,15936
train,1224,21,16128,188,27072,43200
train,1225,19,14592,154,22176,36768
train,1226,14,10752,84,12096,22848
train,1227,19,14592,154,22176,36768
train,1228,39,29952,648,93312,123264
train,1229,35,26880,522,75168,102048
train,1230,9,6912,35,5040,11952
train,1231,6,4608,15,2160,6768
train,1232,12,9216,61,8784,18000
train,1233,14,10752,84,12096,22848
train,1234,32,24576,436,62784,87360
train,1235,30,23040,383,55152,78192
train,1236,23,17664,225,32400,50064
train,1237,25,19200,266,38304,57504
train,1238,14,10752,84,12096,22848
train,1239,50,38400,1064,153216,191616
train,1240,14,10752,84,12096,22848
train,1241,6,4608,15,2160,6768
train,1242,20,15360,170,24480,39840
train,1243,22,16896,206,29664,46560
train,1244,32,24576,436,62784,87360
train,1245,14,10752,84,12096,22848
train,1246,16,12288,109,15696,27984
train,1247,31,23808,409,58896,82704
train,1248,22,16896,206,29664,46560
train,1249,5,3840,11,1584,5424
train,1250,4,3072,7,1008,4080
train,1251,8,6144,27,3888,10032
train,1252,15,11520,96,13824,25344
train,1253,15,11520,96,13824,25344
train,1254,24,18432,266,38304,56736
train,1255,9,6912,35,5040,11952
train,1256,17,13056,123,17712,30768
train,1257,23,17664,225,32400,50064
train,1258,27,20736,310,44640,65376
train,1259,6,4608,15,2160,6768
train,1260,13,9984,72,10368,20352
train,1261,18,13824,138,19872,33696
train,1262,7,5376,21,3024,8400
train,1263,38,29184,615,88560,117744
train,1264,27,20736,310,44640,65376
train,1265,28,21504,334,48096,69600
train,1266,12,9216,61,8784,18000
train,1267,27,20736,310,44640,65376
train,1268,25,19200,266,38304,57504
train,1269,12,9216,61,8784,18000
train,1270,21,16128,188,27072,43200
train,1271,32,24576,436,62784,87360
train,1272,26,19968,288,41472,61440
train,1273,21,16128,188,27072,43200
train,1274,28,21504,334,48096,69600
train,1275,28,21504,334,48096,69600
train,1276,25,19200,266,38304,57504
train,1277,21,16128,188,27072,43200
train,1278,19,14592,154,22176,36768
train,1279,27,20736,310,44640,65376
train,1280,28,21504,334,48096,69600
train,1281,16,12288,109,15696,27984
train,1282,40,30720,681,98064,128784
train,1283,23,17664,225,32400,50064
train,1284,21,16128,188,27072,43200
train,1285,9,6912,35,5040,11952
train,1286,21,16128,206,29664,45792
train,1287,22,16896,206,29664,46560
train,1288,31,23808,409,58896,82704
train,1289,40,30720,681,98064,128784
train,1290,30,23040,383,55152,78192
train,1291,11,8448,52,7488,15936
train,1292,27,20736,310,44640,65376
train,1293,51,39168,1107,159408,198576
train,1294,22,16896,206,29664,46560
train,1295,25,19200,266,38304,57504
train,1296,19,14592,170,24480,39072
train,1297,10,7680,43,6192,13872
train,1298,24,18432,245,35280,53712
train,1299,10,7680,43,6192,13872
train,1300,31,23808,409,58896,82704
train,1301,25,19200,266,38304,57504
train,1302,14,10752,84,12096,22848
train,1303,27,20736,310,44640,65376
train,1304,29,22272,358,51552,73824
train,1305,14,10752,84,12096,22848
train,1306,19,14592,154,22176,36768
train,1307,24,18432,245,35280,53712
train,1308,42,32256,751,108144,140400
train,1309,8,6144,27,3888,10032
train,1310,16,12288,109,15696,27984
train,1311,7,5376,21,3024,8400
train,1312,30,23040,383,55152,78192
train,1313,4,3072,7,1008,4080
train,1314,23,17664,225,32400,50064
train,1315,12,9216,61,8784,18000
train,1316,11,8448,52,7488,15936
train,1317,10,7680,43,6192,13872
train,1318,16,12288,109,15696,27984
train,1319,15,11520,96,13824,25344
train,1320,3,2304,4,576,2880
train,1321,5,3840,11,1584,5424
train,1322,17,13056,123,17712,30768
train,1323,18,13824,138,19872,33696
train,1324,18,13824,138,19872,33696
train,1325,21,16128,188,27072,43200
train,1326,23,17664,225,32400,50064
train,1327,4,3072,7,1008,4080
train,1328,24,18432,245,35280,53712
train,1329,18,13824,138,19872,33696
train,1330,14,10752,84,12096,22848
train,1331,24,18432,245,35280,53712
train,1332,24,18432,245,35280,53712
train,1333,24,18432,245,35280,53712
train,1334,28,21504,334,48096,69600
train,1335,14,10752,84,12096,22848
train,1336,22,16896,206,29664,46560
train,1337,16,12288,109,15696,27984
train,1338,21,16128,188,27072,43200
train,1339,34,26112,492,70848,96960
train,1340,26,19968,288,41472,61440
train,1341,34,26112,492,70848,96960
train,1342,16,12288,109,15696,27984
train,1343,24,18432,245,35280,53712
train,1344,9,6912,35,5040,11952
train,1345,35,26880,522,75168,102048
train,1346,20,15360,170,24480,39840
train,1347,12,9216,61,8784,18000
train,1348,10,7680,43,6192,13872
train,1349,5,3840,11,1584,5424
train,1350,14,10752,84,12096,22848
train,1351,17,13056,123,17712,30768
train,1352,22,16896,206,29664,46560
train,1353,15,11520,96,13824,25344
train,1354,9,6912,35,5040,11952
train,1355,4,3072,7,1008,4080
train,1356,24,18432,245,35280,53712
train,1357,39,29952,648,93312,123264
train,1358,26,19968,288,41472,61440
train,1359,19,14592,154,22176,36768
train,1360,10,7680,43,6192,13872
train,1361,25,19200,266,38304,57504
train,1362,25,19200,266,38304,57504
train,1363,4,3072,7,1008,4080
train,1364,20,15360,170,24480,39840
train,1365,31,23808,409,58896,82704
train,1366,32,24576,436,62784,87360
train,1367,12,9216,61,8784,18000
train,1368,44,33792,824,118656,152448
train,1369,20,15360,170,24480,39840
train,1370,21,16128,188,27072,43200
train,1371,47,36096,940,135360,171456
train,1372,23,17664,225,32400,50064
train,1373,11,8448,52,7488,15936
train,1374,11,8448,52,7488,15936
train,1375,17,13056,123,17712,30768
train,1376,27,20736,310,44640,65376
train,1377,34,26112,492,70848,96960
train,1378,13,9984,72,10368,20352
train,1379,22,16896,206,29664,46560
train,1380,25,19200,266,38304,57504
train,1381,33,25344,464,66816,92160
train,1382,18,13824,138,19872,33696
train,1383,13,9984,72,10368,20352
train,1384,24,18432,245,35280,53712
train,1385,12,9216,61,8784,18000
train,1386,13,9984,72,10368,20352
train,1387,12,9216,61,8784,18000
train,1388,20,15360,170,24480,39840
train,1389,26,19968,288,41472,61440
train,1390,5,3840,11,1584,5424
train,1391,14,10752,84,12096,22848
train,1392,15,11520,96,13824,25344
train,1393,31,23808,409,58896,82704
train,1394,13,9984,72,10368,20352
train,1395,28,21504,334,48096,69600
train,1396,31,23808,409,58896,82704
train,1397,18,13824,138,19872,33696
train,1398,19,14592,154,22176,36768
train,1399,26,19968,288,41472,61440
train,1400,27,20736,310,44640,65376
train,1401,9,6912,35,5040,11952
train,1402,13,9984,72,10368,20352
train,1403,12,9216,72,10368,19584
train,1404,6,4608,15,2160,6768
train,1405,17,13056,123,17712,30768
train,1406,19,14592,154,22176,36768
train,1407,8,6144,35,5040,11184
train,1408,18,13824,138,19872,33696
train,1409,13,9984,72,10368,20352
train,1410,19,14592,154,22176,36768
train,1411,42,32256,751,108144,140400
train,1412,34,26112,492,70848,96960
train,1413,24,18432,245,35280,53712
train,1414,25,19200,266,38304,57504
train,1415,24,18432,245,35280,53712
train,1416,15,11520,96,13824,25344
train,1417,15,11520,96,13824,25344
train,1418,33,25344,464,66816,92160
train,1419,28,21504,334,48096,69600
train,1420,19,14592,154,22176,36768
train,1421,19,14592,154,22176,36768
train,1422,16,12288,109,15696,27984
train,1423,24,18432,245,35280,53712
train,1424,25,19200,266,38304,57504
train,1425,44,33792,824,118656,152448
train,1426,6,4608,15,2160,6768
train,1427,10,7680,43,6192,13872
train,1428,19,14592,154,22176,36768
train,1429,25,19200,266,38304,57504
train,1430,30,23040,383,55152,78192
train,1431,26,19968,288,41472,61440
train,1432,11,8448,52,7488,15936
train,1433,7,5376,21,3024,8400
train,1434,25,19200,266,38304,57504
train,1435,22,16896,225,32400,49296
train,1436,18,13824,138,19872,33696
train,1437,21,16128,188,27072,43200
train,1438,21,16128,188,27072,43200
train,1439,26,19968,288,41472,61440
train,1440,15,11520,96,13824,25344
train,1441,13,9984,72,10368,20352
train,1442,23,17664,225,32400,50064
train,1443,27,20736,310,44640,65376
train,1444,19,14592,154,22176,36768
train,1445,35,26880,522,75168,102048
train,1446,15,11520,96,13824,25344
train,1447,27,20736,310,44640,65376
train,1448,29,22272,383,55152,77424
train,1449,11,8448,52,7488,15936
train,1450,8,6144,27,3888,10032
train,1451,11,8448,52,7488,15936
train,1452,32,24576,436,62784,87360
train,1453,10,7680,43,6192,13872
train,1454,30,23040,383,55152,78192
train,1455,29,22272,358,51552,73824
train,1456,12,9216,61,8784,18000
train,1457,33,25344,464,66816,92160
train,1458,13,9984,72,10368,20352
train,1459,18,13824,138,19872,33696
train,1460,28,21504,334,48096,69600
train,1461,15,11520,109,15696,27216
train,1462,17,13056,123,17712,30768
train,1463,10,7680,43,6192,13872
train,1464,21,16128,188,27072,43200
train,1465,14,10752,84,12096,22848
train,1466,33,25344,464,66816,92160
train,1467,27,20736,310,44640,65376
train,1468,14,10752,84,12096,22848
train,1469,16,12288,109,15696,27984
train,1470,12,9216,61,8784,18000
train,1471,31,23808,409,58896,82704
train,1472,37,28416,583,83952,112368
train,1473,24,18432,245,35280,53712
train,1474,26,19968,288,41472,61440
train,1475,20,15360,170,24480,39840
train,1476,18,13824,138,19872,33696
train,1477,11,8448,61,8784,17232
train,1478,32,24576,436,62784,87360
train,1479,26,19968,288,41472,61440
train,1480,15,11520,96,13824,25344
train,1481,41,31488,716,103104,134592
train,1482,32,24576,436,62784,87360
train,1483,5,3840,11,1584,5424
train,1484,25,19200,266,38304,57504
train,1485,35,26880,522,75168,102048
train,1486,31,23808,409,58896,82704
train,1487,10,7680,43,6192,13872
train,1488,14,10752,84,12096,22848
train,1489,6,4608,15,2160,6768
train,1490,11,8448,52,7488,15936
train,1491,12,9216,61,8784,18000
train,1492,13,9984,72,10368,20352
train,1493,30,23040,383,55152,78192
train,1494,20,15360,170,24480,39840
train,1495,8,6144,27,3888,10032
train,1496,33,25344,464,66816,92160
train,1497,24,18432,245,35280,53712
train,1498,33,25344,464,66816,92160
train,1499,38,29184,615,88560,117744
train,1500,22,16896,206,29664,46560
train,1501,15,11520,96,13824,25344
train,1502,16,12288,109,15696,27984
train,1503,21,16128,188,27072,43200
train,1504,10,7680,43,6192,13872
train,1505,9,6912,35,5040,11952
train,1506,37,28416,583,83952,112368
train,1507,6,4608,15,2160,6768
train,1508,34,26112,492,70848,96960
train,1509,28,21504,334,48096,69600
train,1510,15,11520,96,13824,25344
train,1511,13,9984,72,10368,20352
train,1512,13,9984,72,10368,20352
train,1513,9,6912,35,5040,11952
train,1514,24,18432,245,35280,53712
train,1515,34,26112,492,70848,96960
train,1516,13,9984,72,10368,20352
train,1517,17,13056,123,17712,30768
train,1518,11,8448,52,7488,15936
train,1519,10,7680,43,6192,13872
train,1520,18,13824,138,19872,33696
train,1521,12,9216,61,8784,18000
train,1522,11,8448,52,7488,15936
train,1523,13,9984,72,10368,20352
train,1524,29,22272,358,51552,73824
train,1525,16,12288,109,15696,27984
train,1526,25,19200,266,38304,57504
train,1527,29,22272,358,51552,73824
train,1528,35,26880,522,75168,102048
train,1529,6,4608,15,2160,6768
train,1530,31,23808,409,58896,82704
train,1531,24,18432,245,35280,53712
train,1532,23,17664,225,32400,50064
train,1533,32,24576,436,62784,87360
train,1534,17,13056,123,17712,30768
train,1535,18,13824,138,19872,33696
train,1536,10,7680,43,6192,13872
train,1537,16,12288,109,15696,27984
train,1538,15,11520,96,13824,25344
train,1539,25,19200,288,41472,60672
train,1540,9,6912,35,5040,11952
train,1541,27,20736,310,44640,65376
train,1542,24,18432,245,35280,53712
train,1543,17,13056,123,17712,30768
train,1544,29,22272,358,51552,73824
train,1545,29,22272,358,51552,73824
train,1546,23,17664,225,32400,50064
train,1547,37,28416,583,83952,112368
train,1548,23,17664,225,32400,50064
train,1549,14,10752,84,12096,22848
train,1550,11,8448,52,7488,15936
train,1551,15,11520,96,13824,25344
train,1552,22,16896,206,29664,46560
train,1553,39,29952,648,93312,123264
train,1554,8,6144,27,3888,10032
train,1555,20,15360,170,24480,39840
train,1556,10,7680,43,6192,13872
train,1557,32,24576,436,62784,87360
train,1558,13,9984,72,10368,20352
train,1559,34,26112,492,70848,96960
train,1560,15,11520,109,15696,27216
train,1561,6,4608,15,2160,6768
train,1562,11,8448,52,7488,15936
train,1563,9,6912,35,5040,11952
train,1564,8,6144,27,3888,10032
train,1565,32,24576,436,62784,87360
train,1566,22,16896,206,29664,46560
train,1567,15,11520,96,13824,25344
train,1568,31,23808,409,58896,82704
train,1569,15,11520,96,13824,25344
train,1570,35,26880,522,75168,102048
train,1571,24,18432,245,35280,53712
train,1572,26,19968,288,41472,61440
train,1573,25,19200,266,38304,57504
train,1574,22,16896,206,29664,46560
train,1575,13,9984,72,10368,20352
train,1576,7,5376,21,3024,8400
train,1577,21,16128,188,27072,43200
train,1578,10,7680,43,6192,13872
train,1579,43,33024,787,113328,146352
train,1580,40,30720,681,98064,128784
train,1581,29,22272,358,51552,73824
train,1582,44,33792,824,118656,152448
train,1583,5,3840,11,1584,5424
train,1584,6,4608,15,2160,6768
train,1585,13,9984,72,10368,20352
train,1586,17,13056,123,17712,30768
train,1587,36,27648,552,79488,107136
train,1588,10,7680,43,6192,13872
train,1589,27,20736,310,44640,65376
train,1590,14,10752,84,12096,22848
train,1591,28,21504,334,48096,69600
train,1592,24,18432,245,35280,53712
train,1593,30,23040,383,55152,78192
train,1594,30,23040,383,55152,78192
train,1595,10,7680,43,6192,13872
train,1596,13,9984,72,10368,20352
train,1597,11,8448,52,7488,15936
train,1598,14,10752,84,12096,22848
train,1599,31,23808,409,58896,82704
train,1600,24,18432,245,35280,53712
train,1601,32,24576,436,62784,87360
train,1602,8,6144,27,3888,10032
train,1603,14,10752,84,12096,22848
train,1604,34,26112,492,70848,96960
train,1605,14,10752,84,12096,22848
train,1606,23,17664,225,32400,50064
train,1607,21,16128,188,27072,43200
train,1608,11,8448,52,7488,15936
train,1609,21,16128,188,27072,43200
train,1610,40,30720,681,98064,128784
train,1611,12,9216,61,8784,18000
train,1612,18,13824,138,19872,33696
train,1613,19,14592,154,22176,36768
train,1614,24,18432,245,35280,53712
train,1615,17,13056,123,17712,30768
train,1616,28,21504,334,48096,69600
train,1617,21,16128,188,27072,43200
train,1618,12,9216,61,8784,18000
train,1619,9,6912,35,5040,11952
train,1620,33,25344,464,66816,92160
train,1621,17,13056,123,17712,30768
train,1622,8,6144,27,3888,10032
train,1623,7,5376,21,3024,8400
train,1624,29,22272,358,51552,73824
train,1625,38,29184,615,88560,117744
train,1626,12,9216,61,8784,18000
train,1627,16,12288,109,15696,27984
train,1628,27,20736,310,44640,65376
train,1629,12,9216,61,8784,18000
train,1630,14,10752,84,12096,22848
train,1631,28,21504,334,48096,69600
train,1632,20,15360,170,24480,39840
train,1633,18,13824,138,19872,33696
train,1634,3,2304,4,576,2880
train,1635,24,18432,245,35280,53712
train,1636,35,26880,522,75168,102048
train,1637,10,7680,43,6192,13872
train,1638,9,6912,35,5040,11952
train,1639,11,8448,52,7488,15936
train,1640,45,34560,862,124128,158688
train,1641,14,10752,84,12096,22848
train,1642,23,17664,225,32400,50064
train,1643,17,13056,123,17712,30768
train,1644,30,23040,383,55152,78192
train,1645,10,7680,43,6192,13872
train,1646,30,23040,409,58896,81936
train,1647,13,9984,72,10368,20352
train,1648,4,3072,7,1008,4080
train,1649,17,13056,123,17712,30768
train,1650,8,6144,27,3888,10032
train,1651,22,16896,206,29664,46560
train,1652,32,24576,436,62784,87360
train,1653,51,39168,1107,159408,198576
train,1654,30,23040,383,55152,78192
train,1655,15,11520,96,13824,25344
train,1656,13,9984,72,10368,20352
train,1657,18,13824,138,19872,33696
train,1658,19,14592,154,22176,36768
train,1659,20,15360,170,24480,39840
train,1660,10,7680,43,6192,13872
train,1661,21,16128,188,27072,43200
train,1662,11,8448,52,7488,15936
train,1663,14,10752,84,12096,22848
train,1664,18,13824,138,19872,33696
train,1665,13,9984,72,10368,20352
train,1666,12,9216,61,8784,18000
train,1667,10,7680,43,6192,13872
train,1668,15,11520,96,13824,25344
train,1669,9,6912,35,5040,11952
train,1670,17,13056,123,17712,30768
train,1671,9,6912,35,5040,11952
train,1672,11,8448,52,7488,15936
train,1673,15,11520,96,13824,25344
train,1674,20,15360,170,24480,39840
train,1675,32,24576,436,62784,87360
train,1676,40,30720,681,98064,128784
train,1677,30,23040,383,55152,78192
train,1678,18,13824,138,19872,33696
train,1679,22,16896,206,29664,46560
train,1680,23,17664,225,32400,50064
train,1681,33,25344,464,66816,92160
train,1682,13,9984,72,10368,20352
train,1683,30,23040,383,55152,78192
train,1684,19,14592,154,22176,36768
train,1685,38,29184,615,88560,117744
train,1686,3,2304,4,576,2880
train,1687,10,7680,43,6192,13872
train,1688,18,13824,138,19872,33696
train,1689,29,22272,358,51552,73824
train,1690,36,27648,552,79488,107136
train,1691,35,26880,522,75168,102048
train,1692,15,11520,96,13824,25344
train,1693,18,13824,138,19872,33696
train,1694,26,19968,288,41472,61440
train,1695,31,23808,409,58896,82704
train,1696,14,10752,84,12096,22848
train,1697,17,13056,123,17712,30768
train,1698,9,6912,35,5040,11952
train,1699,26,19968,288,41472,61440
train,1700,5,3840,11,1584,5424
train,1701,23,17664,225,32400,50064
train,1702,24,18432,245,35280,53712
train,1703,22,16896,206,29664,46560
train,1704,34,26112,492,70848,96960
train,1705,34,26112,492,70848,96960
train,1706,26,19968,288,41472,61440
train,1707,20,15360,170,24480,39840
train,1708,10,7680,43,6192,13872
train,1709,21,16128,188,27072,43200
train,1710,5,3840,11,1584,5424
train,1711,7,5376,21,3024,8400
train,1712,12,9216,61,8784,18000
train,1713,18,13824,138,19872,33696
train,1714,14,10752,84,12096,22848
train,1715,6,4608,15,2160,6768
train,1716,14,10752,84,12096,22848
train,1717,41,31488,716,103104,134592
train,1718,4,3072,7,1008,4080
train,1719,36,27648,552,79488,107136
train,1720,24,18432,245,35280,53712
train,1721,11,8448,52,7488,15936
train,1722,39,29952,648,93312,123264
train,1723,22,16896,206,29664,46560
train,1724,15,11520,96,13824,25344
train,1725,8,6144,27,3888,10032
train,1726,13,9984,72,10368,20352
train,1727,35,26880,522,75168,102048
train,1728,16,12288,109,15696,27984
train,1729,18,13824,138,19872,33696
train,1730,8,6144,27,3888,10032
train,1731,19,14592,154,22176,36768
train,1732,22,16896,206,29664,46560
train,1733,13,9984,72,10368,20352
train,1734,14,10752,84,12096,22848
train,1735,27,20736,310,44640,65376
train,1736,5,3840,11,1584,5424
train,1737,29,22272,358,51552,73824
train,1738,32,24576,436,62784,87360
train,1739,35,26880,522,75168,102048
train,1740,31,23808,409,58896,82704
train,1741,38,29184,615,88560,117744
train,1742,4,3072,7,1008,4080
train,1743,34,26112,492,70848,96960
train,1744,8,6144,35,5040,11184
train,1745,29,22272,358,51552,73824
train,1746,15,11520,96,13824,25344
train,1747,6,4608,15,2160,6768
train,1748,13,9984,72,10368,20352
train,1749,37,28416,583,83952,112368
train,1750,29,22272,358,51552,73824
train,1751,28,21504,334,48096,69600
train,1752,21,16128,188,27072,43200
train,1753,43,33024,787,113328,146352
train,1754,23,17664,225,32400,50064
train,1755,19,14592,154,22176,36768
train,1756,35,26880,522,75168,102048
train,1757,17,13056,123,17712,30768
train,1758,16,12288,109,15696,27984
train,1759,12,9216,61,8784,18000
train,1760,28,21504,334,48096,69600
train,1761,21,16128,188,27072,43200
train,1762,14,10752,84,12096,22848
train,1763,29,22272,358,51552,73824
train,1764,31,23808,409,58896,82704
train,1765,17,13056,123,17712,30768
train,1766,39,29952,648,93312,123264
train,1767,11,8448,52,7488,15936
train,1768,11,8448,52,7488,15936
train,1769,22,16896,206,29664,46560
train,1770,13,9984,72,10368,20352
train,1771,28,21504,334,48096,69600
train,1772,31,23808,409,58896,82704
train,1773,12,9216,61,8784,18000
train,1774,14,10752,84,12096,22848
train,1775,16,12288,109,15696,27984
train,1776,16,12288,123,17712,30000
train,1777,3,2304,4,576,2880
train,1778,20,15360,170,24480,39840
train,1779,25,19200,266,38304,57504
train,1780,22,16896,206,29664,46560
train,1781,32,24576,436,62784,87360
train,1782,18,13824,138,19872,33696
train,1783,23,17664,225,32400,50064
train,1784,3,2304,4,576,2880
train,1785,17,13056,123,17712,30768
train,1786,22,16896,206,29664,46560
train,1787,13,9984,72,10368,20352
train,1788,33,25344,464,66816,92160
train,1789,19,14592,154,22176,36768
train,1790,20,15360,170,24480,39840
train,1791,4,3072,7,1008,4080
train,1792,15,11520,96,13824,25344
train,1793,17,13056,123,17712,30768
train,1794,22,16896,206,29664,46560
train,1795,19,14592,154,22176,36768
train,1796,10,7680,43,6192,13872
train,1797,26,19968,288,41472,61440
train,1798,17,13056,123,17712,30768
train,1799,28,21504,334,48096,69600
train,1800,31,23808,409,58896,82704
train,1801,42,32256,751,108144,140400
train,1802,15,11520,96,13824,25344
train,1803,11,8448,52,7488,15936
train,1804,12,9216,61,8784,18000
train,1805,26,19968,288,41472,61440
train,1806,8,6144,27,3888,10032
train,1807,27,20736,310,44640,65376
train,1808,7,5376,27,3888,9264
train,1809,9,6912,35,5040,11952
train,1810,15,11520,96,13824,25344
train,1811,15,11520,96,13824,25344
train,1812,22,16896,206,29664,46560
train,1813,9,6912,35,5040,11952
train,1814,34,26112,492,70848,96960
train,1815,24,18432,245,35280,53712
train,1816,14,10752,84,12096,22848
train,1817,20,15360,170,24480,39840
train,1818,29,22272,358,51552,73824
train,1819,6,4608,21,3024,7632
train,1820,17,13056,123,17712,30768
train,1821,8,6144,27,3888,10032
train,1822,18,13824,138,19872,33696
train,1823,37,28416,583,83952,112368
train,1824,18,13824,138,19872,33696
train,1825,32,24576,436,62784,87360
train,1826,11,8448,52,7488,15936
train,1827,26,19968,288,41472,61440
train,1828,14,10752,84,12096,22848
train,1829,20,15360,170,24480,39840
train,1830,10,7680,43,6192,13872
train,1831,19,14592,154,22176,36768
train,1832,31,23808,409,58896,82704
train,1833,14,10752,84,12096,22848
train,1834,13,9984,72,10368,20352
train,1835,7,5376,21,3024,8400
train,1836,20,15360,170,24480,39840
train,1837,19,14592,154,22176,36768
train,1838,24,18432,245,35280,53712
train,1839,20,15360,170,24480,39840
train,1840,15,11520,96,13824,25344
train,1841,14,10752,84,12096,22848
train,1842,34,26112,492,70848,96960
train,1843,18,13824,138,19872,33696
train,1844,32,24576,436,62784,87360
train,1845,17,13056,123,17712,30768
train,1846,9,6912,35,5040,11952
train,1847,44,33792,824,118656,152448
train,1848,29,22272,358,51552,73824
train,1849,32,24576,436,62784,87360
train,1850,20,15360,170,24480,39840
train,1851,19,14592,154,22176,36768
train,1852,40,30720,681,98064,128784
train,1853,35,26880,552,79488,106368
train,1854,25,19200,266,38304,57504
train,1855,6,4608,15,2160,6768
train,1856,24,18432,245,35280,53712
train,1857,16,12288,109,15696,27984
train,1858,30,23040,383,55152,78192
train,1859,17,13056,123,17712,30768
train,1860,18,13824,138,19872,33696
train,1861,9,6912,35,5040,11952
train,1862,50,38400,1064,153216,191616
train,1863,9,6912,35,5040,11952
train,1864,15,11520,96,13824,25344
train,1865,17,13056,123,17712,30768
train,1866,21,16128,188,27072,43200
train,1867,25,19200,266,38304,57504
train,1868,16,12288,123,17712,30000
train,1869,44,33792,824,118656,152448
train,1870,31,23808,409,58896,82704
train,1871,19,14592,154,22176,36768
train,1872,4,3072,7,1008,4080
train,1873,20,15360,170,24480,39840
train,1874,28,21504,334,48096,69600
train,1875,23,17664,225,32400,50064
train,1876,10,7680,43,6192,13872
train,1877,15,11520,96,13824,25344
train,1878,5,3840,11,1584,5424
train,1879,15,11520,96,13824,25344
train,1880,16,12288,109,15696,27984
train,1881,16,12288,109,15696,27984
train,1882,6,4608,15,2160,6768
train,1883,33,25344,464,66816,92160
train,1884,28,21504,334,48096,69600
train,1885,25,19200,266,38304,57504
train,1886,28,21504,334,48096,69600
train,1887,10,7680,43,6192,13872
train,1888,6,4608,15,2160,6768
train,1889,13,9984,72,10368,20352
train,1890,21,16128,188,27072,43200
train,1891,12,9216,61,8784,18000
train,1892,9,6912,35,5040,11952
train,1893,13,9984,72,10368,20352
train,1894,9,6912,35,5040,11952
train,1895,24,18432,245,35280,53712
train,1896,11,8448,52,7488,15936
train,1897,12,9216,61,8784,18000
train,1898,28,21504,334,48096,69600
train,1899,42,32256,751,108144,140400
train,1900,9,6912,35,5040,11952
train,1901,26,19968,288,41472,61440
train,1902,29,22272,358,51552,73824
train,1903,16,12288,109,15696,27984
train,1904,7,5376,21,3024,8400
train,1905,18,13824,138,19872,33696
train,1906,23,17664,225,32400,50064
train,1907,20,15360,188,27072,42432
train,1908,10,7680,43,6192,13872
train,1909,11,8448,52,7488,15936
train,1910,12,9216,61,8784,18000
train,1911,29,22272,358,51552,73824
train,1912,4,3072,7,1008,4080
train,1913,25,19200,266,38304,57504
train,1914,22,16896,206,29664,46560
train,1915,6,4608,15,2160,6768
train,1916,13,9984,72,10368,20352
train,1917,24,18432,245,35280,53712
train,1918,5,3840,11,1584,5424
train,1919,15,11520,96,13824,25344
train,1920,7,5376,27,3888,9264
train,1921,35,26880,522,75168,102048
train,1922,22,16896,206,29664,46560
train,1923,11,8448,52,7488,15936
train,1924,5,3840,11,1584,5424
train,1925,18,13824,138,19872,33696
train,1926,16,12288,109,15696,27984
train,1927,17,13056,123,17712,30768
train,1928,36,27648,552,79488,107136
train,1929,28,21504,334,48096,69600
train,1930,13,9984,72,10368,20352
train,1931,28,21504,334,48096,69600
train,1932,37,28416,583,83952,112368
train,1933,6,4608,15,2160,6768
train,1934,6,4608,15,2160,6768
train,1935,13,9984,72,10368,20352
train,1936,19,14592,154,22176,36768
train,1937,36,27648,552,79488,107136
train,1938,5,3840,11,1584,5424
train,1939,31,23808,409,58896,82704
train,1940,21,16128,188,27072,43200
train,1941,4,3072,7,1008,4080
train,1942,10,7680,43,6192,13872
train,1943,21,16128,188,27072,43200
train,1944,18,13824,138,19872,33696
train,1945,37,28416,583,83952,112368
train,1946,14,10752,84,12096,22848
train,1947,4,3072,7,1008,4080
train,1948,21,16128,188,27072,43200
train,1949,22,16896,206,29664,46560
train,1950,12,9216,61,8784,18000
train,1951,5,3840,11,1584,5424
train,1952,35,26880,522,75168,102048
train,1953,35,26880,522,75168,102048
train,1954,13,9984,72,10368,20352
train,1955,24,18432,245,35280,53712
train,1956,16,12288,109,15696,27984
train,1957,14,10752,84,12096,22848
train,1958,18,13824,138,19872,33696
train,1959,22,16896,206,29664,46560
train,1960,30,23040,383,55152,78192
train,1961,4,3072,7,1008,4080
train,1962,13,9984,72,10368,20352
train,1963,40,30720,681,98064,128784
train,1964,30,23040,383,55152,78192
train,1965,25,19200,266,38304,57504
train,1966,28,21504,334,48096,69600
train,1967,17,13056,123,17712,30768
train,1968,13,9984,72,10368,20352
train,1969,32,24576,436,62784,87360
train,1970,19,14592,154,22176,36768
train,1971,7,5376,21,3024,8400
train,1972,17,13056,123,17712,30768
train,1973,12,9216,61,8784,18000
train,1974,30,23040,383,55152,78192
train,1975,23,17664,225,32400,50064
train,1976,36,27648,552,79488,107136
train,1977,8,6144,27,3888,10032
train,1978,7,5376,21,3024,8400
train,1979,11,8448,52,7488,15936
train,1980,26,19968,288,41472,61440
train,1981,37,28416,583,83952,112368
train,1982,7,5376,21,3024,8400
train,1983,39,29952,648,93312,123264
train,1984,21,16128,188,27072,43200
train,1985,23,17664,225,32400,50064
train,1986,16,12288,109,15696,27984
train,1987,16,12288,109,15696,27984
train,1988,20,15360,170,24480,39840
train,1989,20,15360,170,24480,39840
train,1990,7,5376,21,3024,8400
train,1991,19,14592,154,22176,36768
train,1992,9,6912,35,5040,11952
train,1993,8,6144,27,3888,10032
train,1994,8,6144,27,3888,10032
train,1995,32,24576,436,62784,87360
train,1996,9,6912,35,5040,11952
train,1997,13,9984,72,10368,20352
train,1998,30,23040,383,55152,78192
train,1999,19,14592,154,22176,36768
train,2000,21,16128,188,27072,43200
train,2001,16,12288,109,15696,27984
train,2002,16,12288,109,15696,27984
train,2003,28,21504,334,48096,69600
train,2004,37,28416,583,83952,112368
train,2005,21,16128,188,27072,43200
train,2006,35,26880,522,75168,102048
train,2007,33,25344,464,66816,92160
train,2008,33,25344,464,66816,92160
train,2009,17,13056,123,17712,30768
train,2010,24,18432,245,35280,53712
train,2011,25,19200,266,38304,57504
train,2012,24,18432,245,35280,53712
train,2013,32,24576,436,62784,87360
train,2014,5,3840,11,1584,5424
train,2015,23,17664,225,32400,50064
train,2016,36,27648,552,79488,107136
train,2017,15,11520,96,13824,25344
train,2018,27,20736,310,44640,65376
train,2019,38,29184,615,88560,117744
train,2020,18,13824,138,19872,33696
train,2021,11,8448,52,7488,15936
train,2022,27,20736,310,44640,65376
train,2023,8,6144,27,3888,10032
train,2024,19,14592,154,22176,36768
train,2025,21,16128,188,27072,43200
train,2026,34,26112,492,70848,96960
train,2027,7,5376,21,3024,8400
train,2028,15,11520,96,13824,25344
train,2029,20,15360,170,24480,39840
train,2030,8,6144,27,3888,10032
train,2031,45,34560,862,124128,158688
train,2032,14,10752,84,12096,22848
train,2033,23,17664,225,32400,50064
train,2034,16,12288,109,15696,27984
train,2035,10,7680,43,6192,13872
train,2036,33,25344,464,66816,92160
train,2037,6,4608,15,2160,6768
train,2038,25,19200,266,38304,57504
train,2039,34,26112,492,70848,96960
train,2040,16,12288,109,15696,27984
train,2041,52,39936,1151,165744,205680
train,2042,5,3840,11,1584,5424
train,2043,14,10752,84,12096,22848
train,2044,31,23808,409,58896,82704
train,2045,14,10752,84,12096,22848
train,2046,19,14592,154,22176,36768
train,2047,12,9216,61,8784,18000
train,2048,29,22272,358,51552,73824
train,2049,19,14592,154,22176,36768
train,2050,15,11520,96,13824,25344
train,2051,26,19968,288,41472,61440
train,2052,55,42240,1288,185472,227712
train,2053,18,13824,138,19872,33696
train,2054,14,10752,84,12096,22848
train,2055,18,13824,138,19872,33696
train,2056,6,4608,15,2160,6768
train,2057,17,13056,123,17712,30768
train,2058,30,23040,383,55152,78192
train,2059,15,11520,96,13824,25344
train,2060,11,8448,52,7488,15936
train,2061,14,10752,84,12096,22848
train,2062,17,13056,123,17712,30768
train,2063,22,16896,206,29664,46560
train,2064,21,16128,188,27072,43200
train,2065,25,19200,266,38304,57504
train,2066,36,27648,552,79488,107136
train,2067,19,14592,154,22176,36768
train,2068,26,19968,288,41472,61440
train,2069,19,14592,154,22176,36768
train,2070,15,11520,96,13824,25344
train,2071,21,16128,188,27072,43200
train,2072,14,10752,84,12096,22848
train,2073,24,18432,245,35280,53712
train,2074,8,6144,27,3888,10032
train,2075,25,19200,266,38304,57504
train,2076,22,16896,206,29664,46560
train,2077,20,15360,170,24480,39840
train,2078,7,5376,21,3024,8400
train,2079,14,10752,84,12096,22848
train,2080,29,22272,358,51552,73824
train,2081,10,7680,43,6192,13872
train,2082,23,17664,225,32400,50064
train,2083,28,21504,334,48096,69600
train,2084,32,24576,436,62784,87360
train,2085,19,14592,154,22176,36768
train,2086,8,6144,27,3888,10032
train,2087,20,15360,170,24480,39840
train,2088,8,6144,27,3888,10032
train,2089,25,19200,266,38304,57504
train,2090,9,6912,35,5040,11952
train,2091,16,12288,109,15696,27984
train,2092,17,13056,123,17712,30768
train,2093,10,7680,43,6192,13872
train,2094,24,18432,245,35280,53712
train,2095,4,3072,7,1008,4080
train,2096,14,10752,84,12096,22848
train,2097,5,3840,11,1584,5424
train,2098,22,16896,206,29664,46560
train,2099,34,26112,492,70848,96960
train,2100,30,23040,383,55152,78192
train,2101,36,27648,552,79488,107136
train,2102,19,14592,154,22176,36768
train,2103,10,7680,43,6192,13872
train,2104,7,5376,21,3024,8400
train,2105,22,16896,206,29664,46560
train,2106,19,14592,154,22176,36768
train,2107,49,37632,1022,147168,184800
train,2108,21,16128,188,27072,43200
train,2109,4,3072,7,1008,4080
train,2110,13,9984,72,10368,20352
train,2111,18,13824,138,19872,33696
train,2112,36,27648,552,79488,107136
train,2113,7,5376,27,3888,9264
train,2114,43,33024,787,113328,146352
train,2115,8,6144,27,3888,10032
train,2116,27,20736,310,44640,65376
train,2117,29,22272,383,55152,77424
train,2118,27,20736,310,44640,65376
train,2119,7,5376,21,3024,8400
train,2120,26,19968,288,41472,61440
train,2121,8,6144,27,3888,10032
train,2122,21,16128,188,27072,43200
train,2123,18,13824,138,19872,33696
train,2124,18,13824,138,19872,33696
train,2125,22,16896,206,29664,46560
train,2126,28,21504,334,48096,69600
train,2127,35,26880,522,75168,102048
train,2128,9,6912,35,5040,11952
train,2129,9,6912,35,5040,11952
train,2130,15,11520,96,13824,25344
train,2131,4,3072,7,1008,4080
train,2132,21,16128,188,27072,43200
train,2133,4,3072,7,1008,4080
train,2134,24,18432,245,35280,53712
train,2135,25,19200,266,38304,57504
train,2136,31,23808,409,58896,82704
train,2137,6,4608,15,2160,6768
train,2138,19,14592,154,22176,36768
train,2139,21,16128,188,27072,43200
train,2140,9,6912,35,5040,11952
train,2141,28,21504,334,48096,69600
train,2142,9,6912,35,5040,11952
train,2143,27,20736,310,44640,65376
train,2144,16,12288,109,15696,27984
train,2145,28,21504,334,48096,69600
train,2146,13,9984,72,10368,20352
train,2147,29,22272,358,51552,73824
train,2148,16,12288,123,17712,30000
train,2149,20,15360,170,24480,39840
train,2150,22,16896,206,29664,46560
train,2151,38,29184,648,93312,122496
train,2152,24,18432,245,35280,53712
train,2153,12,9216,61,8784,18000
train,2154,19,14592,154,22176,36768
train,2155,14,10752,84,12096,22848
train,2156,3,2304,4,576,2880
train,2157,7,5376,21,3024,8400
train,2158,12,9216,61,8784,18000
train,2159,32,24576,436,62784,87360
train,2160,12,9216,61,8784,18000
train,2161,13,9984,72,10368,20352
train,2162,7,5376,21,3024,8400
train,2163,25,19200,266,38304,57504
train,2164,40,30720,681,98064,128784
train,2165,7,5376,21,3024,8400
train,2166,12,9216,61,8784,18000
train,2167,13,9984,72,10368,20352
train,2168,20,15360,170,24480,39840
train,2169,13,9984,72,10368,20352
train,2170,23,17664,225,32400,50064
train,2171,21,16128,188,27072,43200
train,2172,22,16896,206,29664,46560
train,2173,29,22272,358,51552,73824
train,2174,20,15360,170,24480,39840
train,2175,27,20736,310,44640,65376
train,2176,27,20736,310,44640,65376
train,2177,11,8448,52,7488,15936
train,2178,32,24576,436,62784,87360
train,2179,9,6912,35,5040,11952
train,2180,24,18432,245,35280,53712
train,2181,19,14592,154,22176,36768
train,2182,8,6144,27,3888,10032
train,2183,25,19200,266,38304,57504
train,2184,13,9984,72,10368,20352
train,2185,3,2304,4,576,2880
train,2186,19,14592,170,24480,39072
train,2187,15,11520,96,13824,25344
train,2188,18,13824,138,19872,33696
train,2189,27,20736,310,44640,65376
train,2190,24,18432,245,35280,53712
train,2191,38,29184,615,88560,117744
train,2192,27,20736,310,44640,65376
train,2193,9,6912,35,5040,11952
train,2194,26,19968,288,41472,61440
train,2195,4,3072,7,1008,4080
train,2196,22,16896,206,29664,46560
train,2197,18,13824,138,19872,33696
train,2198,17,13056,123,17712,30768
train,2199,27,20736,310,44640,65376
train,2200,15,11520,96,13824,25344
train,2201,15,11520,96,13824,25344
train,2202,20,15360,170,24480,39840
train,2203,7,5376,21,3024,8400
train,2204,11,8448,52,7488,15936
train,2205,26,19968,288,41472,61440
train,2206,22,16896,206,29664,46560
train,2207,7,5376,21,3024,8400
train,2208,30,23040,383,55152,78192
train,2209,28,21504,334,48096,69600
train,2210,18,13824,138,19872,33696
train,2211,31,23808,409,58896,82704
train,2212,37,28416,583,83952,112368
train,2213,15,11520,96,13824,25344
train,2214,22,16896,206,29664,46560
train,2215,31,23808,409,58896,82704
train,2216,35,26880,522,75168,102048
train,2217,41,31488,751,108144,139632
train,2218,26,19968,288,41472,61440
train,2219,11,8448,52,7488,15936
train,2220,8,6144,27,3888,10032
train,2221,10,7680,43,6192,13872
train,2222,17,13056,123,17712,30768
train,2223,16,12288,109,15696,27984
train,2224,32,24576,436,62784,87360
train,2225,10,7680,43,6192,13872
train,2226,18,13824,138,19872,33696
train,2227,19,14592,154,22176,36768
train,2228,22,16896,206,29664,46560
train,2229,20,15360,170,24480,39840
train,2230,37,28416,583,83952,112368
train,2231,12,9216,61,8784,18000
train,2232,24,18432,245,35280,53712
train,2233,26,19968,288,41472,61440
train,2234,30,23040,409,58896,81936
train,2235,20,15360,170,24480,39840
train,2236,29,22272,358,51552,73824
train,2237,11,8448,52,7488,15936
train,2238,16,12288,109,15696,27984
train,2239,6,4608,15,2160,6768
train,2240,26,19968,288,41472,61440
train,2241,26,19968,288,41472,61440
train,2242,23,17664,225,32400,50064
train,2243,20,15360,170,24480,39840
train,2244,9,6912,35,5040,11952
train,2245,8,6144,27,3888,10032
train,2246,30,23040,383,55152,78192
train,2247,37,28416,583,83952,112368
train,2248,33,25344,464,66816,92160
train,2249,8,6144,27,3888,10032
train,2250,26,19968,288,41472,61440
train,2251,16,12288,109,15696,27984
train,2252,28,21504,334,48096,69600
train,2253,46,35328,901,129744,165072
train,2254,3,2304,4,576,2880
train,2255,25,19200,266,38304,57504
train,2256,15,11520,96,13824,25344
train,2257,10,7680,43,6192,13872
train,2258,28,21504,334,48096,69600
train,2259,13,9984,72,10368,20352
train,2260,37,28416,583,83952,112368
train,2261,7,5376,21,3024,8400
train,2262,13,9984,72,10368,20352
train,2263,27,20736,310,44640,65376
train,2264,26,19968,288,41472,61440
train,2265,20,15360,170,24480,39840
train,2266,20,15360,170,24480,39840
train,2267,33,25344,464,66816,92160
train,2268,24,18432,245,35280,53712
train,2269,29,22272,358,51552,73824
train,2270,17,13056,123,17712,30768
train,2271,28,21504,334,48096,69600
train,2272,32,24576,436,62784,87360
train,2273,27,20736,310,44640,65376
train,2274,25,19200,266,38304,57504
train,2275,18,13824,138,19872,33696
train,2276,18,13824,138,19872,33696
train,2277,37,28416,583,83952,112368
train,2278,7,5376,21,3024,8400
train,2279,27,20736,310,44640,65376
train,2280,29,22272,358,51552,73824
train,2281,14,10752,84,12096,22848
train,2282,23,17664,225,32400,50064
train,2283,7,5376,21,3024,8400
train,2284,22,16896,206,29664,46560
train,2285,27,20736,310,44640,65376
train,2286,18,13824,138,19872,33696
train,2287,33,25344,464,66816,92160
train,2288,23,17664,225,32400,50064
train,2289,12,9216,61,8784,18000
train,2290,28,21504,334,48096,69600
train,2291,10,7680,43,6192,13872
train,2292,18,13824,138,19872,33696
train,2293,16,12288,109,15696,27984
train,2294,8,6144,27,3888,10032
train,2295,26,19968,288,41472,61440
train,2296,28,21504,334,48096,69600
train,2297,24,18432,245,35280,53712
train,2298,19,14592,154,22176,36768
train,2299,26,19968,288,41472,61440
train,2300,21,16128,188,27072,43200
train,2301,11,8448,52,7488,15936
train,2302,35,26880,522,75168,102048
train,2303,9,6912,35,5040,11952
train,2304,29,22272,358,51552,73824
train,2305,32,24576,436,62784,87360
train,2306,29,22272,358,51552,73824
train,2307,10,7680,43,6192,13872
train,2308,38,29184,615,88560,117744
train,2309,13,9984,72,10368,20352
train,2310,18,13824,138,19872,33696
train,2311,24,18432,245,35280,53712
train,2312,7,5376,21,3024,8400
train,2313,27,20736,310,44640,65376
train,2314,15,11520,96,13824,25344
train,2315,23,17664,225,32400,50064
train,2316,30,23040,383,55152,78192
train,2317,21,16128,188,27072,43200
train,2318,26,19968,288,41472,61440
train,2319,18,13824,138,19872,33696
train,2320,15,11520,96,13824,25344
train,2321,15,11520,96,13824,25344
train,2322,15,11520,96,13824,25344
train,2323,31,23808,409,58896,82704
train,2324,35,26880,522,75168,102048
train,2325,5,3840,15,2160,6000
train,2326,23,17664,225,32400,50064
train,2327,31,23808,409,58896,82704
train,2328,22,16896,206,29664,46560
train,2329,21,16128,188,27072,43200
train,2330,19,14592,154,22176,36768
train,2331,16,12288,109,15696,27984
train,2332,33,25344,464,66816,92160
train,2333,11,8448,52,7488,15936
train,2334,16,12288,109,15696,27984
train,2335,30,23040,383,55152,78192
train,2336,18,13824,138,19872,33696
train,2337,19,14592,154,22176,36768
train,2338,15,11520,96,13824,25344
train,2339,26,19968,288,41472,61440
train,2340,41,31488,716,103104,134592
train,2341,15,11520,96,13824,25344
train,2342,16,12288,109,15696,27984
train,2343,20,15360,170,24480,39840
train,2344,25,19200,266,38304,57504
train,2345,25,19200,266,38304,57504
train,2346,28,21504,334,48096,69600
train,2347,14,10752,84,12096,22848
train,2348,22,16896,206,29664,46560
train,2349,31,23808,409,58896,82704
train,2350,41,31488,716,103104,134592
train,2351,15,11520,96,13824,25344
train,2352,6,4608,15,2160,6768
train,2353,16,12288,109,15696,27984
train,2354,19,14592,154,22176,36768
train,2355,30,23040,383,55152,78192
train,2356,32,24576,436,62784,87360
train,2357,17,13056,123,17712,30768
train,2358,27,20736,310,44640,65376
train,2359,11,8448,52,7488,15936
train,2360,36,27648,552,79488,107136
train,2361,33,25344,464,66816,92160
train,2362,7,5376,21,3024,8400
train,2363,12,9216,61,8784,18000
train,2364,38,29184,615,88560,117744
train,2365,35,26880,522,75168,102048
train,2366,17,13056,123,17712,30768
train,2367,11,8448,52,7488,15936
train,2368,20,15360,170,24480,39840
train,2369,11,8448,52,7488,15936
train,2370,32,24576,436,62784,87360
train,2371,24,18432,245,35280,53712
train,2372,17,13056,123,17712,30768
train,2373,16,12288,109,15696,27984
train,2374,14,10752,84,12096,22848
train,2375,22,16896,206,29664,46560
train,2376,6,4608,15,2160,6768
train,2377,6,4608,15,2160,6768
train,2378,29,22272,358,51552,73824
train,2379,14,10752,84,12096,22848
train,2380,13,9984,72,10368,20352
train,2381,33,25344,464,66816,92160
train,2382,23,17664,225,32400,50064
train,2383,12,9216,61,8784,18000
train,2384,22,16896,206,29664,46560
train,2385,28,21504,334,48096,69600
train,2386,27,20736,310,44640,65376
train,2387,14,10752,96,13824,24576
train,2388,27,20736,310,44640,65376
train,2389,28,21504,334,48096,69600
train,2390,19,14592,154,22176,36768
train,2391,29,22272,358,51552,73824
train,2392,13,9984,72,10368,20352
train,2393,24,18432,245,35280,53712
train,2394,25,19200,266,38304,57504
train,2395,23,17664,225,32400,50064
train,2396,12,9216,61,8784,18000
train,2397,11,8448,52,7488,15936
train,2398,9,6912,35,5040,11952
train,2399,21,16128,188,27072,43200
train,2400,29,22272,358,51552,73824
train,2401,25,19200,266,38304,57504
train,2402,19,14592,154,22176,36768
train,2403,25,19200,266,38304,57504
train,2404,22,16896,206,29664,46560
train,2405,17,13056,123,17712,30768
train,2406,19,14592,154,22176,36768
train,2407,22,16896,206,29664,46560
train,2408,14,10752,84,12096,22848
train,2409,6,4608,15,2160,6768
train,2410,10,7680,43,6192,13872
train,2411,8,6144,27,3888,10032
train,2412,15,11520,96,13824,25344
train,2413,10,7680,43,6192,13872
train,2414,25,19200,266,38304,57504
train,2415,18,13824,138,19872,33696
train,2416,29,22272,358,51552,73824
train,2417,18,13824,138,19872,33696
train,2418,13,9984,72,10368,20352
train,2419,18,13824,138,19872,33696
train,2420,5,3840,11,1584,5424
train,2421,18,13824,138,19872,33696
train,2422,5,3840,11,1584,5424
train,2423,16,12288,109,15696,27984
train,2424,27,20736,310,44640,65376
train,2425,10,7680,43,6192,13872
train,2426,18,13824,138,19872,33696
train,2427,19,14592,154,22176,36768
train,2428,23,17664,225,32400,50064
train,2429,17,13056,123,17712,30768
train,2430,26,19968,288,41472,61440
train,2431,28,21504,334,48096,69600
train,2432,17,13056,123,17712,30768
train,2433,7,5376,21,3024,8400
train,2434,23,17664,225,32400,50064
train,2435,29,22272,358,51552,73824
train,2436,12,9216,61,8784,18000
train,2437,16,12288,109,15696,27984
train,2438,22,16896,225,32400,49296
train,2439,36,27648,552,79488,107136
train,2440,29,22272,358,51552,73824
train,2441,26,19968,288,41472,61440
train,2442,23,17664,225,32400,50064
train,2443,27,20736,310,44640,65376
train,2444,32,24576,436,62784,87360
train,2445,13,9984,72,10368,20352
train,2446,9,6912,35,5040,11952
train,2447,28,21504,334,48096,69600
train,2448,5,3840,15,2160,6000
train,2449,29,22272,358,51552,73824
train,2450,20,15360,170,24480,39840
train,2451,16,12288,109,15696,27984
train,2452,19,14592,154,22176,36768
train,2453,30,23040,383,55152,78192
train,2454,9,6912,35,5040,11952
train,2455,18,13824,138,19872,33696
train,2456,35,26880,552,79488,106368
train,2457,7,5376,21,3024,8400
train,2458,29,22272,358,51552,73824
train,2459,19,14592,154,22176,36768
train,2460,9,6912,35,5040,11952
train,2461,49,37632,1022,147168,184800
train,2462,7,5376,21,3024,8400
train,2463,38,29184,615,88560,117744
train,2464,27,20736,310,44640,65376
train,2465,23,17664,225,32400,50064
train,2466,16,12288,109,15696,27984
train,2467,20,15360,170,24480,39840
train,2468,22,16896,206,29664,46560
train,2469,14,10752,84,12096,22848
train,2470,8,6144,27,3888,10032
train,2471,12,9216,61,8784,18000
train,2472,16,12288,109,15696,27984
train,2473,25,19200,266,38304,57504
train,2474,21,16128,188,27072,43200
train,2475,19,14592,154,22176,36768
train,2476,15,11520,96,13824,25344
train,2477,29,22272,358,51552,73824
train,2478,30,23040,383,55152,78192
train,2479,26,19968,288,41472,61440
train,2480,41,31488,751,108144,139632
train,2481,11,8448,52,7488,15936
train,2482,28,21504,334,48096,69600
train,2483,40,30720,681,98064,128784
train,2484,31,23808,409,58896,82704
train,2485,26,19968,288,41472,61440
train,2486,22,16896,206,29664,46560
train,2487,30,23040,383,55152,78192
train,2488,34,26112,492,70848,96960
train,2489,29,22272,358,51552,73824
train,2490,11,8448,52,7488,15936
train,2491,24,18432,245,35280,53712
train,2492,43,33024,787,113328,146352
train,2493,32,24576,436,62784,87360
train,2494,26,19968,288,41472,61440
train,2495,41,31488,716,103104,134592
train,2496,30,23040,383,55152,78192
train,2497,40,30720,681,98064,128784
train,2498,13,9984,72,10368,20352
train,2499,41,31488,716,103104,134592
train,2500,28,21504,334,48096,69600
train,2501,13,9984,72,10368,20352
train,2502,30,23040,383,55152,78192
train,2503,38,29184,615,88560,117744
train,2504,26,19968,288,41472,61440
train,2505,19,14592,154,22176,36768
train,2506,14,10752,84,12096,22848
train,2507,30,23040,383,55152,78192
train,2508,36,27648,552,79488,107136
train,2509,14,10752,84,12096,22848
train,2510,23,17664,225,32400,50064
train,2511,12,9216,61,8784,18000
train,2512,6,4608,15,2160,6768
train,2513,23,17664,225,32400,50064
train,2514,19,14592,154,22176,36768
train,2515,14,10752,84,12096,22848
train,2516,23,17664,225,32400,50064
train,2517,16,12288,109,15696,27984
train,2518,32,24576,436,62784,87360
train,2519,25,19200,266,38304,57504
train,2520,9,6912,35,5040,11952
train,2521,21,16128,188,27072,43200
train,2522,20,15360,170,24480,39840
train,2523,40,30720,681,98064,128784
train,2524,3,2304,4,576,2880
train,2525,12,9216,61,8784,18000
train,2526,28,21504,334,48096,69600
train,2527,35,26880,522,75168,102048
train,2528,33,25344,464,66816,92160
train,2529,16,12288,109,15696,27984
train,2530,12,9216,61,8784,18000
train,2531,21,16128,188,27072,43200
train,2532,22,16896,206,29664,46560
train,2533,22,16896,206,29664,46560
train,2534,17,13056,123,17712,30768
train,2535,20,15360,170,24480,39840
train,2536,10,7680,43,6192,13872
train,2537,30,23040,383,55152,78192
train,2538,26,19968,288,41472,61440
train,2539,32,24576,436,62784,87360
train,2540,11,8448,52,7488,15936
train,2541,38,29184,615,88560,117744
train,2542,8,6144,27,3888,10032
train,2543,16,12288,109,15696,27984
train,2544,26,19968,288,41472,61440
train,2545,17,13056,123,17712,30768
train,2546,3,2304,4,576,2880
train,2547,16,12288,109,15696,27984
train,2548,6,4608,15,2160,6768
train,2549,15,11520,96,13824,25344
train,2550,34,26112,522,75168,101280
train,2551,33,25344,464,66816,92160
train,2552,31,23808,409,58896,82704
train,2553,25,19200,266,38304,57504
train,2554,30,23040,383,55152,78192
train,2555,24,18432,245,35280,53712
train,2556,26,19968,288,41472,61440
train,2557,48,36864,981,141264,178128
train,2558,6,4608,15,2160,6768
train,2559,10,7680,43,6192,13872
train,2560,7,5376,21,3024,8400
train,2561,7,5376,21,3024,8400
train,2562,43,33024,787,113328,146352
train,2563,28,21504,334,48096,69600
train,2564,27,20736,310,44640,65376
train,2565,22,16896,206,29664,46560
train,2566,20,15360,170,24480,39840
train,2567,12,9216,61,8784,18000
train,2568,21,16128,188,27072,43200
train,2569,10,7680,43,6192,13872
train,2570,13,9984,72,10368,20352
train,2571,10,7680,43,6192,13872
train,2572,30,23040,383,55152,78192
train,2573,23,17664,225,32400,50064
train,2574,29,22272,358,51552,73824
train,2575,19,14592,154,22176,36768
train,2576,21,16128,188,27072,43200
train,2577,45,34560,862,124128,158688
train,2578,22,16896,206,29664,46560
train,2579,33,25344,464,66816,92160
train,2580,35,26880,522,75168,102048
train,2581,26,19968,288,41472,61440
train,2582,17,13056,123,17712,30768
train,2583,17,13056,123,17712,30768
train,2584,20,15360,170,24480,39840
train,2585,21,16128,188,27072,43200
train,2586,9,6912,35,5040,11952
train,2587,10,7680,43,6192,13872
train,2588,13,9984,72,10368,20352
train,2589,16,12288,109,15696,27984
train,2590,7,5376,21,3024,8400
train,2591,49,37632,1022,147168,184800
train,2592,13,9984,72,10368,20352
train,2593,18,13824,138,19872,33696
train,2594,25,19200,266,38304,57504
train,2595,16,12288,109,15696,27984
train,2596,29,22272,358,51552,73824
train,2597,37,28416,615,88560,116976
train,2598,28,21504,358,51552,73056
train,2599,20,15360,170,24480,39840
train,2600,24,18432,245,35280,53712
train,2601,39,29952,648,93312,123264
train,2602,20,15360,170,24480,39840
train,2603,32,24576,436,62784,87360
train,2604,45,34560,862,124128,158688
train,2605,10,7680,43,6192,13872
train,2606,6,4608,15,2160,6768
train,2607,25,19200,266,38304,57504
train,2608,24,18432,245,35280,53712
train,2609,29,22272,358,51552,73824
train,2610,19,14592,154,22176,36768
train,2611,22,16896,206,29664,46560
train,2612,17,13056,123,17712,30768
train,2613,12,9216,61,8784,18000
train,2614,8,6144,27,3888,10032
train,2615,12,9216,61,8784,18000
train,2616,20,15360,170,24480,39840
train,2617,9,6912,35,5040,11952
train,2618,35,26880,522,75168,102048
train,2619,35,26880,522,75168,102048
train,2620,33,25344,464,66816,92160
train,2621,15,11520,96,13824,25344
train,2622,29,22272,358,51552,73824
train,2623,12,9216,61,8784,18000
train,2624,10,7680,43,6192,13872
train,2625,19,14592,154,22176,36768
train,2626,34,26112,492,70848,96960
train,2627,18,13824,138,19872,33696
train,2628,38,29184,615,88560,117744
train,2629,20,15360,170,24480,39840
train,2630,32,24576,436,62784,87360
train,2631,35,26880,522,75168,102048
train,2632,23,17664,225,32400,50064
train,2633,15,11520,96,13824,25344
train,2634,19,14592,154,22176,36768
train,2635,25,19200,266,38304,57504
train,2636,24,18432,245,35280,53712
train,2637,13,9984,72,10368,20352
train,2638,27,20736,310,44640,65376
train,2639,18,13824,138,19872,33696
train,2640,18,13824,138,19872,33696
train,2641,24,18432,245,35280,53712
train,2642,46,35328,901,129744,165072
train,2643,19,14592,154,22176,36768
train,2644,11,8448,52,7488,15936
train,2645,15,11520,96,13824,25344
train,2646,18,13824,138,19872,33696
train,2647,22,16896,206,29664,46560
train,2648,15,11520,96,13824,25344
train,2649,15,11520,96,13824,25344
train,2650,26,19968,288,41472,61440
train,2651,26,19968,288,41472,61440
train,2652,27,20736,310,44640,65376
train,2653,21,16128,188,27072,43200
train,2654,18,13824,138,19872,33696
train,2655,39,29952,681,98064,128016
train,2656,16,12288,109,15696,27984
train,2657,14,10752,84,12096,22848
train,2658,26,19968,288,41472,61440
train,2659,16,12288,109,15696,27984
train,2660,19,14592,154,22176,36768
train,2661,11,8448,52,7488,15936
train,2662,27,20736,310,44640,65376
train,2663,34,26112,492,70848,96960
train,2664,16,12288,109,15696,27984
train,2665,12,9216,61,8784,18000
train,2666,40,30720,681,98064,128784
train,2667,10,7680,43,6192,13872
train,2668,10,7680,43,6192,13872
train,2669,5,3840,11,1584,5424
train,2670,21,16128,188,27072,43200
train,2671,22,16896,206,29664,46560
train,2672,21,16128,188,27072,43200
train,2673,29,22272,358,51552,73824
train,2674,14,10752,84,12096,22848
train,2675,25,19200,266,38304,57504
train,2676,19,14592,154,22176,36768
train,2677,19,14592,154,22176,36768
train,2678,19,14592,154,22176,36768
train,2679,20,15360,170,24480,39840
train,2680,8,6144,27,3888,10032
train,2681,22,16896,206,29664,46560
train,2682,22,16896,206,29664,46560
train,2683,20,15360,170,24480,39840
train,2684,30,23040,383,55152,78192
train,2685,31,23808,409,58896,82704
train,2686,39,29952,648,93312,123264
train,2687,31,23808,409,58896,82704
train,2688,17,13056,123,17712,30768
train,2689,24,18432,245,35280,53712
train,2690,14,10752,84,12096,22848
train,2691,16,12288,109,15696,27984
train,2692,31,23808,409,58896,82704
train,2693,21,16128,188,27072,43200
train,2694,17,13056,123,17712,30768
train,2695,38,29184,615,88560,117744
train,2696,32,24576,436,62784,87360
train,2697,29,22272,358,51552,73824
train,2698,17,13056,123,17712,30768
train,2699,32,24576,436,62784,87360
train,2700,16,12288,109,15696,27984
train,2701,18,13824,138,19872,33696
train,2702,5,3840,11,1584,5424
train,2703,23,17664,225,32400,50064
train,2704,25,19200,266,38304,57504
train,2705,28,21504,334,48096,69600
train,2706,17,13056,123,17712,30768
train,2707,28,21504,334,48096,69600
train,2708,25,19200,266,38304,57504
train,2709,21,16128,188,27072,43200
train,2710,18,13824,138,19872,33696
train,2711,30,23040,383,55152,78192
train,2712,11,8448,52,7488,15936
train,2713,11,8448,52,7488,15936
train,2714,24,18432,245,35280,53712
train,2715,9,6912,35,5040,11952
train,2716,47,36096,940,135360,171456
train,2717,14,10752,84,12096,22848
train,2718,22,16896,206,29664,46560
train,2719,25,19200,266,38304,57504
train,2720,41,31488,716,103104,134592
train,2721,22,16896,206,29664,46560
train,2722,40,30720,681,98064,128784
train,2723,23,17664,225,32400,50064
train,2724,21,16128,188,27072,43200
train,2725,19,14592,154,22176,36768
train,2726,18,13824,138,19872,33696
train,2727,22,16896,206,29664,46560
train,2728,30,23040,383,55152,78192
train,2729,28,21504,334,48096,69600
train,2730,15,11520,96,13824,25344
train,2731,22,16896,206,29664,46560
train,2732,15,11520,96,13824,25344
train,2733,30,23040,383,55152,78192
train,2734,15,11520,96,13824,25344
train,2735,13,9984,72,10368,20352
train,2736,10,7680,43,6192,13872
train,2737,28,21504,334,48096,69600
train,2738,9,6912,35,5040,11952
train,2739,37,28416,583,83952,112368
train,2740,19,14592,154,22176,36768
train,2741,12,9216,61,8784,18000
train,2742,24,18432,245,35280,53712
train,2743,17,13056,123,17712,30768
train,2744,26,19968,288,41472,61440
train,2745,12,9216,61,8784,18000
train,2746,22,16896,206,29664,46560
train,2747,22,16896,206,29664,46560
train,2748,17,13056,123,17712,30768
train,2749,17,13056,123,17712,30768
train,2750,4,3072,7,1008,4080
train,2751,17,13056,123,17712,30768
train,2752,18,13824,138,19872,33696
train,2753,12,9216,61,8784,18000
train,2754,20,15360,170,24480,39840
train,2755,31,23808,409,58896,82704
train,2756,20,15360,170,24480,39840
train,2757,23,17664,225,32400,50064
train,2758,28,21504,334,48096,69600
train,2759,34,26112,492,70848,96960
train,2760,13,9984,72,10368,20352
train,2761,4,3072,7,1008,4080
train,2762,19,14592,154,22176,36768
train,2763,27,20736,310,44640,65376
train,2764,18,13824,138,19872,33696
train,2765,36,27648,552,79488,107136
train,2766,8,6144,27,3888,10032
train,2767,24,18432,245,35280,53712
train,2768,26,19968,288,41472,61440
train,2769,17,13056,123,17712,30768
train,2770,7,5376,21,3024,8400
train,2771,5,3840,11,1584,5424
train,2772,12,9216,61,8784,18000
train,2773,23,17664,225,32400,50064
train,2774,29,22272,358,51552,73824
train,2775,21,16128,188,27072,43200
train,2776,19,14592,154,22176,36768
train,2777,19,14592,154,22176,36768
train,2778,14,10752,84,12096,22848
train,2779,16,12288,109,15696,27984
train,2780,30,23040,383,55152,78192
train,2781,21,16128,188,27072,43200
train,2782,20,15360,170,24480,39840
train,2783,27,20736,310,44640,65376
train,2784,13,9984,72,10368,20352
train,2785,31,23808,409,58896,82704
train,2786,14,10752,84,12096,22848
train,2787,14,10752,84,12096,22848
train,2788,44,33792,824,118656,152448
train,2789,25,19200,266,38304,57504
train,2790,11,8448,52,7488,15936
train,2791,21,16128,188,27072,43200
train,2792,20,15360,170,24480,39840
train,2793,3,2304,4,576,2880
train,2794,40,30720,681,98064,128784
train,2795,8,6144,27,3888,10032
train,2796,17,13056,123,17712,30768
train,2797,12,9216,61,8784,18000
train,2798,5,3840,11,1584,5424
train,2799,27,20736,310,44640,65376
train,2800,12,9216,61,8784,18000
train,2801,28,21504,334,48096,69600
train,2802,16,12288,109,15696,27984
train,2803,19,14592,154,22176,36768
train,2804,26,19968,288,41472,61440
train,2805,15,11520,96,13824,25344
train,2806,9,6912,35,5040,11952
train,2807,18,13824,138,19872,33696
train,2808,8,6144,27,3888,10032
train,2809,33,25344,464,66816,92160
train,2810,12,9216,61,8784,18000
train,2811,21,16128,188,27072,43200
train,2812,19,14592,154,22176,36768
train,2813,17,13056,123,17712,30768
train,2814,8,6144,27,3888,10032
train,2815,18,13824,138,19872,33696
train,2816,12,9216,61,8784,18000
train,2817,28,21504,334,48096,69600
train,2818,19,14592,154,22176,36768
train,2819,25,19200,266,38304,57504
train,2820,15,11520,96,13824,25344
train,2821,9,6912,35,5040,11952
train,2822,20,15360,170,24480,39840
train,2823,14,10752,84,12096,22848
train,2824,20,15360,170,24480,39840
train,2825,22,16896,206,29664,46560
train,2826,23,17664,225,32400,50064
train,2827,19,14592,154,22176,36768
train,2828,9,6912,35,5040,11952
train,2829,26,19968,288,41472,61440
train,2830,22,16896,206,29664,46560
train,2831,31,23808,409,58896,82704
train,2832,16,12288,109,15696,27984
train,2833,11,8448,52,7488,15936
train,2834,16,12288,109,15696,27984
train,2835,32,24576,436,62784,87360
train,2836,16,12288,109,15696,27984
train,2837,16,12288,109,15696,27984
train,2838,27,20736,310,44640,65376
train,2839,13,9984,72,10368,20352
train,2840,21,16128,188,27072,43200
train,2841,28,21504,334,48096,69600
train,2842,10,7680,43,6192,13872
train,2843,18,13824,138,19872,33696
train,2844,18,13824,138,19872,33696
train,2845,15,11520,96,13824,25344
train,2846,9,6912,35,5040,11952
train,2847,11,8448,52,7488,15936
train,2848,13,9984,72,10368,20352
train,2849,19,14592,154,22176,36768
train,2850,22,16896,225,32400,49296
train,2851,25,19200,266,38304,57504
train,2852,23,17664,225,32400,50064
train,2853,17,13056,123,17712,30768
train,2854,18,13824,138,19872,33696
train,2855,25,19200,266,38304,57504
train,2856,28,21504,334,48096,69600
train,2857,28,21504,334,48096,69600
train,2858,10,7680,43,6192,13872
train,2859,17,13056,123,17712,30768
train,2860,34,26112,492,70848,96960
train,2861,46,35328,901,129744,165072
train,2862,35,26880,522,75168,102048
train,2863,25,19200,266,38304,57504
train,2864,18,13824,138,19872,33696
train,2865,25,19200,266,38304,57504
train,2866,13,9984,72,10368,20352
train,2867,41,31488,716,103104,134592
train,2868,20,15360,170,24480,39840
train,2869,30,23040,383,55152,78192
train,2870,19,14592,154,22176,36768
train,2871,23,17664,225,32400,50064
train,2872,18,13824,138,19872,33696
train,2873,7,5376,21,3024,8400
train,2874,21,16128,188,27072,43200
train,2875,14,10752,84,12096,22848
train,2876,12,9216,61,8784,18000
train,2877,15,11520,96,13824,25344
train,2878,29,22272,358,51552,73824
train,2879,17,13056,138,19872,32928
train,2880,29,22272,358,51552,73824
train,2881,36,27648,552,79488,107136
train,2882,5,3840,11,1584,5424
train,2883,16,12288,109,15696,27984
train,2884,36,27648,552,79488,107136
train,2885,11,8448,52,7488,15936
train,2886,14,10752,84,12096,22848
train,2887,20,15360,170,24480,39840
train,2888,21,16128,188,27072,43200
train,2889,35,26880,552,79488,106368
train,2890,11,8448,52,7488,15936
train,2891,18,13824,138,19872,33696
train,2892,14,10752,84,12096,22848
train,2893,21,16128,188,27072,43200
train,2894,33,25344,464,66816,92160
train,2895,39,29952,648,93312,123264
train,2896,11,8448,52,7488,15936
train,2897,12,9216,61,8784,18000
train,2898,15,11520,96,13824,25344
train,2899,24,18432,245,35280,53712
train,2900,4,3072,7,1008,4080
train,2901,13,9984,72,10368,20352
train,2902,12,9216,61,8784,18000
train,2903,20,15360,170,24480,39840
train,2904,25,19200,266,38304,57504
train,2905,12,9216,61,8784,18000
train,2906,16,12288,109,15696,27984
train,2907,18,13824,138,19872,33696
train,2908,16,12288,109,15696,27984
train,2909,17,13056,123,17712,30768
train,2910,20,15360,170,24480,39840
train,2911,18,13824,138,19872,33696
train,2912,11,8448,52,7488,15936
train,2913,13,9984,72,10368,20352
train,2914,27,20736,310,44640,65376
train,2915,12,9216,61,8784,18000
train,2916,26,19968,288,41472,61440
train,2917,10,7680,43,6192,13872
train,2918,5,3840,11,1584,5424
train,2919,24,18432,245,35280,53712
train,2920,7,5376,21,3024,8400
train,2921,34,26112,492,70848,96960
train,2922,25,19200,266,38304,57504
train,2923,22,16896,206,29664,46560
train,2924,18,13824,138,19872,33696
train,2925,16,12288,109,15696,27984
train,2926,25,19200,266,38304,57504
train,2927,10,7680,43,6192,13872
train,2928,36,27648,552,79488,107136
train,2929,7,5376,21,3024,8400
train,2930,25,19200,266,38304,57504
train,2931,15,11520,96,13824,25344
train,2932,21,16128,188,27072,43200
train,2933,13,9984,72,10368,20352
train,2934,34,26112,492,70848,96960
train,2935,36,27648,552,79488,107136
train,2936,26,19968,288,41472,61440
train,2937,16,12288,109,15696,27984
train,2938,40,30720,681,98064,128784
train,2939,21,16128,188,27072,43200
train,2940,14,10752,84,12096,22848
train,2941,21,16128,188,27072,43200
train,2942,16,12288,109,15696,27984
train,2943,11,8448,52,7488,15936
train,2944,8,6144,27,3888,10032
train,2945,32,24576,436,62784,87360
train,2946,33,25344,464,66816,92160
train,2947,24,18432,245,35280,53712
train,2948,18,13824,138,19872,33696
train,2949,24,18432,245,35280,53712
train,2950,6,4608,15,2160,6768
train,2951,18,13824,138,19872,33696
train,2952,14,10752,84,12096,22848
train,2953,26,19968,288,41472,61440
train,2954,17,13056,123,17712,30768
train,2955,36,27648,552,79488,107136
train,2956,26,19968,288,41472,61440
train,2957,38,29184,615,88560,117744
train,2958,27,20736,310,44640,65376
train,2959,27,20736,310,44640,65376
train,2960,3,2304,4,576,2880
train,2961,16,12288,109,15696,27984
train,2962,32,24576,436,62784,87360
train,2963,13,9984,72,10368,20352
train,2964,4,3072,7,1008,4080
train,2965,28,21504,334,48096,69600
train,2966,22,16896,206,29664,46560
train,2967,20,15360,170,24480,39840
train,2968,25,19200,266,38304,57504
train,2969,21,16128,188,27072,43200
train,2970,17,13056,123,17712,30768
train,2971,18,13824,138,19872,33696
train,2972,15,11520,96,13824,25344
train,2973,22,16896,206,29664,46560
train,2974,28,21504,334,48096,69600
train,2975,16,12288,109,15696,27984
train,2976,29,22272,358,51552,73824
train,2977,42,32256,751,108144,140400
train,2978,36,27648,552,79488,107136
train,2979,32,24576,436,62784,87360
train,2980,22,16896,206,29664,46560
train,2981,11,8448,52,7488,15936
train,2982,17,13056,123,17712,30768
train,2983,33,25344,464,66816,92160
train,2984,15,11520,96,13824,25344
train,2985,13,9984,72,10368,20352
train,2986,21,16128,188,27072,43200
train,2987,35,26880,522,75168,102048
train,2988,18,13824,138,19872,33696
train,2989,21,16128,188,27072,43200
train,2990,28,21504,334,48096,69600
train,2991,16,12288,109,15696,27984
train,2992,11,8448,52,7488,15936
train,2993,7,5376,21,3024,8400
train,2994,14,10752,84,12096,22848
train,2995,27,20736,310,44640,65376
train,2996,22,16896,206,29664,46560
train,2997,15,11520,96,13824,25344
train,2998,3,2304,4,576,2880
train,2999,20,15360,170,24480,39840
train,3000,3,2304,4,576,2880
train,3001,42,32256,751,108144,140400
train,3002,27,20736,310,44640,65376
train,3003,33,25344,464,66816,92160
train,3004,6,4608,15,2160,6768
train,3005,12,9216,61,8784,18000
train,3006,34,26112,492,70848,96960
train,3007,15,11520,96,13824,25344
train,3008,24,18432,245,35280,53712
train,3009,12,9216,61,8784,18000
train,3010,32,24576,436,62784,87360
train,3011,4,3072,7,1008,4080
train,3012,11,8448,52,7488,15936
train,3013,14,10752,84,12096,22848
train,3014,10,7680,43,6192,13872
train,3015,6,4608,15,2160,6768
train,3016,16,12288,109,15696,27984
train,3017,6,4608,15,2160,6768
train,3018,13,9984,72,10368,20352
train,3019,2,1536,2,288,1824
train,3020,20,15360,170,24480,39840
train,3021,19,14592,154,22176,36768
train,3022,5,3840,11,1584,5424
train,3023,15,11520,96,13824,25344
train,3024,17,13056,123,17712,30768
train,3025,28,21504,334,48096,69600
train,3026,30,23040,383,55152,78192
train,3027,6,4608,15,2160,6768
train,3028,22,16896,206,29664,46560
train,3029,36,27648,552,79488,107136
train,3030,6,4608,15,2160,6768
train,3031,26,19968,288,41472,61440
train,3032,19,14592,154,22176,36768
train,3033,37,28416,615,88560,116976
train,3034,30,23040,383,55152,78192
train,3035,22,16896,206,29664,46560
train,3036,10,7680,43,6192,13872
train,3037,22,16896,206,29664,46560
train,3038,24,18432,245,35280,53712
train,3039,14,10752,84,12096,22848
train,3040,20,15360,170,24480,39840
train,3041,12,9216,61,8784,18000
train,3042,24,18432,245,35280,53712
train,3043,14,10752,84,12096,22848
train,3044,19,14592,154,22176,36768
train,3045,8,6144,27,3888,10032
train,3046,27,20736,310,44640,65376
train,3047,33,25344,492,70848,96192
train,3048,13,9984,72,10368,20352
train,3049,17,13056,123,17712,30768
train,3050,14,10752,84,12096,22848
train,3051,27,20736,310,44640,65376
train,3052,31,23808,436,62784,86592
train,3053,41,31488,716,103104,134592
train,3054,32,24576,436,62784,87360
train,3055,30,23040,383,55152,78192
train,3056,23,17664,225,32400,50064
train,3057,10,7680,43,6192,13872
train,3058,22,16896,206,29664,46560
train,3059,20,15360,170,24480,39840
train,3060,5,3840,11,1584,5424
train,3061,14,10752,84,12096,22848
train,3062,15,11520,96,13824,25344
train,3063,44,33792,824,118656,152448
train,3064,21,16128,188,27072,43200
train,3065,30,23040,383,55152,78192
train,3066,25,19200,266,38304,57504
train,3067,31,23808,409,58896,82704
train,3068,23,17664,225,32400,50064
train,3069,25,19200,266,38304,57504
train,3070,29,22272,358,51552,73824
train,3071,14,10752,84,12096,22848
train,3072,43,33024,787,113328,146352
train,3073,10,7680,43,6192,13872
train,3074,26,19968,288,41472,61440
train,3075,21,16128,188,27072,43200
train,3076,14,10752,84,12096,22848
train,3077,12,9216,61,8784,18000
train,3078,3,2304,4,576,2880
train,3079,19,14592,154,22176,36768
train,3080,10,7680,43,6192,13872
train,3081,11,8448,52,7488,15936
train,3082,14,10752,84,12096,22848
train,3083,33,25344,464,66816,92160
train,3084,14,10752,84,12096,22848
train,3085,13,9984,72,10368,20352
train,3086,13,9984,72,10368,20352
train,3087,22,16896,206,29664,46560
train,3088,31,23808,409,58896,82704
train,3089,12,9216,61,8784,18000
train,3090,17,13056,123,17712,30768
train,3091,26,19968,288,41472,61440
train,3092,41,31488,716,103104,134592
train,3093,14,10752,84,12096,22848
train,3094,17,13056,123,17712,30768
train,3095,4,3072,7,1008,4080
train,3096,9,6912,35,5040,11952
train,3097,25,19200,266,38304,57504
train,3098,34,26112,492,70848,96960
train,3099,18,13824,138,19872,33696
train,3100,5,3840,11,1584,5424
train,3101,26,19968,288,41472,61440
train,3102,32,24576,436,62784,87360
train,3103,37,28416,583,83952,112368
train,3104,27,20736,310,44640,65376
train,3105,23,17664,225,32400,50064
train,3106,22,16896,206,29664,46560
train,3107,26,19968,288,41472,61440
train,3108,9,6912,35,5040,11952
train,3109,9,6912,35,5040,11952
train,3110,26,19968,288,41472,61440
train,3111,36,27648,552,79488,107136
train,3112,19,14592,154,22176,36768
train,3113,13,9984,72,10368,20352
train,3114,17,13056,123,17712,30768
train,3115,24,18432,245,35280,53712
train,3116,19,14592,154,22176,36768
train,3117,34,26112,492,70848,96960
train,3118,20,15360,170,24480,39840
train,3119,10,7680,43,6192,13872
train,3120,3,2304,4,576,2880
train,3121,19,14592,154,22176,36768
train,3122,32,24576,436,62784,87360
train,3123,6,4608,15,2160,6768
train,3124,36,27648,552,79488,107136
train,3125,15,11520,96,13824,25344
train,3126,16,12288,109,15696,27984
train,3127,26,19968,288,41472,61440
train,3128,23,17664,225,32400,50064
train,3129,28,21504,334,48096,69600
train,3130,27,20736,310,44640,65376
train,3131,19,14592,154,22176,36768
train,3132,41,31488,716,103104,134592
train,3133,15,11520,96,13824,25344
train,3134,25,19200,266,38304,57504
train,3135,26,19968,288,41472,61440
train,3136,17,13056,123,17712,30768
train,3137,33,25344,464,66816,92160
train,3138,20,15360,170,24480,39840
train,3139,19,14592,154,22176,36768
train,3140,43,33024,787,113328,146352
train,3141,30,23040,383,55152,78192
train,3142,23,17664,225,32400,50064
train,3143,17,13056,123,17712,30768
train,3144,34,26112,492,70848,96960
train,3145,30,23040,383,55152,78192
train,3146,17,13056,123,17712,30768
train,3147,27,20736,310,44640,65376
train,3148,5,3840,11,1584,5424
train,3149,33,25344,464,66816,92160
train,3150,11,8448,52,7488,15936
train,3151,12,9216,61,8784,18000
train,3152,19,14592,154,22176,36768
train,3153,17,13056,123,17712,30768
train,3154,17,13056,123,17712,30768
train,3155,18,13824,138,19872,33696
train,3156,34,26112,492,70848,96960
train,3157,21,16128,188,27072,43200
train,3158,27,20736,310,44640,65376
train,3159,19,14592,154,22176,36768
train,3160,33,25344,464,66816,92160
train,3161,25,19200,266,38304,57504
train,3162,12,9216,61,8784,18000
train,3163,11,8448,52,7488,15936
train,3164,22,16896,206,29664,46560
train,3165,7,5376,21,3024,8400
train,3166,41,31488,716,103104,134592
train,3167,17,13056,123,17712,30768
train,3168,26,19968,288,41472,61440
train,3169,22,16896,206,29664,46560
train,3170,42,32256,751,108144,140400
train,3171,14,10752,84,12096,22848
train,3172,12,9216,61,8784,18000
train,3173,24,18432,245,35280,53712
train,3174,11,8448,52,7488,15936
train,3175,11,8448,52,7488,15936
train,3176,25,19200,266,38304,57504
train,3177,54,41472,1241,178704,220176
train,3178,32,24576,436,62784,87360
train,3179,14,10752,84,12096,22848
train,3180,23,17664,225,32400,50064
train,3181,17,13056,123,17712,30768
train,3182,24,18432,245,35280,53712
train,3183,32,24576,436,62784,87360
train,3184,14,10752,84,12096,22848
train,3185,16,12288,109,15696,27984
train,3186,28,21504,334,48096,69600
train,3187,22,16896,206,29664,46560
train,3188,6,4608,15,2160,6768
train,3189,25,19200,266,38304,57504
train,3190,16,12288,109,15696,27984
train,3191,23,17664,225,32400,50064
train,3192,15,11520,96,13824,25344
train,3193,16,12288,109,15696,27984
train,3194,33,25344,464,66816,92160
train,3195,6,4608,15,2160,6768
train,3196,13,9984,72,10368,20352
train,3197,13,9984,72,10368,20352
train,3198,28,21504,334,48096,69600
train,3199,10,7680,43,6192,13872
train,3200,19,14592,154,22176,36768
train,3201,9,6912,35,5040,11952
train,3202,26,19968,288,41472,61440
train,3203,11,8448,52,7488,15936
train,3204,43,33024,787,113328,146352
train,3205,12,9216,61,8784,18000
train,3206,17,13056,123,17712,30768
train,3207,34,26112,492,70848,96960
train,3208,20,15360,170,24480,39840
train,3209,5,3840,11,1584,5424
train,3210,38,29184,615,88560,117744
train,3211,26,19968,288,41472,61440
train,3212,7,5376,21,3024,8400
train,3213,11,8448,52,7488,15936
train,3214,27,20736,310,44640,65376
train,3215,21,16128,188,27072,43200
train,3216,20,15360,170,24480,39840
train,3217,23,17664,225,32400,50064
train,3218,23,17664,225,32400,50064
train,3219,16,12288,109,15696,27984
train,3220,11,8448,52,7488,15936
train,3221,19,14592,154,22176,36768
train,3222,3,2304,7,1008,3312
train,3223,36,27648,552,79488,107136
train,3224,8,6144,27,3888,10032
train,3225,34,26112,522,75168,101280
train,3226,8,6144,27,3888,10032
train,3227,21,16128,188,27072,43200
train,3228,20,15360,170,24480,39840
train,3229,20,15360,170,24480,39840
train,3230,20,15360,170,24480,39840
train,3231,7,5376,21,3024,8400
train,3232,21,16128,188,27072,43200
train,3233,12,9216,61,8784,18000
train,3234,17,13056,123,17712,30768
train,3235,15,11520,96,13824,25344
train,3236,15,11520,96,13824,25344
train,3237,30,23040,383,55152,78192
train,3238,8,6144,27,3888,10032
train,3239,27,20736,310,44640,65376
train,3240,10,7680,43,6192,13872
train,3241,9,6912,35,5040,11952
train,3242,16,12288,109,15696,27984
train,3243,18,13824,170,24480,38304
train,3244,19,14592,154,22176,36768
train,3245,11,8448,52,7488,15936
train,3246,27,20736,310,44640,65376
train,3247,20,15360,170,24480,39840
train,3248,16,12288,109,15696,27984
train,3249,17,13056,123,17712,30768
train,3250,17,13056,123,17712,30768
train,3251,31,23808,409,58896,82704
train,3252,6,4608,15,2160,6768
train,3253,39,29952,648,93312,123264
train,3254,38,29184,615,88560,117744
train,3255,38,29184,615,88560,117744
train,3256,29,22272,358,51552,73824
train,3257,27,20736,334,48096,68832
train,3258,13,9984,84,12096,22080
train,3259,32,24576,436,62784,87360
train,3260,31,23808,409,58896,82704
train,3261,18,13824,138,19872,33696
train,3262,35,26880,522,75168,102048
train,3263,20,15360,170,24480,39840
train,3264,17,13056,123,17712,30768
train,3265,16,12288,109,15696,27984
train,3266,30,23040,383,55152,78192
train,3267,14,10752,84,12096,22848
train,3268,20,15360,170,24480,39840
train,3269,33,25344,464,66816,92160
train,3270,27,20736,310,44640,65376
train,3271,26,19968,288,41472,61440
train,3272,15,11520,96,13824,25344
train,3273,12,9216,61,8784,18000
train,3274,19,14592,154,22176,36768
train,3275,16,12288,109,15696,27984
train,3276,4,3072,7,1008,4080
train,3277,41,31488,716,103104,134592
train,3278,31,23808,409,58896,82704
train,3279,35,26880,522,75168,102048
train,3280,22,16896,206,29664,46560
train,3281,17,13056,123,17712,30768
train,3282,8,6144,27,3888,10032
train,3283,25,19200,266,38304,57504
train,3284,8,6144,27,3888,10032
train,3285,15,11520,96,13824,25344
train,3286,15,11520,96,13824,25344
train,3287,19,14592,154,22176,36768
train,3288,15,11520,96,13824,25344
train,3289,21,16128,188,27072,43200
train,3290,16,12288,109,15696,27984
train,3291,30,23040,383,55152,78192
train,3292,29,22272,358,51552,73824
train,3293,6,4608,15,2160,6768
train,3294,17,13056,123,17712,30768
train,3295,48,36864,981,141264,178128
train,3296,5,3840,11,1584,5424
train,3297,12,9216,61,8784,18000
train,3298,12,9216,61,8784,18000
train,3299,9,6912,35,5040,11952
train,3300,47,36096,940,135360,171456
train,3301,23,17664,225,32400,50064
train,3302,15,11520,96,13824,25344
train,3303,20,15360,170,24480,39840
train,3304,17,13056,138,19872,32928
train,3305,27,20736,310,44640,65376
train,3306,17,13056,123,17712,30768
train,3307,24,18432,245,35280,53712
train,3308,5,3840,11,1584,5424
train,3309,8,6144,27,3888,10032
train,3310,7,5376,21,3024,8400
train,3311,11,8448,52,7488,15936
train,3312,7,5376,21,3024,8400
train,3313,29,22272,358,51552,73824
train,3314,10,7680,43,6192,13872
train,3315,4,3072,7,1008,4080
train,3316,16,12288,109,15696,27984
train,3317,34,26112,492,70848,96960
train,3318,12,9216,61,8784,18000
train,3319,30,23040,383,55152,78192
train,3320,23,17664,225,32400,50064
train,3321,24,18432,245,35280,53712
train,3322,26,19968,288,41472,61440
train,3323,13,9984,72,10368,20352
train,3324,24,18432,245,35280,53712
train,3325,18,13824,138,19872,33696
train,3326,22,16896,225,32400,49296
train,3327,35,26880,552,79488,106368
train,3328,34,26112,492,70848,96960
train,3329,17,13056,123,17712,30768
train,3330,13,9984,72,10368,20352
train,3331,12,9216,61,8784,18000
train,3332,25,19200,266,38304,57504
train,3333,17,13056,123,17712,30768
train,3334,32,24576,436,62784,87360
train,3335,21,16128,188,27072,43200
train,3336,23,17664,225,32400,50064
train,3337,25,19200,266,38304,57504
train,3338,29,22272,358,51552,73824
train,3339,37,28416,583,83952,112368
train,3340,21,16128,188,27072,43200
train,3341,13,9984,72,10368,20352
train,3342,23,17664,225,32400,50064
train,3343,21,16128,188,27072,43200
train,3344,10,7680,43,6192,13872
train,3345,16,12288,109,15696,27984
train,3346,7,5376,27,3888,9264
train,3347,18,13824,138,19872,33696
train,3348,9,6912,35,5040,11952
train,3349,34,26112,492,70848,96960
train,3350,4,3072,7,1008,4080
train,3351,33,25344,464,66816,92160
train,3352,6,4608,15,2160,6768
train,3353,43,33024,787,113328,146352
train,3354,12,9216,61,8784,18000
train,3355,16,12288,109,15696,27984
train,3356,17,13056,123,17712,30768
train,3357,15,11520,96,13824,25344
train,3358,31,23808,409,58896,82704
train,3359,10,7680,43,6192,13872
train,3360,18,13824,138,19872,33696
train,3361,22,16896,206,29664,46560
train,3362,7,5376,21,3024,8400
train,3363,33,25344,464,66816,92160
train,3364,16,12288,109,15696,27984
train,3365,17,13056,123,17712,30768
train,3366,4,3072,7,1008,4080
train,3367,16,12288,109,15696,27984
train,3368,35,26880,522,75168,102048
train,3369,28,21504,334,48096,69600
train,3370,12,9216,61,8784,18000
train,3371,45,34560,862,124128,158688
train,3372,10,7680,52,7488,15168
train,3373,31,23808,409,58896,82704
train,3374,19,14592,154,22176,36768
train,3375,27,20736,310,44640,65376
train,3376,35,26880,522,75168,102048
train,3377,8,6144,27,3888,10032
train,3378,37,28416,583,83952,112368
train,3379,29,22272,358,51552,73824
train,3380,14,10752,84,12096,22848
train,3381,8,6144,27,3888,10032
train,3382,21,16128,188,27072,43200
train,3383,23,17664,225,32400,50064
train,3384,26,19968,288,41472,61440
train,3385,28,21504,334,48096,69600
train,3386,6,4608,15,2160,6768
train,3387,22,16896,206,29664,46560
train,3388,19,14592,154,22176,36768
train,3389,19,14592,154,22176,36768
train,3390,18,13824,138,19872,33696
train,3391,33,25344,464,66816,92160
train,3392,16,12288,109,15696,27984
train,3393,17,13056,123,17712,30768
train,3394,14,10752,84,12096,22848
train,3395,19,14592,154,22176,36768
train,3396,20,15360,170,24480,39840
train,3397,39,29952,648,93312,123264
train,3398,14,10752,84,12096,22848
train,3399,25,19200,266,38304,57504
train,3400,21,16128,188,27072,43200
train,3401,17,13056,123,17712,30768
train,3402,17,13056,123,17712,30768
train,3403,31,23808,409,58896,82704
train,3404,17,13056,123,17712,30768
train,3405,20,15360,170,24480,39840
train,3406,2,1536,2,288,1824
train,3407,8,6144,27,3888,10032
train,3408,26,19968,288,41472,61440
train,3409,21,16128,188,27072,43200
train,3410,29,22272,358,51552,73824
train,3411,42,32256,787,113328,145584
train,3412,10,7680,52,7488,15168
train,3413,9,6912,43,6192,13104
train,3414,40,30720,681,98064,128784
train,3415,21,16128,188,27072,43200
train,3416,17,13056,123,17712,30768
train,3417,39,29952,648,93312,123264
train,3418,35,26880,522,75168,102048
train,3419,7,5376,21,3024,8400
train,3420,26,19968,288,41472,61440
train,3421,4,3072,7,1008,4080
train,3422,30,23040,383,55152,78192
train,3423,30,23040,383,55152,78192
train,3424,36,27648,552,79488,107136
train,3425,22,16896,206,29664,46560
train,3426,29,22272,358,51552,73824
train,3427,13,9984,72,10368,20352
train,3428,17,13056,123,17712,30768
train,3429,5,3840,11,1584,5424
train,3430,19,14592,154,22176,36768
train,3431,4,3072,7,1008,4080
train,3432,29,22272,358,51552,73824
train,3433,34,26112,492,70848,96960
train,3434,14,10752,84,12096,22848
train,3435,16,12288,109,15696,27984
train,3436,25,19200,266,38304,57504
train,3437,30,23040,383,55152,78192
train,3438,16,12288,109,15696,27984
train,3439,7,5376,21,3024,8400
train,3440,17,13056,123,17712,30768
train,3441,26,19968,288,41472,61440
train,3442,17,13056,123,17712,30768
train,3443,16,12288,109,15696,27984
train,3444,13,9984,72,10368,20352
train,3445,20,15360,170,24480,39840
train,3446,21,16128,188,27072,43200
train,3447,37,28416,583,83952,112368
train,3448,24,18432,245,35280,53712
train,3449,2,1536,2,288,1824
train,3450,14,10752,84,12096,22848
train,3451,35,26880,522,75168,102048
train,3452,18,13824,138,19872,33696
train,3453,9,6912,35,5040,11952
train,3454,30,23040,383,55152,78192
train,3455,29,22272,358,51552,73824
train,3456,10,7680,43,6192,13872
train,3457,15,11520,96,13824,25344
train,3458,8,6144,27,3888,10032
train,3459,31,23808,409,58896,82704
train,3460,40,30720,681,98064,128784
train,3461,28,21504,334,48096,69600
train,3462,26,19968,288,41472,61440
train,3463,14,10752,84,12096,22848
train,3464,13,9984,72,10368,20352
train,3465,35,26880,522,75168,102048
train,3466,26,19968,288,41472,61440
train,3467,26,19968,288,41472,61440
train,3468,15,11520,96,13824,25344
train,3469,11,8448,52,7488,15936
train,3470,12,9216,61,8784,18000
train,3471,20,15360,188,27072,42432
train,3472,28,21504,334,48096,69600
train,3473,6,4608,15,2160,6768
train,3474,33,25344,464,66816,92160
train,3475,11,8448,52,7488,15936
train,3476,10,7680,43,6192,13872
train,3477,25,19200,266,38304,57504
train,3478,27,20736,310,44640,65376
train,3479,19,14592,154,22176,36768
train,3480,10,7680,43,6192,13872
train,3481,32,24576,436,62784,87360
train,3482,26,19968,288,41472,61440
train,3483,29,22272,358,51552,73824
train,3484,17,13056,123,17712,30768
train,3485,27,20736,334,48096,68832
train,3486,29,22272,358,51552,73824
train,3487,17,13056,123,17712,30768
train,3488,35,26880,522,75168,102048
train,3489,15,11520,96,13824,25344
train,3490,36,27648,552,79488,107136
train,3491,36,27648,552,79488,107136
train,3492,8,6144,27,3888,10032
train,3493,39,29952,648,93312,123264
train,3494,14,10752,84,12096,22848
train,3495,5,3840,11,1584,5424
train,3496,9,6912,35,5040,11952
train,3497,24,18432,245,35280,53712
train,3498,17,13056,123,17712,30768
train,3499,18,13824,138,19872,33696
train,3500,19,14592,154,22176,36768
train,3501,23,17664,225,32400,50064
train,3502,16,12288,109,15696,27984
train,3503,24,18432,266,38304,56736
train,3504,31,23808,409,58896,82704
train,3505,20,15360,170,24480,39840
train,3506,25,19200,266,38304,57504
train,3507,36,27648,552,79488,107136
train,3508,8,6144,27,3888,10032
train,3509,15,11520,96,13824,25344
train,3510,19,14592,154,22176,36768
train,3511,16,12288,109,15696,27984
train,3512,26,19968,288,41472,61440
train,3513,21,16128,188,27072,43200
train,3514,28,21504,334,48096,69600
train,3515,8,6144,27,3888,10032
train,3516,32,24576,436,62784,87360
train,3517,29,22272,358,51552,73824
train,3518,8,6144,27,3888,10032
train,3519,9,6912,35,5040,11952
train,3520,16,12288,109,15696,27984
train,3521,23,17664,225,32400,50064
train,3522,9,6912,35,5040,11952
train,3523,9,6912,35,5040,11952
train,3524,11,8448,52,7488,15936
train,3525,19,14592,154,22176,36768
train,3526,29,22272,358,51552,73824
train,3527,8,6144,27,3888,10032
train,3528,8,6144,27,3888,10032
train,3529,23,17664,225,32400,50064
train,3530,20,15360,170,24480,39840
train,3531,6,4608,15,2160,6768
train,3532,20,15360,170,24480,39840
train,3533,18,13824,138,19872,33696
train,3534,7,5376,21,3024,8400
train,3535,6,4608,15,2160,6768
train,3536,23,17664,225,32400,50064
train,3537,17,13056,123,17712,30768
train,3538,28,21504,334,48096,69600
train,3539,16,12288,109,15696,27984
train,3540,43,33024,787,113328,146352
train,3541,21,16128,188,27072,43200
train,3542,19,14592,154,22176,36768
train,3543,30,23040,383,55152,78192
train,3544,7,5376,21,3024,8400
train,3545,18,13824,138,19872,33696
train,3546,9,6912,35,5040,11952
train,3547,5,3840,11,1584,5424
train,3548,20,15360,170,24480,39840
train,3549,16,12288,109,15696,27984
train,3550,31,23808,409,58896,82704
train,3551,19,14592,154,22176,36768
train,3552,12,9216,61,8784,18000
train,3553,24,18432,245,35280,53712
train,3554,28,21504,334,48096,69600
train,3555,34,26112,492,70848,96960
train,3556,14,10752,84,12096,22848
train,3557,23,17664,225,32400,50064
train,3558,18,13824,138,19872,33696
train,3559,6,4608,15,2160,6768
train,3560,24,18432,245,35280,53712
train,3561,10,7680,43,6192,13872
train,3562,22,16896,206,29664,46560
train,3563,26,19968,288,41472,61440
train,3564,19,14592,154,22176,36768
train,3565,22,16896,206,29664,46560
train,3566,22,16896,206,29664,46560
train,3567,17,13056,123,17712,30768
train,3568,6,4608,15,2160,6768
train,3569,27,20736,310,44640,65376
train,3570,22,16896,206,29664,46560
train,3571,16,12288,109,15696,27984
train,3572,14,10752,84,12096,22848
train,3573,26,19968,288,41472,61440
train,3574,12,9216,61,8784,18000
train,3575,22,16896,206,29664,46560
train,3576,32,24576,436,62784,87360
train,3577,27,20736,310,44640,65376
train,3578,8,6144,27,3888,10032
train,3579,14,10752,84,12096,22848
train,3580,24,18432,245,35280,53712
train,3581,14,10752,84,12096,22848
train,3582,21,16128,188,27072,43200
train,3583,8,6144,27,3888,10032
train,3584,18,13824,138,19872,33696
train,3585,14,10752,84,12096,22848
train,3586,19,14592,154,22176,36768
train,3587,14,10752,84,12096,22848
train,3588,25,19200,266,38304,57504
train,3589,18,13824,138,19872,33696
train,3590,8,6144,27,3888,10032
train,3591,6,4608,15,2160,6768
train,3592,40,30720,681,98064,128784
train,3593,28,21504,334,48096,69600
train,3594,32,24576,436,62784,87360
train,3595,19,14592,154,22176,36768
train,3596,15,11520,96,13824,25344
train,3597,16,12288,109,15696,27984
train,3598,24,18432,245,35280,53712
train,3599,8,6144,27,3888,10032
train,3600,22,16896,206,29664,46560
train,3601,23,17664,225,32400,50064
train,3602,10,7680,43,6192,13872
train,3603,28,21504,334,48096,69600
train,3604,38,29184,615,88560,117744
train,3605,14,10752,84,12096,22848
train,3606,35,26880,522,75168,102048
train,3607,42,32256,751,108144,140400
train,3608,17,13056,123,17712,30768
train,3609,10,7680,43,6192,13872
train,3610,17,13056,123,17712,30768
train,3611,17,13056,123,17712,30768
train,3612,24,18432,245,35280,53712
train,3613,30,23040,383,55152,78192
train,3614,31,23808,409,58896,82704
train,3615,23,17664,225,32400,50064
train,3616,19,14592,170,24480,39072
train,3617,23,17664,225,32400,50064
train,3618,28,21504,334,48096,69600
train,3619,38,29184,615,88560,117744
train,3620,24,18432,245,35280,53712
train,3621,13,9984,72,10368,20352
train,3622,25,19200,266,38304,57504
train,3623,27,20736,310,44640,65376
train,3624,13,9984,72,10368,20352
train,3625,12,9216,61,8784,18000
train,3626,18,13824,138,19872,33696
train,3627,28,21504,334,48096,69600
train,3628,20,15360,170,24480,39840
train,3629,21,16128,188,27072,43200
train,3630,11,8448,52,7488,15936
train,3631,10,7680,43,6192,13872
train,3632,11,8448,52,7488,15936
train,3633,9,6912,35,5040,11952
train,3634,20,15360,170,24480,39840
train,3635,12,9216,61,8784,18000
train,3636,19,14592,154,22176,36768
train,3637,34,26112,492,70848,96960
train,3638,17,13056,123,17712,30768
train,3639,25,19200,266,38304,57504
train,3640,13,9984,72,10368,20352
train,3641,29,22272,358,51552,73824
train,3642,28,21504,334,48096,69600
train,3643,27,20736,310,44640,65376
train,3644,31,23808,409,58896,82704
train,3645,7,5376,21,3024,8400
train,3646,16,12288,109,15696,27984
train,3647,32,24576,436,62784,87360
train,3648,10,7680,43,6192,13872
train,3649,19,14592,154,22176,36768
train,3650,8,6144,27,3888,10032
train,3651,18,13824,138,19872,33696
train,3652,23,17664,225,32400,50064
train,3653,28,21504,334,48096,69600
train,3654,10,7680,43,6192,13872
train,3655,20,15360,170,24480,39840
train,3656,26,19968,288,41472,61440
train,3657,22,16896,206,29664,46560
train,3658,29,22272,358,51552,73824
train,3659,25,19200,266,38304,57504
train,3660,22,16896,206,29664,46560
train,3661,3,2304,4,576,2880
train,3662,29,22272,358,51552,73824
train,3663,20,15360,170,24480,39840
train,3664,11,8448,52,7488,15936
train,3665,18,13824,138,19872,33696
train,3666,26,19968,288,41472,61440
train,3667,40,30720,681,98064,128784
train,3668,23,17664,225,32400,50064
train,3669,20,15360,170,24480,39840
train,3670,21,16128,188,27072,43200
train,3671,18,13824,138,19872,33696
train,3672,26,19968,288,41472,61440
train,3673,27,20736,310,44640,65376
train,3674,40,30720,681,98064,128784
train,3675,20,15360,170,24480,39840
train,3676,25,19200,266,38304,57504
train,3677,6,4608,15,2160,6768
train,3678,7,5376,21,3024,8400
train,3679,14,10752,84,12096,22848
train,3680,30,23040,383,55152,78192
train,3681,16,12288,109,15696,27984
train,3682,10,7680,43,6192,13872
train,3683,14,10752,84,12096,22848
train,3684,22,16896,206,29664,46560
train,3685,21,16128,188,27072,43200
train,3686,10,7680,43,6192,13872
train,3687,22,16896,206,29664,46560
train,3688,29,22272,358,51552,73824
train,3689,20,15360,170,24480,39840
train,3690,28,21504,334,48096,69600
train,3691,33,25344,464,66816,92160
train,3692,13,9984,72,10368,20352
train,3693,44,33792,824,118656,152448
train,3694,14,10752,84,12096,22848
train,3695,20,15360,170,24480,39840
train,3696,18,13824,138,19872,33696
train,3697,26,19968,288,41472,61440
train,3698,13,9984,72,10368,20352
train,3699,19,14592,154,22176,36768
train,3700,18,13824,138,19872,33696
train,3701,27,20736,310,44640,65376
train,3702,37,28416,583,83952,112368
train,3703,35,26880,522,75168,102048
train,3704,19,14592,154,22176,36768
train,3705,36,27648,552,79488,107136
train,3706,17,13056,123,17712,30768
train,3707,26,19968,310,44640,64608
train,3708,14,10752,84,12096,22848
train,3709,30,23040,383,55152,78192
train,3710,33,25344,464,66816,92160
train,3711,19,14592,154,22176,36768
train,3712,14,10752,84,12096,22848
train,3713,36,27648,552,79488,107136
train,3714,22,16896,206,29664,46560
train,3715,29,22272,358,51552,73824
train,3716,17,13056,123,17712,30768
train,3717,47,36096,940,135360,171456
train,3718,23,17664,225,32400,50064
train,3719,18,13824,138,19872,33696
train,3720,21,16128,188,27072,43200
train,3721,22,16896,206,29664,46560
train,3722,12,9216,72,10368,19584
train,3723,17,13056,123,17712,30768
train,3724,20,15360,170,24480,39840
train,3725,33,25344,464,66816,92160
train,3726,28,21504,334,48096,69600
train,3727,4,3072,7,1008,4080
train,3728,9,6912,35,5040,11952
train,3729,13,9984,84,12096,22080
train,3730,38,29184,648,93312,122496
train,3731,18,13824,138,19872,33696
train,3732,16,12288,109,15696,27984
train,3733,22,16896,206,29664,46560
train,3734,29,22272,358,51552,73824
train,3735,18,13824,138,19872,33696
train,3736,43,33024,787,113328,146352
train,3737,21,16128,188,27072,43200
train,3738,22,16896,225,32400,49296
train,3739,19,14592,154,22176,36768
train,3740,19,14592,154,22176,36768
train,3741,27,20736,310,44640,65376
train,3742,22,16896,225,32400,49296
train,3743,30,23040,383,55152,78192
train,3744,39,29952,681,98064,128016
train,3745,22,16896,206,29664,46560
train,3746,25,19200,266,38304,57504
train,3747,41,31488,716,103104,134592
train,3748,9,6912,35,5040,11952
train,3749,23,17664,225,32400,50064
train,3750,10,7680,43,6192,13872
train,3751,27,20736,310,44640,65376
train,3752,35,26880,522,75168,102048
train,3753,17,13056,123,17712,30768
train,3754,20,15360,170,24480,39840
train,3755,19,14592,154,22176,36768
train,3756,18,13824,138,19872,33696
train,3757,8,6144,27,3888,10032
train,3758,9,6912,35,5040,11952
train,3759,39,29952,648,93312,123264
train,3760,12,9216,61,8784,18000
train,3761,20,15360,170,24480,39840
train,3762,9,6912,35,5040,11952
train,3763,23,17664,225,32400,50064
train,3764,9,6912,35,5040,11952
train,3765,31,23808,409,58896,82704
train,3766,32,24576,436,62784,87360
train,3767,28,21504,334,48096,69600
train,3768,20,15360,170,24480,39840
train,3769,22,16896,206,29664,46560
train,3770,9,6912,35,5040,11952
train,3771,15,11520,96,13824,25344
train,3772,27,20736,310,44640,65376
train,3773,10,7680,43,6192,13872
train,3774,11,8448,52,7488,15936
train,3775,29,22272,358,51552,73824
train,3776,20,15360,170,24480,39840
train,3777,47,36096,940,135360,171456
train,3778,51,39168,1107,159408,198576
train,3779,22,16896,206,29664,46560
train,3780,26,19968,288,41472,61440
train,3781,30,23040,383,55152,78192
train,3782,27,20736,310,44640,65376
train,3783,26,19968,288,41472,61440
train,3784,42,32256,751,108144,140400
train,3785,12,9216,61,8784,18000
train,3786,16,12288,109,15696,27984
train,3787,15,11520,96,13824,25344
train,3788,26,19968,288,41472,61440
train,3789,37,28416,583,83952,112368
train,3790,17,13056,123,17712,30768
train,3791,19,14592,154,22176,36768
train,3792,13,9984,72,10368,20352
train,3793,34,26112,492,70848,96960
train,3794,28,21504,334,48096,69600
train,3795,32,24576,436,62784,87360
train,3796,23,17664,225,32400,50064
train,3797,8,6144,27,3888,10032
train,3798,15,11520,96,13824,25344
train,3799,33,25344,464,66816,92160
train,3800,15,11520,96,13824,25344
train,3801,18,13824,138,19872,33696
train,3802,17,13056,123,17712,30768
train,3803,47,36096,940,135360,171456
train,3804,18,13824,138,19872,33696
train,3805,3,2304,4,576,2880
train,3806,20,15360,170,24480,39840
train,3807,12,9216,61,8784,18000
train,3808,11,8448,52,7488,15936
train,3809,15,11520,96,13824,25344
train,3810,27,20736,310,44640,65376
train,3811,39,29952,648,93312,123264
train,3812,21,16128,188,27072,43200
train,3813,15,11520,96,13824,25344
train,3814,16,12288,109,15696,27984
train,3815,39,29952,648,93312,123264
train,3816,27,20736,310,44640,65376
train,3817,9,6912,35,5040,11952
train,3818,9,6912,35,5040,11952
train,3819,33,25344,464,66816,92160
train,3820,24,18432,245,35280,53712
train,3821,16,12288,109,15696,27984
train,3822,14,10752,84,12096,22848
train,3823,23,17664,225,32400,50064
train,3824,21,16128,188,27072,43200
train,3825,22,16896,206,29664,46560
train,3826,17,13056,123,17712,30768
train,3827,22,16896,225,32400,49296
train,3828,21,16128,188,27072,43200
train,3829,28,21504,334,48096,69600
train,3830,17,13056,123,17712,30768
train,3831,11,8448,52,7488,15936
train,3832,15,11520,96,13824,25344
train,3833,33,25344,464,66816,92160
train,3834,16,12288,109,15696,27984
train,3835,4,3072,7,1008,4080
train,3836,12,9216,61,8784,18000
train,3837,13,9984,72,10368,20352
train,3838,43,33024,787,113328,146352
train,3839,19,14592,154,22176,36768
train,3840,24,18432,245,35280,53712
train,3841,26,19968,288,41472,61440
train,3842,28,21504,334,48096,69600
train,3843,23,17664,225,32400,50064
train,3844,31,23808,409,58896,82704
train,3845,8,6144,27,3888,10032
train,3846,26,19968,288,41472,61440
train,3847,20,15360,170,24480,39840
train,3848,47,36096,940,135360,171456
train,3849,9,6912,35,5040,11952
train,3850,24,18432,245,35280,53712
train,3851,18,13824,154,22176,36000
train,3852,21,16128,188,27072,43200
train,3853,25,19200,266,38304,57504
train,3854,11,8448,52,7488,15936
train,3855,11,8448,52,7488,15936
train,3856,22,16896,206,29664,46560
train,3857,23,17664,225,32400,50064
train,3858,20,15360,170,24480,39840
train,3859,11,8448,52,7488,15936
train,3860,23,17664,225,32400,50064
train,3861,33,25344,464,66816,92160
train,3862,26,19968,288,41472,61440
train,3863,31,23808,409,58896,82704
train,3864,15,11520,96,13824,25344
train,3865,23,17664,225,32400,50064
train,3866,34,26112,492,70848,96960
train,3867,36,27648,552,79488,107136
train,3868,28,21504,334,48096,69600
train,3869,16,12288,109,15696,27984
train,3870,33,25344,464,66816,92160
train,3871,19,14592,154,22176,36768
train,3872,11,8448,52,7488,15936
train,3873,3,2304,4,576,2880
train,3874,6,4608,15,2160,6768
train,3875,8,6144,27,3888,10032
train,3876,17,13056,123,17712,30768
train,3877,22,16896,206,29664,46560
train,3878,10,7680,43,6192,13872
train,3879,24,18432,245,35280,53712
train,3880,7,5376,21,3024,8400
train,3881,14,10752,84,12096,22848
train,3882,3,2304,4,576,2880
train,3883,20,15360,170,24480,39840
train,3884,38,29184,615,88560,117744
train,3885,27,20736,310,44640,65376
train,3886,17,13056,123,17712,30768
train,3887,33,25344,464,66816,92160
train,3888,27,20736,310,44640,65376
train,3889,18,13824,138,19872,33696
train,3890,19,14592,154,22176,36768
train,3891,12,9216,61,8784,18000
train,3892,16,12288,109,15696,27984
train,3893,6,4608,15,2160,6768
train,3894,20,15360,170,24480,39840
train,3895,32,24576,436,62784,87360
train,3896,39,29952,648,93312,123264
train,3897,10,7680,43,6192,13872
train,3898,26,19968,288,41472,61440
train,3899,21,16128,188,27072,43200
train,3900,5,3840,11,1584,5424
train,3901,24,18432,245,35280,53712
train,3902,21,16128,188,27072,43200
train,3903,17,13056,123,17712,30768
train,3904,21,16128,188,27072,43200
train,3905,7,5376,27,3888,9264
train,3906,23,17664,225,32400,50064
train,3907,9,6912,35,5040,11952
train,3908,26,19968,288,41472,61440
train,3909,6,4608,15,2160,6768
train,3910,17,13056,123,17712,30768
train,3911,13,9984,72,10368,20352
train,3912,26,19968,288,41472,61440
train,3913,6,4608,15,2160,6768
train,3914,19,14592,154,22176,36768
train,3915,24,18432,245,35280,53712
train,3916,11,8448,52,7488,15936
train,3917,28,21504,334,48096,69600
train,3918,11,8448,52,7488,15936
train,3919,26,19968,288,41472,61440
train,3920,7,5376,21,3024,8400
train,3921,28,21504,334,48096,69600
train,3922,14,10752,84,12096,22848
train,3923,33,25344,464,66816,92160
train,3924,15,11520,96,13824,25344
train,3925,29,22272,358,51552,73824
train,3926,34,26112,492,70848,96960
train,3927,13,9984,72,10368,20352
train,3928,20,15360,170,24480,39840
train,3929,10,7680,43,6192,13872
train,3930,28,21504,334,48096,69600
train,3931,28,21504,334,48096,69600
train,3932,7,5376,21,3024,8400
train,3933,18,13824,138,19872,33696
train,3934,27,20736,310,44640,65376
train,3935,27,20736,310,44640,65376
train,3936,26,19968,288,41472,61440
train,3937,28,21504,334,48096,69600
train,3938,16,12288,109,15696,27984
train,3939,11,8448,52,7488,15936
train,3940,32,24576,436,62784,87360
train,3941,32,24576,436,62784,87360
train,3942,17,13056,123,17712,30768
train,3943,13,9984,72,10368,20352
train,3944,29,22272,358,51552,73824
train,3945,24,18432,245,35280,53712
train,3946,24,18432,245,35280,53712
train,3947,8,6144,27,3888,10032
train,3948,9,6912,35,5040,11952
train,3949,40,30720,681,98064,128784
train,3950,30,23040,383,55152,78192
train,3951,18,13824,138,19872,33696
train,3952,22,16896,206,29664,46560
train,3953,12,9216,61,8784,18000
train,3954,22,16896,206,29664,46560
train,3955,14,10752,84,12096,22848
train,3956,17,13056,123,17712,30768
train,3957,23,17664,245,35280,52944
train,3958,35,26880,522,75168,102048
train,3959,21,16128,188,27072,43200
train,3960,25,19200,266,38304,57504
train,3961,10,7680,52,7488,15168
train,3962,19,14592,154,22176,36768
train,3963,7,5376,21,3024,8400
train,3964,33,25344,464,66816,92160
train,3965,19,14592,154,22176,36768
train,3966,34,26112,492,70848,96960
train,3967,21,16128,188,27072,43200
train,3968,14,10752,84,12096,22848
train,3969,10,7680,43,6192,13872
train,3970,33,25344,464,66816,92160
train,3971,11,8448,52,7488,15936
train,3972,29,22272,358,51552,73824
train,3973,14,10752,84,12096,22848
train,3974,29,22272,358,51552,73824
train,3975,19,14592,154,22176,36768
train,3976,45,34560,862,124128,158688
train,3977,28,21504,334,48096,69600
train,3978,28,21504,334,48096,69600
train,3979,8,6144,27,3888,10032
train,3980,22,16896,206,29664,46560
train,3981,12,9216,61,8784,18000
train,3982,30,23040,383,55152,78192
train,3983,32,24576,436,62784,87360
train,3984,28,21504,334,48096,69600
train,3985,17,13056,123,17712,30768
train,3986,32,24576,436,62784,87360
train,3987,21,16128,188,27072,43200
train,3988,27,20736,310,44640,65376
train,3989,18,13824,138,19872,33696
train,3990,29,22272,358,51552,73824
train,3991,25,19200,266,38304,57504
train,3992,32,24576,436,62784,87360
train,3993,20,15360,170,24480,39840
train,3994,22,16896,206,29664,46560
train,3995,31,23808,409,58896,82704
train,3996,40,30720,681,98064,128784
train,3997,16,12288,109,15696,27984
train,3998,23,17664,225,32400,50064
train,3999,24,18432,245,35280,53712
train,4000,12,9216,61,8784,18000
train,4001,22,16896,206,29664,46560
train,4002,31,23808,409,58896,82704
train,4003,29,22272,358,51552,73824
train,4004,14,10752,84,12096,22848
train,4005,9,6912,35,5040,11952
train,4006,23,17664,225,32400,50064
train,4007,22,16896,206,29664,46560
train,4008,31,23808,409,58896,82704
train,4009,20,15360,170,24480,39840
train,4010,22,16896,206,29664,46560
train,4011,10,7680,43,6192,13872
train,4012,5,3840,11,1584,5424
train,4013,24,18432,245,35280,53712
train,4014,26,19968,288,41472,61440
train,4015,30,23040,383,55152,78192
train,4016,24,18432,245,35280,53712
train,4017,10,7680,43,6192,13872
train,4018,13,9984,72,10368,20352
train,4019,31,23808,409,58896,82704
train,4020,33,25344,464,66816,92160
train,4021,32,24576,436,62784,87360
train,4022,26,19968,288,41472,61440
train,4023,19,14592,154,22176,36768
train,4024,37,28416,583,83952,112368
train,4025,28,21504,334,48096,69600
train,4026,27,20736,310,44640,65376
train,4027,15,11520,96,13824,25344
train,4028,24,18432,245,35280,53712
train,4029,34,26112,492,70848,96960
train,4030,13,9984,72,10368,20352
train,4031,2,1536,2,288,1824
train,4032,13,9984,72,10368,20352
train,4033,8,6144,27,3888,10032
train,4034,51,39168,1107,159408,198576
train,4035,16,12288,109,15696,27984
train,4036,34,26112,492,70848,96960
train,4037,19,14592,154,22176,36768
train,4038,26,19968,288,41472,61440
train,4039,29,22272,358,51552,73824
train,4040,19,14592,154,22176,36768
train,4041,21,16128,206,29664,45792
train,4042,5,3840,11,1584,5424
train,4043,17,13056,138,19872,32928
train,4044,20,15360,170,24480,39840
train,4045,14,10752,84,12096,22848
train,4046,18,13824,138,19872,33696
train,4047,5,3840,11,1584,5424
train,4048,8,6144,27,3888,10032
train,4049,21,16128,206,29664,45792
train,4050,21,16128,188,27072,43200
train,4051,23,17664,225,32400,50064
train,4052,7,5376,21,3024,8400
train,4053,16,12288,109,15696,27984
train,4054,25,19200,266,38304,57504
train,4055,18,13824,138,19872,33696
train,4056,9,6912,35,5040,11952
train,4057,29,22272,358,51552,73824
train,4058,18,13824,138,19872,33696
train,4059,24,18432,245,35280,53712
train,4060,7,5376,21,3024,8400
train,4061,25,19200,266,38304,57504
train,4062,24,18432,245,35280,53712
train,4063,11,8448,52,7488,15936
train,4064,17,13056,123,17712,30768
train,4065,25,19200,266,38304,57504
train,4066,11,8448,52,7488,15936
train,4067,7,5376,21,3024,8400
train,4068,42,32256,751,108144,140400
train,4069,9,6912,35,5040,11952
train,4070,11,8448,52,7488,15936
train,4071,5,3840,11,1584,5424
train,4072,19,14592,154,22176,36768
train,4073,12,9216,61,8784,18000
train,4074,23,17664,225,32400,50064
train,4075,9,6912,35,5040,11952
train,4076,30,23040,383,55152,78192
train,4077,29,22272,358,51552,73824
train,4078,12,9216,61,8784,18000
train,4079,19,14592,154,22176,36768
train,4080,15,11520,96,13824,25344
train,4081,29,22272,383,55152,77424
train,4082,34,26112,492,70848,96960
train,4083,24,18432,245,35280,53712
train,4084,19,14592,154,22176,36768
train,4085,51,39168,1107,159408,198576
train,4086,30,23040,383,55152,78192
train,4087,25,19200,266,38304,57504
train,4088,26,19968,288,41472,61440
train,4089,10,7680,43,6192,13872
train,4090,12,9216,61,8784,18000
train,4091,22,16896,206,29664,46560
train,4092,20,15360,170,24480,39840
train,4093,8,6144,27,3888,10032
train,4094,31,23808,409,58896,82704
train,4095,26,19968,288,41472,61440
train,4096,8,6144,27,3888,10032
train,4097,13,9984,72,10368,20352
train,4098,29,22272,358,51552,73824
train,4099,40,30720,681,98064,128784
train,4100,31,23808,409,58896,82704
train,4101,32,24576,436,62784,87360
train,4102,3,2304,4,576,2880
train,4103,19,14592,154,22176,36768
train,4104,34,26112,492,70848,96960
train,4105,15,11520,96,13824,25344
train,4106,2,1536,2,288,1824
train,4107,18,13824,138,19872,33696
train,4108,14,10752,84,12096,22848
train,4109,45,34560,862,124128,158688
train,4110,24,18432,245,35280,53712
train,4111,29,22272,358,51552,73824
train,4112,26,19968,288,41472,61440
train,4113,26,19968,288,41472,61440
train,4114,9,6912,35,5040,11952
train,4115,17,13056,123,17712,30768
train,4116,29,22272,358,51552,73824
train,4117,12,9216,61,8784,18000
train,4118,34,26112,492,70848,96960
train,4119,25,19200,266,38304,57504
train,4120,11,8448,52,7488,15936
train,4121,24,18432,245,35280,53712
train,4122,36,27648,552,79488,107136
train,4123,19,14592,154,22176,36768
train,4124,17,13056,123,17712,30768
train,4125,33,25344,464,66816,92160
train,4126,14,10752,84,12096,22848
train,4127,9,6912,35,5040,11952
train,4128,27,20736,310,44640,65376
train,4129,37,28416,583,83952,112368
train,4130,38,29184,615,88560,117744
train,4131,21,16128,206,29664,45792
train,4132,11,8448,52,7488,15936
train,4133,18,13824,138,19872,33696
train,4134,21,16128,188,27072,43200
train,4135,12,9216,61,8784,18000
train,4136,25,19200,266,38304,57504
train,4137,34,26112,492,70848,96960
train,4138,24,18432,245,35280,53712
train,4139,37,28416,583,83952,112368
train,4140,11,8448,52,7488,15936
train,4141,19,14592,154,22176,36768
train,4142,30,23040,383,55152,78192
train,4143,32,24576,436,62784,87360
train,4144,9,6912,35,5040,11952
train,4145,34,26112,492,70848,96960
train,4146,11,8448,52,7488,15936
train,4147,42,32256,751,108144,140400
train,4148,28,21504,334,48096,69600
train,4149,9,6912,35,5040,11952
train,4150,27,20736,310,44640,65376
train,4151,27,20736,310,44640,65376
train,4152,28,21504,334,48096,69600
train,4153,26,19968,288,41472,61440
train,4154,36,27648,552,79488,107136
train,4155,25,19200,266,38304,57504
train,4156,16,12288,109,15696,27984
train,4157,6,4608,15,2160,6768
train,4158,8,6144,27,3888,10032
train,4159,17,13056,123,17712,30768
train,4160,12,9216,61,8784,18000
train,4161,21,16128,206,29664,45792
train,4162,15,11520,96,13824,25344
train,4163,37,28416,583,83952,112368
train,4164,23,17664,225,32400,50064
train,4165,13,9984,72,10368,20352
train,4166,14,10752,84,12096,22848
train,4167,16,12288,109,15696,27984
train,4168,20,15360,170,24480,39840
train,4169,26,19968,288,41472,61440
train,4170,27,20736,310,44640,65376
train,4171,17,13056,123,17712,30768
train,4172,33,25344,464,66816,92160
train,4173,26,19968,288,41472,61440
train,4174,30,23040,383,55152,78192
train,4175,26,19968,288,41472,61440
train,4176,38,29184,615,88560,117744
train,4177,16,12288,109,15696,27984
train,4178,28,21504,334,48096,69600
train,4179,22,16896,206,29664,46560
train,4180,20,15360,170,24480,39840
train,4181,26,19968,288,41472,61440
train,4182,19,14592,154,22176,36768
train,4183,15,11520,96,13824,25344
train,4184,12,9216,61,8784,18000
train,4185,31,23808,409,58896,82704
train,4186,27,20736,310,44640,65376
train,4187,15,11520,96,13824,25344
train,4188,17,13056,123,17712,30768
train,4189,25,19200,288,41472,60672
train,4190,34,26112,492,70848,96960
train,4191,25,19200,266,38304,57504
train,4192,21,16128,188,27072,43200
train,4193,27,20736,310,44640,65376
train,4194,30,23040,383,55152,78192
train,4195,13,9984,72,10368,20352
train,4196,21,16128,188,27072,43200
train,4197,28,21504,334,48096,69600
train,4198,39,29952,648,93312,123264
train,4199,16,12288,109,15696,27984
train,4200,11,8448,52,7488,15936
train,4201,21,16128,188,27072,43200
train,4202,14,10752,84,12096,22848
train,4203,22,16896,206,29664,46560
train,4204,32,24576,436,62784,87360
train,4205,11,8448,52,7488,15936
train,4206,13,9984,72,10368,20352
train,4207,29,22272,358,51552,73824
train,4208,40,30720,681,98064,128784
train,4209,13,9984,72,10368,20352
train,4210,39,29952,648,93312,123264
train,4211,10,7680,43,6192,13872
train,4212,28,21504,334,48096,69600
train,4213,19,14592,154,22176,36768
train,4214,27,20736,310,44640,65376
train,4215,8,6144,35,5040,11184
train,4216,27,20736,310,44640,65376
train,4217,21,16128,188,27072,43200
train,4218,5,3840,11,1584,5424
train,4219,35,26880,522,75168,102048
train,4220,23,17664,225,32400,50064
train,4221,8,6144,27,3888,10032
train,4222,20,15360,188,27072,42432
train,4223,35,26880,522,75168,102048
train,4224,17,13056,123,17712,30768
train,4225,9,6912,35,5040,11952
train,4226,41,31488,716,103104,134592
train,4227,10,7680,43,6192,13872
train,4228,16,12288,109,15696,27984
train,4229,28,21504,334,48096,69600
train,4230,24,18432,245,35280,53712
train,4231,21,16128,188,27072,43200
train,4232,15,11520,96,13824,25344
train,4233,15,11520,96,13824,25344
train,4234,18,13824,138,19872,33696
train,4235,36,27648,552,79488,107136
train,4236,20,15360,170,24480,39840
train,4237,14,10752,84,12096,22848
train,4238,23,17664,225,32400,50064
train,4239,34,26112,492,70848,96960
train,4240,17,13056,123,17712,30768
train,4241,6,4608,15,2160,6768
train,4242,13,9984,72,10368,20352
train,4243,17,13056,123,17712,30768
train,4244,21,16128,188,27072,43200
train,4245,4,3072,7,1008,4080
train,4246,27,20736,310,44640,65376
train,4247,29,22272,358,51552,73824
train,4248,7,5376,21,3024,8400
train,4249,16,12288,109,15696,27984
train,4250,26,19968,288,41472,61440
train,4251,15,11520,96,13824,25344
train,4252,24,18432,245,35280,53712
train,4253,15,11520,96,13824,25344
train,4254,7,5376,21,3024,8400
train,4255,11,8448,52,7488,15936
train,4256,24,18432,245,35280,53712
train,4257,17,13056,123,17712,30768
train,4258,26,19968,288,41472,61440
train,4259,30,23040,383,55152,78192
train,4260,8,6144,27,3888,10032
train,4261,13,9984,72,10368,20352
train,4262,7,5376,21,3024,8400
train,4263,15,11520,96,13824,25344
train,4264,9,6912,35,5040,11952
train,4265,17,13056,123,17712,30768
train,4266,17,13056,123,17712,30768
train,4267,9,6912,35,5040,11952
train,4268,19,14592,154,22176,36768
train,4269,25,19200,266,38304,57504
train,4270,18,13824,138,19872,33696
train,4271,36,27648,552,79488,107136
train,4272,13,9984,72,10368,20352
train,4273,20,15360,170,24480,39840
train,4274,19,14592,154,22176,36768
train,4275,10,7680,43,6192,13872
train,4276,29,22272,358,51552,73824
train,4277,15,11520,96,13824,25344
train,4278,44,33792,824,118656,152448
train,4279,17,13056,123,17712,30768
train,4280,14,10752,84,12096,22848
train,4281,23,17664,225,32400,50064
train,4282,3,2304,4,576,2880
train,4283,28,21504,334,48096,69600
train,4284,18,13824,138,19872,33696
train,4285,17,13056,123,17712,30768
train,4286,19,14592,154,22176,36768
train,4287,27,20736,310,44640,65376
train,4288,16,12288,109,15696,27984
train,4289,10,7680,43,6192,13872
train,4290,22,16896,206,29664,46560
train,4291,9,6912,35,5040,11952
train,4292,3,2304,4,576,2880
train,4293,29,22272,358,51552,73824
train,4294,32,24576,436,62784,87360
train,4295,6,4608,15,2160,6768
train,4296,18,13824,138,19872,33696
train,4297,11,8448,52,7488,15936
train,4298,25,19200,266,38304,57504
train,4299,17,13056,123,17712,30768
train,4300,2,1536,2,288,1824
train,4301,15,11520,96,13824,25344
train,4302,42,32256,751,108144,140400
train,4303,25,19200,266,38304,57504
train,4304,13,9984,72,10368,20352
train,4305,24,18432,245,35280,53712
train,4306,38,29184,615,88560,117744
train,4307,5,3840,11,1584,5424
train,4308,13,9984,72,10368,20352
train,4309,42,32256,751,108144,140400
train,4310,25,19200,266,38304,57504
train,4311,31,23808,409,58896,82704
train,4312,29,22272,358,51552,73824
train,4313,17,13056,123,17712,30768
train,4314,28,21504,334,48096,69600
train,4315,29,22272,358,51552,73824
train,4316,16,12288,109,15696,27984
train,4317,13,9984,72,10368,20352
train,4318,15,11520,96,13824,25344
train,4319,24,18432,245,35280,53712
train,4320,34,26112,492,70848,96960
train,4321,13,9984,72,10368,20352
train,4322,4,3072,7,1008,4080
train,4323,17,13056,123,17712,30768
train,4324,15,11520,96,13824,25344
train,4325,8,6144,27,3888,10032
train,4326,10,7680,43,6192,13872
train,4327,13,9984,72,10368,20352
train,4328,35,26880,522,75168,102048
train,4329,24,18432,245,35280,53712
train,4330,8,6144,27,3888,10032
train,4331,22,16896,206,29664,46560
train,4332,37,28416,583,83952,112368
train,4333,27,20736,334,48096,68832
train,4334,7,5376,21,3024,8400
train,4335,19,14592,154,22176,36768
train,4336,6,4608,15,2160,6768
train,4337,37,28416,583,83952,112368
train,4338,36,27648,552,79488,107136
train,4339,33,25344,464,66816,92160
train,4340,11,8448,52,7488,15936
train,4341,19,14592,154,22176,36768
train,4342,25,19200,266,38304,57504
train,4343,10,7680,43,6192,13872
train,4344,25,19200,266,38304,57504
train,4345,9,6912,35,5040,11952
train,4346,29,22272,358,51552,73824
train,4347,21,16128,188,27072,43200
train,4348,42,32256,751,108144,140400
train,4349,18,13824,138,19872,33696
train,4350,35,26880,522,75168,102048
train,4351,25,19200,266,38304,57504
train,4352,17,13056,123,17712,30768
train,4353,29,22272,358,51552,73824
train,4354,45,34560,862,124128,158688
train,4355,15,11520,96,13824,25344
train,4356,12,9216,61,8784,18000
train,4357,29,22272,358,51552,73824
train,4358,19,14592,154,22176,36768
train,4359,26,19968,288,41472,61440
train,4360,29,22272,358,51552,73824
train,4361,8,6144,27,3888,10032
train,4362,16,12288,109,15696,27984
train,4363,27,20736,310,44640,65376
train,4364,24,18432,245,35280,53712
train,4365,11,8448,52,7488,15936
train,4366,23,17664,225,32400,50064
train,4367,6,4608,15,2160,6768
train,4368,37,28416,583,83952,112368
train,4369,17,13056,123,17712,30768
train,4370,2,1536,2,288,1824
train,4371,17,13056,123,17712,30768
train,4372,5,3840,15,2160,6000
train,4373,28,21504,358,51552,73056
train,4374,13,9984,72,10368,20352
train,4375,32,24576,436,62784,87360
train,4376,29,22272,358,51552,73824
train,4377,28,21504,334,48096,69600
train,4378,28,21504,334,48096,69600
train,4379,7,5376,21,3024,8400
train,4380,22,16896,206,29664,46560
train,4381,7,5376,21,3024,8400
train,4382,14,10752,84,12096,22848
train,4383,12,9216,61,8784,18000
train,4384,21,16128,188,27072,43200
train,4385,21,16128,188,27072,43200
train,4386,23,17664,225,32400,50064
train,4387,29,22272,358,51552,73824
train,4388,8,6144,27,3888,10032
train,4389,17,13056,123,17712,30768
train,4390,25,19200,266,38304,57504
train,4391,36,27648,552,79488,107136
train,4392,39,29952,648,93312,123264
train,4393,19,14592,154,22176,36768
train,4394,25,19200,266,38304,57504
train,4395,13,9984,72,10368,20352
train,4396,13,9984,72,10368,20352
train,4397,17,13056,123,17712,30768
train,4398,31,23808,409,58896,82704
train,4399,35,26880,522,75168,102048
train,4400,26,19968,288,41472,61440
train,4401,15,11520,96,13824,25344
train,4402,13,9984,72,10368,20352
train,4403,4,3072,7,1008,4080
train,4404,30,23040,383,55152,78192
train,4405,11,8448,52,7488,15936
train,4406,29,22272,358,51552,73824
train,4407,14,10752,84,12096,22848
train,4408,29,22272,358,51552,73824
train,4409,17,13056,123,17712,30768
train,4410,20,15360,170,24480,39840
train,4411,17,13056,123,17712,30768
train,4412,22,16896,206,29664,46560
train,4413,17,13056,138,19872,32928
train,4414,17,13056,123,17712,30768
train,4415,35,26880,522,75168,102048
train,4416,15,11520,96,13824,25344
train,4417,28,21504,334,48096,69600
train,4418,9,6912,35,5040,11952
train,4419,9,6912,35,5040,11952
train,4420,35,26880,583,83952,110832
train,4421,42,32256,751,108144,140400
train,4422,35,26880,522,75168,102048
train,4423,24,18432,245,35280,53712
train,4424,9,6912,35,5040,11952
train,4425,15,11520,96,13824,25344
train,4426,23,17664,225,32400,50064
train,4427,12,9216,61,8784,18000
train,4428,13,9984,72,10368,20352
train,4429,19,14592,154,22176,36768
train,4430,14,10752,84,12096,22848
train,4431,23,17664,225,32400,50064
train,4432,28,21504,334,48096,69600
train,4433,21,16128,188,27072,43200
train,4434,14,10752,84,12096,22848
train,4435,18,13824,138,19872,33696
train,4436,12,9216,61,8784,18000
train,4437,27,20736,310,44640,65376
train,4438,25,19200,266,38304,57504
train,4439,18,13824,138,19872,33696
train,4440,54,41472,1241,178704,220176
train,4441,19,14592,154,22176,36768
train,4442,16,12288,109,15696,27984
train,4443,29,22272,358,51552,73824
train,4444,21,16128,188,27072,43200
train,4445,31,23808,409,58896,82704
train,4446,22,16896,206,29664,46560
train,4447,23,17664,225,32400,50064
train,4448,9,6912,35,5040,11952
train,4449,37,28416,583,83952,112368
train,4450,16,12288,109,15696,27984
train,4451,26,19968,288,41472,61440
train,4452,24,18432,245,35280,53712
train,4453,19,14592,154,22176,36768
train,4454,14,10752,84,12096,22848
train,4455,46,35328,901,129744,165072
train,4456,22,16896,206,29664,46560
train,4457,20,15360,170,24480,39840
train,4458,25,19200,266,38304,57504
train,4459,21,16128,188,27072,43200
train,4460,18,13824,138,19872,33696
train,4461,49,37632,1022,147168,184800
train,4462,17,13056,123,17712,30768
train,4463,20,15360,170,24480,39840
train,4464,12,9216,61,8784,18000
train,4465,7,5376,21,3024,8400
train,4466,29,22272,358,51552,73824
train,4467,30,23040,383,55152,78192
train,4468,17,13056,123,17712,30768
train,4469,24,18432,245,35280,53712
train,4470,23,17664,225,32400,50064
train,4471,20,15360,170,24480,39840
train,4472,11,8448,52,7488,15936
train,4473,23,17664,225,32400,50064
train,4474,9,6912,35,5040,11952
train,4475,17,13056,123,17712,30768
train,4476,25,19200,266,38304,57504
train,4477,10,7680,43,6192,13872
train,4478,27,20736,310,44640,65376
train,4479,20,15360,170,24480,39840
train,4480,10,7680,43,6192,13872
train,4481,14,10752,84,12096,22848
train,4482,30,23040,383,55152,78192
train,4483,12,9216,61,8784,18000
train,4484,11,8448,52,7488,15936
train,4485,25,19200,266,38304,57504
train,4486,20,15360,170,24480,39840
train,4487,30,23040,383,55152,78192
train,4488,17,13056,123,17712,30768
train,4489,22,16896,206,29664,46560
train,4490,26,19968,288,41472,61440
train,4491,11,8448,52,7488,15936
train,4492,21,16128,188,27072,43200
train,4493,10,7680,61,8784,16464
train,4494,7,5376,21,3024,8400
train,4495,22,16896,206,29664,46560
train,4496,18,13824,154,22176,36000
train,4497,20,15360,170,24480,39840
train,4498,34,26112,492,70848,96960
train,4499,24,18432,245,35280,53712
train,4500,16,12288,109,15696,27984
train,4501,24,18432,245,35280,53712
train,4502,4,3072,7,1008,4080
train,4503,34,26112,492,70848,96960
train,4504,9,6912,35,5040,11952
train,4505,29,22272,358,51552,73824
train,4506,5,3840,11,1584,5424
train,4507,15,11520,96,13824,25344
train,4508,15,11520,96,13824,25344
train,4509,18,13824,138,19872,33696
train,4510,6,4608,15,2160,6768
train,4511,32,24576,436,62784,87360
train,4512,37,28416,583,83952,112368
train,4513,17,13056,123,17712,30768
train,4514,23,17664,225,32400,50064
train,4515,8,6144,27,3888,10032
train,4516,7,5376,21,3024,8400
train,4517,16,12288,109,15696,27984
train,4518,11,8448,52,7488,15936
train,4519,27,20736,310,44640,65376
train,4520,35,26880,522,75168,102048
train,4521,28,21504,334,48096,69600
train,4522,20,15360,170,24480,39840
train,4523,29,22272,358,51552,73824
train,4524,25,19200,266,38304,57504
train,4525,18,13824,138,19872,33696
train,4526,21,16128,188,27072,43200
train,4527,20,15360,170,24480,39840
train,4528,39,29952,648,93312,123264
train,4529,10,7680,43,6192,13872
train,4530,22,16896,206,29664,46560
train,4531,16,12288,109,15696,27984
train,4532,33,25344,464,66816,92160
train,4533,17,13056,123,17712,30768
train,4534,36,27648,552,79488,107136
train,4535,7,5376,21,3024,8400
train,4536,5,3840,11,1584,5424
train,4537,11,8448,52,7488,15936
train,4538,15,11520,96,13824,25344
train,4539,24,18432,245,35280,53712
train,4540,19,14592,154,22176,36768
train,4541,22,16896,206,29664,46560
train,4542,41,31488,716,103104,134592
train,4543,20,15360,170,24480,39840
train,4544,23,17664,245,35280,52944
train,4545,12,9216,61,8784,18000
train,4546,25,19200,266,38304,57504
train,4547,27,20736,310,44640,65376
train,4548,26,19968,288,41472,61440
train,4549,18,13824,138,19872,33696
train,4550,20,15360,170,24480,39840
train,4551,38,29184,615,88560,117744
train,4552,13,9984,72,10368,20352
train,4553,27,20736,310,44640,65376
train,4554,18,13824,138,19872,33696
train,4555,36,27648,552,79488,107136
train,4556,20,15360,170,24480,39840
train,4557,27,20736,310,44640,65376
train,4558,35,26880,522,75168,102048
train,4559,12,9216,61,8784,18000
train,4560,31,23808,409,58896,82704
train,4561,19,14592,154,22176,36768
train,4562,22,16896,206,29664,46560
train,4563,3,2304,4,576,2880
train,4564,31,23808,436,62784,86592
train,4565,7,5376,21,3024,8400
train,4566,32,24576,436,62784,87360
train,4567,25,19200,266,38304,57504
train,4568,19,14592,154,22176,36768
train,4569,25,19200,266,38304,57504
train,4570,26,19968,288,41472,61440
train,4571,14,10752,84,12096,22848
train,4572,18,13824,138,19872,33696
train,4573,17,13056,123,17712,30768
train,4574,25,19200,266,38304,57504
train,4575,31,23808,409,58896,82704
train,4576,24,18432,245,35280,53712
train,4577,31,23808,409,58896,82704
train,4578,38,29184,615,88560,117744
train,4579,23,17664,225,32400,50064
train,4580,12,9216,61,8784,18000
train,4581,28,21504,334,48096,69600
train,4582,19,14592,154,22176,36768
train,4583,16,12288,109,15696,27984
train,4584,22,16896,206,29664,46560
train,4585,26,19968,288,41472,61440
train,4586,11,8448,52,7488,15936
train,4587,32,24576,436,62784,87360
train,4588,34,26112,492,70848,96960
train,4589,31,23808,409,58896,82704
train,4590,20,15360,170,24480,39840
train,4591,8,6144,27,3888,10032
train,4592,9,6912,35,5040,11952
train,4593,28,21504,334,48096,69600
train,4594,24,18432,245,35280,53712
train,4595,20,15360,170,24480,39840
train,4596,10,7680,43,6192,13872
train,4597,18,13824,138,19872,33696
train,4598,4,3072,7,1008,4080
train,4599,9,6912,35,5040,11952
train,4600,36,27648,552,79488,107136
train,4601,5,3840,11,1584,5424
train,4602,34,26112,492,70848,96960
train,4603,13,9984,72,10368,20352
train,4604,17,13056,123,17712,30768
train,4605,9,6912,35,5040,11952
train,4606,20,15360,170,24480,39840
train,4607,32,24576,436,62784,87360
train,4608,32,24576,436,62784,87360
train,4609,2,1536,2,288,1824
train,4610,24,18432,245,35280,53712
train,4611,8,6144,27,3888,10032
train,4612,20,15360,170,24480,39840
train,4613,31,23808,409,58896,82704
train,4614,15,11520,96,13824,25344
train,4615,19,14592,154,22176,36768
train,4616,23,17664,225,32400,50064
train,4617,37,28416,583,83952,112368
train,4618,22,16896,206,29664,46560
train,4619,26,19968,288,41472,61440
train,4620,24,18432,245,35280,53712
train,4621,12,9216,61,8784,18000
train,4622,15,11520,96,13824,25344
train,4623,5,3840,11,1584,5424
train,4624,31,23808,409,58896,82704
train,4625,29,22272,358,51552,73824
train,4626,19,14592,154,22176,36768
train,4627,18,13824,138,19872,33696
train,4628,36,27648,552,79488,107136
train,4629,35,26880,522,75168,102048
train,4630,19,14592,154,22176,36768
train,4631,29,22272,358,51552,73824
train,4632,39,29952,648,93312,123264
train,4633,23,17664,225,32400,50064
train,4634,21,16128,188,27072,43200
train,4635,15,11520,96,13824,25344
train,4636,27,20736,310,44640,65376
train,4637,13,9984,72,10368,20352
train,4638,8,6144,27,3888,10032
train,4639,32,24576,436,62784,87360
train,4640,6,4608,15,2160,6768
train,4641,23,17664,225,32400,50064
train,4642,6,4608,15,2160,6768
train,4643,21,16128,188,27072,43200
train,4644,9,6912,35,5040,11952
train,4645,23,17664,225,32400,50064
train,4646,16,12288,109,15696,27984
train,4647,9,6912,35,5040,11952
train,4648,20,15360,170,24480,39840
train,4649,21,16128,188,27072,43200
train,4650,19,14592,154,22176,36768
train,4651,28,21504,334,48096,69600
train,4652,35,26880,522,75168,102048
train,4653,7,5376,21,3024,8400
train,4654,12,9216,61,8784,18000
train,4655,29,22272,358,51552,73824
train,4656,23,17664,225,32400,50064
train,4657,10,7680,43,6192,13872
train,4658,23,17664,225,32400,50064
train,4659,16,12288,109,15696,27984
train,4660,21,16128,188,27072,43200
train,4661,16,12288,109,15696,27984
train,4662,16,12288,109,15696,27984
train,4663,20,15360,170,24480,39840
train,4664,32,24576,436,62784,87360
train,4665,24,18432,245,35280,53712
train,4666,14,10752,84,12096,22848
train,4667,13,9984,72,10368,20352
train,4668,21,16128,188,27072,43200
train,4669,37,28416,583,83952,112368
train,4670,18,13824,138,19872,33696
train,4671,13,9984,84,12096,22080
train,4672,16,12288,109,15696,27984
train,4673,25,19200,266,38304,57504
train,4674,8,6144,27,3888,10032
train,4675,29,22272,358,51552,73824
train,4676,4,3072,7,1008,4080
train,4677,31,23808,409,58896,82704
train,4678,11,8448,52,7488,15936
train,4679,38,29184,615,88560,117744
train,4680,21,16128,188,27072,43200
train,4681,16,12288,109,15696,27984
train,4682,21,16128,188,27072,43200
train,4683,8,6144,27,3888,10032
train,4684,11,8448,52,7488,15936
train,4685,21,16128,188,27072,43200
train,4686,10,7680,43,6192,13872
train,4687,24,18432,245,35280,53712
train,4688,11,8448,52,7488,15936
train,4689,15,11520,96,13824,25344
train,4690,26,19968,288,41472,61440
train,4691,22,16896,206,29664,46560
train,4692,24,18432,245,35280,53712
train,4693,37,28416,583,83952,112368
train,4694,20,15360,170,24480,39840
train,4695,21,16128,188,27072,43200
train,4696,24,18432,245,35280,53712
train,4697,35,26880,522,75168,102048
train,4698,20,15360,170,24480,39840
train,4699,24,18432,245,35280,53712
train,4700,21,16128,188,27072,43200
train,4701,25,19200,266,38304,57504
train,4702,9,6912,35,5040,11952
train,4703,12,9216,61,8784,18000
train,4704,36,27648,552,79488,107136
train,4705,17,13056,123,17712,30768
train,4706,21,16128,188,27072,43200
train,4707,39,29952,648,93312,123264
train,4708,33,25344,464,66816,92160
train,4709,19,14592,154,22176,36768
train,4710,11,8448,52,7488,15936
train,4711,22,16896,206,29664,46560
train,4712,17,13056,154,22176,35232
train,4713,14,10752,84,12096,22848
train,4714,21,16128,188,27072,43200
train,4715,26,19968,288,41472,61440
train,4716,11,8448,52,7488,15936
train,4717,14,10752,84,12096,22848
train,4718,29,22272,358,51552,73824
train,4719,19,14592,154,22176,36768
train,4720,39,29952,648,93312,123264
train,4721,6,4608,15,2160,6768
train,4722,21,16128,188,27072,43200
train,4723,13,9984,72,10368,20352
train,4724,25,19200,266,38304,57504
train,4725,31,23808,436,62784,86592
train,4726,2,1536,2,288,1824
train,4727,8,6144,27,3888,10032
train,4728,24,18432,245,35280,53712
train,4729,20,15360,170,24480,39840
train,4730,17,13056,123,17712,30768
train,4731,22,16896,206,29664,46560
train,4732,26,19968,288,41472,61440
train,4733,29,22272,358,51552,73824
train,4734,15,11520,96,13824,25344
train,4735,13,9984,72,10368,20352
train,4736,10,7680,43,6192,13872
train,4737,29,22272,358,51552,73824
train,4738,42,32256,751,108144,140400
train,4739,35,26880,522,75168,102048
train,4740,11,8448,52,7488,15936
train,4741,17,13056,123,17712,30768
train,4742,31,23808,409,58896,82704
train,4743,26,19968,288,41472,61440
train,4744,22,16896,206,29664,46560
train,4745,20,15360,170,24480,39840
train,4746,19,14592,154,22176,36768
train,4747,42,32256,751,108144,140400
train,4748,22,16896,206,29664,46560
train,4749,30,23040,383,55152,78192
train,4750,35,26880,522,75168,102048
train,4751,11,8448,52,7488,15936
train,4752,16,12288,109,15696,27984
train,4753,6,4608,15,2160,6768
train,4754,20,15360,170,24480,39840
train,4755,46,35328,901,129744,165072
train,4756,23,17664,225,32400,50064
train,4757,37,28416,583,83952,112368
train,4758,14,10752,84,12096,22848
train,4759,14,10752,84,12096,22848
train,4760,22,16896,206,29664,46560
train,4761,29,22272,358,51552,73824
train,4762,14,10752,84,12096,22848
train,4763,14,10752,84,12096,22848
train,4764,19,14592,154,22176,36768
train,4765,35,26880,522,75168,102048
train,4766,16,12288,109,15696,27984
train,4767,24,18432,245,35280,53712
train,4768,20,15360,170,24480,39840
train,4769,36,27648,552,79488,107136
train,4770,17,13056,123,17712,30768
train,4771,12,9216,61,8784,18000
train,4772,9,6912,35,5040,11952
train,4773,42,32256,751,108144,140400
train,4774,17,13056,123,17712,30768
train,4775,36,27648,552,79488,107136
train,4776,33,25344,464,66816,92160
train,4777,17,13056,123,17712,30768
train,4778,14,10752,84,12096,22848
train,4779,21,16128,188,27072,43200
train,4780,10,7680,43,6192,13872
train,4781,15,11520,96,13824,25344
train,4782,12,9216,61,8784,18000
train,4783,14,10752,84,12096,22848
train,4784,15,11520,96,13824,25344
train,4785,12,9216,61,8784,18000
train,4786,14,10752,84,12096,22848
train,4787,22,16896,206,29664,46560
train,4788,36,27648,552,79488,107136
train,4789,22,16896,206,29664,46560
train,4790,17,13056,123,17712,30768
train,4791,31,23808,409,58896,82704
train,4792,27,20736,310,44640,65376
train,4793,23,17664,225,32400,50064
train,4794,35,26880,522,75168,102048
train,4795,24,18432,245,35280,53712
train,4796,22,16896,206,29664,46560
train,4797,10,7680,43,6192,13872
train,4798,18,13824,138,19872,33696
train,4799,21,16128,188,27072,43200
train,4800,24,18432,245,35280,53712
train,4801,7,5376,21,3024,8400
train,4802,33,25344,464,66816,92160
train,4803,5,3840,11,1584,5424
train,4804,6,4608,15,2160,6768
train,4805,14,10752,84,12096,22848
train,4806,30,23040,383,55152,78192
train,4807,6,4608,15,2160,6768
train,4808,14,10752,84,12096,22848
train,4809,20,15360,170,24480,39840
train,4810,18,13824,138,19872,33696
train,4811,28,21504,334,48096,69600
train,4812,36,27648,552,79488,107136
train,4813,15,11520,96,13824,25344
train,4814,7,5376,21,3024,8400
train,4815,23,17664,225,32400,50064
train,4816,25,19200,266,38304,57504
train,4817,28,21504,334,48096,69600
train,4818,27,20736,310,44640,65376
train,4819,19,14592,154,22176,36768
train,4820,12,9216,61,8784,18000
train,4821,24,18432,245,35280,53712
train,4822,24,18432,245,35280,53712
train,4823,33,25344,464,66816,92160
train,4824,12,9216,61,8784,18000
train,4825,35,26880,522,75168,102048
train,4826,18,13824,138,19872,33696
train,4827,20,15360,170,24480,39840
train,4828,23,17664,225,32400,50064
train,4829,45,34560,901,129744,164304
train,4830,20,15360,170,24480,39840
train,4831,27,20736,310,44640,65376
train,4832,34,26112,492,70848,96960
train,4833,15,11520,96,13824,25344
train,4834,22,16896,206,29664,46560
train,4835,7,5376,21,3024,8400
train,4836,14,10752,84,12096,22848
train,4837,24,18432,245,35280,53712
train,4838,15,11520,96,13824,25344
train,4839,14,10752,84,12096,22848
train,4840,8,6144,27,3888,10032
train,4841,7,5376,21,3024,8400
train,4842,14,10752,84,12096,22848
train,4843,24,18432,245,35280,53712
train,4844,25,19200,266,38304,57504
train,4845,27,20736,310,44640,65376
train,4846,26,19968,310,44640,64608
train,4847,18,13824,138,19872,33696
train,4848,24,18432,245,35280,53712
train,4849,13,9984,72,10368,20352
train,4850,30,23040,383,55152,78192
train,4851,15,11520,96,13824,25344
train,4852,24,18432,245,35280,53712
train,4853,41,31488,716,103104,134592
train,4854,20,15360,170,24480,39840
train,4855,17,13056,123,17712,30768
train,4856,29,22272,358,51552,73824
train,4857,17,13056,123,17712,30768
train,4858,31,23808,409,58896,82704
train,4859,11,8448,52,7488,15936
train,4860,13,9984,72,10368,20352
train,4861,12,9216,61,8784,18000
train,4862,22,16896,206,29664,46560
train,4863,16,12288,109,15696,27984
train,4864,17,13056,123,17712,30768
train,4865,26,19968,288,41472,61440
train,4866,9,6912,35,5040,11952
train,4867,37,28416,583,83952,112368
train,4868,20,15360,170,24480,39840
train,4869,44,33792,824,118656,152448
train,4870,23,17664,245,35280,52944
train,4871,11,8448,61,8784,17232
train,4872,11,8448,52,7488,15936
train,4873,25,19200,266,38304,57504
train,4874,10,7680,43,6192,13872
train,4875,8,6144,27,3888,10032
train,4876,23,17664,225,32400,50064
train,4877,15,11520,96,13824,25344
train,4878,17,13056,123,17712,30768
train,4879,22,16896,206,29664,46560
train,4880,27,20736,310,44640,65376
train,4881,26,19968,288,41472,61440
train,4882,14,10752,96,13824,24576
train,4883,43,33024,787,113328,146352
train,4884,17,13056,123,17712,30768
train,4885,5,3840,15,2160,6000
train,4886,26,19968,288,41472,61440
train,4887,12,9216,61,8784,18000
train,4888,20,15360,170,24480,39840
train,4889,22,16896,206,29664,46560
train,4890,8,6144,27,3888,10032
train,4891,23,17664,225,32400,50064
train,4892,25,19200,266,38304,57504
train,4893,7,5376,21,3024,8400
train,4894,30,23040,383,55152,78192
train,4895,28,21504,334,48096,69600
train,4896,15,11520,96,13824,25344
train,4897,24,18432,245,35280,53712
train,4898,34,26112,492,70848,96960
train,4899,37,28416,583,83952,112368
train,4900,29,22272,358,51552,73824
train,4901,17,13056,138,19872,32928
train,4902,15,11520,96,13824,25344
train,4903,16,12288,109,15696,27984
train,4904,11,8448,52,7488,15936
train,4905,11,8448,52,7488,15936
train,4906,26,19968,288,41472,61440
train,4907,16,12288,109,15696,27984
train,4908,27,20736,310,44640,65376
train,4909,38,29184,615,88560,117744
train,4910,23,17664,225,32400,50064
train,4911,20,15360,170,24480,39840
train,4912,32,24576,436,62784,87360
train,4913,45,34560,862,124128,158688
train,4914,4,3072,7,1008,4080
train,4915,28,21504,334,48096,69600
train,4916,8,6144,27,3888,10032
train,4917,2,1536,2,288,1824
train,4918,28,21504,334,48096,69600
train,4919,22,16896,206,29664,46560
train,4920,36,27648,552,79488,107136
train,4921,26,19968,288,41472,61440
train,4922,25,19200,266,38304,57504
train,4923,25,19200,266,38304,57504
train,4924,38,29184,615,88560,117744
train,4925,15,11520,96,13824,25344
train,4926,7,5376,21,3024,8400
train,4927,34,26112,492,70848,96960
train,4928,17,13056,123,17712,30768
train,4929,17,13056,123,17712,30768
train,4930,17,13056,123,17712,30768
train,4931,27,20736,310,44640,65376
train,4932,8,6144,27,3888,10032
train,4933,21,16128,188,27072,43200
train,4934,11,8448,52,7488,15936
train,4935,15,11520,96,13824,25344
train,4936,35,26880,522,75168,102048
train,4937,2,1536,2,288,1824
train,4938,12,9216,61,8784,18000
train,4939,20,15360,170,24480,39840
train,4940,19,14592,154,22176,36768
train,4941,31,23808,409,58896,82704
train,4942,19,14592,154,22176,36768
train,4943,32,24576,436,62784,87360
train,4944,17,13056,123,17712,30768
train,4945,20,15360,170,24480,39840
train,4946,22,16896,206,29664,46560
train,4947,17,13056,123,17712,30768
train,4948,18,13824,138,19872,33696
train,4949,17,13056,123,17712,30768
train,4950,26,19968,310,44640,64608
train,4951,9,6912,35,5040,11952
train,4952,15,11520,96,13824,25344
train,4953,14,10752,84,12096,22848
train,4954,19,14592,154,22176,36768
train,4955,13,9984,72,10368,20352
train,4956,26,19968,288,41472,61440
train,4957,21,16128,188,27072,43200
train,4958,24,18432,245,35280,53712
train,4959,7,5376,21,3024,8400
train,4960,9,6912,35,5040,11952
train,4961,10,7680,43,6192,13872
train,4962,20,15360,170,24480,39840
train,4963,26,19968,288,41472,61440
train,4964,24,18432,245,35280,53712
train,4965,20,15360,170,24480,39840
train,4966,19,14592,154,22176,36768
train,4967,27,20736,310,44640,65376
train,4968,25,19200,266,38304,57504
train,4969,20,15360,170,24480,39840
train,4970,37,28416,583,83952,112368
train,4971,19,14592,154,22176,36768
train,4972,27,20736,310,44640,65376
train,4973,32,24576,436,62784,87360
train,4974,21,16128,188,27072,43200
train,4975,8,6144,27,3888,10032
train,4976,30,23040,383,55152,78192
train,4977,16,12288,109,15696,27984
train,4978,21,16128,188,27072,43200
train,4979,20,15360,170,24480,39840
train,4980,25,19200,266,38304,57504
train,4981,10,7680,43,6192,13872
train,4982,30,23040,383,55152,78192
train,4983,7,5376,21,3024,8400
train,4984,16,12288,109,15696,27984
train,4985,18,13824,138,19872,33696
train,4986,19,14592,154,22176,36768
train,4987,19,14592,154,22176,36768
train,4988,25,19200,266,38304,57504
train,4989,17,13056,123,17712,30768
train,4990,26,19968,288,41472,61440
train,4991,22,16896,206,29664,46560
train,4992,21,16128,188,27072,43200
train,4993,40,30720,681,98064,128784
train,4994,12,9216,61,8784,18000
train,4995,29,22272,358,51552,73824
train,4996,24,18432,245,35280,53712
train,4997,21,16128,188,27072,43200
train,4998,12,9216,61,8784,18000
train,4999,47,36096,940,135360,171456
train,5000,37,28416,583,83952,112368
train,5001,4,3072,7,1008,4080
train,5002,24,18432,245,35280,53712
train,5003,13,9984,72,10368,20352
train,5004,14,10752,84,12096,22848
train,5005,31,23808,409,58896,82704
train,5006,6,4608,15,2160,6768
train,5007,4,3072,7,1008,4080
train,5008,24,18432,245,35280,53712
train,5009,10,7680,43,6192,13872
train,5010,27,20736,310,44640,65376
train,5011,13,9984,72,10368,20352
train,5012,19,14592,154,22176,36768
train,5013,28,21504,334,48096,69600
train,5014,14,10752,84,12096,22848
train,5015,19,14592,154,22176,36768
train,5016,9,6912,35,5040,11952
train,5017,6,4608,15,2160,6768
train,5018,18,13824,138,19872,33696
train,5019,27,20736,310,44640,65376
train,5020,9,6912,35,5040,11952
train,5021,39,29952,648,93312,123264
train,5022,26,19968,288,41472,61440
train,5023,25,19200,266,38304,57504
train,5024,16,12288,109,15696,27984
train,5025,14,10752,84,12096,22848
train,5026,31,23808,409,58896,82704
train,5027,8,6144,27,3888,10032
train,5028,24,18432,245,35280,53712
train,5029,18,13824,138,19872,33696
train,5030,18,13824,138,19872,33696
train,5031,20,15360,170,24480,39840
train,5032,21,16128,188,27072,43200
train,5033,14,10752,84,12096,22848
train,5034,39,29952,648,93312,123264
train,5035,30,23040,383,55152,78192
train,5036,22,16896,206,29664,46560
train,5037,31,23808,409,58896,82704
train,5038,13,9984,72,10368,20352
train,5039,19,14592,154,22176,36768
train,5040,27,20736,310,44640,65376
train,5041,24,18432,245,35280,53712
train,5042,23,17664,225,32400,50064
train,5043,39,29952,648,93312,123264
train,5044,8,6144,27,3888,10032
train,5045,27,20736,334,48096,68832
train,5046,32,24576,436,62784,87360
train,5047,9,6912,35,5040,11952
train,5048,16,12288,109,15696,27984
train,5049,14,10752,84,12096,22848
train,5050,7,5376,21,3024,8400
train,5051,22,16896,206,29664,46560
train,5052,14,10752,84,12096,22848
train,5053,14,10752,84,12096,22848
train,5054,22,16896,206,29664,46560
train,5055,23,17664,225,32400,50064
train,5056,39,29952,648,93312,123264
train,5057,31,23808,409,58896,82704
train,5058,18,13824,138,19872,33696
train,5059,19,14592,154,22176,36768
train,5060,14,10752,84,12096,22848
train,5061,38,29184,615,88560,117744
train,5062,27,20736,310,44640,65376
train,5063,11,8448,52,7488,15936
train,5064,44,33792,862,124128,157920
train,5065,29,22272,358,51552,73824
train,5066,14,10752,84,12096,22848
train,5067,28,21504,334,48096,69600
train,5068,16,12288,109,15696,27984
train,5069,21,16128,188,27072,43200
train,5070,21,16128,188,27072,43200
train,5071,31,23808,409,58896,82704
train,5072,23,17664,225,32400,50064
train,5073,29,22272,358,51552,73824
train,5074,8,6144,27,3888,10032
train,5075,20,15360,170,24480,39840
train,5076,15,11520,96,13824,25344
train,5077,15,11520,96,13824,25344
train,5078,19,14592,154,22176,36768
train,5079,32,24576,436,62784,87360
train,5080,12,9216,61,8784,18000
train,5081,7,5376,21,3024,8400
train,5082,13,9984,72,10368,20352
train,5083,34,26112,492,70848,96960
train,5084,23,17664,225,32400,50064
train,5085,31,23808,409,58896,82704
train,5086,9,6912,35,5040,11952
train,5087,17,13056,123,17712,30768
train,5088,27,20736,310,44640,65376
train,5089,20,15360,170,24480,39840
train,5090,38,29184,615,88560,117744
train,5091,28,21504,334,48096,69600
train,5092,6,4608,15,2160,6768
train,5093,15,11520,96,13824,25344
train,5094,15,11520,96,13824,25344
train,5095,13,9984,72,10368,20352
train,5096,25,19200,266,38304,57504
train,5097,27,20736,310,44640,65376
train,5098,16,12288,109,15696,27984
train,5099,21,16128,188,27072,43200
train,5100,7,5376,21,3024,8400
train,5101,34,26112,492,70848,96960
train,5102,12,9216,61,8784,18000
train,5103,15,11520,96,13824,25344
train,5104,7,5376,21,3024,8400
train,5105,14,10752,84,12096,22848
train,5106,21,16128,188,27072,43200
train,5107,33,25344,464,66816,92160
train,5108,15,11520,96,13824,25344
train,5109,43,33024,787,113328,146352
train,5110,35,26880,522,75168,102048
train,5111,37,28416,615,88560,116976
train,5112,9,6912,35,5040,11952
train,5113,26,19968,288,41472,61440
train,5114,34,26112,492,70848,96960
train,5115,8,6144,27,3888,10032
train,5116,27,20736,310,44640,65376
train,5117,23,17664,225,32400,50064
train,5118,15,11520,96,13824,25344
train,5119,16,12288,109,15696,27984
train,5120,44,33792,824,118656,152448
train,5121,48,36864,981,141264,178128
train,5122,23,17664,225,32400,50064
train,5123,16,12288,109,15696,27984
train,5124,10,7680,43,6192,13872
train,5125,11,8448,52,7488,15936
train,5126,20,15360,170,24480,39840
train,5127,12,9216,61,8784,18000
train,5128,32,24576,436,62784,87360
train,5129,19,14592,154,22176,36768
train,5130,19,14592,154,22176,36768
train,5131,26,19968,288,41472,61440
train,5132,9,6912,35,5040,11952
train,5133,31,23808,409,58896,82704
train,5134,40,30720,681,98064,128784
train,5135,15,11520,96,13824,25344
train,5136,21,16128,188,27072,43200
train,5137,11,8448,52,7488,15936
train,5138,23,17664,225,32400,50064
train,5139,10,7680,43,6192,13872
train,5140,21,16128,188,27072,43200
train,5141,10,7680,43,6192,13872
train,5142,32,24576,436,62784,87360
train,5143,15,11520,96,13824,25344
train,5144,24,18432,245,35280,53712
train,5145,29,22272,358,51552,73824
train,5146,18,13824,138,19872,33696
train,5147,26,19968,288,41472,61440
train,5148,23,17664,225,32400,50064
train,5149,41,31488,716,103104,134592
train,5150,16,12288,109,15696,27984
train,5151,15,11520,96,13824,25344
train,5152,25,19200,266,38304,57504
train,5153,22,16896,206,29664,46560
train,5154,17,13056,123,17712,30768
train,5155,21,16128,188,27072,43200
train,5156,27,20736,310,44640,65376
train,5157,21,16128,188,27072,43200
train,5158,17,13056,123,17712,30768
train,5159,16,12288,109,15696,27984
train,5160,33,25344,464,66816,92160
train,5161,28,21504,334,48096,69600
train,5162,34,26112,492,70848,96960
train,5163,20,15360,170,24480,39840
train,5164,19,14592,154,22176,36768
train,5165,12,9216,61,8784,18000
train,5166,16,12288,109,15696,27984
train,5167,22,16896,206,29664,46560
train,5168,12,9216,61,8784,18000
train,5169,16,12288,109,15696,27984
train,5170,32,24576,436,62784,87360
train,5171,8,6144,27,3888,10032
train,5172,12,9216,61,8784,18000
train,5173,12,9216,61,8784,18000
train,5174,18,13824,138,19872,33696
train,5175,17,13056,123,17712,30768
train,5176,12,9216,61,8784,18000
train,5177,12,9216,61,8784,18000
train,5178,9,6912,35,5040,11952
train,5179,18,13824,138,19872,33696
train,5180,36,27648,583,83952,111600
train,5181,29,22272,358,51552,73824
train,5182,27,20736,310,44640,65376
train,5183,26,19968,288,41472,61440
train,5184,28,21504,334,48096,69600
train,5185,46,35328,901,129744,165072
train,5186,31,23808,409,58896,82704
train,5187,29,22272,358,51552,73824
train,5188,27,20736,310,44640,65376
train,5189,25,19200,266,38304,57504
train,5190,13,9984,72,10368,20352
train,5191,13,9984,72,10368,20352
train,5192,31,23808,409,58896,82704
train,5193,8,6144,27,3888,10032
train,5194,3,2304,4,576,2880
train,5195,46,35328,901,129744,165072
train,5196,9,6912,35,5040,11952
train,5197,19,14592,154,22176,36768
train,5198,37,28416,583,83952,112368
train,5199,16,12288,109,15696,27984
train,5200,9,6912,35,5040,11952
train,5201,13,9984,72,10368,20352
train,5202,9,6912,35,5040,11952
train,5203,31,23808,409,58896,82704
train,5204,3,2304,4,576,2880
train,5205,29,22272,358,51552,73824
train,5206,33,25344,464,66816,92160
train,5207,34,26112,492,70848,96960
train,5208,20,15360,170,24480,39840
train,5209,30,23040,383,55152,78192
train,5210,25,19200,288,41472,60672
train,5211,10,7680,43,6192,13872
train,5212,12,9216,61,8784,18000
train,5213,10,7680,43,6192,13872
train,5214,13,9984,72,10368,20352
train,5215,12,9216,61,8784,18000
train,5216,30,23040,383,55152,78192
train,5217,25,19200,266,38304,57504
train,5218,15,11520,96,13824,25344
train,5219,33,25344,464,66816,92160
train,5220,14,10752,84,12096,22848
train,5221,8,6144,27,3888,10032
train,5222,25,19200,266,38304,57504
train,5223,6,4608,15,2160,6768
train,5224,23,17664,225,32400,50064
train,5225,46,35328,901,129744,165072
train,5226,20,15360,170,24480,39840
train,5227,35,26880,522,75168,102048
train,5228,30,23040,383,55152,78192
train,5229,22,16896,206,29664,46560
train,5230,25,19200,266,38304,57504
train,5231,21,16128,188,27072,43200
train,5232,25,19200,266,38304,57504
train,5233,15,11520,96,13824,25344
train,5234,39,29952,648,93312,123264
train,5235,14,10752,84,12096,22848
train,5236,5,3840,11,1584,5424
train,5237,20,15360,170,24480,39840
train,5238,27,20736,310,44640,65376
train,5239,30,23040,383,55152,78192
train,5240,42,32256,751,108144,140400
train,5241,15,11520,96,13824,25344
train,5242,18,13824,138,19872,33696
train,5243,22,16896,206,29664,46560
train,5244,20,15360,170,24480,39840
train,5245,19,14592,154,22176,36768
train,5246,13,9984,72,10368,20352
train,5247,11,8448,52,7488,15936
train,5248,16,12288,109,15696,27984
train,5249,30,23040,383,55152,78192
train,5250,13,9984,72,10368,20352
train,5251,21,16128,188,27072,43200
train,5252,19,14592,154,22176,36768
train,5253,22,16896,206,29664,46560
train,5254,14,10752,84,12096,22848
train,5255,29,22272,358,51552,73824
train,5256,14,10752,84,12096,22848
train,5257,10,7680,43,6192,13872
train,5258,8,6144,27,3888,10032
train,5259,10,7680,43,6192,13872
train,5260,32,24576,436,62784,87360
train,5261,11,8448,52,7488,15936
train,5262,33,25344,464,66816,92160
train,5263,39,29952,648,93312,123264
train,5264,23,17664,225,32400,50064
train,5265,15,11520,96,13824,25344
train,5266,21,16128,188,27072,43200
train,5267,19,14592,154,22176,36768
train,5268,41,31488,716,103104,134592
train,5269,8,6144,27,3888,10032
train,5270,9,6912,35,5040,11952
train,5271,28,21504,334,48096,69600
train,5272,16,12288,109,15696,27984
train,5273,23,17664,225,32400,50064
train,5274,35,26880,522,75168,102048
train,5275,19,14592,154,22176,36768
train,5276,35,26880,522,75168,102048
train,5277,23,17664,225,32400,50064
train,5278,14,10752,84,12096,22848
train,5279,17,13056,123,17712,30768
train,5280,24,18432,245,35280,53712
train,5281,37,28416,583,83952,112368
train,5282,26,19968,288,41472,61440
train,5283,14,10752,84,12096,22848
train,5284,24,18432,245,35280,53712
train,5285,15,11520,96,13824,25344
train,5286,20,15360,170,24480,39840
train,5287,31,23808,409,58896,82704
train,5288,22,16896,206,29664,46560
train,5289,22,16896,206,29664,46560
train,5290,18,13824,138,19872,33696
train,5291,23,17664,225,32400,50064
train,5292,13,9984,72,10368,20352
train,5293,14,10752,84,12096,22848
train,5294,26,19968,288,41472,61440
train,5295,34,26112,492,70848,96960
train,5296,24,18432,245,35280,53712
train,5297,16,12288,109,15696,27984
train,5298,22,16896,206,29664,46560
train,5299,22,16896,206,29664,46560
train,5300,11,8448,52,7488,15936
train,5301,11,8448,52,7488,15936
train,5302,7,5376,21,3024,8400
train,5303,13,9984,72,10368,20352
train,5304,17,13056,123,17712,30768
train,5305,26,19968,288,41472,61440
train,5306,25,19200,266,38304,57504
train,5307,27,20736,310,44640,65376
train,5308,11,8448,52,7488,15936
train,5309,8,6144,27,3888,10032
train,5310,22,16896,206,29664,46560
train,5311,3,2304,4,576,2880
train,5312,16,12288,109,15696,27984
train,5313,15,11520,96,13824,25344
train,5314,40,30720,681,98064,128784
train,5315,14,10752,84,12096,22848
train,5316,24,18432,245,35280,53712
train,5317,19,14592,154,22176,36768
train,5318,21,16128,206,29664,45792
train,5319,30,23040,383,55152,78192
train,5320,37,28416,615,88560,116976
train,5321,20,15360,170,24480,39840
train,5322,23,17664,225,32400,50064
train,5323,32,24576,436,62784,87360
train,5324,13,9984,72,10368,20352
train,5325,15,11520,96,13824,25344
train,5326,17,13056,123,17712,30768
train,5327,17,13056,123,17712,30768
train,5328,5,3840,11,1584,5424
train,5329,30,23040,383,55152,78192
train,5330,5,3840,11,1584,5424
train,5331,35,26880,522,75168,102048
train,5332,22,16896,206,29664,46560
train,5333,9,6912,35,5040,11952
train,5334,17,13056,123,17712,30768
train,5335,11,8448,52,7488,15936
train,5336,14,10752,84,12096,22848
train,5337,20,15360,170,24480,39840
train,5338,4,3072,11,1584,4656
train,5339,17,13056,123,17712,30768
train,5340,9,6912,35,5040,11952
train,5341,40,30720,681,98064,128784
train,5342,25,19200,266,38304,57504
train,5343,10,7680,43,6192,13872
train,5344,24,18432,245,35280,53712
train,5345,16,12288,109,15696,27984
train,5346,23,17664,225,32400,50064
train,5347,4,3072,7,1008,4080
train,5348,12,9216,61,8784,18000
train,5349,18,13824,138,19872,33696
train,5350,25,19200,266,38304,57504
train,5351,29,22272,358,51552,73824
train,5352,25,19200,266,38304,57504
train,5353,18,13824,138,19872,33696
train,5354,23,17664,225,32400,50064
train,5355,31,23808,409,58896,82704
train,5356,6,4608,15,2160,6768
train,5357,9,6912,35,5040,11952
train,5358,6,4608,15,2160,6768
train,5359,16,12288,109,15696,27984
train,5360,22,16896,206,29664,46560
train,5361,23,17664,225,32400,50064
train,5362,31,23808,409,58896,82704
train,5363,16,12288,109,15696,27984
train,5364,21,16128,188,27072,43200
train,5365,16,12288,109,15696,27984
train,5366,18,13824,138,19872,33696
train,5367,13,9984,72,10368,20352
train,5368,26,19968,288,41472,61440
train,5369,11,8448,52,7488,15936
train,5370,17,13056,123,17712,30768
train,5371,17,13056,123,17712,30768
train,5372,20,15360,170,24480,39840
train,5373,22,16896,206,29664,46560
train,5374,21,16128,188,27072,43200
train,5375,7,5376,21,3024,8400
train,5376,40,30720,681,98064,128784
train,5377,16,12288,109,15696,27984
train,5378,41,31488,716,103104,134592
train,5379,5,3840,11,1584,5424
train,5380,32,24576,436,62784,87360
train,5381,24,18432,245,35280,53712
train,5382,19,14592,154,22176,36768
train,5383,30,23040,383,55152,78192
train,5384,21,16128,188,27072,43200
train,5385,7,5376,21,3024,8400
train,5386,18,13824,138,19872,33696
train,5387,15,11520,96,13824,25344
train,5388,32,24576,436,62784,87360
train,5389,29,22272,358,51552,73824
train,5390,17,13056,123,17712,30768
train,5391,22,16896,225,32400,49296
train,5392,12,9216,72,10368,19584
train,5393,25,19200,266,38304,57504
train,5394,7,5376,27,3888,9264
train,5395,8,6144,27,3888,10032
train,5396,10,7680,43,6192,13872
train,5397,23,17664,225,32400,50064
train,5398,14,10752,84,12096,22848
train,5399,13,9984,72,10368,20352
train,5400,7,5376,27,3888,9264
train,5401,25,19200,266,38304,57504
train,5402,8,6144,27,3888,10032
train,5403,3,2304,4,576,2880
train,5404,25,19200,266,38304,57504
train,5405,11,8448,52,7488,15936
train,5406,32,24576,436,62784,87360
train,5407,25,19200,266,38304,57504
train,5408,21,16128,188,27072,43200
train,5409,6,4608,15,2160,6768
train,5410,30,23040,383,55152,78192
train,5411,26,19968,288,41472,61440
train,5412,14,10752,84,12096,22848
train,5413,12,9216,61,8784,18000
train,5414,19,14592,154,22176,36768
train,5415,20,15360,170,24480,39840
train,5416,41,31488,716,103104,134592
train,5417,37,28416,583,83952,112368
train,5418,29,22272,358,51552,73824
train,5419,25,19200,266,38304,57504
train,5420,21,16128,188,27072,43200
train,5421,32,24576,436,62784,87360
train,5422,22,16896,206,29664,46560
train,5423,9,6912,35,5040,11952
train,5424,20,15360,170,24480,39840
train,5425,18,13824,138,19872,33696
train,5426,21,16128,188,27072,43200
train,5427,7,5376,21,3024,8400
train,5428,28,21504,334,48096,69600
train,5429,12,9216,72,10368,19584
train,5430,12,9216,61,8784,18000
train,5431,35,26880,522,75168,102048
train,5432,15,11520,96,13824,25344
train,5433,17,13056,123,17712,30768
train,5434,17,13056,123,17712,30768
train,5435,10,7680,43,6192,13872
train,5436,19,14592,154,22176,36768
train,5437,24,18432,245,35280,53712
train,5438,15,11520,96,13824,25344
train,5439,33,25344,464,66816,92160
train,5440,18,13824,138,19872,33696
train,5441,29,22272,358,51552,73824
train,5442,39,29952,648,93312,123264
train,5443,13,9984,72,10368,20352
train,5444,29,22272,358,51552,73824
train,5445,18,13824,138,19872,33696
train,5446,23,17664,225,32400,50064
train,5447,6,4608,15,2160,6768
train,5448,11,8448,52,7488,15936
train,5449,23,17664,225,32400,50064
train,5450,31,23808,409,58896,82704
train,5451,20,15360,170,24480,39840
train,5452,39,29952,648,93312,123264
train,5453,28,21504,334,48096,69600
train,5454,24,18432,245,35280,53712
train,5455,36,27648,552,79488,107136
train,5456,10,7680,43,6192,13872
train,5457,23,17664,225,32400,50064
train,5458,26,19968,288,41472,61440
train,5459,33,25344,464,66816,92160
train,5460,23,17664,225,32400,50064
train,5461,20,15360,170,24480,39840
train,5462,21,16128,188,27072,43200
train,5463,25,19200,266,38304,57504
train,5464,30,23040,383,55152,78192
train,5465,9,6912,35,5040,11952
train,5466,25,19200,266,38304,57504
train,5467,4,3072,7,1008,4080
train,5468,14,10752,84,12096,22848
train,5469,16,12288,109,15696,27984
train,5470,26,19968,288,41472,61440
train,5471,10,7680,43,6192,13872
train,5472,34,26112,492,70848,96960
train,5473,20,15360,170,24480,39840
train,5474,24,18432,266,38304,56736
train,5475,9,6912,35,5040,11952
train,5476,34,26112,492,70848,96960
train,5477,39,29952,648,93312,123264
train,5478,16,12288,109,15696,27984
train,5479,2,1536,2,288,1824
train,5480,30,23040,383,55152,78192
train,5481,8,6144,27,3888,10032
train,5482,22,16896,206,29664,46560
train,5483,10,7680,43,6192,13872
train,5484,18,13824,138,19872,33696
train,5485,22,16896,206,29664,46560
train,5486,36,27648,552,79488,107136
train,5487,13,9984,72,10368,20352
train,5488,8,6144,27,3888,10032
train,5489,35,26880,522,75168,102048
train,5490,15,11520,96,13824,25344
train,5491,32,24576,436,62784,87360
train,5492,21,16128,188,27072,43200
train,5493,28,21504,334,48096,69600
train,5494,35,26880,522,75168,102048
train,5495,25,19200,266,38304,57504
train,5496,12,9216,61,8784,18000
train,5497,27,20736,310,44640,65376
train,5498,19,14592,154,22176,36768
train,5499,13,9984,72,10368,20352
train,5500,15,11520,96,13824,25344
train,5501,23,17664,245,35280,52944
train,5502,21,16128,188,27072,43200
train,5503,25,19200,266,38304,57504
train,5504,4,3072,7,1008,4080
train,5505,14,10752,84,12096,22848
train,5506,7,5376,21,3024,8400
train,5507,36,27648,552,79488,107136
train,5508,28,21504,334,48096,69600
train,5509,22,16896,206,29664,46560
train,5510,27,20736,310,44640,65376
train,5511,27,20736,310,44640,65376
train,5512,25,19200,266,38304,57504
train,5513,25,19200,266,38304,57504
train,5514,21,16128,188,27072,43200
train,5515,14,10752,84,12096,22848
train,5516,10,7680,43,6192,13872
train,5517,17,13056,123,17712,30768
train,5518,14,10752,84,12096,22848
train,5519,30,23040,409,58896,81936
train,5520,39,29952,648,93312,123264
train,5521,22,16896,206,29664,46560
train,5522,22,16896,206,29664,46560
train,5523,22,16896,206,29664,46560
train,5524,20,15360,170,24480,39840
train,5525,16,12288,109,15696,27984
train,5526,19,14592,154,22176,36768
train,5527,21,16128,188,27072,43200
train,5528,14,10752,96,13824,24576
train,5529,26,19968,288,41472,61440
train,5530,25,19200,266,38304,57504
train,5531,19,14592,154,22176,36768
train,5532,12,9216,61,8784,18000
train,5533,13,9984,72,10368,20352
train,5534,7,5376,21,3024,8400
train,5535,13,9984,72,10368,20352
train,5536,36,27648,552,79488,107136
train,5537,4,3072,7,1008,4080
train,5538,8,6144,27,3888,10032
train,5539,14,10752,84,12096,22848
train,5540,31,23808,409,58896,82704
train,5541,34,26112,492,70848,96960
train,5542,34,26112,492,70848,96960
train,5543,23,17664,225,32400,50064
train,5544,27,20736,310,44640,65376
train,5545,9,6912,35,5040,11952
train,5546,29,22272,358,51552,73824
train,5547,34,26112,492,70848,96960
train,5548,22,16896,206,29664,46560
train,5549,13,9984,72,10368,20352
train,5550,22,16896,206,29664,46560
train,5551,36,27648,552,79488,107136
train,5552,42,32256,751,108144,140400
train,5553,10,7680,43,6192,13872
train,5554,24,18432,245,35280,53712
train,5555,10,7680,43,6192,13872
train,5556,17,13056,123,17712,30768
train,5557,24,18432,245,35280,53712
train,5558,26,19968,288,41472,61440
train,5559,39,29952,648,93312,123264
train,5560,13,9984,72,10368,20352
train,5561,34,26112,492,70848,96960
train,5562,38,29184,615,88560,117744
train,5563,16,12288,109,15696,27984
train,5564,14,10752,84,12096,22848
train,5565,21,16128,188,27072,43200
train,5566,10,7680,43,6192,13872
train,5567,25,19200,266,38304,57504
train,5568,11,8448,52,7488,15936
train,5569,18,13824,138,19872,33696
train,5570,23,17664,225,32400,50064
train,5571,11,8448,52,7488,15936
train,5572,33,25344,464,66816,92160
train,5573,37,28416,583,83952,112368
train,5574,36,27648,552,79488,107136
train,5575,17,13056,123,17712,30768
train,5576,8,6144,27,3888,10032
train,5577,19,14592,154,22176,36768
train,5578,10,7680,43,6192,13872
train,5579,30,23040,383,55152,78192
train,5580,7,5376,21,3024,8400
train,5581,21,16128,188,27072,43200
train,5582,21,16128,188,27072,43200
train,5583,34,26112,492,70848,96960
train,5584,13,9984,72,10368,20352
train,5585,24,18432,245,35280,53712
train,5586,9,6912,35,5040,11952
train,5587,12,9216,61,8784,18000
train,5588,27,20736,310,44640,65376
train,5589,30,23040,383,55152,78192
train,5590,32,24576,436,62784,87360
train,5591,16,12288,109,15696,27984
train,5592,23,17664,225,32400,50064
train,5593,24,18432,245,35280,53712
train,5594,10,7680,43,6192,13872
train,5595,37,28416,583,83952,112368
train,5596,19,14592,154,22176,36768
train,5597,15,11520,96,13824,25344
train,5598,23,17664,225,32400,50064
train,5599,10,7680,43,6192,13872
train,5600,16,12288,109,15696,27984
train,5601,18,13824,138,19872,33696
train,5602,25,19200,266,38304,57504
train,5603,23,17664,225,32400,50064
train,5604,15,11520,96,13824,25344
train,5605,27,20736,310,44640,65376
train,5606,10,7680,43,6192,13872
train,5607,17,13056,123,17712,30768
train,5608,24,18432,245,35280,53712
train,5609,18,13824,138,19872,33696
train,5610,21,16128,188,27072,43200
train,5611,17,13056,123,17712,30768
train,5612,17,13056,123,17712,30768
train,5613,28,21504,334,48096,69600
train,5614,26,19968,288,41472,61440
train,5615,16,12288,109,15696,27984
train,5616,12,9216,61,8784,18000
train,5617,19,14592,154,22176,36768
train,5618,15,11520,96,13824,25344
train,5619,9,6912,35,5040,11952
train,5620,6,4608,15,2160,6768
train,5621,5,3840,11,1584,5424
train,5622,13,9984,72,10368,20352
train,5623,25,19200,266,38304,57504
train,5624,23,17664,225,32400,50064
train,5625,35,26880,522,75168,102048
train,5626,20,15360,170,24480,39840
train,5627,31,23808,436,62784,86592
train,5628,18,13824,138,19872,33696
train,5629,25,19200,266,38304,57504
train,5630,32,24576,436,62784,87360
train,5631,15,11520,96,13824,25344
train,5632,11,8448,52,7488,15936
train,5633,5,3840,11,1584,5424
train,5634,25,19200,266,38304,57504
train,5635,23,17664,225,32400,50064
train,5636,30,23040,383,55152,78192
train,5637,15,11520,96,13824,25344
train,5638,17,13056,123,17712,30768
train,5639,23,17664,225,32400,50064
train,5640,25,19200,266,38304,57504
train,5641,25,19200,266,38304,57504
train,5642,11,8448,52,7488,15936
train,5643,11,8448,52,7488,15936
train,5644,20,15360,170,24480,39840
train,5645,16,12288,109,15696,27984
train,5646,8,6144,27,3888,10032
train,5647,23,17664,225,32400,50064
train,5648,22,16896,206,29664,46560
train,5649,27,20736,310,44640,65376
train,5650,22,16896,206,29664,46560
train,5651,23,17664,225,32400,50064
train,5652,14,10752,84,12096,22848
train,5653,23,17664,225,32400,50064
train,5654,21,16128,188,27072,43200
train,5655,2,1536,2,288,1824
train,5656,6,4608,15,2160,6768
train,5657,36,27648,552,79488,107136
train,5658,30,23040,383,55152,78192
train,5659,29,22272,358,51552,73824
train,5660,25,19200,266,38304,57504
train,5661,26,19968,288,41472,61440
train,5662,16,12288,109,15696,27984
train,5663,16,12288,109,15696,27984
train,5664,25,19200,266,38304,57504
train,5665,37,28416,583,83952,112368
train,5666,32,24576,436,62784,87360
train,5667,14,10752,84,12096,22848
train,5668,11,8448,52,7488,15936
train,5669,12,9216,61,8784,18000
train,5670,19,14592,154,22176,36768
train,5671,7,5376,21,3024,8400
train,5672,18,13824,138,19872,33696
train,5673,23,17664,225,32400,50064
train,5674,23,17664,225,32400,50064
train,5675,14,10752,84,12096,22848
train,5676,19,14592,154,22176,36768
train,5677,19,14592,154,22176,36768
train,5678,23,17664,225,32400,50064
train,5679,25,19200,266,38304,57504
train,5680,19,14592,154,22176,36768
train,5681,22,16896,206,29664,46560
train,5682,11,8448,52,7488,15936
train,5683,35,26880,522,75168,102048
train,5684,18,13824,138,19872,33696
train,5685,11,8448,52,7488,15936
train,5686,24,18432,245,35280,53712
train,5687,13,9984,72,10368,20352
train,5688,20,15360,170,24480,39840
train,5689,37,28416,583,83952,112368
train,5690,33,25344,464,66816,92160
train,5691,20,15360,170,24480,39840
train,5692,5,3840,11,1584,5424
train,5693,23,17664,225,32400,50064
train,5694,28,21504,334,48096,69600
train,5695,27,20736,310,44640,65376
train,5696,38,29184,615,88560,117744
train,5697,13,9984,72,10368,20352
train,5698,30,23040,383,55152,78192
train,5699,28,21504,334,48096,69600
train,5700,23,17664,225,32400,50064
train,5701,3,2304,4,576,2880
train,5702,11,8448,52,7488,15936
train,5703,15,11520,96,13824,25344
train,5704,17,13056,123,17712,30768
train,5705,3,2304,4,576,2880
train,5706,17,13056,123,17712,30768
train,5707,19,14592,154,22176,36768
train,5708,24,18432,245,35280,53712
train,5709,33,25344,464,66816,92160
train,5710,31,23808,409,58896,82704
train,5711,2,1536,2,288,1824
train,5712,15,11520,96,13824,25344
train,5713,28,21504,334,48096,69600
train,5714,24,18432,245,35280,53712
train,5715,7,5376,21,3024,8400
train,5716,29,22272,358,51552,73824
train,5717,14,10752,84,12096,22848
train,5718,20,15360,170,24480,39840
train,5719,12,9216,61,8784,18000
train,5720,33,25344,464,66816,92160
train,5721,20,15360,188,27072,42432
train,5722,5,3840,15,2160,6000
train,5723,22,16896,206,29664,46560
train,5724,20,15360,170,24480,39840
train,5725,14,10752,84,12096,22848
train,5726,18,13824,138,19872,33696
train,5727,9,6912,35,5040,11952
train,5728,31,23808,409,58896,82704
train,5729,22,16896,206,29664,46560
train,5730,32,24576,436,62784,87360
train,5731,7,5376,21,3024,8400
train,5732,7,5376,21,3024,8400
train,5733,29,22272,358,51552,73824
train,5734,18,13824,138,19872,33696
train,5735,12,9216,61,8784,18000
train,5736,19,14592,154,22176,36768
train,5737,28,21504,334,48096,69600
train,5738,19,14592,154,22176,36768
train,5739,32,24576,436,62784,87360
train,5740,7,5376,21,3024,8400
train,5741,21,16128,188,27072,43200
train,5742,19,14592,154,22176,36768
train,5743,5,3840,11,1584,5424
train,5744,15,11520,96,13824,25344
train,5745,14,10752,84,12096,22848
train,5746,9,6912,35,5040,11952
train,5747,21,16128,188,27072,43200
train,5748,36,27648,552,79488,107136
train,5749,28,21504,334,48096,69600
train,5750,13,9984,72,10368,20352
train,5751,40,30720,681,98064,128784
train,5752,36,27648,552,79488,107136
train,5753,5,3840,11,1584,5424
train,5754,36,27648,552,79488,107136
train,5755,16,12288,109,15696,27984
train,5756,31,23808,409,58896,82704
train,5757,29,22272,358,51552,73824
train,5758,14,10752,84,12096,22848
train,5759,25,19200,266,38304,57504
train,5760,18,13824,138,19872,33696
train,5761,37,28416,583,83952,112368
train,5762,34,26112,492,70848,96960
train,5763,15,11520,96,13824,25344
train,5764,15,11520,96,13824,25344
train,5765,11,8448,52,7488,15936
train,5766,29,22272,358,51552,73824
train,5767,3,2304,4,576,2880
train,5768,29,22272,358,51552,73824
train,5769,28,21504,334,48096,69600
train,5770,25,19200,266,38304,57504
train,5771,13,9984,72,10368,20352
train,5772,22,16896,206,29664,46560
train,5773,21,16128,188,27072,43200
train,5774,27,20736,310,44640,65376
train,5775,18,13824,138,19872,33696
train,5776,29,22272,358,51552,73824
train,5777,36,27648,552,79488,107136
train,5778,16,12288,109,15696,27984
train,5779,18,13824,138,19872,33696
train,5780,46,35328,901,129744,165072
train,5781,8,6144,27,3888,10032
train,5782,11,8448,52,7488,15936
train,5783,28,21504,334,48096,69600
train,5784,18,13824,138,19872,33696
train,5785,15,11520,96,13824,25344
train,5786,9,6912,35,5040,11952
train,5787,46,35328,901,129744,165072
train,5788,28,21504,334,48096,69600
train,5789,27,20736,334,48096,68832
train,5790,33,25344,464,66816,92160
train,5791,10,7680,43,6192,13872
train,5792,6,4608,15,2160,6768
train,5793,12,9216,61,8784,18000
train,5794,9,6912,35,5040,11952
train,5795,12,9216,61,8784,18000
train,5796,27,20736,310,44640,65376
train,5797,32,24576,436,62784,87360
train,5798,29,22272,358,51552,73824
train,5799,21,16128,188,27072,43200
train,5800,34,26112,492,70848,96960
train,5801,3,2304,4,576,2880
train,5802,31,23808,409,58896,82704
train,5803,15,11520,96,13824,25344
train,5804,24,18432,266,38304,56736
train,5805,21,16128,188,27072,43200
train,5806,21,16128,188,27072,43200
train,5807,15,11520,96,13824,25344
train,5808,24,18432,245,35280,53712
train,5809,9,6912,35,5040,11952
train,5810,31,23808,409,58896,82704
train,5811,25,19200,266,38304,57504
train,5812,19,14592,154,22176,36768
train,5813,28,21504,334,48096,69600
train,5814,14,10752,84,12096,22848
train,5815,6,4608,15,2160,6768
train,5816,31,23808,409,58896,82704
train,5817,32,24576,436,62784,87360
train,5818,7,5376,21,3024,8400
train,5819,20,15360,170,24480,39840
train,5820,23,17664,225,32400,50064
train,5821,4,3072,7,1008,4080
train,5822,20,15360,170,24480,39840
train,5823,15,11520,96,13824,25344
train,5824,20,15360,170,24480,39840
train,5825,8,6144,27,3888,10032
train,5826,21,16128,188,27072,43200
train,5827,15,11520,96,13824,25344
train,5828,25,19200,266,38304,57504
train,5829,19,14592,154,22176,36768
train,5830,22,16896,206,29664,46560
train,5831,18,13824,138,19872,33696
train,5832,25,19200,266,38304,57504
train,5833,23,17664,245,35280,52944
train,5834,23,17664,225,32400,50064
train,5835,38,29184,615,88560,117744
train,5836,31,23808,409,58896,82704
train,5837,32,24576,464,66816,91392
train,5838,25,19200,266,38304,57504
train,5839,27,20736,310,44640,65376
train,5840,34,26112,492,70848,96960
train,5841,20,15360,170,24480,39840
train,5842,21,16128,188,27072,43200
train,5843,20,15360,170,24480,39840
train,5844,3,2304,4,576,2880
train,5845,12,9216,61,8784,18000
train,5846,21,16128,188,27072,43200
train,5847,12,9216,61,8784,18000
train,5848,15,11520,96,13824,25344
train,5849,6,4608,15,2160,6768
train,5850,43,33024,787,113328,146352
train,5851,21,16128,188,27072,43200
train,5852,18,13824,154,22176,36000
train,5853,12,9216,61,8784,18000
train,5854,9,6912,35,5040,11952
train,5855,13,9984,72,10368,20352
train,5856,19,14592,154,22176,36768
train,5857,19,14592,154,22176,36768
train,5858,30,23040,383,55152,78192
train,5859,30,23040,383,55152,78192
train,5860,11,8448,52,7488,15936
train,5861,28,21504,334,48096,69600
train,5862,29,22272,358,51552,73824
train,5863,15,11520,96,13824,25344
train,5864,7,5376,21,3024,8400
train,5865,8,6144,27,3888,10032
train,5866,10,7680,43,6192,13872
train,5867,45,34560,862,124128,158688
train,5868,13,9984,72,10368,20352
train,5869,22,16896,206,29664,46560
train,5870,29,22272,358,51552,73824
train,5871,28,21504,334,48096,69600
train,5872,16,12288,109,15696,27984
train,5873,11,8448,52,7488,15936
train,5874,26,19968,288,41472,61440
train,5875,17,13056,123,17712,30768
train,5876,33,25344,464,66816,92160
train,5877,41,31488,716,103104,134592
train,5878,22,16896,206,29664,46560
train,5879,31,23808,409,58896,82704
train,5880,11,8448,52,7488,15936
train,5881,36,27648,552,79488,107136
train,5882,9,6912,35,5040,11952
train,5883,16,12288,109,15696,27984
train,5884,19,14592,154,22176,36768
train,5885,20,15360,170,24480,39840
train,5886,21,16128,188,27072,43200
train,5887,20,15360,170,24480,39840
train,5888,37,28416,583,83952,112368
train,5889,24,18432,245,35280,53712
train,5890,14,10752,84,12096,22848
train,5891,37,28416,583,83952,112368
train,5892,14,10752,84,12096,22848
train,5893,10,7680,43,6192,13872
train,5894,13,9984,72,10368,20352
train,5895,31,23808,409,58896,82704
train,5896,19,14592,154,22176,36768
train,5897,34,26112,492,70848,96960
train,5898,21,16128,188,27072,43200
train,5899,25,19200,266,38304,57504
train,5900,22,16896,225,32400,49296
train,5901,23,17664,225,32400,50064
train,5902,9,6912,35,5040,11952
train,5903,27,20736,310,44640,65376
train,5904,15,11520,96,13824,25344
train,5905,32,24576,464,66816,91392
train,5906,24,18432,245,35280,53712
train,5907,20,15360,170,24480,39840
train,5908,9,6912,35,5040,11952
train,5909,16,12288,109,15696,27984
train,5910,14,10752,84,12096,22848
train,5911,27,20736,310,44640,65376
train,5912,10,7680,43,6192,13872
train,5913,37,28416,583,83952,112368
train,5914,23,17664,225,32400,50064
train,5915,13,9984,72,10368,20352
train,5916,14,10752,96,13824,24576
train,5917,25,19200,266,38304,57504
train,5918,11,8448,52,7488,15936
train,5919,11,8448,52,7488,15936
train,5920,12,9216,61,8784,18000
train,5921,29,22272,358,51552,73824
train,5922,31,23808,409,58896,82704
train,5923,6,4608,15,2160,6768
train,5924,6,4608,15,2160,6768
train,5925,39,29952,648,93312,123264
train,5926,21,16128,188,27072,43200
train,5927,3,2304,4,576,2880
train,5928,25,19200,266,38304,57504
train,5929,25,19200,266,38304,57504
train,5930,30,23040,383,55152,78192
train,5931,11,8448,52,7488,15936
train,5932,20,15360,170,24480,39840
train,5933,8,6144,27,3888,10032
train,5934,18,13824,138,19872,33696
train,5935,21,16128,188,27072,43200
train,5936,18,13824,138,19872,33696
train,5937,9,6912,35,5040,11952
train,5938,21,16128,188,27072,43200
train,5939,23,17664,225,32400,50064
train,5940,35,26880,522,75168,102048
train,5941,25,19200,266,38304,57504
train,5942,23,17664,225,32400,50064
train,5943,17,13056,123,17712,30768
train,5944,34,26112,492,70848,96960
train,5945,7,5376,21,3024,8400
train,5946,14,10752,84,12096,22848
train,5947,27,20736,310,44640,65376
train,5948,13,9984,72,10368,20352
train,5949,22,16896,206,29664,46560
train,5950,10,7680,43,6192,13872
train,5951,23,17664,225,32400,50064
train,5952,17,13056,123,17712,30768
train,5953,20,15360,170,24480,39840
train,5954,26,19968,310,44640,64608
train,5955,29,22272,358,51552,73824
train,5956,37,28416,583,83952,112368
train,5957,23,17664,225,32400,50064
train,5958,18,13824,138,19872,33696
train,5959,27,20736,310,44640,65376
train,5960,17,13056,123,17712,30768
train,5961,22,16896,206,29664,46560
train,5962,26,19968,288,41472,61440
train,5963,43,33024,787,113328,146352
train,5964,13,9984,72,10368,20352
train,5965,23,17664,225,32400,50064
train,5966,16,12288,109,15696,27984
train,5967,30,23040,383,55152,78192
train,5968,16,12288,109,15696,27984
train,5969,21,16128,188,27072,43200
train,5970,40,30720,681,98064,128784
train,5971,21,16128,206,29664,45792
train,5972,9,6912,35,5040,11952
train,5973,26,19968,288,41472,61440
train,5974,20,15360,170,24480,39840
train,5975,15,11520,96,13824,25344
train,5976,20,15360,170,24480,39840
train,5977,23,17664,225,32400,50064
train,5978,23,17664,225,32400,50064
train,5979,35,26880,552,79488,106368
train,5980,23,17664,225,32400,50064
train,5981,36,27648,552,79488,107136
train,5982,28,21504,334,48096,69600
train,5983,9,6912,35,5040,11952
train,5984,21,16128,206,29664,45792
train,5985,26,19968,288,41472,61440
train,5986,20,15360,170,24480,39840
train,5987,37,28416,583,83952,112368
train,5988,20,15360,170,24480,39840
train,5989,27,20736,310,44640,65376
train,5990,24,18432,245,35280,53712
train,5991,24,18432,245,35280,53712
train,5992,6,4608,15,2160,6768
train,5993,14,10752,84,12096,22848
train,5994,35,26880,522,75168,102048
train,5995,19,14592,154,22176,36768
train,5996,18,13824,138,19872,33696
train,5997,9,6912,35,5040,11952
train,5998,32,24576,436,62784,87360
train,5999,30,23040,383,55152,78192
train,6000,33,25344,492,70848,96192
train,6001,17,13056,123,17712,30768
train,6002,29,22272,358,51552,73824
train,6003,24,18432,245,35280,53712
train,6004,19,14592,154,22176,36768
train,6005,35,26880,522,75168,102048
train,6006,23,17664,245,35280,52944
train,6007,19,14592,154,22176,36768
train,6008,15,11520,96,13824,25344
train,6009,28,21504,334,48096,69600
train,6010,32,24576,436,62784,87360
train,6011,30,23040,383,55152,78192
train,6012,23,17664,225,32400,50064
train,6013,7,5376,21,3024,8400
train,6014,45,34560,862,124128,158688
train,6015,22,16896,206,29664,46560
train,6016,22,16896,206,29664,46560
train,6017,25,19200,266,38304,57504
train,6018,22,16896,206,29664,46560
train,6019,26,19968,288,41472,61440
train,6020,30,23040,383,55152,78192
train,6021,13,9984,72,10368,20352
train,6022,20,15360,170,24480,39840
train,6023,11,8448,52,7488,15936
train,6024,17,13056,123,17712,30768
train,6025,21,16128,188,27072,43200
train,6026,31,23808,409,58896,82704
train,6027,10,7680,43,6192,13872
train,6028,15,11520,96,13824,25344
train,6029,24,18432,245,35280,53712
train,6030,5,3840,11,1584,5424
train,6031,17,13056,138,19872,32928
train,6032,11,8448,52,7488,15936
train,6033,23,17664,225,32400,50064
train,6034,14,10752,84,12096,22848
train,6035,28,21504,358,51552,73056
train,6036,17,13056,123,17712,30768
train,6037,40,30720,681,98064,128784
train,6038,7,5376,21,3024,8400
train,6039,15,11520,96,13824,25344
train,6040,31,23808,436,62784,86592
train,6041,11,8448,52,7488,15936
train,6042,23,17664,225,32400,50064
train,6043,16,12288,109,15696,27984
train,6044,18,13824,138,19872,33696
train,6045,45,34560,862,124128,158688
train,6046,36,27648,583,83952,111600
train,6047,17,13056,123,17712,30768
train,6048,31,23808,409,58896,82704
train,6049,23,17664,225,32400,50064
train,6050,24,18432,245,35280,53712
train,6051,13,9984,72,10368,20352
train,6052,11,8448,52,7488,15936
train,6053,27,20736,310,44640,65376
train,6054,20,15360,170,24480,39840
train,6055,11,8448,52,7488,15936
train,6056,32,24576,436,62784,87360
train,6057,10,7680,43,6192,13872
train,6058,21,16128,188,27072,43200
train,6059,6,4608,15,2160,6768
train,6060,24,18432,245,35280,53712
train,6061,16,12288,109,15696,27984
train,6062,28,21504,334,48096,69600
train,6063,27,20736,310,44640,65376
train,6064,23,17664,225,32400,50064
train,6065,19,14592,154,22176,36768
train,6066,29,22272,358,51552,73824
train,6067,12,9216,61,8784,18000
train,6068,19,14592,154,22176,36768
train,6069,26,19968,288,41472,61440
train,6070,9,6912,35,5040,11952
train,6071,12,9216,61,8784,18000
train,6072,31,23808,409,58896,82704
train,6073,18,13824,138,19872,33696
train,6074,31,23808,409,58896,82704
train,6075,19,14592,154,22176,36768
train,6076,40,30720,681,98064,128784
train,6077,5,3840,11,1584,5424
train,6078,7,5376,21,3024,8400
train,6079,20,15360,170,24480,39840
train,6080,16,12288,109,15696,27984
train,6081,12,9216,61,8784,18000
train,6082,24,18432,245,35280,53712
train,6083,18,13824,138,19872,33696
train,6084,14,10752,84,12096,22848
train,6085,6,4608,15,2160,6768
train,6086,22,16896,206,29664,46560
train,6087,28,21504,334,48096,69600
train,6088,21,16128,188,27072,43200
train,6089,9,6912,35,5040,11952
train,6090,9,6912,35,5040,11952
train,6091,21,16128,188,27072,43200
train,6092,14,10752,84,12096,22848
train,6093,19,14592,154,22176,36768
train,6094,15,11520,96,13824,25344
train,6095,27,20736,310,44640,65376
train,6096,18,13824,138,19872,33696
train,6097,21,16128,188,27072,43200
train,6098,29,22272,358,51552,73824
train,6099,13,9984,72,10368,20352
train,6100,6,4608,15,2160,6768
train,6101,15,11520,96,13824,25344
train,6102,22,16896,206,29664,46560
train,6103,8,6144,27,3888,10032
train,6104,9,6912,35,5040,11952
train,6105,21,16128,188,27072,43200
train,6106,26,19968,288,41472,61440
train,6107,17,13056,123,17712,30768
train,6108,11,8448,52,7488,15936
train,6109,30,23040,436,62784,85824
train,6110,22,16896,206,29664,46560
train,6111,7,5376,21,3024,8400
train,6112,32,24576,436,62784,87360
train,6113,11,8448,52,7488,15936
train,6114,15,11520,96,13824,25344
train,6115,20,15360,170,24480,39840
train,6116,22,16896,206,29664,46560
train,6117,21,16128,188,27072,43200
train,6118,33,25344,464,66816,92160
train,6119,32,24576,436,62784,87360
train,6120,23,17664,225,32400,50064
train,6121,5,3840,11,1584,5424
train,6122,23,17664,225,32400,50064
train,6123,28,21504,334,48096,69600
train,6124,37,28416,583,83952,112368
train,6125,29,22272,358,51552,73824
train,6126,16,12288,109,15696,27984
train,6127,12,9216,61,8784,18000
train,6128,24,18432,245,35280,53712
train,6129,12,9216,61,8784,18000
train,6130,17,13056,123,17712,30768
train,6131,20,15360,170,24480,39840
train,6132,8,6144,27,3888,10032
train,6133,21,16128,188,27072,43200
train,6134,9,6912,43,6192,13104
train,6135,15,11520,96,13824,25344
train,6136,20,15360,170,24480,39840
train,6137,26,19968,288,41472,61440
train,6138,20,15360,170,24480,39840
train,6139,22,16896,206,29664,46560
train,6140,19,14592,154,22176,36768
train,6141,14,10752,84,12096,22848
train,6142,15,11520,96,13824,25344
train,6143,24,18432,245,35280,53712
train,6144,16,12288,109,15696,27984
train,6145,14,10752,84,12096,22848
train,6146,18,13824,138,19872,33696
train,6147,27,20736,310,44640,65376
train,6148,28,21504,334,48096,69600
train,6149,12,9216,61,8784,18000
train,6150,34,26112,492,70848,96960
train,6151,8,6144,27,3888,10032
train,6152,18,13824,138,19872,33696
train,6153,19,14592,154,22176,36768
train,6154,16,12288,109,15696,27984
train,6155,36,27648,552,79488,107136
train,6156,25,19200,266,38304,57504
train,6157,24,18432,245,35280,53712
train,6158,31,23808,409,58896,82704
train,6159,27,20736,310,44640,65376
train,6160,35,26880,522,75168,102048
train,6161,20,15360,170,24480,39840
train,6162,35,26880,522,75168,102048
train,6163,17,13056,123,17712,30768
train,6164,22,16896,206,29664,46560
train,6165,34,26112,492,70848,96960
train,6166,8,6144,27,3888,10032
train,6167,4,3072,7,1008,4080
train,6168,11,8448,52,7488,15936
train,6169,23,17664,225,32400,50064
train,6170,26,19968,288,41472,61440
train,6171,16,12288,109,15696,27984
train,6172,28,21504,334,48096,69600
train,6173,9,6912,35,5040,11952
train,6174,17,13056,123,17712,30768
train,6175,26,19968,288,41472,61440
train,6176,17,13056,123,17712,30768
train,6177,8,6144,27,3888,10032
train,6178,27,20736,310,44640,65376
train,6179,19,14592,154,22176,36768
train,6180,13,9984,72,10368,20352
train,6181,28,21504,334,48096,69600
train,6182,12,9216,61,8784,18000
train,6183,13,9984,72,10368,20352
train,6184,24,18432,245,35280,53712
train,6185,34,26112,492,70848,96960
train,6186,34,26112,492,70848,96960
train,6187,19,14592,154,22176,36768
train,6188,3,2304,4,576,2880
train,6189,17,13056,123,17712,30768
train,6190,15,11520,96,13824,25344
train,6191,27,20736,310,44640,65376
train,6192,18,13824,138,19872,33696
train,6193,9,6912,35,5040,11952
train,6194,17,13056,123,17712,30768
train,6195,18,13824,138,19872,33696
train,6196,5,3840,11,1584,5424
train,6197,14,10752,84,12096,22848
train,6198,39,29952,648,93312,123264
train,6199,26,19968,288,41472,61440
train,6200,30,23040,383,55152,78192
train,6201,20,15360,170,24480,39840
train,6202,28,21504,334,48096,69600
train,6203,37,28416,583,83952,112368
train,6204,22,16896,206,29664,46560
train,6205,19,14592,154,22176,36768
train,6206,28,21504,334,48096,69600
train,6207,24,18432,245,35280,53712
train,6208,32,24576,436,62784,87360
train,6209,21,16128,188,27072,43200
train,6210,17,13056,123,17712,30768
train,6211,22,16896,206,29664,46560
train,6212,24,18432,245,35280,53712
train,6213,10,7680,43,6192,13872
train,6214,13,9984,72,10368,20352
train,6215,26,19968,288,41472,61440
train,6216,36,27648,583,83952,111600
train,6217,24,18432,245,35280,53712
train,6218,28,21504,334,48096,69600
train,6219,28,21504,334,48096,69600
train,6220,24,18432,245,35280,53712
train,6221,25,19200,266,38304,57504
train,6222,20,15360,170,24480,39840
train,6223,16,12288,109,15696,27984
train,6224,26,19968,288,41472,61440
train,6225,30,23040,383,55152,78192
train,6226,28,21504,334,48096,69600
train,6227,26,19968,288,41472,61440
train,6228,21,16128,188,27072,43200
train,6229,19,14592,154,22176,36768
train,6230,30,23040,383,55152,78192
train,6231,11,8448,52,7488,15936
train,6232,6,4608,15,2160,6768
train,6233,11,8448,52,7488,15936
train,6234,10,7680,43,6192,13872
train,6235,36,27648,552,79488,107136
train,6236,31,23808,409,58896,82704
train,6237,7,5376,21,3024,8400
train,6238,17,13056,123,17712,30768
train,6239,29,22272,358,51552,73824
train,6240,22,16896,206,29664,46560
train,6241,31,23808,409,58896,82704
train,6242,25,19200,266,38304,57504
train,6243,13,9984,72,10368,20352
train,6244,10,7680,52,7488,15168
train,6245,20,15360,170,24480,39840
train,6246,10,7680,43,6192,13872
train,6247,27,20736,310,44640,65376
train,6248,35,26880,522,75168,102048
train,6249,31,23808,409,58896,82704
train,6250,31,23808,409,58896,82704
train,6251,6,4608,15,2160,6768
train,6252,32,24576,436,62784,87360
train,6253,6,4608,15,2160,6768
train,6254,18,13824,138,19872,33696
train,6255,19,14592,154,22176,36768
train,6256,8,6144,27,3888,10032
train,6257,11,8448,52,7488,15936
train,6258,22,16896,206,29664,46560
train,6259,20,15360,170,24480,39840
train,6260,7,5376,21,3024,8400
train,6261,29,22272,358,51552,73824
train,6262,23,17664,225,32400,50064
train,6263,34,26112,492,70848,96960
train,6264,30,23040,383,55152,78192
train,6265,5,3840,11,1584,5424
train,6266,14,10752,84,12096,22848
train,6267,24,18432,245,35280,53712
train,6268,45,34560,862,124128,158688
train,6269,18,13824,138,19872,33696
train,6270,26,19968,310,44640,64608
train,6271,20,15360,170,24480,39840
train,6272,24,18432,245,35280,53712
train,6273,20,15360,170,24480,39840
train,6274,10,7680,43,6192,13872
train,6275,28,21504,334,48096,69600
train,6276,12,9216,61,8784,18000
train,6277,19,14592,154,22176,36768
train,6278,12,9216,61,8784,18000
train,6279,10,7680,43,6192,13872
train,6280,25,19200,266,38304,57504
train,6281,17,13056,123,17712,30768
train,6282,38,29184,615,88560,117744
train,6283,24,18432,245,35280,53712
train,6284,23,17664,225,32400,50064
train,6285,6,4608,15,2160,6768
train,6286,36,27648,552,79488,107136
train,6287,33,25344,464,66816,92160
train,6288,40,30720,681,98064,128784
train,6289,35,26880,522,75168,102048
train,6290,28,21504,334,48096,69600
train,6291,34,26112,492,70848,96960
train,6292,6,4608,15,2160,6768
train,6293,28,21504,334,48096,69600
train,6294,21,16128,188,27072,43200
train,6295,25,19200,266,38304,57504
train,6296,23,17664,225,32400,50064
train,6297,11,8448,52,7488,15936
train,6298,18,13824,138,19872,33696
train,6299,26,19968,288,41472,61440
train,6300,27,20736,310,44640,65376
train,6301,8,6144,27,3888,10032
train,6302,20,15360,170,24480,39840
train,6303,22,16896,206,29664,46560
train,6304,24,18432,245,35280,53712
train,6305,13,9984,72,10368,20352
train,6306,24,18432,266,38304,56736
train,6307,25,19200,266,38304,57504
train,6308,15,11520,96,13824,25344
train,6309,23,17664,225,32400,50064
train,6310,41,31488,716,103104,134592
train,6311,34,26112,492,70848,96960
train,6312,25,19200,266,38304,57504
train,6313,5,3840,11,1584,5424
train,6314,27,20736,310,44640,65376
train,6315,36,27648,552,79488,107136
train,6316,22,16896,206,29664,46560
train,6317,29,22272,358,51552,73824
train,6318,11,8448,52,7488,15936
train,6319,13,9984,72,10368,20352
train,6320,10,7680,43,6192,13872
train,6321,28,21504,334,48096,69600
train,6322,35,26880,522,75168,102048
train,6323,11,8448,52,7488,15936
train,6324,19,14592,154,22176,36768
train,6325,23,17664,225,32400,50064
train,6326,17,13056,123,17712,30768
train,6327,21,16128,188,27072,43200
train,6328,11,8448,52,7488,15936
train,6329,12,9216,61,8784,18000
train,6330,20,15360,170,24480,39840
train,6331,35,26880,583,83952,110832
train,6332,36,27648,552,79488,107136
train,6333,31,23808,409,58896,82704
train,6334,29,22272,358,51552,73824
train,6335,11,8448,52,7488,15936
train,6336,15,11520,96,13824,25344
train,6337,21,16128,188,27072,43200
train,6338,17,13056,123,17712,30768
train,6339,23,17664,225,32400,50064
train,6340,38,29184,615,88560,117744
train,6341,22,16896,206,29664,46560
train,6342,24,18432,245,35280,53712
train,6343,13,9984,72,10368,20352
train,6344,12,9216,61,8784,18000
train,6345,20,15360,170,24480,39840
train,6346,17,13056,123,17712,30768
train,6347,19,14592,154,22176,36768
train,6348,7,5376,27,3888,9264
train,6349,31,23808,409,58896,82704
train,6350,42,32256,751,108144,140400
train,6351,29,22272,358,51552,73824
train,6352,20,15360,170,24480,39840
train,6353,15,11520,96,13824,25344
train,6354,25,19200,266,38304,57504
train,6355,33,25344,464,66816,92160
train,6356,29,22272,358,51552,73824
train,6357,22,16896,206,29664,46560
train,6358,28,21504,334,48096,69600
train,6359,12,9216,61,8784,18000
train,6360,26,19968,288,41472,61440
train,6361,35,26880,522,75168,102048
train,6362,19,14592,154,22176,36768
train,6363,3,2304,4,576,2880
train,6364,10,7680,43,6192,13872
train,6365,28,21504,334,48096,69600
train,6366,13,9984,72,10368,20352
train,6367,9,6912,35,5040,11952
train,6368,7,5376,21,3024,8400
train,6369,37,28416,583,83952,112368
train,6370,7,5376,21,3024,8400
train,6371,21,16128,188,27072,43200
train,6372,30,23040,383,55152,78192
train,6373,18,13824,138,19872,33696
train,6374,23,17664,225,32400,50064
train,6375,23,17664,225,32400,50064
train,6376,26,19968,288,41472,61440
train,6377,11,8448,52,7488,15936
train,6378,16,12288,109,15696,27984
train,6379,15,11520,96,13824,25344
train,6380,35,26880,522,75168,102048
train,6381,15,11520,96,13824,25344
train,6382,19,14592,154,22176,36768
train,6383,22,16896,206,29664,46560
train,6384,6,4608,15,2160,6768
train,6385,18,13824,138,19872,33696
train,6386,23,17664,225,32400,50064
train,6387,38,29184,615,88560,117744
train,6388,30,23040,383,55152,78192
train,6389,14,10752,84,12096,22848
train,6390,27,20736,310,44640,65376
train,6391,28,21504,334,48096,69600
train,6392,14,10752,84,12096,22848
train,6393,39,29952,648,93312,123264
train,6394,5,3840,15,2160,6000
train,6395,26,19968,288,41472,61440
train,6396,11,8448,52,7488,15936
train,6397,23,17664,225,32400,50064
train,6398,18,13824,138,19872,33696
train,6399,12,9216,61,8784,18000
train,6400,37,28416,583,83952,112368
train,6401,26,19968,288,41472,61440
train,6402,8,6144,27,3888,10032
train,6403,9,6912,35,5040,11952
train,6404,13,9984,72,10368,20352
train,6405,10,7680,43,6192,13872
train,6406,7,5376,21,3024,8400
train,6407,11,8448,52,7488,15936
train,6408,7,5376,21,3024,8400
train,6409,23,17664,225,32400,50064
train,6410,34,26112,492,70848,96960
train,6411,12,9216,61,8784,18000
train,6412,32,24576,436,62784,87360
train,6413,23,17664,225,32400,50064
train,6414,17,13056,123,17712,30768
train,6415,27,20736,310,44640,65376
train,6416,32,24576,436,62784,87360
train,6417,23,17664,225,32400,50064
train,6418,18,13824,138,19872,33696
train,6419,16,12288,109,15696,27984
train,6420,20,15360,170,24480,39840
train,6421,17,13056,123,17712,30768
train,6422,16,12288,109,15696,27984
train,6423,8,6144,27,3888,10032
train,6424,14,10752,84,12096,22848
train,6425,18,13824,138,19872,33696
train,6426,22,16896,206,29664,46560
train,6427,31,23808,409,58896,82704
train,6428,19,14592,154,22176,36768
train,6429,6,4608,15,2160,6768
train,6430,17,13056,123,17712,30768
train,6431,17,13056,123,17712,30768
train,6432,7,5376,21,3024,8400
train,6433,32,24576,464,66816,91392
train,6434,13,9984,72,10368,20352
train,6435,20,15360,170,24480,39840
train,6436,22,16896,206,29664,46560
train,6437,19,14592,154,22176,36768
train,6438,34,26112,492,70848,96960
train,6439,34,26112,522,75168,101280
train,6440,31,23808,409,58896,82704
train,6441,23,17664,225,32400,50064
train,6442,13,9984,72,10368,20352
train,6443,35,26880,522,75168,102048
train,6444,11,8448,52,7488,15936
train,6445,7,5376,21,3024,8400
train,6446,5,3840,11,1584,5424
train,6447,8,6144,27,3888,10032
train,6448,24,18432,245,35280,53712
train,6449,22,16896,206,29664,46560
train,6450,24,18432,245,35280,53712
train,6451,10,7680,43,6192,13872
train,6452,27,20736,310,44640,65376
train,6453,12,9216,61,8784,18000
train,6454,5,3840,11,1584,5424
train,6455,14,10752,84,12096,22848
train,6456,20,15360,170,24480,39840
train,6457,20,15360,170,24480,39840
train,6458,31,23808,409,58896,82704
train,6459,21,16128,188,27072,43200
train,6460,14,10752,84,12096,22848
train,6461,12,9216,61,8784,18000
train,6462,23,17664,225,32400,50064
train,6463,5,3840,11,1584,5424
train,6464,18,13824,138,19872,33696
train,6465,13,9984,72,10368,20352
train,6466,14,10752,84,12096,22848
train,6467,38,29184,648,93312,122496
train,6468,10,7680,43,6192,13872
train,6469,24,18432,245,35280,53712
train,6470,25,19200,266,38304,57504
train,6471,23,17664,225,32400,50064
train,6472,13,9984,72,10368,20352
train,6473,9,6912,35,5040,11952
train,6474,10,7680,43,6192,13872
train,6475,40,30720,681,98064,128784
train,6476,13,9984,72,10368,20352
train,6477,29,22272,358,51552,73824
train,6478,23,17664,225,32400,50064
train,6479,24,18432,245,35280,53712
train,6480,11,8448,52,7488,15936
train,6481,33,25344,464,66816,92160
train,6482,21,16128,188,27072,43200
train,6483,12,9216,61,8784,18000
train,6484,43,33024,787,113328,146352
train,6485,22,16896,206,29664,46560
train,6486,23,17664,225,32400,50064
train,6487,39,29952,648,93312,123264
train,6488,16,12288,109,15696,27984
train,6489,4,3072,7,1008,4080
train,6490,23,17664,225,32400,50064
train,6491,34,26112,492,70848,96960
train,6492,27,20736,310,44640,65376
train,6493,41,31488,716,103104,134592
train,6494,20,15360,170,24480,39840
train,6495,23,17664,225,32400,50064
train,6496,33,25344,464,66816,92160
train,6497,24,18432,245,35280,53712
train,6498,15,11520,96,13824,25344
train,6499,46,35328,901,129744,165072
train,6500,22,16896,206,29664,46560
train,6501,28,21504,334,48096,69600
train,6502,4,3072,7,1008,4080
train,6503,27,20736,310,44640,65376
train,6504,24,18432,245,35280,53712
train,6505,20,15360,170,24480,39840
train,6506,27,20736,310,44640,65376
train,6507,10,7680,43,6192,13872
train,6508,10,7680,43,6192,13872
train,6509,24,18432,245,35280,53712
train,6510,14,10752,84,12096,22848
train,6511,19,14592,154,22176,36768
train,6512,17,13056,123,17712,30768
train,6513,25,19200,266,38304,57504
train,6514,27,20736,310,44640,65376
train,6515,7,5376,21,3024,8400
train,6516,23,17664,225,32400,50064
train,6517,22,16896,206,29664,46560
train,6518,7,5376,21,3024,8400
train,6519,5,3840,11,1584,5424
train,6520,9,6912,35,5040,11952
train,6521,3,2304,4,576,2880
train,6522,19,14592,154,22176,36768
train,6523,18,13824,138,19872,33696
train,6524,19,14592,154,22176,36768
train,6525,16,12288,109,15696,27984
train,6526,7,5376,21,3024,8400
train,6527,17,13056,123,17712,30768
train,6528,2,1536,2,288,1824
train,6529,14,10752,84,12096,22848
train,6530,18,13824,138,19872,33696
train,6531,25,19200,266,38304,57504
train,6532,19,14592,154,22176,36768
train,6533,15,11520,96,13824,25344
train,6534,28,21504,334,48096,69600
train,6535,21,16128,188,27072,43200
train,6536,18,13824,138,19872,33696
train,6537,33,25344,464,66816,92160
train,6538,38,29184,648,93312,122496
train,6539,7,5376,21,3024,8400
train,6540,23,17664,225,32400,50064
train,6541,22,16896,206,29664,46560
train,6542,9,6912,35,5040,11952
train,6543,19,14592,170,24480,39072
train,6544,29,22272,358,51552,73824
train,6545,34,26112,492,70848,96960
train,6546,11,8448,52,7488,15936
train,6547,23,17664,225,32400,50064
train,6548,29,22272,358,51552,73824
train,6549,14,10752,84,12096,22848
train,6550,12,9216,61,8784,18000
train,6551,11,8448,52,7488,15936
train,6552,4,3072,7,1008,4080
train,6553,19,14592,154,22176,36768
train,6554,20,15360,170,24480,39840
train,6555,10,7680,43,6192,13872
train,6556,17,13056,123,17712,30768
train,6557,13,9984,72,10368,20352
train,6558,16,12288,109,15696,27984
train,6559,32,24576,436,62784,87360
train,6560,10,7680,43,6192,13872
train,6561,9,6912,35,5040,11952
train,6562,6,4608,15,2160,6768
train,6563,4,3072,7,1008,4080
train,6564,7,5376,21,3024,8400
train,6565,5,3840,11,1584,5424
train,6566,36,27648,552,79488,107136
train,6567,29,22272,358,51552,73824
train,6568,30,23040,383,55152,78192
train,6569,20,15360,170,24480,39840
train,6570,41,31488,716,103104,134592
train,6571,12,9216,61,8784,18000
train,6572,18,13824,138,19872,33696
train,6573,24,18432,245,35280,53712
train,6574,29,22272,358,51552,73824
train,6575,27,20736,310,44640,65376
train,6576,11,8448,52,7488,15936
train,6577,11,8448,52,7488,15936
train,6578,15,11520,96,13824,25344
train,6579,24,18432,245,35280,53712
train,6580,13,9984,72,10368,20352
train,6581,40,30720,681,98064,128784
train,6582,5,3840,11,1584,5424
train,6583,12,9216,61,8784,18000
train,6584,17,13056,123,17712,30768
train,6585,25,19200,266,38304,57504
train,6586,22,16896,206,29664,46560
train,6587,28,21504,334,48096,69600
train,6588,25,19200,266,38304,57504
train,6589,14,10752,84,12096,22848
train,6590,13,9984,72,10368,20352
train,6591,14,10752,84,12096,22848
train,6592,23,17664,225,32400,50064
train,6593,11,8448,52,7488,15936
train,6594,12,9216,61,8784,18000
train,6595,26,19968,288,41472,61440
train,6596,41,31488,716,103104,134592
train,6597,9,6912,35,5040,11952
train,6598,19,14592,154,22176,36768
train,6599,24,18432,245,35280,53712
train,6600,14,10752,84,12096,22848
train,6601,7,5376,21,3024,8400
train,6602,11,8448,52,7488,15936
train,6603,20,15360,170,24480,39840
train,6604,24,18432,245,35280,53712
train,6605,4,3072,7,1008,4080
train,6606,11,8448,52,7488,15936
train,6607,27,20736,310,44640,65376
train,6608,16,12288,109,15696,27984
train,6609,15,11520,96,13824,25344
train,6610,17,13056,123,17712,30768
train,6611,18,13824,138,19872,33696
train,6612,20,15360,170,24480,39840
train,6613,23,17664,225,32400,50064
train,6614,3,2304,4,576,2880
train,6615,18,13824,138,19872,33696
train,6616,16,12288,109,15696,27984
train,6617,18,13824,138,19872,33696
train,6618,38,29184,615,88560,117744
train,6619,26,19968,288,41472,61440
train,6620,25,19200,266,38304,57504
train,6621,20,15360,170,24480,39840
train,6622,24,18432,245,35280,53712
train,6623,26,19968,288,41472,61440
train,6624,8,6144,27,3888,10032
train,6625,19,14592,154,22176,36768
train,6626,16,12288,109,15696,27984
train,6627,36,27648,552,79488,107136
train,6628,18,13824,138,19872,33696
train,6629,6,4608,15,2160,6768
train,6630,28,21504,334,48096,69600
train,6631,14,10752,84,12096,22848
train,6632,22,16896,206,29664,46560
train,6633,16,12288,109,15696,27984
train,6634,14,10752,84,12096,22848
train,6635,27,20736,310,44640,65376
train,6636,22,16896,206,29664,46560
train,6637,18,13824,138,19872,33696
train,6638,4,3072,7,1008,4080
train,6639,15,11520,96,13824,25344
train,6640,6,4608,15,2160,6768
train,6641,17,13056,123,17712,30768
train,6642,37,28416,583,83952,112368
train,6643,10,7680,43,6192,13872
train,6644,20,15360,170,24480,39840
train,6645,8,6144,27,3888,10032
train,6646,35,26880,522,75168,102048
train,6647,29,22272,409,58896,81168
train,6648,29,22272,358,51552,73824
train,6649,20,15360,170,24480,39840
train,6650,23,17664,225,32400,50064
train,6651,11,8448,52,7488,15936
train,6652,26,19968,288,41472,61440
train,6653,25,19200,266,38304,57504
train,6654,12,9216,61,8784,18000
train,6655,22,16896,206,29664,46560
train,6656,29,22272,358,51552,73824
train,6657,22,16896,206,29664,46560
train,6658,14,10752,84,12096,22848
train,6659,21,16128,188,27072,43200
train,6660,29,22272,358,51552,73824
train,6661,10,7680,43,6192,13872
train,6662,10,7680,43,6192,13872
train,6663,29,22272,358,51552,73824
train,6664,20,15360,170,24480,39840
train,6665,10,7680,43,6192,13872
train,6666,12,9216,61,8784,18000
train,6667,6,4608,15,2160,6768
train,6668,28,21504,334,48096,69600
train,6669,29,22272,358,51552,73824
train,6670,26,19968,288,41472,61440
train,6671,29,22272,358,51552,73824
train,6672,15,11520,96,13824,25344
train,6673,39,29952,648,93312,123264
train,6674,12,9216,61,8784,18000
train,6675,13,9984,72,10368,20352
train,6676,7,5376,21,3024,8400
train,6677,16,12288,109,15696,27984
train,6678,26,19968,288,41472,61440
train,6679,20,15360,170,24480,39840
train,6680,26,19968,288,41472,61440
train,6681,21,16128,188,27072,43200
train,6682,22,16896,206,29664,46560
train,6683,47,36096,940,135360,171456
train,6684,29,22272,358,51552,73824
train,6685,21,16128,188,27072,43200
train,6686,13,9984,72,10368,20352
train,6687,3,2304,4,576,2880
train,6688,12,9216,61,8784,18000
train,6689,12,9216,61,8784,18000
train,6690,16,12288,109,15696,27984
train,6691,28,21504,334,48096,69600
train,6692,26,19968,288,41472,61440
train,6693,15,11520,96,13824,25344
train,6694,18,13824,138,19872,33696
train,6695,39,29952,648,93312,123264
train,6696,30,23040,409,58896,81936
train,6697,30,23040,409,58896,81936
train,6698,30,23040,383,55152,78192
train,6699,12,9216,61,8784,18000
train,6700,25,19200,266,38304,57504
train,6701,5,3840,11,1584,5424
train,6702,25,19200,266,38304,57504
train,6703,12,9216,61,8784,18000
train,6704,22,16896,206,29664,46560
train,6705,4,3072,7,1008,4080
train,6706,14,10752,84,12096,22848
train,6707,20,15360,170,24480,39840
train,6708,12,9216,61,8784,18000
train,6709,16,12288,109,15696,27984
train,6710,23,17664,225,32400,50064
train,6711,34,26112,492,70848,96960
train,6712,38,29184,615,88560,117744
train,6713,29,22272,358,51552,73824
train,6714,22,16896,206,29664,46560
train,6715,22,16896,206,29664,46560
train,6716,20,15360,170,24480,39840
train,6717,31,23808,409,58896,82704
train,6718,8,6144,27,3888,10032
train,6719,17,13056,123,17712,30768
train,6720,9,6912,35,5040,11952
train,6721,14,10752,84,12096,22848
train,6722,31,23808,409,58896,82704
train,6723,8,6144,27,3888,10032
train,6724,17,13056,123,17712,30768
train,6725,17,13056,123,17712,30768
train,6726,27,20736,310,44640,65376
train,6727,32,24576,436,62784,87360
train,6728,13,9984,72,10368,20352
train,6729,13,9984,72,10368,20352
train,6730,4,3072,7,1008,4080
train,6731,5,3840,11,1584,5424
train,6732,32,24576,436,62784,87360
train,6733,20,15360,170,24480,39840
train,6734,24,18432,245,35280,53712
train,6735,32,24576,436,62784,87360
train,6736,21,16128,188,27072,43200
train,6737,13,9984,72,10368,20352
train,6738,13,9984,72,10368,20352
train,6739,17,13056,123,17712,30768
train,6740,34,26112,492,70848,96960
train,6741,31,23808,409,58896,82704
train,6742,13,9984,72,10368,20352
train,6743,24,18432,245,35280,53712
train,6744,19,14592,154,22176,36768
train,6745,15,11520,96,13824,25344
train,6746,24,18432,245,35280,53712
train,6747,7,5376,21,3024,8400
train,6748,5,3840,11,1584,5424
train,6749,16,12288,109,15696,27984
train,6750,29,22272,358,51552,73824
train,6751,20,15360,170,24480,39840
train,6752,27,20736,310,44640,65376
train,6753,30,23040,383,55152,78192
train,6754,25,19200,266,38304,57504
train,6755,4,3072,7,1008,4080
train,6756,17,13056,123,17712,30768
train,6757,24,18432,245,35280,53712
train,6758,19,14592,154,22176,36768
train,6759,19,14592,154,22176,36768
train,6760,18,13824,138,19872,33696
train,6761,10,7680,43,6192,13872
train,6762,38,29184,615,88560,117744
train,6763,22,16896,206,29664,46560
train,6764,30,23040,383,55152,78192
train,6765,36,27648,552,79488,107136
train,6766,32,24576,436,62784,87360
train,6767,20,15360,170,24480,39840
train,6768,26,19968,288,41472,61440
train,6769,6,4608,15,2160,6768
train,6770,9,6912,35,5040,11952
train,6771,7,5376,21,3024,8400
train,6772,12,9216,61,8784,18000
train,6773,7,5376,21,3024,8400
train,6774,4,3072,7,1008,4080
train,6775,31,23808,409,58896,82704
train,6776,5,3840,11,1584,5424
train,6777,15,11520,96,13824,25344
train,6778,24,18432,245,35280,53712
train,6779,30,23040,383,55152,78192
train,6780,29,22272,358,51552,73824
train,6781,23,17664,225,32400,50064
train,6782,34,26112,492,70848,96960
train,6783,30,23040,383,55152,78192
train,6784,40,30720,681,98064,128784
train,6785,30,23040,383,55152,78192
train,6786,11,8448,52,7488,15936
train,6787,12,9216,61,8784,18000
train,6788,29,22272,358,51552,73824
train,6789,16,12288,109,15696,27984
train,6790,8,6144,27,3888,10032
train,6791,36,27648,552,79488,107136
train,6792,22,16896,206,29664,46560
train,6793,33,25344,464,66816,92160
train,6794,20,15360,170,24480,39840
train,6795,21,16128,188,27072,43200
train,6796,11,8448,52,7488,15936
train,6797,19,14592,154,22176,36768
train,6798,8,6144,27,3888,10032
train,6799,24,18432,245,35280,53712
train,6800,6,4608,15,2160,6768
train,6801,13,9984,72,10368,20352
train,6802,11,8448,52,7488,15936
train,6803,16,12288,109,15696,27984
train,6804,21,16128,188,27072,43200
train,6805,8,6144,27,3888,10032
train,6806,34,26112,492,70848,96960
train,6807,10,7680,43,6192,13872
train,6808,17,13056,123,17712,30768
train,6809,9,6912,35,5040,11952
train,6810,20,15360,170,24480,39840
train,6811,27,20736,310,44640,65376
train,6812,18,13824,138,19872,33696
train,6813,22,16896,206,29664,46560
train,6814,8,6144,27,3888,10032
train,6815,37,28416,583,83952,112368
train,6816,22,16896,206,29664,46560
train,6817,32,24576,436,62784,87360
train,6818,19,14592,154,22176,36768
train,6819,18,13824,138,19872,33696
train,6820,29,22272,358,51552,73824
train,6821,24,18432,245,35280,53712
train,6822,7,5376,21,3024,8400
train,6823,17,13056,123,17712,30768
train,6824,11,8448,52,7488,15936
train,6825,34,26112,492,70848,96960
train,6826,43,33024,787,113328,146352
train,6827,20,15360,170,24480,39840
train,6828,8,6144,27,3888,10032
train,6829,28,21504,334,48096,69600
train,6830,27,20736,310,44640,65376
train,6831,11,8448,52,7488,15936
train,6832,22,16896,206,29664,46560
train,6833,41,31488,716,103104,134592
train,6834,36,27648,552,79488,107136
train,6835,21,16128,188,27072,43200
train,6836,22,16896,206,29664,46560
train,6837,14,10752,84,12096,22848
train,6838,21,16128,188,27072,43200
train,6839,18,13824,138,19872,33696
train,6840,6,4608,15,2160,6768
train,6841,12,9216,61,8784,18000
train,6842,23,17664,225,32400,50064
train,6843,8,6144,27,3888,10032
train,6844,18,13824,154,22176,36000
train,6845,31,23808,409,58896,82704
train,6846,25,19200,266,38304,57504
train,6847,32,24576,436,62784,87360
train,6848,16,12288,109,15696,27984
train,6849,28,21504,334,48096,69600
train,6850,34,26112,492,70848,96960
train,6851,28,21504,334,48096,69600
train,6852,23,17664,225,32400,50064
train,6853,18,13824,138,19872,33696
train,6854,15,11520,96,13824,25344
train,6855,22,16896,206,29664,46560
train,6856,19,14592,154,22176,36768
train,6857,23,17664,225,32400,50064
train,6858,17,13056,123,17712,30768
train,6859,18,13824,138,19872,33696
train,6860,26,19968,288,41472,61440
train,6861,20,15360,170,24480,39840
train,6862,20,15360,170,24480,39840
train,6863,15,11520,96,13824,25344
train,6864,31,23808,409,58896,82704
train,6865,36,27648,552,79488,107136
train,6866,26,19968,288,41472,61440
train,6867,30,23040,383,55152,78192
train,6868,43,33024,787,113328,146352
train,6869,18,13824,138,19872,33696
train,6870,22,16896,206,29664,46560
train,6871,17,13056,123,17712,30768
train,6872,21,16128,188,27072,43200
train,6873,19,14592,154,22176,36768
train,6874,15,11520,96,13824,25344
train,6875,19,14592,154,22176,36768
train,6876,35,26880,522,75168,102048
train,6877,19,14592,154,22176,36768
train,6878,25,19200,266,38304,57504
train,6879,7,5376,21,3024,8400
train,6880,16,12288,109,15696,27984
train,6881,34,26112,492,70848,96960
train,6882,13,9984,72,10368,20352
train,6883,16,12288,109,15696,27984
train,6884,20,15360,170,24480,39840
train,6885,21,16128,188,27072,43200
train,6886,26,19968,288,41472,61440
train,6887,27,20736,310,44640,65376
train,6888,33,25344,464,66816,92160
train,6889,38,29184,615,88560,117744
train,6890,16,12288,109,15696,27984
train,6891,33,25344,464,66816,92160
train,6892,14,10752,84,12096,22848
train,6893,18,13824,138,19872,33696
train,6894,22,16896,206,29664,46560
train,6895,9,6912,35,5040,11952
train,6896,19,14592,170,24480,39072
train,6897,26,19968,288,41472,61440
train,6898,29,22272,358,51552,73824
train,6899,28,21504,334,48096,69600
train,6900,19,14592,154,22176,36768
train,6901,7,5376,21,3024,8400
train,6902,12,9216,61,8784,18000
train,6903,18,13824,138,19872,33696
train,6904,27,20736,310,44640,65376
train,6905,17,13056,123,17712,30768
train,6906,8,6144,27,3888,10032
train,6907,25,19200,266,38304,57504
train,6908,17,13056,123,17712,30768
train,6909,15,11520,96,13824,25344
train,6910,11,8448,52,7488,15936
train,6911,19,14592,154,22176,36768
train,6912,22,16896,206,29664,46560
train,6913,20,15360,170,24480,39840
train,6914,16,12288,123,17712,30000
train,6915,28,21504,334,48096,69600
train,6916,23,17664,225,32400,50064
train,6917,10,7680,43,6192,13872
train,6918,18,13824,138,19872,33696
train,6919,29,22272,358,51552,73824
validation,0,24,18432,245,35280,53712
validation,1,31,23808,409,58896,82704
validation,2,27,20736,334,48096,68832
validation,3,31,23808,409,58896,82704
validation,4,24,18432,245,35280,53712
validation,5,22,16896,206,29664,46560
validation,6,19,14592,154,22176,36768
validation,7,19,14592,154,22176,36768
validation,8,18,13824,138,19872,33696
validation,9,29,22272,358,51552,73824
validation,10,24,18432,245,35280,53712
validation,11,15,11520,96,13824,25344
validation,12,22,16896,206,29664,46560
validation,13,41,31488,751,108144,139632
validation,14,23,17664,225,32400,50064
validation,15,14,10752,84,12096,22848
validation,16,10,7680,43,6192,13872
validation,17,9,6912,43,6192,13104
validation,18,20,15360,170,24480,39840
validation,19,12,9216,61,8784,18000
validation,20,28,21504,334,48096,69600
validation,21,29,22272,358,51552,73824
validation,22,10,7680,43,6192,13872
validation,23,7,5376,21,3024,8400
validation,24,25,19200,266,38304,57504
validation,25,41,31488,716,103104,134592
validation,26,13,9984,72,10368,20352
validation,27,13,9984,72,10368,20352
validation,28,40,30720,681,98064,128784
validation,29,15,11520,96,13824,25344
validation,30,15,11520,96,13824,25344
validation,31,42,32256,751,108144,140400
validation,32,18,13824,138,19872,33696
validation,33,33,25344,464,66816,92160
validation,34,17,13056,123,17712,30768
validation,35,32,24576,436,62784,87360
validation,36,29,22272,358,51552,73824
validation,37,21,16128,188,27072,43200
validation,38,20,15360,170,24480,39840
validation,39,29,22272,358,51552,73824
validation,40,32,24576,436,62784,87360
validation,41,11,8448,52,7488,15936
validation,42,30,23040,383,55152,78192
validation,43,10,7680,43,6192,13872
validation,44,24,18432,245,35280,53712
validation,45,30,23040,383,55152,78192
validation,46,18,13824,138,19872,33696
validation,47,13,9984,72,10368,20352
validation,48,7,5376,21,3024,8400
validation,49,11,8448,52,7488,15936
validation,50,23,17664,225,32400,50064
validation,51,30,23040,383,55152,78192
validation,52,18,13824,138,19872,33696
validation,53,9,6912,35,5040,11952
validation,54,19,14592,170,24480,39072
validation,55,27,20736,310,44640,65376
validation,56,17,13056,123,17712,30768
validation,57,14,10752,96,13824,24576
validation,58,16,12288,109,15696,27984
validation,59,18,13824,138,19872,33696
validation,60,5,3840,11,1584,5424
validation,61,14,10752,84,12096,22848
validation,62,12,9216,61,8784,18000
validation,63,20,15360,170,24480,39840
validation,64,11,8448,52,7488,15936
validation,65,23,17664,225,32400,50064
validation,66,30,23040,383,55152,78192
validation,67,7,5376,21,3024,8400
validation,68,13,9984,72,10368,20352
validation,69,27,20736,310,44640,65376
validation,70,18,13824,138,19872,33696
validation,71,27,20736,310,44640,65376
validation,72,16,12288,109,15696,27984
validation,73,20,15360,170,24480,39840
validation,74,25,19200,266,38304,57504
validation,75,14,10752,84,12096,22848
validation,76,29,22272,358,51552,73824
validation,77,24,18432,245,35280,53712
validation,78,16,12288,109,15696,27984
validation,79,27,20736,310,44640,65376
validation,80,42,32256,751,108144,140400
validation,81,15,11520,96,13824,25344
validation,82,23,17664,225,32400,50064
validation,83,30,23040,383,55152,78192
validation,84,32,24576,436,62784,87360
validation,85,21,16128,188,27072,43200
validation,86,13,9984,72,10368,20352
validation,87,15,11520,96,13824,25344
validation,88,14,10752,84,12096,22848
validation,89,30,23040,383,55152,78192
validation,90,15,11520,96,13824,25344
validation,91,26,19968,288,41472,61440
validation,92,22,16896,206,29664,46560
validation,93,18,13824,138,19872,33696
validation,94,24,18432,245,35280,53712
validation,95,30,23040,383,55152,78192
validation,96,41,31488,716,103104,134592
validation,97,27,20736,310,44640,65376
validation,98,21,16128,188,27072,43200
validation,99,19,14592,154,22176,36768
validation,100,41,31488,716,103104,134592
validation,101,18,13824,138,19872,33696
validation,102,17,13056,123,17712,30768
validation,103,42,32256,751,108144,140400
validation,104,19,14592,154,22176,36768
validation,105,18,13824,138,19872,33696
validation,106,27,20736,310,44640,65376
validation,107,39,29952,648,93312,123264
validation,108,12,9216,61,8784,18000
validation,109,19,14592,154,22176,36768
validation,110,29,22272,358,51552,73824
validation,111,35,26880,522,75168,102048
validation,112,26,19968,288,41472,61440
validation,113,23,17664,225,32400,50064
validation,114,28,21504,334,48096,69600
validation,115,6,4608,15,2160,6768
validation,116,33,25344,464,66816,92160
validation,117,26,19968,288,41472,61440
validation,118,18,13824,138,19872,33696
validation,119,19,14592,154,22176,36768
validation,120,21,16128,188,27072,43200
validation,121,26,19968,288,41472,61440
validation,122,26,19968,288,41472,61440
validation,123,10,7680,43,6192,13872
validation,124,27,20736,310,44640,65376
validation,125,12,9216,61,8784,18000
validation,126,22,16896,206,29664,46560
validation,127,24,18432,245,35280,53712
validation,128,44,33792,824,118656,152448
validation,129,28,21504,334,48096,69600
validation,130,28,21504,334,48096,69600
validation,131,26,19968,288,41472,61440
validation,132,35,26880,522,75168,102048
validation,133,34,26112,492,70848,96960
validation,134,25,19200,266,38304,57504
validation,135,26,19968,288,41472,61440
validation,136,20,15360,170,24480,39840
validation,137,37,28416,583,83952,112368
validation,138,25,19200,266,38304,57504
validation,139,13,9984,72,10368,20352
validation,140,32,24576,436,62784,87360
validation,141,37,28416,583,83952,112368
validation,142,27,20736,310,44640,65376
validation,143,20,15360,170,24480,39840
validation,144,18,13824,138,19872,33696
validation,145,35,26880,522,75168,102048
validation,146,34,26112,492,70848,96960
validation,147,21,16128,188,27072,43200
validation,148,35,26880,522,75168,102048
validation,149,18,13824,138,19872,33696
validation,150,39,29952,648,93312,123264
validation,151,21,16128,188,27072,43200
validation,152,9,6912,35,5040,11952
validation,153,11,8448,52,7488,15936
validation,154,21,16128,188,27072,43200
validation,155,7,5376,21,3024,8400
validation,156,11,8448,52,7488,15936
validation,157,23,17664,225,32400,50064
validation,158,24,18432,245,35280,53712
validation,159,12,9216,61,8784,18000
validation,160,16,12288,109,15696,27984
validation,161,18,13824,138,19872,33696
validation,162,19,14592,154,22176,36768
validation,163,25,19200,266,38304,57504
validation,164,9,6912,35,5040,11952
validation,165,17,13056,123,17712,30768
validation,166,25,19200,266,38304,57504
validation,167,28,21504,334,48096,69600
validation,168,11,8448,52,7488,15936
validation,169,10,7680,43,6192,13872
validation,170,17,13056,123,17712,30768
validation,171,21,16128,188,27072,43200
validation,172,23,17664,225,32400,50064
validation,173,21,16128,188,27072,43200
validation,174,19,14592,154,22176,36768
validation,175,38,29184,615,88560,117744
validation,176,8,6144,27,3888,10032
validation,177,23,17664,225,32400,50064
validation,178,30,23040,383,55152,78192
validation,179,19,14592,154,22176,36768
validation,180,20,15360,170,24480,39840
validation,181,33,25344,464,66816,92160
validation,182,20,15360,170,24480,39840
validation,183,18,13824,138,19872,33696
validation,184,22,16896,206,29664,46560
validation,185,9,6912,35,5040,11952
validation,186,21,16128,188,27072,43200
validation,187,23,17664,225,32400,50064
validation,188,19,14592,154,22176,36768
validation,189,13,9984,72,10368,20352
validation,190,30,23040,383,55152,78192
validation,191,25,19200,266,38304,57504
validation,192,28,21504,334,48096,69600
validation,193,11,8448,52,7488,15936
validation,194,15,11520,96,13824,25344
validation,195,12,9216,61,8784,18000
validation,196,11,8448,52,7488,15936
validation,197,18,13824,138,19872,33696
validation,198,35,26880,522,75168,102048
validation,199,15,11520,96,13824,25344
validation,200,32,24576,436,62784,87360
validation,201,29,22272,358,51552,73824
validation,202,7,5376,21,3024,8400
validation,203,9,6912,35,5040,11952
validation,204,27,20736,310,44640,65376
validation,205,14,10752,84,12096,22848
validation,206,14,10752,84,12096,22848
validation,207,29,22272,358,51552,73824
validation,208,45,34560,862,124128,158688
validation,209,3,2304,4,576,2880
validation,210,19,14592,154,22176,36768
validation,211,10,7680,43,6192,13872
validation,212,12,9216,61,8784,18000
validation,213,27,20736,310,44640,65376
validation,214,18,13824,138,19872,33696
validation,215,10,7680,43,6192,13872
validation,216,28,21504,334,48096,69600
validation,217,32,24576,464,66816,91392
validation,218,25,19200,266,38304,57504
validation,219,25,19200,266,38304,57504
validation,220,21,16128,188,27072,43200
validation,221,16,12288,109,15696,27984
validation,222,16,12288,109,15696,27984
validation,223,37,28416,583,83952,112368
validation,224,39,29952,648,93312,123264
validation,225,23,17664,225,32400,50064
validation,226,23,17664,225,32400,50064
validation,227,20,15360,170,24480,39840
validation,228,35,26880,522,75168,102048
validation,229,16,12288,109,15696,27984
validation,230,22,16896,206,29664,46560
validation,231,12,9216,61,8784,18000
validation,232,4,3072,7,1008,4080
validation,233,26,19968,288,41472,61440
validation,234,7,5376,27,3888,9264
validation,235,22,16896,206,29664,46560
validation,236,26,19968,288,41472,61440
validation,237,25,19200,266,38304,57504
validation,238,13,9984,72,10368,20352
validation,239,19,14592,154,22176,36768
validation,240,13,9984,72,10368,20352
validation,241,14,10752,84,12096,22848
validation,242,13,9984,72,10368,20352
validation,243,7,5376,21,3024,8400
validation,244,9,6912,35,5040,11952
validation,245,18,13824,154,22176,36000
validation,246,8,6144,27,3888,10032
validation,247,13,9984,84,12096,22080
validation,248,17,13056,123,17712,30768
validation,249,44,33792,824,118656,152448
validation,250,17,13056,123,17712,30768
validation,251,34,26112,492,70848,96960
validation,252,20,15360,170,24480,39840
validation,253,33,25344,464,66816,92160
validation,254,20,15360,170,24480,39840
validation,255,14,10752,84,12096,22848
validation,256,13,9984,72,10368,20352
validation,257,37,28416,583,83952,112368
validation,258,14,10752,84,12096,22848
validation,259,21,16128,188,27072,43200
validation,260,32,24576,436,62784,87360
validation,261,17,13056,123,17712,30768
validation,262,25,19200,266,38304,57504
validation,263,18,13824,138,19872,33696
validation,264,17,13056,123,17712,30768
validation,265,8,6144,27,3888,10032
validation,266,29,22272,358,51552,73824
validation,267,16,12288,123,17712,30000
validation,268,23,17664,225,32400,50064
validation,269,22,16896,206,29664,46560
validation,270,20,15360,170,24480,39840
validation,271,11,8448,52,7488,15936
validation,272,17,13056,123,17712,30768
validation,273,16,12288,109,15696,27984
validation,274,6,4608,15,2160,6768
validation,275,8,6144,27,3888,10032
validation,276,26,19968,288,41472,61440
validation,277,25,19200,266,38304,57504
validation,278,36,27648,552,79488,107136
validation,279,19,14592,154,22176,36768
validation,280,18,13824,138,19872,33696
validation,281,37,28416,583,83952,112368
validation,282,26,19968,288,41472,61440
validation,283,9,6912,35,5040,11952
validation,284,17,13056,123,17712,30768
validation,285,32,24576,436,62784,87360
validation,286,12,9216,61,8784,18000
validation,287,14,10752,84,12096,22848
validation,288,24,18432,245,35280,53712
validation,289,27,20736,310,44640,65376
validation,290,22,16896,206,29664,46560
validation,291,17,13056,123,17712,30768
validation,292,6,4608,21,3024,7632
validation,293,13,9984,72,10368,20352
validation,294,24,18432,245,35280,53712
validation,295,31,23808,409,58896,82704
validation,296,25,19200,266,38304,57504
validation,297,10,7680,43,6192,13872
validation,298,16,12288,109,15696,27984
validation,299,18,13824,138,19872,33696
validation,300,11,8448,52,7488,15936
validation,301,21,16128,188,27072,43200
validation,302,11,8448,52,7488,15936
validation,303,27,20736,310,44640,65376
validation,304,25,19200,266,38304,57504
validation,305,7,5376,21,3024,8400
validation,306,16,12288,109,15696,27984
validation,307,22,16896,206,29664,46560
validation,308,30,23040,383,55152,78192
validation,309,14,10752,84,12096,22848
validation,310,12,9216,61,8784,18000
validation,311,18,13824,138,19872,33696
validation,312,22,16896,206,29664,46560
validation,313,17,13056,123,17712,30768
validation,314,20,15360,170,24480,39840
validation,315,18,13824,138,19872,33696
validation,316,13,9984,84,12096,22080
validation,317,23,17664,225,32400,50064
validation,318,23,17664,225,32400,50064
validation,319,20,15360,170,24480,39840
validation,320,33,25344,464,66816,92160
validation,321,14,10752,84,12096,22848
validation,322,8,6144,27,3888,10032
validation,323,14,10752,84,12096,22848
validation,324,16,12288,109,15696,27984
validation,325,24,18432,245,35280,53712
validation,326,30,23040,383,55152,78192
validation,327,14,10752,84,12096,22848
validation,328,13,9984,72,10368,20352
validation,329,13,9984,72,10368,20352
validation,330,17,13056,123,17712,30768
validation,331,26,19968,288,41472,61440
validation,332,22,16896,206,29664,46560
validation,333,15,11520,96,13824,25344
validation,334,23,17664,245,35280,52944
validation,335,24,18432,245,35280,53712
validation,336,28,21504,334,48096,69600
validation,337,15,11520,96,13824,25344
validation,338,35,26880,522,75168,102048
validation,339,32,24576,436,62784,87360
validation,340,5,3840,11,1584,5424
validation,341,21,16128,188,27072,43200
validation,342,25,19200,266,38304,57504
validation,343,25,19200,266,38304,57504
validation,344,9,6912,35,5040,11952
validation,345,16,12288,109,15696,27984
validation,346,9,6912,35,5040,11952
validation,347,13,9984,72,10368,20352
validation,348,7,5376,21,3024,8400
validation,349,15,11520,96,13824,25344
validation,350,22,16896,206,29664,46560
validation,351,18,13824,138,19872,33696
validation,352,21,16128,188,27072,43200
validation,353,13,9984,72,10368,20352
validation,354,12,9216,61,8784,18000
validation,355,2,1536,2,288,1824
validation,356,6,4608,15,2160,6768
validation,357,33,25344,464,66816,92160
validation,358,15,11520,96,13824,25344
validation,359,33,25344,464,66816,92160
validation,360,21,16128,188,27072,43200
validation,361,8,6144,27,3888,10032
validation,362,39,29952,648,93312,123264
validation,363,20,15360,170,24480,39840
validation,364,17,13056,123,17712,30768
validation,365,35,26880,522,75168,102048
validation,366,8,6144,27,3888,10032
validation,367,44,33792,862,124128,157920
validation,368,8,6144,27,3888,10032
validation,369,28,21504,334,48096,69600
validation,370,15,11520,96,13824,25344
validation,371,24,18432,245,35280,53712
validation,372,26,19968,288,41472,61440
validation,373,27,20736,310,44640,65376
validation,374,22,16896,206,29664,46560
validation,375,35,26880,522,75168,102048
validation,376,24,18432,245,35280,53712
validation,377,26,19968,288,41472,61440
validation,378,5,3840,11,1584,5424
validation,379,19,14592,154,22176,36768
validation,380,33,25344,464,66816,92160
validation,381,22,16896,206,29664,46560
validation,382,38,29184,615,88560,117744
validation,383,18,13824,138,19872,33696
validation,384,18,13824,138,19872,33696
validation,385,37,28416,583,83952,112368
validation,386,13,9984,72,10368,20352
validation,387,13,9984,72,10368,20352
validation,388,6,4608,15,2160,6768
validation,389,20,15360,170,24480,39840
validation,390,11,8448,52,7488,15936
validation,391,21,16128,188,27072,43200
validation,392,6,4608,15,2160,6768
validation,393,30,23040,383,55152,78192
validation,394,26,19968,288,41472,61440
validation,395,31,23808,409,58896,82704
validation,396,19,14592,154,22176,36768
validation,397,14,10752,84,12096,22848
validation,398,26,19968,288,41472,61440
validation,399,8,6144,27,3888,10032
validation,400,6,4608,15,2160,6768
validation,401,35,26880,522,75168,102048
validation,402,26,19968,288,41472,61440
validation,403,25,19200,266,38304,57504
validation,404,24,18432,245,35280,53712
validation,405,21,16128,188,27072,43200
validation,406,12,9216,61,8784,18000
validation,407,18,13824,138,19872,33696
validation,408,24,18432,245,35280,53712
validation,409,5,3840,11,1584,5424
validation,410,17,13056,123,17712,30768
validation,411,31,23808,409,58896,82704
validation,412,22,16896,206,29664,46560
validation,413,6,4608,15,2160,6768
validation,414,13,9984,72,10368,20352
validation,415,34,26112,492,70848,96960
validation,416,29,22272,358,51552,73824
validation,417,12,9216,61,8784,18000
validation,418,27,20736,310,44640,65376
validation,419,17,13056,123,17712,30768
validation,420,31,23808,409,58896,82704
validation,421,22,16896,206,29664,46560
validation,422,28,21504,334,48096,69600
validation,423,26,19968,288,41472,61440
validation,424,25,19200,266,38304,57504
validation,425,14,10752,84,12096,22848
validation,426,26,19968,288,41472,61440
validation,427,24,18432,245,35280,53712
validation,428,49,37632,1022,147168,184800
validation,429,17,13056,123,17712,30768
validation,430,29,22272,358,51552,73824
validation,431,21,16128,188,27072,43200
validation,432,9,6912,35,5040,11952
validation,433,19,14592,154,22176,36768
validation,434,15,11520,96,13824,25344
validation,435,17,13056,138,19872,32928
validation,436,14,10752,84,12096,22848
validation,437,23,17664,225,32400,50064
validation,438,15,11520,96,13824,25344
validation,439,16,12288,109,15696,27984
validation,440,10,7680,43,6192,13872
validation,441,19,14592,154,22176,36768
validation,442,8,6144,27,3888,10032
validation,443,22,16896,206,29664,46560
validation,444,37,28416,583,83952,112368
validation,445,34,26112,492,70848,96960
validation,446,15,11520,96,13824,25344
validation,447,12,9216,61,8784,18000
validation,448,13,9984,72,10368,20352
validation,449,8,6144,27,3888,10032
validation,450,34,26112,492,70848,96960
validation,451,28,21504,334,48096,69600
validation,452,30,23040,383,55152,78192
validation,453,28,21504,334,48096,69600
validation,454,19,14592,154,22176,36768
validation,455,14,10752,84,12096,22848
validation,456,23,17664,225,32400,50064
validation,457,10,7680,43,6192,13872
validation,458,25,19200,266,38304,57504
validation,459,30,23040,383,55152,78192
validation,460,14,10752,84,12096,22848
validation,461,16,12288,109,15696,27984
validation,462,31,23808,409,58896,82704
validation,463,19,14592,154,22176,36768
validation,464,18,13824,138,19872,33696
validation,465,20,15360,170,24480,39840
validation,466,22,16896,206,29664,46560
validation,467,11,8448,52,7488,15936
validation,468,9,6912,35,5040,11952
validation,469,28,21504,334,48096,69600
validation,470,34,26112,492,70848,96960
validation,471,27,20736,310,44640,65376
validation,472,9,6912,35,5040,11952
validation,473,20,15360,170,24480,39840
validation,474,27,20736,310,44640,65376
validation,475,21,16128,188,27072,43200
validation,476,29,22272,358,51552,73824
validation,477,32,24576,436,62784,87360
validation,478,25,19200,266,38304,57504
validation,479,17,13056,123,17712,30768
validation,480,21,16128,206,29664,45792
validation,481,25,19200,266,38304,57504
validation,482,8,6144,27,3888,10032
validation,483,21,16128,188,27072,43200
validation,484,38,29184,615,88560,117744
validation,485,22,16896,206,29664,46560
validation,486,7,5376,21,3024,8400
validation,487,30,23040,383,55152,78192
validation,488,11,8448,52,7488,15936
validation,489,20,15360,170,24480,39840
validation,490,17,13056,123,17712,30768
validation,491,8,6144,27,3888,10032
validation,492,26,19968,288,41472,61440
validation,493,18,13824,138,19872,33696
validation,494,21,16128,188,27072,43200
validation,495,15,11520,96,13824,25344
validation,496,31,23808,409,58896,82704
validation,497,17,13056,123,17712,30768
validation,498,38,29184,615,88560,117744
validation,499,32,24576,436,62784,87360
validation,500,19,14592,154,22176,36768
validation,501,25,19200,266,38304,57504
validation,502,10,7680,43,6192,13872
validation,503,18,13824,138,19872,33696
validation,504,23,17664,225,32400,50064
validation,505,22,16896,206,29664,46560
validation,506,10,7680,43,6192,13872
validation,507,25,19200,266,38304,57504
validation,508,19,14592,154,22176,36768
validation,509,34,26112,492,70848,96960
validation,510,20,15360,170,24480,39840
validation,511,21,16128,188,27072,43200
validation,512,21,16128,188,27072,43200
validation,513,13,9984,72,10368,20352
validation,514,25,19200,266,38304,57504
validation,515,9,6912,35,5040,11952
validation,516,15,11520,96,13824,25344
validation,517,15,11520,96,13824,25344
validation,518,19,14592,154,22176,36768
validation,519,46,35328,901,129744,165072
validation,520,34,26112,492,70848,96960
validation,521,11,8448,52,7488,15936
validation,522,30,23040,383,55152,78192
validation,523,30,23040,383,55152,78192
validation,524,28,21504,334,48096,69600
validation,525,21,16128,188,27072,43200
validation,526,23,17664,225,32400,50064
validation,527,8,6144,27,3888,10032
validation,528,20,15360,170,24480,39840
validation,529,15,11520,96,13824,25344
validation,530,26,19968,288,41472,61440
validation,531,23,17664,225,32400,50064
validation,532,38,29184,615,88560,117744
validation,533,35,26880,522,75168,102048
validation,534,19,14592,154,22176,36768
validation,535,28,21504,358,51552,73056
validation,536,25,19200,266,38304,57504
validation,537,30,23040,383,55152,78192
validation,538,15,11520,96,13824,25344
validation,539,19,14592,154,22176,36768
validation,540,21,16128,188,27072,43200
validation,541,17,13056,123,17712,30768
validation,542,16,12288,109,15696,27984
validation,543,13,9984,72,10368,20352
validation,544,18,13824,138,19872,33696
validation,545,19,14592,154,22176,36768
validation,546,22,16896,206,29664,46560
validation,547,11,8448,61,8784,17232
validation,548,8,6144,27,3888,10032
validation,549,32,24576,436,62784,87360
validation,550,16,12288,109,15696,27984
validation,551,31,23808,409,58896,82704
validation,552,20,15360,170,24480,39840
validation,553,27,20736,310,44640,65376
validation,554,23,17664,225,32400,50064
validation,555,30,23040,383,55152,78192
validation,556,37,28416,583,83952,112368
validation,557,31,23808,409,58896,82704
validation,558,20,15360,170,24480,39840
validation,559,15,11520,96,13824,25344
validation,560,26,19968,288,41472,61440
validation,561,19,14592,154,22176,36768
validation,562,29,22272,358,51552,73824
validation,563,19,14592,154,22176,36768
validation,564,2,1536,2,288,1824
validation,565,10,7680,43,6192,13872
validation,566,14,10752,84,12096,22848
validation,567,12,9216,61,8784,18000
validation,568,19,14592,154,22176,36768
validation,569,33,25344,464,66816,92160
validation,570,16,12288,109,15696,27984
validation,571,16,12288,109,15696,27984
validation,572,12,9216,61,8784,18000
validation,573,26,19968,288,41472,61440
validation,574,19,14592,154,22176,36768
validation,575,24,18432,245,35280,53712
validation,576,26,19968,288,41472,61440
validation,577,5,3840,11,1584,5424
validation,578,25,19200,266,38304,57504
validation,579,18,13824,138,19872,33696
validation,580,23,17664,225,32400,50064
validation,581,6,4608,15,2160,6768
validation,582,38,29184,615,88560,117744
validation,583,22,16896,206,29664,46560
validation,584,25,19200,266,38304,57504
validation,585,12,9216,61,8784,18000
validation,586,23,17664,225,32400,50064
validation,587,38,29184,615,88560,117744
validation,588,13,9984,72,10368,20352
validation,589,6,4608,15,2160,6768
validation,590,21,16128,188,27072,43200
validation,591,16,12288,109,15696,27984
validation,592,20,15360,170,24480,39840
validation,593,14,10752,84,12096,22848
validation,594,16,12288,123,17712,30000
validation,595,11,8448,52,7488,15936
validation,596,9,6912,35,5040,11952
validation,597,15,11520,96,13824,25344
validation,598,19,14592,154,22176,36768
validation,599,5,3840,11,1584,5424
validation,600,22,16896,206,29664,46560
validation,601,27,20736,310,44640,65376
validation,602,10,7680,43,6192,13872
validation,603,24,18432,245,35280,53712
validation,604,25,19200,266,38304,57504
validation,605,19,14592,154,22176,36768
validation,606,13,9984,72,10368,20352
validation,607,22,16896,206,29664,46560
validation,608,29,22272,358,51552,73824
validation,609,27,20736,310,44640,65376
validation,610,23,17664,225,32400,50064
validation,611,25,19200,266,38304,57504
validation,612,34,26112,492,70848,96960
validation,613,15,11520,96,13824,25344
validation,614,11,8448,52,7488,15936
validation,615,30,23040,383,55152,78192
validation,616,23,17664,225,32400,50064
validation,617,27,20736,310,44640,65376
validation,618,13,9984,72,10368,20352
validation,619,11,8448,52,7488,15936
validation,620,22,16896,206,29664,46560
validation,621,11,8448,52,7488,15936
validation,622,21,16128,188,27072,43200
validation,623,26,19968,288,41472,61440
validation,624,23,17664,225,32400,50064
validation,625,12,9216,61,8784,18000
validation,626,42,32256,751,108144,140400
validation,627,25,19200,266,38304,57504
validation,628,10,7680,43,6192,13872
validation,629,27,20736,310,44640,65376
validation,630,9,6912,43,6192,13104
validation,631,28,21504,334,48096,69600
validation,632,28,21504,334,48096,69600
validation,633,16,12288,109,15696,27984
validation,634,19,14592,154,22176,36768
validation,635,8,6144,27,3888,10032
validation,636,8,6144,27,3888,10032
validation,637,20,15360,170,24480,39840
validation,638,22,16896,206,29664,46560
validation,639,33,25344,464,66816,92160
validation,640,33,25344,464,66816,92160
validation,641,21,16128,188,27072,43200
validation,642,25,19200,266,38304,57504
validation,643,10,7680,43,6192,13872
validation,644,28,21504,334,48096,69600
validation,645,19,14592,154,22176,36768
validation,646,35,26880,522,75168,102048
validation,647,16,12288,109,15696,27984
validation,648,10,7680,43,6192,13872
validation,649,35,26880,522,75168,102048
validation,650,30,23040,383,55152,78192
validation,651,28,21504,334,48096,69600
validation,652,37,28416,583,83952,112368
validation,653,7,5376,21,3024,8400
validation,654,30,23040,383,55152,78192
validation,655,28,21504,334,48096,69600
validation,656,20,15360,170,24480,39840
validation,657,43,33024,787,113328,146352
validation,658,16,12288,109,15696,27984
validation,659,35,26880,552,79488,106368
validation,660,30,23040,383,55152,78192
validation,661,43,33024,787,113328,146352
validation,662,24,18432,245,35280,53712
validation,663,26,19968,288,41472,61440
validation,664,32,24576,436,62784,87360
validation,665,30,23040,383,55152,78192
validation,666,17,13056,123,17712,30768
validation,667,13,9984,72,10368,20352
validation,668,25,19200,266,38304,57504
validation,669,33,25344,464,66816,92160
validation,670,17,13056,123,17712,30768
validation,671,21,16128,188,27072,43200
validation,672,7,5376,21,3024,8400
validation,673,7,5376,21,3024,8400
validation,674,20,15360,170,24480,39840
validation,675,31,23808,409,58896,82704
validation,676,23,17664,225,32400,50064
validation,677,35,26880,522,75168,102048
validation,678,23,17664,225,32400,50064
validation,679,14,10752,84,12096,22848
validation,680,11,8448,52,7488,15936
validation,681,26,19968,288,41472,61440
validation,682,34,26112,492,70848,96960
validation,683,29,22272,358,51552,73824
validation,684,29,22272,358,51552,73824
validation,685,26,19968,288,41472,61440
validation,686,22,16896,206,29664,46560
validation,687,13,9984,72,10368,20352
validation,688,11,8448,52,7488,15936
validation,689,10,7680,43,6192,13872
validation,690,19,14592,154,22176,36768
validation,691,15,11520,96,13824,25344
validation,692,14,10752,84,12096,22848
validation,693,22,16896,206,29664,46560
validation,694,8,6144,27,3888,10032
validation,695,28,21504,334,48096,69600
validation,696,27,20736,310,44640,65376
validation,697,25,19200,266,38304,57504
validation,698,25,19200,266,38304,57504
validation,699,14,10752,84,12096,22848
validation,700,4,3072,7,1008,4080
validation,701,34,26112,492,70848,96960
validation,702,17,13056,123,17712,30768
validation,703,22,16896,206,29664,46560
validation,704,18,13824,138,19872,33696
validation,705,10,7680,43,6192,13872
validation,706,18,13824,138,19872,33696
validation,707,25,19200,266,38304,57504
validation,708,25,19200,266,38304,57504
validation,709,15,11520,96,13824,25344
validation,710,9,6912,35,5040,11952
validation,711,16,12288,109,15696,27984
validation,712,23,17664,225,32400,50064
validation,713,26,19968,288,41472,61440
validation,714,11,8448,52,7488,15936
validation,715,20,15360,170,24480,39840
validation,716,17,13056,123,17712,30768
validation,717,25,19200,266,38304,57504
validation,718,21,16128,188,27072,43200
validation,719,35,26880,522,75168,102048
validation,720,19,14592,154,22176,36768
validation,721,20,15360,170,24480,39840
validation,722,23,17664,225,32400,50064
validation,723,11,8448,52,7488,15936
validation,724,19,14592,154,22176,36768
validation,725,11,8448,52,7488,15936
validation,726,39,29952,648,93312,123264
validation,727,22,16896,206,29664,46560
validation,728,9,6912,35,5040,11952
validation,729,24,18432,245,35280,53712
validation,730,20,15360,170,24480,39840
validation,731,21,16128,188,27072,43200
validation,732,22,16896,206,29664,46560
validation,733,34,26112,492,70848,96960
validation,734,4,3072,7,1008,4080
validation,735,26,19968,288,41472,61440
validation,736,6,4608,15,2160,6768
validation,737,14,10752,84,12096,22848
validation,738,17,13056,123,17712,30768
validation,739,15,11520,96,13824,25344
validation,740,17,13056,123,17712,30768
validation,741,34,26112,492,70848,96960
validation,742,23,17664,225,32400,50064
validation,743,6,4608,15,2160,6768
validation,744,38,29184,615,88560,117744
validation,745,40,30720,681,98064,128784
validation,746,34,26112,492,70848,96960
validation,747,25,19200,266,38304,57504
validation,748,29,22272,358,51552,73824
validation,749,30,23040,383,55152,78192
validation,750,20,15360,170,24480,39840
validation,751,26,19968,288,41472,61440
validation,752,8,6144,27,3888,10032
validation,753,27,20736,310,44640,65376
validation,754,22,16896,206,29664,46560
validation,755,35,26880,522,75168,102048
validation,756,21,16128,188,27072,43200
validation,757,12,9216,61,8784,18000
validation,758,20,15360,170,24480,39840
validation,759,16,12288,109,15696,27984
validation,760,18,13824,138,19872,33696
validation,761,24,18432,245,35280,53712
validation,762,11,8448,52,7488,15936
validation,763,31,23808,409,58896,82704
validation,764,25,19200,266,38304,57504
validation,765,8,6144,27,3888,10032
validation,766,34,26112,492,70848,96960
validation,767,38,29184,615,88560,117744
validation,768,15,11520,96,13824,25344
validation,769,8,6144,35,5040,11184
validation,770,32,24576,436,62784,87360
validation,771,29,22272,358,51552,73824
validation,772,13,9984,72,10368,20352
validation,773,16,12288,109,15696,27984
validation,774,32,24576,436,62784,87360
validation,775,13,9984,72,10368,20352
validation,776,19,14592,154,22176,36768
validation,777,9,6912,35,5040,11952
validation,778,19,14592,154,22176,36768
validation,779,15,11520,96,13824,25344
validation,780,22,16896,206,29664,46560
validation,781,18,13824,138,19872,33696
validation,782,23,17664,225,32400,50064
validation,783,38,29184,615,88560,117744
validation,784,20,15360,170,24480,39840
validation,785,29,22272,358,51552,73824
validation,786,20,15360,170,24480,39840
validation,787,6,4608,15,2160,6768
validation,788,26,19968,288,41472,61440
validation,789,8,6144,27,3888,10032
validation,790,13,9984,72,10368,20352
validation,791,29,22272,358,51552,73824
validation,792,41,31488,716,103104,134592
validation,793,20,15360,170,24480,39840
validation,794,7,5376,27,3888,9264
validation,795,24,18432,245,35280,53712
validation,796,21,16128,188,27072,43200
validation,797,20,15360,170,24480,39840
validation,798,13,9984,72,10368,20352
validation,799,15,11520,96,13824,25344
validation,800,34,26112,492,70848,96960
validation,801,11,8448,52,7488,15936
validation,802,35,26880,522,75168,102048
validation,803,14,10752,84,12096,22848
validation,804,9,6912,35,5040,11952
validation,805,11,8448,52,7488,15936
validation,806,34,26112,492,70848,96960
validation,807,10,7680,43,6192,13872
validation,808,15,11520,96,13824,25344
validation,809,24,18432,245,35280,53712
validation,810,28,21504,334,48096,69600
validation,811,23,17664,225,32400,50064
validation,812,18,13824,154,22176,36000
validation,813,28,21504,334,48096,69600
validation,814,16,12288,109,15696,27984
validation,815,21,16128,188,27072,43200
validation,816,14,10752,84,12096,22848
validation,817,13,9984,72,10368,20352
validation,818,25,19200,266,38304,57504
validation,819,15,11520,96,13824,25344
validation,820,25,19200,266,38304,57504
validation,821,10,7680,43,6192,13872
validation,822,22,16896,206,29664,46560
validation,823,14,10752,84,12096,22848
validation,824,17,13056,123,17712,30768
validation,825,7,5376,27,3888,9264
validation,826,33,25344,464,66816,92160
validation,827,18,13824,138,19872,33696
validation,828,17,13056,123,17712,30768
validation,829,31,23808,409,58896,82704
validation,830,35,26880,522,75168,102048
validation,831,28,21504,334,48096,69600
validation,832,22,16896,206,29664,46560
validation,833,33,25344,464,66816,92160
validation,834,16,12288,109,15696,27984
validation,835,17,13056,123,17712,30768
validation,836,30,23040,383,55152,78192
validation,837,33,25344,464,66816,92160
validation,838,10,7680,43,6192,13872
validation,839,6,4608,15,2160,6768
validation,840,10,7680,43,6192,13872
validation,841,7,5376,21,3024,8400
validation,842,24,18432,245,35280,53712
validation,843,14,10752,84,12096,22848
validation,844,27,20736,310,44640,65376
validation,845,13,9984,72,10368,20352
validation,846,26,19968,288,41472,61440
validation,847,31,23808,409,58896,82704
validation,848,21,16128,188,27072,43200
validation,849,24,18432,245,35280,53712
validation,850,31,23808,409,58896,82704
validation,851,9,6912,35,5040,11952
validation,852,8,6144,27,3888,10032
validation,853,16,12288,109,15696,27984
validation,854,8,6144,27,3888,10032
validation,855,12,9216,61,8784,18000
validation,856,23,17664,225,32400,50064
validation,857,15,11520,96,13824,25344
validation,858,16,12288,109,15696,27984
validation,859,21,16128,188,27072,43200
validation,860,20,15360,188,27072,42432
validation,861,8,6144,27,3888,10032
validation,862,27,20736,310,44640,65376
validation,863,9,6912,35,5040,11952
validation,864,33,25344,464,66816,92160
validation,865,38,29184,615,88560,117744
validation,866,14,10752,84,12096,22848
validation,867,18,13824,138,19872,33696
validation,868,25,19200,266,38304,57504
validation,869,34,26112,492,70848,96960
validation,870,37,28416,583,83952,112368
validation,871,27,20736,310,44640,65376
test,0,15,11520,96,13824,25344
test,1,13,9984,72,10368,20352
test,2,28,21504,334,48096,69600
test,3,24,18432,245,35280,53712
test,4,21,16128,188,27072,43200
test,5,25,19200,266,38304,57504
test,6,26,19968,288,41472,61440
test,7,8,6144,27,3888,10032
test,8,10,7680,43,6192,13872
test,9,23,17664,225,32400,50064
test,10,18,13824,138,19872,33696
test,11,20,15360,170,24480,39840
test,12,5,3840,11,1584,5424
test,13,22,16896,206,29664,46560
test,14,35,26880,522,75168,102048
test,15,35,26880,522,75168,102048
test,16,11,8448,52,7488,15936
test,17,5,3840,11,1584,5424
test,18,34,26112,492,70848,96960
test,19,26,19968,288,41472,61440
test,20,20,15360,170,24480,39840
test,21,16,12288,109,15696,27984
test,22,15,11520,96,13824,25344
test,23,14,10752,84,12096,22848
test,24,24,18432,245,35280,53712
test,25,22,16896,206,29664,46560
test,26,21,16128,188,27072,43200
test,27,9,6912,35,5040,11952
test,28,7,5376,21,3024,8400
test,29,14,10752,84,12096,22848
test,30,13,9984,72,10368,20352
test,31,15,11520,96,13824,25344
test,32,10,7680,43,6192,13872
test,33,24,18432,245,35280,53712
test,34,17,13056,123,17712,30768
test,35,23,17664,225,32400,50064
test,36,10,7680,43,6192,13872
test,37,14,10752,84,12096,22848
test,38,34,26112,492,70848,96960
test,39,13,9984,72,10368,20352
test,40,26,19968,288,41472,61440
test,41,8,6144,27,3888,10032
test,42,33,25344,464,66816,92160
test,43,25,19200,288,41472,60672
test,44,25,19200,266,38304,57504
test,45,23,17664,225,32400,50064
test,46,31,23808,409,58896,82704
test,47,15,11520,96,13824,25344
test,48,22,16896,206,29664,46560
test,49,30,23040,383,55152,78192
test,50,14,10752,84,12096,22848
test,51,20,15360,170,24480,39840
test,52,33,25344,464,66816,92160
test,53,21,16128,188,27072,43200
test,54,25,19200,266,38304,57504
test,55,24,18432,245,35280,53712
test,56,20,15360,170,24480,39840
test,57,10,7680,43,6192,13872
test,58,29,22272,358,51552,73824
test,59,8,6144,27,3888,10032
test,60,18,13824,138,19872,33696
test,61,22,16896,206,29664,46560
test,62,25,19200,266,38304,57504
test,63,15,11520,96,13824,25344
test,64,29,22272,358,51552,73824
test,65,30,23040,383,55152,78192
test,66,20,15360,170,24480,39840
test,67,20,15360,170,24480,39840
test,68,19,14592,154,22176,36768
test,69,11,8448,52,7488,15936
test,70,36,27648,552,79488,107136
test,71,24,18432,245,35280,53712
test,72,9,6912,35,5040,11952
test,73,12,9216,61,8784,18000
test,74,13,9984,72,10368,20352
test,75,20,15360,170,24480,39840
test,76,24,18432,245,35280,53712
test,77,15,11520,96,13824,25344
test,78,8,6144,27,3888,10032
test,79,7,5376,21,3024,8400
test,80,24,18432,245,35280,53712
test,81,29,22272,358,51552,73824
test,82,20,15360,170,24480,39840
test,83,32,24576,436,62784,87360
test,84,7,5376,21,3024,8400
test,85,29,22272,358,51552,73824
test,86,31,23808,409,58896,82704
test,87,21,16128,188,27072,43200
test,88,12,9216,61,8784,18000
test,89,23,17664,225,32400,50064
test,90,30,23040,383,55152,78192
test,91,24,18432,245,35280,53712
test,92,33,25344,464,66816,92160
test,93,14,10752,84,12096,22848
test,94,12,9216,61,8784,18000
test,95,18,13824,138,19872,33696
test,96,30,23040,383,55152,78192
test,97,28,21504,334,48096,69600
test,98,32,24576,436,62784,87360
test,99,15,11520,96,13824,25344
test,100,25,19200,266,38304,57504
test,101,23,17664,225,32400,50064
test,102,30,23040,383,55152,78192
test,103,17,13056,123,17712,30768
test,104,24,18432,245,35280,53712
test,105,29,22272,358,51552,73824
test,106,32,24576,436,62784,87360
test,107,10,7680,43,6192,13872
test,108,22,16896,206,29664,46560
test,109,19,14592,154,22176,36768
test,110,32,24576,436,62784,87360
test,111,34,26112,492,70848,96960
test,112,22,16896,206,29664,46560
test,113,40,30720,681,98064,128784
test,114,17,13056,123,17712,30768
test,115,11,8448,52,7488,15936
test,116,7,5376,21,3024,8400
test,117,10,7680,43,6192,13872
test,118,22,16896,225,32400,49296
test,119,14,10752,84,12096,22848
test,120,24,18432,245,35280,53712
test,121,18,13824,138,19872,33696
test,122,12,9216,61,8784,18000
test,123,27,20736,310,44640,65376
test,124,16,12288,109,15696,27984
test,125,46,35328,901,129744,165072
test,126,26,19968,288,41472,61440
test,127,19,14592,154,22176,36768
test,128,15,11520,96,13824,25344
test,129,16,12288,109,15696,27984
test,130,9,6912,35,5040,11952
test,131,12,9216,61,8784,18000
test,132,10,7680,43,6192,13872
test,133,17,13056,123,17712,30768
test,134,31,23808,409,58896,82704
test,135,25,19200,266,38304,57504
test,136,8,6144,27,3888,10032
test,137,28,21504,334,48096,69600
test,138,32,24576,436,62784,87360
test,139,20,15360,170,24480,39840
test,140,12,9216,61,8784,18000
test,141,35,26880,522,75168,102048
test,142,15,11520,96,13824,25344
test,143,18,13824,154,22176,36000
test,144,17,13056,123,17712,30768
test,145,8,6144,27,3888,10032
test,146,20,15360,170,24480,39840
test,147,22,16896,206,29664,46560
test,148,37,28416,583,83952,112368
test,149,22,16896,206,29664,46560
test,150,20,15360,170,24480,39840
test,151,32,24576,436,62784,87360
test,152,18,13824,138,19872,33696
test,153,20,15360,170,24480,39840
test,154,12,9216,61,8784,18000
test,155,18,13824,138,19872,33696
test,156,20,15360,170,24480,39840
test,157,13,9984,72,10368,20352
test,158,27,20736,310,44640,65376
test,159,31,23808,409,58896,82704
test,160,14,10752,84,12096,22848
test,161,32,24576,436,62784,87360
test,162,26,19968,288,41472,61440
test,163,12,9216,61,8784,18000
test,164,22,16896,206,29664,46560
test,165,48,36864,981,141264,178128
test,166,16,12288,109,15696,27984
test,167,5,3840,11,1584,5424
test,168,15,11520,96,13824,25344
test,169,9,6912,35,5040,11952
test,170,13,9984,72,10368,20352
test,171,12,9216,61,8784,18000
test,172,38,29184,615,88560,117744
test,173,22,16896,206,29664,46560
test,174,19,14592,154,22176,36768
test,175,27,20736,310,44640,65376
test,176,13,9984,72,10368,20352
test,177,38,29184,615,88560,117744
test,178,21,16128,188,27072,43200
test,179,25,19200,266,38304,57504
test,180,22,16896,206,29664,46560
test,181,39,29952,648,93312,123264
test,182,24,18432,245,35280,53712
test,183,24,18432,245,35280,53712
test,184,24,18432,245,35280,53712
test,185,32,24576,436,62784,87360
test,186,23,17664,225,32400,50064
test,187,24,18432,245,35280,53712
test,188,12,9216,61,8784,18000
test,189,16,12288,109,15696,27984
test,190,28,21504,334,48096,69600
test,191,44,33792,824,118656,152448
test,192,28,21504,334,48096,69600
test,193,10,7680,43,6192,13872
test,194,40,30720,681,98064,128784
test,195,13,9984,72,10368,20352
test,196,12,9216,61,8784,18000
test,197,25,19200,266,38304,57504
test,198,11,8448,52,7488,15936
test,199,29,22272,358,51552,73824
test,200,24,18432,245,35280,53712
test,201,11,8448,52,7488,15936
test,202,10,7680,43,6192,13872
test,203,11,8448,52,7488,15936
test,204,27,20736,310,44640,65376
test,205,26,19968,288,41472,61440
test,206,13,9984,72,10368,20352
test,207,32,24576,436,62784,87360
test,208,18,13824,138,19872,33696
test,209,10,7680,43,6192,13872
test,210,5,3840,11,1584,5424
test,211,27,20736,310,44640,65376
test,212,33,25344,464,66816,92160
test,213,18,13824,138,19872,33696
test,214,29,22272,358,51552,73824
test,215,9,6912,35,5040,11952
test,216,35,26880,522,75168,102048
test,217,7,5376,21,3024,8400
test,218,30,23040,383,55152,78192
test,219,7,5376,21,3024,8400
test,220,19,14592,154,22176,36768
test,221,19,14592,154,22176,36768
test,222,10,7680,43,6192,13872
test,223,38,29184,615,88560,117744
test,224,6,4608,15,2160,6768
test,225,30,23040,383,55152,78192
test,226,10,7680,43,6192,13872
test,227,26,19968,288,41472,61440
test,228,18,13824,138,19872,33696
test,229,16,12288,109,15696,27984
test,230,26,19968,288,41472,61440
test,231,13,9984,72,10368,20352
test,232,12,9216,61,8784,18000
test,233,29,22272,358,51552,73824
test,234,11,8448,52,7488,15936
test,235,15,11520,96,13824,25344
test,236,29,22272,358,51552,73824
test,237,12,9216,61,8784,18000
test,238,7,5376,21,3024,8400
test,239,20,15360,170,24480,39840
test,240,22,16896,206,29664,46560
test,241,33,25344,464,66816,92160
test,242,13,9984,72,10368,20352
test,243,33,25344,464,66816,92160
test,244,9,6912,35,5040,11952
test,245,21,16128,188,27072,43200
test,246,22,16896,206,29664,46560
test,247,26,19968,288,41472,61440
test,248,19,14592,154,22176,36768
test,249,4,3072,7,1008,4080
test,250,16,12288,109,15696,27984
test,251,15,11520,96,13824,25344
test,252,29,22272,358,51552,73824
test,253,29,22272,358,51552,73824
test,254,22,16896,206,29664,46560
test,255,7,5376,21,3024,8400
test,256,7,5376,21,3024,8400
test,257,23,17664,225,32400,50064
test,258,28,21504,334,48096,69600
test,259,27,20736,310,44640,65376
test,260,19,14592,154,22176,36768
test,261,25,19200,266,38304,57504
test,262,28,21504,334,48096,69600
test,263,8,6144,27,3888,10032
test,264,22,16896,206,29664,46560
test,265,34,26112,492,70848,96960
test,266,25,19200,266,38304,57504
test,267,23,17664,225,32400,50064
test,268,12,9216,61,8784,18000
test,269,19,14592,154,22176,36768
test,270,20,15360,170,24480,39840
test,271,22,16896,206,29664,46560
test,272,38,29184,615,88560,117744
test,273,26,19968,288,41472,61440
test,274,20,15360,170,24480,39840
test,275,17,13056,123,17712,30768
test,276,24,18432,245,35280,53712
test,277,8,6144,27,3888,10032
test,278,15,11520,96,13824,25344
test,279,35,26880,522,75168,102048
test,280,18,13824,138,19872,33696
test,281,29,22272,358,51552,73824
test,282,19,14592,154,22176,36768
test,283,30,23040,383,55152,78192
test,284,9,6912,35,5040,11952
test,285,30,23040,409,58896,81936
test,286,32,24576,436,62784,87360
test,287,14,10752,84,12096,22848
test,288,10,7680,43,6192,13872
test,289,18,13824,138,19872,33696
test,290,11,8448,52,7488,15936
test,291,13,9984,72,10368,20352
test,292,16,12288,109,15696,27984
test,293,7,5376,21,3024,8400
test,294,39,29952,648,93312,123264
test,295,26,19968,288,41472,61440
test,296,32,24576,436,62784,87360
test,297,32,24576,436,62784,87360
test,298,34,26112,492,70848,96960
test,299,16,12288,109,15696,27984
test,300,25,19200,266,38304,57504
test,301,51,39168,1107,159408,198576
test,302,27,20736,310,44640,65376
test,303,9,6912,35,5040,11952
test,304,25,19200,266,38304,57504
test,305,27,20736,310,44640,65376
test,306,21,16128,206,29664,45792
test,307,25,19200,266,38304,57504
test,308,21,16128,188,27072,43200
test,309,13,9984,72,10368,20352
test,310,10,7680,43,6192,13872
test,311,13,9984,72,10368,20352
test,312,26,19968,288,41472,61440
test,313,15,11520,96,13824,25344
test,314,18,13824,138,19872,33696
test,315,23,17664,225,32400,50064
test,316,23,17664,225,32400,50064
test,317,29,22272,358,51552,73824
test,318,26,19968,288,41472,61440
test,319,18,13824,138,19872,33696
test,320,18,13824,138,19872,33696
test,321,12,9216,61,8784,18000
test,322,27,20736,310,44640,65376
test,323,16,12288,109,15696,27984
test,324,25,19200,266,38304,57504
test,325,25,19200,266,38304,57504
test,326,24,18432,245,35280,53712
test,327,7,5376,21,3024,8400
test,328,26,19968,288,41472,61440
test,329,17,13056,123,17712,30768
test,330,22,16896,206,29664,46560
test,331,16,12288,109,15696,27984
test,332,9,6912,35,5040,11952
test,333,7,5376,21,3024,8400
test,334,15,11520,96,13824,25344
test,335,20,15360,170,24480,39840
test,336,14,10752,84,12096,22848
test,337,16,12288,109,15696,27984
test,338,32,24576,436,62784,87360
test,339,42,32256,751,108144,140400
test,340,18,13824,138,19872,33696
test,341,11,8448,52,7488,15936
test,342,29,22272,358,51552,73824
test,343,44,33792,824,118656,152448
test,344,27,20736,310,44640,65376
test,345,16,12288,109,15696,27984
test,346,28,21504,358,51552,73056
test,347,14,10752,84,12096,22848
test,348,22,16896,206,29664,46560
test,349,33,25344,464,66816,92160
test,350,21,16128,188,27072,43200
test,351,33,25344,464,66816,92160
test,352,34,26112,492,70848,96960
test,353,25,19200,288,41472,60672
test,354,16,12288,109,15696,27984
test,355,15,11520,96,13824,25344
test,356,22,16896,225,32400,49296
test,357,32,24576,436,62784,87360
test,358,23,17664,225,32400,50064
test,359,18,13824,138,19872,33696
test,360,36,27648,552,79488,107136
test,361,18,13824,138,19872,33696
test,362,26,19968,288,41472,61440
test,363,20,15360,170,24480,39840
test,364,10,7680,43,6192,13872
test,365,14,10752,84,12096,22848
test,366,33,25344,464,66816,92160
test,367,8,6144,27,3888,10032
test,368,17,13056,123,17712,30768
test,369,20,15360,170,24480,39840
test,370,31,23808,409,58896,82704
test,371,17,13056,123,17712,30768
test,372,20,15360,170,24480,39840
test,373,19,14592,154,22176,36768
test,374,28,21504,334,48096,69600
test,375,27,20736,310,44640,65376
test,376,23,17664,225,32400,50064
test,377,27,20736,310,44640,65376
test,378,25,19200,266,38304,57504
test,379,11,8448,52,7488,15936
test,380,18,13824,138,19872,33696
test,381,22,16896,206,29664,46560
test,382,17,13056,123,17712,30768
test,383,6,4608,21,3024,7632
test,384,11,8448,52,7488,15936
test,385,19,14592,154,22176,36768
test,386,18,13824,138,19872,33696
test,387,29,22272,358,51552,73824
test,388,16,12288,109,15696,27984
test,389,15,11520,96,13824,25344
test,390,29,22272,358,51552,73824
test,391,23,17664,225,32400,50064
test,392,10,7680,43,6192,13872
test,393,26,19968,288,41472,61440
test,394,19,14592,154,22176,36768
test,395,23,17664,225,32400,50064
test,396,13,9984,72,10368,20352
test,397,17,13056,123,17712,30768
test,398,34,26112,492,70848,96960
test,399,10,7680,43,6192,13872
test,400,24,18432,245,35280,53712
test,401,19,14592,154,22176,36768
test,402,18,13824,138,19872,33696
test,403,4,3072,7,1008,4080
test,404,19,14592,154,22176,36768
test,405,34,26112,492,70848,96960
test,406,24,18432,245,35280,53712
test,407,4,3072,7,1008,4080
test,408,26,19968,288,41472,61440
test,409,12,9216,61,8784,18000
test,410,21,16128,188,27072,43200
test,411,13,9984,72,10368,20352
test,412,21,16128,188,27072,43200
test,413,25,19200,266,38304,57504
test,414,10,7680,43,6192,13872
test,415,12,9216,61,8784,18000
test,416,32,24576,436,62784,87360
test,417,21,16128,188,27072,43200
test,418,18,13824,138,19872,33696
test,419,10,7680,43,6192,13872
test,420,22,16896,206,29664,46560
test,421,14,10752,84,12096,22848
test,422,32,24576,436,62784,87360
test,423,17,13056,123,17712,30768
test,424,29,22272,358,51552,73824
test,425,20,15360,170,24480,39840
test,426,17,13056,123,17712,30768
test,427,6,4608,15,2160,6768
test,428,23,17664,225,32400,50064
test,429,35,26880,522,75168,102048
test,430,17,13056,123,17712,30768
test,431,8,6144,27,3888,10032
test,432,22,16896,206,29664,46560
test,433,9,6912,35,5040,11952
test,434,28,21504,334,48096,69600
test,435,7,5376,21,3024,8400
test,436,16,12288,109,15696,27984
test,437,10,7680,43,6192,13872
test,438,29,22272,358,51552,73824
test,439,31,23808,409,58896,82704
test,440,8,6144,27,3888,10032
test,441,18,13824,138,19872,33696
test,442,31,23808,409,58896,82704
test,443,14,10752,84,12096,22848
test,444,19,14592,154,22176,36768
test,445,13,9984,72,10368,20352
test,446,18,13824,138,19872,33696
test,447,32,24576,436,62784,87360
test,448,8,6144,27,3888,10032
test,449,24,18432,245,35280,53712
test,450,17,13056,123,17712,30768
test,451,9,6912,35,5040,11952
test,452,44,33792,824,118656,152448
test,453,38,29184,615,88560,117744
test,454,20,15360,170,24480,39840
test,455,19,14592,154,22176,36768
test,456,22,16896,206,29664,46560
test,457,15,11520,96,13824,25344
test,458,15,11520,96,13824,25344
test,459,31,23808,409,58896,82704
test,460,12,9216,61,8784,18000
test,461,18,13824,138,19872,33696
test,462,25,19200,266,38304,57504
test,463,22,16896,206,29664,46560
test,464,11,8448,52,7488,15936
test,465,13,9984,72,10368,20352
test,466,22,16896,206,29664,46560
test,467,8,6144,27,3888,10032
test,468,19,14592,154,22176,36768
test,469,19,14592,154,22176,36768
test,470,21,16128,188,27072,43200
test,471,39,29952,648,93312,123264
test,472,26,19968,288,41472,61440
test,473,26,19968,288,41472,61440
test,474,19,14592,154,22176,36768
test,475,33,25344,464,66816,92160
test,476,8,6144,27,3888,10032
test,477,28,21504,334,48096,69600
test,478,26,19968,288,41472,61440
test,479,17,13056,123,17712,30768
test,480,16,12288,109,15696,27984
test,481,35,26880,522,75168,102048
test,482,24,18432,245,35280,53712
test,483,39,29952,648,93312,123264
test,484,22,16896,206,29664,46560
test,485,19,14592,154,22176,36768
test,486,21,16128,188,27072,43200
test,487,8,6144,27,3888,10032
test,488,16,12288,109,15696,27984
test,489,25,19200,266,38304,57504
test,490,18,13824,138,19872,33696
test,491,13,9984,72,10368,20352
test,492,13,9984,72,10368,20352
test,493,37,28416,583,83952,112368
test,494,9,6912,35,5040,11952
test,495,38,29184,615,88560,117744
test,496,12,9216,61,8784,18000
test,497,16,12288,109,15696,27984
test,498,23,17664,225,32400,50064
test,499,27,20736,310,44640,65376
test,500,18,13824,138,19872,33696
test,501,32,24576,436,62784,87360
test,502,28,21504,334,48096,69600
test,503,13,9984,72,10368,20352
test,504,12,9216,61,8784,18000
test,505,16,12288,109,15696,27984
test,506,32,24576,436,62784,87360
test,507,7,5376,21,3024,8400
test,508,21,16128,188,27072,43200
test,509,28,21504,334,48096,69600
test,510,27,20736,310,44640,65376
test,511,11,8448,52,7488,15936
test,512,15,11520,96,13824,25344
test,513,20,15360,188,27072,42432
test,514,30,23040,383,55152,78192
test,515,8,6144,27,3888,10032
test,516,31,23808,409,58896,82704
test,517,16,12288,109,15696,27984
test,518,30,23040,383,55152,78192
test,519,12,9216,61,8784,18000
test,520,11,8448,52,7488,15936
test,521,28,21504,334,48096,69600
test,522,15,11520,96,13824,25344
test,523,15,11520,96,13824,25344
test,524,22,16896,206,29664,46560
test,525,10,7680,43,6192,13872
test,526,26,19968,288,41472,61440
test,527,14,10752,84,12096,22848
test,528,16,12288,109,15696,27984
test,529,17,13056,123,17712,30768
test,530,25,19200,266,38304,57504
test,531,25,19200,266,38304,57504
test,532,34,26112,492,70848,96960
test,533,11,8448,52,7488,15936
test,534,40,30720,716,103104,133824
test,535,22,16896,206,29664,46560
test,536,25,19200,288,41472,60672
test,537,8,6144,27,3888,10032
test,538,23,17664,225,32400,50064
test,539,15,11520,96,13824,25344
test,540,37,28416,583,83952,112368
test,541,23,17664,225,32400,50064
test,542,18,13824,138,19872,33696
test,543,17,13056,123,17712,30768
test,544,23,17664,225,32400,50064
test,545,27,20736,334,48096,68832
test,546,35,26880,522,75168,102048
test,547,23,17664,225,32400,50064
test,548,11,8448,52,7488,15936
test,549,32,24576,436,62784,87360
test,550,33,25344,464,66816,92160
test,551,8,6144,27,3888,10032
test,552,11,8448,52,7488,15936
test,553,23,17664,225,32400,50064
test,554,21,16128,188,27072,43200
test,555,29,22272,358,51552,73824
test,556,27,20736,310,44640,65376
test,557,42,32256,751,108144,140400
test,558,28,21504,334,48096,69600
test,559,16,12288,109,15696,27984
test,560,16,12288,109,15696,27984
test,561,14,10752,84,12096,22848
test,562,34,26112,492,70848,96960
test,563,10,7680,43,6192,13872
test,564,5,3840,11,1584,5424
test,565,14,10752,84,12096,22848
test,566,7,5376,21,3024,8400
test,567,7,5376,21,3024,8400
test,568,28,21504,334,48096,69600
test,569,17,13056,123,17712,30768
test,570,10,7680,43,6192,13872
test,571,12,9216,61,8784,18000
test,572,7,5376,21,3024,8400
test,573,14,10752,84,12096,22848
test,574,22,16896,206,29664,46560
test,575,21,16128,188,27072,43200
test,576,22,16896,206,29664,46560
test,577,8,6144,27,3888,10032
test,578,7,5376,21,3024,8400
test,579,23,17664,225,32400,50064
test,580,8,6144,27,3888,10032
test,581,21,16128,188,27072,43200
test,582,18,13824,138,19872,33696
test,583,29,22272,358,51552,73824
test,584,7,5376,21,3024,8400
test,585,17,13056,123,17712,30768
test,586,6,4608,15,2160,6768
test,587,35,26880,522,75168,102048
test,588,23,17664,225,32400,50064
test,589,23,17664,225,32400,50064
test,590,18,13824,138,19872,33696
test,591,38,29184,615,88560,117744
test,592,41,31488,716,103104,134592
test,593,27,20736,310,44640,65376
test,594,16,12288,109,15696,27984
test,595,25,19200,266,38304,57504
test,596,20,15360,170,24480,39840
test,597,9,6912,35,5040,11952
test,598,9,6912,35,5040,11952
test,599,7,5376,21,3024,8400
test,600,29,22272,358,51552,73824
test,601,28,21504,334,48096,69600
test,602,9,6912,35,5040,11952
test,603,34,26112,492,70848,96960
test,604,10,7680,43,6192,13872
test,605,10,7680,43,6192,13872
test,606,18,13824,138,19872,33696
test,607,22,16896,206,29664,46560
test,608,22,16896,206,29664,46560
test,609,25,19200,266,38304,57504
test,610,14,10752,84,12096,22848
test,611,11,8448,52,7488,15936
test,612,10,7680,43,6192,13872
test,613,19,14592,154,22176,36768
test,614,42,32256,751,108144,140400
test,615,7,5376,21,3024,8400
test,616,28,21504,334,48096,69600
test,617,11,8448,52,7488,15936
test,618,9,6912,35,5040,11952
test,619,8,6144,27,3888,10032
test,620,14,10752,84,12096,22848
test,621,8,6144,27,3888,10032
test,622,23,17664,225,32400,50064
test,623,22,16896,206,29664,46560
test,624,22,16896,206,29664,46560
test,625,32,24576,436,62784,87360
test,626,12,9216,61,8784,18000
test,627,16,12288,109,15696,27984
test,628,23,17664,225,32400,50064
test,629,14,10752,84,12096,22848
test,630,26,19968,288,41472,61440
test,631,25,19200,266,38304,57504
test,632,17,13056,123,17712,30768
test,633,29,22272,358,51552,73824
test,634,22,16896,206,29664,46560
test,635,22,16896,206,29664,46560
test,636,30,23040,383,55152,78192
test,637,7,5376,21,3024,8400
test,638,10,7680,43,6192,13872
test,639,25,19200,266,38304,57504
test,640,12,9216,61,8784,18000
test,641,35,26880,522,75168,102048
test,642,15,11520,96,13824,25344
test,643,13,9984,72,10368,20352
test,644,18,13824,138,19872,33696
test,645,14,10752,84,12096,22848
test,646,17,13056,123,17712,30768
test,647,12,9216,61,8784,18000
test,648,39,29952,648,93312,123264
test,649,11,8448,52,7488,15936
test,650,23,17664,225,32400,50064
test,651,17,13056,123,17712,30768
test,652,26,19968,288,41472,61440
test,653,18,13824,138,19872,33696
test,654,17,13056,123,17712,30768
test,655,35,26880,522,75168,102048
test,656,38,29184,615,88560,117744
test,657,11,8448,52,7488,15936
test,658,18,13824,138,19872,33696
test,659,11,8448,52,7488,15936
test,660,14,10752,84,12096,22848
test,661,26,19968,288,41472,61440
test,662,26,19968,288,41472,61440
test,663,41,31488,716,103104,134592
test,664,17,13056,123,17712,30768
test,665,32,24576,436,62784,87360
test,666,25,19200,266,38304,57504
test,667,26,19968,288,41472,61440
test,668,27,20736,310,44640,65376
test,669,16,12288,109,15696,27984
test,670,10,7680,43,6192,13872
test,671,23,17664,225,32400,50064
test,672,21,16128,188,27072,43200
test,673,8,6144,27,3888,10032
test,674,20,15360,170,24480,39840
test,675,19,14592,154,22176,36768
test,676,26,19968,288,41472,61440
test,677,15,11520,96,13824,25344
test,678,22,16896,206,29664,46560
test,679,28,21504,334,48096,69600
test,680,25,19200,266,38304,57504
test,681,23,17664,225,32400,50064
test,682,27,20736,310,44640,65376
test,683,5,3840,11,1584,5424
test,684,14,10752,84,12096,22848
test,685,11,8448,52,7488,15936
test,686,24,18432,245,35280,53712
test,687,47,36096,940,135360,171456
test,688,24,18432,245,35280,53712
test,689,11,8448,52,7488,15936
test,690,33,25344,464,66816,92160
test,691,24,18432,245,35280,53712
test,692,22,16896,206,29664,46560
test,693,30,23040,383,55152,78192
test,694,22,16896,206,29664,46560
test,695,28,21504,334,48096,69600
test,696,14,10752,84,12096,22848
test,697,13,9984,72,10368,20352
test,698,17,13056,123,17712,30768
test,699,30,23040,383,55152,78192
test,700,14,10752,84,12096,22848
test,701,22,16896,206,29664,46560
test,702,11,8448,52,7488,15936
test,703,20,15360,170,24480,39840
test,704,14,10752,84,12096,22848
test,705,25,19200,266,38304,57504
test,706,50,38400,1064,153216,191616
test,707,8,6144,27,3888,10032
test,708,11,8448,52,7488,15936
test,709,20,15360,170,24480,39840
test,710,42,32256,751,108144,140400
test,711,27,20736,310,44640,65376
test,712,11,8448,52,7488,15936
test,713,9,6912,35,5040,11952
test,714,31,23808,409,58896,82704
test,715,24,18432,245,35280,53712
test,716,18,13824,138,19872,33696
test,717,5,3840,11,1584,5424
test,718,19,14592,154,22176,36768
test,719,16,12288,109,15696,27984
test,720,20,15360,170,24480,39840
test,721,21,16128,188,27072,43200
test,722,12,9216,61,8784,18000
test,723,9,6912,35,5040,11952
test,724,17,13056,123,17712,30768
test,725,29,22272,383,55152,77424
test,726,36,27648,552,79488,107136
test,727,21,16128,188,27072,43200
test,728,15,11520,96,13824,25344
test,729,16,12288,109,15696,27984
test,730,16,12288,109,15696,27984
test,731,10,7680,43,6192,13872
test,732,21,16128,188,27072,43200
test,733,16,12288,109,15696,27984
test,734,20,15360,170,24480,39840
test,735,6,4608,15,2160,6768
test,736,16,12288,109,15696,27984
test,737,8,6144,27,3888,10032
test,738,15,11520,96,13824,25344
test,739,23,17664,225,32400,50064
test,740,9,6912,35,5040,11952
test,741,23,17664,225,32400,50064
test,742,31,23808,409,58896,82704
test,743,20,15360,170,24480,39840
test,744,27,20736,310,44640,65376
test,745,18,13824,138,19872,33696
test,746,34,26112,492,70848,96960
test,747,15,11520,96,13824,25344
test,748,19,14592,154,22176,36768
test,749,12,9216,61,8784,18000
test,750,24,18432,245,35280,53712
test,751,37,28416,583,83952,112368
test,752,40,30720,681,98064,128784
test,753,8,6144,27,3888,10032
test,754,14,10752,84,12096,22848
test,755,37,28416,583,83952,112368
test,756,14,10752,84,12096,22848
test,757,30,23040,383,55152,78192
test,758,24,18432,245,35280,53712
test,759,17,13056,123,17712,30768
test,760,29,22272,358,51552,73824
test,761,29,22272,358,51552,73824
test,762,23,17664,225,32400,50064
test,763,28,21504,334,48096,69600
test,764,21,16128,188,27072,43200
test,765,40,30720,681,98064,128784
test,766,10,7680,43,6192,13872
test,767,17,13056,123,17712,30768
test,768,25,19200,266,38304,57504
test,769,10,7680,43,6192,13872
test,770,23,17664,225,32400,50064
test,771,5,3840,11,1584,5424
test,772,22,16896,206,29664,46560
test,773,12,9216,61,8784,18000
test,774,29,22272,358,51552,73824
test,775,11,8448,52,7488,15936
test,776,14,10752,84,12096,22848
test,777,31,23808,409,58896,82704
test,778,10,7680,43,6192,13872
test,779,28,21504,334,48096,69600
test,780,11,8448,52,7488,15936
test,781,27,20736,310,44640,65376
test,782,17,13056,123,17712,30768
test,783,23,17664,225,32400,50064
test,784,12,9216,61,8784,18000
test,785,39,29952,648,93312,123264
test,786,14,10752,84,12096,22848
test,787,21,16128,188,27072,43200
test,788,19,14592,154,22176,36768
test,789,23,17664,225,32400,50064
test,790,15,11520,96,13824,25344
test,791,16,12288,109,15696,27984
test,792,13,9984,72,10368,20352
test,793,23,17664,225,32400,50064
test,794,20,15360,170,24480,39840
test,795,13,9984,72,10368,20352
test,796,19,14592,154,22176,36768
test,797,7,5376,21,3024,8400
test,798,8,6144,27,3888,10032
test,799,13,9984,72,10368,20352
test,800,32,24576,436,62784,87360
test,801,24,18432,245,35280,53712
test,802,37,28416,583,83952,112368
test,803,16,12288,109,15696,27984
test,804,11,8448,52,7488,15936
test,805,8,6144,27,3888,10032
test,806,17,13056,123,17712,30768
test,807,8,6144,27,3888,10032
test,808,15,11520,96,13824,25344
test,809,16,12288,109,15696,27984
test,810,20,15360,170,24480,39840
test,811,29,22272,358,51552,73824
test,812,28,21504,334,48096,69600
test,813,18,13824,138,19872,33696
test,814,23,17664,225,32400,50064
test,815,4,3072,7,1008,4080
test,816,19,14592,154,22176,36768
test,817,29,22272,358,51552,73824
test,818,20,15360,170,24480,39840
test,819,9,6912,35,5040,11952
test,820,2,1536,2,288,1824
test,821,19,14592,154,22176,36768
test,822,12,9216,61,8784,18000
test,823,13,9984,72,10368,20352
test,824,21,16128,188,27072,43200
test,825,21,16128,188,27072,43200
test,826,19,14592,154,22176,36768
test,827,26,19968,288,41472,61440
test,828,20,15360,170,24480,39840
test,829,20,15360,170,24480,39840
test,830,9,6912,35,5040,11952
test,831,28,21504,334,48096,69600
test,832,16,12288,123,17712,30000
test,833,11,8448,52,7488,15936
test,834,40,30720,681,98064,128784
test,835,20,15360,170,24480,39840
test,836,28,21504,358,51552,73056
test,837,14,10752,84,12096,22848
test,838,7,5376,21,3024,8400
test,839,13,9984,72,10368,20352
test,840,15,11520,96,13824,25344
test,841,23,17664,225,32400,50064
test,842,29,22272,358,51552,73824
test,843,38,29184,615,88560,117744
test,844,18,13824,138,19872,33696
test,845,30,23040,383,55152,78192
test,846,12,9216,61,8784,18000
test,847,12,9216,61,8784,18000
test,848,20,15360,170,24480,39840
test,849,18,13824,138,19872,33696
test,850,34,26112,492,70848,96960
test,851,36,27648,552,79488,107136
test,852,19,14592,154,22176,36768
test,853,7,5376,21,3024,8400
test,854,21,16128,188,27072,43200
test,855,31,23808,409,58896,82704
test,856,30,23040,383,55152,78192
test,857,21,16128,188,27072,43200
test,858,14,10752,84,12096,22848
test,859,18,13824,138,19872,33696
test,860,21,16128,188,27072,43200
test,861,22,16896,206,29664,46560
test,862,35,26880,522,75168,102048
test,863,26,19968,288,41472,61440
test,864,28,21504,334,48096,69600
test,865,21,16128,188,27072,43200
test,866,34,26112,492,70848,96960
test,867,49,37632,1022,147168,184800
test,868,14,10752,84,12096,22848
test,869,22,16896,206,29664,46560
test,870,10,7680,43,6192,13872
test,871,30,23040,383,55152,78192
test,872,5,3840,11,1584,5424
test,873,19,14592,154,22176,36768
test,874,30,23040,383,55152,78192
test,875,20,15360,170,24480,39840
test,876,15,11520,96,13824,25344
test,877,37,28416,583,83952,112368
test,878,35,26880,522,75168,102048
test,879,26,19968,288,41472,61440
test,880,33,25344,464,66816,92160
test,881,5,3840,11,1584,5424
test,882,29,22272,358,51552,73824
test,883,28,21504,334,48096,69600
test,884,9,6912,35,5040,11952
test,885,29,22272,358,51552,73824
test,886,9,6912,35,5040,11952
test,887,11,8448,52,7488,15936
test,888,20,15360,170,24480,39840
test,889,25,19200,266,38304,57504
test,890,15,11520,96,13824,25344
test,891,30,23040,383,55152,78192
test,892,28,21504,334,48096,69600
test,893,31,23808,409,58896,82704
test,894,26,19968,288,41472,61440
test,895,5,3840,11,1584,5424
test,896,24,18432,245,35280,53712
test,897,28,21504,334,48096,69600
test,898,18,13824,138,19872,33696
test,899,12,9216,61,8784,18000
test,900,14,10752,84,12096,22848
test,901,24,18432,245,35280,53712
test,902,30,23040,383,55152,78192
test,903,35,26880,522,75168,102048
test,904,16,12288,109,15696,27984
test,905,24,18432,245,35280,53712
test,906,18,13824,138,19872,33696
test,907,14,10752,84,12096,22848
test,908,12,9216,61,8784,18000
test,909,14,10752,84,12096,22848
test,910,21,16128,188,27072,43200
test,911,35,26880,522,75168,102048
test,912,8,6144,27,3888,10032
test,913,18,13824,138,19872,33696
test,914,21,16128,188,27072,43200
test,915,25,19200,266,38304,57504
test,916,27,20736,310,44640,65376
test,917,28,21504,334,48096,69600
test,918,15,11520,96,13824,25344
test,919,16,12288,109,15696,27984
test,920,13,9984,72,10368,20352
test,921,25,19200,288,41472,60672
test,922,32,24576,436,62784,87360
test,923,11,8448,52,7488,15936
test,924,31,23808,409,58896,82704
test,925,35,26880,522,75168,102048
test,926,40,30720,681,98064,128784
test,927,36,27648,552,79488,107136
test,928,9,6912,35,5040,11952
test,929,20,15360,170,24480,39840
test,930,38,29184,615,88560,117744
test,931,20,15360,170,24480,39840
test,932,17,13056,123,17712,30768
test,933,8,6144,27,3888,10032
test,934,45,34560,862,124128,158688
test,935,15,11520,96,13824,25344
test,936,14,10752,96,13824,24576
test,937,9,6912,35,5040,11952
test,938,14,10752,84,12096,22848
test,939,42,32256,751,108144,140400
test,940,25,19200,266,38304,57504
test,941,39,29952,648,93312,123264
test,942,29,22272,358,51552,73824
test,943,19,14592,154,22176,36768
test,944,22,16896,206,29664,46560
test,945,22,16896,206,29664,46560
test,946,43,33024,787,113328,146352
test,947,34,26112,492,70848,96960
test,948,33,25344,464,66816,92160
test,949,16,12288,109,15696,27984
test,950,28,21504,334,48096,69600
test,951,24,18432,245,35280,53712
test,952,21,16128,188,27072,43200
test,953,19,14592,154,22176,36768
test,954,9,6912,43,6192,13104
test,955,33,25344,464,66816,92160
test,956,17,13056,123,17712,30768
test,957,24,18432,266,38304,56736
test,958,26,19968,288,41472,61440
test,959,31,23808,409,58896,82704
test,960,14,10752,84,12096,22848
test,961,9,6912,35,5040,11952
test,962,18,13824,138,19872,33696
test,963,20,15360,170,24480,39840
test,964,15,11520,96,13824,25344
test,965,11,8448,52,7488,15936
test,966,27,20736,310,44640,65376
test,967,23,17664,225,32400,50064
test,968,23,17664,225,32400,50064
test,969,8,6144,27,3888,10032
test,970,7,5376,21,3024,8400
test,971,36,27648,552,79488,107136
test,972,30,23040,383,55152,78192
test,973,18,13824,154,22176,36000
test,974,9,6912,35,5040,11952
test,975,10,7680,43,6192,13872
test,976,6,4608,15,2160,6768
test,977,20,15360,170,24480,39840
test,978,16,12288,109,15696,27984
test,979,19,14592,154,22176,36768
test,980,26,19968,288,41472,61440
test,981,32,24576,436,62784,87360
test,982,26,19968,288,41472,61440
test,983,7,5376,21,3024,8400
test,984,12,9216,61,8784,18000
test,985,9,6912,35,5040,11952
test,986,11,8448,52,7488,15936
test,987,33,25344,464,66816,92160
test,988,10,7680,43,6192,13872
test,989,19,14592,154,22176,36768
test,990,35,26880,522,75168,102048
test,991,16,12288,109,15696,27984
test,992,24,18432,245,35280,53712
test,993,42,32256,751,108144,140400
test,994,13,9984,72,10368,20352
test,995,33,25344,464,66816,92160
test,996,17,13056,123,17712,30768
test,997,13,9984,72,10368,20352
test,998,17,13056,123,17712,30768
test,999,35,26880,522,75168,102048
test,1000,14,10752,84,12096,22848
test,1001,21,16128,188,27072,43200
test,1002,9,6912,35,5040,11952
test,1003,8,6144,27,3888,10032
test,1004,29,22272,358,51552,73824
test,1005,32,24576,436,62784,87360
test,1006,25,19200,266,38304,57504
test,1007,12,9216,61,8784,18000
test,1008,24,18432,245,35280,53712
test,1009,31,23808,409,58896,82704
test,1010,6,4608,15,2160,6768
test,1011,21,16128,188,27072,43200
test,1012,7,5376,21,3024,8400
test,1013,9,6912,35,5040,11952
test,1014,12,9216,61,8784,18000
test,1015,11,8448,52,7488,15936
test,1016,25,19200,266,38304,57504
test,1017,10,7680,43,6192,13872
test,1018,9,6912,35,5040,11952
test,1019,41,31488,716,103104,134592
test,1020,28,21504,358,51552,73056
test,1021,28,21504,334,48096,69600
test,1022,22,16896,206,29664,46560
test,1023,3,2304,4,576,2880
test,1024,22,16896,206,29664,46560
test,1025,10,7680,43,6192,13872
test,1026,18,13824,138,19872,33696
test,1027,13,9984,72,10368,20352
test,1028,12,9216,61,8784,18000
test,1029,12,9216,72,10368,19584
test,1030,18,13824,138,19872,33696
test,1031,34,26112,492,70848,96960
test,1032,28,21504,334,48096,69600
test,1033,20,15360,170,24480,39840
test,1034,20,15360,170,24480,39840
test,1035,13,9984,72,10368,20352
test,1036,25,19200,266,38304,57504
test,1037,26,19968,288,41472,61440
test,1038,24,18432,245,35280,53712
test,1039,16,12288,109,15696,27984
test,1040,20,15360,170,24480,39840
test,1041,9,6912,35,5040,11952
test,1042,27,20736,310,44640,65376
test,1043,30,23040,383,55152,78192
test,1044,16,12288,109,15696,27984
test,1045,20,15360,170,24480,39840
test,1046,21,16128,188,27072,43200
test,1047,14,10752,96,13824,24576
test,1048,10,7680,43,6192,13872
test,1049,33,25344,464,66816,92160
test,1050,13,9984,72,10368,20352
test,1051,26,19968,288,41472,61440
test,1052,36,27648,552,79488,107136
test,1053,46,35328,901,129744,165072
test,1054,26,19968,288,41472,61440
test,1055,8,6144,27,3888,10032
test,1056,12,9216,61,8784,18000
test,1057,6,4608,15,2160,6768
test,1058,7,5376,21,3024,8400
test,1059,3,2304,4,576,2880
test,1060,28,21504,334,48096,69600
test,1061,20,15360,170,24480,39840
test,1062,14,10752,84,12096,22848
test,1063,22,16896,206,29664,46560
test,1064,19,14592,154,22176,36768
test,1065,22,16896,206,29664,46560
test,1066,15,11520,96,13824,25344
test,1067,25,19200,266,38304,57504
test,1068,20,15360,170,24480,39840
test,1069,28,21504,334,48096,69600
test,1070,19,14592,154,22176,36768
test,1071,31,23808,409,58896,82704
test,1072,24,18432,245,35280,53712
test,1073,39,29952,648,93312,123264
test,1074,22,16896,206,29664,46560
test,1075,10,7680,43,6192,13872
test,1076,19,14592,154,22176,36768
test,1077,14,10752,84,12096,22848
test,1078,18,13824,138,19872,33696
test,1079,27,20736,310,44640,65376
test,1080,14,10752,84,12096,22848
test,1081,19,14592,154,22176,36768
test,1082,3,2304,4,576,2880
test,1083,8,6144,27,3888,10032
test,1084,27,20736,310,44640,65376
test,1085,3,2304,4,576,2880
test,1086,19,14592,154,22176,36768
test,1087,33,25344,464,66816,92160
test,1088,24,18432,245,35280,53712
test,1089,24,18432,245,35280,53712
test,1090,20,15360,170,24480,39840
test,1091,9,6912,35,5040,11952
test,1092,20,15360,170,24480,39840
test,1093,6,4608,15,2160,6768
test,1094,18,13824,138,19872,33696
test,1095,10,7680,43,6192,13872
test,1096,19,14592,154,22176,36768
test,1097,18,13824,138,19872,33696
test,1098,41,31488,716,103104,134592
test,1099,12,9216,61,8784,18000
test,1100,14,10752,84,12096,22848
test,1101,19,14592,154,22176,36768
test,1102,23,17664,225,32400,50064
test,1103,34,26112,492,70848,96960
test,1104,16,12288,109,15696,27984
test,1105,12,9216,61,8784,18000
test,1106,24,18432,245,35280,53712
test,1107,29,22272,358,51552,73824
test,1108,22,16896,206,29664,46560
test,1109,12,9216,61,8784,18000
test,1110,18,13824,138,19872,33696
test,1111,29,22272,358,51552,73824
test,1112,21,16128,188,27072,43200
test,1113,34,26112,492,70848,96960
test,1114,24,18432,245,35280,53712
test,1115,8,6144,27,3888,10032
test,1116,22,16896,206,29664,46560
test,1117,20,15360,170,24480,39840
test,1118,9,6912,35,5040,11952
test,1119,26,19968,288,41472,61440
test,1120,7,5376,21,3024,8400
test,1121,13,9984,72,10368,20352
test,1122,28,21504,334,48096,69600
test,1123,27,20736,310,44640,65376
test,1124,32,24576,436,62784,87360
test,1125,28,21504,334,48096,69600
test,1126,10,7680,43,6192,13872
test,1127,17,13056,123,17712,30768
test,1128,10,7680,43,6192,13872
test,1129,20,15360,170,24480,39840
test,1130,23,17664,225,32400,50064
test,1131,14,10752,84,12096,22848
test,1132,21,16128,188,27072,43200
test,1133,3,2304,4,576,2880
test,1134,16,12288,109,15696,27984
test,1135,28,21504,334,48096,69600
test,1136,37,28416,583,83952,112368
test,1137,15,11520,96,13824,25344
test,1138,23,17664,225,32400,50064
test,1139,36,27648,552,79488,107136
test,1140,9,6912,35,5040,11952
test,1141,20,15360,170,24480,39840
test,1142,21,16128,188,27072,43200
test,1143,27,20736,310,44640,65376
test,1144,44,33792,824,118656,152448
test,1145,42,32256,751,108144,140400
test,1146,15,11520,109,15696,27216
test,1147,41,31488,716,103104,134592
test,1148,15,11520,96,13824,25344
test,1149,10,7680,43,6192,13872
test,1150,26,19968,288,41472,61440
test,1151,22,16896,206,29664,46560
test,1152,20,15360,170,24480,39840
test,1153,13,9984,72,10368,20352
test,1154,31,23808,409,58896,82704
test,1155,19,14592,154,22176,36768
test,1156,6,4608,15,2160,6768
test,1157,12,9216,61,8784,18000
test,1158,32,24576,436,62784,87360
test,1159,36,27648,552,79488,107136
test,1160,12,9216,61,8784,18000
test,1161,19,14592,154,22176,36768
test,1162,21,16128,188,27072,43200
test,1163,8,6144,27,3888,10032
test,1164,29,22272,358,51552,73824
test,1165,27,20736,310,44640,65376
test,1166,27,20736,310,44640,65376
test,1167,29,22272,358,51552,73824
test,1168,13,9984,72,10368,20352
test,1169,24,18432,245,35280,53712
test,1170,32,24576,436,62784,87360
test,1171,33,25344,464,66816,92160
test,1172,36,27648,552,79488,107136
test,1173,26,19968,288,41472,61440
test,1174,15,11520,96,13824,25344
test,1175,14,10752,84,12096,22848
test,1176,27,20736,310,44640,65376
test,1177,29,22272,358,51552,73824
test,1178,23,17664,225,32400,50064
test,1179,13,9984,72,10368,20352
test,1180,10,7680,43,6192,13872
test,1181,21,16128,188,27072,43200
test,1182,17,13056,123,17712,30768
test,1183,23,17664,225,32400,50064
test,1184,15,11520,96,13824,25344
test,1185,26,19968,288,41472,61440
test,1186,17,13056,123,17712,30768
test,1187,17,13056,123,17712,30768
test,1188,22,16896,206,29664,46560
test,1189,23,17664,225,32400,50064
test,1190,22,16896,206,29664,46560
test,1191,7,5376,21,3024,8400
test,1192,12,9216,61,8784,18000
test,1193,22,16896,206,29664,46560
test,1194,15,11520,96,13824,25344
test,1195,19,14592,154,22176,36768
test,1196,26,19968,288,41472,61440
test,1197,10,7680,43,6192,13872
test,1198,13,9984,72,10368,20352
test,1199,21,16128,188,27072,43200
test,1200,14,10752,84,12096,22848
test,1201,15,11520,96,13824,25344
test,1202,14,10752,84,12096,22848
test,1203,26,19968,288,41472,61440
test,1204,40,30720,681,98064,128784
test,1205,13,9984,72,10368,20352
test,1206,29,22272,383,55152,77424
test,1207,16,12288,109,15696,27984
test,1208,31,23808,409,58896,82704
test,1209,35,26880,522,75168,102048
test,1210,21,16128,188,27072,43200
test,1211,29,22272,358,51552,73824
test,1212,7,5376,21,3024,8400
test,1213,44,33792,824,118656,152448
test,1214,28,21504,334,48096,69600
test,1215,22,16896,206,29664,46560
test,1216,28,21504,334,48096,69600
test,1217,6,4608,15,2160,6768
test,1218,36,27648,552,79488,107136
test,1219,15,11520,96,13824,25344
test,1220,14,10752,84,12096,22848
test,1221,10,7680,43,6192,13872
test,1222,36,27648,552,79488,107136
test,1223,8,6144,27,3888,10032
test,1224,21,16128,188,27072,43200
test,1225,23,17664,225,32400,50064
test,1226,30,23040,383,55152,78192
test,1227,37,28416,583,83952,112368
test,1228,28,21504,334,48096,69600
test,1229,5,3840,11,1584,5424
test,1230,18,13824,138,19872,33696
test,1231,25,19200,266,38304,57504
test,1232,16,12288,109,15696,27984
test,1233,27,20736,310,44640,65376
test,1234,13,9984,72,10368,20352
test,1235,13,9984,72,10368,20352
test,1236,25,19200,266,38304,57504
test,1237,26,19968,288,41472,61440
test,1238,13,9984,72,10368,20352
test,1239,22,16896,206,29664,46560
test,1240,12,9216,61,8784,18000
test,1241,19,14592,154,22176,36768
test,1242,25,19200,266,38304,57504
test,1243,37,28416,583,83952,112368
test,1244,27,20736,310,44640,65376
test,1245,41,31488,716,103104,134592
test,1246,20,15360,170,24480,39840
test,1247,14,10752,84,12096,22848
test,1248,33,25344,464,66816,92160
test,1249,17,13056,123,17712,30768
test,1250,18,13824,138,19872,33696
test,1251,22,16896,206,29664,46560
test,1252,12,9216,61,8784,18000
test,1253,25,19200,266,38304,57504
test,1254,30,23040,383,55152,78192
test,1255,21,16128,188,27072,43200
test,1256,22,16896,206,29664,46560
test,1257,8,6144,27,3888,10032
test,1258,28,21504,334,48096,69600
test,1259,16,12288,109,15696,27984
test,1260,16,12288,109,15696,27984
test,1261,8,6144,27,3888,10032
test,1262,16,12288,109,15696,27984
test,1263,35,26880,522,75168,102048
test,1264,28,21504,334,48096,69600
test,1265,27,20736,310,44640,65376
test,1266,27,20736,310,44640,65376
test,1267,16,12288,109,15696,27984
test,1268,15,11520,96,13824,25344
test,1269,26,19968,288,41472,61440
test,1270,12,9216,61,8784,18000
test,1271,16,12288,109,15696,27984
test,1272,10,7680,43,6192,13872
test,1273,22,16896,206,29664,46560
test,1274,24,18432,245,35280,53712
test,1275,27,20736,310,44640,65376
test,1276,27,20736,310,44640,65376
test,1277,31,23808,409,58896,82704
test,1278,6,4608,15,2160,6768
test,1279,15,11520,96,13824,25344
test,1280,22,16896,206,29664,46560
test,1281,12,9216,72,10368,19584
test,1282,13,9984,72,10368,20352
test,1283,16,12288,109,15696,27984
test,1284,12,9216,61,8784,18000
test,1285,32,24576,436,62784,87360
test,1286,18,13824,138,19872,33696
test,1287,32,24576,436,62784,87360
test,1288,28,21504,334,48096,69600
test,1289,7,5376,21,3024,8400
test,1290,32,24576,436,62784,87360
test,1291,21,16128,188,27072,43200
test,1292,22,16896,206,29664,46560
test,1293,21,16128,188,27072,43200
test,1294,2,1536,2,288,1824
test,1295,20,15360,170,24480,39840
test,1296,10,7680,43,6192,13872
test,1297,28,21504,334,48096,69600
test,1298,16,12288,109,15696,27984
test,1299,33,25344,464,66816,92160
test,1300,23,17664,225,32400,50064
test,1301,18,13824,138,19872,33696
test,1302,19,14592,154,22176,36768
test,1303,17,13056,123,17712,30768
test,1304,9,6912,35,5040,11952
test,1305,30,23040,383,55152,78192
test,1306,24,18432,245,35280,53712
test,1307,18,13824,138,19872,33696
test,1308,8,6144,27,3888,10032
test,1309,13,9984,72,10368,20352
test,1310,8,6144,27,3888,10032
test,1311,31,23808,409,58896,82704
test,1312,18,13824,138,19872,33696
test,1313,12,9216,61,8784,18000
test,1314,23,17664,225,32400,50064
test,1315,29,22272,358,51552,73824
test,1316,34,26112,492,70848,96960
test,1317,22,16896,206,29664,46560
test,1318,11,8448,52,7488,15936
test,1319,24,18432,245,35280,53712
test,1320,23,17664,225,32400,50064
test,1321,16,12288,109,15696,27984
test,1322,14,10752,84,12096,22848
test,1323,31,23808,409,58896,82704
test,1324,17,13056,123,17712,30768
test,1325,7,5376,21,3024,8400
test,1326,37,28416,583,83952,112368
test,1327,5,3840,11,1584,5424
test,1328,16,12288,109,15696,27984
test,1329,18,13824,138,19872,33696
test,1330,18,13824,138,19872,33696
test,1331,9,6912,35,5040,11952
test,1332,13,9984,72,10368,20352
test,1333,29,22272,383,55152,77424
test,1334,19,14592,154,22176,36768
test,1335,26,19968,288,41472,61440
test,1336,40,30720,681,98064,128784
test,1337,10,7680,43,6192,13872
test,1338,22,16896,206,29664,46560
test,1339,19,14592,154,22176,36768
test,1340,16,12288,109,15696,27984
test,1341,20,15360,170,24480,39840
test,1342,9,6912,35,5040,11952
test,1343,21,16128,188,27072,43200
test,1344,12,9216,61,8784,18000
test,1345,20,15360,170,24480,39840
test,1346,35,26880,522,75168,102048
test,1347,21,16128,188,27072,43200
test,1348,24,18432,245,35280,53712
test,1349,29,22272,358,51552,73824
test,1350,16,12288,109,15696,27984
test,1351,27,20736,310,44640,65376
test,1352,19,14592,154,22176,36768
test,1353,20,15360,170,24480,39840
test,1354,16,12288,109,15696,27984
test,1355,8,6144,27,3888,10032
test,1356,16,12288,109,15696,27984
test,1357,21,16128,188,27072,43200
test,1358,27,20736,310,44640,65376
test,1359,42,32256,751,108144,140400
test,1360,18,13824,138,19872,33696
test,1361,19,14592,154,22176,36768
test,1362,5,3840,11,1584,5424
test,1363,33,25344,464,66816,92160
test,1364,9,6912,35,5040,11952
test,1365,24,18432,245,35280,53712
test,1366,12,9216,61,8784,18000
test,1367,21,16128,188,27072,43200
test,1368,23,17664,225,32400,50064
test,1369,15,11520,96,13824,25344
test,1370,20,15360,170,24480,39840
test,1371,26,19968,288,41472,61440
test,1372,26,19968,288,41472,61440
test,1373,18,13824,138,19872,33696
test,1374,24,18432,245,35280,53712
test,1375,11,8448,52,7488,15936
test,1376,11,8448,52,7488,15936
test,1377,35,26880,522,75168,102048
test,1378,26,19968,288,41472,61440
test,1379,28,21504,334,48096,69600
test,1380,17,13056,123,17712,30768
test,1381,19,14592,154,22176,36768
test,1382,29,22272,358,51552,73824
test,1383,30,23040,383,55152,78192
test,1384,15,11520,96,13824,25344
test,1385,18,13824,138,19872,33696
test,1386,21,16128,188,27072,43200
test,1387,25,19200,266,38304,57504
test,1388,13,9984,72,10368,20352
test,1389,6,4608,15,2160,6768
test,1390,19,14592,154,22176,36768
test,1391,6,4608,15,2160,6768
test,1392,15,11520,96,13824,25344
test,1393,40,30720,681,98064,128784
test,1394,30,23040,383,55152,78192
test,1395,14,10752,84,12096,22848
test,1396,12,9216,61,8784,18000
test,1397,13,9984,72,10368,20352
test,1398,22,16896,206,29664,46560
test,1399,14,10752,84,12096,22848
test,1400,12,9216,61,8784,18000
test,1401,14,10752,84,12096,22848
test,1402,24,18432,245,35280,53712
test,1403,30,23040,383,55152,78192
test,1404,29,22272,358,51552,73824
test,1405,26,19968,288,41472,61440
test,1406,25,19200,266,38304,57504
test,1407,10,7680,43,6192,13872
test,1408,21,16128,188,27072,43200
test,1409,25,19200,266,38304,57504
test,1410,14,10752,84,12096,22848
test,1411,17,13056,123,17712,30768
test,1412,27,20736,310,44640,65376
test,1413,8,6144,27,3888,10032
test,1414,16,12288,109,15696,27984
test,1415,7,5376,21,3024,8400
test,1416,23,17664,225,32400,50064
test,1417,25,19200,266,38304,57504
test,1418,27,20736,310,44640,65376
test,1419,16,12288,109,15696,27984
test,1420,10,7680,43,6192,13872
test,1421,36,27648,552,79488,107136
test,1422,11,8448,52,7488,15936
test,1423,22,16896,206,29664,46560
test,1424,24,18432,245,35280,53712
test,1425,16,12288,109,15696,27984
test,1426,17,13056,123,17712,30768
test,1427,23,17664,225,32400,50064
test,1428,11,8448,52,7488,15936
test,1429,23,17664,225,32400,50064
test,1430,23,17664,225,32400,50064
test,1431,13,9984,72,10368,20352
test,1432,33,25344,464,66816,92160
test,1433,19,14592,154,22176,36768
test,1434,45,34560,862,124128,158688
test,1435,21,16128,188,27072,43200
test,1436,33,25344,464,66816,92160
test,1437,25,19200,266,38304,57504
test,1438,28,21504,334,48096,69600
test,1439,23,17664,225,32400,50064
test,1440,29,22272,358,51552,73824
test,1441,16,12288,109,15696,27984
test,1442,13,9984,72,10368,20352
test,1443,9,6912,35,5040,11952
test,1444,23,17664,225,32400,50064
test,1445,47,36096,940,135360,171456
test,1446,39,29952,648,93312,123264
test,1447,20,15360,170,24480,39840
test,1448,15,11520,96,13824,25344
test,1449,30,23040,383,55152,78192
test,1450,25,19200,266,38304,57504
test,1451,37,28416,583,83952,112368
test,1452,36,27648,552,79488,107136
test,1453,29,22272,358,51552,73824
test,1454,24,18432,266,38304,56736
test,1455,15,11520,96,13824,25344
test,1456,28,21504,334,48096,69600
test,1457,7,5376,21,3024,8400
test,1458,24,18432,245,35280,53712
test,1459,7,5376,21,3024,8400
test,1460,30,23040,383,55152,78192
test,1461,12,9216,61,8784,18000
test,1462,23,17664,225,32400,50064
test,1463,18,13824,138,19872,33696
test,1464,14,10752,84,12096,22848
test,1465,30,23040,383,55152,78192
test,1466,41,31488,716,103104,134592
test,1467,23,17664,225,32400,50064
test,1468,27,20736,310,44640,65376
test,1469,35,26880,522,75168,102048
test,1470,14,10752,84,12096,22848
test,1471,14,10752,96,13824,24576
test,1472,8,6144,27,3888,10032
test,1473,27,20736,310,44640,65376
test,1474,16,12288,109,15696,27984
test,1475,11,8448,61,8784,17232
test,1476,20,15360,170,24480,39840
test,1477,21,16128,188,27072,43200
test,1478,14,10752,84,12096,22848
test,1479,26,19968,288,41472,61440
test,1480,20,15360,170,24480,39840
test,1481,14,10752,84,12096,22848
test,1482,29,22272,358,51552,73824
test,1483,19,14592,154,22176,36768
test,1484,25,19200,266,38304,57504
test,1485,11,8448,52,7488,15936
test,1486,10,7680,43,6192,13872
test,1487,19,14592,154,22176,36768
test,1488,29,22272,358,51552,73824
test,1489,18,13824,138,19872,33696
test,1490,15,11520,96,13824,25344
test,1491,31,23808,409,58896,82704
test,1492,33,25344,464,66816,92160
test,1493,24,18432,245,35280,53712
test,1494,25,19200,266,38304,57504
test,1495,7,5376,21,3024,8400
test,1496,9,6912,35,5040,11952
test,1497,5,3840,11,1584,5424
test,1498,20,15360,170,24480,39840
test,1499,9,6912,35,5040,11952
test,1500,9,6912,35,5040,11952
test,1501,45,34560,862,124128,158688
test,1502,24,18432,245,35280,53712
test,1503,25,19200,266,38304,57504
test,1504,43,33024,787,113328,146352
test,1505,16,12288,109,15696,27984
test,1506,4,3072,7,1008,4080
test,1507,35,26880,522,75168,102048
test,1508,20,15360,170,24480,39840
test,1509,26,19968,288,41472,61440
test,1510,20,15360,170,24480,39840
test,1511,23,17664,225,32400,50064
test,1512,11,8448,52,7488,15936
test,1513,16,12288,109,15696,27984
test,1514,10,7680,43,6192,13872
test,1515,24,18432,245,35280,53712
test,1516,16,12288,109,15696,27984
test,1517,17,13056,123,17712,30768
test,1518,42,32256,751,108144,140400
test,1519,27,20736,310,44640,65376
test,1520,33,25344,464,66816,92160
test,1521,29,22272,358,51552,73824
test,1522,28,21504,334,48096,69600
test,1523,9,6912,35,5040,11952
test,1524,28,21504,334,48096,69600
test,1525,7,5376,21,3024,8400
test,1526,29,22272,358,51552,73824
test,1527,14,10752,84,12096,22848
test,1528,25,19200,266,38304,57504
test,1529,15,11520,96,13824,25344
test,1530,28,21504,334,48096,69600
test,1531,7,5376,21,3024,8400
test,1532,44,33792,824,118656,152448
test,1533,24,18432,245,35280,53712
test,1534,16,12288,109,15696,27984
test,1535,18,13824,138,19872,33696
test,1536,17,13056,123,17712,30768
test,1537,17,13056,123,17712,30768
test,1538,17,13056,123,17712,30768
test,1539,26,19968,288,41472,61440
test,1540,11,8448,52,7488,15936
test,1541,20,15360,170,24480,39840
test,1542,18,13824,138,19872,33696
test,1543,18,13824,138,19872,33696
test,1544,19,14592,154,22176,36768
test,1545,12,9216,61,8784,18000
test,1546,15,11520,96,13824,25344
test,1547,16,12288,109,15696,27984
test,1548,27,20736,310,44640,65376
test,1549,21,16128,188,27072,43200
test,1550,10,7680,43,6192,13872
test,1551,26,19968,288,41472,61440
test,1552,21,16128,188,27072,43200
test,1553,22,16896,206,29664,46560
test,1554,12,9216,61,8784,18000
test,1555,33,25344,464,66816,92160
test,1556,10,7680,43,6192,13872
test,1557,14,10752,84,12096,22848
test,1558,37,28416,615,88560,116976
test,1559,20,15360,170,24480,39840
test,1560,7,5376,21,3024,8400
test,1561,19,14592,154,22176,36768
test,1562,12,9216,61,8784,18000
test,1563,41,31488,716,103104,134592
test,1564,9,6912,35,5040,11952
test,1565,17,13056,123,17712,30768
test,1566,17,13056,123,17712,30768
test,1567,13,9984,72,10368,20352
test,1568,13,9984,72,10368,20352
test,1569,11,8448,52,7488,15936
test,1570,16,12288,109,15696,27984
test,1571,10,7680,43,6192,13872
test,1572,21,16128,188,27072,43200
test,1573,32,24576,436,62784,87360
test,1574,26,19968,310,44640,64608
test,1575,11,8448,52,7488,15936
test,1576,30,23040,383,55152,78192
test,1577,12,9216,61,8784,18000
test,1578,15,11520,96,13824,25344
test,1579,28,21504,334,48096,69600
test,1580,7,5376,21,3024,8400
test,1581,22,16896,206,29664,46560
test,1582,21,16128,188,27072,43200
test,1583,19,14592,154,22176,36768
test,1584,25,19200,266,38304,57504
test,1585,8,6144,27,3888,10032
test,1586,19,14592,154,22176,36768
test,1587,17,13056,123,17712,30768
test,1588,19,14592,154,22176,36768
test,1589,20,15360,170,24480,39840
test,1590,19,14592,154,22176,36768
test,1591,13,9984,72,10368,20352
test,1592,32,24576,436,62784,87360
test,1593,13,9984,72,10368,20352
test,1594,25,19200,266,38304,57504
test,1595,24,18432,266,38304,56736
test,1596,13,9984,72,10368,20352
test,1597,10,7680,43,6192,13872
test,1598,38,29184,615,88560,117744
test,1599,29,22272,358,51552,73824
test,1600,17,13056,123,17712,30768
test,1601,17,13056,123,17712,30768
test,1602,15,11520,96,13824,25344
test,1603,6,4608,15,2160,6768
test,1604,7,5376,21,3024,8400
test,1605,17,13056,123,17712,30768
test,1606,9,6912,35,5040,11952
test,1607,16,12288,109,15696,27984
test,1608,13,9984,72,10368,20352
test,1609,14,10752,84,12096,22848
test,1610,18,13824,138,19872,33696
test,1611,12,9216,61,8784,18000
test,1612,24,18432,245,35280,53712
test,1613,21,16128,188,27072,43200
test,1614,18,13824,138,19872,33696
test,1615,19,14592,154,22176,36768
test,1616,26,19968,288,41472,61440
test,1617,14,10752,84,12096,22848
test,1618,30,23040,383,55152,78192
test,1619,27,20736,310,44640,65376
test,1620,20,15360,170,24480,39840
test,1621,7,5376,21,3024,8400
test,1622,25,19200,266,38304,57504
test,1623,36,27648,552,79488,107136
test,1624,10,7680,43,6192,13872
test,1625,21,16128,188,27072,43200
test,1626,22,16896,206,29664,46560
test,1627,18,13824,138,19872,33696
test,1628,26,19968,288,41472,61440
test,1629,40,30720,681,98064,128784
test,1630,23,17664,225,32400,50064
test,1631,20,15360,170,24480,39840
test,1632,28,21504,334,48096,69600
test,1633,18,13824,138,19872,33696
test,1634,39,29952,648,93312,123264
test,1635,23,17664,225,32400,50064
test,1636,44,33792,824,118656,152448
test,1637,13,9984,72,10368,20352
test,1638,23,17664,225,32400,50064
test,1639,12,9216,61,8784,18000
test,1640,23,17664,225,32400,50064
test,1641,9,6912,35,5040,11952
test,1642,36,27648,552,79488,107136
test,1643,18,13824,138,19872,33696
test,1644,24,18432,245,35280,53712
test,1645,17,13056,123,17712,30768
test,1646,16,12288,109,15696,27984
test,1647,28,21504,334,48096,69600
test,1648,24,18432,245,35280,53712
test,1649,19,14592,154,22176,36768
test,1650,34,26112,492,70848,96960
test,1651,25,19200,266,38304,57504
test,1652,24,18432,245,35280,53712
test,1653,24,18432,245,35280,53712
test,1654,11,8448,52,7488,15936
test,1655,31,23808,409,58896,82704
test,1656,33,25344,464,66816,92160
test,1657,5,3840,11,1584,5424
test,1658,10,7680,43,6192,13872
test,1659,30,23040,383,55152,78192
test,1660,25,19200,266,38304,57504
test,1661,31,23808,409,58896,82704
test,1662,23,17664,225,32400,50064
test,1663,13,9984,84,12096,22080
test,1664,19,14592,154,22176,36768
test,1665,18,13824,138,19872,33696
test,1666,17,13056,123,17712,30768
test,1667,34,26112,492,70848,96960
test,1668,35,26880,552,79488,106368
test,1669,16,12288,109,15696,27984
test,1670,21,16128,188,27072,43200
test,1671,18,13824,138,19872,33696
test,1672,30,23040,383,55152,78192
test,1673,25,19200,266,38304,57504
test,1674,33,25344,464,66816,92160
test,1675,22,16896,206,29664,46560
test,1676,22,16896,206,29664,46560
test,1677,35,26880,522,75168,102048
test,1678,10,7680,43,6192,13872
test,1679,22,16896,206,29664,46560
test,1680,3,2304,4,576,2880
test,1681,19,14592,154,22176,36768
test,1682,40,30720,681,98064,128784
test,1683,32,24576,436,62784,87360
test,1684,17,13056,123,17712,30768
test,1685,9,6912,35,5040,11952
test,1686,30,23040,383,55152,78192
test,1687,33,25344,464,66816,92160
test,1688,14,10752,84,12096,22848
test,1689,27,20736,334,48096,68832
test,1690,17,13056,123,17712,30768
test,1691,7,5376,21,3024,8400
test,1692,31,23808,409,58896,82704
test,1693,32,24576,436,62784,87360
test,1694,18,13824,138,19872,33696
test,1695,9,6912,35,5040,11952
test,1696,34,26112,492,70848,96960
test,1697,24,18432,245,35280,53712
test,1698,11,8448,52,7488,15936
test,1699,15,11520,96,13824,25344
test,1700,20,15360,170,24480,39840
test,1701,22,16896,206,29664,46560
test,1702,23,17664,225,32400,50064
test,1703,13,9984,72,10368,20352
test,1704,24,18432,245,35280,53712
test,1705,24,18432,245,35280,53712
test,1706,22,16896,206,29664,46560
test,1707,22,16896,206,29664,46560
test,1708,18,13824,138,19872,33696
test,1709,34,26112,492,70848,96960
test,1710,7,5376,21,3024,8400
test,1711,27,20736,310,44640,65376
test,1712,20,15360,170,24480,39840
test,1713,13,9984,72,10368,20352
test,1714,26,19968,288,41472,61440
test,1715,21,16128,188,27072,43200
test,1716,27,20736,310,44640,65376
test,1717,21,16128,188,27072,43200
test,1718,7,5376,21,3024,8400
test,1719,15,11520,96,13824,25344
test,1720,27,20736,310,44640,65376
test,1721,8,6144,27,3888,10032
test,1722,22,16896,225,32400,49296
test,1723,20,15360,170,24480,39840
test,1724,6,4608,15,2160,6768
test,1725,30,23040,383,55152,78192
test,1726,10,7680,43,6192,13872
test,1727,6,4608,15,2160,6768
test,1728,32,24576,436,62784,87360
test,1729,25,19200,266,38304,57504
test,1730,17,13056,123,17712,30768
test,1731,20,15360,170,24480,39840
test,1732,21,16128,188,27072,43200
test,1733,3,2304,4,576,2880
test,1734,16,12288,109,15696,27984
test,1735,22,16896,206,29664,46560
test,1736,12,9216,61,8784,18000
test,1737,29,22272,358,51552,73824
test,1738,17,13056,123,17712,30768
test,1739,24,18432,245,35280,53712
test,1740,39,29952,648,93312,123264
test,1741,23,17664,225,32400,50064
test,1742,31,23808,409,58896,82704
test,1743,15,11520,96,13824,25344
test,1744,28,21504,334,48096,69600
test,1745,22,16896,206,29664,46560
test,1746,48,36864,981,141264,178128
test,1747,31,23808,409,58896,82704
test,1748,23,17664,225,32400,50064
test,1749,32,24576,436,62784,87360
test,1750,21,16128,188,27072,43200
test,1751,3,2304,4,576,2880
test,1752,34,26112,492,70848,96960
test,1753,29,22272,358,51552,73824
test,1754,7,5376,21,3024,8400
test,1755,24,18432,245,35280,53712
test,1756,6,4608,15,2160,6768
test,1757,10,7680,43,6192,13872
test,1758,14,10752,84,12096,22848
test,1759,23,17664,225,32400,50064
test,1760,6,4608,15,2160,6768
test,1761,31,23808,409,58896,82704
test,1762,19,14592,154,22176,36768
test,1763,13,9984,72,10368,20352
test,1764,17,13056,123,17712,30768
test,1765,22,16896,206,29664,46560
test,1766,20,15360,170,24480,39840
test,1767,18,13824,138,19872,33696
test,1768,32,24576,436,62784,87360
test,1769,31,23808,409,58896,82704
test,1770,19,14592,154,22176,36768
test,1771,13,9984,72,10368,20352
test,1772,26,19968,288,41472,61440
test,1773,17,13056,123,17712,30768
test,1774,26,19968,288,41472,61440
test,1775,34,26112,492,70848,96960
test,1776,6,4608,15,2160,6768
test,1777,32,24576,436,62784,87360
test,1778,16,12288,109,15696,27984
test,1779,22,16896,206,29664,46560
test,1780,27,20736,310,44640,65376
test,1781,16,12288,109,15696,27984
test,1782,17,13056,123,17712,30768
test,1783,8,6144,27,3888,10032
test,1784,14,10752,84,12096,22848
test,1785,14,10752,84,12096,22848
test,1786,19,14592,154,22176,36768
test,1787,36,27648,552,79488,107136
test,1788,22,16896,206,29664,46560
test,1789,34,26112,492,70848,96960
test,1790,32,24576,436,62784,87360
test,1791,35,26880,522,75168,102048
test,1792,15,11520,96,13824,25344
test,1793,32,24576,436,62784,87360
test,1794,9,6912,35,5040,11952
test,1795,33,25344,464,66816,92160
test,1796,32,24576,436,62784,87360
test,1797,34,26112,492,70848,96960
test,1798,25,19200,266,38304,57504
test,1799,14,10752,84,12096,22848
test,1800,9,6912,35,5040,11952
test,1801,18,13824,138,19872,33696
test,1802,7,5376,21,3024,8400
test,1803,30,23040,383,55152,78192
test,1804,26,19968,310,44640,64608
test,1805,13,9984,72,10368,20352
test,1806,26,19968,288,41472,61440
test,1807,23,17664,225,32400,50064
test,1808,6,4608,15,2160,6768
test,1809,8,6144,27,3888,10032
test,1810,21,16128,188,27072,43200
test,1811,33,25344,464,66816,92160
test,1812,35,26880,522,75168,102048
test,1813,25,19200,266,38304,57504
test,1814,14,10752,84,12096,22848
test,1815,31,23808,409,58896,82704
test,1816,35,26880,522,75168,102048
test,1817,15,11520,96,13824,25344
test,1818,30,23040,383,55152,78192
test,1819,4,3072,7,1008,4080
test,1820,28,21504,334,48096,69600
