split,index,nodes,total_values_for_nodes,edges,total_values_for_edges,total_values_for_graph
train,0,422,324096,178084,25644096,25968192
train,1,348,267264,121104,17438976,17706240
train,2,382,293376,145924,21013056,21306432
train,3,292,224256,85264,12278016,12502272
train,4,127,97536,16129,2322576,2420112
train,5,360,276480,129600,18662400,18938880
train,6,123,94464,15129,2178576,2273040
train,7,512,393216,262144,37748736,38141952
train,8,201,154368,40401,5817744,5972112
train,9,246,188928,60516,8714304,8903232
train,10,354,271872,125316,18045504,18317376
train,11,116,89088,13456,1937664,2026752
train,12,268,205824,71824,10342656,10548480
train,13,291,223488,84681,12194064,12417552
train,14,312,239616,97344,14017536,14257152
train,15,172,132096,29584,4260096,4392192
train,16,377,289536,142129,20466576,20756112
train,17,265,203520,70225,10112400,10315920
train,18,397,304896,157609,22695696,23000592
train,19,104,79872,10816,1557504,1637376
train,20,219,168192,47961,6906384,7074576
train,21,160,122880,25600,3686400,3809280
train,22,222,170496,49284,7096896,7267392
train,23,247,189696,61009,8785296,8974992
train,24,438,336384,191844,27625536,27961920
train,25,416,319488,173056,24920064,25239552
train,26,311,238848,96721,13927824,14166672
train,27,412,316416,169744,24443136,24759552
train,28,215,165120,46225,6656400,6821520
train,29,160,122880,25600,3686400,3809280
train,30,160,122880,25600,3686400,3809280
train,31,315,241920,99225,14288400,14530320
train,32,397,304896,157609,22695696,23000592
train,33,512,393216,262144,37748736,38141952
train,34,418,321024,174724,25160256,25481280
train,35,331,254208,109561,15776784,16030992
train,36,306,235008,93636,13483584,13718592
train,37,265,203520,70225,10112400,10315920
train,38,194,148992,37636,5419584,5568576
train,39,423,324864,178929,25765776,26090640
train,40,393,301824,154449,22240656,22542480
train,41,344,264192,118336,17040384,17304576
train,42,173,132864,29929,4309776,4442640
train,43,305,234240,93025,13395600,13629840
train,44,213,163584,45369,6533136,6696720
train,45,276,211968,76176,10969344,11181312
train,46,355,272640,126025,18147600,18420240
train,47,423,324864,178929,25765776,26090640
train,48,258,198144,66564,9585216,9783360
train,49,255,195840,65025,9363600,9559440
train,50,461,354048,212521,30603024,30957072
train,51,222,170496,49284,7096896,7267392
train,52,308,236544,94864,13660416,13896960
train,53,446,342528,198916,28643904,28986432
train,54,97,74496,9409,1354896,1429392
train,55,187,143616,34969,5035536,5179152
train,56,171,131328,29241,4210704,4342032
train,57,376,288768,141376,20358144,20646912
train,58,446,342528,198916,28643904,28986432
train,59,512,393216,262144,37748736,38141952
train,60,215,165120,46225,6656400,6821520
train,61,226,173568,51076,7354944,7528512
train,62,362,278016,131044,18870336,19148352
train,63,353,271104,124609,17943696,18214800
train,64,353,271104,124609,17943696,18214800
train,65,221,169728,48841,7033104,7202832
train,66,107,82176,11449,1648656,1730832
train,67,87,66816,7569,1089936,1156752
train,68,230,176640,52900,7617600,7794240
train,69,368,282624,135424,19501056,19783680
train,70,255,195840,65025,9363600,9559440
train,71,188,144384,35344,5089536,5233920
train,72,106,81408,11236,1617984,1699392
train,73,274,210432,75076,10810944,11021376
train,74,153,117504,23409,3370896,3488400
train,75,83,63744,6889,992016,1055760
train,76,362,278016,131044,18870336,19148352
train,77,281,215808,78961,11370384,11586192
train,78,397,304896,157609,22695696,23000592
train,79,263,201984,69169,9960336,10162320
train,80,412,316416,169744,24443136,24759552
train,81,298,228864,88804,12787776,13016640
train,82,252,193536,63504,9144576,9338112
train,83,403,309504,162409,23386896,23696400
train,84,412,316416,169744,24443136,24759552
train,85,147,112896,21609,3111696,3224592
train,86,466,357888,217156,31270464,31628352
train,87,235,180480,55225,7952400,8132880
train,88,309,237312,95481,13749264,13986576
train,89,397,304896,157609,22695696,23000592
train,90,366,281088,133956,19289664,19570752
train,91,459,352512,210681,30338064,30690576
train,92,512,393216,262144,37748736,38141952
train,93,209,160512,43681,6290064,6450576
train,94,209,160512,43681,6290064,6450576
train,95,349,268032,121801,17539344,17807376
train,96,402,308736,161604,23270976,23579712
train,97,156,119808,24336,3504384,3624192
train,98,341,261888,116281,16744464,17006352
train,99,186,142848,34596,4981824,5124672
train,100,343,263424,117649,16941456,17204880
train,101,298,228864,88804,12787776,13016640
train,102,260,199680,67600,9734400,9934080
train,103,320,245760,102400,14745600,14991360
train,104,368,282624,135424,19501056,19783680
train,105,450,345600,202500,29160000,29505600
train,106,120,92160,14400,2073600,2165760
train,107,212,162816,44944,6471936,6634752
train,108,236,181248,55696,8020224,8201472
train,109,258,198144,66564,9585216,9783360
train,110,273,209664,74529,10732176,10941840
train,111,189,145152,35721,5143824,5288976
train,112,300,230400,90000,12960000,13190400
train,113,359,275712,128881,18558864,18834576
train,114,191,146688,36481,5253264,5399952
train,115,461,354048,212521,30603024,30957072
train,116,417,320256,173889,25040016,25360272
train,117,363,278784,131769,18974736,19253520
train,118,164,125952,26896,3873024,3998976
train,119,418,321024,174724,25160256,25481280
train,120,512,393216,262144,37748736,38141952
train,121,317,243456,100489,14470416,14713872
train,122,206,158208,42436,6110784,6268992
train,123,338,259584,114244,16451136,16710720
train,124,287,220416,82369,11861136,12081552
train,125,188,144384,35344,5089536,5233920
train,126,119,91392,14161,2039184,2130576
train,127,215,165120,46225,6656400,6821520
train,128,242,185856,58564,8433216,8619072
train,129,420,322560,176400,25401600,25724160
train,130,218,167424,47524,6843456,7010880
train,131,405,311040,164025,23619600,23930640
train,132,195,149760,38025,5475600,5625360
train,133,243,186624,59049,8503056,8689680
train,134,155,119040,24025,3459600,3578640
train,135,132,101376,17424,2509056,2610432
train,136,177,135936,31329,4511376,4647312
train,137,317,243456,100489,14470416,14713872
train,138,512,393216,262144,37748736,38141952
train,139,436,334848,190096,27373824,27708672
train,140,326,250368,106276,15303744,15554112
train,141,204,156672,41616,5992704,6149376
train,142,220,168960,48400,6969600,7138560
train,143,306,235008,93636,13483584,13718592
train,144,411,315648,168921,24324624,24640272
train,145,271,208128,73441,10575504,10783632
train,146,103,79104,10609,1527696,1606800
train,147,163,125184,26569,3825936,3951120
train,148,309,237312,95481,13749264,13986576
train,149,230,176640,52900,7617600,7794240
train,150,326,250368,106276,15303744,15554112
train,151,101,77568,10201,1468944,1546512
train,152,168,129024,28224,4064256,4193280
train,153,373,286464,139129,20034576,20321040
train,154,293,225024,85849,12362256,12587280
train,155,215,165120,46225,6656400,6821520
train,156,326,250368,106276,15303744,15554112
train,157,471,361728,221841,31945104,32306832
train,158,374,287232,139876,20142144,20429376
train,159,284,218112,80656,11614464,11832576
train,160,111,85248,12321,1774224,1859472
train,161,173,132864,29929,4309776,4442640
train,162,186,142848,34596,4981824,5124672
train,163,154,118272,23716,3415104,3533376
train,164,444,340992,197136,28387584,28728576
train,165,351,269568,123201,17740944,18010512
train,166,332,254976,110224,15872256,16127232
train,167,141,108288,19881,2862864,2971152
train,168,123,94464,15129,2178576,2273040
train,169,89,68352,7921,1140624,1208976
train,170,143,109824,20449,2944656,3054480
train,171,487,374016,237169,34152336,34526352
train,172,186,142848,34596,4981824,5124672
train,173,443,340224,196249,28259856,28600080
train,174,342,262656,116964,16842816,17105472
train,175,320,245760,102400,14745600,14991360
train,176,247,189696,61009,8785296,8974992
train,177,360,276480,129600,18662400,18938880
train,178,382,293376,145924,21013056,21306432
train,179,400,307200,160000,23040000,23347200
train,180,357,274176,127449,18352656,18626832
train,181,94,72192,8836,1272384,1344576
train,182,134,102912,17956,2585664,2688576
train,183,357,274176,127449,18352656,18626832
train,184,252,193536,63504,9144576,9338112
train,185,390,299520,152100,21902400,22201920
train,186,268,205824,71824,10342656,10548480
train,187,336,258048,112896,16257024,16515072
train,188,300,230400,90000,12960000,13190400
train,189,324,248832,104976,15116544,15365376
train,190,494,379392,244036,35141184,35520576
train,191,390,299520,152100,21902400,22201920
train,192,273,209664,74529,10732176,10941840
train,193,338,259584,114244,16451136,16710720
train,194,252,193536,63504,9144576,9338112
train,195,268,205824,71824,10342656,10548480
train,196,423,324864,178929,25765776,26090640
train,197,121,92928,14641,2108304,2201232
train,198,231,177408,53361,7683984,7861392
train,199,343,263424,117649,16941456,17204880
train,200,465,357120,216225,31136400,31493520
train,201,320,245760,102400,14745600,14991360
train,202,489,375552,239121,34433424,34808976
train,203,389,298752,151321,21790224,22088976
train,204,226,173568,51076,7354944,7528512
train,205,264,202752,69696,10036224,10238976
train,206,271,208128,73441,10575504,10783632
train,207,512,393216,262144,37748736,38141952
train,208,301,231168,90601,13046544,13277712
train,209,346,265728,119716,17239104,17504832
train,210,376,288768,141376,20358144,20646912
train,211,406,311808,164836,23736384,24048192
train,212,158,121344,24964,3594816,3716160
train,213,401,307968,160801,23155344,23463312
train,214,190,145920,36100,5198400,5344320
train,215,412,316416,169744,24443136,24759552
train,216,269,206592,72361,10419984,10626576
train,217,229,175872,52441,7551504,7727376
train,218,201,154368,40401,5817744,5972112
train,219,92,70656,8464,1218816,1289472
train,220,275,211200,75625,10890000,11101200
train,221,401,307968,160801,23155344,23463312
train,222,302,231936,91204,13133376,13365312
train,223,101,77568,10201,1468944,1546512
train,224,241,185088,58081,8363664,8548752
train,225,352,270336,123904,17842176,18112512
train,226,260,199680,67600,9734400,9934080
train,227,335,257280,112225,16160400,16417680
train,228,312,239616,97344,14017536,14257152
train,229,170,130560,28900,4161600,4292160
train,230,134,102912,17956,2585664,2688576
train,231,512,393216,262144,37748736,38141952
train,232,434,333312,188356,27123264,27456576
train,233,275,211200,75625,10890000,11101200
train,234,176,135168,30976,4460544,4595712
train,235,221,169728,48841,7033104,7202832
train,236,382,293376,145924,21013056,21306432
train,237,249,191232,62001,8928144,9119376
train,238,373,286464,139129,20034576,20321040
train,239,508,390144,258064,37161216,37551360
train,240,287,220416,82369,11861136,12081552
train,241,512,393216,262144,37748736,38141952
train,242,257,197376,66049,9511056,9708432
train,243,266,204288,70756,10188864,10393152
train,244,269,206592,72361,10419984,10626576
train,245,227,174336,51529,7420176,7594512
train,246,298,228864,88804,12787776,13016640
train,247,111,85248,12321,1774224,1859472
train,248,430,330240,184900,26625600,26955840
train,249,162,124416,26244,3779136,3903552
train,250,291,223488,84681,12194064,12417552
train,251,392,301056,153664,22127616,22428672
train,252,142,109056,20164,2903616,3012672
train,253,283,217344,80089,11532816,11750160
train,254,277,212736,76729,11048976,11261712
train,255,219,168192,47961,6906384,7074576
train,256,297,228096,88209,12702096,12930192
train,257,341,261888,116281,16744464,17006352
train,258,254,195072,64516,9290304,9485376
train,259,314,241152,98596,14197824,14438976
train,260,110,84480,12100,1742400,1826880
train,261,300,230400,90000,12960000,13190400
train,262,292,224256,85264,12278016,12502272
train,263,328,251904,107584,15492096,15744000
train,264,216,165888,46656,6718464,6884352
train,265,134,102912,17956,2585664,2688576
train,266,426,327168,181476,26132544,26459712
train,267,230,176640,52900,7617600,7794240
train,268,346,265728,119716,17239104,17504832
train,269,391,300288,152881,22014864,22315152
train,270,403,309504,162409,23386896,23696400
train,271,245,188160,60025,8643600,8831760
train,272,441,338688,194481,28005264,28343952
train,273,315,241920,99225,14288400,14530320
train,274,174,133632,30276,4359744,4493376
train,275,330,253440,108900,15681600,15935040
train,276,183,140544,33489,4822416,4962960
train,277,204,156672,41616,5992704,6149376
train,278,285,218880,81225,11696400,11915280
train,279,512,393216,262144,37748736,38141952
train,280,333,255744,110889,15968016,16223760
train,281,227,174336,51529,7420176,7594512
train,282,260,199680,67600,9734400,9934080
train,283,274,210432,75076,10810944,11021376
train,284,230,176640,52900,7617600,7794240
train,285,392,301056,153664,22127616,22428672
train,286,345,264960,119025,17139600,17404560
train,287,456,350208,207936,29942784,30292992
train,288,341,261888,116281,16744464,17006352
train,289,79,60672,6241,898704,959376
train,290,506,388608,256036,36869184,37257792
train,291,217,166656,47089,6780816,6947472
train,292,336,258048,112896,16257024,16515072
train,293,283,217344,80089,11532816,11750160
train,294,352,270336,123904,17842176,18112512
train,295,420,322560,176400,25401600,25724160
train,296,314,241152,98596,14197824,14438976
train,297,270,207360,72900,10497600,10704960
train,298,194,148992,37636,5419584,5568576
train,299,320,245760,102400,14745600,14991360
train,300,160,122880,25600,3686400,3809280
train,301,138,105984,19044,2742336,2848320
train,302,302,231936,91204,13133376,13365312
train,303,155,119040,24025,3459600,3578640
train,304,236,181248,55696,8020224,8201472
train,305,356,273408,126736,18249984,18523392
train,306,496,380928,246016,35426304,35807232
train,307,370,284160,136900,19713600,19997760
train,308,257,197376,66049,9511056,9708432
train,309,102,78336,10404,1498176,1576512
train,310,242,185856,58564,8433216,8619072
train,311,305,234240,93025,13395600,13629840
train,312,426,327168,181476,26132544,26459712
train,313,366,281088,133956,19289664,19570752
train,314,512,393216,262144,37748736,38141952
train,315,211,162048,44521,6411024,6573072
train,316,292,224256,85264,12278016,12502272
train,317,238,182784,56644,8156736,8339520
train,318,359,275712,128881,18558864,18834576
train,319,222,170496,49284,7096896,7267392
train,320,150,115200,22500,3240000,3355200
train,321,466,357888,217156,31270464,31628352
train,322,406,311808,164836,23736384,24048192
train,323,374,287232,139876,20142144,20429376
train,324,195,149760,38025,5475600,5625360
train,325,396,304128,156816,22581504,22885632
train,326,127,97536,16129,2322576,2420112
train,327,145,111360,21025,3027600,3138960
train,328,372,285696,138384,19927296,20212992
train,329,189,145152,35721,5143824,5288976
train,330,201,154368,40401,5817744,5972112
train,331,167,128256,27889,4016016,4144272
train,332,416,319488,173056,24920064,25239552
train,333,417,320256,173889,25040016,25360272
train,334,215,165120,46225,6656400,6821520
train,335,164,125952,26896,3873024,3998976
train,336,207,158976,42849,6170256,6329232
train,337,79,60672,6241,898704,959376
train,338,335,257280,112225,16160400,16417680
train,339,512,393216,262144,37748736,38141952
train,340,256,196608,65536,9437184,9633792
train,341,446,342528,198916,28643904,28986432
train,342,350,268800,122500,17640000,17908800
train,343,102,78336,10404,1498176,1576512
train,344,270,207360,72900,10497600,10704960
train,345,512,393216,262144,37748736,38141952
train,346,495,380160,245025,35283600,35663760
train,347,360,276480,129600,18662400,18938880
train,348,155,119040,24025,3459600,3578640
train,349,322,247296,103684,14930496,15177792
train,350,341,261888,116281,16744464,17006352
train,351,402,308736,161604,23270976,23579712
train,352,259,198912,67081,9659664,9858576
train,353,249,191232,62001,8928144,9119376
train,354,347,266496,120409,17338896,17605392
train,355,196,150528,38416,5531904,5682432
train,356,512,393216,262144,37748736,38141952
train,357,243,186624,59049,8503056,8689680
train,358,207,158976,42849,6170256,6329232
train,359,310,238080,96100,13838400,14076480
train,360,222,170496,49284,7096896,7267392
train,361,196,150528,38416,5531904,5682432
train,362,192,147456,36864,5308416,5455872
train,363,200,153600,40000,5760000,5913600
train,364,132,101376,17424,2509056,2610432
train,365,407,312576,165649,23853456,24166032
train,366,374,287232,139876,20142144,20429376
train,367,512,393216,262144,37748736,38141952
train,368,231,177408,53361,7683984,7861392
train,369,267,205056,71289,10265616,10470672
train,370,242,185856,58564,8433216,8619072
train,371,323,248064,104329,15023376,15271440
train,372,193,148224,37249,5363856,5512080
train,373,395,303360,156025,22467600,22770960
train,374,297,228096,88209,12702096,12930192
train,375,394,302592,155236,22353984,22656576
train,376,313,240384,97969,14107536,14347920
train,377,512,393216,262144,37748736,38141952
train,378,157,120576,24649,3549456,3670032
train,379,309,237312,95481,13749264,13986576
train,380,207,158976,42849,6170256,6329232
train,381,470,360960,220900,31809600,32170560
train,382,387,297216,149769,21566736,21863952
train,383,160,122880,25600,3686400,3809280
train,384,161,123648,25921,3732624,3856272
train,385,137,105216,18769,2702736,2807952
train,386,120,92160,14400,2073600,2165760
train,387,432,331776,186624,26873856,27205632
train,388,475,364800,225625,32490000,32854800
train,389,151,115968,22801,3283344,3399312
train,390,243,186624,59049,8503056,8689680
train,391,220,168960,48400,6969600,7138560
train,392,201,154368,40401,5817744,5972112
train,393,60,46080,3600,518400,564480
train,394,161,123648,25921,3732624,3856272
train,395,147,112896,21609,3111696,3224592
train,396,225,172800,50625,7290000,7462800
train,397,233,178944,54289,7817616,7996560
train,398,88,67584,7744,1115136,1182720
train,399,459,352512,210681,30338064,30690576
train,400,356,273408,126736,18249984,18523392
train,401,239,183552,57121,8225424,8408976
train,402,176,135168,30976,4460544,4595712
train,403,342,262656,116964,16842816,17105472
train,404,210,161280,44100,6350400,6511680
train,405,312,239616,97344,14017536,14257152
train,406,359,275712,128881,18558864,18834576
train,407,274,210432,75076,10810944,11021376
train,408,381,292608,145161,20903184,21195792
train,409,379,291072,143641,20684304,20975376
train,410,316,242688,99856,14379264,14621952
train,411,364,279552,132496,19079424,19358976
train,412,225,172800,50625,7290000,7462800
train,413,108,82944,11664,1679616,1762560
train,414,320,245760,102400,14745600,14991360
train,415,398,305664,158404,22810176,23115840
train,416,244,187392,59536,8573184,8760576
train,417,112,86016,12544,1806336,1892352
train,418,309,237312,95481,13749264,13986576
train,419,434,333312,188356,27123264,27456576
train,420,135,103680,18225,2624400,2728080
train,421,400,307200,160000,23040000,23347200
train,422,260,199680,67600,9734400,9934080
train,423,239,183552,57121,8225424,8408976
train,424,178,136704,31684,4562496,4699200
train,425,301,231168,90601,13046544,13277712
train,426,512,393216,262144,37748736,38141952
train,427,379,291072,143641,20684304,20975376
train,428,142,109056,20164,2903616,3012672
train,429,282,216576,79524,11451456,11668032
train,430,381,292608,145161,20903184,21195792
train,431,177,135936,31329,4511376,4647312
train,432,79,60672,6241,898704,959376
train,433,365,280320,133225,19184400,19464720
train,434,202,155136,40804,5875776,6030912
train,435,512,393216,262144,37748736,38141952
train,436,97,74496,9409,1354896,1429392
train,437,105,80640,11025,1587600,1668240
train,438,307,235776,94249,13571856,13807632
train,439,256,196608,65536,9437184,9633792
train,440,449,344832,201601,29030544,29375376
train,441,389,298752,151321,21790224,22088976
train,442,239,183552,57121,8225424,8408976
train,443,122,93696,14884,2143296,2236992
train,444,486,373248,236196,34012224,34385472
train,445,288,221184,82944,11943936,12165120
train,446,376,288768,141376,20358144,20646912
train,447,280,215040,78400,11289600,11504640
train,448,168,129024,28224,4064256,4193280
train,449,351,269568,123201,17740944,18010512
train,450,156,119808,24336,3504384,3624192
train,451,405,311040,164025,23619600,23930640
train,452,193,148224,37249,5363856,5512080
train,453,385,295680,148225,21344400,21640080
train,454,301,231168,90601,13046544,13277712
train,455,108,82944,11664,1679616,1762560
train,456,385,295680,148225,21344400,21640080
train,457,236,181248,55696,8020224,8201472
train,458,346,265728,119716,17239104,17504832
train,459,85,65280,7225,1040400,1105680
train,460,299,229632,89401,12873744,13103376
train,461,220,168960,48400,6969600,7138560
train,462,248,190464,61504,8856576,9047040
train,463,363,278784,131769,18974736,19253520
train,464,129,99072,16641,2396304,2495376
train,465,276,211968,76176,10969344,11181312
train,466,317,243456,100489,14470416,14713872
train,467,415,318720,172225,24800400,25119120
train,468,350,268800,122500,17640000,17908800
train,469,403,309504,162409,23386896,23696400
train,470,89,68352,7921,1140624,1208976
train,471,229,175872,52441,7551504,7727376
train,472,292,224256,85264,12278016,12502272
train,473,178,136704,31684,4562496,4699200
train,474,319,244992,101761,14653584,14898576
train,475,426,327168,181476,26132544,26459712
train,476,351,269568,123201,17740944,18010512
train,477,213,163584,45369,6533136,6696720
train,478,222,170496,49284,7096896,7267392
train,479,135,103680,18225,2624400,2728080
train,480,179,137472,32041,4613904,4751376
train,481,327,251136,106929,15397776,15648912
train,482,289,221952,83521,12027024,12248976
train,483,93,71424,8649,1245456,1316880
train,484,243,186624,59049,8503056,8689680
train,485,495,380160,245025,35283600,35663760
train,486,305,234240,93025,13395600,13629840
train,487,378,290304,142884,20575296,20865600
train,488,391,300288,152881,22014864,22315152
train,489,383,294144,146689,21123216,21417360
train,490,156,119808,24336,3504384,3624192
train,491,329,252672,108241,15586704,15839376
train,492,451,346368,203401,29289744,29636112
train,493,289,221952,83521,12027024,12248976
train,494,436,334848,190096,27373824,27708672
train,495,494,379392,244036,35141184,35520576
train,496,396,304128,156816,22581504,22885632
train,497,147,112896,21609,3111696,3224592
train,498,216,165888,46656,6718464,6884352
train,499,408,313344,166464,23970816,24284160
train,500,265,203520,70225,10112400,10315920
train,501,228,175104,51984,7485696,7660800
train,502,227,174336,51529,7420176,7594512
train,503,483,370944,233289,33593616,33964560
train,504,512,393216,262144,37748736,38141952
train,505,352,270336,123904,17842176,18112512
train,506,312,239616,97344,14017536,14257152
train,507,303,232704,91809,13220496,13453200
train,508,414,317952,171396,24681024,24998976
train,509,150,115200,22500,3240000,3355200
train,510,111,85248,12321,1774224,1859472
train,511,166,127488,27556,3968064,4095552
train,512,432,331776,186624,26873856,27205632
train,513,288,221184,82944,11943936,12165120
train,514,114,87552,12996,1871424,1958976
train,515,441,338688,194481,28005264,28343952
train,516,199,152832,39601,5702544,5855376
train,517,250,192000,62500,9000000,9192000
train,518,194,148992,37636,5419584,5568576
train,519,402,308736,161604,23270976,23579712
train,520,69,52992,4761,685584,738576
train,521,311,238848,96721,13927824,14166672
train,522,462,354816,213444,30735936,31090752
train,523,379,291072,143641,20684304,20975376
train,524,144,110592,20736,2985984,3096576
train,525,423,324864,178929,25765776,26090640
train,526,168,129024,28224,4064256,4193280
train,527,337,258816,113569,16353936,16612752
train,528,84,64512,7056,1016064,1080576
train,529,228,175104,51984,7485696,7660800
train,530,231,177408,53361,7683984,7861392
train,531,226,173568,51076,7354944,7528512
train,532,342,262656,116964,16842816,17105472
train,533,313,240384,97969,14107536,14347920
train,534,358,274944,128164,18455616,18730560
train,535,415,318720,172225,24800400,25119120
train,536,405,311040,164025,23619600,23930640
train,537,139,106752,19321,2782224,2888976
train,538,192,147456,36864,5308416,5455872
train,539,289,221952,83521,12027024,12248976
train,540,355,272640,126025,18147600,18420240
train,541,339,260352,114921,16548624,16808976
train,542,341,261888,116281,16744464,17006352
train,543,94,72192,8836,1272384,1344576
train,544,459,352512,210681,30338064,30690576
train,545,397,304896,157609,22695696,23000592
train,546,512,393216,262144,37748736,38141952
train,547,233,178944,54289,7817616,7996560
train,548,188,144384,35344,5089536,5233920
train,549,160,122880,25600,3686400,3809280
train,550,216,165888,46656,6718464,6884352
train,551,308,236544,94864,13660416,13896960
train,552,254,195072,64516,9290304,9485376
train,553,321,246528,103041,14837904,15084432
train,554,95,72960,9025,1299600,1372560
train,555,96,73728,9216,1327104,1400832
train,556,367,281856,134689,19395216,19677072
train,557,367,281856,134689,19395216,19677072
train,558,248,190464,61504,8856576,9047040
train,559,259,198912,67081,9659664,9858576
train,560,512,393216,262144,37748736,38141952
train,561,180,138240,32400,4665600,4803840
train,562,323,248064,104329,15023376,15271440
train,563,330,253440,108900,15681600,15935040
train,564,273,209664,74529,10732176,10941840
train,565,343,263424,117649,16941456,17204880
train,566,340,261120,115600,16646400,16907520
train,567,510,391680,260100,37454400,37846080
train,568,155,119040,24025,3459600,3578640
train,569,198,152064,39204,5645376,5797440
train,570,329,252672,108241,15586704,15839376
train,571,137,105216,18769,2702736,2807952
train,572,200,153600,40000,5760000,5913600
train,573,362,278016,131044,18870336,19148352
train,574,403,309504,162409,23386896,23696400
train,575,345,264960,119025,17139600,17404560
train,576,454,348672,206116,29680704,30029376
train,577,265,203520,70225,10112400,10315920
train,578,512,393216,262144,37748736,38141952
train,579,416,319488,173056,24920064,25239552
train,580,246,188928,60516,8714304,8903232
train,581,345,264960,119025,17139600,17404560
train,582,364,279552,132496,19079424,19358976
train,583,455,349440,207025,29811600,30161040
train,584,185,142080,34225,4928400,5070480
train,585,250,192000,62500,9000000,9192000
train,586,487,374016,237169,34152336,34526352
train,587,115,88320,13225,1904400,1992720
train,588,206,158208,42436,6110784,6268992
train,589,87,66816,7569,1089936,1156752
train,590,325,249600,105625,15210000,15459600
train,591,115,88320,13225,1904400,1992720
train,592,180,138240,32400,4665600,4803840
train,593,281,215808,78961,11370384,11586192
train,594,312,239616,97344,14017536,14257152
train,595,352,270336,123904,17842176,18112512
train,596,171,131328,29241,4210704,4342032
train,597,350,268800,122500,17640000,17908800
train,598,358,274944,128164,18455616,18730560
train,599,321,246528,103041,14837904,15084432
train,600,292,224256,85264,12278016,12502272
train,601,274,210432,75076,10810944,11021376
train,602,196,150528,38416,5531904,5682432
train,603,472,362496,222784,32080896,32443392
train,604,157,120576,24649,3549456,3670032
train,605,383,294144,146689,21123216,21417360
train,606,161,123648,25921,3732624,3856272
train,607,446,342528,198916,28643904,28986432
train,608,233,178944,54289,7817616,7996560
train,609,90,69120,8100,1166400,1235520
train,610,86,66048,7396,1065024,1131072
train,611,389,298752,151321,21790224,22088976
train,612,391,300288,152881,22014864,22315152
train,613,159,122112,25281,3640464,3762576
train,614,319,244992,101761,14653584,14898576
train,615,213,163584,45369,6533136,6696720
train,616,303,232704,91809,13220496,13453200
train,617,204,156672,41616,5992704,6149376
train,618,512,393216,262144,37748736,38141952
train,619,164,125952,26896,3873024,3998976
train,620,398,305664,158404,22810176,23115840
train,621,280,215040,78400,11289600,11504640
train,622,108,82944,11664,1679616,1762560
train,623,160,122880,25600,3686400,3809280
train,624,327,251136,106929,15397776,15648912
train,625,429,329472,184041,26501904,26831376
train,626,282,216576,79524,11451456,11668032
train,627,189,145152,35721,5143824,5288976
train,628,236,181248,55696,8020224,8201472
train,629,411,315648,168921,24324624,24640272
train,630,224,172032,50176,7225344,7397376
train,631,262,201216,68644,9884736,10085952
train,632,289,221952,83521,12027024,12248976
train,633,363,278784,131769,18974736,19253520
train,634,196,150528,38416,5531904,5682432
train,635,251,192768,63001,9072144,9264912
train,636,413,317184,170569,24561936,24879120
train,637,141,108288,19881,2862864,2971152
train,638,370,284160,136900,19713600,19997760
train,639,94,72192,8836,1272384,1344576
train,640,306,235008,93636,13483584,13718592
train,641,445,341760,198025,28515600,28857360
train,642,173,132864,29929,4309776,4442640
train,643,285,218880,81225,11696400,11915280
train,644,220,168960,48400,6969600,7138560
train,645,385,295680,148225,21344400,21640080
train,646,196,150528,38416,5531904,5682432
train,647,175,134400,30625,4410000,4544400
train,648,313,240384,97969,14107536,14347920
train,649,204,156672,41616,5992704,6149376
train,650,187,143616,34969,5035536,5179152
train,651,130,99840,16900,2433600,2533440
train,652,236,181248,55696,8020224,8201472
train,653,245,188160,60025,8643600,8831760
train,654,151,115968,22801,3283344,3399312
train,655,349,268032,121801,17539344,17807376
train,656,184,141312,33856,4875264,5016576
train,657,483,370944,233289,33593616,33964560
train,658,308,236544,94864,13660416,13896960
train,659,267,205056,71289,10265616,10470672
train,660,350,268800,122500,17640000,17908800
train,661,129,99072,16641,2396304,2495376
train,662,283,217344,80089,11532816,11750160
train,663,229,175872,52441,7551504,7727376
train,664,253,194304,64009,9217296,9411600
train,665,201,154368,40401,5817744,5972112
train,666,272,208896,73984,10653696,10862592
train,667,192,147456,36864,5308416,5455872
train,668,285,218880,81225,11696400,11915280
train,669,108,82944,11664,1679616,1762560
train,670,81,62208,6561,944784,1006992
train,671,303,232704,91809,13220496,13453200
train,672,158,121344,24964,3594816,3716160
train,673,335,257280,112225,16160400,16417680
train,674,302,231936,91204,13133376,13365312
train,675,312,239616,97344,14017536,14257152
train,676,189,145152,35721,5143824,5288976
train,677,482,370176,232324,33454656,33824832
train,678,287,220416,82369,11861136,12081552
train,679,360,276480,129600,18662400,18938880
train,680,307,235776,94249,13571856,13807632
train,681,262,201216,68644,9884736,10085952
train,682,148,113664,21904,3154176,3267840
train,683,164,125952,26896,3873024,3998976
train,684,378,290304,142884,20575296,20865600
train,685,152,116736,23104,3326976,3443712
train,686,333,255744,110889,15968016,16223760
train,687,466,357888,217156,31270464,31628352
train,688,324,248832,104976,15116544,15365376
train,689,344,264192,118336,17040384,17304576
train,690,322,247296,103684,14930496,15177792
train,691,280,215040,78400,11289600,11504640
train,692,334,256512,111556,16064064,16320576
train,693,342,262656,116964,16842816,17105472
train,694,80,61440,6400,921600,983040
train,695,283,217344,80089,11532816,11750160
train,696,154,118272,23716,3415104,3533376
train,697,285,218880,81225,11696400,11915280
train,698,269,206592,72361,10419984,10626576
train,699,500,384000,250000,36000000,36384000
train,700,419,321792,175561,25280784,25602576
train,701,348,267264,121104,17438976,17706240
train,702,128,98304,16384,2359296,2457600
train,703,165,126720,27225,3920400,4047120
train,704,275,211200,75625,10890000,11101200
train,705,256,196608,65536,9437184,9633792
train,706,169,129792,28561,4112784,4242576
train,707,409,314112,167281,24088464,24402576
train,708,166,127488,27556,3968064,4095552
train,709,337,258816,113569,16353936,16612752
train,710,381,292608,145161,20903184,21195792
train,711,265,203520,70225,10112400,10315920
train,712,206,158208,42436,6110784,6268992
train,713,211,162048,44521,6411024,6573072
train,714,399,306432,159201,22924944,23231376
train,715,235,180480,55225,7952400,8132880
train,716,157,120576,24649,3549456,3670032
train,717,290,222720,84100,12110400,12333120
train,718,322,247296,103684,14930496,15177792
train,719,436,334848,190096,27373824,27708672
train,720,220,168960,48400,6969600,7138560
train,721,335,257280,112225,16160400,16417680
train,722,216,165888,46656,6718464,6884352
train,723,142,109056,20164,2903616,3012672
train,724,397,304896,157609,22695696,23000592
train,725,205,157440,42025,6051600,6209040
train,726,244,187392,59536,8573184,8760576
train,727,282,216576,79524,11451456,11668032
train,728,253,194304,64009,9217296,9411600
train,729,243,186624,59049,8503056,8689680
train,730,186,142848,34596,4981824,5124672
train,731,191,146688,36481,5253264,5399952
train,732,283,217344,80089,11532816,11750160
train,733,358,274944,128164,18455616,18730560
train,734,380,291840,144400,20793600,21085440
train,735,456,350208,207936,29942784,30292992
train,736,381,292608,145161,20903184,21195792
train,737,119,91392,14161,2039184,2130576
train,738,306,235008,93636,13483584,13718592
train,739,203,155904,41209,5934096,6090000
train,740,277,212736,76729,11048976,11261712
train,741,179,137472,32041,4613904,4751376
train,742,502,385536,252004,36288576,36674112
train,743,302,231936,91204,13133376,13365312
train,744,148,113664,21904,3154176,3267840
train,745,194,148992,37636,5419584,5568576
train,746,313,240384,97969,14107536,14347920
train,747,159,122112,25281,3640464,3762576
train,748,189,145152,35721,5143824,5288976
train,749,344,264192,118336,17040384,17304576
train,750,297,228096,88209,12702096,12930192
train,751,300,230400,90000,12960000,13190400
train,752,135,103680,18225,2624400,2728080
train,753,251,192768,63001,9072144,9264912
train,754,222,170496,49284,7096896,7267392
train,755,211,162048,44521,6411024,6573072
train,756,248,190464,61504,8856576,9047040
train,757,304,233472,92416,13307904,13541376
train,758,327,251136,106929,15397776,15648912
train,759,292,224256,85264,12278016,12502272
train,760,282,216576,79524,11451456,11668032
train,761,451,346368,203401,29289744,29636112
train,762,103,79104,10609,1527696,1606800
train,763,153,117504,23409,3370896,3488400
train,764,80,61440,6400,921600,983040
train,765,262,201216,68644,9884736,10085952
train,766,315,241920,99225,14288400,14530320
train,767,453,347904,205209,29550096,29898000
train,768,412,316416,169744,24443136,24759552
train,769,146,112128,21316,3069504,3181632
train,770,148,113664,21904,3154176,3267840
train,771,249,191232,62001,8928144,9119376
train,772,325,249600,105625,15210000,15459600
train,773,346,265728,119716,17239104,17504832
train,774,276,211968,76176,10969344,11181312
train,775,431,331008,185761,26749584,27080592
train,776,234,179712,54756,7884864,8064576
train,777,234,179712,54756,7884864,8064576
train,778,165,126720,27225,3920400,4047120
train,779,173,132864,29929,4309776,4442640
train,780,303,232704,91809,13220496,13453200
train,781,165,126720,27225,3920400,4047120
train,782,241,185088,58081,8363664,8548752
train,783,264,202752,69696,10036224,10238976
train,784,237,182016,56169,8088336,8270352
train,785,107,82176,11449,1648656,1730832
train,786,223,171264,49729,7160976,7332240
train,787,445,341760,198025,28515600,28857360
train,788,80,61440,6400,921600,983040
train,789,337,258816,113569,16353936,16612752
train,790,407,312576,165649,23853456,24166032
train,791,306,235008,93636,13483584,13718592
train,792,110,84480,12100,1742400,1826880
train,793,440,337920,193600,27878400,28216320
train,794,347,266496,120409,17338896,17605392
train,795,136,104448,18496,2663424,2767872
train,796,289,221952,83521,12027024,12248976
train,797,187,143616,34969,5035536,5179152
train,798,161,123648,25921,3732624,3856272
train,799,322,247296,103684,14930496,15177792
train,800,226,173568,51076,7354944,7528512
train,801,320,245760,102400,14745600,14991360
train,802,183,140544,33489,4822416,4962960
train,803,287,220416,82369,11861136,12081552
train,804,398,305664,158404,22810176,23115840
train,805,363,278784,131769,18974736,19253520
train,806,384,294912,147456,21233664,21528576
train,807,459,352512,210681,30338064,30690576
train,808,329,252672,108241,15586704,15839376
train,809,84,64512,7056,1016064,1080576
train,810,273,209664,74529,10732176,10941840
train,811,395,303360,156025,22467600,22770960
train,812,136,104448,18496,2663424,2767872
train,813,76,58368,5776,831744,890112
train,814,377,289536,142129,20466576,20756112
train,815,395,303360,156025,22467600,22770960
train,816,437,335616,190969,27499536,27835152
train,817,393,301824,154449,22240656,22542480
train,818,88,67584,7744,1115136,1182720
train,819,499,383232,249001,35856144,36239376
train,820,456,350208,207936,29942784,30292992
train,821,311,238848,96721,13927824,14166672
train,822,257,197376,66049,9511056,9708432
train,823,304,233472,92416,13307904,13541376
train,824,325,249600,105625,15210000,15459600
train,825,363,278784,131769,18974736,19253520
train,826,190,145920,36100,5198400,5344320
train,827,471,361728,221841,31945104,32306832
train,828,366,281088,133956,19289664,19570752
train,829,192,147456,36864,5308416,5455872
train,830,393,301824,154449,22240656,22542480
train,831,141,108288,19881,2862864,2971152
train,832,302,231936,91204,13133376,13365312
train,833,339,260352,114921,16548624,16808976
train,834,279,214272,77841,11209104,11423376
train,835,389,298752,151321,21790224,22088976
train,836,315,241920,99225,14288400,14530320
train,837,233,178944,54289,7817616,7996560
train,838,157,120576,24649,3549456,3670032
train,839,453,347904,205209,29550096,29898000
train,840,106,81408,11236,1617984,1699392
train,841,255,195840,65025,9363600,9559440
train,842,196,150528,38416,5531904,5682432
train,843,172,132096,29584,4260096,4392192
train,844,143,109824,20449,2944656,3054480
train,845,217,166656,47089,6780816,6947472
train,846,396,304128,156816,22581504,22885632
train,847,275,211200,75625,10890000,11101200
train,848,418,321024,174724,25160256,25481280
train,849,375,288000,140625,20250000,20538000
train,850,286,219648,81796,11778624,11998272
train,851,257,197376,66049,9511056,9708432
train,852,155,119040,24025,3459600,3578640
train,853,288,221184,82944,11943936,12165120
train,854,311,238848,96721,13927824,14166672
train,855,206,158208,42436,6110784,6268992
train,856,360,276480,129600,18662400,18938880
train,857,115,88320,13225,1904400,1992720
train,858,191,146688,36481,5253264,5399952
train,859,512,393216,262144,37748736,38141952
train,860,424,325632,179776,25887744,26213376
train,861,207,158976,42849,6170256,6329232
train,862,285,218880,81225,11696400,11915280
train,863,512,393216,262144,37748736,38141952
train,864,340,261120,115600,16646400,16907520
train,865,286,219648,81796,11778624,11998272
train,866,102,78336,10404,1498176,1576512
train,867,186,142848,34596,4981824,5124672
train,868,146,112128,21316,3069504,3181632
train,869,413,317184,170569,24561936,24879120
train,870,220,168960,48400,6969600,7138560
train,871,197,151296,38809,5588496,5739792
train,872,241,185088,58081,8363664,8548752
train,873,200,153600,40000,5760000,5913600
train,874,354,271872,125316,18045504,18317376
train,875,142,109056,20164,2903616,3012672
train,876,476,365568,226576,32626944,32992512
train,877,390,299520,152100,21902400,22201920
train,878,319,244992,101761,14653584,14898576
train,879,266,204288,70756,10188864,10393152
train,880,277,212736,76729,11048976,11261712
train,881,135,103680,18225,2624400,2728080
train,882,208,159744,43264,6230016,6389760
train,883,302,231936,91204,13133376,13365312
train,884,265,203520,70225,10112400,10315920
train,885,183,140544,33489,4822416,4962960
train,886,410,314880,168100,24206400,24521280
train,887,206,158208,42436,6110784,6268992
train,888,188,144384,35344,5089536,5233920
train,889,293,225024,85849,12362256,12587280
train,890,462,354816,213444,30735936,31090752
train,891,121,92928,14641,2108304,2201232
train,892,341,261888,116281,16744464,17006352
train,893,292,224256,85264,12278016,12502272
train,894,385,295680,148225,21344400,21640080
train,895,389,298752,151321,21790224,22088976
train,896,117,89856,13689,1971216,2061072
train,897,351,269568,123201,17740944,18010512
train,898,348,267264,121104,17438976,17706240
train,899,201,154368,40401,5817744,5972112
train,900,439,337152,192721,27751824,28088976
train,901,194,148992,37636,5419584,5568576
train,902,217,166656,47089,6780816,6947472
train,903,198,152064,39204,5645376,5797440
train,904,74,56832,5476,788544,845376
train,905,171,131328,29241,4210704,4342032
train,906,384,294912,147456,21233664,21528576
train,907,320,245760,102400,14745600,14991360
train,908,399,306432,159201,22924944,23231376
train,909,272,208896,73984,10653696,10862592
train,910,387,297216,149769,21566736,21863952
train,911,233,178944,54289,7817616,7996560
train,912,100,76800,10000,1440000,1516800
train,913,250,192000,62500,9000000,9192000
train,914,291,223488,84681,12194064,12417552
train,915,226,173568,51076,7354944,7528512
train,916,303,232704,91809,13220496,13453200
train,917,238,182784,56644,8156736,8339520
train,918,158,121344,24964,3594816,3716160
train,919,374,287232,139876,20142144,20429376
train,920,401,307968,160801,23155344,23463312
train,921,237,182016,56169,8088336,8270352
train,922,225,172800,50625,7290000,7462800
train,923,238,182784,56644,8156736,8339520
train,924,420,322560,176400,25401600,25724160
train,925,395,303360,156025,22467600,22770960
train,926,224,172032,50176,7225344,7397376
train,927,183,140544,33489,4822416,4962960
train,928,121,92928,14641,2108304,2201232
train,929,233,178944,54289,7817616,7996560
train,930,75,57600,5625,810000,867600
train,931,283,217344,80089,11532816,11750160
train,932,397,304896,157609,22695696,23000592
train,933,298,228864,88804,12787776,13016640
train,934,217,166656,47089,6780816,6947472
train,935,116,89088,13456,1937664,2026752
train,936,331,254208,109561,15776784,16030992
train,937,251,192768,63001,9072144,9264912
train,938,265,203520,70225,10112400,10315920
train,939,315,241920,99225,14288400,14530320
train,940,264,202752,69696,10036224,10238976
train,941,405,311040,164025,23619600,23930640
train,942,310,238080,96100,13838400,14076480
train,943,286,219648,81796,11778624,11998272
train,944,162,124416,26244,3779136,3903552
train,945,218,167424,47524,6843456,7010880
train,946,245,188160,60025,8643600,8831760
train,947,229,175872,52441,7551504,7727376
train,948,227,174336,51529,7420176,7594512
train,949,168,129024,28224,4064256,4193280
train,950,512,393216,262144,37748736,38141952
train,951,327,251136,106929,15397776,15648912
train,952,353,271104,124609,17943696,18214800
train,953,262,201216,68644,9884736,10085952
train,954,340,261120,115600,16646400,16907520
train,955,246,188928,60516,8714304,8903232
train,956,108,82944,11664,1679616,1762560
train,957,256,196608,65536,9437184,9633792
train,958,361,277248,130321,18766224,19043472
train,959,91,69888,8281,1192464,1262352
train,960,219,168192,47961,6906384,7074576
train,961,165,126720,27225,3920400,4047120
train,962,243,186624,59049,8503056,8689680
train,963,276,211968,76176,10969344,11181312
train,964,169,129792,28561,4112784,4242576
train,965,185,142080,34225,4928400,5070480
train,966,480,368640,230400,33177600,33546240
train,967,263,201984,69169,9960336,10162320
train,968,429,329472,184041,26501904,26831376
train,969,204,156672,41616,5992704,6149376
train,970,449,344832,201601,29030544,29375376
train,971,453,347904,205209,29550096,29898000
train,972,165,126720,27225,3920400,4047120
train,973,495,380160,245025,35283600,35663760
train,974,213,163584,45369,6533136,6696720
train,975,380,291840,144400,20793600,21085440
train,976,206,158208,42436,6110784,6268992
train,977,276,211968,76176,10969344,11181312
train,978,247,189696,61009,8785296,8974992
train,979,364,279552,132496,19079424,19358976
train,980,512,393216,262144,37748736,38141952
train,981,265,203520,70225,10112400,10315920
train,982,94,72192,8836,1272384,1344576
train,983,166,127488,27556,3968064,4095552
train,984,299,229632,89401,12873744,13103376
train,985,434,333312,188356,27123264,27456576
train,986,157,120576,24649,3549456,3670032
train,987,301,231168,90601,13046544,13277712
train,988,414,317952,171396,24681024,24998976
train,989,239,183552,57121,8225424,8408976
train,990,169,129792,28561,4112784,4242576
train,991,248,190464,61504,8856576,9047040
train,992,209,160512,43681,6290064,6450576
train,993,101,77568,10201,1468944,1546512
train,994,264,202752,69696,10036224,10238976
train,995,275,211200,75625,10890000,11101200
train,996,315,241920,99225,14288400,14530320
train,997,186,142848,34596,4981824,5124672
train,998,406,311808,164836,23736384,24048192
train,999,223,171264,49729,7160976,7332240
train,1000,118,90624,13924,2005056,2095680
train,1001,136,104448,18496,2663424,2767872
train,1002,243,186624,59049,8503056,8689680
train,1003,285,218880,81225,11696400,11915280
train,1004,187,143616,34969,5035536,5179152
train,1005,345,264960,119025,17139600,17404560
train,1006,181,139008,32761,4717584,4856592
train,1007,373,286464,139129,20034576,20321040
train,1008,363,278784,131769,18974736,19253520
train,1009,213,163584,45369,6533136,6696720
train,1010,270,207360,72900,10497600,10704960
train,1011,173,132864,29929,4309776,4442640
train,1012,254,195072,64516,9290304,9485376
train,1013,189,145152,35721,5143824,5288976
train,1014,329,252672,108241,15586704,15839376
train,1015,193,148224,37249,5363856,5512080
train,1016,182,139776,33124,4769856,4909632
train,1017,194,148992,37636,5419584,5568576
train,1018,410,314880,168100,24206400,24521280
train,1019,295,226560,87025,12531600,12758160
train,1020,431,331008,185761,26749584,27080592
train,1021,397,304896,157609,22695696,23000592
train,1022,241,185088,58081,8363664,8548752
train,1023,512,393216,262144,37748736,38141952
train,1024,228,175104,51984,7485696,7660800
train,1025,209,160512,43681,6290064,6450576
train,1026,360,276480,129600,18662400,18938880
train,1027,296,227328,87616,12616704,12844032
train,1028,163,125184,26569,3825936,3951120
train,1029,182,139776,33124,4769856,4909632
train,1030,106,81408,11236,1617984,1699392
train,1031,205,157440,42025,6051600,6209040
train,1032,435,334080,189225,27248400,27582480
train,1033,289,221952,83521,12027024,12248976
train,1034,354,271872,125316,18045504,18317376
train,1035,299,229632,89401,12873744,13103376
train,1036,216,165888,46656,6718464,6884352
train,1037,349,268032,121801,17539344,17807376
train,1038,229,175872,52441,7551504,7727376
train,1039,286,219648,81796,11778624,11998272
train,1040,335,257280,112225,16160400,16417680
train,1041,190,145920,36100,5198400,5344320
train,1042,120,92160,14400,2073600,2165760
train,1043,204,156672,41616,5992704,6149376
train,1044,211,162048,44521,6411024,6573072
train,1045,118,90624,13924,2005056,2095680
train,1046,225,172800,50625,7290000,7462800
train,1047,168,129024,28224,4064256,4193280
train,1048,190,145920,36100,5198400,5344320
train,1049,329,252672,108241,15586704,15839376
train,1050,254,195072,64516,9290304,9485376
train,1051,417,320256,173889,25040016,25360272
train,1052,203,155904,41209,5934096,6090000
train,1053,252,193536,63504,9144576,9338112
train,1054,298,228864,88804,12787776,13016640
train,1055,213,163584,45369,6533136,6696720
train,1056,150,115200,22500,3240000,3355200
train,1057,213,163584,45369,6533136,6696720
train,1058,134,102912,17956,2585664,2688576
train,1059,187,143616,34969,5035536,5179152
train,1060,124,95232,15376,2214144,2309376
train,1061,304,233472,92416,13307904,13541376
train,1062,236,181248,55696,8020224,8201472
train,1063,330,253440,108900,15681600,15935040
train,1064,294,225792,86436,12446784,12672576
train,1065,119,91392,14161,2039184,2130576
train,1066,253,194304,64009,9217296,9411600
train,1067,219,168192,47961,6906384,7074576
train,1068,267,205056,71289,10265616,10470672
train,1069,249,191232,62001,8928144,9119376
train,1070,390,299520,152100,21902400,22201920
train,1071,319,244992,101761,14653584,14898576
train,1072,235,180480,55225,7952400,8132880
train,1073,197,151296,38809,5588496,5739792
train,1074,133,102144,17689,2547216,2649360
train,1075,243,186624,59049,8503056,8689680
train,1076,348,267264,121104,17438976,17706240
train,1077,324,248832,104976,15116544,15365376
train,1078,178,136704,31684,4562496,4699200
train,1079,333,255744,110889,15968016,16223760
train,1080,311,238848,96721,13927824,14166672
train,1081,247,189696,61009,8785296,8974992
train,1082,175,134400,30625,4410000,4544400
train,1083,139,106752,19321,2782224,2888976
train,1084,195,149760,38025,5475600,5625360
train,1085,158,121344,24964,3594816,3716160
train,1086,169,129792,28561,4112784,4242576
train,1087,96,73728,9216,1327104,1400832
train,1088,104,79872,10816,1557504,1637376
train,1089,330,253440,108900,15681600,15935040
train,1090,412,316416,169744,24443136,24759552
train,1091,287,220416,82369,11861136,12081552
train,1092,206,158208,42436,6110784,6268992
train,1093,512,393216,262144,37748736,38141952
train,1094,211,162048,44521,6411024,6573072
train,1095,140,107520,19600,2822400,2929920
train,1096,268,205824,71824,10342656,10548480
train,1097,431,331008,185761,26749584,27080592
train,1098,436,334848,190096,27373824,27708672
train,1099,336,258048,112896,16257024,16515072
train,1100,326,250368,106276,15303744,15554112
train,1101,189,145152,35721,5143824,5288976
train,1102,259,198912,67081,9659664,9858576
train,1103,486,373248,236196,34012224,34385472
train,1104,139,106752,19321,2782224,2888976
train,1105,79,60672,6241,898704,959376
train,1106,314,241152,98596,14197824,14438976
train,1107,336,258048,112896,16257024,16515072
train,1108,84,64512,7056,1016064,1080576
train,1109,512,393216,262144,37748736,38141952
train,1110,278,213504,77284,11128896,11342400
train,1111,158,121344,24964,3594816,3716160
train,1112,299,229632,89401,12873744,13103376
train,1113,248,190464,61504,8856576,9047040
train,1114,298,228864,88804,12787776,13016640
train,1115,308,236544,94864,13660416,13896960
train,1116,104,79872,10816,1557504,1637376
train,1117,429,329472,184041,26501904,26831376
train,1118,202,155136,40804,5875776,6030912
train,1119,217,166656,47089,6780816,6947472
train,1120,292,224256,85264,12278016,12502272
train,1121,132,101376,17424,2509056,2610432
train,1122,265,203520,70225,10112400,10315920
train,1123,138,105984,19044,2742336,2848320
train,1124,76,58368,5776,831744,890112
train,1125,288,221184,82944,11943936,12165120
train,1126,495,380160,245025,35283600,35663760
train,1127,499,383232,249001,35856144,36239376
train,1128,104,79872,10816,1557504,1637376
train,1129,112,86016,12544,1806336,1892352
train,1130,289,221952,83521,12027024,12248976
train,1131,283,217344,80089,11532816,11750160
train,1132,248,190464,61504,8856576,9047040
train,1133,512,393216,262144,37748736,38141952
train,1134,121,92928,14641,2108304,2201232
train,1135,120,92160,14400,2073600,2165760
train,1136,315,241920,99225,14288400,14530320
train,1137,366,281088,133956,19289664,19570752
train,1138,400,307200,160000,23040000,23347200
train,1139,102,78336,10404,1498176,1576512
train,1140,399,306432,159201,22924944,23231376
train,1141,134,102912,17956,2585664,2688576
train,1142,163,125184,26569,3825936,3951120
train,1143,322,247296,103684,14930496,15177792
train,1144,276,211968,76176,10969344,11181312
train,1145,446,342528,198916,28643904,28986432
train,1146,185,142080,34225,4928400,5070480
train,1147,273,209664,74529,10732176,10941840
train,1148,215,165120,46225,6656400,6821520
train,1149,347,266496,120409,17338896,17605392
train,1150,441,338688,194481,28005264,28343952
train,1151,356,273408,126736,18249984,18523392
train,1152,299,229632,89401,12873744,13103376
train,1153,256,196608,65536,9437184,9633792
train,1154,235,180480,55225,7952400,8132880
train,1155,498,382464,248004,35712576,36095040
train,1156,245,188160,60025,8643600,8831760
train,1157,322,247296,103684,14930496,15177792
train,1158,298,228864,88804,12787776,13016640
train,1159,164,125952,26896,3873024,3998976
train,1160,108,82944,11664,1679616,1762560
train,1161,378,290304,142884,20575296,20865600
train,1162,328,251904,107584,15492096,15744000
train,1163,385,295680,148225,21344400,21640080
train,1164,512,393216,262144,37748736,38141952
train,1165,191,146688,36481,5253264,5399952
train,1166,273,209664,74529,10732176,10941840
train,1167,184,141312,33856,4875264,5016576
train,1168,90,69120,8100,1166400,1235520
train,1169,176,135168,30976,4460544,4595712
train,1170,315,241920,99225,14288400,14530320
train,1171,218,167424,47524,6843456,7010880
train,1172,157,120576,24649,3549456,3670032
train,1173,512,393216,262144,37748736,38141952
train,1174,156,119808,24336,3504384,3624192
train,1175,368,282624,135424,19501056,19783680
train,1176,303,232704,91809,13220496,13453200
train,1177,309,237312,95481,13749264,13986576
train,1178,181,139008,32761,4717584,4856592
train,1179,489,375552,239121,34433424,34808976
train,1180,89,68352,7921,1140624,1208976
train,1181,57,43776,3249,467856,511632
train,1182,143,109824,20449,2944656,3054480
train,1183,512,393216,262144,37748736,38141952
train,1184,201,154368,40401,5817744,5972112
train,1185,266,204288,70756,10188864,10393152
train,1186,512,393216,262144,37748736,38141952
train,1187,455,349440,207025,29811600,30161040
train,1188,512,393216,262144,37748736,38141952
train,1189,182,139776,33124,4769856,4909632
train,1190,392,301056,153664,22127616,22428672
train,1191,322,247296,103684,14930496,15177792
train,1192,168,129024,28224,4064256,4193280
train,1193,351,269568,123201,17740944,18010512
train,1194,269,206592,72361,10419984,10626576
train,1195,238,182784,56644,8156736,8339520
train,1196,206,158208,42436,6110784,6268992
train,1197,249,191232,62001,8928144,9119376
train,1198,268,205824,71824,10342656,10548480
train,1199,340,261120,115600,16646400,16907520
train,1200,183,140544,33489,4822416,4962960
train,1201,356,273408,126736,18249984,18523392
train,1202,252,193536,63504,9144576,9338112
train,1203,424,325632,179776,25887744,26213376
train,1204,273,209664,74529,10732176,10941840
train,1205,69,52992,4761,685584,738576
train,1206,180,138240,32400,4665600,4803840
train,1207,168,129024,28224,4064256,4193280
train,1208,263,201984,69169,9960336,10162320
train,1209,366,281088,133956,19289664,19570752
train,1210,251,192768,63001,9072144,9264912
train,1211,175,134400,30625,4410000,4544400
train,1212,264,202752,69696,10036224,10238976
train,1213,512,393216,262144,37748736,38141952
train,1214,365,280320,133225,19184400,19464720
train,1215,209,160512,43681,6290064,6450576
train,1216,210,161280,44100,6350400,6511680
train,1217,362,278016,131044,18870336,19148352
train,1218,417,320256,173889,25040016,25360272
train,1219,243,186624,59049,8503056,8689680
train,1220,260,199680,67600,9734400,9934080
train,1221,512,393216,262144,37748736,38141952
train,1222,199,152832,39601,5702544,5855376
train,1223,219,168192,47961,6906384,7074576
train,1224,329,252672,108241,15586704,15839376
train,1225,83,63744,6889,992016,1055760
train,1226,398,305664,158404,22810176,23115840
train,1227,315,241920,99225,14288400,14530320
train,1228,512,393216,262144,37748736,38141952
train,1229,113,86784,12769,1838736,1925520
train,1230,292,224256,85264,12278016,12502272
train,1231,123,94464,15129,2178576,2273040
train,1232,311,238848,96721,13927824,14166672
train,1233,350,268800,122500,17640000,17908800
train,1234,277,212736,76729,11048976,11261712
train,1235,337,258816,113569,16353936,16612752
train,1236,97,74496,9409,1354896,1429392
train,1237,369,283392,136161,19607184,19890576
train,1238,214,164352,45796,6594624,6758976
train,1239,183,140544,33489,4822416,4962960
train,1240,324,248832,104976,15116544,15365376
train,1241,242,185856,58564,8433216,8619072
train,1242,201,154368,40401,5817744,5972112
train,1243,143,109824,20449,2944656,3054480
train,1244,163,125184,26569,3825936,3951120
train,1245,394,302592,155236,22353984,22656576
train,1246,187,143616,34969,5035536,5179152
train,1247,369,283392,136161,19607184,19890576
train,1248,64,49152,4096,589824,638976
train,1249,252,193536,63504,9144576,9338112
train,1250,275,211200,75625,10890000,11101200
train,1251,86,66048,7396,1065024,1131072
train,1252,512,393216,262144,37748736,38141952
train,1253,368,282624,135424,19501056,19783680
train,1254,137,105216,18769,2702736,2807952
train,1255,369,283392,136161,19607184,19890576
train,1256,49,37632,2401,345744,383376
train,1257,183,140544,33489,4822416,4962960
train,1258,157,120576,24649,3549456,3670032
train,1259,354,271872,125316,18045504,18317376
train,1260,351,269568,123201,17740944,18010512
train,1261,326,250368,106276,15303744,15554112
train,1262,362,278016,131044,18870336,19148352
train,1263,297,228096,88209,12702096,12930192
train,1264,249,191232,62001,8928144,9119376
train,1265,275,211200,75625,10890000,11101200
train,1266,239,183552,57121,8225424,8408976
train,1267,241,185088,58081,8363664,8548752
train,1268,319,244992,101761,14653584,14898576
train,1269,293,225024,85849,12362256,12587280
train,1270,138,105984,19044,2742336,2848320
train,1271,179,137472,32041,4613904,4751376
train,1272,163,125184,26569,3825936,3951120
train,1273,275,211200,75625,10890000,11101200
train,1274,162,124416,26244,3779136,3903552
train,1275,284,218112,80656,11614464,11832576
train,1276,143,109824,20449,2944656,3054480
train,1277,261,200448,68121,9809424,10009872
train,1278,346,265728,119716,17239104,17504832
train,1279,239,183552,57121,8225424,8408976
train,1280,411,315648,168921,24324624,24640272
train,1281,330,253440,108900,15681600,15935040
train,1282,218,167424,47524,6843456,7010880
train,1283,221,169728,48841,7033104,7202832
train,1284,201,154368,40401,5817744,5972112
train,1285,200,153600,40000,5760000,5913600
train,1286,396,304128,156816,22581504,22885632
train,1287,300,230400,90000,12960000,13190400
train,1288,106,81408,11236,1617984,1699392
train,1289,224,172032,50176,7225344,7397376
train,1290,512,393216,262144,37748736,38141952
train,1291,358,274944,128164,18455616,18730560
train,1292,87,66816,7569,1089936,1156752
train,1293,219,168192,47961,6906384,7074576
train,1294,210,161280,44100,6350400,6511680
train,1295,228,175104,51984,7485696,7660800
train,1296,160,122880,25600,3686400,3809280
train,1297,292,224256,85264,12278016,12502272
train,1298,169,129792,28561,4112784,4242576
train,1299,246,188928,60516,8714304,8903232
train,1300,325,249600,105625,15210000,15459600
train,1301,185,142080,34225,4928400,5070480
train,1302,333,255744,110889,15968016,16223760
train,1303,255,195840,65025,9363600,9559440
train,1304,157,120576,24649,3549456,3670032
train,1305,403,309504,162409,23386896,23696400
train,1306,299,229632,89401,12873744,13103376
train,1307,160,122880,25600,3686400,3809280
train,1308,144,110592,20736,2985984,3096576
train,1309,183,140544,33489,4822416,4962960
train,1310,195,149760,38025,5475600,5625360
train,1311,470,360960,220900,31809600,32170560
train,1312,512,393216,262144,37748736,38141952
train,1313,229,175872,52441,7551504,7727376
train,1314,320,245760,102400,14745600,14991360
train,1315,439,337152,192721,27751824,28088976
train,1316,168,129024,28224,4064256,4193280
train,1317,512,393216,262144,37748736,38141952
train,1318,428,328704,183184,26378496,26707200
train,1319,512,393216,262144,37748736,38141952
train,1320,170,130560,28900,4161600,4292160
train,1321,382,293376,145924,21013056,21306432
train,1322,221,169728,48841,7033104,7202832
train,1323,201,154368,40401,5817744,5972112
train,1324,376,288768,141376,20358144,20646912
train,1325,154,118272,23716,3415104,3533376
train,1326,413,317184,170569,24561936,24879120
train,1327,278,213504,77284,11128896,11342400
train,1328,512,393216,262144,37748736,38141952
train,1329,341,261888,116281,16744464,17006352
train,1330,285,218880,81225,11696400,11915280
train,1331,101,77568,10201,1468944,1546512
train,1332,291,223488,84681,12194064,12417552
train,1333,444,340992,197136,28387584,28728576
train,1334,250,192000,62500,9000000,9192000
train,1335,252,193536,63504,9144576,9338112
train,1336,310,238080,96100,13838400,14076480
train,1337,381,292608,145161,20903184,21195792
train,1338,166,127488,27556,3968064,4095552
train,1339,382,293376,145924,21013056,21306432
train,1340,468,359424,219024,31539456,31898880
train,1341,347,266496,120409,17338896,17605392
train,1342,204,156672,41616,5992704,6149376
train,1343,49,37632,2401,345744,383376
train,1344,359,275712,128881,18558864,18834576
train,1345,248,190464,61504,8856576,9047040
train,1346,109,83712,11881,1710864,1794576
train,1347,287,220416,82369,11861136,12081552
train,1348,260,199680,67600,9734400,9934080
train,1349,120,92160,14400,2073600,2165760
train,1350,346,265728,119716,17239104,17504832
train,1351,210,161280,44100,6350400,6511680
train,1352,413,317184,170569,24561936,24879120
train,1353,63,48384,3969,571536,619920
train,1354,273,209664,74529,10732176,10941840
train,1355,174,133632,30276,4359744,4493376
train,1356,412,316416,169744,24443136,24759552
train,1357,405,311040,164025,23619600,23930640
train,1358,132,101376,17424,2509056,2610432
train,1359,107,82176,11449,1648656,1730832
train,1360,378,290304,142884,20575296,20865600
train,1361,288,221184,82944,11943936,12165120
train,1362,125,96000,15625,2250000,2346000
train,1363,95,72960,9025,1299600,1372560
train,1364,512,393216,262144,37748736,38141952
train,1365,255,195840,65025,9363600,9559440
train,1366,259,198912,67081,9659664,9858576
train,1367,221,169728,48841,7033104,7202832
train,1368,275,211200,75625,10890000,11101200
train,1369,76,58368,5776,831744,890112
train,1370,228,175104,51984,7485696,7660800
train,1371,223,171264,49729,7160976,7332240
train,1372,440,337920,193600,27878400,28216320
train,1373,512,393216,262144,37748736,38141952
train,1374,195,149760,38025,5475600,5625360
train,1375,233,178944,54289,7817616,7996560
train,1376,383,294144,146689,21123216,21417360
train,1377,366,281088,133956,19289664,19570752
train,1378,340,261120,115600,16646400,16907520
train,1379,214,164352,45796,6594624,6758976
train,1380,330,253440,108900,15681600,15935040
train,1381,274,210432,75076,10810944,11021376
train,1382,191,146688,36481,5253264,5399952
train,1383,365,280320,133225,19184400,19464720
train,1384,170,130560,28900,4161600,4292160
train,1385,214,164352,45796,6594624,6758976
train,1386,212,162816,44944,6471936,6634752
train,1387,50,38400,2500,360000,398400
train,1388,156,119808,24336,3504384,3624192
train,1389,308,236544,94864,13660416,13896960
train,1390,225,172800,50625,7290000,7462800
train,1391,412,316416,169744,24443136,24759552
train,1392,423,324864,178929,25765776,26090640
train,1393,101,77568,10201,1468944,1546512
train,1394,297,228096,88209,12702096,12930192
train,1395,336,258048,112896,16257024,16515072
train,1396,176,135168,30976,4460544,4595712
train,1397,417,320256,173889,25040016,25360272
train,1398,114,87552,12996,1871424,1958976
train,1399,135,103680,18225,2624400,2728080
train,1400,512,393216,262144,37748736,38141952
train,1401,116,89088,13456,1937664,2026752
train,1402,512,393216,262144,37748736,38141952
train,1403,441,338688,194481,28005264,28343952
train,1404,95,72960,9025,1299600,1372560
train,1405,338,259584,114244,16451136,16710720
train,1406,240,184320,57600,8294400,8478720
train,1407,427,327936,182329,26255376,26583312
train,1408,363,278784,131769,18974736,19253520
train,1409,321,246528,103041,14837904,15084432
train,1410,321,246528,103041,14837904,15084432
train,1411,240,184320,57600,8294400,8478720
train,1412,118,90624,13924,2005056,2095680
train,1413,150,115200,22500,3240000,3355200
train,1414,266,204288,70756,10188864,10393152
train,1415,368,282624,135424,19501056,19783680
train,1416,512,393216,262144,37748736,38141952
train,1417,272,208896,73984,10653696,10862592
train,1418,382,293376,145924,21013056,21306432
train,1419,247,189696,61009,8785296,8974992
train,1420,469,360192,219961,31674384,32034576
train,1421,304,233472,92416,13307904,13541376
train,1422,512,393216,262144,37748736,38141952
train,1423,268,205824,71824,10342656,10548480
train,1424,363,278784,131769,18974736,19253520
train,1425,350,268800,122500,17640000,17908800
train,1426,507,389376,257049,37015056,37404432
train,1427,325,249600,105625,15210000,15459600
train,1428,199,152832,39601,5702544,5855376
train,1429,202,155136,40804,5875776,6030912
train,1430,329,252672,108241,15586704,15839376
train,1431,255,195840,65025,9363600,9559440
train,1432,303,232704,91809,13220496,13453200
train,1433,434,333312,188356,27123264,27456576
train,1434,389,298752,151321,21790224,22088976
train,1435,238,182784,56644,8156736,8339520
train,1436,452,347136,204304,29419776,29766912
train,1437,450,345600,202500,29160000,29505600
train,1438,264,202752,69696,10036224,10238976
train,1439,359,275712,128881,18558864,18834576
train,1440,145,111360,21025,3027600,3138960
train,1441,348,267264,121104,17438976,17706240
train,1442,352,270336,123904,17842176,18112512
train,1443,313,240384,97969,14107536,14347920
train,1444,310,238080,96100,13838400,14076480
train,1445,84,64512,7056,1016064,1080576
train,1446,349,268032,121801,17539344,17807376
train,1447,256,196608,65536,9437184,9633792
train,1448,173,132864,29929,4309776,4442640
train,1449,512,393216,262144,37748736,38141952
train,1450,429,329472,184041,26501904,26831376
train,1451,320,245760,102400,14745600,14991360
train,1452,330,253440,108900,15681600,15935040
train,1453,371,284928,137641,19820304,20105232
train,1454,297,228096,88209,12702096,12930192
train,1455,435,334080,189225,27248400,27582480
train,1456,285,218880,81225,11696400,11915280
train,1457,501,384768,251001,36144144,36528912
train,1458,346,265728,119716,17239104,17504832
train,1459,246,188928,60516,8714304,8903232
train,1460,431,331008,185761,26749584,27080592
train,1461,284,218112,80656,11614464,11832576
train,1462,452,347136,204304,29419776,29766912
train,1463,186,142848,34596,4981824,5124672
train,1464,179,137472,32041,4613904,4751376
train,1465,304,233472,92416,13307904,13541376
train,1466,459,352512,210681,30338064,30690576
train,1467,329,252672,108241,15586704,15839376
train,1468,321,246528,103041,14837904,15084432
train,1469,428,328704,183184,26378496,26707200
train,1470,188,144384,35344,5089536,5233920
train,1471,77,59136,5929,853776,912912
train,1472,411,315648,168921,24324624,24640272
train,1473,512,393216,262144,37748736,38141952
train,1474,397,304896,157609,22695696,23000592
train,1475,273,209664,74529,10732176,10941840
train,1476,368,282624,135424,19501056,19783680
train,1477,290,222720,84100,12110400,12333120
train,1478,196,150528,38416,5531904,5682432
train,1479,348,267264,121104,17438976,17706240
train,1480,174,133632,30276,4359744,4493376
train,1481,449,344832,201601,29030544,29375376
train,1482,501,384768,251001,36144144,36528912
train,1483,317,243456,100489,14470416,14713872
train,1484,280,215040,78400,11289600,11504640
train,1485,296,227328,87616,12616704,12844032
train,1486,208,159744,43264,6230016,6389760
train,1487,240,184320,57600,8294400,8478720
train,1488,465,357120,216225,31136400,31493520
train,1489,199,152832,39601,5702544,5855376
train,1490,159,122112,25281,3640464,3762576
train,1491,265,203520,70225,10112400,10315920
train,1492,355,272640,126025,18147600,18420240
train,1493,166,127488,27556,3968064,4095552
train,1494,313,240384,97969,14107536,14347920
train,1495,81,62208,6561,944784,1006992
train,1496,301,231168,90601,13046544,13277712
train,1497,409,314112,167281,24088464,24402576
train,1498,453,347904,205209,29550096,29898000
train,1499,345,264960,119025,17139600,17404560
train,1500,263,201984,69169,9960336,10162320
train,1501,273,209664,74529,10732176,10941840
train,1502,365,280320,133225,19184400,19464720
train,1503,455,349440,207025,29811600,30161040
train,1504,152,116736,23104,3326976,3443712
train,1505,100,76800,10000,1440000,1516800
train,1506,463,355584,214369,30869136,31224720
train,1507,355,272640,126025,18147600,18420240
train,1508,483,370944,233289,33593616,33964560
train,1509,371,284928,137641,19820304,20105232
train,1510,512,393216,262144,37748736,38141952
train,1511,374,287232,139876,20142144,20429376
train,1512,403,309504,162409,23386896,23696400
train,1513,458,351744,209764,30206016,30557760
train,1514,206,158208,42436,6110784,6268992
train,1515,366,281088,133956,19289664,19570752
train,1516,223,171264,49729,7160976,7332240
train,1517,512,393216,262144,37748736,38141952
train,1518,116,89088,13456,1937664,2026752
train,1519,102,78336,10404,1498176,1576512
train,1520,275,211200,75625,10890000,11101200
train,1521,440,337920,193600,27878400,28216320
train,1522,305,234240,93025,13395600,13629840
train,1523,225,172800,50625,7290000,7462800
train,1524,247,189696,61009,8785296,8974992
train,1525,212,162816,44944,6471936,6634752
train,1526,109,83712,11881,1710864,1794576
train,1527,384,294912,147456,21233664,21528576
train,1528,247,189696,61009,8785296,8974992
train,1529,289,221952,83521,12027024,12248976
train,1530,443,340224,196249,28259856,28600080
train,1531,330,253440,108900,15681600,15935040
train,1532,422,324096,178084,25644096,25968192
train,1533,239,183552,57121,8225424,8408976
train,1534,381,292608,145161,20903184,21195792
train,1535,373,286464,139129,20034576,20321040
train,1536,244,187392,59536,8573184,8760576
train,1537,405,311040,164025,23619600,23930640
train,1538,373,286464,139129,20034576,20321040
train,1539,229,175872,52441,7551504,7727376
train,1540,212,162816,44944,6471936,6634752
train,1541,129,99072,16641,2396304,2495376
train,1542,273,209664,74529,10732176,10941840
train,1543,169,129792,28561,4112784,4242576
train,1544,362,278016,131044,18870336,19148352
train,1545,268,205824,71824,10342656,10548480
train,1546,440,337920,193600,27878400,28216320
train,1547,320,245760,102400,14745600,14991360
train,1548,421,323328,177241,25522704,25846032
train,1549,304,233472,92416,13307904,13541376
train,1550,486,373248,236196,34012224,34385472
train,1551,512,393216,262144,37748736,38141952
train,1552,508,390144,258064,37161216,37551360
train,1553,232,178176,53824,7750656,7928832
train,1554,126,96768,15876,2286144,2382912
train,1555,477,366336,227529,32764176,33130512
train,1556,362,278016,131044,18870336,19148352
train,1557,512,393216,262144,37748736,38141952
train,1558,261,200448,68121,9809424,10009872
train,1559,303,232704,91809,13220496,13453200
train,1560,370,284160,136900,19713600,19997760
train,1561,285,218880,81225,11696400,11915280
train,1562,319,244992,101761,14653584,14898576
train,1563,234,179712,54756,7884864,8064576
train,1564,116,89088,13456,1937664,2026752
train,1565,335,257280,112225,16160400,16417680
train,1566,76,58368,5776,831744,890112
train,1567,512,393216,262144,37748736,38141952
train,1568,290,222720,84100,12110400,12333120
train,1569,325,249600,105625,15210000,15459600
train,1570,427,327936,182329,26255376,26583312
train,1571,317,243456,100489,14470416,14713872
train,1572,225,172800,50625,7290000,7462800
train,1573,285,218880,81225,11696400,11915280
train,1574,226,173568,51076,7354944,7528512
train,1575,201,154368,40401,5817744,5972112
train,1576,317,243456,100489,14470416,14713872
train,1577,319,244992,101761,14653584,14898576
train,1578,228,175104,51984,7485696,7660800
train,1579,106,81408,11236,1617984,1699392
train,1580,182,139776,33124,4769856,4909632
train,1581,386,296448,148996,21455424,21751872
train,1582,198,152064,39204,5645376,5797440
train,1583,211,162048,44521,6411024,6573072
train,1584,82,62976,6724,968256,1031232
train,1585,305,234240,93025,13395600,13629840
train,1586,241,185088,58081,8363664,8548752
train,1587,186,142848,34596,4981824,5124672
train,1588,486,373248,236196,34012224,34385472
train,1589,147,112896,21609,3111696,3224592
train,1590,429,329472,184041,26501904,26831376
train,1591,377,289536,142129,20466576,20756112
train,1592,360,276480,129600,18662400,18938880
train,1593,231,177408,53361,7683984,7861392
train,1594,366,281088,133956,19289664,19570752
train,1595,229,175872,52441,7551504,7727376
train,1596,176,135168,30976,4460544,4595712
train,1597,160,122880,25600,3686400,3809280
train,1598,215,165120,46225,6656400,6821520
train,1599,193,148224,37249,5363856,5512080
train,1600,320,245760,102400,14745600,14991360
train,1601,296,227328,87616,12616704,12844032
train,1602,125,96000,15625,2250000,2346000
train,1603,463,355584,214369,30869136,31224720
train,1604,349,268032,121801,17539344,17807376
train,1605,290,222720,84100,12110400,12333120
train,1606,492,377856,242064,34857216,35235072
train,1607,358,274944,128164,18455616,18730560
train,1608,459,352512,210681,30338064,30690576
train,1609,251,192768,63001,9072144,9264912
train,1610,214,164352,45796,6594624,6758976
train,1611,180,138240,32400,4665600,4803840
train,1612,100,76800,10000,1440000,1516800
train,1613,175,134400,30625,4410000,4544400
train,1614,512,393216,262144,37748736,38141952
train,1615,290,222720,84100,12110400,12333120
train,1616,128,98304,16384,2359296,2457600
train,1617,512,393216,262144,37748736,38141952
train,1618,478,367104,228484,32901696,33268800
train,1619,305,234240,93025,13395600,13629840
train,1620,293,225024,85849,12362256,12587280
train,1621,370,284160,136900,19713600,19997760
train,1622,301,231168,90601,13046544,13277712
train,1623,236,181248,55696,8020224,8201472
train,1624,317,243456,100489,14470416,14713872
train,1625,293,225024,85849,12362256,12587280
train,1626,379,291072,143641,20684304,20975376
train,1627,301,231168,90601,13046544,13277712
train,1628,186,142848,34596,4981824,5124672
train,1629,218,167424,47524,6843456,7010880
train,1630,445,341760,198025,28515600,28857360
train,1631,130,99840,16900,2433600,2533440
train,1632,287,220416,82369,11861136,12081552
train,1633,197,151296,38809,5588496,5739792
train,1634,477,366336,227529,32764176,33130512
train,1635,75,57600,5625,810000,867600
train,1636,245,188160,60025,8643600,8831760
train,1637,396,304128,156816,22581504,22885632
train,1638,336,258048,112896,16257024,16515072
train,1639,378,290304,142884,20575296,20865600
train,1640,250,192000,62500,9000000,9192000
train,1641,294,225792,86436,12446784,12672576
train,1642,182,139776,33124,4769856,4909632
train,1643,383,294144,146689,21123216,21417360
train,1644,262,201216,68644,9884736,10085952
train,1645,293,225024,85849,12362256,12587280
train,1646,422,324096,178084,25644096,25968192
train,1647,111,85248,12321,1774224,1859472
train,1648,314,241152,98596,14197824,14438976
train,1649,425,326400,180625,26010000,26336400
train,1650,165,126720,27225,3920400,4047120
train,1651,382,293376,145924,21013056,21306432
train,1652,169,129792,28561,4112784,4242576
train,1653,340,261120,115600,16646400,16907520
train,1654,427,327936,182329,26255376,26583312
train,1655,251,192768,63001,9072144,9264912
train,1656,243,186624,59049,8503056,8689680
train,1657,409,314112,167281,24088464,24402576
train,1658,206,158208,42436,6110784,6268992
train,1659,166,127488,27556,3968064,4095552
train,1660,381,292608,145161,20903184,21195792
train,1661,95,72960,9025,1299600,1372560
train,1662,160,122880,25600,3686400,3809280
train,1663,410,314880,168100,24206400,24521280
train,1664,316,242688,99856,14379264,14621952
train,1665,406,311808,164836,23736384,24048192
train,1666,418,321024,174724,25160256,25481280
train,1667,353,271104,124609,17943696,18214800
train,1668,252,193536,63504,9144576,9338112
train,1669,479,367872,229441,33039504,33407376
train,1670,116,89088,13456,1937664,2026752
train,1671,229,175872,52441,7551504,7727376
train,1672,253,194304,64009,9217296,9411600
train,1673,293,225024,85849,12362256,12587280
train,1674,204,156672,41616,5992704,6149376
train,1675,271,208128,73441,10575504,10783632
train,1676,366,281088,133956,19289664,19570752
train,1677,349,268032,121801,17539344,17807376
train,1678,399,306432,159201,22924944,23231376
train,1679,55,42240,3025,435600,477840
train,1680,90,69120,8100,1166400,1235520
train,1681,76,58368,5776,831744,890112
train,1682,231,177408,53361,7683984,7861392
train,1683,386,296448,148996,21455424,21751872
train,1684,276,211968,76176,10969344,11181312
train,1685,338,259584,114244,16451136,16710720
train,1686,510,391680,260100,37454400,37846080
train,1687,242,185856,58564,8433216,8619072
train,1688,304,233472,92416,13307904,13541376
train,1689,431,331008,185761,26749584,27080592
train,1690,307,235776,94249,13571856,13807632
train,1691,416,319488,173056,24920064,25239552
train,1692,244,187392,59536,8573184,8760576
train,1693,308,236544,94864,13660416,13896960
train,1694,208,159744,43264,6230016,6389760
train,1695,68,52224,4624,665856,718080
train,1696,66,50688,4356,627264,677952
train,1697,219,168192,47961,6906384,7074576
train,1698,498,382464,248004,35712576,36095040
train,1699,330,253440,108900,15681600,15935040
train,1700,280,215040,78400,11289600,11504640
train,1701,340,261120,115600,16646400,16907520
train,1702,326,250368,106276,15303744,15554112
train,1703,350,268800,122500,17640000,17908800
train,1704,512,393216,262144,37748736,38141952
train,1705,393,301824,154449,22240656,22542480
train,1706,87,66816,7569,1089936,1156752
train,1707,222,170496,49284,7096896,7267392
train,1708,101,77568,10201,1468944,1546512
train,1709,330,253440,108900,15681600,15935040
train,1710,456,350208,207936,29942784,30292992
train,1711,228,175104,51984,7485696,7660800
train,1712,140,107520,19600,2822400,2929920
train,1713,428,328704,183184,26378496,26707200
train,1714,452,347136,204304,29419776,29766912
train,1715,141,108288,19881,2862864,2971152
train,1716,436,334848,190096,27373824,27708672
train,1717,171,131328,29241,4210704,4342032
train,1718,172,132096,29584,4260096,4392192
train,1719,426,327168,181476,26132544,26459712
train,1720,512,393216,262144,37748736,38141952
train,1721,345,264960,119025,17139600,17404560
train,1722,279,214272,77841,11209104,11423376
train,1723,441,338688,194481,28005264,28343952
train,1724,404,310272,163216,23503104,23813376
train,1725,439,337152,192721,27751824,28088976
train,1726,316,242688,99856,14379264,14621952
train,1727,403,309504,162409,23386896,23696400
train,1728,212,162816,44944,6471936,6634752
train,1729,182,139776,33124,4769856,4909632
train,1730,290,222720,84100,12110400,12333120
train,1731,107,82176,11449,1648656,1730832
train,1732,372,285696,138384,19927296,20212992
train,1733,372,285696,138384,19927296,20212992
train,1734,220,168960,48400,6969600,7138560
train,1735,112,86016,12544,1806336,1892352
train,1736,387,297216,149769,21566736,21863952
train,1737,512,393216,262144,37748736,38141952
train,1738,383,294144,146689,21123216,21417360
train,1739,144,110592,20736,2985984,3096576
train,1740,313,240384,97969,14107536,14347920
train,1741,361,277248,130321,18766224,19043472
train,1742,268,205824,71824,10342656,10548480
train,1743,512,393216,262144,37748736,38141952
train,1744,207,158976,42849,6170256,6329232
train,1745,258,198144,66564,9585216,9783360
train,1746,115,88320,13225,1904400,1992720
train,1747,292,224256,85264,12278016,12502272
train,1748,416,319488,173056,24920064,25239552
train,1749,198,152064,39204,5645376,5797440
train,1750,512,393216,262144,37748736,38141952
train,1751,216,165888,46656,6718464,6884352
train,1752,59,45312,3481,501264,546576
train,1753,227,174336,51529,7420176,7594512
train,1754,303,232704,91809,13220496,13453200
train,1755,155,119040,24025,3459600,3578640
train,1756,122,93696,14884,2143296,2236992
train,1757,354,271872,125316,18045504,18317376
train,1758,170,130560,28900,4161600,4292160
train,1759,168,129024,28224,4064256,4193280
train,1760,374,287232,139876,20142144,20429376
train,1761,209,160512,43681,6290064,6450576
train,1762,152,116736,23104,3326976,3443712
train,1763,199,152832,39601,5702544,5855376
train,1764,243,186624,59049,8503056,8689680
train,1765,105,80640,11025,1587600,1668240
train,1766,292,224256,85264,12278016,12502272
train,1767,234,179712,54756,7884864,8064576
train,1768,431,331008,185761,26749584,27080592
train,1769,229,175872,52441,7551504,7727376
train,1770,336,258048,112896,16257024,16515072
train,1771,346,265728,119716,17239104,17504832
train,1772,482,370176,232324,33454656,33824832
train,1773,512,393216,262144,37748736,38141952
train,1774,249,191232,62001,8928144,9119376
train,1775,158,121344,24964,3594816,3716160
train,1776,289,221952,83521,12027024,12248976
train,1777,414,317952,171396,24681024,24998976
train,1778,182,139776,33124,4769856,4909632
train,1779,346,265728,119716,17239104,17504832
train,1780,159,122112,25281,3640464,3762576
train,1781,264,202752,69696,10036224,10238976
train,1782,512,393216,262144,37748736,38141952
train,1783,410,314880,168100,24206400,24521280
train,1784,161,123648,25921,3732624,3856272
train,1785,327,251136,106929,15397776,15648912
train,1786,512,393216,262144,37748736,38141952
train,1787,152,116736,23104,3326976,3443712
train,1788,382,293376,145924,21013056,21306432
train,1789,412,316416,169744,24443136,24759552
train,1790,249,191232,62001,8928144,9119376
train,1791,232,178176,53824,7750656,7928832
train,1792,322,247296,103684,14930496,15177792
train,1793,272,208896,73984,10653696,10862592
train,1794,282,216576,79524,11451456,11668032
train,1795,177,135936,31329,4511376,4647312
train,1796,142,109056,20164,2903616,3012672
train,1797,112,86016,12544,1806336,1892352
train,1798,236,181248,55696,8020224,8201472
train,1799,429,329472,184041,26501904,26831376
train,1800,321,246528,103041,14837904,15084432
train,1801,424,325632,179776,25887744,26213376
train,1802,390,299520,152100,21902400,22201920
train,1803,425,326400,180625,26010000,26336400
train,1804,448,344064,200704,28901376,29245440
train,1805,294,225792,86436,12446784,12672576
train,1806,219,168192,47961,6906384,7074576
train,1807,291,223488,84681,12194064,12417552
train,1808,509,390912,259081,37307664,37698576
train,1809,88,67584,7744,1115136,1182720
train,1810,409,314112,167281,24088464,24402576
train,1811,207,158976,42849,6170256,6329232
train,1812,407,312576,165649,23853456,24166032
train,1813,230,176640,52900,7617600,7794240
train,1814,135,103680,18225,2624400,2728080
train,1815,259,198912,67081,9659664,9858576
train,1816,248,190464,61504,8856576,9047040
train,1817,176,135168,30976,4460544,4595712
train,1818,89,68352,7921,1140624,1208976
train,1819,207,158976,42849,6170256,6329232
train,1820,80,61440,6400,921600,983040
train,1821,495,380160,245025,35283600,35663760
train,1822,119,91392,14161,2039184,2130576
train,1823,263,201984,69169,9960336,10162320
train,1824,333,255744,110889,15968016,16223760
train,1825,269,206592,72361,10419984,10626576
train,1826,403,309504,162409,23386896,23696400
train,1827,289,221952,83521,12027024,12248976
train,1828,123,94464,15129,2178576,2273040
train,1829,451,346368,203401,29289744,29636112
train,1830,432,331776,186624,26873856,27205632
train,1831,447,343296,199809,28772496,29115792
train,1832,408,313344,166464,23970816,24284160
train,1833,228,175104,51984,7485696,7660800
train,1834,134,102912,17956,2585664,2688576
train,1835,488,374784,238144,34292736,34667520
train,1836,418,321024,174724,25160256,25481280
train,1837,400,307200,160000,23040000,23347200
train,1838,512,393216,262144,37748736,38141952
train,1839,406,311808,164836,23736384,24048192
train,1840,145,111360,21025,3027600,3138960
train,1841,254,195072,64516,9290304,9485376
train,1842,373,286464,139129,20034576,20321040
train,1843,404,310272,163216,23503104,23813376
train,1844,199,152832,39601,5702544,5855376
train,1845,329,252672,108241,15586704,15839376
train,1846,267,205056,71289,10265616,10470672
train,1847,252,193536,63504,9144576,9338112
train,1848,444,340992,197136,28387584,28728576
train,1849,393,301824,154449,22240656,22542480
train,1850,259,198912,67081,9659664,9858576
train,1851,293,225024,85849,12362256,12587280
train,1852,288,221184,82944,11943936,12165120
train,1853,320,245760,102400,14745600,14991360
train,1854,289,221952,83521,12027024,12248976
train,1855,267,205056,71289,10265616,10470672
train,1856,374,287232,139876,20142144,20429376
train,1857,97,74496,9409,1354896,1429392
train,1858,461,354048,212521,30603024,30957072
train,1859,243,186624,59049,8503056,8689680
train,1860,161,123648,25921,3732624,3856272
train,1861,454,348672,206116,29680704,30029376
train,1862,284,218112,80656,11614464,11832576
train,1863,242,185856,58564,8433216,8619072
train,1864,382,293376,145924,21013056,21306432
train,1865,219,168192,47961,6906384,7074576
train,1866,192,147456,36864,5308416,5455872
train,1867,387,297216,149769,21566736,21863952
train,1868,217,166656,47089,6780816,6947472
train,1869,340,261120,115600,16646400,16907520
train,1870,80,61440,6400,921600,983040
train,1871,226,173568,51076,7354944,7528512
train,1872,412,316416,169744,24443136,24759552
train,1873,512,393216,262144,37748736,38141952
train,1874,353,271104,124609,17943696,18214800
train,1875,436,334848,190096,27373824,27708672
train,1876,240,184320,57600,8294400,8478720
train,1877,224,172032,50176,7225344,7397376
train,1878,149,114432,22201,3196944,3311376
train,1879,49,37632,2401,345744,383376
train,1880,303,232704,91809,13220496,13453200
train,1881,153,117504,23409,3370896,3488400
train,1882,177,135936,31329,4511376,4647312
train,1883,200,153600,40000,5760000,5913600
train,1884,206,158208,42436,6110784,6268992
train,1885,116,89088,13456,1937664,2026752
train,1886,157,120576,24649,3549456,3670032
train,1887,172,132096,29584,4260096,4392192
train,1888,512,393216,262144,37748736,38141952
train,1889,74,56832,5476,788544,845376
train,1890,286,219648,81796,11778624,11998272
train,1891,165,126720,27225,3920400,4047120
train,1892,345,264960,119025,17139600,17404560
train,1893,223,171264,49729,7160976,7332240
train,1894,219,168192,47961,6906384,7074576
train,1895,160,122880,25600,3686400,3809280
train,1896,177,135936,31329,4511376,4647312
train,1897,417,320256,173889,25040016,25360272
train,1898,397,304896,157609,22695696,23000592
train,1899,414,317952,171396,24681024,24998976
train,1900,512,393216,262144,37748736,38141952
train,1901,371,284928,137641,19820304,20105232
train,1902,280,215040,78400,11289600,11504640
train,1903,333,255744,110889,15968016,16223760
train,1904,309,237312,95481,13749264,13986576
train,1905,195,149760,38025,5475600,5625360
train,1906,409,314112,167281,24088464,24402576
train,1907,445,341760,198025,28515600,28857360
train,1908,317,243456,100489,14470416,14713872
train,1909,311,238848,96721,13927824,14166672
train,1910,436,334848,190096,27373824,27708672
train,1911,304,233472,92416,13307904,13541376
train,1912,434,333312,188356,27123264,27456576
train,1913,389,298752,151321,21790224,22088976
train,1914,469,360192,219961,31674384,32034576
train,1915,512,393216,262144,37748736,38141952
train,1916,512,393216,262144,37748736,38141952
train,1917,455,349440,207025,29811600,30161040
train,1918,223,171264,49729,7160976,7332240
train,1919,124,95232,15376,2214144,2309376
train,1920,249,191232,62001,8928144,9119376
train,1921,283,217344,80089,11532816,11750160
train,1922,169,129792,28561,4112784,4242576
train,1923,486,373248,236196,34012224,34385472
train,1924,170,130560,28900,4161600,4292160
train,1925,200,153600,40000,5760000,5913600
train,1926,369,283392,136161,19607184,19890576
train,1927,385,295680,148225,21344400,21640080
train,1928,354,271872,125316,18045504,18317376
train,1929,426,327168,181476,26132544,26459712
train,1930,245,188160,60025,8643600,8831760
train,1931,224,172032,50176,7225344,7397376
train,1932,512,393216,262144,37748736,38141952
train,1933,327,251136,106929,15397776,15648912
train,1934,396,304128,156816,22581504,22885632
train,1935,125,96000,15625,2250000,2346000
train,1936,305,234240,93025,13395600,13629840
train,1937,232,178176,53824,7750656,7928832
train,1938,242,185856,58564,8433216,8619072
train,1939,143,109824,20449,2944656,3054480
train,1940,404,310272,163216,23503104,23813376
train,1941,156,119808,24336,3504384,3624192
train,1942,342,262656,116964,16842816,17105472
train,1943,465,357120,216225,31136400,31493520
train,1944,89,68352,7921,1140624,1208976
train,1945,273,209664,74529,10732176,10941840
train,1946,68,52224,4624,665856,718080
train,1947,113,86784,12769,1838736,1925520
train,1948,415,318720,172225,24800400,25119120
train,1949,428,328704,183184,26378496,26707200
train,1950,404,310272,163216,23503104,23813376
train,1951,115,88320,13225,1904400,1992720
train,1952,280,215040,78400,11289600,11504640
train,1953,324,248832,104976,15116544,15365376
train,1954,479,367872,229441,33039504,33407376
train,1955,73,56064,5329,767376,823440
train,1956,447,343296,199809,28772496,29115792
train,1957,138,105984,19044,2742336,2848320
train,1958,316,242688,99856,14379264,14621952
train,1959,242,185856,58564,8433216,8619072
train,1960,183,140544,33489,4822416,4962960
train,1961,512,393216,262144,37748736,38141952
train,1962,183,140544,33489,4822416,4962960
train,1963,217,166656,47089,6780816,6947472
train,1964,229,175872,52441,7551504,7727376
train,1965,175,134400,30625,4410000,4544400
train,1966,487,374016,237169,34152336,34526352
train,1967,512,393216,262144,37748736,38141952
train,1968,224,172032,50176,7225344,7397376
train,1969,244,187392,59536,8573184,8760576
train,1970,265,203520,70225,10112400,10315920
train,1971,242,185856,58564,8433216,8619072
train,1972,335,257280,112225,16160400,16417680
train,1973,99,76032,9801,1411344,1487376
train,1974,117,89856,13689,1971216,2061072
train,1975,170,130560,28900,4161600,4292160
train,1976,238,182784,56644,8156736,8339520
train,1977,110,84480,12100,1742400,1826880
train,1978,486,373248,236196,34012224,34385472
train,1979,418,321024,174724,25160256,25481280
train,1980,414,317952,171396,24681024,24998976
train,1981,288,221184,82944,11943936,12165120
train,1982,512,393216,262144,37748736,38141952
train,1983,167,128256,27889,4016016,4144272
train,1984,340,261120,115600,16646400,16907520
train,1985,452,347136,204304,29419776,29766912
train,1986,360,276480,129600,18662400,18938880
train,1987,220,168960,48400,6969600,7138560
train,1988,166,127488,27556,3968064,4095552
train,1989,156,119808,24336,3504384,3624192
train,1990,233,178944,54289,7817616,7996560
train,1991,121,92928,14641,2108304,2201232
train,1992,396,304128,156816,22581504,22885632
train,1993,196,150528,38416,5531904,5682432
train,1994,323,248064,104329,15023376,15271440
train,1995,240,184320,57600,8294400,8478720
train,1996,265,203520,70225,10112400,10315920
train,1997,162,124416,26244,3779136,3903552
train,1998,278,213504,77284,11128896,11342400
train,1999,387,297216,149769,21566736,21863952
train,2000,209,160512,43681,6290064,6450576
train,2001,216,165888,46656,6718464,6884352
train,2002,512,393216,262144,37748736,38141952
train,2003,279,214272,77841,11209104,11423376
train,2004,389,298752,151321,21790224,22088976
train,2005,225,172800,50625,7290000,7462800
train,2006,318,244224,101124,14561856,14806080
train,2007,165,126720,27225,3920400,4047120
train,2008,111,85248,12321,1774224,1859472
train,2009,478,367104,228484,32901696,33268800
train,2010,363,278784,131769,18974736,19253520
train,2011,363,278784,131769,18974736,19253520
train,2012,188,144384,35344,5089536,5233920
train,2013,379,291072,143641,20684304,20975376
train,2014,203,155904,41209,5934096,6090000
train,2015,163,125184,26569,3825936,3951120
train,2016,385,295680,148225,21344400,21640080
train,2017,90,69120,8100,1166400,1235520
train,2018,65,49920,4225,608400,658320
train,2019,294,225792,86436,12446784,12672576
train,2020,404,310272,163216,23503104,23813376
train,2021,410,314880,168100,24206400,24521280
train,2022,234,179712,54756,7884864,8064576
train,2023,355,272640,126025,18147600,18420240
train,2024,252,193536,63504,9144576,9338112
train,2025,365,280320,133225,19184400,19464720
train,2026,460,353280,211600,30470400,30823680
train,2027,160,122880,25600,3686400,3809280
train,2028,432,331776,186624,26873856,27205632
train,2029,512,393216,262144,37748736,38141952
train,2030,338,259584,114244,16451136,16710720
train,2031,406,311808,164836,23736384,24048192
train,2032,44,33792,1936,278784,312576
train,2033,90,69120,8100,1166400,1235520
train,2034,512,393216,262144,37748736,38141952
train,2035,213,163584,45369,6533136,6696720
train,2036,442,339456,195364,28132416,28471872
train,2037,337,258816,113569,16353936,16612752
train,2038,312,239616,97344,14017536,14257152
train,2039,332,254976,110224,15872256,16127232
train,2040,260,199680,67600,9734400,9934080
train,2041,248,190464,61504,8856576,9047040
train,2042,237,182016,56169,8088336,8270352
train,2043,189,145152,35721,5143824,5288976
train,2044,229,175872,52441,7551504,7727376
train,2045,102,78336,10404,1498176,1576512
train,2046,195,149760,38025,5475600,5625360
train,2047,512,393216,262144,37748736,38141952
train,2048,404,310272,163216,23503104,23813376
train,2049,389,298752,151321,21790224,22088976
train,2050,280,215040,78400,11289600,11504640
train,2051,355,272640,126025,18147600,18420240
train,2052,249,191232,62001,8928144,9119376
train,2053,372,285696,138384,19927296,20212992
train,2054,378,290304,142884,20575296,20865600
train,2055,108,82944,11664,1679616,1762560
train,2056,386,296448,148996,21455424,21751872
train,2057,373,286464,139129,20034576,20321040
train,2058,229,175872,52441,7551504,7727376
train,2059,270,207360,72900,10497600,10704960
train,2060,362,278016,131044,18870336,19148352
train,2061,239,183552,57121,8225424,8408976
train,2062,235,180480,55225,7952400,8132880
train,2063,325,249600,105625,15210000,15459600
train,2064,211,162048,44521,6411024,6573072
train,2065,123,94464,15129,2178576,2273040
train,2066,219,168192,47961,6906384,7074576
train,2067,231,177408,53361,7683984,7861392
train,2068,421,323328,177241,25522704,25846032
train,2069,423,324864,178929,25765776,26090640
train,2070,370,284160,136900,19713600,19997760
train,2071,512,393216,262144,37748736,38141952
train,2072,242,185856,58564,8433216,8619072
train,2073,337,258816,113569,16353936,16612752
train,2074,243,186624,59049,8503056,8689680
train,2075,94,72192,8836,1272384,1344576
train,2076,133,102144,17689,2547216,2649360
train,2077,360,276480,129600,18662400,18938880
train,2078,512,393216,262144,37748736,38141952
train,2079,151,115968,22801,3283344,3399312
train,2080,152,116736,23104,3326976,3443712
train,2081,461,354048,212521,30603024,30957072
train,2082,437,335616,190969,27499536,27835152
train,2083,190,145920,36100,5198400,5344320
train,2084,356,273408,126736,18249984,18523392
train,2085,411,315648,168921,24324624,24640272
train,2086,136,104448,18496,2663424,2767872
train,2087,203,155904,41209,5934096,6090000
train,2088,285,218880,81225,11696400,11915280
train,2089,512,393216,262144,37748736,38141952
train,2090,323,248064,104329,15023376,15271440
train,2091,422,324096,178084,25644096,25968192
train,2092,145,111360,21025,3027600,3138960
train,2093,242,185856,58564,8433216,8619072
train,2094,475,364800,225625,32490000,32854800
train,2095,438,336384,191844,27625536,27961920
train,2096,311,238848,96721,13927824,14166672
train,2097,374,287232,139876,20142144,20429376
train,2098,401,307968,160801,23155344,23463312
train,2099,410,314880,168100,24206400,24521280
train,2100,268,205824,71824,10342656,10548480
train,2101,130,99840,16900,2433600,2533440
train,2102,254,195072,64516,9290304,9485376
train,2103,165,126720,27225,3920400,4047120
train,2104,402,308736,161604,23270976,23579712
train,2105,275,211200,75625,10890000,11101200
train,2106,375,288000,140625,20250000,20538000
train,2107,214,164352,45796,6594624,6758976
train,2108,219,168192,47961,6906384,7074576
train,2109,359,275712,128881,18558864,18834576
train,2110,210,161280,44100,6350400,6511680
train,2111,150,115200,22500,3240000,3355200
train,2112,449,344832,201601,29030544,29375376
train,2113,211,162048,44521,6411024,6573072
train,2114,297,228096,88209,12702096,12930192
train,2115,280,215040,78400,11289600,11504640
train,2116,146,112128,21316,3069504,3181632
train,2117,464,356352,215296,31002624,31358976
train,2118,315,241920,99225,14288400,14530320
train,2119,377,289536,142129,20466576,20756112
train,2120,401,307968,160801,23155344,23463312
train,2121,512,393216,262144,37748736,38141952
train,2122,317,243456,100489,14470416,14713872
train,2123,91,69888,8281,1192464,1262352
train,2124,182,139776,33124,4769856,4909632
train,2125,338,259584,114244,16451136,16710720
train,2126,430,330240,184900,26625600,26955840
train,2127,89,68352,7921,1140624,1208976
train,2128,142,109056,20164,2903616,3012672
train,2129,239,183552,57121,8225424,8408976
train,2130,177,135936,31329,4511376,4647312
train,2131,149,114432,22201,3196944,3311376
train,2132,378,290304,142884,20575296,20865600
train,2133,356,273408,126736,18249984,18523392
train,2134,125,96000,15625,2250000,2346000
train,2135,343,263424,117649,16941456,17204880
train,2136,216,165888,46656,6718464,6884352
train,2137,433,332544,187489,26998416,27330960
train,2138,512,393216,262144,37748736,38141952
train,2139,223,171264,49729,7160976,7332240
train,2140,280,215040,78400,11289600,11504640
train,2141,131,100608,17161,2471184,2571792
train,2142,132,101376,17424,2509056,2610432
train,2143,316,242688,99856,14379264,14621952
train,2144,286,219648,81796,11778624,11998272
train,2145,338,259584,114244,16451136,16710720
train,2146,423,324864,178929,25765776,26090640
train,2147,153,117504,23409,3370896,3488400
train,2148,148,113664,21904,3154176,3267840
train,2149,505,387840,255025,36723600,37111440
train,2150,174,133632,30276,4359744,4493376
train,2151,77,59136,5929,853776,912912
train,2152,108,82944,11664,1679616,1762560
train,2153,236,181248,55696,8020224,8201472
train,2154,305,234240,93025,13395600,13629840
train,2155,512,393216,262144,37748736,38141952
train,2156,113,86784,12769,1838736,1925520
train,2157,124,95232,15376,2214144,2309376
train,2158,394,302592,155236,22353984,22656576
train,2159,276,211968,76176,10969344,11181312
train,2160,176,135168,30976,4460544,4595712
train,2161,282,216576,79524,11451456,11668032
train,2162,318,244224,101124,14561856,14806080
train,2163,240,184320,57600,8294400,8478720
train,2164,225,172800,50625,7290000,7462800
train,2165,108,82944,11664,1679616,1762560
train,2166,85,65280,7225,1040400,1105680
train,2167,228,175104,51984,7485696,7660800
train,2168,192,147456,36864,5308416,5455872
train,2169,297,228096,88209,12702096,12930192
train,2170,197,151296,38809,5588496,5739792
train,2171,366,281088,133956,19289664,19570752
train,2172,183,140544,33489,4822416,4962960
train,2173,234,179712,54756,7884864,8064576
train,2174,164,125952,26896,3873024,3998976
train,2175,290,222720,84100,12110400,12333120
train,2176,254,195072,64516,9290304,9485376
train,2177,512,393216,262144,37748736,38141952
train,2178,347,266496,120409,17338896,17605392
train,2179,225,172800,50625,7290000,7462800
train,2180,276,211968,76176,10969344,11181312
train,2181,236,181248,55696,8020224,8201472
train,2182,271,208128,73441,10575504,10783632
train,2183,304,233472,92416,13307904,13541376
train,2184,242,185856,58564,8433216,8619072
train,2185,120,92160,14400,2073600,2165760
train,2186,381,292608,145161,20903184,21195792
train,2187,324,248832,104976,15116544,15365376
train,2188,115,88320,13225,1904400,1992720
train,2189,440,337920,193600,27878400,28216320
train,2190,209,160512,43681,6290064,6450576
train,2191,278,213504,77284,11128896,11342400
train,2192,246,188928,60516,8714304,8903232
train,2193,416,319488,173056,24920064,25239552
train,2194,466,357888,217156,31270464,31628352
train,2195,468,359424,219024,31539456,31898880
train,2196,429,329472,184041,26501904,26831376
train,2197,139,106752,19321,2782224,2888976
train,2198,185,142080,34225,4928400,5070480
train,2199,319,244992,101761,14653584,14898576
train,2200,293,225024,85849,12362256,12587280
train,2201,490,376320,240100,34574400,34950720
train,2202,272,208896,73984,10653696,10862592
train,2203,431,331008,185761,26749584,27080592
train,2204,302,231936,91204,13133376,13365312
train,2205,334,256512,111556,16064064,16320576
train,2206,315,241920,99225,14288400,14530320
train,2207,112,86016,12544,1806336,1892352
train,2208,261,200448,68121,9809424,10009872
train,2209,418,321024,174724,25160256,25481280
train,2210,242,185856,58564,8433216,8619072
train,2211,303,232704,91809,13220496,13453200
train,2212,162,124416,26244,3779136,3903552
train,2213,253,194304,64009,9217296,9411600
train,2214,241,185088,58081,8363664,8548752
train,2215,190,145920,36100,5198400,5344320
train,2216,436,334848,190096,27373824,27708672
train,2217,214,164352,45796,6594624,6758976
train,2218,405,311040,164025,23619600,23930640
train,2219,387,297216,149769,21566736,21863952
train,2220,386,296448,148996,21455424,21751872
train,2221,467,358656,218089,31404816,31763472
train,2222,85,65280,7225,1040400,1105680
train,2223,226,173568,51076,7354944,7528512
train,2224,464,356352,215296,31002624,31358976
train,2225,392,301056,153664,22127616,22428672
train,2226,309,237312,95481,13749264,13986576
train,2227,90,69120,8100,1166400,1235520
train,2228,278,213504,77284,11128896,11342400
train,2229,241,185088,58081,8363664,8548752
train,2230,305,234240,93025,13395600,13629840
train,2231,221,169728,48841,7033104,7202832
train,2232,75,57600,5625,810000,867600
train,2233,433,332544,187489,26998416,27330960
train,2234,392,301056,153664,22127616,22428672
train,2235,118,90624,13924,2005056,2095680
train,2236,407,312576,165649,23853456,24166032
train,2237,136,104448,18496,2663424,2767872
train,2238,231,177408,53361,7683984,7861392
train,2239,155,119040,24025,3459600,3578640
train,2240,197,151296,38809,5588496,5739792
train,2241,192,147456,36864,5308416,5455872
train,2242,236,181248,55696,8020224,8201472
train,2243,277,212736,76729,11048976,11261712
train,2244,234,179712,54756,7884864,8064576
train,2245,437,335616,190969,27499536,27835152
train,2246,227,174336,51529,7420176,7594512
train,2247,224,172032,50176,7225344,7397376
train,2248,443,340224,196249,28259856,28600080
train,2249,319,244992,101761,14653584,14898576
train,2250,488,374784,238144,34292736,34667520
train,2251,98,75264,9604,1382976,1458240
train,2252,245,188160,60025,8643600,8831760
train,2253,195,149760,38025,5475600,5625360
train,2254,448,344064,200704,28901376,29245440
train,2255,488,374784,238144,34292736,34667520
train,2256,268,205824,71824,10342656,10548480
train,2257,363,278784,131769,18974736,19253520
train,2258,286,219648,81796,11778624,11998272
train,2259,428,328704,183184,26378496,26707200
train,2260,203,155904,41209,5934096,6090000
train,2261,472,362496,222784,32080896,32443392
train,2262,397,304896,157609,22695696,23000592
train,2263,140,107520,19600,2822400,2929920
train,2264,315,241920,99225,14288400,14530320
train,2265,370,284160,136900,19713600,19997760
train,2266,512,393216,262144,37748736,38141952
train,2267,245,188160,60025,8643600,8831760
train,2268,138,105984,19044,2742336,2848320
train,2269,164,125952,26896,3873024,3998976
train,2270,263,201984,69169,9960336,10162320
train,2271,257,197376,66049,9511056,9708432
train,2272,242,185856,58564,8433216,8619072
train,2273,108,82944,11664,1679616,1762560
train,2274,323,248064,104329,15023376,15271440
train,2275,301,231168,90601,13046544,13277712
train,2276,414,317952,171396,24681024,24998976
train,2277,352,270336,123904,17842176,18112512
train,2278,512,393216,262144,37748736,38141952
train,2279,343,263424,117649,16941456,17204880
train,2280,290,222720,84100,12110400,12333120
train,2281,470,360960,220900,31809600,32170560
train,2282,387,297216,149769,21566736,21863952
train,2283,475,364800,225625,32490000,32854800
train,2284,222,170496,49284,7096896,7267392
train,2285,512,393216,262144,37748736,38141952
train,2286,235,180480,55225,7952400,8132880
train,2287,335,257280,112225,16160400,16417680
train,2288,262,201216,68644,9884736,10085952
train,2289,234,179712,54756,7884864,8064576
train,2290,56,43008,3136,451584,494592
train,2291,387,297216,149769,21566736,21863952
train,2292,100,76800,10000,1440000,1516800
train,2293,288,221184,82944,11943936,12165120
train,2294,371,284928,137641,19820304,20105232
train,2295,119,91392,14161,2039184,2130576
train,2296,384,294912,147456,21233664,21528576
train,2297,188,144384,35344,5089536,5233920
train,2298,314,241152,98596,14197824,14438976
train,2299,307,235776,94249,13571856,13807632
train,2300,226,173568,51076,7354944,7528512
train,2301,254,195072,64516,9290304,9485376
train,2302,244,187392,59536,8573184,8760576
train,2303,275,211200,75625,10890000,11101200
train,2304,370,284160,136900,19713600,19997760
train,2305,434,333312,188356,27123264,27456576
train,2306,512,393216,262144,37748736,38141952
train,2307,132,101376,17424,2509056,2610432
train,2308,258,198144,66564,9585216,9783360
train,2309,283,217344,80089,11532816,11750160
train,2310,364,279552,132496,19079424,19358976
train,2311,205,157440,42025,6051600,6209040
train,2312,401,307968,160801,23155344,23463312
train,2313,364,279552,132496,19079424,19358976
train,2314,437,335616,190969,27499536,27835152
train,2315,342,262656,116964,16842816,17105472
train,2316,318,244224,101124,14561856,14806080
train,2317,267,205056,71289,10265616,10470672
train,2318,226,173568,51076,7354944,7528512
train,2319,241,185088,58081,8363664,8548752
train,2320,155,119040,24025,3459600,3578640
train,2321,402,308736,161604,23270976,23579712
train,2322,465,357120,216225,31136400,31493520
train,2323,363,278784,131769,18974736,19253520
train,2324,251,192768,63001,9072144,9264912
train,2325,238,182784,56644,8156736,8339520
train,2326,447,343296,199809,28772496,29115792
train,2327,320,245760,102400,14745600,14991360
train,2328,253,194304,64009,9217296,9411600
train,2329,279,214272,77841,11209104,11423376
train,2330,191,146688,36481,5253264,5399952
train,2331,163,125184,26569,3825936,3951120
train,2332,306,235008,93636,13483584,13718592
train,2333,273,209664,74529,10732176,10941840
train,2334,427,327936,182329,26255376,26583312
train,2335,298,228864,88804,12787776,13016640
train,2336,375,288000,140625,20250000,20538000
train,2337,441,338688,194481,28005264,28343952
train,2338,418,321024,174724,25160256,25481280
train,2339,216,165888,46656,6718464,6884352
train,2340,225,172800,50625,7290000,7462800
train,2341,426,327168,181476,26132544,26459712
train,2342,281,215808,78961,11370384,11586192
train,2343,383,294144,146689,21123216,21417360
train,2344,178,136704,31684,4562496,4699200
train,2345,205,157440,42025,6051600,6209040
train,2346,238,182784,56644,8156736,8339520
train,2347,420,322560,176400,25401600,25724160
train,2348,141,108288,19881,2862864,2971152
train,2349,177,135936,31329,4511376,4647312
train,2350,303,232704,91809,13220496,13453200
train,2351,383,294144,146689,21123216,21417360
train,2352,512,393216,262144,37748736,38141952
train,2353,111,85248,12321,1774224,1859472
train,2354,243,186624,59049,8503056,8689680
train,2355,155,119040,24025,3459600,3578640
train,2356,161,123648,25921,3732624,3856272
train,2357,351,269568,123201,17740944,18010512
train,2358,242,185856,58564,8433216,8619072
train,2359,226,173568,51076,7354944,7528512
train,2360,146,112128,21316,3069504,3181632
train,2361,369,283392,136161,19607184,19890576
train,2362,280,215040,78400,11289600,11504640
train,2363,191,146688,36481,5253264,5399952
train,2364,512,393216,262144,37748736,38141952
train,2365,173,132864,29929,4309776,4442640
train,2366,424,325632,179776,25887744,26213376
train,2367,373,286464,139129,20034576,20321040
train,2368,254,195072,64516,9290304,9485376
train,2369,435,334080,189225,27248400,27582480
train,2370,356,273408,126736,18249984,18523392
train,2371,281,215808,78961,11370384,11586192
train,2372,164,125952,26896,3873024,3998976
train,2373,372,285696,138384,19927296,20212992
train,2374,462,354816,213444,30735936,31090752
train,2375,386,296448,148996,21455424,21751872
train,2376,197,151296,38809,5588496,5739792
train,2377,239,183552,57121,8225424,8408976
train,2378,134,102912,17956,2585664,2688576
train,2379,248,190464,61504,8856576,9047040
train,2380,383,294144,146689,21123216,21417360
train,2381,264,202752,69696,10036224,10238976
train,2382,122,93696,14884,2143296,2236992
train,2383,436,334848,190096,27373824,27708672
train,2384,167,128256,27889,4016016,4144272
train,2385,436,334848,190096,27373824,27708672
train,2386,238,182784,56644,8156736,8339520
train,2387,98,75264,9604,1382976,1458240
train,2388,115,88320,13225,1904400,1992720
train,2389,219,168192,47961,6906384,7074576
train,2390,322,247296,103684,14930496,15177792
train,2391,58,44544,3364,484416,528960
train,2392,209,160512,43681,6290064,6450576
train,2393,274,210432,75076,10810944,11021376
train,2394,206,158208,42436,6110784,6268992
train,2395,275,211200,75625,10890000,11101200
train,2396,164,125952,26896,3873024,3998976
train,2397,258,198144,66564,9585216,9783360
train,2398,183,140544,33489,4822416,4962960
train,2399,322,247296,103684,14930496,15177792
train,2400,223,171264,49729,7160976,7332240
train,2401,218,167424,47524,6843456,7010880
train,2402,303,232704,91809,13220496,13453200
train,2403,309,237312,95481,13749264,13986576
train,2404,374,287232,139876,20142144,20429376
train,2405,297,228096,88209,12702096,12930192
train,2406,98,75264,9604,1382976,1458240
train,2407,275,211200,75625,10890000,11101200
train,2408,151,115968,22801,3283344,3399312
train,2409,363,278784,131769,18974736,19253520
train,2410,142,109056,20164,2903616,3012672
train,2411,182,139776,33124,4769856,4909632
train,2412,283,217344,80089,11532816,11750160
train,2413,322,247296,103684,14930496,15177792
train,2414,262,201216,68644,9884736,10085952
train,2415,313,240384,97969,14107536,14347920
train,2416,229,175872,52441,7551504,7727376
train,2417,308,236544,94864,13660416,13896960
train,2418,444,340992,197136,28387584,28728576
train,2419,309,237312,95481,13749264,13986576
train,2420,431,331008,185761,26749584,27080592
train,2421,241,185088,58081,8363664,8548752
train,2422,245,188160,60025,8643600,8831760
train,2423,512,393216,262144,37748736,38141952
train,2424,375,288000,140625,20250000,20538000
train,2425,183,140544,33489,4822416,4962960
train,2426,394,302592,155236,22353984,22656576
train,2427,249,191232,62001,8928144,9119376
train,2428,225,172800,50625,7290000,7462800
train,2429,52,39936,2704,389376,429312
train,2430,382,293376,145924,21013056,21306432
train,2431,151,115968,22801,3283344,3399312
train,2432,512,393216,262144,37748736,38141952
train,2433,432,331776,186624,26873856,27205632
train,2434,383,294144,146689,21123216,21417360
train,2435,145,111360,21025,3027600,3138960
train,2436,352,270336,123904,17842176,18112512
train,2437,253,194304,64009,9217296,9411600
train,2438,227,174336,51529,7420176,7594512
train,2439,162,124416,26244,3779136,3903552
train,2440,306,235008,93636,13483584,13718592
train,2441,327,251136,106929,15397776,15648912
train,2442,211,162048,44521,6411024,6573072
train,2443,313,240384,97969,14107536,14347920
train,2444,228,175104,51984,7485696,7660800
train,2445,87,66816,7569,1089936,1156752
train,2446,196,150528,38416,5531904,5682432
train,2447,277,212736,76729,11048976,11261712
train,2448,199,152832,39601,5702544,5855376
train,2449,441,338688,194481,28005264,28343952
train,2450,240,184320,57600,8294400,8478720
train,2451,297,228096,88209,12702096,12930192
train,2452,202,155136,40804,5875776,6030912
train,2453,461,354048,212521,30603024,30957072
train,2454,310,238080,96100,13838400,14076480
train,2455,284,218112,80656,11614464,11832576
train,2456,252,193536,63504,9144576,9338112
train,2457,350,268800,122500,17640000,17908800
train,2458,207,158976,42849,6170256,6329232
train,2459,412,316416,169744,24443136,24759552
train,2460,151,115968,22801,3283344,3399312
train,2461,243,186624,59049,8503056,8689680
train,2462,309,237312,95481,13749264,13986576
train,2463,450,345600,202500,29160000,29505600
train,2464,218,167424,47524,6843456,7010880
train,2465,157,120576,24649,3549456,3670032
train,2466,391,300288,152881,22014864,22315152
train,2467,323,248064,104329,15023376,15271440
train,2468,84,64512,7056,1016064,1080576
train,2469,410,314880,168100,24206400,24521280
train,2470,181,139008,32761,4717584,4856592
train,2471,177,135936,31329,4511376,4647312
train,2472,164,125952,26896,3873024,3998976
train,2473,75,57600,5625,810000,867600
train,2474,355,272640,126025,18147600,18420240
train,2475,229,175872,52441,7551504,7727376
train,2476,431,331008,185761,26749584,27080592
train,2477,252,193536,63504,9144576,9338112
train,2478,217,166656,47089,6780816,6947472
train,2479,227,174336,51529,7420176,7594512
train,2480,374,287232,139876,20142144,20429376
train,2481,233,178944,54289,7817616,7996560
train,2482,314,241152,98596,14197824,14438976
train,2483,200,153600,40000,5760000,5913600
train,2484,281,215808,78961,11370384,11586192
train,2485,138,105984,19044,2742336,2848320
train,2486,96,73728,9216,1327104,1400832
train,2487,255,195840,65025,9363600,9559440
train,2488,322,247296,103684,14930496,15177792
train,2489,331,254208,109561,15776784,16030992
train,2490,222,170496,49284,7096896,7267392
train,2491,470,360960,220900,31809600,32170560
train,2492,147,112896,21609,3111696,3224592
train,2493,84,64512,7056,1016064,1080576
train,2494,170,130560,28900,4161600,4292160
train,2495,259,198912,67081,9659664,9858576
train,2496,293,225024,85849,12362256,12587280
train,2497,105,80640,11025,1587600,1668240
train,2498,272,208896,73984,10653696,10862592
train,2499,433,332544,187489,26998416,27330960
train,2500,388,297984,150544,21678336,21976320
train,2501,129,99072,16641,2396304,2495376
train,2502,287,220416,82369,11861136,12081552
train,2503,216,165888,46656,6718464,6884352
train,2504,302,231936,91204,13133376,13365312
train,2505,254,195072,64516,9290304,9485376
train,2506,301,231168,90601,13046544,13277712
train,2507,209,160512,43681,6290064,6450576
train,2508,246,188928,60516,8714304,8903232
train,2509,105,80640,11025,1587600,1668240
train,2510,205,157440,42025,6051600,6209040
train,2511,480,368640,230400,33177600,33546240
train,2512,207,158976,42849,6170256,6329232
train,2513,153,117504,23409,3370896,3488400
train,2514,512,393216,262144,37748736,38141952
train,2515,387,297216,149769,21566736,21863952
train,2516,369,283392,136161,19607184,19890576
train,2517,512,393216,262144,37748736,38141952
train,2518,310,238080,96100,13838400,14076480
train,2519,102,78336,10404,1498176,1576512
train,2520,107,82176,11449,1648656,1730832
train,2521,330,253440,108900,15681600,15935040
train,2522,454,348672,206116,29680704,30029376
train,2523,153,117504,23409,3370896,3488400
train,2524,193,148224,37249,5363856,5512080
train,2525,431,331008,185761,26749584,27080592
train,2526,108,82944,11664,1679616,1762560
train,2527,438,336384,191844,27625536,27961920
train,2528,142,109056,20164,2903616,3012672
train,2529,184,141312,33856,4875264,5016576
train,2530,250,192000,62500,9000000,9192000
train,2531,225,172800,50625,7290000,7462800
train,2532,314,241152,98596,14197824,14438976
train,2533,116,89088,13456,1937664,2026752
train,2534,248,190464,61504,8856576,9047040
train,2535,79,60672,6241,898704,959376
train,2536,125,96000,15625,2250000,2346000
train,2537,194,148992,37636,5419584,5568576
train,2538,304,233472,92416,13307904,13541376
train,2539,94,72192,8836,1272384,1344576
train,2540,68,52224,4624,665856,718080
train,2541,188,144384,35344,5089536,5233920
train,2542,249,191232,62001,8928144,9119376
train,2543,350,268800,122500,17640000,17908800
train,2544,322,247296,103684,14930496,15177792
train,2545,202,155136,40804,5875776,6030912
train,2546,356,273408,126736,18249984,18523392
train,2547,297,228096,88209,12702096,12930192
train,2548,336,258048,112896,16257024,16515072
train,2549,98,75264,9604,1382976,1458240
train,2550,341,261888,116281,16744464,17006352
train,2551,384,294912,147456,21233664,21528576
train,2552,114,87552,12996,1871424,1958976
train,2553,340,261120,115600,16646400,16907520
train,2554,175,134400,30625,4410000,4544400
train,2555,505,387840,255025,36723600,37111440
train,2556,218,167424,47524,6843456,7010880
train,2557,148,113664,21904,3154176,3267840
train,2558,314,241152,98596,14197824,14438976
train,2559,129,99072,16641,2396304,2495376
train,2560,158,121344,24964,3594816,3716160
train,2561,366,281088,133956,19289664,19570752
train,2562,254,195072,64516,9290304,9485376
train,2563,255,195840,65025,9363600,9559440
train,2564,75,57600,5625,810000,867600
train,2565,160,122880,25600,3686400,3809280
train,2566,87,66816,7569,1089936,1156752
train,2567,309,237312,95481,13749264,13986576
train,2568,251,192768,63001,9072144,9264912
train,2569,208,159744,43264,6230016,6389760
train,2570,408,313344,166464,23970816,24284160
train,2571,441,338688,194481,28005264,28343952
train,2572,210,161280,44100,6350400,6511680
train,2573,473,363264,223729,32216976,32580240
train,2574,282,216576,79524,11451456,11668032
train,2575,451,346368,203401,29289744,29636112
train,2576,354,271872,125316,18045504,18317376
train,2577,237,182016,56169,8088336,8270352
train,2578,147,112896,21609,3111696,3224592
train,2579,244,187392,59536,8573184,8760576
train,2580,212,162816,44944,6471936,6634752
train,2581,263,201984,69169,9960336,10162320
train,2582,290,222720,84100,12110400,12333120
train,2583,346,265728,119716,17239104,17504832
train,2584,266,204288,70756,10188864,10393152
train,2585,308,236544,94864,13660416,13896960
train,2586,316,242688,99856,14379264,14621952
train,2587,408,313344,166464,23970816,24284160
train,2588,395,303360,156025,22467600,22770960
train,2589,141,108288,19881,2862864,2971152
train,2590,172,132096,29584,4260096,4392192
train,2591,285,218880,81225,11696400,11915280
train,2592,392,301056,153664,22127616,22428672
train,2593,241,185088,58081,8363664,8548752
train,2594,499,383232,249001,35856144,36239376
train,2595,397,304896,157609,22695696,23000592
train,2596,512,393216,262144,37748736,38141952
train,2597,436,334848,190096,27373824,27708672
train,2598,247,189696,61009,8785296,8974992
train,2599,370,284160,136900,19713600,19997760
train,2600,237,182016,56169,8088336,8270352
train,2601,254,195072,64516,9290304,9485376
train,2602,258,198144,66564,9585216,9783360
train,2603,146,112128,21316,3069504,3181632
train,2604,510,391680,260100,37454400,37846080
train,2605,305,234240,93025,13395600,13629840
train,2606,341,261888,116281,16744464,17006352
train,2607,235,180480,55225,7952400,8132880
train,2608,139,106752,19321,2782224,2888976
train,2609,283,217344,80089,11532816,11750160
train,2610,202,155136,40804,5875776,6030912
train,2611,156,119808,24336,3504384,3624192
train,2612,325,249600,105625,15210000,15459600
train,2613,204,156672,41616,5992704,6149376
train,2614,422,324096,178084,25644096,25968192
train,2615,399,306432,159201,22924944,23231376
train,2616,447,343296,199809,28772496,29115792
train,2617,90,69120,8100,1166400,1235520
train,2618,178,136704,31684,4562496,4699200
train,2619,266,204288,70756,10188864,10393152
train,2620,489,375552,239121,34433424,34808976
train,2621,300,230400,90000,12960000,13190400
train,2622,213,163584,45369,6533136,6696720
train,2623,512,393216,262144,37748736,38141952
train,2624,243,186624,59049,8503056,8689680
train,2625,367,281856,134689,19395216,19677072
train,2626,267,205056,71289,10265616,10470672
train,2627,239,183552,57121,8225424,8408976
train,2628,464,356352,215296,31002624,31358976
train,2629,512,393216,262144,37748736,38141952
train,2630,305,234240,93025,13395600,13629840
train,2631,311,238848,96721,13927824,14166672
train,2632,389,298752,151321,21790224,22088976
train,2633,192,147456,36864,5308416,5455872
train,2634,213,163584,45369,6533136,6696720
train,2635,290,222720,84100,12110400,12333120
train,2636,273,209664,74529,10732176,10941840
train,2637,347,266496,120409,17338896,17605392
train,2638,512,393216,262144,37748736,38141952
train,2639,115,88320,13225,1904400,1992720
train,2640,249,191232,62001,8928144,9119376
train,2641,409,314112,167281,24088464,24402576
train,2642,80,61440,6400,921600,983040
train,2643,306,235008,93636,13483584,13718592
train,2644,383,294144,146689,21123216,21417360
train,2645,408,313344,166464,23970816,24284160
train,2646,116,89088,13456,1937664,2026752
train,2647,201,154368,40401,5817744,5972112
train,2648,204,156672,41616,5992704,6149376
train,2649,377,289536,142129,20466576,20756112
train,2650,258,198144,66564,9585216,9783360
train,2651,274,210432,75076,10810944,11021376
train,2652,234,179712,54756,7884864,8064576
train,2653,170,130560,28900,4161600,4292160
train,2654,328,251904,107584,15492096,15744000
train,2655,309,237312,95481,13749264,13986576
train,2656,423,324864,178929,25765776,26090640
train,2657,179,137472,32041,4613904,4751376
train,2658,186,142848,34596,4981824,5124672
train,2659,74,56832,5476,788544,845376
train,2660,187,143616,34969,5035536,5179152
train,2661,281,215808,78961,11370384,11586192
train,2662,223,171264,49729,7160976,7332240
train,2663,316,242688,99856,14379264,14621952
train,2664,446,342528,198916,28643904,28986432
train,2665,169,129792,28561,4112784,4242576
train,2666,154,118272,23716,3415104,3533376
train,2667,349,268032,121801,17539344,17807376
train,2668,273,209664,74529,10732176,10941840
train,2669,233,178944,54289,7817616,7996560
train,2670,368,282624,135424,19501056,19783680
train,2671,373,286464,139129,20034576,20321040
train,2672,204,156672,41616,5992704,6149376
train,2673,170,130560,28900,4161600,4292160
train,2674,319,244992,101761,14653584,14898576
train,2675,147,112896,21609,3111696,3224592
train,2676,366,281088,133956,19289664,19570752
train,2677,148,113664,21904,3154176,3267840
train,2678,279,214272,77841,11209104,11423376
train,2679,227,174336,51529,7420176,7594512
train,2680,216,165888,46656,6718464,6884352
train,2681,222,170496,49284,7096896,7267392
train,2682,293,225024,85849,12362256,12587280
train,2683,369,283392,136161,19607184,19890576
train,2684,355,272640,126025,18147600,18420240
validation,0,150,115200,22500,3240000,3355200
validation,1,130,99840,16900,2433600,2533440
validation,2,136,104448,18496,2663424,2767872
validation,3,227,174336,51529,7420176,7594512
validation,4,293,225024,85849,12362256,12587280
validation,5,466,357888,217156,31270464,31628352
validation,6,512,393216,262144,37748736,38141952
validation,7,492,377856,242064,34857216,35235072
validation,8,278,213504,77284,11128896,11342400
validation,9,339,260352,114921,16548624,16808976
validation,10,297,228096,88209,12702096,12930192
validation,11,279,214272,77841,11209104,11423376
validation,12,113,86784,12769,1838736,1925520
validation,13,245,188160,60025,8643600,8831760
validation,14,354,271872,125316,18045504,18317376
validation,15,446,342528,198916,28643904,28986432
validation,16,325,249600,105625,15210000,15459600
validation,17,276,211968,76176,10969344,11181312
validation,18,483,370944,233289,33593616,33964560
validation,19,285,218880,81225,11696400,11915280
validation,20,186,142848,34596,4981824,5124672
validation,21,345,264960,119025,17139600,17404560
validation,22,506,388608,256036,36869184,37257792
validation,23,251,192768,63001,9072144,9264912
validation,24,201,154368,40401,5817744,5972112
validation,25,366,281088,133956,19289664,19570752
validation,26,210,161280,44100,6350400,6511680
validation,27,70,53760,4900,705600,759360
validation,28,190,145920,36100,5198400,5344320
validation,29,199,152832,39601,5702544,5855376
validation,30,367,281856,134689,19395216,19677072
validation,31,413,317184,170569,24561936,24879120
validation,32,317,243456,100489,14470416,14713872
validation,33,412,316416,169744,24443136,24759552
validation,34,465,357120,216225,31136400,31493520
validation,35,82,62976,6724,968256,1031232
validation,36,169,129792,28561,4112784,4242576
validation,37,210,161280,44100,6350400,6511680
validation,38,236,181248,55696,8020224,8201472
validation,39,354,271872,125316,18045504,18317376
validation,40,382,293376,145924,21013056,21306432
validation,41,317,243456,100489,14470416,14713872
validation,42,469,360192,219961,31674384,32034576
validation,43,125,96000,15625,2250000,2346000
validation,44,204,156672,41616,5992704,6149376
validation,45,441,338688,194481,28005264,28343952
validation,46,381,292608,145161,20903184,21195792
validation,47,195,149760,38025,5475600,5625360
validation,48,432,331776,186624,26873856,27205632
validation,49,204,156672,41616,5992704,6149376
validation,50,258,198144,66564,9585216,9783360
validation,51,259,198912,67081,9659664,9858576
validation,52,249,191232,62001,8928144,9119376
validation,53,154,118272,23716,3415104,3533376
validation,54,395,303360,156025,22467600,22770960
validation,55,339,260352,114921,16548624,16808976
validation,56,429,329472,184041,26501904,26831376
validation,57,219,168192,47961,6906384,7074576
validation,58,150,115200,22500,3240000,3355200
validation,59,204,156672,41616,5992704,6149376
validation,60,371,284928,137641,19820304,20105232
validation,61,412,316416,169744,24443136,24759552
validation,62,445,341760,198025,28515600,28857360
validation,63,343,263424,117649,16941456,17204880
validation,64,512,393216,262144,37748736,38141952
validation,65,480,368640,230400,33177600,33546240
validation,66,178,136704,31684,4562496,4699200
validation,67,202,155136,40804,5875776,6030912
validation,68,355,272640,126025,18147600,18420240
validation,69,194,148992,37636,5419584,5568576
validation,70,274,210432,75076,10810944,11021376
validation,71,105,80640,11025,1587600,1668240
validation,72,434,333312,188356,27123264,27456576
validation,73,228,175104,51984,7485696,7660800
validation,74,211,162048,44521,6411024,6573072
validation,75,379,291072,143641,20684304,20975376
validation,76,169,129792,28561,4112784,4242576
validation,77,220,168960,48400,6969600,7138560
validation,78,504,387072,254016,36578304,36965376
validation,79,191,146688,36481,5253264,5399952
validation,80,48,36864,2304,331776,368640
validation,81,439,337152,192721,27751824,28088976
validation,82,363,278784,131769,18974736,19253520
validation,83,275,211200,75625,10890000,11101200
validation,84,259,198912,67081,9659664,9858576
validation,85,281,215808,78961,11370384,11586192
validation,86,364,279552,132496,19079424,19358976
validation,87,213,163584,45369,6533136,6696720
validation,88,375,288000,140625,20250000,20538000
validation,89,220,168960,48400,6969600,7138560
validation,90,93,71424,8649,1245456,1316880
validation,91,303,232704,91809,13220496,13453200
validation,92,163,125184,26569,3825936,3951120
validation,93,278,213504,77284,11128896,11342400
validation,94,265,203520,70225,10112400,10315920
validation,95,236,181248,55696,8020224,8201472
validation,96,102,78336,10404,1498176,1576512
validation,97,132,101376,17424,2509056,2610432
validation,98,120,92160,14400,2073600,2165760
validation,99,458,351744,209764,30206016,30557760
validation,100,298,228864,88804,12787776,13016640
validation,101,228,175104,51984,7485696,7660800
validation,102,344,264192,118336,17040384,17304576
validation,103,71,54528,5041,725904,780432
validation,104,286,219648,81796,11778624,11998272
validation,105,475,364800,225625,32490000,32854800
validation,106,321,246528,103041,14837904,15084432
validation,107,128,98304,16384,2359296,2457600
validation,108,379,291072,143641,20684304,20975376
validation,109,295,226560,87025,12531600,12758160
validation,110,290,222720,84100,12110400,12333120
validation,111,248,190464,61504,8856576,9047040
validation,112,183,140544,33489,4822416,4962960
validation,113,85,65280,7225,1040400,1105680
validation,114,512,393216,262144,37748736,38141952
validation,115,182,139776,33124,4769856,4909632
validation,116,393,301824,154449,22240656,22542480
validation,117,190,145920,36100,5198400,5344320
validation,118,272,208896,73984,10653696,10862592
validation,119,294,225792,86436,12446784,12672576
validation,120,294,225792,86436,12446784,12672576
validation,121,267,205056,71289,10265616,10470672
validation,122,357,274176,127449,18352656,18626832
validation,123,96,73728,9216,1327104,1400832
validation,124,321,246528,103041,14837904,15084432
validation,125,385,295680,148225,21344400,21640080
validation,126,200,153600,40000,5760000,5913600
validation,127,399,306432,159201,22924944,23231376
validation,128,488,374784,238144,34292736,34667520
validation,129,309,237312,95481,13749264,13986576
validation,130,282,216576,79524,11451456,11668032
validation,131,303,232704,91809,13220496,13453200
validation,132,349,268032,121801,17539344,17807376
validation,133,304,233472,92416,13307904,13541376
validation,134,278,213504,77284,11128896,11342400
validation,135,364,279552,132496,19079424,19358976
validation,136,116,89088,13456,1937664,2026752
validation,137,313,240384,97969,14107536,14347920
validation,138,134,102912,17956,2585664,2688576
validation,139,257,197376,66049,9511056,9708432
validation,140,253,194304,64009,9217296,9411600
validation,141,402,308736,161604,23270976,23579712
validation,142,223,171264,49729,7160976,7332240
validation,143,368,282624,135424,19501056,19783680
validation,144,139,106752,19321,2782224,2888976
validation,145,249,191232,62001,8928144,9119376
validation,146,432,331776,186624,26873856,27205632
validation,147,416,319488,173056,24920064,25239552
validation,148,190,145920,36100,5198400,5344320
validation,149,211,162048,44521,6411024,6573072
validation,150,243,186624,59049,8503056,8689680
validation,151,232,178176,53824,7750656,7928832
validation,152,247,189696,61009,8785296,8974992
validation,153,455,349440,207025,29811600,30161040
validation,154,112,86016,12544,1806336,1892352
validation,155,253,194304,64009,9217296,9411600
validation,156,322,247296,103684,14930496,15177792
validation,157,283,217344,80089,11532816,11750160
validation,158,341,261888,116281,16744464,17006352
validation,159,238,182784,56644,8156736,8339520
validation,160,172,132096,29584,4260096,4392192
validation,161,175,134400,30625,4410000,4544400
validation,162,248,190464,61504,8856576,9047040
validation,163,185,142080,34225,4928400,5070480
validation,164,410,314880,168100,24206400,24521280
validation,165,512,393216,262144,37748736,38141952
validation,166,191,146688,36481,5253264,5399952
validation,167,240,184320,57600,8294400,8478720
validation,168,403,309504,162409,23386896,23696400
validation,169,132,101376,17424,2509056,2610432
validation,170,336,258048,112896,16257024,16515072
validation,171,111,85248,12321,1774224,1859472
validation,172,301,231168,90601,13046544,13277712
validation,173,323,248064,104329,15023376,15271440
validation,174,390,299520,152100,21902400,22201920
validation,175,431,331008,185761,26749584,27080592
validation,176,307,235776,94249,13571856,13807632
validation,177,68,52224,4624,665856,718080
validation,178,68,52224,4624,665856,718080
validation,179,378,290304,142884,20575296,20865600
validation,180,484,371712,234256,33732864,34104576
validation,181,235,180480,55225,7952400,8132880
validation,182,373,286464,139129,20034576,20321040
validation,183,434,333312,188356,27123264,27456576
validation,184,177,135936,31329,4511376,4647312
validation,185,253,194304,64009,9217296,9411600
validation,186,356,273408,126736,18249984,18523392
validation,187,443,340224,196249,28259856,28600080
validation,188,198,152064,39204,5645376,5797440
validation,189,336,258048,112896,16257024,16515072
validation,190,225,172800,50625,7290000,7462800
validation,191,289,221952,83521,12027024,12248976
validation,192,283,217344,80089,11532816,11750160
validation,193,372,285696,138384,19927296,20212992
validation,194,210,161280,44100,6350400,6511680
validation,195,438,336384,191844,27625536,27961920
validation,196,292,224256,85264,12278016,12502272
validation,197,229,175872,52441,7551504,7727376
validation,198,259,198912,67081,9659664,9858576
validation,199,396,304128,156816,22581504,22885632
validation,200,169,129792,28561,4112784,4242576
validation,201,477,366336,227529,32764176,33130512
validation,202,111,85248,12321,1774224,1859472
validation,203,100,76800,10000,1440000,1516800
validation,204,443,340224,196249,28259856,28600080
validation,205,263,201984,69169,9960336,10162320
validation,206,485,372480,235225,33872400,34244880
validation,207,359,275712,128881,18558864,18834576
validation,208,264,202752,69696,10036224,10238976
validation,209,191,146688,36481,5253264,5399952
validation,210,250,192000,62500,9000000,9192000
validation,211,292,224256,85264,12278016,12502272
validation,212,319,244992,101761,14653584,14898576
validation,213,266,204288,70756,10188864,10393152
validation,214,282,216576,79524,11451456,11668032
validation,215,155,119040,24025,3459600,3578640
validation,216,289,221952,83521,12027024,12248976
validation,217,478,367104,228484,32901696,33268800
validation,218,317,243456,100489,14470416,14713872
validation,219,393,301824,154449,22240656,22542480
validation,220,223,171264,49729,7160976,7332240
validation,221,317,243456,100489,14470416,14713872
validation,222,330,253440,108900,15681600,15935040
validation,223,227,174336,51529,7420176,7594512
validation,224,492,377856,242064,34857216,35235072
validation,225,143,109824,20449,2944656,3054480
validation,226,74,56832,5476,788544,845376
validation,227,243,186624,59049,8503056,8689680
validation,228,227,174336,51529,7420176,7594512
validation,229,430,330240,184900,26625600,26955840
validation,230,294,225792,86436,12446784,12672576
validation,231,206,158208,42436,6110784,6268992
validation,232,153,117504,23409,3370896,3488400
validation,233,246,188928,60516,8714304,8903232
validation,234,101,77568,10201,1468944,1546512
validation,235,387,297216,149769,21566736,21863952
validation,236,215,165120,46225,6656400,6821520
validation,237,376,288768,141376,20358144,20646912
validation,238,243,186624,59049,8503056,8689680
validation,239,384,294912,147456,21233664,21528576
validation,240,309,237312,95481,13749264,13986576
validation,241,278,213504,77284,11128896,11342400
validation,242,103,79104,10609,1527696,1606800
validation,243,193,148224,37249,5363856,5512080
validation,244,415,318720,172225,24800400,25119120
validation,245,92,70656,8464,1218816,1289472
validation,246,179,137472,32041,4613904,4751376
validation,247,224,172032,50176,7225344,7397376
validation,248,386,296448,148996,21455424,21751872
validation,249,219,168192,47961,6906384,7074576
validation,250,419,321792,175561,25280784,25602576
validation,251,220,168960,48400,6969600,7138560
validation,252,234,179712,54756,7884864,8064576
validation,253,392,301056,153664,22127616,22428672
validation,254,297,228096,88209,12702096,12930192
validation,255,430,330240,184900,26625600,26955840
validation,256,430,330240,184900,26625600,26955840
validation,257,353,271104,124609,17943696,18214800
validation,258,453,347904,205209,29550096,29898000
validation,259,107,82176,11449,1648656,1730832
validation,260,251,192768,63001,9072144,9264912
validation,261,355,272640,126025,18147600,18420240
validation,262,353,271104,124609,17943696,18214800
validation,263,327,251136,106929,15397776,15648912
validation,264,283,217344,80089,11532816,11750160
validation,265,146,112128,21316,3069504,3181632
validation,266,433,332544,187489,26998416,27330960
validation,267,383,294144,146689,21123216,21417360
validation,268,109,83712,11881,1710864,1794576
validation,269,303,232704,91809,13220496,13453200
validation,270,366,281088,133956,19289664,19570752
validation,271,198,152064,39204,5645376,5797440
validation,272,102,78336,10404,1498176,1576512
validation,273,289,221952,83521,12027024,12248976
validation,274,101,77568,10201,1468944,1546512
validation,275,196,150528,38416,5531904,5682432
validation,276,124,95232,15376,2214144,2309376
validation,277,83,63744,6889,992016,1055760
validation,278,318,244224,101124,14561856,14806080
validation,279,247,189696,61009,8785296,8974992
validation,280,132,101376,17424,2509056,2610432
validation,281,83,63744,6889,992016,1055760
validation,282,291,223488,84681,12194064,12417552
validation,283,295,226560,87025,12531600,12758160
validation,284,388,297984,150544,21678336,21976320
validation,285,287,220416,82369,11861136,12081552
validation,286,298,228864,88804,12787776,13016640
validation,287,105,80640,11025,1587600,1668240
validation,288,195,149760,38025,5475600,5625360
validation,289,241,185088,58081,8363664,8548752
validation,290,201,154368,40401,5817744,5972112
validation,291,190,145920,36100,5198400,5344320
validation,292,64,49152,4096,589824,638976
validation,293,356,273408,126736,18249984,18523392
validation,294,292,224256,85264,12278016,12502272
validation,295,501,384768,251001,36144144,36528912
validation,296,471,361728,221841,31945104,32306832
validation,297,381,292608,145161,20903184,21195792
validation,298,297,228096,88209,12702096,12930192
validation,299,313,240384,97969,14107536,14347920
validation,300,388,297984,150544,21678336,21976320
validation,301,343,263424,117649,16941456,17204880
validation,302,442,339456,195364,28132416,28471872
validation,303,420,322560,176400,25401600,25724160
validation,304,194,148992,37636,5419584,5568576
validation,305,218,167424,47524,6843456,7010880
validation,306,216,165888,46656,6718464,6884352
validation,307,252,193536,63504,9144576,9338112
validation,308,217,166656,47089,6780816,6947472
validation,309,92,70656,8464,1218816,1289472
validation,310,438,336384,191844,27625536,27961920
validation,311,200,153600,40000,5760000,5913600
validation,312,217,166656,47089,6780816,6947472
validation,313,338,259584,114244,16451136,16710720
validation,314,370,284160,136900,19713600,19997760
validation,315,221,169728,48841,7033104,7202832
validation,316,139,106752,19321,2782224,2888976
validation,317,157,120576,24649,3549456,3670032
validation,318,262,201216,68644,9884736,10085952
validation,319,512,393216,262144,37748736,38141952
validation,320,170,130560,28900,4161600,4292160
validation,321,119,91392,14161,2039184,2130576
validation,322,372,285696,138384,19927296,20212992
validation,323,283,217344,80089,11532816,11750160
validation,324,187,143616,34969,5035536,5179152
validation,325,512,393216,262144,37748736,38141952
validation,326,136,104448,18496,2663424,2767872
validation,327,310,238080,96100,13838400,14076480
validation,328,394,302592,155236,22353984,22656576
validation,329,411,315648,168921,24324624,24640272
validation,330,224,172032,50176,7225344,7397376
validation,331,373,286464,139129,20034576,20321040
validation,332,512,393216,262144,37748736,38141952
validation,333,228,175104,51984,7485696,7660800
validation,334,347,266496,120409,17338896,17605392
validation,335,115,88320,13225,1904400,1992720
validation,336,410,314880,168100,24206400,24521280
validation,337,199,152832,39601,5702544,5855376
validation,338,388,297984,150544,21678336,21976320
validation,339,313,240384,97969,14107536,14347920
validation,340,377,289536,142129,20466576,20756112
validation,341,242,185856,58564,8433216,8619072
validation,342,202,155136,40804,5875776,6030912
validation,343,219,168192,47961,6906384,7074576
validation,344,340,261120,115600,16646400,16907520
validation,345,348,267264,121104,17438976,17706240
validation,346,440,337920,193600,27878400,28216320
validation,347,243,186624,59049,8503056,8689680
validation,348,217,166656,47089,6780816,6947472
validation,349,420,322560,176400,25401600,25724160
validation,350,100,76800,10000,1440000,1516800
validation,351,226,173568,51076,7354944,7528512
validation,352,304,233472,92416,13307904,13541376
validation,353,393,301824,154449,22240656,22542480
validation,354,265,203520,70225,10112400,10315920
validation,355,402,308736,161604,23270976,23579712
validation,356,134,102912,17956,2585664,2688576
validation,357,160,122880,25600,3686400,3809280
validation,358,309,237312,95481,13749264,13986576
validation,359,243,186624,59049,8503056,8689680
validation,360,208,159744,43264,6230016,6389760
validation,361,429,329472,184041,26501904,26831376
validation,362,317,243456,100489,14470416,14713872
validation,363,227,174336,51529,7420176,7594512
validation,364,253,194304,64009,9217296,9411600
validation,365,369,283392,136161,19607184,19890576
validation,366,260,199680,67600,9734400,9934080
validation,367,173,132864,29929,4309776,4442640
validation,368,367,281856,134689,19395216,19677072
validation,369,283,217344,80089,11532816,11750160
validation,370,243,186624,59049,8503056,8689680
validation,371,72,55296,5184,746496,801792
validation,372,263,201984,69169,9960336,10162320
validation,373,406,311808,164836,23736384,24048192
validation,374,444,340992,197136,28387584,28728576
validation,375,231,177408,53361,7683984,7861392
validation,376,335,257280,112225,16160400,16417680
validation,377,230,176640,52900,7617600,7794240
validation,378,370,284160,136900,19713600,19997760
validation,379,259,198912,67081,9659664,9858576
validation,380,512,393216,262144,37748736,38141952
validation,381,462,354816,213444,30735936,31090752
validation,382,404,310272,163216,23503104,23813376
validation,383,512,393216,262144,37748736,38141952
validation,384,409,314112,167281,24088464,24402576
validation,385,298,228864,88804,12787776,13016640
validation,386,213,163584,45369,6533136,6696720
validation,387,280,215040,78400,11289600,11504640
validation,388,262,201216,68644,9884736,10085952
validation,389,129,99072,16641,2396304,2495376
validation,390,283,217344,80089,11532816,11750160
validation,391,219,168192,47961,6906384,7074576
validation,392,442,339456,195364,28132416,28471872
validation,393,301,231168,90601,13046544,13277712
validation,394,512,393216,262144,37748736,38141952
validation,395,429,329472,184041,26501904,26831376
validation,396,159,122112,25281,3640464,3762576
validation,397,278,213504,77284,11128896,11342400
validation,398,222,170496,49284,7096896,7267392
validation,399,335,257280,112225,16160400,16417680
validation,400,471,361728,221841,31945104,32306832
validation,401,177,135936,31329,4511376,4647312
validation,402,335,257280,112225,16160400,16417680
validation,403,87,66816,7569,1089936,1156752
validation,404,233,178944,54289,7817616,7996560
validation,405,392,301056,153664,22127616,22428672
validation,406,249,191232,62001,8928144,9119376
validation,407,158,121344,24964,3594816,3716160
validation,408,170,130560,28900,4161600,4292160
validation,409,370,284160,136900,19713600,19997760
validation,410,194,148992,37636,5419584,5568576
validation,411,512,393216,262144,37748736,38141952
validation,412,329,252672,108241,15586704,15839376
validation,413,285,218880,81225,11696400,11915280
validation,414,246,188928,60516,8714304,8903232
validation,415,207,158976,42849,6170256,6329232
validation,416,270,207360,72900,10497600,10704960
validation,417,195,149760,38025,5475600,5625360
validation,418,148,113664,21904,3154176,3267840
validation,419,403,309504,162409,23386896,23696400
validation,420,452,347136,204304,29419776,29766912
validation,421,91,69888,8281,1192464,1262352
validation,422,436,334848,190096,27373824,27708672
validation,423,313,240384,97969,14107536,14347920
validation,424,196,150528,38416,5531904,5682432
validation,425,109,83712,11881,1710864,1794576
validation,426,303,232704,91809,13220496,13453200
validation,427,224,172032,50176,7225344,7397376
validation,428,425,326400,180625,26010000,26336400
validation,429,123,94464,15129,2178576,2273040
validation,430,166,127488,27556,3968064,4095552
validation,431,314,241152,98596,14197824,14438976
validation,432,297,228096,88209,12702096,12930192
validation,433,193,148224,37249,5363856,5512080
validation,434,354,271872,125316,18045504,18317376
validation,435,417,320256,173889,25040016,25360272
validation,436,509,390912,259081,37307664,37698576
validation,437,118,90624,13924,2005056,2095680
validation,438,223,171264,49729,7160976,7332240
validation,439,159,122112,25281,3640464,3762576
validation,440,189,145152,35721,5143824,5288976
validation,441,71,54528,5041,725904,780432
validation,442,374,287232,139876,20142144,20429376
validation,443,381,292608,145161,20903184,21195792
validation,444,162,124416,26244,3779136,3903552
validation,445,227,174336,51529,7420176,7594512
validation,446,332,254976,110224,15872256,16127232
validation,447,103,79104,10609,1527696,1606800
validation,448,383,294144,146689,21123216,21417360
validation,449,400,307200,160000,23040000,23347200
validation,450,211,162048,44521,6411024,6573072
validation,451,238,182784,56644,8156736,8339520
validation,452,198,152064,39204,5645376,5797440
validation,453,219,168192,47961,6906384,7074576
validation,454,255,195840,65025,9363600,9559440
validation,455,281,215808,78961,11370384,11586192
validation,456,128,98304,16384,2359296,2457600
validation,457,353,271104,124609,17943696,18214800
validation,458,185,142080,34225,4928400,5070480
validation,459,215,165120,46225,6656400,6821520
validation,460,205,157440,42025,6051600,6209040
validation,461,108,82944,11664,1679616,1762560
validation,462,281,215808,78961,11370384,11586192
validation,463,216,165888,46656,6718464,6884352
validation,464,326,250368,106276,15303744,15554112
validation,465,385,295680,148225,21344400,21640080
validation,466,315,241920,99225,14288400,14530320
validation,467,336,258048,112896,16257024,16515072
validation,468,134,102912,17956,2585664,2688576
validation,469,421,323328,177241,25522704,25846032
validation,470,168,129024,28224,4064256,4193280
validation,471,193,148224,37249,5363856,5512080
validation,472,442,339456,195364,28132416,28471872
validation,473,297,228096,88209,12702096,12930192
validation,474,278,213504,77284,11128896,11342400
validation,475,376,288768,141376,20358144,20646912
validation,476,442,339456,195364,28132416,28471872
validation,477,127,97536,16129,2322576,2420112
validation,478,271,208128,73441,10575504,10783632
validation,479,394,302592,155236,22353984,22656576
validation,480,364,279552,132496,19079424,19358976
validation,481,369,283392,136161,19607184,19890576
validation,482,395,303360,156025,22467600,22770960
validation,483,211,162048,44521,6411024,6573072
validation,484,114,87552,12996,1871424,1958976
validation,485,223,171264,49729,7160976,7332240
validation,486,210,161280,44100,6350400,6511680
validation,487,428,328704,183184,26378496,26707200
validation,488,420,322560,176400,25401600,25724160
validation,489,184,141312,33856,4875264,5016576
validation,490,166,127488,27556,3968064,4095552
validation,491,464,356352,215296,31002624,31358976
validation,492,410,314880,168100,24206400,24521280
validation,493,383,294144,146689,21123216,21417360
validation,494,284,218112,80656,11614464,11832576
validation,495,275,211200,75625,10890000,11101200
validation,496,298,228864,88804,12787776,13016640
validation,497,392,301056,153664,22127616,22428672
validation,498,229,175872,52441,7551504,7727376
validation,499,400,307200,160000,23040000,23347200
validation,500,309,237312,95481,13749264,13986576
validation,501,512,393216,262144,37748736,38141952
validation,502,267,205056,71289,10265616,10470672
validation,503,440,337920,193600,27878400,28216320
validation,504,326,250368,106276,15303744,15554112
validation,505,176,135168,30976,4460544,4595712
validation,506,270,207360,72900,10497600,10704960
validation,507,299,229632,89401,12873744,13103376
validation,508,254,195072,64516,9290304,9485376
validation,509,343,263424,117649,16941456,17204880
validation,510,426,327168,181476,26132544,26459712
validation,511,166,127488,27556,3968064,4095552
validation,512,191,146688,36481,5253264,5399952
validation,513,306,235008,93636,13483584,13718592
validation,514,235,180480,55225,7952400,8132880
validation,515,462,354816,213444,30735936,31090752
validation,516,317,243456,100489,14470416,14713872
validation,517,279,214272,77841,11209104,11423376
validation,518,307,235776,94249,13571856,13807632
validation,519,105,80640,11025,1587600,1668240
validation,520,254,195072,64516,9290304,9485376
validation,521,295,226560,87025,12531600,12758160
validation,522,123,94464,15129,2178576,2273040
validation,523,416,319488,173056,24920064,25239552
validation,524,220,168960,48400,6969600,7138560
validation,525,291,223488,84681,12194064,12417552
validation,526,184,141312,33856,4875264,5016576
validation,527,472,362496,222784,32080896,32443392
validation,528,143,109824,20449,2944656,3054480
validation,529,173,132864,29929,4309776,4442640
validation,530,221,169728,48841,7033104,7202832
validation,531,245,188160,60025,8643600,8831760
validation,532,386,296448,148996,21455424,21751872
validation,533,461,354048,212521,30603024,30957072
validation,534,338,259584,114244,16451136,16710720
validation,535,234,179712,54756,7884864,8064576
validation,536,276,211968,76176,10969344,11181312
validation,537,433,332544,187489,26998416,27330960
validation,538,381,292608,145161,20903184,21195792
validation,539,429,329472,184041,26501904,26831376
validation,540,326,250368,106276,15303744,15554112
validation,541,217,166656,47089,6780816,6947472
validation,542,360,276480,129600,18662400,18938880
validation,543,227,174336,51529,7420176,7594512
validation,544,229,175872,52441,7551504,7727376
validation,545,346,265728,119716,17239104,17504832
validation,546,233,178944,54289,7817616,7996560
validation,547,324,248832,104976,15116544,15365376
validation,548,274,210432,75076,10810944,11021376
validation,549,512,393216,262144,37748736,38141952
validation,550,274,210432,75076,10810944,11021376
validation,551,435,334080,189225,27248400,27582480
validation,552,140,107520,19600,2822400,2929920
validation,553,461,354048,212521,30603024,30957072
validation,554,240,184320,57600,8294400,8478720
validation,555,214,164352,45796,6594624,6758976
validation,556,101,77568,10201,1468944,1546512
validation,557,221,169728,48841,7033104,7202832
validation,558,140,107520,19600,2822400,2929920
validation,559,326,250368,106276,15303744,15554112
validation,560,398,305664,158404,22810176,23115840
validation,561,238,182784,56644,8156736,8339520
validation,562,108,82944,11664,1679616,1762560
validation,563,350,268800,122500,17640000,17908800
validation,564,511,392448,261121,37601424,37993872
validation,565,319,244992,101761,14653584,14898576
validation,566,384,294912,147456,21233664,21528576
validation,567,512,393216,262144,37748736,38141952
validation,568,308,236544,94864,13660416,13896960
validation,569,303,232704,91809,13220496,13453200
validation,570,512,393216,262144,37748736,38141952
validation,571,154,118272,23716,3415104,3533376
validation,572,512,393216,262144,37748736,38141952
validation,573,287,220416,82369,11861136,12081552
validation,574,399,306432,159201,22924944,23231376
validation,575,55,42240,3025,435600,477840
validation,576,221,169728,48841,7033104,7202832
validation,577,338,259584,114244,16451136,16710720
validation,578,283,217344,80089,11532816,11750160
validation,579,155,119040,24025,3459600,3578640
validation,580,170,130560,28900,4161600,4292160
validation,581,459,352512,210681,30338064,30690576
validation,582,384,294912,147456,21233664,21528576
validation,583,138,105984,19044,2742336,2848320
validation,584,241,185088,58081,8363664,8548752
validation,585,309,237312,95481,13749264,13986576
validation,586,308,236544,94864,13660416,13896960
validation,587,284,218112,80656,11614464,11832576
validation,588,226,173568,51076,7354944,7528512
validation,589,204,156672,41616,5992704,6149376
validation,590,295,226560,87025,12531600,12758160
validation,591,265,203520,70225,10112400,10315920
validation,592,151,115968,22801,3283344,3399312
validation,593,280,215040,78400,11289600,11504640
validation,594,393,301824,154449,22240656,22542480
validation,595,213,163584,45369,6533136,6696720
validation,596,377,289536,142129,20466576,20756112
validation,597,268,205824,71824,10342656,10548480
validation,598,82,62976,6724,968256,1031232
validation,599,95,72960,9025,1299600,1372560
validation,600,111,85248,12321,1774224,1859472
validation,601,221,169728,48841,7033104,7202832
validation,602,107,82176,11449,1648656,1730832
validation,603,418,321024,174724,25160256,25481280
validation,604,359,275712,128881,18558864,18834576
validation,605,160,122880,25600,3686400,3809280
validation,606,344,264192,118336,17040384,17304576
validation,607,336,258048,112896,16257024,16515072
validation,608,246,188928,60516,8714304,8903232
validation,609,255,195840,65025,9363600,9559440
validation,610,426,327168,181476,26132544,26459712
validation,611,453,347904,205209,29550096,29898000
validation,612,341,261888,116281,16744464,17006352
validation,613,140,107520,19600,2822400,2929920
validation,614,335,257280,112225,16160400,16417680
validation,615,220,168960,48400,6969600,7138560
validation,616,292,224256,85264,12278016,12502272
validation,617,124,95232,15376,2214144,2309376
validation,618,226,173568,51076,7354944,7528512
validation,619,181,139008,32761,4717584,4856592
validation,620,370,284160,136900,19713600,19997760
validation,621,323,248064,104329,15023376,15271440
validation,622,221,169728,48841,7033104,7202832
validation,623,85,65280,7225,1040400,1105680
validation,624,285,218880,81225,11696400,11915280
validation,625,451,346368,203401,29289744,29636112
validation,626,104,79872,10816,1557504,1637376
validation,627,374,287232,139876,20142144,20429376
validation,628,208,159744,43264,6230016,6389760
validation,629,416,319488,173056,24920064,25239552
validation,630,232,178176,53824,7750656,7928832
validation,631,222,170496,49284,7096896,7267392
validation,632,265,203520,70225,10112400,10315920
validation,633,494,379392,244036,35141184,35520576
validation,634,358,274944,128164,18455616,18730560
validation,635,244,187392,59536,8573184,8760576
validation,636,80,61440,6400,921600,983040
validation,637,512,393216,262144,37748736,38141952
validation,638,355,272640,126025,18147600,18420240
validation,639,512,393216,262144,37748736,38141952
validation,640,107,82176,11449,1648656,1730832
validation,641,497,381696,247009,35569296,35950992
validation,642,385,295680,148225,21344400,21640080
validation,643,158,121344,24964,3594816,3716160
validation,644,252,193536,63504,9144576,9338112
validation,645,137,105216,18769,2702736,2807952
validation,646,312,239616,97344,14017536,14257152
validation,647,312,239616,97344,14017536,14257152
validation,648,239,183552,57121,8225424,8408976
validation,649,489,375552,239121,34433424,34808976
validation,650,353,271104,124609,17943696,18214800
validation,651,385,295680,148225,21344400,21640080
validation,652,97,74496,9409,1354896,1429392
validation,653,325,249600,105625,15210000,15459600
validation,654,313,240384,97969,14107536,14347920
validation,655,406,311808,164836,23736384,24048192
validation,656,263,201984,69169,9960336,10162320
validation,657,359,275712,128881,18558864,18834576
validation,658,276,211968,76176,10969344,11181312
validation,659,369,283392,136161,19607184,19890576
validation,660,433,332544,187489,26998416,27330960
validation,661,291,223488,84681,12194064,12417552
validation,662,345,264960,119025,17139600,17404560
validation,663,177,135936,31329,4511376,4647312
validation,664,173,132864,29929,4309776,4442640
validation,665,128,98304,16384,2359296,2457600
validation,666,205,157440,42025,6051600,6209040
validation,667,396,304128,156816,22581504,22885632
validation,668,185,142080,34225,4928400,5070480
validation,669,361,277248,130321,18766224,19043472
validation,670,240,184320,57600,8294400,8478720
validation,671,315,241920,99225,14288400,14530320
test,0,212,162816,44944,6471936,6634752
test,1,280,215040,78400,11289600,11504640
test,2,206,158208,42436,6110784,6268992
test,3,231,177408,53361,7683984,7861392
test,4,243,186624,59049,8503056,8689680
test,5,479,367872,229441,33039504,33407376
test,6,473,363264,223729,32216976,32580240
test,7,376,288768,141376,20358144,20646912
test,8,512,393216,262144,37748736,38141952
test,9,512,393216,262144,37748736,38141952
test,10,278,213504,77284,11128896,11342400
test,11,348,267264,121104,17438976,17706240
test,12,226,173568,51076,7354944,7528512
test,13,141,108288,19881,2862864,2971152
test,14,109,83712,11881,1710864,1794576
test,15,230,176640,52900,7617600,7794240
test,16,231,177408,53361,7683984,7861392
test,17,179,137472,32041,4613904,4751376
test,18,229,175872,52441,7551504,7727376
test,19,433,332544,187489,26998416,27330960
test,20,278,213504,77284,11128896,11342400
test,21,160,122880,25600,3686400,3809280
test,22,351,269568,123201,17740944,18010512
test,23,512,393216,262144,37748736,38141952
test,24,380,291840,144400,20793600,21085440
test,25,397,304896,157609,22695696,23000592
test,26,427,327936,182329,26255376,26583312
test,27,233,178944,54289,7817616,7996560
test,28,162,124416,26244,3779136,3903552
test,29,76,58368,5776,831744,890112
test,30,475,364800,225625,32490000,32854800
test,31,106,81408,11236,1617984,1699392
test,32,190,145920,36100,5198400,5344320
test,33,358,274944,128164,18455616,18730560
test,34,178,136704,31684,4562496,4699200
test,35,284,218112,80656,11614464,11832576
test,36,139,106752,19321,2782224,2888976
test,37,138,105984,19044,2742336,2848320
test,38,177,135936,31329,4511376,4647312
test,39,224,172032,50176,7225344,7397376
test,40,422,324096,178084,25644096,25968192
test,41,135,103680,18225,2624400,2728080
test,42,373,286464,139129,20034576,20321040
test,43,190,145920,36100,5198400,5344320
test,44,107,82176,11449,1648656,1730832
test,45,281,215808,78961,11370384,11586192
test,46,382,293376,145924,21013056,21306432
test,47,350,268800,122500,17640000,17908800
test,48,372,285696,138384,19927296,20212992
test,49,247,189696,61009,8785296,8974992
test,50,268,205824,71824,10342656,10548480
test,51,183,140544,33489,4822416,4962960
test,52,286,219648,81796,11778624,11998272
test,53,233,178944,54289,7817616,7996560
test,54,268,205824,71824,10342656,10548480
test,55,185,142080,34225,4928400,5070480
test,56,265,203520,70225,10112400,10315920
test,57,458,351744,209764,30206016,30557760
test,58,230,176640,52900,7617600,7794240
test,59,202,155136,40804,5875776,6030912
test,60,381,292608,145161,20903184,21195792
test,61,244,187392,59536,8573184,8760576
test,62,241,185088,58081,8363664,8548752
test,63,278,213504,77284,11128896,11342400
test,64,467,358656,218089,31404816,31763472
test,65,435,334080,189225,27248400,27582480
test,66,220,168960,48400,6969600,7138560
test,67,131,100608,17161,2471184,2571792
test,68,512,393216,262144,37748736,38141952
test,69,216,165888,46656,6718464,6884352
test,70,220,168960,48400,6969600,7138560
test,71,261,200448,68121,9809424,10009872
test,72,371,284928,137641,19820304,20105232
test,73,123,94464,15129,2178576,2273040
test,74,324,248832,104976,15116544,15365376
test,75,334,256512,111556,16064064,16320576
test,76,353,271104,124609,17943696,18214800
test,77,347,266496,120409,17338896,17605392
test,78,357,274176,127449,18352656,18626832
test,79,220,168960,48400,6969600,7138560
test,80,161,123648,25921,3732624,3856272
test,81,106,81408,11236,1617984,1699392
test,82,375,288000,140625,20250000,20538000
test,83,317,243456,100489,14470416,14713872
test,84,394,302592,155236,22353984,22656576
test,85,196,150528,38416,5531904,5682432
test,86,192,147456,36864,5308416,5455872
test,87,314,241152,98596,14197824,14438976
test,88,425,326400,180625,26010000,26336400
test,89,167,128256,27889,4016016,4144272
test,90,311,238848,96721,13927824,14166672
test,91,430,330240,184900,26625600,26955840
test,92,459,352512,210681,30338064,30690576
test,93,420,322560,176400,25401600,25724160
test,94,304,233472,92416,13307904,13541376
test,95,480,368640,230400,33177600,33546240
test,96,145,111360,21025,3027600,3138960
test,97,171,131328,29241,4210704,4342032
test,98,418,321024,174724,25160256,25481280
test,99,308,236544,94864,13660416,13896960
test,100,370,284160,136900,19713600,19997760
test,101,248,190464,61504,8856576,9047040
test,102,339,260352,114921,16548624,16808976
test,103,236,181248,55696,8020224,8201472
test,104,66,50688,4356,627264,677952
test,105,367,281856,134689,19395216,19677072
test,106,338,259584,114244,16451136,16710720
test,107,312,239616,97344,14017536,14257152
test,108,287,220416,82369,11861136,12081552
test,109,467,358656,218089,31404816,31763472
test,110,250,192000,62500,9000000,9192000
test,111,419,321792,175561,25280784,25602576
test,112,399,306432,159201,22924944,23231376
test,113,354,271872,125316,18045504,18317376
test,114,422,324096,178084,25644096,25968192
test,115,323,248064,104329,15023376,15271440
test,116,402,308736,161604,23270976,23579712
test,117,217,166656,47089,6780816,6947472
test,118,512,393216,262144,37748736,38141952
test,119,222,170496,49284,7096896,7267392
test,120,233,178944,54289,7817616,7996560
test,121,329,252672,108241,15586704,15839376
test,122,357,274176,127449,18352656,18626832
test,123,411,315648,168921,24324624,24640272
test,124,171,131328,29241,4210704,4342032
test,125,378,290304,142884,20575296,20865600
test,126,81,62208,6561,944784,1006992
test,127,282,216576,79524,11451456,11668032
test,128,253,194304,64009,9217296,9411600
test,129,374,287232,139876,20142144,20429376
test,130,231,177408,53361,7683984,7861392
test,131,94,72192,8836,1272384,1344576
test,132,155,119040,24025,3459600,3578640
test,133,142,109056,20164,2903616,3012672
test,134,389,298752,151321,21790224,22088976
test,135,237,182016,56169,8088336,8270352
test,136,372,285696,138384,19927296,20212992
test,137,462,354816,213444,30735936,31090752
test,138,273,209664,74529,10732176,10941840
test,139,245,188160,60025,8643600,8831760
test,140,394,302592,155236,22353984,22656576
test,141,106,81408,11236,1617984,1699392
test,142,146,112128,21316,3069504,3181632
test,143,112,86016,12544,1806336,1892352
test,144,422,324096,178084,25644096,25968192
test,145,238,182784,56644,8156736,8339520
test,146,264,202752,69696,10036224,10238976
test,147,166,127488,27556,3968064,4095552
test,148,235,180480,55225,7952400,8132880
test,149,334,256512,111556,16064064,16320576
test,150,93,71424,8649,1245456,1316880
test,151,284,218112,80656,11614464,11832576
test,152,351,269568,123201,17740944,18010512
test,153,389,298752,151321,21790224,22088976
test,154,472,362496,222784,32080896,32443392
test,155,429,329472,184041,26501904,26831376
test,156,512,393216,262144,37748736,38141952
test,157,243,186624,59049,8503056,8689680
test,158,272,208896,73984,10653696,10862592
test,159,220,168960,48400,6969600,7138560
test,160,280,215040,78400,11289600,11504640
test,161,512,393216,262144,37748736,38141952
test,162,402,308736,161604,23270976,23579712
test,163,254,195072,64516,9290304,9485376
test,164,328,251904,107584,15492096,15744000
test,165,154,118272,23716,3415104,3533376
test,166,166,127488,27556,3968064,4095552
test,167,89,68352,7921,1140624,1208976
test,168,346,265728,119716,17239104,17504832
test,169,234,179712,54756,7884864,8064576
test,170,290,222720,84100,12110400,12333120
test,171,149,114432,22201,3196944,3311376
test,172,187,143616,34969,5035536,5179152
test,173,379,291072,143641,20684304,20975376
test,174,256,196608,65536,9437184,9633792
test,175,147,112896,21609,3111696,3224592
test,176,450,345600,202500,29160000,29505600
test,177,330,253440,108900,15681600,15935040
test,178,188,144384,35344,5089536,5233920
test,179,154,118272,23716,3415104,3533376
test,180,405,311040,164025,23619600,23930640
test,181,411,315648,168921,24324624,24640272
test,182,66,50688,4356,627264,677952
test,183,208,159744,43264,6230016,6389760
test,184,281,215808,78961,11370384,11586192
test,185,250,192000,62500,9000000,9192000
test,186,276,211968,76176,10969344,11181312
test,187,132,101376,17424,2509056,2610432
test,188,445,341760,198025,28515600,28857360
test,189,273,209664,74529,10732176,10941840
test,190,155,119040,24025,3459600,3578640
test,191,337,258816,113569,16353936,16612752
test,192,351,269568,123201,17740944,18010512
test,193,286,219648,81796,11778624,11998272
test,194,201,154368,40401,5817744,5972112
test,195,258,198144,66564,9585216,9783360
test,196,107,82176,11449,1648656,1730832
test,197,253,194304,64009,9217296,9411600
test,198,264,202752,69696,10036224,10238976
test,199,352,270336,123904,17842176,18112512
test,200,391,300288,152881,22014864,22315152
test,201,380,291840,144400,20793600,21085440
test,202,244,187392,59536,8573184,8760576
test,203,478,367104,228484,32901696,33268800
test,204,211,162048,44521,6411024,6573072
test,205,340,261120,115600,16646400,16907520
test,206,257,197376,66049,9511056,9708432
test,207,109,83712,11881,1710864,1794576
test,208,427,327936,182329,26255376,26583312
test,209,185,142080,34225,4928400,5070480
test,210,382,293376,145924,21013056,21306432
test,211,326,250368,106276,15303744,15554112
test,212,198,152064,39204,5645376,5797440
test,213,361,277248,130321,18766224,19043472
test,214,276,211968,76176,10969344,11181312
test,215,266,204288,70756,10188864,10393152
test,216,238,182784,56644,8156736,8339520
test,217,512,393216,262144,37748736,38141952
test,218,301,231168,90601,13046544,13277712
test,219,512,393216,262144,37748736,38141952
test,220,267,205056,71289,10265616,10470672
test,221,481,369408,231361,33315984,33685392
test,222,108,82944,11664,1679616,1762560
test,223,465,357120,216225,31136400,31493520
test,224,277,212736,76729,11048976,11261712
test,225,308,236544,94864,13660416,13896960
test,226,182,139776,33124,4769856,4909632
test,227,465,357120,216225,31136400,31493520
test,228,272,208896,73984,10653696,10862592
test,229,169,129792,28561,4112784,4242576
test,230,222,170496,49284,7096896,7267392
test,231,364,279552,132496,19079424,19358976
test,232,313,240384,97969,14107536,14347920
test,233,259,198912,67081,9659664,9858576
test,234,174,133632,30276,4359744,4493376
test,235,157,120576,24649,3549456,3670032
test,236,268,205824,71824,10342656,10548480
test,237,175,134400,30625,4410000,4544400
test,238,312,239616,97344,14017536,14257152
test,239,381,292608,145161,20903184,21195792
test,240,221,169728,48841,7033104,7202832
test,241,302,231936,91204,13133376,13365312
test,242,167,128256,27889,4016016,4144272
test,243,300,230400,90000,12960000,13190400
test,244,266,204288,70756,10188864,10393152
test,245,268,205824,71824,10342656,10548480
test,246,465,357120,216225,31136400,31493520
test,247,252,193536,63504,9144576,9338112
test,248,486,373248,236196,34012224,34385472
test,249,173,132864,29929,4309776,4442640
test,250,268,205824,71824,10342656,10548480
test,251,152,116736,23104,3326976,3443712
test,252,238,182784,56644,8156736,8339520
test,253,330,253440,108900,15681600,15935040
test,254,252,193536,63504,9144576,9338112
test,255,272,208896,73984,10653696,10862592
test,256,225,172800,50625,7290000,7462800
test,257,330,253440,108900,15681600,15935040
test,258,430,330240,184900,26625600,26955840
test,259,304,233472,92416,13307904,13541376
test,260,227,174336,51529,7420176,7594512
test,261,335,257280,112225,16160400,16417680
test,262,332,254976,110224,15872256,16127232
test,263,233,178944,54289,7817616,7996560
test,264,187,143616,34969,5035536,5179152
test,265,312,239616,97344,14017536,14257152
test,266,388,297984,150544,21678336,21976320
test,267,296,227328,87616,12616704,12844032
test,268,273,209664,74529,10732176,10941840
test,269,275,211200,75625,10890000,11101200
test,270,205,157440,42025,6051600,6209040
test,271,362,278016,131044,18870336,19148352
test,272,507,389376,257049,37015056,37404432
test,273,160,122880,25600,3686400,3809280
test,274,268,205824,71824,10342656,10548480
test,275,206,158208,42436,6110784,6268992
test,276,156,119808,24336,3504384,3624192
test,277,165,126720,27225,3920400,4047120
test,278,257,197376,66049,9511056,9708432
test,279,124,95232,15376,2214144,2309376
test,280,203,155904,41209,5934096,6090000
test,281,242,185856,58564,8433216,8619072
test,282,105,80640,11025,1587600,1668240
test,283,203,155904,41209,5934096,6090000
test,284,412,316416,169744,24443136,24759552
test,285,268,205824,71824,10342656,10548480
test,286,228,175104,51984,7485696,7660800
test,287,418,321024,174724,25160256,25481280
test,288,243,186624,59049,8503056,8689680
test,289,217,166656,47089,6780816,6947472
test,290,391,300288,152881,22014864,22315152
test,291,161,123648,25921,3732624,3856272
test,292,335,257280,112225,16160400,16417680
test,293,356,273408,126736,18249984,18523392
test,294,409,314112,167281,24088464,24402576
test,295,313,240384,97969,14107536,14347920
test,296,129,99072,16641,2396304,2495376
test,297,431,331008,185761,26749584,27080592
test,298,464,356352,215296,31002624,31358976
test,299,475,364800,225625,32490000,32854800
test,300,299,229632,89401,12873744,13103376
test,301,93,71424,8649,1245456,1316880
test,302,238,182784,56644,8156736,8339520
test,303,422,324096,178084,25644096,25968192
test,304,447,343296,199809,28772496,29115792
test,305,369,283392,136161,19607184,19890576
test,306,321,246528,103041,14837904,15084432
test,307,317,243456,100489,14470416,14713872
test,308,157,120576,24649,3549456,3670032
test,309,268,205824,71824,10342656,10548480
test,310,107,82176,11449,1648656,1730832
test,311,124,95232,15376,2214144,2309376
test,312,206,158208,42436,6110784,6268992
test,313,108,82944,11664,1679616,1762560
test,314,248,190464,61504,8856576,9047040
test,315,155,119040,24025,3459600,3578640
test,316,416,319488,173056,24920064,25239552
test,317,136,104448,18496,2663424,2767872
test,318,324,248832,104976,15116544,15365376
test,319,68,52224,4624,665856,718080
test,320,294,225792,86436,12446784,12672576
test,321,264,202752,69696,10036224,10238976
test,322,419,321792,175561,25280784,25602576
test,323,267,205056,71289,10265616,10470672
test,324,241,185088,58081,8363664,8548752
test,325,113,86784,12769,1838736,1925520
test,326,322,247296,103684,14930496,15177792
test,327,279,214272,77841,11209104,11423376
test,328,141,108288,19881,2862864,2971152
test,329,432,331776,186624,26873856,27205632
test,330,182,139776,33124,4769856,4909632
test,331,197,151296,38809,5588496,5739792
test,332,183,140544,33489,4822416,4962960
test,333,382,293376,145924,21013056,21306432
test,334,147,112896,21609,3111696,3224592
test,335,512,393216,262144,37748736,38141952
test,336,112,86016,12544,1806336,1892352
test,337,232,178176,53824,7750656,7928832
test,338,300,230400,90000,12960000,13190400
test,339,60,46080,3600,518400,564480
test,340,82,62976,6724,968256,1031232
test,341,196,150528,38416,5531904,5682432
test,342,213,163584,45369,6533136,6696720
test,343,308,236544,94864,13660416,13896960
test,344,310,238080,96100,13838400,14076480
test,345,239,183552,57121,8225424,8408976
test,346,293,225024,85849,12362256,12587280
test,347,426,327168,181476,26132544,26459712
test,348,332,254976,110224,15872256,16127232
test,349,226,173568,51076,7354944,7528512
test,350,253,194304,64009,9217296,9411600
test,351,189,145152,35721,5143824,5288976
test,352,357,274176,127449,18352656,18626832
test,353,368,282624,135424,19501056,19783680
test,354,178,136704,31684,4562496,4699200
test,355,512,393216,262144,37748736,38141952
test,356,343,263424,117649,16941456,17204880
test,357,165,126720,27225,3920400,4047120
test,358,266,204288,70756,10188864,10393152
test,359,431,331008,185761,26749584,27080592
test,360,281,215808,78961,11370384,11586192
test,361,344,264192,118336,17040384,17304576
test,362,91,69888,8281,1192464,1262352
test,363,269,206592,72361,10419984,10626576
test,364,62,47616,3844,553536,601152
test,365,177,135936,31329,4511376,4647312
test,366,108,82944,11664,1679616,1762560
test,367,282,216576,79524,11451456,11668032
test,368,436,334848,190096,27373824,27708672
test,369,124,95232,15376,2214144,2309376
test,370,357,274176,127449,18352656,18626832
test,371,268,205824,71824,10342656,10548480
test,372,114,87552,12996,1871424,1958976
test,373,323,248064,104329,15023376,15271440
test,374,365,280320,133225,19184400,19464720
test,375,512,393216,262144,37748736,38141952
test,376,267,205056,71289,10265616,10470672
test,377,254,195072,64516,9290304,9485376
test,378,218,167424,47524,6843456,7010880
test,379,178,136704,31684,4562496,4699200
test,380,123,94464,15129,2178576,2273040
test,381,372,285696,138384,19927296,20212992
test,382,289,221952,83521,12027024,12248976
test,383,119,91392,14161,2039184,2130576
test,384,160,122880,25600,3686400,3809280
test,385,230,176640,52900,7617600,7794240
test,386,210,161280,44100,6350400,6511680
test,387,368,282624,135424,19501056,19783680
test,388,292,224256,85264,12278016,12502272
test,389,143,109824,20449,2944656,3054480
test,390,227,174336,51529,7420176,7594512
test,391,102,78336,10404,1498176,1576512
test,392,388,297984,150544,21678336,21976320
test,393,396,304128,156816,22581504,22885632
test,394,457,350976,208849,30074256,30425232
test,395,309,237312,95481,13749264,13986576
test,396,421,323328,177241,25522704,25846032
test,397,152,116736,23104,3326976,3443712
test,398,320,245760,102400,14745600,14991360
test,399,211,162048,44521,6411024,6573072
test,400,412,316416,169744,24443136,24759552
test,401,155,119040,24025,3459600,3578640
test,402,315,241920,99225,14288400,14530320
test,403,408,313344,166464,23970816,24284160
test,404,236,181248,55696,8020224,8201472
test,405,225,172800,50625,7290000,7462800
test,406,183,140544,33489,4822416,4962960
test,407,404,310272,163216,23503104,23813376
test,408,448,344064,200704,28901376,29245440
test,409,437,335616,190969,27499536,27835152
test,410,288,221184,82944,11943936,12165120
test,411,261,200448,68121,9809424,10009872
test,412,109,83712,11881,1710864,1794576
test,413,413,317184,170569,24561936,24879120
test,414,227,174336,51529,7420176,7594512
test,415,406,311808,164836,23736384,24048192
test,416,475,364800,225625,32490000,32854800
test,417,425,326400,180625,26010000,26336400
test,418,453,347904,205209,29550096,29898000
test,419,183,140544,33489,4822416,4962960
test,420,195,149760,38025,5475600,5625360
test,421,145,111360,21025,3027600,3138960
test,422,182,139776,33124,4769856,4909632
test,423,180,138240,32400,4665600,4803840
test,424,512,393216,262144,37748736,38141952
test,425,161,123648,25921,3732624,3856272
test,426,346,265728,119716,17239104,17504832
test,427,197,151296,38809,5588496,5739792
test,428,296,227328,87616,12616704,12844032
test,429,169,129792,28561,4112784,4242576
test,430,212,162816,44944,6471936,6634752
test,431,175,134400,30625,4410000,4544400
test,432,368,282624,135424,19501056,19783680
test,433,329,252672,108241,15586704,15839376
test,434,286,219648,81796,11778624,11998272
test,435,262,201216,68644,9884736,10085952
test,436,269,206592,72361,10419984,10626576
test,437,512,393216,262144,37748736,38141952
test,438,434,333312,188356,27123264,27456576
test,439,359,275712,128881,18558864,18834576
test,440,512,393216,262144,37748736,38141952
test,441,300,230400,90000,12960000,13190400
test,442,267,205056,71289,10265616,10470672
test,443,271,208128,73441,10575504,10783632
test,444,100,76800,10000,1440000,1516800
test,445,299,229632,89401,12873744,13103376
test,446,346,265728,119716,17239104,17504832
test,447,246,188928,60516,8714304,8903232
test,448,376,288768,141376,20358144,20646912
test,449,255,195840,65025,9363600,9559440
test,450,507,389376,257049,37015056,37404432
test,451,436,334848,190096,27373824,27708672
test,452,512,393216,262144,37748736,38141952
test,453,439,337152,192721,27751824,28088976
test,454,261,200448,68121,9809424,10009872
test,455,281,215808,78961,11370384,11586192
test,456,462,354816,213444,30735936,31090752
test,457,416,319488,173056,24920064,25239552
test,458,424,325632,179776,25887744,26213376
test,459,229,175872,52441,7551504,7727376
test,460,395,303360,156025,22467600,22770960
test,461,348,267264,121104,17438976,17706240
test,462,244,187392,59536,8573184,8760576
test,463,247,189696,61009,8785296,8974992
test,464,132,101376,17424,2509056,2610432
test,465,342,262656,116964,16842816,17105472
test,466,153,117504,23409,3370896,3488400
test,467,354,271872,125316,18045504,18317376
test,468,281,215808,78961,11370384,11586192
test,469,391,300288,152881,22014864,22315152
test,470,346,265728,119716,17239104,17504832
test,471,267,205056,71289,10265616,10470672
test,472,133,102144,17689,2547216,2649360
test,473,390,299520,152100,21902400,22201920
test,474,238,182784,56644,8156736,8339520
test,475,512,393216,262144,37748736,38141952
test,476,153,117504,23409,3370896,3488400
test,477,416,319488,173056,24920064,25239552
test,478,128,98304,16384,2359296,2457600
test,479,191,146688,36481,5253264,5399952
test,480,412,316416,169744,24443136,24759552
test,481,423,324864,178929,25765776,26090640
test,482,270,207360,72900,10497600,10704960
test,483,146,112128,21316,3069504,3181632
test,484,408,313344,166464,23970816,24284160
test,485,150,115200,22500,3240000,3355200
test,486,123,94464,15129,2178576,2273040
test,487,288,221184,82944,11943936,12165120
test,488,436,334848,190096,27373824,27708672
test,489,512,393216,262144,37748736,38141952
test,490,224,172032,50176,7225344,7397376
test,491,411,315648,168921,24324624,24640272
test,492,267,205056,71289,10265616,10470672
test,493,345,264960,119025,17139600,17404560
test,494,113,86784,12769,1838736,1925520
test,495,220,168960,48400,6969600,7138560
test,496,303,232704,91809,13220496,13453200
test,497,512,393216,262144,37748736,38141952
test,498,301,231168,90601,13046544,13277712
test,499,431,331008,185761,26749584,27080592
test,500,138,105984,19044,2742336,2848320
test,501,265,203520,70225,10112400,10315920
test,502,214,164352,45796,6594624,6758976
test,503,206,158208,42436,6110784,6268992
test,504,201,154368,40401,5817744,5972112
test,505,387,297216,149769,21566736,21863952
test,506,175,134400,30625,4410000,4544400
test,507,358,274944,128164,18455616,18730560
test,508,411,315648,168921,24324624,24640272
test,509,512,393216,262144,37748736,38141952
test,510,239,183552,57121,8225424,8408976
test,511,217,166656,47089,6780816,6947472
test,512,266,204288,70756,10188864,10393152
test,513,412,316416,169744,24443136,24759552
test,514,133,102144,17689,2547216,2649360
test,515,348,267264,121104,17438976,17706240
test,516,209,160512,43681,6290064,6450576
test,517,191,146688,36481,5253264,5399952
test,518,448,344064,200704,28901376,29245440
test,519,330,253440,108900,15681600,15935040
test,520,99,76032,9801,1411344,1487376
test,521,145,111360,21025,3027600,3138960
test,522,122,93696,14884,2143296,2236992
test,523,306,235008,93636,13483584,13718592
test,524,512,393216,262144,37748736,38141952
test,525,261,200448,68121,9809424,10009872
test,526,512,393216,262144,37748736,38141952
test,527,258,198144,66564,9585216,9783360
test,528,82,62976,6724,968256,1031232
test,529,57,43776,3249,467856,511632
test,530,432,331776,186624,26873856,27205632
test,531,193,148224,37249,5363856,5512080
test,532,141,108288,19881,2862864,2971152
test,533,177,135936,31329,4511376,4647312
test,534,343,263424,117649,16941456,17204880
test,535,512,393216,262144,37748736,38141952
test,536,139,106752,19321,2782224,2888976
test,537,140,107520,19600,2822400,2929920
test,538,378,290304,142884,20575296,20865600
test,539,299,229632,89401,12873744,13103376
test,540,306,235008,93636,13483584,13718592
test,541,203,155904,41209,5934096,6090000
test,542,238,182784,56644,8156736,8339520
test,543,314,241152,98596,14197824,14438976
test,544,117,89856,13689,1971216,2061072
test,545,323,248064,104329,15023376,15271440
test,546,309,237312,95481,13749264,13986576
test,547,326,250368,106276,15303744,15554112
test,548,512,393216,262144,37748736,38141952
test,549,142,109056,20164,2903616,3012672
test,550,227,174336,51529,7420176,7594512
test,551,382,293376,145924,21013056,21306432
test,552,213,163584,45369,6533136,6696720
test,553,170,130560,28900,4161600,4292160
test,554,218,167424,47524,6843456,7010880
test,555,111,85248,12321,1774224,1859472
test,556,226,173568,51076,7354944,7528512
test,557,483,370944,233289,33593616,33964560
test,558,512,393216,262144,37748736,38141952
test,559,297,228096,88209,12702096,12930192
test,560,362,278016,131044,18870336,19148352
test,561,235,180480,55225,7952400,8132880
test,562,128,98304,16384,2359296,2457600
test,563,507,389376,257049,37015056,37404432
test,564,248,190464,61504,8856576,9047040
test,565,343,263424,117649,16941456,17204880
test,566,512,393216,262144,37748736,38141952
test,567,403,309504,162409,23386896,23696400
test,568,389,298752,151321,21790224,22088976
test,569,223,171264,49729,7160976,7332240
test,570,192,147456,36864,5308416,5455872
test,571,290,222720,84100,12110400,12333120
test,572,223,171264,49729,7160976,7332240
test,573,242,185856,58564,8433216,8619072
test,574,161,123648,25921,3732624,3856272
test,575,193,148224,37249,5363856,5512080
test,576,442,339456,195364,28132416,28471872
test,577,122,93696,14884,2143296,2236992
test,578,389,298752,151321,21790224,22088976
test,579,156,119808,24336,3504384,3624192
test,580,394,302592,155236,22353984,22656576
test,581,144,110592,20736,2985984,3096576
test,582,328,251904,107584,15492096,15744000
test,583,227,174336,51529,7420176,7594512
test,584,512,393216,262144,37748736,38141952
test,585,416,319488,173056,24920064,25239552
test,586,359,275712,128881,18558864,18834576
test,587,171,131328,29241,4210704,4342032
test,588,75,57600,5625,810000,867600
test,589,326,250368,106276,15303744,15554112
test,590,398,305664,158404,22810176,23115840
test,591,254,195072,64516,9290304,9485376
test,592,349,268032,121801,17539344,17807376
test,593,321,246528,103041,14837904,15084432
test,594,270,207360,72900,10497600,10704960
test,595,239,183552,57121,8225424,8408976
test,596,512,393216,262144,37748736,38141952
test,597,300,230400,90000,12960000,13190400
test,598,106,81408,11236,1617984,1699392
test,599,216,165888,46656,6718464,6884352
test,600,114,87552,12996,1871424,1958976
test,601,245,188160,60025,8643600,8831760
test,602,171,131328,29241,4210704,4342032
test,603,225,172800,50625,7290000,7462800
test,604,317,243456,100489,14470416,14713872
test,605,480,368640,230400,33177600,33546240
test,606,512,393216,262144,37748736,38141952
test,607,296,227328,87616,12616704,12844032
test,608,223,171264,49729,7160976,7332240
test,609,127,97536,16129,2322576,2420112
test,610,298,228864,88804,12787776,13016640
test,611,307,235776,94249,13571856,13807632
test,612,477,366336,227529,32764176,33130512
test,613,427,327936,182329,26255376,26583312
test,614,490,376320,240100,34574400,34950720
test,615,355,272640,126025,18147600,18420240
test,616,188,144384,35344,5089536,5233920
test,617,147,112896,21609,3111696,3224592
test,618,235,180480,55225,7952400,8132880
test,619,280,215040,78400,11289600,11504640
test,620,217,166656,47089,6780816,6947472
test,621,289,221952,83521,12027024,12248976
test,622,512,393216,262144,37748736,38141952
test,623,386,296448,148996,21455424,21751872
test,624,85,65280,7225,1040400,1105680
test,625,283,217344,80089,11532816,11750160
test,626,326,250368,106276,15303744,15554112
test,627,170,130560,28900,4161600,4292160
test,628,211,162048,44521,6411024,6573072
test,629,282,216576,79524,11451456,11668032
test,630,401,307968,160801,23155344,23463312
test,631,366,281088,133956,19289664,19570752
test,632,143,109824,20449,2944656,3054480
test,633,358,274944,128164,18455616,18730560
test,634,281,215808,78961,11370384,11586192
test,635,258,198144,66564,9585216,9783360
test,636,325,249600,105625,15210000,15459600
test,637,342,262656,116964,16842816,17105472
test,638,320,245760,102400,14745600,14991360
test,639,261,200448,68121,9809424,10009872
test,640,286,219648,81796,11778624,11998272
test,641,483,370944,233289,33593616,33964560
test,642,107,82176,11449,1648656,1730832
test,643,315,241920,99225,14288400,14530320
test,644,415,318720,172225,24800400,25119120
test,645,304,233472,92416,13307904,13541376
test,646,512,393216,262144,37748736,38141952
test,647,91,69888,8281,1192464,1262352
test,648,456,350208,207936,29942784,30292992
test,649,81,62208,6561,944784,1006992
test,650,147,112896,21609,3111696,3224592
test,651,442,339456,195364,28132416,28471872
test,652,315,241920,99225,14288400,14530320
test,653,182,139776,33124,4769856,4909632
test,654,171,131328,29241,4210704,4342032
test,655,455,349440,207025,29811600,30161040
test,656,466,357888,217156,31270464,31628352
test,657,459,352512,210681,30338064,30690576
test,658,328,251904,107584,15492096,15744000
test,659,228,175104,51984,7485696,7660800
test,660,339,260352,114921,16548624,16808976
test,661,274,210432,75076,10810944,11021376
test,662,314,241152,98596,14197824,14438976
test,663,352,270336,123904,17842176,18112512
test,664,305,234240,93025,13395600,13629840
test,665,329,252672,108241,15586704,15839376
test,666,392,301056,153664,22127616,22428672
test,667,253,194304,64009,9217296,9411600
test,668,512,393216,262144,37748736,38141952
test,669,265,203520,70225,10112400,10315920
test,670,269,206592,72361,10419984,10626576
test,671,319,244992,101761,14653584,14898576
test,672,399,306432,159201,22924944,23231376
test,673,360,276480,129600,18662400,18938880
test,674,471,361728,221841,31945104,32306832
test,675,229,175872,52441,7551504,7727376
test,676,242,185856,58564,8433216,8619072
test,677,264,202752,69696,10036224,10238976
test,678,455,349440,207025,29811600,30161040
test,679,199,152832,39601,5702544,5855376
test,680,162,124416,26244,3779136,3903552
test,681,247,189696,61009,8785296,8974992
test,682,392,301056,153664,22127616,22428672
test,683,369,283392,136161,19607184,19890576
test,684,255,195840,65025,9363600,9559440
test,685,512,393216,262144,37748736,38141952
test,686,206,158208,42436,6110784,6268992
test,687,244,187392,59536,8573184,8760576
test,688,197,151296,38809,5588496,5739792
test,689,215,165120,46225,6656400,6821520
test,690,496,380928,246016,35426304,35807232
test,691,227,174336,51529,7420176,7594512
test,692,378,290304,142884,20575296,20865600
test,693,277,212736,76729,11048976,11261712
test,694,241,185088,58081,8363664,8548752
test,695,359,275712,128881,18558864,18834576
test,696,440,337920,193600,27878400,28216320
test,697,229,175872,52441,7551504,7727376
test,698,500,384000,250000,36000000,36384000
test,699,408,313344,166464,23970816,24284160
test,700,348,267264,121104,17438976,17706240
test,701,230,176640,52900,7617600,7794240
test,702,274,210432,75076,10810944,11021376
test,703,255,195840,65025,9363600,9559440
test,704,456,350208,207936,29942784,30292992
test,705,280,215040,78400,11289600,11504640
test,706,306,235008,93636,13483584,13718592
test,707,124,95232,15376,2214144,2309376
test,708,147,112896,21609,3111696,3224592
test,709,202,155136,40804,5875776,6030912
test,710,183,140544,33489,4822416,4962960
test,711,191,146688,36481,5253264,5399952
test,712,466,357888,217156,31270464,31628352
test,713,109,83712,11881,1710864,1794576
test,714,354,271872,125316,18045504,18317376
test,715,125,96000,15625,2250000,2346000
test,716,206,158208,42436,6110784,6268992
test,717,89,68352,7921,1140624,1208976
test,718,150,115200,22500,3240000,3355200
test,719,91,69888,8281,1192464,1262352
test,720,166,127488,27556,3968064,4095552
test,721,275,211200,75625,10890000,11101200
test,722,132,101376,17424,2509056,2610432
test,723,256,196608,65536,9437184,9633792
test,724,320,245760,102400,14745600,14991360
test,725,246,188928,60516,8714304,8903232
test,726,339,260352,114921,16548624,16808976
test,727,402,308736,161604,23270976,23579712
test,728,134,102912,17956,2585664,2688576
test,729,304,233472,92416,13307904,13541376
test,730,426,327168,181476,26132544,26459712
test,731,305,234240,93025,13395600,13629840
test,732,512,393216,262144,37748736,38141952
test,733,225,172800,50625,7290000,7462800
test,734,208,159744,43264,6230016,6389760
test,735,139,106752,19321,2782224,2888976
test,736,93,71424,8649,1245456,1316880
test,737,283,217344,80089,11532816,11750160
test,738,131,100608,17161,2471184,2571792
test,739,480,368640,230400,33177600,33546240
test,740,107,82176,11449,1648656,1730832
test,741,512,393216,262144,37748736,38141952
test,742,449,344832,201601,29030544,29375376
test,743,185,142080,34225,4928400,5070480
test,744,98,75264,9604,1382976,1458240
test,745,311,238848,96721,13927824,14166672
test,746,111,85248,12321,1774224,1859472
test,747,205,157440,42025,6051600,6209040
test,748,273,209664,74529,10732176,10941840
test,749,160,122880,25600,3686400,3809280
test,750,512,393216,262144,37748736,38141952
test,751,348,267264,121104,17438976,17706240
test,752,287,220416,82369,11861136,12081552
test,753,311,238848,96721,13927824,14166672
test,754,168,129024,28224,4064256,4193280
test,755,488,374784,238144,34292736,34667520
test,756,268,205824,71824,10342656,10548480
test,757,320,245760,102400,14745600,14991360
test,758,167,128256,27889,4016016,4144272
test,759,151,115968,22801,3283344,3399312
test,760,287,220416,82369,11861136,12081552
test,761,168,129024,28224,4064256,4193280
test,762,297,228096,88209,12702096,12930192
test,763,329,252672,108241,15586704,15839376
test,764,417,320256,173889,25040016,25360272
test,765,204,156672,41616,5992704,6149376
test,766,182,139776,33124,4769856,4909632
test,767,87,66816,7569,1089936,1156752
test,768,104,79872,10816,1557504,1637376
test,769,268,205824,71824,10342656,10548480
test,770,210,161280,44100,6350400,6511680
test,771,185,142080,34225,4928400,5070480
test,772,392,301056,153664,22127616,22428672
test,773,494,379392,244036,35141184,35520576
test,774,274,210432,75076,10810944,11021376
test,775,118,90624,13924,2005056,2095680
test,776,117,89856,13689,1971216,2061072
test,777,290,222720,84100,12110400,12333120
test,778,325,249600,105625,15210000,15459600
test,779,94,72192,8836,1272384,1344576
test,780,425,326400,180625,26010000,26336400
test,781,512,393216,262144,37748736,38141952
test,782,324,248832,104976,15116544,15365376
test,783,93,71424,8649,1245456,1316880
test,784,345,264960,119025,17139600,17404560
test,785,311,238848,96721,13927824,14166672
test,786,293,225024,85849,12362256,12587280
test,787,224,172032,50176,7225344,7397376
test,788,492,377856,242064,34857216,35235072
test,789,303,232704,91809,13220496,13453200
test,790,176,135168,30976,4460544,4595712
test,791,117,89856,13689,1971216,2061072
test,792,292,224256,85264,12278016,12502272
test,793,426,327168,181476,26132544,26459712
test,794,511,392448,261121,37601424,37993872
test,795,86,66048,7396,1065024,1131072
test,796,207,158976,42849,6170256,6329232
test,797,143,109824,20449,2944656,3054480
test,798,323,248064,104329,15023376,15271440
test,799,184,141312,33856,4875264,5016576
test,800,169,129792,28561,4112784,4242576
test,801,512,393216,262144,37748736,38141952
test,802,284,218112,80656,11614464,11832576
test,803,238,182784,56644,8156736,8339520
test,804,205,157440,42025,6051600,6209040
test,805,246,188928,60516,8714304,8903232
test,806,400,307200,160000,23040000,23347200
test,807,349,268032,121801,17539344,17807376
test,808,400,307200,160000,23040000,23347200
test,809,288,221184,82944,11943936,12165120
test,810,240,184320,57600,8294400,8478720
test,811,51,39168,2601,374544,413712
test,812,116,89088,13456,1937664,2026752
test,813,347,266496,120409,17338896,17605392
test,814,416,319488,173056,24920064,25239552
test,815,83,63744,6889,992016,1055760
test,816,265,203520,70225,10112400,10315920
test,817,104,79872,10816,1557504,1637376
test,818,211,162048,44521,6411024,6573072
test,819,415,318720,172225,24800400,25119120
test,820,512,393216,262144,37748736,38141952
test,821,241,185088,58081,8363664,8548752
test,822,512,393216,262144,37748736,38141952
test,823,215,165120,46225,6656400,6821520
test,824,506,388608,256036,36869184,37257792
test,825,282,216576,79524,11451456,11668032
test,826,387,297216,149769,21566736,21863952
test,827,428,328704,183184,26378496,26707200
test,828,359,275712,128881,18558864,18834576
test,829,111,85248,12321,1774224,1859472
test,830,272,208896,73984,10653696,10862592
test,831,350,268800,122500,17640000,17908800
test,832,237,182016,56169,8088336,8270352
test,833,114,87552,12996,1871424,1958976
test,834,78,59904,6084,876096,936000
test,835,166,127488,27556,3968064,4095552
test,836,512,393216,262144,37748736,38141952
test,837,512,393216,262144,37748736,38141952
test,838,405,311040,164025,23619600,23930640
test,839,189,145152,35721,5143824,5288976
test,840,168,129024,28224,4064256,4193280
test,841,384,294912,147456,21233664,21528576
test,842,164,125952,26896,3873024,3998976
test,843,367,281856,134689,19395216,19677072
test,844,102,78336,10404,1498176,1576512
test,845,83,63744,6889,992016,1055760
test,846,483,370944,233289,33593616,33964560
test,847,266,204288,70756,10188864,10393152
test,848,381,292608,145161,20903184,21195792
test,849,294,225792,86436,12446784,12672576
test,850,294,225792,86436,12446784,12672576
test,851,351,269568,123201,17740944,18010512
test,852,211,162048,44521,6411024,6573072
test,853,228,175104,51984,7485696,7660800
test,854,247,189696,61009,8785296,8974992
test,855,325,249600,105625,15210000,15459600
test,856,247,189696,61009,8785296,8974992
test,857,203,155904,41209,5934096,6090000
test,858,418,321024,174724,25160256,25481280
test,859,251,192768,63001,9072144,9264912
test,860,253,194304,64009,9217296,9411600
test,861,250,192000,62500,9000000,9192000
test,862,384,294912,147456,21233664,21528576
test,863,512,393216,262144,37748736,38141952
test,864,120,92160,14400,2073600,2165760
test,865,352,270336,123904,17842176,18112512
test,866,455,349440,207025,29811600,30161040
test,867,500,384000,250000,36000000,36384000
test,868,119,91392,14161,2039184,2130576
test,869,318,244224,101124,14561856,14806080
test,870,168,129024,28224,4064256,4193280
test,871,143,109824,20449,2944656,3054480
test,872,224,172032,50176,7225344,7397376
test,873,512,393216,262144,37748736,38141952
test,874,290,222720,84100,12110400,12333120
test,875,70,53760,4900,705600,759360
test,876,471,361728,221841,31945104,32306832
test,877,111,85248,12321,1774224,1859472
test,878,314,241152,98596,14197824,14438976
test,879,179,137472,32041,4613904,4751376
test,880,436,334848,190096,27373824,27708672
test,881,261,200448,68121,9809424,10009872
test,882,188,144384,35344,5089536,5233920
test,883,431,331008,185761,26749584,27080592
test,884,289,221952,83521,12027024,12248976
test,885,395,303360,156025,22467600,22770960
test,886,275,211200,75625,10890000,11101200
test,887,453,347904,205209,29550096,29898000
test,888,97,74496,9409,1354896,1429392
test,889,319,244992,101761,14653584,14898576
test,890,119,91392,14161,2039184,2130576
test,891,273,209664,74529,10732176,10941840
test,892,434,333312,188356,27123264,27456576
test,893,387,297216,149769,21566736,21863952
test,894,301,231168,90601,13046544,13277712
test,895,144,110592,20736,2985984,3096576
test,896,361,277248,130321,18766224,19043472
test,897,367,281856,134689,19395216,19677072
test,898,128,98304,16384,2359296,2457600
test,899,399,306432,159201,22924944,23231376
test,900,425,326400,180625,26010000,26336400
test,901,228,175104,51984,7485696,7660800
test,902,216,165888,46656,6718464,6884352
test,903,398,305664,158404,22810176,23115840
test,904,161,123648,25921,3732624,3856272
test,905,391,300288,152881,22014864,22315152
test,906,181,139008,32761,4717584,4856592
test,907,148,113664,21904,3154176,3267840
test,908,163,125184,26569,3825936,3951120
test,909,88,67584,7744,1115136,1182720
test,910,373,286464,139129,20034576,20321040
test,911,247,189696,61009,8785296,8974992
test,912,185,142080,34225,4928400,5070480
test,913,250,192000,62500,9000000,9192000
test,914,239,183552,57121,8225424,8408976
test,915,293,225024,85849,12362256,12587280
test,916,289,221952,83521,12027024,12248976
test,917,91,69888,8281,1192464,1262352
test,918,350,268800,122500,17640000,17908800
test,919,285,218880,81225,11696400,11915280
test,920,306,235008,93636,13483584,13718592
test,921,171,131328,29241,4210704,4342032
test,922,344,264192,118336,17040384,17304576
test,923,177,135936,31329,4511376,4647312
test,924,258,198144,66564,9585216,9783360
test,925,85,65280,7225,1040400,1105680
test,926,256,196608,65536,9437184,9633792
test,927,397,304896,157609,22695696,23000592
test,928,245,188160,60025,8643600,8831760
test,929,115,88320,13225,1904400,1992720
test,930,287,220416,82369,11861136,12081552
test,931,166,127488,27556,3968064,4095552
test,932,273,209664,74529,10732176,10941840
test,933,409,314112,167281,24088464,24402576
test,934,195,149760,38025,5475600,5625360
test,935,224,172032,50176,7225344,7397376
test,936,259,198912,67081,9659664,9858576
test,937,512,393216,262144,37748736,38141952
test,938,400,307200,160000,23040000,23347200
test,939,213,163584,45369,6533136,6696720
test,940,243,186624,59049,8503056,8689680
test,941,303,232704,91809,13220496,13453200
test,942,92,70656,8464,1218816,1289472
test,943,512,393216,262144,37748736,38141952
test,944,492,377856,242064,34857216,35235072
test,945,409,314112,167281,24088464,24402576
test,946,175,134400,30625,4410000,4544400
test,947,277,212736,76729,11048976,11261712
test,948,349,268032,121801,17539344,17807376
test,949,288,221184,82944,11943936,12165120
test,950,215,165120,46225,6656400,6821520
test,951,225,172800,50625,7290000,7462800
test,952,457,350976,208849,30074256,30425232
test,953,353,271104,124609,17943696,18214800
test,954,293,225024,85849,12362256,12587280
test,955,404,310272,163216,23503104,23813376
test,956,194,148992,37636,5419584,5568576
test,957,327,251136,106929,15397776,15648912
test,958,310,238080,96100,13838400,14076480
test,959,156,119808,24336,3504384,3624192
test,960,273,209664,74529,10732176,10941840
test,961,153,117504,23409,3370896,3488400
test,962,273,209664,74529,10732176,10941840
test,963,244,187392,59536,8573184,8760576
test,964,217,166656,47089,6780816,6947472
test,965,230,176640,52900,7617600,7794240
test,966,169,129792,28561,4112784,4242576
test,967,444,340992,197136,28387584,28728576
test,968,359,275712,128881,18558864,18834576
test,969,276,211968,76176,10969344,11181312
test,970,170,130560,28900,4161600,4292160
test,971,315,241920,99225,14288400,14530320
test,972,238,182784,56644,8156736,8339520
test,973,158,121344,24964,3594816,3716160
test,974,196,150528,38416,5531904,5682432
test,975,510,391680,260100,37454400,37846080
test,976,189,145152,35721,5143824,5288976
test,977,163,125184,26569,3825936,3951120
test,978,367,281856,134689,19395216,19677072
test,979,442,339456,195364,28132416,28471872
test,980,304,233472,92416,13307904,13541376
test,981,273,209664,74529,10732176,10941840
test,982,458,351744,209764,30206016,30557760
test,983,396,304128,156816,22581504,22885632
test,984,411,315648,168921,24324624,24640272
test,985,75,57600,5625,810000,867600
test,986,155,119040,24025,3459600,3578640
test,987,272,208896,73984,10653696,10862592
test,988,315,241920,99225,14288400,14530320
test,989,426,327168,181476,26132544,26459712
test,990,192,147456,36864,5308416,5455872
test,991,110,84480,12100,1742400,1826880
test,992,252,193536,63504,9144576,9338112
test,993,367,281856,134689,19395216,19677072
test,994,274,210432,75076,10810944,11021376
test,995,123,94464,15129,2178576,2273040
test,996,512,393216,262144,37748736,38141952
test,997,315,241920,99225,14288400,14530320
test,998,181,139008,32761,4717584,4856592
test,999,352,270336,123904,17842176,18112512
test,1000,285,218880,81225,11696400,11915280
test,1001,215,165120,46225,6656400,6821520
test,1002,195,149760,38025,5475600,5625360
test,1003,299,229632,89401,12873744,13103376
test,1004,412,316416,169744,24443136,24759552
test,1005,198,152064,39204,5645376,5797440
test,1006,163,125184,26569,3825936,3951120
test,1007,512,393216,262144,37748736,38141952
test,1008,191,146688,36481,5253264,5399952
test,1009,320,245760,102400,14745600,14991360
test,1010,176,135168,30976,4460544,4595712
test,1011,315,241920,99225,14288400,14530320
test,1012,423,324864,178929,25765776,26090640
test,1013,266,204288,70756,10188864,10393152
test,1014,302,231936,91204,13133376,13365312
test,1015,211,162048,44521,6411024,6573072
test,1016,182,139776,33124,4769856,4909632
test,1017,322,247296,103684,14930496,15177792
test,1018,143,109824,20449,2944656,3054480
test,1019,254,195072,64516,9290304,9485376
test,1020,295,226560,87025,12531600,12758160
test,1021,269,206592,72361,10419984,10626576
test,1022,103,79104,10609,1527696,1606800
test,1023,172,132096,29584,4260096,4392192
test,1024,349,268032,121801,17539344,17807376
test,1025,408,313344,166464,23970816,24284160
test,1026,75,57600,5625,810000,867600
test,1027,253,194304,64009,9217296,9411600
test,1028,272,208896,73984,10653696,10862592
test,1029,216,165888,46656,6718464,6884352
test,1030,198,152064,39204,5645376,5797440
test,1031,89,68352,7921,1140624,1208976
test,1032,250,192000,62500,9000000,9192000
test,1033,334,256512,111556,16064064,16320576
test,1034,262,201216,68644,9884736,10085952
test,1035,199,152832,39601,5702544,5855376
test,1036,105,80640,11025,1587600,1668240
test,1037,254,195072,64516,9290304,9485376
test,1038,270,207360,72900,10497600,10704960
test,1039,94,72192,8836,1272384,1344576
test,1040,86,66048,7396,1065024,1131072
test,1041,400,307200,160000,23040000,23347200
test,1042,217,166656,47089,6780816,6947472
test,1043,199,152832,39601,5702544,5855376
test,1044,331,254208,109561,15776784,16030992
test,1045,364,279552,132496,19079424,19358976
test,1046,457,350976,208849,30074256,30425232
test,1047,457,350976,208849,30074256,30425232
test,1048,240,184320,57600,8294400,8478720
test,1049,392,301056,153664,22127616,22428672
test,1050,288,221184,82944,11943936,12165120
test,1051,252,193536,63504,9144576,9338112
test,1052,180,138240,32400,4665600,4803840
test,1053,209,160512,43681,6290064,6450576
test,1054,325,249600,105625,15210000,15459600
test,1055,329,252672,108241,15586704,15839376
test,1056,269,206592,72361,10419984,10626576
test,1057,512,393216,262144,37748736,38141952
test,1058,116,89088,13456,1937664,2026752
test,1059,116,89088,13456,1937664,2026752
test,1060,182,139776,33124,4769856,4909632
test,1061,512,393216,262144,37748736,38141952
test,1062,219,168192,47961,6906384,7074576
test,1063,512,393216,262144,37748736,38141952
test,1064,226,173568,51076,7354944,7528512
test,1065,436,334848,190096,27373824,27708672
test,1066,230,176640,52900,7617600,7794240
test,1067,197,151296,38809,5588496,5739792
test,1068,204,156672,41616,5992704,6149376
test,1069,325,249600,105625,15210000,15459600
test,1070,398,305664,158404,22810176,23115840
test,1071,247,189696,61009,8785296,8974992
test,1072,266,204288,70756,10188864,10393152
test,1073,204,156672,41616,5992704,6149376
test,1074,325,249600,105625,15210000,15459600
test,1075,512,393216,262144,37748736,38141952
test,1076,255,195840,65025,9363600,9559440
test,1077,442,339456,195364,28132416,28471872
test,1078,361,277248,130321,18766224,19043472
test,1079,512,393216,262144,37748736,38141952
test,1080,444,340992,197136,28387584,28728576
test,1081,288,221184,82944,11943936,12165120
test,1082,209,160512,43681,6290064,6450576
test,1083,388,297984,150544,21678336,21976320
test,1084,412,316416,169744,24443136,24759552
test,1085,374,287232,139876,20142144,20429376
test,1086,396,304128,156816,22581504,22885632
test,1087,497,381696,247009,35569296,35950992
test,1088,269,206592,72361,10419984,10626576
test,1089,290,222720,84100,12110400,12333120
test,1090,64,49152,4096,589824,638976
test,1091,316,242688,99856,14379264,14621952
test,1092,292,224256,85264,12278016,12502272
test,1093,83,63744,6889,992016,1055760
test,1094,347,266496,120409,17338896,17605392
test,1095,348,267264,121104,17438976,17706240
test,1096,512,393216,262144,37748736,38141952
test,1097,494,379392,244036,35141184,35520576
test,1098,343,263424,117649,16941456,17204880
test,1099,512,393216,262144,37748736,38141952
test,1100,372,285696,138384,19927296,20212992
test,1101,468,359424,219024,31539456,31898880
test,1102,135,103680,18225,2624400,2728080
test,1103,130,99840,16900,2433600,2533440
test,1104,293,225024,85849,12362256,12587280
test,1105,512,393216,262144,37748736,38141952
test,1106,283,217344,80089,11532816,11750160
test,1107,481,369408,231361,33315984,33685392
test,1108,269,206592,72361,10419984,10626576
test,1109,310,238080,96100,13838400,14076480
test,1110,385,295680,148225,21344400,21640080
test,1111,274,210432,75076,10810944,11021376
test,1112,283,217344,80089,11532816,11750160
test,1113,199,152832,39601,5702544,5855376
test,1114,441,338688,194481,28005264,28343952
test,1115,227,174336,51529,7420176,7594512
test,1116,346,265728,119716,17239104,17504832
test,1117,129,99072,16641,2396304,2495376
test,1118,409,314112,167281,24088464,24402576
test,1119,225,172800,50625,7290000,7462800
test,1120,291,223488,84681,12194064,12417552
test,1121,298,228864,88804,12787776,13016640
test,1122,321,246528,103041,14837904,15084432
test,1123,92,70656,8464,1218816,1289472
test,1124,219,168192,47961,6906384,7074576
test,1125,460,353280,211600,30470400,30823680
test,1126,182,139776,33124,4769856,4909632
test,1127,314,241152,98596,14197824,14438976
test,1128,213,163584,45369,6533136,6696720
test,1129,414,317952,171396,24681024,24998976
test,1130,392,301056,153664,22127616,22428672
test,1131,313,240384,97969,14107536,14347920
test,1132,321,246528,103041,14837904,15084432
test,1133,247,189696,61009,8785296,8974992
test,1134,390,299520,152100,21902400,22201920
test,1135,341,261888,116281,16744464,17006352
test,1136,435,334080,189225,27248400,27582480
test,1137,318,244224,101124,14561856,14806080
test,1138,390,299520,152100,21902400,22201920
test,1139,207,158976,42849,6170256,6329232
test,1140,227,174336,51529,7420176,7594512
test,1141,192,147456,36864,5308416,5455872
test,1142,307,235776,94249,13571856,13807632
test,1143,358,274944,128164,18455616,18730560
test,1144,419,321792,175561,25280784,25602576
test,1145,298,228864,88804,12787776,13016640
test,1146,512,393216,262144,37748736,38141952
test,1147,209,160512,43681,6290064,6450576
test,1148,463,355584,214369,30869136,31224720
test,1149,379,291072,143641,20684304,20975376
test,1150,410,314880,168100,24206400,24521280
test,1151,84,64512,7056,1016064,1080576
test,1152,78,59904,6084,876096,936000
test,1153,123,94464,15129,2178576,2273040
test,1154,330,253440,108900,15681600,15935040
test,1155,359,275712,128881,18558864,18834576
test,1156,360,276480,129600,18662400,18938880
test,1157,96,73728,9216,1327104,1400832
test,1158,236,181248,55696,8020224,8201472
test,1159,461,354048,212521,30603024,30957072
test,1160,383,294144,146689,21123216,21417360
test,1161,413,317184,170569,24561936,24879120
test,1162,103,79104,10609,1527696,1606800
test,1163,99,76032,9801,1411344,1487376
test,1164,209,160512,43681,6290064,6450576
test,1165,214,164352,45796,6594624,6758976
test,1166,224,172032,50176,7225344,7397376
test,1167,344,264192,118336,17040384,17304576
test,1168,145,111360,21025,3027600,3138960
test,1169,120,92160,14400,2073600,2165760
test,1170,489,375552,239121,34433424,34808976
test,1171,254,195072,64516,9290304,9485376
test,1172,196,150528,38416,5531904,5682432
test,1173,405,311040,164025,23619600,23930640
test,1174,297,228096,88209,12702096,12930192
test,1175,186,142848,34596,4981824,5124672
test,1176,380,291840,144400,20793600,21085440
test,1177,121,92928,14641,2108304,2201232
test,1178,308,236544,94864,13660416,13896960
test,1179,268,205824,71824,10342656,10548480
test,1180,199,152832,39601,5702544,5855376
test,1181,371,284928,137641,19820304,20105232
test,1182,178,136704,31684,4562496,4699200
test,1183,225,172800,50625,7290000,7462800
test,1184,153,117504,23409,3370896,3488400
test,1185,343,263424,117649,16941456,17204880
test,1186,337,258816,113569,16353936,16612752
test,1187,273,209664,74529,10732176,10941840
test,1188,214,164352,45796,6594624,6758976
test,1189,91,69888,8281,1192464,1262352
test,1190,235,180480,55225,7952400,8132880
test,1191,351,269568,123201,17740944,18010512
test,1192,348,267264,121104,17438976,17706240
test,1193,326,250368,106276,15303744,15554112
test,1194,377,289536,142129,20466576,20756112
test,1195,366,281088,133956,19289664,19570752
test,1196,321,246528,103041,14837904,15084432
test,1197,360,276480,129600,18662400,18938880
test,1198,169,129792,28561,4112784,4242576
test,1199,360,276480,129600,18662400,18938880
test,1200,349,268032,121801,17539344,17807376
test,1201,214,164352,45796,6594624,6758976
test,1202,91,69888,8281,1192464,1262352
test,1203,359,275712,128881,18558864,18834576
test,1204,292,224256,85264,12278016,12502272
test,1205,209,160512,43681,6290064,6450576
test,1206,436,334848,190096,27373824,27708672
test,1207,311,238848,96721,13927824,14166672
test,1208,346,265728,119716,17239104,17504832
test,1209,436,334848,190096,27373824,27708672
test,1210,173,132864,29929,4309776,4442640
test,1211,178,136704,31684,4562496,4699200
test,1212,512,393216,262144,37748736,38141952
test,1213,64,49152,4096,589824,638976
test,1214,404,310272,163216,23503104,23813376
test,1215,313,240384,97969,14107536,14347920
test,1216,280,215040,78400,11289600,11504640
test,1217,258,198144,66564,9585216,9783360
test,1218,266,204288,70756,10188864,10393152
test,1219,466,357888,217156,31270464,31628352
test,1220,435,334080,189225,27248400,27582480
test,1221,372,285696,138384,19927296,20212992
test,1222,239,183552,57121,8225424,8408976
test,1223,145,111360,21025,3027600,3138960
test,1224,506,388608,256036,36869184,37257792
test,1225,340,261120,115600,16646400,16907520
test,1226,442,339456,195364,28132416,28471872
test,1227,281,215808,78961,11370384,11586192
test,1228,311,238848,96721,13927824,14166672
test,1229,343,263424,117649,16941456,17204880
test,1230,512,393216,262144,37748736,38141952
test,1231,282,216576,79524,11451456,11668032
test,1232,83,63744,6889,992016,1055760
test,1233,316,242688,99856,14379264,14621952
test,1234,464,356352,215296,31002624,31358976
test,1235,40,30720,1600,230400,261120
test,1236,138,105984,19044,2742336,2848320
test,1237,97,74496,9409,1354896,1429392
test,1238,175,134400,30625,4410000,4544400
test,1239,353,271104,124609,17943696,18214800
test,1240,419,321792,175561,25280784,25602576
test,1241,463,355584,214369,30869136,31224720
test,1242,344,264192,118336,17040384,17304576
test,1243,338,259584,114244,16451136,16710720
test,1244,132,101376,17424,2509056,2610432
test,1245,90,69120,8100,1166400,1235520
test,1246,248,190464,61504,8856576,9047040
test,1247,295,226560,87025,12531600,12758160
test,1248,136,104448,18496,2663424,2767872
test,1249,452,347136,204304,29419776,29766912
test,1250,247,189696,61009,8785296,8974992
test,1251,512,393216,262144,37748736,38141952
test,1252,250,192000,62500,9000000,9192000
test,1253,366,281088,133956,19289664,19570752
test,1254,399,306432,159201,22924944,23231376
test,1255,256,196608,65536,9437184,9633792
test,1256,335,257280,112225,16160400,16417680
test,1257,207,158976,42849,6170256,6329232
test,1258,271,208128,73441,10575504,10783632
test,1259,434,333312,188356,27123264,27456576
test,1260,117,89856,13689,1971216,2061072
test,1261,205,157440,42025,6051600,6209040
test,1262,386,296448,148996,21455424,21751872
test,1263,440,337920,193600,27878400,28216320
test,1264,189,145152,35721,5143824,5288976
test,1265,276,211968,76176,10969344,11181312
test,1266,208,159744,43264,6230016,6389760
test,1267,289,221952,83521,12027024,12248976
test,1268,477,366336,227529,32764176,33130512
test,1269,312,239616,97344,14017536,14257152
test,1270,356,273408,126736,18249984,18523392
test,1271,211,162048,44521,6411024,6573072
test,1272,75,57600,5625,810000,867600
test,1273,228,175104,51984,7485696,7660800
test,1274,231,177408,53361,7683984,7861392
test,1275,298,228864,88804,12787776,13016640
test,1276,323,248064,104329,15023376,15271440
test,1277,471,361728,221841,31945104,32306832
test,1278,421,323328,177241,25522704,25846032
test,1279,358,274944,128164,18455616,18730560
test,1280,204,156672,41616,5992704,6149376
test,1281,220,168960,48400,6969600,7138560
test,1282,376,288768,141376,20358144,20646912
test,1283,251,192768,63001,9072144,9264912
test,1284,293,225024,85849,12362256,12587280
test,1285,196,150528,38416,5531904,5682432
test,1286,512,393216,262144,37748736,38141952
test,1287,101,77568,10201,1468944,1546512
test,1288,62,47616,3844,553536,601152
test,1289,294,225792,86436,12446784,12672576
test,1290,312,239616,97344,14017536,14257152
test,1291,212,162816,44944,6471936,6634752
test,1292,175,134400,30625,4410000,4544400
test,1293,334,256512,111556,16064064,16320576
test,1294,68,52224,4624,665856,718080
test,1295,211,162048,44521,6411024,6573072
test,1296,263,201984,69169,9960336,10162320
test,1297,512,393216,262144,37748736,38141952
test,1298,223,171264,49729,7160976,7332240
test,1299,291,223488,84681,12194064,12417552
test,1300,149,114432,22201,3196944,3311376
test,1301,149,114432,22201,3196944,3311376
test,1302,208,159744,43264,6230016,6389760
test,1303,93,71424,8649,1245456,1316880
test,1304,465,357120,216225,31136400,31493520
test,1305,266,204288,70756,10188864,10393152
test,1306,277,212736,76729,11048976,11261712
test,1307,70,53760,4900,705600,759360
test,1308,384,294912,147456,21233664,21528576
test,1309,321,246528,103041,14837904,15084432
test,1310,102,78336,10404,1498176,1576512
test,1311,265,203520,70225,10112400,10315920
test,1312,209,160512,43681,6290064,6450576
test,1313,351,269568,123201,17740944,18010512
test,1314,265,203520,70225,10112400,10315920
test,1315,400,307200,160000,23040000,23347200
test,1316,395,303360,156025,22467600,22770960
test,1317,369,283392,136161,19607184,19890576
test,1318,168,129024,28224,4064256,4193280
test,1319,79,60672,6241,898704,959376
test,1320,104,79872,10816,1557504,1637376
test,1321,432,331776,186624,26873856,27205632
test,1322,161,123648,25921,3732624,3856272
test,1323,418,321024,174724,25160256,25481280
test,1324,250,192000,62500,9000000,9192000
test,1325,389,298752,151321,21790224,22088976
test,1326,200,153600,40000,5760000,5913600
test,1327,187,143616,34969,5035536,5179152
test,1328,398,305664,158404,22810176,23115840
test,1329,135,103680,18225,2624400,2728080
test,1330,512,393216,262144,37748736,38141952
test,1331,452,347136,204304,29419776,29766912
test,1332,192,147456,36864,5308416,5455872
test,1333,307,235776,94249,13571856,13807632
test,1334,388,297984,150544,21678336,21976320
test,1335,243,186624,59049,8503056,8689680
test,1336,379,291072,143641,20684304,20975376
test,1337,265,203520,70225,10112400,10315920
test,1338,323,248064,104329,15023376,15271440
test,1339,355,272640,126025,18147600,18420240
test,1340,112,86016,12544,1806336,1892352
test,1341,359,275712,128881,18558864,18834576
test,1342,253,194304,64009,9217296,9411600
test,1343,378,290304,142884,20575296,20865600
test,1344,210,161280,44100,6350400,6511680
test,1345,332,254976,110224,15872256,16127232
test,1346,250,192000,62500,9000000,9192000
test,1347,143,109824,20449,2944656,3054480
test,1348,218,167424,47524,6843456,7010880
test,1349,108,82944,11664,1679616,1762560
test,1350,334,256512,111556,16064064,16320576
test,1351,229,175872,52441,7551504,7727376
test,1352,122,93696,14884,2143296,2236992
test,1353,163,125184,26569,3825936,3951120
test,1354,200,153600,40000,5760000,5913600
test,1355,512,393216,262144,37748736,38141952
test,1356,242,185856,58564,8433216,8619072
test,1357,92,70656,8464,1218816,1289472
test,1358,316,242688,99856,14379264,14621952
test,1359,220,168960,48400,6969600,7138560
test,1360,273,209664,74529,10732176,10941840
test,1361,170,130560,28900,4161600,4292160
test,1362,206,158208,42436,6110784,6268992
test,1363,214,164352,45796,6594624,6758976
test,1364,506,388608,256036,36869184,37257792
test,1365,451,346368,203401,29289744,29636112
test,1366,381,292608,145161,20903184,21195792
test,1367,346,265728,119716,17239104,17504832
test,1368,225,172800,50625,7290000,7462800
test,1369,259,198912,67081,9659664,9858576
test,1370,209,160512,43681,6290064,6450576
test,1371,224,172032,50176,7225344,7397376
test,1372,222,170496,49284,7096896,7267392
test,1373,207,158976,42849,6170256,6329232
test,1374,505,387840,255025,36723600,37111440
test,1375,267,205056,71289,10265616,10470672
test,1376,49,37632,2401,345744,383376
test,1377,512,393216,262144,37748736,38141952
test,1378,334,256512,111556,16064064,16320576
test,1379,55,42240,3025,435600,477840
test,1380,235,180480,55225,7952400,8132880
test,1381,155,119040,24025,3459600,3578640
test,1382,235,180480,55225,7952400,8132880
test,1383,109,83712,11881,1710864,1794576
test,1384,238,182784,56644,8156736,8339520
test,1385,190,145920,36100,5198400,5344320
test,1386,372,285696,138384,19927296,20212992
test,1387,178,136704,31684,4562496,4699200
test,1388,276,211968,76176,10969344,11181312
test,1389,222,170496,49284,7096896,7267392
test,1390,337,258816,113569,16353936,16612752
test,1391,380,291840,144400,20793600,21085440
test,1392,265,203520,70225,10112400,10315920
test,1393,351,269568,123201,17740944,18010512
test,1394,88,67584,7744,1115136,1182720
test,1395,429,329472,184041,26501904,26831376
test,1396,193,148224,37249,5363856,5512080
test,1397,512,393216,262144,37748736,38141952
test,1398,109,83712,11881,1710864,1794576
test,1399,339,260352,114921,16548624,16808976
test,1400,268,205824,71824,10342656,10548480
test,1401,179,137472,32041,4613904,4751376
test,1402,175,134400,30625,4410000,4544400
test,1403,308,236544,94864,13660416,13896960
test,1404,53,40704,2809,404496,445200
test,1405,212,162816,44944,6471936,6634752
test,1406,249,191232,62001,8928144,9119376
test,1407,441,338688,194481,28005264,28343952
test,1408,305,234240,93025,13395600,13629840
test,1409,154,118272,23716,3415104,3533376
test,1410,398,305664,158404,22810176,23115840
test,1411,264,202752,69696,10036224,10238976
test,1412,301,231168,90601,13046544,13277712
test,1413,341,261888,116281,16744464,17006352
test,1414,200,153600,40000,5760000,5913600
test,1415,512,393216,262144,37748736,38141952
test,1416,182,139776,33124,4769856,4909632
test,1417,431,331008,185761,26749584,27080592
test,1418,512,393216,262144,37748736,38141952
test,1419,294,225792,86436,12446784,12672576
test,1420,425,326400,180625,26010000,26336400
test,1421,262,201216,68644,9884736,10085952
test,1422,329,252672,108241,15586704,15839376
test,1423,512,393216,262144,37748736,38141952
test,1424,156,119808,24336,3504384,3624192
test,1425,512,393216,262144,37748736,38141952
test,1426,479,367872,229441,33039504,33407376
test,1427,302,231936,91204,13133376,13365312
test,1428,318,244224,101124,14561856,14806080
test,1429,297,228096,88209,12702096,12930192
test,1430,330,253440,108900,15681600,15935040
test,1431,305,234240,93025,13395600,13629840
test,1432,275,211200,75625,10890000,11101200
test,1433,356,273408,126736,18249984,18523392
test,1434,107,82176,11449,1648656,1730832
test,1435,328,251904,107584,15492096,15744000
test,1436,352,270336,123904,17842176,18112512
test,1437,275,211200,75625,10890000,11101200
test,1438,219,168192,47961,6906384,7074576
test,1439,70,53760,4900,705600,759360
test,1440,329,252672,108241,15586704,15839376
test,1441,134,102912,17956,2585664,2688576
test,1442,326,250368,106276,15303744,15554112
test,1443,122,93696,14884,2143296,2236992
test,1444,397,304896,157609,22695696,23000592
test,1445,139,106752,19321,2782224,2888976
test,1446,124,95232,15376,2214144,2309376
test,1447,271,208128,73441,10575504,10783632
test,1448,221,169728,48841,7033104,7202832
test,1449,187,143616,34969,5035536,5179152
test,1450,269,206592,72361,10419984,10626576
test,1451,124,95232,15376,2214144,2309376
test,1452,298,228864,88804,12787776,13016640
test,1453,112,86016,12544,1806336,1892352
test,1454,417,320256,173889,25040016,25360272
test,1455,512,393216,262144,37748736,38141952
test,1456,283,217344,80089,11532816,11750160
test,1457,242,185856,58564,8433216,8619072
test,1458,107,82176,11449,1648656,1730832
test,1459,176,135168,30976,4460544,4595712
test,1460,377,289536,142129,20466576,20756112
test,1461,129,99072,16641,2396304,2495376
test,1462,307,235776,94249,13571856,13807632
test,1463,512,393216,262144,37748736,38141952
test,1464,178,136704,31684,4562496,4699200
test,1465,240,184320,57600,8294400,8478720
test,1466,150,115200,22500,3240000,3355200
test,1467,383,294144,146689,21123216,21417360
test,1468,402,308736,161604,23270976,23579712
test,1469,270,207360,72900,10497600,10704960
test,1470,282,216576,79524,11451456,11668032
test,1471,431,331008,185761,26749584,27080592
test,1472,294,225792,86436,12446784,12672576
test,1473,232,178176,53824,7750656,7928832
test,1474,471,361728,221841,31945104,32306832
test,1475,150,115200,22500,3240000,3355200
test,1476,133,102144,17689,2547216,2649360
test,1477,260,199680,67600,9734400,9934080
test,1478,344,264192,118336,17040384,17304576
test,1479,257,197376,66049,9511056,9708432
test,1480,512,393216,262144,37748736,38141952
test,1481,253,194304,64009,9217296,9411600
test,1482,298,228864,88804,12787776,13016640
test,1483,435,334080,189225,27248400,27582480
test,1484,198,152064,39204,5645376,5797440
test,1485,176,135168,30976,4460544,4595712
test,1486,353,271104,124609,17943696,18214800
test,1487,466,357888,217156,31270464,31628352
test,1488,276,211968,76176,10969344,11181312
test,1489,259,198912,67081,9659664,9858576
test,1490,107,82176,11449,1648656,1730832
test,1491,91,69888,8281,1192464,1262352
test,1492,134,102912,17956,2585664,2688576
test,1493,197,151296,38809,5588496,5739792
test,1494,298,228864,88804,12787776,13016640
test,1495,380,291840,144400,20793600,21085440
test,1496,512,393216,262144,37748736,38141952
test,1497,301,231168,90601,13046544,13277712
test,1498,426,327168,181476,26132544,26459712
test,1499,356,273408,126736,18249984,18523392
test,1500,192,147456,36864,5308416,5455872
test,1501,307,235776,94249,13571856,13807632
test,1502,100,76800,10000,1440000,1516800
test,1503,290,222720,84100,12110400,12333120
test,1504,287,220416,82369,11861136,12081552
test,1505,298,228864,88804,12787776,13016640
test,1506,163,125184,26569,3825936,3951120
test,1507,512,393216,262144,37748736,38141952
test,1508,203,155904,41209,5934096,6090000
test,1509,280,215040,78400,11289600,11504640
test,1510,62,47616,3844,553536,601152
test,1511,405,311040,164025,23619600,23930640
test,1512,92,70656,8464,1218816,1289472
test,1513,146,112128,21316,3069504,3181632
test,1514,168,129024,28224,4064256,4193280
test,1515,264,202752,69696,10036224,10238976
test,1516,307,235776,94249,13571856,13807632
test,1517,251,192768,63001,9072144,9264912
test,1518,100,76800,10000,1440000,1516800
test,1519,180,138240,32400,4665600,4803840
test,1520,273,209664,74529,10732176,10941840
test,1521,335,257280,112225,16160400,16417680
test,1522,370,284160,136900,19713600,19997760
test,1523,407,312576,165649,23853456,24166032
test,1524,74,56832,5476,788544,845376
test,1525,210,161280,44100,6350400,6511680
test,1526,300,230400,90000,12960000,13190400
test,1527,299,229632,89401,12873744,13103376
test,1528,360,276480,129600,18662400,18938880
test,1529,255,195840,65025,9363600,9559440
test,1530,473,363264,223729,32216976,32580240
test,1531,353,271104,124609,17943696,18214800
test,1532,295,226560,87025,12531600,12758160
test,1533,238,182784,56644,8156736,8339520
test,1534,297,228096,88209,12702096,12930192
test,1535,346,265728,119716,17239104,17504832
test,1536,204,156672,41616,5992704,6149376
test,1537,368,282624,135424,19501056,19783680
test,1538,458,351744,209764,30206016,30557760
test,1539,313,240384,97969,14107536,14347920
test,1540,414,317952,171396,24681024,24998976
test,1541,512,393216,262144,37748736,38141952
test,1542,273,209664,74529,10732176,10941840
test,1543,328,251904,107584,15492096,15744000
test,1544,187,143616,34969,5035536,5179152
test,1545,220,168960,48400,6969600,7138560
test,1546,326,250368,106276,15303744,15554112
test,1547,286,219648,81796,11778624,11998272
test,1548,142,109056,20164,2903616,3012672
test,1549,266,204288,70756,10188864,10393152
test,1550,122,93696,14884,2143296,2236992
test,1551,444,340992,197136,28387584,28728576
test,1552,288,221184,82944,11943936,12165120
test,1553,484,371712,234256,33732864,34104576
test,1554,225,172800,50625,7290000,7462800
test,1555,273,209664,74529,10732176,10941840
test,1556,426,327168,181476,26132544,26459712
test,1557,364,279552,132496,19079424,19358976
test,1558,409,314112,167281,24088464,24402576
test,1559,167,128256,27889,4016016,4144272
test,1560,479,367872,229441,33039504,33407376
test,1561,141,108288,19881,2862864,2971152
test,1562,264,202752,69696,10036224,10238976
test,1563,304,233472,92416,13307904,13541376
test,1564,376,288768,141376,20358144,20646912
test,1565,404,310272,163216,23503104,23813376
test,1566,380,291840,144400,20793600,21085440
test,1567,214,164352,45796,6594624,6758976
test,1568,294,225792,86436,12446784,12672576
test,1569,122,93696,14884,2143296,2236992
test,1570,200,153600,40000,5760000,5913600
test,1571,256,196608,65536,9437184,9633792
test,1572,298,228864,88804,12787776,13016640
test,1573,174,133632,30276,4359744,4493376
test,1574,216,165888,46656,6718464,6884352
test,1575,112,86016,12544,1806336,1892352
test,1576,165,126720,27225,3920400,4047120
test,1577,345,264960,119025,17139600,17404560
test,1578,285,218880,81225,11696400,11915280
test,1579,340,261120,115600,16646400,16907520
test,1580,474,364032,224676,32353344,32717376
test,1581,259,198912,67081,9659664,9858576
test,1582,365,280320,133225,19184400,19464720
test,1583,512,393216,262144,37748736,38141952
test,1584,159,122112,25281,3640464,3762576
test,1585,198,152064,39204,5645376,5797440
test,1586,109,83712,11881,1710864,1794576
test,1587,307,235776,94249,13571856,13807632
test,1588,212,162816,44944,6471936,6634752
test,1589,363,278784,131769,18974736,19253520
test,1590,232,178176,53824,7750656,7928832
test,1591,488,374784,238144,34292736,34667520
test,1592,190,145920,36100,5198400,5344320
test,1593,101,77568,10201,1468944,1546512
test,1594,386,296448,148996,21455424,21751872
test,1595,379,291072,143641,20684304,20975376
test,1596,186,142848,34596,4981824,5124672
test,1597,385,295680,148225,21344400,21640080
test,1598,122,93696,14884,2143296,2236992
test,1599,217,166656,47089,6780816,6947472
test,1600,226,173568,51076,7354944,7528512
test,1601,190,145920,36100,5198400,5344320
test,1602,299,229632,89401,12873744,13103376
test,1603,358,274944,128164,18455616,18730560
test,1604,286,219648,81796,11778624,11998272
test,1605,254,195072,64516,9290304,9485376
test,1606,389,298752,151321,21790224,22088976
test,1607,382,293376,145924,21013056,21306432
test,1608,375,288000,140625,20250000,20538000
test,1609,352,270336,123904,17842176,18112512
test,1610,198,152064,39204,5645376,5797440
test,1611,224,172032,50176,7225344,7397376
test,1612,203,155904,41209,5934096,6090000
test,1613,139,106752,19321,2782224,2888976
test,1614,320,245760,102400,14745600,14991360
test,1615,139,106752,19321,2782224,2888976
test,1616,374,287232,139876,20142144,20429376
test,1617,230,176640,52900,7617600,7794240
test,1618,114,87552,12996,1871424,1958976
test,1619,253,194304,64009,9217296,9411600
test,1620,333,255744,110889,15968016,16223760
test,1621,296,227328,87616,12616704,12844032
test,1622,307,235776,94249,13571856,13807632
test,1623,270,207360,72900,10497600,10704960
test,1624,156,119808,24336,3504384,3624192
test,1625,425,326400,180625,26010000,26336400
test,1626,129,99072,16641,2396304,2495376
test,1627,293,225024,85849,12362256,12587280
test,1628,247,189696,61009,8785296,8974992
test,1629,459,352512,210681,30338064,30690576
test,1630,113,86784,12769,1838736,1925520
test,1631,243,186624,59049,8503056,8689680
test,1632,400,307200,160000,23040000,23347200
test,1633,136,104448,18496,2663424,2767872
test,1634,370,284160,136900,19713600,19997760
test,1635,242,185856,58564,8433216,8619072
test,1636,221,169728,48841,7033104,7202832
test,1637,199,152832,39601,5702544,5855376
test,1638,286,219648,81796,11778624,11998272
test,1639,290,222720,84100,12110400,12333120
test,1640,362,278016,131044,18870336,19148352
test,1641,391,300288,152881,22014864,22315152
test,1642,512,393216,262144,37748736,38141952
test,1643,154,118272,23716,3415104,3533376
test,1644,333,255744,110889,15968016,16223760
test,1645,495,380160,245025,35283600,35663760
test,1646,228,175104,51984,7485696,7660800
test,1647,452,347136,204304,29419776,29766912
test,1648,284,218112,80656,11614464,11832576
test,1649,101,77568,10201,1468944,1546512
test,1650,256,196608,65536,9437184,9633792
test,1651,231,177408,53361,7683984,7861392
test,1652,183,140544,33489,4822416,4962960
test,1653,250,192000,62500,9000000,9192000
test,1654,65,49920,4225,608400,658320
test,1655,226,173568,51076,7354944,7528512
test,1656,92,70656,8464,1218816,1289472
test,1657,238,182784,56644,8156736,8339520
test,1658,207,158976,42849,6170256,6329232
test,1659,67,51456,4489,646416,697872
test,1660,512,393216,262144,37748736,38141952
test,1661,360,276480,129600,18662400,18938880
test,1662,229,175872,52441,7551504,7727376
test,1663,428,328704,183184,26378496,26707200
test,1664,179,137472,32041,4613904,4751376
test,1665,130,99840,16900,2433600,2533440
test,1666,512,393216,262144,37748736,38141952
test,1667,187,143616,34969,5035536,5179152
test,1668,342,262656,116964,16842816,17105472
test,1669,232,178176,53824,7750656,7928832
test,1670,326,250368,106276,15303744,15554112
test,1671,125,96000,15625,2250000,2346000
test,1672,293,225024,85849,12362256,12587280
test,1673,186,142848,34596,4981824,5124672
test,1674,459,352512,210681,30338064,30690576
test,1675,249,191232,62001,8928144,9119376
test,1676,207,158976,42849,6170256,6329232
test,1677,276,211968,76176,10969344,11181312
test,1678,475,364800,225625,32490000,32854800
test,1679,279,214272,77841,11209104,11423376
test,1680,199,152832,39601,5702544,5855376
test,1681,110,84480,12100,1742400,1826880
test,1682,165,126720,27225,3920400,4047120
test,1683,212,162816,44944,6471936,6634752
test,1684,139,106752,19321,2782224,2888976
test,1685,255,195840,65025,9363600,9559440
test,1686,276,211968,76176,10969344,11181312
test,1687,242,185856,58564,8433216,8619072
test,1688,361,277248,130321,18766224,19043472
test,1689,156,119808,24336,3504384,3624192
test,1690,202,155136,40804,5875776,6030912
test,1691,261,200448,68121,9809424,10009872
test,1692,298,228864,88804,12787776,13016640
test,1693,512,393216,262144,37748736,38141952
test,1694,285,218880,81225,11696400,11915280
test,1695,445,341760,198025,28515600,28857360
test,1696,164,125952,26896,3873024,3998976
test,1697,512,393216,262144,37748736,38141952
test,1698,278,213504,77284,11128896,11342400
test,1699,101,77568,10201,1468944,1546512
test,1700,317,243456,100489,14470416,14713872
test,1701,255,195840,65025,9363600,9559440
test,1702,421,323328,177241,25522704,25846032
test,1703,304,233472,92416,13307904,13541376
test,1704,297,228096,88209,12702096,12930192
test,1705,154,118272,23716,3415104,3533376
test,1706,410,314880,168100,24206400,24521280
test,1707,381,292608,145161,20903184,21195792
test,1708,482,370176,232324,33454656,33824832
test,1709,380,291840,144400,20793600,21085440
test,1710,329,252672,108241,15586704,15839376
test,1711,323,248064,104329,15023376,15271440
test,1712,223,171264,49729,7160976,7332240
test,1713,273,209664,74529,10732176,10941840
test,1714,332,254976,110224,15872256,16127232
test,1715,152,116736,23104,3326976,3443712
test,1716,361,277248,130321,18766224,19043472
test,1717,318,244224,101124,14561856,14806080
test,1718,83,63744,6889,992016,1055760
test,1719,182,139776,33124,4769856,4909632
test,1720,160,122880,25600,3686400,3809280
test,1721,339,260352,114921,16548624,16808976
test,1722,303,232704,91809,13220496,13453200
test,1723,324,248832,104976,15116544,15365376
test,1724,512,393216,262144,37748736,38141952
test,1725,108,82944,11664,1679616,1762560
test,1726,240,184320,57600,8294400,8478720
test,1727,225,172800,50625,7290000,7462800
test,1728,472,362496,222784,32080896,32443392
test,1729,418,321024,174724,25160256,25481280
test,1730,265,203520,70225,10112400,10315920
test,1731,125,96000,15625,2250000,2346000
test,1732,220,168960,48400,6969600,7138560
test,1733,240,184320,57600,8294400,8478720
test,1734,164,125952,26896,3873024,3998976
test,1735,202,155136,40804,5875776,6030912
test,1736,55,42240,3025,435600,477840
test,1737,512,393216,262144,37748736,38141952
test,1738,208,159744,43264,6230016,6389760
test,1739,354,271872,125316,18045504,18317376
test,1740,132,101376,17424,2509056,2610432
test,1741,337,258816,113569,16353936,16612752
test,1742,325,249600,105625,15210000,15459600
test,1743,159,122112,25281,3640464,3762576
test,1744,458,351744,209764,30206016,30557760
test,1745,254,195072,64516,9290304,9485376
test,1746,229,175872,52441,7551504,7727376
test,1747,275,211200,75625,10890000,11101200
test,1748,238,182784,56644,8156736,8339520
test,1749,212,162816,44944,6471936,6634752
test,1750,417,320256,173889,25040016,25360272
test,1751,468,359424,219024,31539456,31898880
test,1752,215,165120,46225,6656400,6821520
test,1753,305,234240,93025,13395600,13629840
test,1754,111,85248,12321,1774224,1859472
test,1755,147,112896,21609,3111696,3224592
test,1756,237,182016,56169,8088336,8270352
test,1757,151,115968,22801,3283344,3399312
test,1758,276,211968,76176,10969344,11181312
test,1759,132,101376,17424,2509056,2610432
test,1760,288,221184,82944,11943936,12165120
test,1761,427,327936,182329,26255376,26583312
test,1762,241,185088,58081,8363664,8548752
test,1763,113,86784,12769,1838736,1925520
test,1764,283,217344,80089,11532816,11750160
test,1765,223,171264,49729,7160976,7332240
test,1766,338,259584,114244,16451136,16710720
test,1767,226,173568,51076,7354944,7528512
test,1768,189,145152,35721,5143824,5288976
test,1769,203,155904,41209,5934096,6090000
test,1770,196,150528,38416,5531904,5682432
test,1771,266,204288,70756,10188864,10393152
test,1772,151,115968,22801,3283344,3399312
test,1773,337,258816,113569,16353936,16612752
test,1774,100,76800,10000,1440000,1516800
test,1775,487,374016,237169,34152336,34526352
test,1776,334,256512,111556,16064064,16320576
test,1777,469,360192,219961,31674384,32034576
test,1778,411,315648,168921,24324624,24640272
test,1779,88,67584,7744,1115136,1182720
test,1780,393,301824,154449,22240656,22542480
test,1781,253,194304,64009,9217296,9411600
test,1782,185,142080,34225,4928400,5070480
test,1783,404,310272,163216,23503104,23813376
test,1784,424,325632,179776,25887744,26213376
test,1785,150,115200,22500,3240000,3355200
test,1786,306,235008,93636,13483584,13718592
test,1787,390,299520,152100,21902400,22201920
test,1788,417,320256,173889,25040016,25360272
test,1789,312,239616,97344,14017536,14257152
test,1790,122,93696,14884,2143296,2236992
test,1791,108,82944,11664,1679616,1762560
test,1792,512,393216,262144,37748736,38141952
test,1793,452,347136,204304,29419776,29766912
test,1794,153,117504,23409,3370896,3488400
test,1795,421,323328,177241,25522704,25846032
test,1796,317,243456,100489,14470416,14713872
test,1797,139,106752,19321,2782224,2888976
test,1798,70,53760,4900,705600,759360
test,1799,471,361728,221841,31945104,32306832
test,1800,302,231936,91204,13133376,13365312
test,1801,417,320256,173889,25040016,25360272
test,1802,174,133632,30276,4359744,4493376
test,1803,435,334080,189225,27248400,27582480
test,1804,346,265728,119716,17239104,17504832
test,1805,254,195072,64516,9290304,9485376
test,1806,349,268032,121801,17539344,17807376
test,1807,506,388608,256036,36869184,37257792
test,1808,320,245760,102400,14745600,14991360
test,1809,88,67584,7744,1115136,1182720
test,1810,439,337152,192721,27751824,28088976
test,1811,482,370176,232324,33454656,33824832
test,1812,295,226560,87025,12531600,12758160
test,1813,231,177408,53361,7683984,7861392
test,1814,195,149760,38025,5475600,5625360
test,1815,395,303360,156025,22467600,22770960
test,1816,181,139008,32761,4717584,4856592
test,1817,369,283392,136161,19607184,19890576
test,1818,412,316416,169744,24443136,24759552
test,1819,244,187392,59536,8573184,8760576
test,1820,139,106752,19321,2782224,2888976
test,1821,512,393216,262144,37748736,38141952
test,1822,207,158976,42849,6170256,6329232
test,1823,389,298752,151321,21790224,22088976
test,1824,263,201984,69169,9960336,10162320
test,1825,115,88320,13225,1904400,1992720
test,1826,258,198144,66564,9585216,9783360
test,1827,126,96768,15876,2286144,2382912
test,1828,238,182784,56644,8156736,8339520
test,1829,134,102912,17956,2585664,2688576
test,1830,178,136704,31684,4562496,4699200
test,1831,478,367104,228484,32901696,33268800
test,1832,423,324864,178929,25765776,26090640
test,1833,301,231168,90601,13046544,13277712
test,1834,126,96768,15876,2286144,2382912
test,1835,218,167424,47524,6843456,7010880
test,1836,387,297216,149769,21566736,21863952
test,1837,149,114432,22201,3196944,3311376
test,1838,369,283392,136161,19607184,19890576
test,1839,344,264192,118336,17040384,17304576
test,1840,282,216576,79524,11451456,11668032
test,1841,368,282624,135424,19501056,19783680
test,1842,379,291072,143641,20684304,20975376
test,1843,459,352512,210681,30338064,30690576
test,1844,218,167424,47524,6843456,7010880
test,1845,288,221184,82944,11943936,12165120
test,1846,167,128256,27889,4016016,4144272
test,1847,279,214272,77841,11209104,11423376
test,1848,373,286464,139129,20034576,20321040
test,1849,298,228864,88804,12787776,13016640
test,1850,320,245760,102400,14745600,14991360
test,1851,512,393216,262144,37748736,38141952
test,1852,368,282624,135424,19501056,19783680
test,1853,86,66048,7396,1065024,1131072
test,1854,301,231168,90601,13046544,13277712
test,1855,146,112128,21316,3069504,3181632
test,1856,326,250368,106276,15303744,15554112
test,1857,512,393216,262144,37748736,38141952
test,1858,482,370176,232324,33454656,33824832
test,1859,369,283392,136161,19607184,19890576
test,1860,211,162048,44521,6411024,6573072
test,1861,327,251136,106929,15397776,15648912
test,1862,280,215040,78400,11289600,11504640
test,1863,348,267264,121104,17438976,17706240
test,1864,107,82176,11449,1648656,1730832
test,1865,210,161280,44100,6350400,6511680
test,1866,301,231168,90601,13046544,13277712
test,1867,321,246528,103041,14837904,15084432
test,1868,445,341760,198025,28515600,28857360
test,1869,251,192768,63001,9072144,9264912
test,1870,380,291840,144400,20793600,21085440
test,1871,345,264960,119025,17139600,17404560
test,1872,161,123648,25921,3732624,3856272
test,1873,294,225792,86436,12446784,12672576
test,1874,315,241920,99225,14288400,14530320
test,1875,259,198912,67081,9659664,9858576
test,1876,165,126720,27225,3920400,4047120
test,1877,267,205056,71289,10265616,10470672
test,1878,259,198912,67081,9659664,9858576
test,1879,354,271872,125316,18045504,18317376
test,1880,219,168192,47961,6906384,7074576
test,1881,167,128256,27889,4016016,4144272
test,1882,131,100608,17161,2471184,2571792
test,1883,283,217344,80089,11532816,11750160
test,1884,257,197376,66049,9511056,9708432
test,1885,265,203520,70225,10112400,10315920
test,1886,504,387072,254016,36578304,36965376
test,1887,467,358656,218089,31404816,31763472
test,1888,396,304128,156816,22581504,22885632
test,1889,364,279552,132496,19079424,19358976
test,1890,350,268800,122500,17640000,17908800
test,1891,230,176640,52900,7617600,7794240
test,1892,189,145152,35721,5143824,5288976
test,1893,438,336384,191844,27625536,27961920
test,1894,275,211200,75625,10890000,11101200
test,1895,286,219648,81796,11778624,11998272
test,1896,181,139008,32761,4717584,4856592
test,1897,128,98304,16384,2359296,2457600
test,1898,266,204288,70756,10188864,10393152
test,1899,364,279552,132496,19079424,19358976
test,1900,222,170496,49284,7096896,7267392
test,1901,415,318720,172225,24800400,25119120
test,1902,378,290304,142884,20575296,20865600
test,1903,489,375552,239121,34433424,34808976
test,1904,251,192768,63001,9072144,9264912
test,1905,133,102144,17689,2547216,2649360
test,1906,323,248064,104329,15023376,15271440
test,1907,299,229632,89401,12873744,13103376
test,1908,326,250368,106276,15303744,15554112
test,1909,210,161280,44100,6350400,6511680
test,1910,334,256512,111556,16064064,16320576
test,1911,128,98304,16384,2359296,2457600
test,1912,512,393216,262144,37748736,38141952
test,1913,235,180480,55225,7952400,8132880
test,1914,200,153600,40000,5760000,5913600
test,1915,310,238080,96100,13838400,14076480
test,1916,407,312576,165649,23853456,24166032
test,1917,360,276480,129600,18662400,18938880
test,1918,294,225792,86436,12446784,12672576
test,1919,512,393216,262144,37748736,38141952
test,1920,246,188928,60516,8714304,8903232
test,1921,425,326400,180625,26010000,26336400
test,1922,308,236544,94864,13660416,13896960
test,1923,327,251136,106929,15397776,15648912
test,1924,288,221184,82944,11943936,12165120
test,1925,333,255744,110889,15968016,16223760
test,1926,242,185856,58564,8433216,8619072
test,1927,283,217344,80089,11532816,11750160
test,1928,151,115968,22801,3283344,3399312
test,1929,230,176640,52900,7617600,7794240
test,1930,132,101376,17424,2509056,2610432
test,1931,89,68352,7921,1140624,1208976
test,1932,330,253440,108900,15681600,15935040
test,1933,203,155904,41209,5934096,6090000
test,1934,113,86784,12769,1838736,1925520
test,1935,498,382464,248004,35712576,36095040
test,1936,281,215808,78961,11370384,11586192
test,1937,205,157440,42025,6051600,6209040
test,1938,274,210432,75076,10810944,11021376
test,1939,372,285696,138384,19927296,20212992
test,1940,273,209664,74529,10732176,10941840
test,1941,298,228864,88804,12787776,13016640
test,1942,120,92160,14400,2073600,2165760
test,1943,399,306432,159201,22924944,23231376
test,1944,368,282624,135424,19501056,19783680
test,1945,370,284160,136900,19713600,19997760
test,1946,248,190464,61504,8856576,9047040
test,1947,450,345600,202500,29160000,29505600
test,1948,342,262656,116964,16842816,17105472
test,1949,150,115200,22500,3240000,3355200
test,1950,403,309504,162409,23386896,23696400
test,1951,124,95232,15376,2214144,2309376
test,1952,326,250368,106276,15303744,15554112
test,1953,206,158208,42436,6110784,6268992
test,1954,229,175872,52441,7551504,7727376
test,1955,439,337152,192721,27751824,28088976
test,1956,374,287232,139876,20142144,20429376
test,1957,187,143616,34969,5035536,5179152
test,1958,512,393216,262144,37748736,38141952
test,1959,285,218880,81225,11696400,11915280
test,1960,227,174336,51529,7420176,7594512
test,1961,389,298752,151321,21790224,22088976
test,1962,128,98304,16384,2359296,2457600
test,1963,117,89856,13689,1971216,2061072
test,1964,331,254208,109561,15776784,16030992
test,1965,512,393216,262144,37748736,38141952
test,1966,288,221184,82944,11943936,12165120
test,1967,263,201984,69169,9960336,10162320
test,1968,306,235008,93636,13483584,13718592
test,1969,222,170496,49284,7096896,7267392
test,1970,167,128256,27889,4016016,4144272
test,1971,138,105984,19044,2742336,2848320
test,1972,257,197376,66049,9511056,9708432
test,1973,221,169728,48841,7033104,7202832
test,1974,107,82176,11449,1648656,1730832
test,1975,185,142080,34225,4928400,5070480
test,1976,106,81408,11236,1617984,1699392
test,1977,81,62208,6561,944784,1006992
test,1978,374,287232,139876,20142144,20429376
test,1979,62,47616,3844,553536,601152
test,1980,278,213504,77284,11128896,11342400
test,1981,158,121344,24964,3594816,3716160
test,1982,134,102912,17956,2585664,2688576
test,1983,118,90624,13924,2005056,2095680
test,1984,336,258048,112896,16257024,16515072
test,1985,331,254208,109561,15776784,16030992
test,1986,385,295680,148225,21344400,21640080
test,1987,512,393216,262144,37748736,38141952
test,1988,369,283392,136161,19607184,19890576
test,1989,100,76800,10000,1440000,1516800
test,1990,289,221952,83521,12027024,12248976
test,1991,349,268032,121801,17539344,17807376
test,1992,252,193536,63504,9144576,9338112
test,1993,250,192000,62500,9000000,9192000
test,1994,288,221184,82944,11943936,12165120
test,1995,205,157440,42025,6051600,6209040
test,1996,511,392448,261121,37601424,37993872
test,1997,194,148992,37636,5419584,5568576
test,1998,348,267264,121104,17438976,17706240
test,1999,342,262656,116964,16842816,17105472
test,2000,304,233472,92416,13307904,13541376
test,2001,276,211968,76176,10969344,11181312
test,2002,271,208128,73441,10575504,10783632
test,2003,312,239616,97344,14017536,14257152
test,2004,164,125952,26896,3873024,3998976
test,2005,274,210432,75076,10810944,11021376
test,2006,279,214272,77841,11209104,11423376
test,2007,105,80640,11025,1587600,1668240
test,2008,130,99840,16900,2433600,2533440
test,2009,285,218880,81225,11696400,11915280
test,2010,280,215040,78400,11289600,11504640
test,2011,259,198912,67081,9659664,9858576
test,2012,229,175872,52441,7551504,7727376
test,2013,250,192000,62500,9000000,9192000
test,2014,412,316416,169744,24443136,24759552
test,2015,176,135168,30976,4460544,4595712
test,2016,244,187392,59536,8573184,8760576
test,2017,475,364800,225625,32490000,32854800
test,2018,121,92928,14641,2108304,2201232
test,2019,350,268800,122500,17640000,17908800
test,2020,285,218880,81225,11696400,11915280
test,2021,231,177408,53361,7683984,7861392
test,2022,154,118272,23716,3415104,3533376
test,2023,408,313344,166464,23970816,24284160
test,2024,131,100608,17161,2471184,2571792
test,2025,188,144384,35344,5089536,5233920
test,2026,170,130560,28900,4161600,4292160
test,2027,340,261120,115600,16646400,16907520
test,2028,226,173568,51076,7354944,7528512
test,2029,188,144384,35344,5089536,5233920
test,2030,342,262656,116964,16842816,17105472
test,2031,344,264192,118336,17040384,17304576
test,2032,253,194304,64009,9217296,9411600
test,2033,124,95232,15376,2214144,2309376
test,2034,136,104448,18496,2663424,2767872
test,2035,305,234240,93025,13395600,13629840
test,2036,89,68352,7921,1140624,1208976
test,2037,398,305664,158404,22810176,23115840
test,2038,469,360192,219961,31674384,32034576
test,2039,404,310272,163216,23503104,23813376
test,2040,123,94464,15129,2178576,2273040
test,2041,280,215040,78400,11289600,11504640
test,2042,314,241152,98596,14197824,14438976
test,2043,107,82176,11449,1648656,1730832
test,2044,448,344064,200704,28901376,29245440
test,2045,512,393216,262144,37748736,38141952
test,2046,187,143616,34969,5035536,5179152
test,2047,297,228096,88209,12702096,12930192
test,2048,213,163584,45369,6533136,6696720
test,2049,184,141312,33856,4875264,5016576
test,2050,300,230400,90000,12960000,13190400
test,2051,226,173568,51076,7354944,7528512
test,2052,422,324096,178084,25644096,25968192
test,2053,325,249600,105625,15210000,15459600
test,2054,406,311808,164836,23736384,24048192
test,2055,143,109824,20449,2944656,3054480
test,2056,247,189696,61009,8785296,8974992
test,2057,231,177408,53361,7683984,7861392
test,2058,261,200448,68121,9809424,10009872
test,2059,246,188928,60516,8714304,8903232
test,2060,450,345600,202500,29160000,29505600
test,2061,312,239616,97344,14017536,14257152
test,2062,227,174336,51529,7420176,7594512
test,2063,222,170496,49284,7096896,7267392
test,2064,512,393216,262144,37748736,38141952
test,2065,275,211200,75625,10890000,11101200
test,2066,172,132096,29584,4260096,4392192
test,2067,255,195840,65025,9363600,9559440
test,2068,447,343296,199809,28772496,29115792
test,2069,428,328704,183184,26378496,26707200
test,2070,450,345600,202500,29160000,29505600
test,2071,233,178944,54289,7817616,7996560
test,2072,164,125952,26896,3873024,3998976
test,2073,207,158976,42849,6170256,6329232
test,2074,180,138240,32400,4665600,4803840
test,2075,246,188928,60516,8714304,8903232
test,2076,378,290304,142884,20575296,20865600
test,2077,86,66048,7396,1065024,1131072
test,2078,177,135936,31329,4511376,4647312
test,2079,183,140544,33489,4822416,4962960
test,2080,210,161280,44100,6350400,6511680
test,2081,170,130560,28900,4161600,4292160
test,2082,281,215808,78961,11370384,11586192
test,2083,107,82176,11449,1648656,1730832
test,2084,384,294912,147456,21233664,21528576
test,2085,268,205824,71824,10342656,10548480
test,2086,252,193536,63504,9144576,9338112
test,2087,322,247296,103684,14930496,15177792
test,2088,154,118272,23716,3415104,3533376
test,2089,446,342528,198916,28643904,28986432
test,2090,78,59904,6084,876096,936000
test,2091,334,256512,111556,16064064,16320576
test,2092,218,167424,47524,6843456,7010880
test,2093,157,120576,24649,3549456,3670032
test,2094,168,129024,28224,4064256,4193280
test,2095,286,219648,81796,11778624,11998272
test,2096,441,338688,194481,28005264,28343952
test,2097,390,299520,152100,21902400,22201920
test,2098,359,275712,128881,18558864,18834576
test,2099,241,185088,58081,8363664,8548752
test,2100,181,139008,32761,4717584,4856592
test,2101,459,352512,210681,30338064,30690576
test,2102,354,271872,125316,18045504,18317376
test,2103,409,314112,167281,24088464,24402576
test,2104,310,238080,96100,13838400,14076480
test,2105,76,58368,5776,831744,890112
test,2106,225,172800,50625,7290000,7462800
test,2107,494,379392,244036,35141184,35520576
test,2108,512,393216,262144,37748736,38141952
test,2109,397,304896,157609,22695696,23000592
test,2110,478,367104,228484,32901696,33268800
test,2111,256,196608,65536,9437184,9633792
test,2112,250,192000,62500,9000000,9192000
test,2113,188,144384,35344,5089536,5233920
test,2114,465,357120,216225,31136400,31493520
test,2115,345,264960,119025,17139600,17404560
test,2116,69,52992,4761,685584,738576
test,2117,277,212736,76729,11048976,11261712
test,2118,186,142848,34596,4981824,5124672
test,2119,202,155136,40804,5875776,6030912
test,2120,90,69120,8100,1166400,1235520
test,2121,512,393216,262144,37748736,38141952
test,2122,326,250368,106276,15303744,15554112
test,2123,148,113664,21904,3154176,3267840
test,2124,187,143616,34969,5035536,5179152
test,2125,407,312576,165649,23853456,24166032
test,2126,277,212736,76729,11048976,11261712
test,2127,105,80640,11025,1587600,1668240
test,2128,245,188160,60025,8643600,8831760
test,2129,274,210432,75076,10810944,11021376
test,2130,377,289536,142129,20466576,20756112
test,2131,306,235008,93636,13483584,13718592
test,2132,295,226560,87025,12531600,12758160
test,2133,125,96000,15625,2250000,2346000
test,2134,369,283392,136161,19607184,19890576
test,2135,217,166656,47089,6780816,6947472
test,2136,174,133632,30276,4359744,4493376
test,2137,307,235776,94249,13571856,13807632
test,2138,150,115200,22500,3240000,3355200
test,2139,369,283392,136161,19607184,19890576
test,2140,246,188928,60516,8714304,8903232
test,2141,264,202752,69696,10036224,10238976
test,2142,280,215040,78400,11289600,11504640
test,2143,377,289536,142129,20466576,20756112
test,2144,415,318720,172225,24800400,25119120
test,2145,337,258816,113569,16353936,16612752
test,2146,224,172032,50176,7225344,7397376
test,2147,331,254208,109561,15776784,16030992
test,2148,414,317952,171396,24681024,24998976
test,2149,227,174336,51529,7420176,7594512
test,2150,246,188928,60516,8714304,8903232
test,2151,443,340224,196249,28259856,28600080
test,2152,245,188160,60025,8643600,8831760
test,2153,285,218880,81225,11696400,11915280
test,2154,178,136704,31684,4562496,4699200
test,2155,489,375552,239121,34433424,34808976
test,2156,343,263424,117649,16941456,17204880
test,2157,512,393216,262144,37748736,38141952
test,2158,97,74496,9409,1354896,1429392
test,2159,230,176640,52900,7617600,7794240
test,2160,238,182784,56644,8156736,8339520
test,2161,449,344832,201601,29030544,29375376
test,2162,446,342528,198916,28643904,28986432
test,2163,321,246528,103041,14837904,15084432
test,2164,292,224256,85264,12278016,12502272
test,2165,243,186624,59049,8503056,8689680
test,2166,395,303360,156025,22467600,22770960
test,2167,306,235008,93636,13483584,13718592
test,2168,512,393216,262144,37748736,38141952
test,2169,276,211968,76176,10969344,11181312
test,2170,288,221184,82944,11943936,12165120
test,2171,486,373248,236196,34012224,34385472
test,2172,329,252672,108241,15586704,15839376
test,2173,290,222720,84100,12110400,12333120
test,2174,268,205824,71824,10342656,10548480
test,2175,512,393216,262144,37748736,38141952
test,2176,268,205824,71824,10342656,10548480
test,2177,112,86016,12544,1806336,1892352
test,2178,449,344832,201601,29030544,29375376
test,2179,316,242688,99856,14379264,14621952
test,2180,117,89856,13689,1971216,2061072
test,2181,339,260352,114921,16548624,16808976
test,2182,192,147456,36864,5308416,5455872
test,2183,494,379392,244036,35141184,35520576
test,2184,355,272640,126025,18147600,18420240
test,2185,336,258048,112896,16257024,16515072
test,2186,512,393216,262144,37748736,38141952
test,2187,216,165888,46656,6718464,6884352
test,2188,388,297984,150544,21678336,21976320
test,2189,260,199680,67600,9734400,9934080
test,2190,196,150528,38416,5531904,5682432
test,2191,168,129024,28224,4064256,4193280
test,2192,165,126720,27225,3920400,4047120
test,2193,289,221952,83521,12027024,12248976
test,2194,118,90624,13924,2005056,2095680
test,2195,416,319488,173056,24920064,25239552
test,2196,336,258048,112896,16257024,16515072
test,2197,251,192768,63001,9072144,9264912
test,2198,411,315648,168921,24324624,24640272
test,2199,207,158976,42849,6170256,6329232
test,2200,232,178176,53824,7750656,7928832
test,2201,171,131328,29241,4210704,4342032
test,2202,111,85248,12321,1774224,1859472
test,2203,95,72960,9025,1299600,1372560
test,2204,212,162816,44944,6471936,6634752
test,2205,267,205056,71289,10265616,10470672
test,2206,250,192000,62500,9000000,9192000
test,2207,350,268800,122500,17640000,17908800
test,2208,406,311808,164836,23736384,24048192
test,2209,158,121344,24964,3594816,3716160
test,2210,264,202752,69696,10036224,10238976
test,2211,227,174336,51529,7420176,7594512
test,2212,299,229632,89401,12873744,13103376
test,2213,285,218880,81225,11696400,11915280
test,2214,195,149760,38025,5475600,5625360
test,2215,99,76032,9801,1411344,1487376
test,2216,205,157440,42025,6051600,6209040
test,2217,105,80640,11025,1587600,1668240
test,2218,293,225024,85849,12362256,12587280
test,2219,419,321792,175561,25280784,25602576
test,2220,434,333312,188356,27123264,27456576
test,2221,485,372480,235225,33872400,34244880
test,2222,238,182784,56644,8156736,8339520
test,2223,197,151296,38809,5588496,5739792
test,2224,312,239616,97344,14017536,14257152
test,2225,45,34560,2025,291600,326160
test,2226,254,195072,64516,9290304,9485376
test,2227,512,393216,262144,37748736,38141952
test,2228,212,162816,44944,6471936,6634752
test,2229,312,239616,97344,14017536,14257152
test,2230,350,268800,122500,17640000,17908800
test,2231,90,69120,8100,1166400,1235520
test,2232,190,145920,36100,5198400,5344320
test,2233,294,225792,86436,12446784,12672576
test,2234,373,286464,139129,20034576,20321040
test,2235,207,158976,42849,6170256,6329232
test,2236,302,231936,91204,13133376,13365312
test,2237,431,331008,185761,26749584,27080592
test,2238,287,220416,82369,11861136,12081552
test,2239,340,261120,115600,16646400,16907520
test,2240,112,86016,12544,1806336,1892352
test,2241,243,186624,59049,8503056,8689680
test,2242,329,252672,108241,15586704,15839376
test,2243,325,249600,105625,15210000,15459600
test,2244,134,102912,17956,2585664,2688576
test,2245,151,115968,22801,3283344,3399312
test,2246,468,359424,219024,31539456,31898880
test,2247,345,264960,119025,17139600,17404560
test,2248,258,198144,66564,9585216,9783360
test,2249,319,244992,101761,14653584,14898576
test,2250,374,287232,139876,20142144,20429376
test,2251,96,73728,9216,1327104,1400832
test,2252,322,247296,103684,14930496,15177792
test,2253,290,222720,84100,12110400,12333120
test,2254,179,137472,32041,4613904,4751376
test,2255,464,356352,215296,31002624,31358976
test,2256,194,148992,37636,5419584,5568576
test,2257,183,140544,33489,4822416,4962960
test,2258,323,248064,104329,15023376,15271440
test,2259,141,108288,19881,2862864,2971152
test,2260,304,233472,92416,13307904,13541376
test,2261,197,151296,38809,5588496,5739792
test,2262,205,157440,42025,6051600,6209040
test,2263,428,328704,183184,26378496,26707200
test,2264,398,305664,158404,22810176,23115840
test,2265,108,82944,11664,1679616,1762560
test,2266,512,393216,262144,37748736,38141952
test,2267,159,122112,25281,3640464,3762576
test,2268,282,216576,79524,11451456,11668032
test,2269,149,114432,22201,3196944,3311376
test,2270,494,379392,244036,35141184,35520576
test,2271,349,268032,121801,17539344,17807376
test,2272,460,353280,211600,30470400,30823680
test,2273,215,165120,46225,6656400,6821520
test,2274,423,324864,178929,25765776,26090640
test,2275,263,201984,69169,9960336,10162320
test,2276,512,393216,262144,37748736,38141952
test,2277,413,317184,170569,24561936,24879120
test,2278,345,264960,119025,17139600,17404560
test,2279,173,132864,29929,4309776,4442640
test,2280,512,393216,262144,37748736,38141952
test,2281,314,241152,98596,14197824,14438976
test,2282,512,393216,262144,37748736,38141952
test,2283,400,307200,160000,23040000,23347200
test,2284,234,179712,54756,7884864,8064576
test,2285,342,262656,116964,16842816,17105472
test,2286,171,131328,29241,4210704,4342032
test,2287,468,359424,219024,31539456,31898880
test,2288,220,168960,48400,6969600,7138560
test,2289,155,119040,24025,3459600,3578640
test,2290,283,217344,80089,11532816,11750160
test,2291,300,230400,90000,12960000,13190400
test,2292,227,174336,51529,7420176,7594512
test,2293,399,306432,159201,22924944,23231376
test,2294,332,254976,110224,15872256,16127232
test,2295,211,162048,44521,6411024,6573072
test,2296,342,262656,116964,16842816,17105472
test,2297,262,201216,68644,9884736,10085952
test,2298,366,281088,133956,19289664,19570752
test,2299,249,191232,62001,8928144,9119376
test,2300,317,243456,100489,14470416,14713872
test,2301,120,92160,14400,2073600,2165760
test,2302,383,294144,146689,21123216,21417360
test,2303,130,99840,16900,2433600,2533440
test,2304,350,268800,122500,17640000,17908800
test,2305,395,303360,156025,22467600,22770960
test,2306,469,360192,219961,31674384,32034576
test,2307,214,164352,45796,6594624,6758976
test,2308,109,83712,11881,1710864,1794576
test,2309,488,374784,238144,34292736,34667520
test,2310,512,393216,262144,37748736,38141952
test,2311,455,349440,207025,29811600,30161040
test,2312,254,195072,64516,9290304,9485376
test,2313,300,230400,90000,12960000,13190400
test,2314,289,221952,83521,12027024,12248976
test,2315,302,231936,91204,13133376,13365312
test,2316,201,154368,40401,5817744,5972112
test,2317,312,239616,97344,14017536,14257152
test,2318,483,370944,233289,33593616,33964560
test,2319,134,102912,17956,2585664,2688576
test,2320,382,293376,145924,21013056,21306432
test,2321,416,319488,173056,24920064,25239552
test,2322,217,166656,47089,6780816,6947472
test,2323,359,275712,128881,18558864,18834576
test,2324,107,82176,11449,1648656,1730832
test,2325,464,356352,215296,31002624,31358976
test,2326,229,175872,52441,7551504,7727376
test,2327,188,144384,35344,5089536,5233920
test,2328,361,277248,130321,18766224,19043472
test,2329,238,182784,56644,8156736,8339520
test,2330,235,180480,55225,7952400,8132880
test,2331,307,235776,94249,13571856,13807632
test,2332,173,132864,29929,4309776,4442640
test,2333,358,274944,128164,18455616,18730560
test,2334,313,240384,97969,14107536,14347920
test,2335,144,110592,20736,2985984,3096576
test,2336,259,198912,67081,9659664,9858576
test,2337,121,92928,14641,2108304,2201232
test,2338,349,268032,121801,17539344,17807376
test,2339,306,235008,93636,13483584,13718592
test,2340,123,94464,15129,2178576,2273040
test,2341,368,282624,135424,19501056,19783680
test,2342,238,182784,56644,8156736,8339520
test,2343,166,127488,27556,3968064,4095552
test,2344,197,151296,38809,5588496,5739792
test,2345,311,238848,96721,13927824,14166672
test,2346,302,231936,91204,13133376,13365312
test,2347,372,285696,138384,19927296,20212992
test,2348,215,165120,46225,6656400,6821520
test,2349,208,159744,43264,6230016,6389760
test,2350,454,348672,206116,29680704,30029376
test,2351,188,144384,35344,5089536,5233920
test,2352,297,228096,88209,12702096,12930192
test,2353,324,248832,104976,15116544,15365376
test,2354,296,227328,87616,12616704,12844032
test,2355,295,226560,87025,12531600,12758160
test,2356,251,192768,63001,9072144,9264912
test,2357,477,366336,227529,32764176,33130512
test,2358,173,132864,29929,4309776,4442640
test,2359,185,142080,34225,4928400,5070480
test,2360,363,278784,131769,18974736,19253520
test,2361,328,251904,107584,15492096,15744000
test,2362,317,243456,100489,14470416,14713872
test,2363,512,393216,262144,37748736,38141952
test,2364,224,172032,50176,7225344,7397376
test,2365,193,148224,37249,5363856,5512080
test,2366,349,268032,121801,17539344,17807376
test,2367,269,206592,72361,10419984,10626576
test,2368,479,367872,229441,33039504,33407376
test,2369,218,167424,47524,6843456,7010880
test,2370,242,185856,58564,8433216,8619072
test,2371,76,58368,5776,831744,890112
test,2372,288,221184,82944,11943936,12165120
test,2373,84,64512,7056,1016064,1080576
test,2374,212,162816,44944,6471936,6634752
test,2375,197,151296,38809,5588496,5739792
test,2376,290,222720,84100,12110400,12333120
test,2377,101,77568,10201,1468944,1546512
test,2378,400,307200,160000,23040000,23347200
test,2379,164,125952,26896,3873024,3998976
test,2380,255,195840,65025,9363600,9559440
test,2381,334,256512,111556,16064064,16320576
test,2382,424,325632,179776,25887744,26213376
test,2383,332,254976,110224,15872256,16127232
test,2384,317,243456,100489,14470416,14713872
test,2385,143,109824,20449,2944656,3054480
test,2386,253,194304,64009,9217296,9411600
test,2387,292,224256,85264,12278016,12502272
test,2388,371,284928,137641,19820304,20105232
test,2389,200,153600,40000,5760000,5913600
test,2390,512,393216,262144,37748736,38141952
test,2391,512,393216,262144,37748736,38141952
test,2392,214,164352,45796,6594624,6758976
test,2393,183,140544,33489,4822416,4962960
test,2394,184,141312,33856,4875264,5016576
test,2395,281,215808,78961,11370384,11586192
test,2396,228,175104,51984,7485696,7660800
test,2397,512,393216,262144,37748736,38141952
test,2398,360,276480,129600,18662400,18938880
test,2399,448,344064,200704,28901376,29245440
test,2400,234,179712,54756,7884864,8064576
test,2401,415,318720,172225,24800400,25119120
test,2402,456,350208,207936,29942784,30292992
test,2403,360,276480,129600,18662400,18938880
test,2404,208,159744,43264,6230016,6389760
test,2405,286,219648,81796,11778624,11998272
test,2406,230,176640,52900,7617600,7794240
test,2407,377,289536,142129,20466576,20756112
test,2408,441,338688,194481,28005264,28343952
test,2409,372,285696,138384,19927296,20212992
test,2410,249,191232,62001,8928144,9119376
test,2411,173,132864,29929,4309776,4442640
test,2412,275,211200,75625,10890000,11101200
test,2413,391,300288,152881,22014864,22315152
test,2414,453,347904,205209,29550096,29898000
test,2415,459,352512,210681,30338064,30690576
test,2416,279,214272,77841,11209104,11423376
test,2417,416,319488,173056,24920064,25239552
test,2418,512,393216,262144,37748736,38141952
test,2419,218,167424,47524,6843456,7010880
test,2420,267,205056,71289,10265616,10470672
test,2421,166,127488,27556,3968064,4095552
test,2422,331,254208,109561,15776784,16030992
test,2423,176,135168,30976,4460544,4595712
test,2424,232,178176,53824,7750656,7928832
test,2425,382,293376,145924,21013056,21306432
test,2426,400,307200,160000,23040000,23347200
test,2427,426,327168,181476,26132544,26459712
test,2428,310,238080,96100,13838400,14076480
test,2429,402,308736,161604,23270976,23579712
test,2430,512,393216,262144,37748736,38141952
test,2431,352,270336,123904,17842176,18112512
test,2432,512,393216,262144,37748736,38141952
test,2433,295,226560,87025,12531600,12758160
test,2434,211,162048,44521,6411024,6573072
test,2435,336,258048,112896,16257024,16515072
test,2436,248,190464,61504,8856576,9047040
test,2437,136,104448,18496,2663424,2767872
test,2438,395,303360,156025,22467600,22770960
test,2439,117,89856,13689,1971216,2061072
test,2440,458,351744,209764,30206016,30557760
test,2441,469,360192,219961,31674384,32034576
test,2442,371,284928,137641,19820304,20105232
test,2443,407,312576,165649,23853456,24166032
test,2444,207,158976,42849,6170256,6329232
test,2445,94,72192,8836,1272384,1344576
test,2446,371,284928,137641,19820304,20105232
test,2447,435,334080,189225,27248400,27582480
test,2448,257,197376,66049,9511056,9708432
test,2449,182,139776,33124,4769856,4909632
test,2450,169,129792,28561,4112784,4242576
test,2451,428,328704,183184,26378496,26707200
test,2452,156,119808,24336,3504384,3624192
test,2453,86,66048,7396,1065024,1131072
test,2454,402,308736,161604,23270976,23579712
test,2455,223,171264,49729,7160976,7332240
test,2456,202,155136,40804,5875776,6030912
test,2457,135,103680,18225,2624400,2728080
test,2458,291,223488,84681,12194064,12417552
test,2459,496,380928,246016,35426304,35807232
test,2460,219,168192,47961,6906384,7074576
test,2461,314,241152,98596,14197824,14438976
test,2462,317,243456,100489,14470416,14713872
test,2463,325,249600,105625,15210000,15459600
test,2464,512,393216,262144,37748736,38141952
test,2465,253,194304,64009,9217296,9411600
test,2466,261,200448,68121,9809424,10009872
test,2467,302,231936,91204,13133376,13365312
test,2468,79,60672,6241,898704,959376
test,2469,512,393216,262144,37748736,38141952
test,2470,323,248064,104329,15023376,15271440
test,2471,290,222720,84100,12110400,12333120
test,2472,169,129792,28561,4112784,4242576
test,2473,137,105216,18769,2702736,2807952
test,2474,232,178176,53824,7750656,7928832
test,2475,424,325632,179776,25887744,26213376
test,2476,249,191232,62001,8928144,9119376
test,2477,185,142080,34225,4928400,5070480
test,2478,286,219648,81796,11778624,11998272
test,2479,147,112896,21609,3111696,3224592
test,2480,285,218880,81225,11696400,11915280
test,2481,120,92160,14400,2073600,2165760
test,2482,246,188928,60516,8714304,8903232
test,2483,267,205056,71289,10265616,10470672
test,2484,333,255744,110889,15968016,16223760
test,2485,411,315648,168921,24324624,24640272
test,2486,373,286464,139129,20034576,20321040
test,2487,447,343296,199809,28772496,29115792
test,2488,320,245760,102400,14745600,14991360
test,2489,195,149760,38025,5475600,5625360
test,2490,375,288000,140625,20250000,20538000
test,2491,340,261120,115600,16646400,16907520
test,2492,83,63744,6889,992016,1055760
test,2493,218,167424,47524,6843456,7010880
test,2494,400,307200,160000,23040000,23347200
test,2495,512,393216,262144,37748736,38141952
test,2496,459,352512,210681,30338064,30690576
test,2497,392,301056,153664,22127616,22428672
test,2498,185,142080,34225,4928400,5070480
test,2499,401,307968,160801,23155344,23463312
test,2500,176,135168,30976,4460544,4595712
test,2501,117,89856,13689,1971216,2061072
test,2502,299,229632,89401,12873744,13103376
test,2503,352,270336,123904,17842176,18112512
test,2504,163,125184,26569,3825936,3951120
test,2505,282,216576,79524,11451456,11668032
test,2506,143,109824,20449,2944656,3054480
test,2507,250,192000,62500,9000000,9192000
test,2508,430,330240,184900,26625600,26955840
test,2509,58,44544,3364,484416,528960
test,2510,240,184320,57600,8294400,8478720
test,2511,494,379392,244036,35141184,35520576
test,2512,303,232704,91809,13220496,13453200
test,2513,336,258048,112896,16257024,16515072
test,2514,183,140544,33489,4822416,4962960
test,2515,386,296448,148996,21455424,21751872
test,2516,88,67584,7744,1115136,1182720
test,2517,398,305664,158404,22810176,23115840
test,2518,213,163584,45369,6533136,6696720
test,2519,120,92160,14400,2073600,2165760
test,2520,180,138240,32400,4665600,4803840
test,2521,490,376320,240100,34574400,34950720
test,2522,140,107520,19600,2822400,2929920
test,2523,244,187392,59536,8573184,8760576
test,2524,460,353280,211600,30470400,30823680
test,2525,240,184320,57600,8294400,8478720
test,2526,257,197376,66049,9511056,9708432
test,2527,141,108288,19881,2862864,2971152
test,2528,512,393216,262144,37748736,38141952
test,2529,118,90624,13924,2005056,2095680
test,2530,254,195072,64516,9290304,9485376
test,2531,63,48384,3969,571536,619920
test,2532,242,185856,58564,8433216,8619072
test,2533,249,191232,62001,8928144,9119376
test,2534,251,192768,63001,9072144,9264912
test,2535,303,232704,91809,13220496,13453200
test,2536,116,89088,13456,1937664,2026752
test,2537,255,195840,65025,9363600,9559440
test,2538,317,243456,100489,14470416,14713872
test,2539,252,193536,63504,9144576,9338112
test,2540,193,148224,37249,5363856,5512080
test,2541,322,247296,103684,14930496,15177792
test,2542,509,390912,259081,37307664,37698576
test,2543,274,210432,75076,10810944,11021376
test,2544,403,309504,162409,23386896,23696400
test,2545,476,365568,226576,32626944,32992512
test,2546,383,294144,146689,21123216,21417360
test,2547,139,106752,19321,2782224,2888976
test,2548,316,242688,99856,14379264,14621952
test,2549,325,249600,105625,15210000,15459600
test,2550,426,327168,181476,26132544,26459712
test,2551,100,76800,10000,1440000,1516800
test,2552,356,273408,126736,18249984,18523392
test,2553,179,137472,32041,4613904,4751376
test,2554,170,130560,28900,4161600,4292160
test,2555,486,373248,236196,34012224,34385472
test,2556,295,226560,87025,12531600,12758160
test,2557,402,308736,161604,23270976,23579712
test,2558,199,152832,39601,5702544,5855376
test,2559,197,151296,38809,5588496,5739792
test,2560,372,285696,138384,19927296,20212992
test,2561,232,178176,53824,7750656,7928832
test,2562,269,206592,72361,10419984,10626576
test,2563,163,125184,26569,3825936,3951120
test,2564,173,132864,29929,4309776,4442640
test,2565,193,148224,37249,5363856,5512080
test,2566,312,239616,97344,14017536,14257152
test,2567,345,264960,119025,17139600,17404560
test,2568,230,176640,52900,7617600,7794240
test,2569,320,245760,102400,14745600,14991360
test,2570,281,215808,78961,11370384,11586192
test,2571,162,124416,26244,3779136,3903552
test,2572,76,58368,5776,831744,890112
test,2573,463,355584,214369,30869136,31224720
test,2574,454,348672,206116,29680704,30029376
test,2575,155,119040,24025,3459600,3578640
test,2576,298,228864,88804,12787776,13016640
test,2577,71,54528,5041,725904,780432
test,2578,215,165120,46225,6656400,6821520
test,2579,222,170496,49284,7096896,7267392
test,2580,422,324096,178084,25644096,25968192
test,2581,211,162048,44521,6411024,6573072
test,2582,326,250368,106276,15303744,15554112
test,2583,128,98304,16384,2359296,2457600
test,2584,234,179712,54756,7884864,8064576
test,2585,512,393216,262144,37748736,38141952
test,2586,264,202752,69696,10036224,10238976
test,2587,174,133632,30276,4359744,4493376
test,2588,219,168192,47961,6906384,7074576
test,2589,469,360192,219961,31674384,32034576
test,2590,261,200448,68121,9809424,10009872
test,2591,165,126720,27225,3920400,4047120
test,2592,349,268032,121801,17539344,17807376
test,2593,373,286464,139129,20034576,20321040
test,2594,338,259584,114244,16451136,16710720
test,2595,169,129792,28561,4112784,4242576
test,2596,271,208128,73441,10575504,10783632
test,2597,83,63744,6889,992016,1055760
test,2598,280,215040,78400,11289600,11504640
test,2599,237,182016,56169,8088336,8270352
test,2600,392,301056,153664,22127616,22428672
test,2601,376,288768,141376,20358144,20646912
test,2602,148,113664,21904,3154176,3267840
test,2603,79,60672,6241,898704,959376
test,2604,473,363264,223729,32216976,32580240
test,2605,63,48384,3969,571536,619920
test,2606,270,207360,72900,10497600,10704960
test,2607,156,119808,24336,3504384,3624192
test,2608,512,393216,262144,37748736,38141952
test,2609,466,357888,217156,31270464,31628352
test,2610,149,114432,22201,3196944,3311376
test,2611,334,256512,111556,16064064,16320576
test,2612,238,182784,56644,8156736,8339520
test,2613,160,122880,25600,3686400,3809280
test,2614,406,311808,164836,23736384,24048192
test,2615,288,221184,82944,11943936,12165120
test,2616,195,149760,38025,5475600,5625360
test,2617,500,384000,250000,36000000,36384000
test,2618,297,228096,88209,12702096,12930192
test,2619,357,274176,127449,18352656,18626832
test,2620,75,57600,5625,810000,867600
test,2621,84,64512,7056,1016064,1080576
test,2622,428,328704,183184,26378496,26707200
test,2623,408,313344,166464,23970816,24284160
test,2624,415,318720,172225,24800400,25119120
test,2625,268,205824,71824,10342656,10548480
test,2626,503,386304,253009,36433296,36819600
test,2627,180,138240,32400,4665600,4803840
test,2628,135,103680,18225,2624400,2728080
test,2629,309,237312,95481,13749264,13986576
test,2630,102,78336,10404,1498176,1576512
test,2631,191,146688,36481,5253264,5399952
test,2632,287,220416,82369,11861136,12081552
test,2633,427,327936,182329,26255376,26583312
test,2634,469,360192,219961,31674384,32034576
test,2635,190,145920,36100,5198400,5344320
test,2636,393,301824,154449,22240656,22542480
test,2637,116,89088,13456,1937664,2026752
test,2638,111,85248,12321,1774224,1859472
test,2639,427,327936,182329,26255376,26583312
test,2640,450,345600,202500,29160000,29505600
test,2641,497,381696,247009,35569296,35950992
test,2642,159,122112,25281,3640464,3762576
test,2643,431,331008,185761,26749584,27080592
test,2644,308,236544,94864,13660416,13896960
test,2645,266,204288,70756,10188864,10393152
test,2646,230,176640,52900,7617600,7794240
test,2647,252,193536,63504,9144576,9338112
test,2648,470,360960,220900,31809600,32170560
test,2649,102,78336,10404,1498176,1576512
test,2650,441,338688,194481,28005264,28343952
test,2651,280,215040,78400,11289600,11504640
test,2652,136,104448,18496,2663424,2767872
test,2653,396,304128,156816,22581504,22885632
test,2654,180,138240,32400,4665600,4803840
test,2655,498,382464,248004,35712576,36095040
test,2656,401,307968,160801,23155344,23463312
test,2657,265,203520,70225,10112400,10315920
test,2658,317,243456,100489,14470416,14713872
test,2659,149,114432,22201,3196944,3311376
test,2660,464,356352,215296,31002624,31358976
test,2661,464,356352,215296,31002624,31358976
test,2662,322,247296,103684,14930496,15177792
test,2663,111,85248,12321,1774224,1859472
test,2664,265,203520,70225,10112400,10315920
test,2665,405,311040,164025,23619600,23930640
test,2666,144,110592,20736,2985984,3096576
test,2667,259,198912,67081,9659664,9858576
test,2668,155,119040,24025,3459600,3578640
test,2669,359,275712,128881,18558864,18834576
test,2670,309,237312,95481,13749264,13986576
test,2671,306,235008,93636,13483584,13718592
test,2672,188,144384,35344,5089536,5233920
test,2673,512,393216,262144,37748736,38141952
test,2674,187,143616,34969,5035536,5179152
test,2675,91,69888,8281,1192464,1262352
test,2676,166,127488,27556,3968064,4095552
test,2677,202,155136,40804,5875776,6030912
test,2678,479,367872,229441,33039504,33407376
test,2679,327,251136,106929,15397776,15648912
test,2680,312,239616,97344,14017536,14257152
test,2681,169,129792,28561,4112784,4242576
test,2682,399,306432,159201,22924944,23231376
test,2683,352,270336,123904,17842176,18112512
test,2684,199,152832,39601,5702544,5855376
test,2685,387,297216,149769,21566736,21863952
test,2686,158,121344,24964,3594816,3716160
test,2687,276,211968,76176,10969344,11181312
test,2688,205,157440,42025,6051600,6209040
test,2689,402,308736,161604,23270976,23579712
test,2690,98,75264,9604,1382976,1458240
test,2691,357,274176,127449,18352656,18626832
test,2692,427,327936,182329,26255376,26583312
test,2693,261,200448,68121,9809424,10009872
test,2694,345,264960,119025,17139600,17404560
test,2695,350,268800,122500,17640000,17908800
test,2696,363,278784,131769,18974736,19253520
test,2697,340,261120,115600,16646400,16907520
test,2698,276,211968,76176,10969344,11181312
test,2699,361,277248,130321,18766224,19043472
test,2700,267,205056,71289,10265616,10470672
test,2701,353,271104,124609,17943696,18214800
test,2702,512,393216,262144,37748736,38141952
test,2703,317,243456,100489,14470416,14713872
test,2704,439,337152,192721,27751824,28088976
test,2705,232,178176,53824,7750656,7928832
test,2706,85,65280,7225,1040400,1105680
test,2707,271,208128,73441,10575504,10783632
test,2708,302,231936,91204,13133376,13365312
test,2709,258,198144,66564,9585216,9783360
test,2710,265,203520,70225,10112400,10315920
test,2711,255,195840,65025,9363600,9559440
test,2712,65,49920,4225,608400,658320
test,2713,298,228864,88804,12787776,13016640
test,2714,186,142848,34596,4981824,5124672
test,2715,313,240384,97969,14107536,14347920
test,2716,266,204288,70756,10188864,10393152
test,2717,398,305664,158404,22810176,23115840
test,2718,461,354048,212521,30603024,30957072
test,2719,221,169728,48841,7033104,7202832
test,2720,444,340992,197136,28387584,28728576
test,2721,512,393216,262144,37748736,38141952
test,2722,512,393216,262144,37748736,38141952
test,2723,351,269568,123201,17740944,18010512
test,2724,333,255744,110889,15968016,16223760
test,2725,138,105984,19044,2742336,2848320
test,2726,168,129024,28224,4064256,4193280
test,2727,392,301056,153664,22127616,22428672
test,2728,512,393216,262144,37748736,38141952
test,2729,326,250368,106276,15303744,15554112
test,2730,389,298752,151321,21790224,22088976
test,2731,243,186624,59049,8503056,8689680
test,2732,89,68352,7921,1140624,1208976
test,2733,65,49920,4225,608400,658320
test,2734,499,383232,249001,35856144,36239376
test,2735,237,182016,56169,8088336,8270352
test,2736,299,229632,89401,12873744,13103376
test,2737,287,220416,82369,11861136,12081552
test,2738,161,123648,25921,3732624,3856272
test,2739,213,163584,45369,6533136,6696720
test,2740,427,327936,182329,26255376,26583312
test,2741,265,203520,70225,10112400,10315920
test,2742,315,241920,99225,14288400,14530320
test,2743,351,269568,123201,17740944,18010512
test,2744,450,345600,202500,29160000,29505600
test,2745,227,174336,51529,7420176,7594512
test,2746,363,278784,131769,18974736,19253520
test,2747,373,286464,139129,20034576,20321040
test,2748,230,176640,52900,7617600,7794240
test,2749,76,58368,5776,831744,890112
test,2750,187,143616,34969,5035536,5179152
test,2751,512,393216,262144,37748736,38141952
test,2752,394,302592,155236,22353984,22656576
test,2753,158,121344,24964,3594816,3716160
test,2754,110,84480,12100,1742400,1826880
test,2755,224,172032,50176,7225344,7397376
test,2756,108,82944,11664,1679616,1762560
test,2757,91,69888,8281,1192464,1262352
test,2758,486,373248,236196,34012224,34385472
test,2759,372,285696,138384,19927296,20212992
test,2760,318,244224,101124,14561856,14806080
test,2761,60,46080,3600,518400,564480
test,2762,176,135168,30976,4460544,4595712
test,2763,512,393216,262144,37748736,38141952
test,2764,129,99072,16641,2396304,2495376
test,2765,496,380928,246016,35426304,35807232
test,2766,512,393216,262144,37748736,38141952
test,2767,296,227328,87616,12616704,12844032
test,2768,343,263424,117649,16941456,17204880
test,2769,434,333312,188356,27123264,27456576
test,2770,200,153600,40000,5760000,5913600
test,2771,204,156672,41616,5992704,6149376
test,2772,143,109824,20449,2944656,3054480
test,2773,226,173568,51076,7354944,7528512
test,2774,210,161280,44100,6350400,6511680
test,2775,186,142848,34596,4981824,5124672
test,2776,495,380160,245025,35283600,35663760
test,2777,255,195840,65025,9363600,9559440
test,2778,179,137472,32041,4613904,4751376
test,2779,512,393216,262144,37748736,38141952
test,2780,377,289536,142129,20466576,20756112
test,2781,278,213504,77284,11128896,11342400
test,2782,140,107520,19600,2822400,2929920
test,2783,512,393216,262144,37748736,38141952
test,2784,191,146688,36481,5253264,5399952
test,2785,114,87552,12996,1871424,1958976
test,2786,212,162816,44944,6471936,6634752
test,2787,232,178176,53824,7750656,7928832
test,2788,195,149760,38025,5475600,5625360
test,2789,185,142080,34225,4928400,5070480
test,2790,298,228864,88804,12787776,13016640
test,2791,189,145152,35721,5143824,5288976
test,2792,309,237312,95481,13749264,13986576
test,2793,100,76800,10000,1440000,1516800
test,2794,298,228864,88804,12787776,13016640
test,2795,368,282624,135424,19501056,19783680
test,2796,66,50688,4356,627264,677952
test,2797,272,208896,73984,10653696,10862592
test,2798,251,192768,63001,9072144,9264912
test,2799,512,393216,262144,37748736,38141952
test,2800,384,294912,147456,21233664,21528576
test,2801,310,238080,96100,13838400,14076480
test,2802,97,74496,9409,1354896,1429392
test,2803,115,88320,13225,1904400,1992720
test,2804,195,149760,38025,5475600,5625360
test,2805,249,191232,62001,8928144,9119376
test,2806,300,230400,90000,12960000,13190400
test,2807,150,115200,22500,3240000,3355200
test,2808,179,137472,32041,4613904,4751376
test,2809,190,145920,36100,5198400,5344320
test,2810,297,228096,88209,12702096,12930192
test,2811,108,82944,11664,1679616,1762560
test,2812,252,193536,63504,9144576,9338112
test,2813,188,144384,35344,5089536,5233920
test,2814,191,146688,36481,5253264,5399952
test,2815,111,85248,12321,1774224,1859472
test,2816,138,105984,19044,2742336,2848320
test,2817,294,225792,86436,12446784,12672576
test,2818,70,53760,4900,705600,759360
test,2819,438,336384,191844,27625536,27961920
test,2820,391,300288,152881,22014864,22315152
test,2821,285,218880,81225,11696400,11915280
test,2822,392,301056,153664,22127616,22428672
test,2823,98,75264,9604,1382976,1458240
test,2824,212,162816,44944,6471936,6634752
test,2825,163,125184,26569,3825936,3951120
test,2826,288,221184,82944,11943936,12165120
test,2827,452,347136,204304,29419776,29766912
test,2828,382,293376,145924,21013056,21306432
test,2829,273,209664,74529,10732176,10941840
test,2830,368,282624,135424,19501056,19783680
test,2831,317,243456,100489,14470416,14713872
test,2832,166,127488,27556,3968064,4095552
test,2833,153,117504,23409,3370896,3488400
test,2834,261,200448,68121,9809424,10009872
test,2835,274,210432,75076,10810944,11021376
test,2836,257,197376,66049,9511056,9708432
test,2837,425,326400,180625,26010000,26336400
test,2838,90,69120,8100,1166400,1235520
test,2839,204,156672,41616,5992704,6149376
test,2840,334,256512,111556,16064064,16320576
test,2841,474,364032,224676,32353344,32717376
test,2842,262,201216,68644,9884736,10085952
test,2843,173,132864,29929,4309776,4442640
test,2844,512,393216,262144,37748736,38141952
test,2845,342,262656,116964,16842816,17105472
test,2846,311,238848,96721,13927824,14166672
test,2847,452,347136,204304,29419776,29766912
test,2848,284,218112,80656,11614464,11832576
test,2849,73,56064,5329,767376,823440
test,2850,282,216576,79524,11451456,11668032
test,2851,260,199680,67600,9734400,9934080
test,2852,362,278016,131044,18870336,19148352
test,2853,153,117504,23409,3370896,3488400
test,2854,340,261120,115600,16646400,16907520
test,2855,364,279552,132496,19079424,19358976
test,2856,143,109824,20449,2944656,3054480
test,2857,251,192768,63001,9072144,9264912
test,2858,345,264960,119025,17139600,17404560
test,2859,173,132864,29929,4309776,4442640
test,2860,419,321792,175561,25280784,25602576
test,2861,371,284928,137641,19820304,20105232
test,2862,397,304896,157609,22695696,23000592
test,2863,370,284160,136900,19713600,19997760
test,2864,312,239616,97344,14017536,14257152
test,2865,81,62208,6561,944784,1006992
test,2866,434,333312,188356,27123264,27456576
test,2867,239,183552,57121,8225424,8408976
test,2868,124,95232,15376,2214144,2309376
test,2869,295,226560,87025,12531600,12758160
test,2870,339,260352,114921,16548624,16808976
test,2871,138,105984,19044,2742336,2848320
test,2872,283,217344,80089,11532816,11750160
test,2873,341,261888,116281,16744464,17006352
test,2874,116,89088,13456,1937664,2026752
test,2875,303,232704,91809,13220496,13453200
test,2876,283,217344,80089,11532816,11750160
test,2877,243,186624,59049,8503056,8689680
test,2878,372,285696,138384,19927296,20212992
test,2879,292,224256,85264,12278016,12502272
test,2880,226,173568,51076,7354944,7528512
test,2881,265,203520,70225,10112400,10315920
test,2882,483,370944,233289,33593616,33964560
test,2883,192,147456,36864,5308416,5455872
test,2884,405,311040,164025,23619600,23930640
test,2885,296,227328,87616,12616704,12844032
test,2886,252,193536,63504,9144576,9338112
test,2887,354,271872,125316,18045504,18317376
test,2888,363,278784,131769,18974736,19253520
test,2889,502,385536,252004,36288576,36674112
test,2890,237,182016,56169,8088336,8270352
test,2891,126,96768,15876,2286144,2382912
test,2892,182,139776,33124,4769856,4909632
test,2893,293,225024,85849,12362256,12587280
test,2894,175,134400,30625,4410000,4544400
test,2895,336,258048,112896,16257024,16515072
test,2896,291,223488,84681,12194064,12417552
test,2897,210,161280,44100,6350400,6511680
test,2898,232,178176,53824,7750656,7928832
test,2899,337,258816,113569,16353936,16612752
test,2900,304,233472,92416,13307904,13541376
test,2901,106,81408,11236,1617984,1699392
test,2902,287,220416,82369,11861136,12081552
test,2903,292,224256,85264,12278016,12502272
test,2904,336,258048,112896,16257024,16515072
test,2905,335,257280,112225,16160400,16417680
test,2906,315,241920,99225,14288400,14530320
test,2907,304,233472,92416,13307904,13541376
test,2908,78,59904,6084,876096,936000
test,2909,152,116736,23104,3326976,3443712
test,2910,305,234240,93025,13395600,13629840
test,2911,252,193536,63504,9144576,9338112
test,2912,76,58368,5776,831744,890112
test,2913,499,383232,249001,35856144,36239376
test,2914,430,330240,184900,26625600,26955840
test,2915,381,292608,145161,20903184,21195792
test,2916,378,290304,142884,20575296,20865600
test,2917,406,311808,164836,23736384,24048192
test,2918,139,106752,19321,2782224,2888976
test,2919,363,278784,131769,18974736,19253520
test,2920,147,112896,21609,3111696,3224592
test,2921,281,215808,78961,11370384,11586192
test,2922,236,181248,55696,8020224,8201472
test,2923,482,370176,232324,33454656,33824832
test,2924,321,246528,103041,14837904,15084432
test,2925,129,99072,16641,2396304,2495376
test,2926,487,374016,237169,34152336,34526352
test,2927,284,218112,80656,11614464,11832576
test,2928,300,230400,90000,12960000,13190400
test,2929,260,199680,67600,9734400,9934080
test,2930,282,216576,79524,11451456,11668032
test,2931,380,291840,144400,20793600,21085440
test,2932,348,267264,121104,17438976,17706240
test,2933,252,193536,63504,9144576,9338112
test,2934,284,218112,80656,11614464,11832576
test,2935,373,286464,139129,20034576,20321040
test,2936,485,372480,235225,33872400,34244880
test,2937,273,209664,74529,10732176,10941840
test,2938,291,223488,84681,12194064,12417552
test,2939,252,193536,63504,9144576,9338112
test,2940,152,116736,23104,3326976,3443712
test,2941,217,166656,47089,6780816,6947472
test,2942,310,238080,96100,13838400,14076480
test,2943,145,111360,21025,3027600,3138960
test,2944,319,244992,101761,14653584,14898576
test,2945,448,344064,200704,28901376,29245440
test,2946,207,158976,42849,6170256,6329232
test,2947,110,84480,12100,1742400,1826880
test,2948,492,377856,242064,34857216,35235072
test,2949,89,68352,7921,1140624,1208976
test,2950,204,156672,41616,5992704,6149376
test,2951,512,393216,262144,37748736,38141952
test,2952,509,390912,259081,37307664,37698576
test,2953,409,314112,167281,24088464,24402576
test,2954,118,90624,13924,2005056,2095680
test,2955,350,268800,122500,17640000,17908800
test,2956,297,228096,88209,12702096,12930192
test,2957,244,187392,59536,8573184,8760576
test,2958,304,233472,92416,13307904,13541376
test,2959,165,126720,27225,3920400,4047120
test,2960,343,263424,117649,16941456,17204880
test,2961,205,157440,42025,6051600,6209040
test,2962,328,251904,107584,15492096,15744000
test,2963,208,159744,43264,6230016,6389760
test,2964,197,151296,38809,5588496,5739792
test,2965,405,311040,164025,23619600,23930640
test,2966,217,166656,47089,6780816,6947472
test,2967,462,354816,213444,30735936,31090752
test,2968,378,290304,142884,20575296,20865600
test,2969,341,261888,116281,16744464,17006352
test,2970,170,130560,28900,4161600,4292160
test,2971,338,259584,114244,16451136,16710720
test,2972,328,251904,107584,15492096,15744000
test,2973,352,270336,123904,17842176,18112512
test,2974,145,111360,21025,3027600,3138960
test,2975,85,65280,7225,1040400,1105680
test,2976,357,274176,127449,18352656,18626832
test,2977,180,138240,32400,4665600,4803840
test,2978,142,109056,20164,2903616,3012672
test,2979,86,66048,7396,1065024,1131072
test,2980,373,286464,139129,20034576,20321040
test,2981,331,254208,109561,15776784,16030992
test,2982,128,98304,16384,2359296,2457600
test,2983,300,230400,90000,12960000,13190400
test,2984,172,132096,29584,4260096,4392192
test,2985,221,169728,48841,7033104,7202832
test,2986,222,170496,49284,7096896,7267392
test,2987,458,351744,209764,30206016,30557760
test,2988,512,393216,262144,37748736,38141952
test,2989,229,175872,52441,7551504,7727376
test,2990,356,273408,126736,18249984,18523392
test,2991,81,62208,6561,944784,1006992
test,2992,251,192768,63001,9072144,9264912
test,2993,197,151296,38809,5588496,5739792
test,2994,333,255744,110889,15968016,16223760
test,2995,512,393216,262144,37748736,38141952
test,2996,304,233472,92416,13307904,13541376
test,2997,378,290304,142884,20575296,20865600
test,2998,141,108288,19881,2862864,2971152
test,2999,359,275712,128881,18558864,18834576
test,3000,271,208128,73441,10575504,10783632
test,3001,291,223488,84681,12194064,12417552
test,3002,300,230400,90000,12960000,13190400
test,3003,336,258048,112896,16257024,16515072
test,3004,370,284160,136900,19713600,19997760
test,3005,144,110592,20736,2985984,3096576
test,3006,194,148992,37636,5419584,5568576
test,3007,76,58368,5776,831744,890112
test,3008,357,274176,127449,18352656,18626832
test,3009,123,94464,15129,2178576,2273040
test,3010,87,66816,7569,1089936,1156752
test,3011,263,201984,69169,9960336,10162320
test,3012,311,238848,96721,13927824,14166672
test,3013,333,255744,110889,15968016,16223760
test,3014,194,148992,37636,5419584,5568576
test,3015,360,276480,129600,18662400,18938880
test,3016,317,243456,100489,14470416,14713872
test,3017,320,245760,102400,14745600,14991360
test,3018,235,180480,55225,7952400,8132880
test,3019,339,260352,114921,16548624,16808976
test,3020,469,360192,219961,31674384,32034576
test,3021,360,276480,129600,18662400,18938880
test,3022,512,393216,262144,37748736,38141952
test,3023,275,211200,75625,10890000,11101200
test,3024,322,247296,103684,14930496,15177792
test,3025,235,180480,55225,7952400,8132880
test,3026,284,218112,80656,11614464,11832576
test,3027,242,185856,58564,8433216,8619072
test,3028,260,199680,67600,9734400,9934080
test,3029,410,314880,168100,24206400,24521280
test,3030,369,283392,136161,19607184,19890576
test,3031,211,162048,44521,6411024,6573072
test,3032,188,144384,35344,5089536,5233920
test,3033,180,138240,32400,4665600,4803840
test,3034,134,102912,17956,2585664,2688576
test,3035,447,343296,199809,28772496,29115792
test,3036,374,287232,139876,20142144,20429376
test,3037,337,258816,113569,16353936,16612752
test,3038,215,165120,46225,6656400,6821520
test,3039,197,151296,38809,5588496,5739792
test,3040,243,186624,59049,8503056,8689680
test,3041,227,174336,51529,7420176,7594512
test,3042,261,200448,68121,9809424,10009872
test,3043,210,161280,44100,6350400,6511680
test,3044,445,341760,198025,28515600,28857360
test,3045,478,367104,228484,32901696,33268800
test,3046,350,268800,122500,17640000,17908800
test,3047,269,206592,72361,10419984,10626576
test,3048,382,293376,145924,21013056,21306432
test,3049,416,319488,173056,24920064,25239552
test,3050,213,163584,45369,6533136,6696720
test,3051,317,243456,100489,14470416,14713872
test,3052,238,182784,56644,8156736,8339520
test,3053,71,54528,5041,725904,780432
test,3054,221,169728,48841,7033104,7202832
test,3055,512,393216,262144,37748736,38141952
test,3056,179,137472,32041,4613904,4751376
test,3057,512,393216,262144,37748736,38141952
test,3058,172,132096,29584,4260096,4392192
test,3059,68,52224,4624,665856,718080
test,3060,512,393216,262144,37748736,38141952
test,3061,224,172032,50176,7225344,7397376
test,3062,208,159744,43264,6230016,6389760
test,3063,346,265728,119716,17239104,17504832
test,3064,181,139008,32761,4717584,4856592
test,3065,261,200448,68121,9809424,10009872
test,3066,512,393216,262144,37748736,38141952
test,3067,196,150528,38416,5531904,5682432
test,3068,431,331008,185761,26749584,27080592
test,3069,98,75264,9604,1382976,1458240
test,3070,407,312576,165649,23853456,24166032
test,3071,152,116736,23104,3326976,3443712
test,3072,257,197376,66049,9511056,9708432
test,3073,398,305664,158404,22810176,23115840
test,3074,419,321792,175561,25280784,25602576
test,3075,377,289536,142129,20466576,20756112
test,3076,239,183552,57121,8225424,8408976
test,3077,160,122880,25600,3686400,3809280
test,3078,410,314880,168100,24206400,24521280
test,3079,321,246528,103041,14837904,15084432
test,3080,503,386304,253009,36433296,36819600
test,3081,479,367872,229441,33039504,33407376
test,3082,251,192768,63001,9072144,9264912
test,3083,488,374784,238144,34292736,34667520
test,3084,281,215808,78961,11370384,11586192
test,3085,365,280320,133225,19184400,19464720
test,3086,269,206592,72361,10419984,10626576
test,3087,385,295680,148225,21344400,21640080
test,3088,495,380160,245025,35283600,35663760
test,3089,288,221184,82944,11943936,12165120
test,3090,262,201216,68644,9884736,10085952
test,3091,462,354816,213444,30735936,31090752
test,3092,249,191232,62001,8928144,9119376
test,3093,270,207360,72900,10497600,10704960
test,3094,359,275712,128881,18558864,18834576
test,3095,317,243456,100489,14470416,14713872
test,3096,235,180480,55225,7952400,8132880
test,3097,421,323328,177241,25522704,25846032
test,3098,152,116736,23104,3326976,3443712
test,3099,413,317184,170569,24561936,24879120
test,3100,334,256512,111556,16064064,16320576
test,3101,274,210432,75076,10810944,11021376
test,3102,367,281856,134689,19395216,19677072
test,3103,241,185088,58081,8363664,8548752
test,3104,192,147456,36864,5308416,5455872
test,3105,288,221184,82944,11943936,12165120
test,3106,336,258048,112896,16257024,16515072
test,3107,286,219648,81796,11778624,11998272
test,3108,225,172800,50625,7290000,7462800
test,3109,118,90624,13924,2005056,2095680
test,3110,299,229632,89401,12873744,13103376
test,3111,216,165888,46656,6718464,6884352
test,3112,395,303360,156025,22467600,22770960
test,3113,127,97536,16129,2322576,2420112
test,3114,177,135936,31329,4511376,4647312
test,3115,234,179712,54756,7884864,8064576
test,3116,356,273408,126736,18249984,18523392
test,3117,226,173568,51076,7354944,7528512
test,3118,206,158208,42436,6110784,6268992
test,3119,60,46080,3600,518400,564480
test,3120,45,34560,2025,291600,326160
test,3121,131,100608,17161,2471184,2571792
test,3122,322,247296,103684,14930496,15177792
test,3123,222,170496,49284,7096896,7267392
test,3124,344,264192,118336,17040384,17304576
test,3125,87,66816,7569,1089936,1156752
test,3126,256,196608,65536,9437184,9633792
test,3127,370,284160,136900,19713600,19997760
test,3128,157,120576,24649,3549456,3670032
test,3129,351,269568,123201,17740944,18010512
test,3130,296,227328,87616,12616704,12844032
test,3131,345,264960,119025,17139600,17404560
test,3132,178,136704,31684,4562496,4699200
test,3133,413,317184,170569,24561936,24879120
test,3134,293,225024,85849,12362256,12587280
test,3135,200,153600,40000,5760000,5913600
test,3136,334,256512,111556,16064064,16320576
test,3137,348,267264,121104,17438976,17706240
test,3138,409,314112,167281,24088464,24402576
test,3139,253,194304,64009,9217296,9411600
test,3140,300,230400,90000,12960000,13190400
test,3141,79,60672,6241,898704,959376
test,3142,316,242688,99856,14379264,14621952
test,3143,123,94464,15129,2178576,2273040
test,3144,344,264192,118336,17040384,17304576
test,3145,378,290304,142884,20575296,20865600
test,3146,163,125184,26569,3825936,3951120
test,3147,369,283392,136161,19607184,19890576
test,3148,87,66816,7569,1089936,1156752
test,3149,512,393216,262144,37748736,38141952
test,3150,512,393216,262144,37748736,38141952
test,3151,322,247296,103684,14930496,15177792
test,3152,214,164352,45796,6594624,6758976
test,3153,350,268800,122500,17640000,17908800
test,3154,361,277248,130321,18766224,19043472
test,3155,156,119808,24336,3504384,3624192
test,3156,347,266496,120409,17338896,17605392
test,3157,377,289536,142129,20466576,20756112
test,3158,179,137472,32041,4613904,4751376
test,3159,79,60672,6241,898704,959376
test,3160,512,393216,262144,37748736,38141952
test,3161,295,226560,87025,12531600,12758160
test,3162,135,103680,18225,2624400,2728080
test,3163,382,293376,145924,21013056,21306432
test,3164,495,380160,245025,35283600,35663760
test,3165,323,248064,104329,15023376,15271440
test,3166,381,292608,145161,20903184,21195792
test,3167,309,237312,95481,13749264,13986576
test,3168,348,267264,121104,17438976,17706240
test,3169,111,85248,12321,1774224,1859472
test,3170,166,127488,27556,3968064,4095552
test,3171,243,186624,59049,8503056,8689680
test,3172,155,119040,24025,3459600,3578640
test,3173,125,96000,15625,2250000,2346000
test,3174,101,77568,10201,1468944,1546512
test,3175,462,354816,213444,30735936,31090752
test,3176,352,270336,123904,17842176,18112512
test,3177,432,331776,186624,26873856,27205632
test,3178,325,249600,105625,15210000,15459600
test,3179,456,350208,207936,29942784,30292992
test,3180,199,152832,39601,5702544,5855376
test,3181,309,237312,95481,13749264,13986576
test,3182,418,321024,174724,25160256,25481280
test,3183,287,220416,82369,11861136,12081552
test,3184,221,169728,48841,7033104,7202832
test,3185,83,63744,6889,992016,1055760
test,3186,451,346368,203401,29289744,29636112
test,3187,281,215808,78961,11370384,11586192
test,3188,432,331776,186624,26873856,27205632
test,3189,127,97536,16129,2322576,2420112
test,3190,116,89088,13456,1937664,2026752
test,3191,500,384000,250000,36000000,36384000
test,3192,132,101376,17424,2509056,2610432
test,3193,501,384768,251001,36144144,36528912
test,3194,222,170496,49284,7096896,7267392
test,3195,68,52224,4624,665856,718080
test,3196,346,265728,119716,17239104,17504832
test,3197,148,113664,21904,3154176,3267840
test,3198,346,265728,119716,17239104,17504832
test,3199,379,291072,143641,20684304,20975376
test,3200,357,274176,127449,18352656,18626832
test,3201,152,116736,23104,3326976,3443712
test,3202,283,217344,80089,11532816,11750160
test,3203,310,238080,96100,13838400,14076480
test,3204,231,177408,53361,7683984,7861392
test,3205,157,120576,24649,3549456,3670032
test,3206,185,142080,34225,4928400,5070480
test,3207,229,175872,52441,7551504,7727376
test,3208,259,198912,67081,9659664,9858576
test,3209,339,260352,114921,16548624,16808976
test,3210,343,263424,117649,16941456,17204880
test,3211,202,155136,40804,5875776,6030912
test,3212,439,337152,192721,27751824,28088976
test,3213,265,203520,70225,10112400,10315920
test,3214,301,231168,90601,13046544,13277712
test,3215,119,91392,14161,2039184,2130576
test,3216,184,141312,33856,4875264,5016576
test,3217,422,324096,178084,25644096,25968192
test,3218,333,255744,110889,15968016,16223760
test,3219,353,271104,124609,17943696,18214800
test,3220,393,301824,154449,22240656,22542480
test,3221,313,240384,97969,14107536,14347920
test,3222,410,314880,168100,24206400,24521280
test,3223,242,185856,58564,8433216,8619072
test,3224,418,321024,174724,25160256,25481280
test,3225,127,97536,16129,2322576,2420112
test,3226,241,185088,58081,8363664,8548752
test,3227,411,315648,168921,24324624,24640272
test,3228,123,94464,15129,2178576,2273040
test,3229,484,371712,234256,33732864,34104576
test,3230,206,158208,42436,6110784,6268992
test,3231,281,215808,78961,11370384,11586192
test,3232,310,238080,96100,13838400,14076480
test,3233,326,250368,106276,15303744,15554112
test,3234,300,230400,90000,12960000,13190400
test,3235,235,180480,55225,7952400,8132880
test,3236,110,84480,12100,1742400,1826880
test,3237,313,240384,97969,14107536,14347920
test,3238,140,107520,19600,2822400,2929920
test,3239,465,357120,216225,31136400,31493520
test,3240,57,43776,3249,467856,511632
test,3241,320,245760,102400,14745600,14991360
test,3242,94,72192,8836,1272384,1344576
test,3243,282,216576,79524,11451456,11668032
test,3244,258,198144,66564,9585216,9783360
test,3245,188,144384,35344,5089536,5233920
test,3246,434,333312,188356,27123264,27456576
test,3247,254,195072,64516,9290304,9485376
test,3248,407,312576,165649,23853456,24166032
test,3249,190,145920,36100,5198400,5344320
test,3250,298,228864,88804,12787776,13016640
test,3251,303,232704,91809,13220496,13453200
test,3252,188,144384,35344,5089536,5233920
test,3253,218,167424,47524,6843456,7010880
test,3254,258,198144,66564,9585216,9783360
test,3255,356,273408,126736,18249984,18523392
test,3256,122,93696,14884,2143296,2236992
test,3257,301,231168,90601,13046544,13277712
test,3258,80,61440,6400,921600,983040
test,3259,206,158208,42436,6110784,6268992
test,3260,300,230400,90000,12960000,13190400
test,3261,397,304896,157609,22695696,23000592
test,3262,126,96768,15876,2286144,2382912
test,3263,424,325632,179776,25887744,26213376
test,3264,235,180480,55225,7952400,8132880
test,3265,512,393216,262144,37748736,38141952
test,3266,310,238080,96100,13838400,14076480
test,3267,94,72192,8836,1272384,1344576
test,3268,272,208896,73984,10653696,10862592
test,3269,226,173568,51076,7354944,7528512
test,3270,380,291840,144400,20793600,21085440
test,3271,187,143616,34969,5035536,5179152
test,3272,193,148224,37249,5363856,5512080
test,3273,343,263424,117649,16941456,17204880
test,3274,408,313344,166464,23970816,24284160
test,3275,491,377088,241081,34715664,35092752
test,3276,247,189696,61009,8785296,8974992
test,3277,271,208128,73441,10575504,10783632
test,3278,164,125952,26896,3873024,3998976
test,3279,157,120576,24649,3549456,3670032
test,3280,366,281088,133956,19289664,19570752
test,3281,365,280320,133225,19184400,19464720
test,3282,205,157440,42025,6051600,6209040
test,3283,210,161280,44100,6350400,6511680
test,3284,433,332544,187489,26998416,27330960
test,3285,378,290304,142884,20575296,20865600
test,3286,264,202752,69696,10036224,10238976
test,3287,495,380160,245025,35283600,35663760
test,3288,512,393216,262144,37748736,38141952
test,3289,141,108288,19881,2862864,2971152
test,3290,251,192768,63001,9072144,9264912
test,3291,380,291840,144400,20793600,21085440
test,3292,244,187392,59536,8573184,8760576
test,3293,211,162048,44521,6411024,6573072
test,3294,352,270336,123904,17842176,18112512
test,3295,381,292608,145161,20903184,21195792
test,3296,102,78336,10404,1498176,1576512
test,3297,220,168960,48400,6969600,7138560
test,3298,384,294912,147456,21233664,21528576
test,3299,261,200448,68121,9809424,10009872
test,3300,415,318720,172225,24800400,25119120
test,3301,85,65280,7225,1040400,1105680
test,3302,444,340992,197136,28387584,28728576
test,3303,367,281856,134689,19395216,19677072
test,3304,350,268800,122500,17640000,17908800
test,3305,126,96768,15876,2286144,2382912
test,3306,128,98304,16384,2359296,2457600
test,3307,277,212736,76729,11048976,11261712
test,3308,310,238080,96100,13838400,14076480
test,3309,324,248832,104976,15116544,15365376
test,3310,394,302592,155236,22353984,22656576
test,3311,206,158208,42436,6110784,6268992
test,3312,391,300288,152881,22014864,22315152
test,3313,268,205824,71824,10342656,10548480
test,3314,380,291840,144400,20793600,21085440
test,3315,186,142848,34596,4981824,5124672
test,3316,190,145920,36100,5198400,5344320
test,3317,431,331008,185761,26749584,27080592
test,3318,190,145920,36100,5198400,5344320
test,3319,174,133632,30276,4359744,4493376
test,3320,199,152832,39601,5702544,5855376
test,3321,335,257280,112225,16160400,16417680
test,3322,131,100608,17161,2471184,2571792
test,3323,191,146688,36481,5253264,5399952
test,3324,170,130560,28900,4161600,4292160
test,3325,345,264960,119025,17139600,17404560
test,3326,361,277248,130321,18766224,19043472
test,3327,257,197376,66049,9511056,9708432
test,3328,80,61440,6400,921600,983040
test,3329,115,88320,13225,1904400,1992720
test,3330,271,208128,73441,10575504,10783632
test,3331,403,309504,162409,23386896,23696400
test,3332,205,157440,42025,6051600,6209040
test,3333,271,208128,73441,10575504,10783632
test,3334,255,195840,65025,9363600,9559440
test,3335,177,135936,31329,4511376,4647312
test,3336,90,69120,8100,1166400,1235520
test,3337,315,241920,99225,14288400,14530320
test,3338,444,340992,197136,28387584,28728576
test,3339,272,208896,73984,10653696,10862592
test,3340,171,131328,29241,4210704,4342032
test,3341,210,161280,44100,6350400,6511680
test,3342,296,227328,87616,12616704,12844032
test,3343,333,255744,110889,15968016,16223760
test,3344,475,364800,225625,32490000,32854800
test,3345,146,112128,21316,3069504,3181632
test,3346,109,83712,11881,1710864,1794576
test,3347,157,120576,24649,3549456,3670032
test,3348,331,254208,109561,15776784,16030992
test,3349,114,87552,12996,1871424,1958976
test,3350,198,152064,39204,5645376,5797440
test,3351,259,198912,67081,9659664,9858576
test,3352,283,217344,80089,11532816,11750160
test,3353,489,375552,239121,34433424,34808976
test,3354,214,164352,45796,6594624,6758976
test,3355,224,172032,50176,7225344,7397376
test,3356,174,133632,30276,4359744,4493376
test,3357,193,148224,37249,5363856,5512080
test,3358,106,81408,11236,1617984,1699392
test,3359,262,201216,68644,9884736,10085952
test,3360,219,168192,47961,6906384,7074576
test,3361,78,59904,6084,876096,936000
test,3362,83,63744,6889,992016,1055760
test,3363,367,281856,134689,19395216,19677072
test,3364,397,304896,157609,22695696,23000592
test,3365,170,130560,28900,4161600,4292160
test,3366,193,148224,37249,5363856,5512080
test,3367,165,126720,27225,3920400,4047120
test,3368,98,75264,9604,1382976,1458240
test,3369,256,196608,65536,9437184,9633792
test,3370,370,284160,136900,19713600,19997760
test,3371,225,172800,50625,7290000,7462800
test,3372,262,201216,68644,9884736,10085952
test,3373,267,205056,71289,10265616,10470672
test,3374,114,87552,12996,1871424,1958976
test,3375,275,211200,75625,10890000,11101200
test,3376,510,391680,260100,37454400,37846080
test,3377,512,393216,262144,37748736,38141952
test,3378,333,255744,110889,15968016,16223760
test,3379,257,197376,66049,9511056,9708432
test,3380,185,142080,34225,4928400,5070480
test,3381,315,241920,99225,14288400,14530320
test,3382,271,208128,73441,10575504,10783632
test,3383,472,362496,222784,32080896,32443392
test,3384,255,195840,65025,9363600,9559440
test,3385,160,122880,25600,3686400,3809280
test,3386,366,281088,133956,19289664,19570752
test,3387,173,132864,29929,4309776,4442640
test,3388,336,258048,112896,16257024,16515072
test,3389,327,251136,106929,15397776,15648912
test,3390,383,294144,146689,21123216,21417360
test,3391,143,109824,20449,2944656,3054480
test,3392,148,113664,21904,3154176,3267840
test,3393,296,227328,87616,12616704,12844032
test,3394,447,343296,199809,28772496,29115792
test,3395,216,165888,46656,6718464,6884352
test,3396,160,122880,25600,3686400,3809280
test,3397,215,165120,46225,6656400,6821520
test,3398,260,199680,67600,9734400,9934080
test,3399,203,155904,41209,5934096,6090000
test,3400,95,72960,9025,1299600,1372560
test,3401,360,276480,129600,18662400,18938880
test,3402,226,173568,51076,7354944,7528512
test,3403,276,211968,76176,10969344,11181312
test,3404,81,62208,6561,944784,1006992
test,3405,341,261888,116281,16744464,17006352
test,3406,512,393216,262144,37748736,38141952
test,3407,259,198912,67081,9659664,9858576
test,3408,211,162048,44521,6411024,6573072
test,3409,466,357888,217156,31270464,31628352
test,3410,309,237312,95481,13749264,13986576
test,3411,288,221184,82944,11943936,12165120
test,3412,377,289536,142129,20466576,20756112
test,3413,505,387840,255025,36723600,37111440
test,3414,275,211200,75625,10890000,11101200
test,3415,149,114432,22201,3196944,3311376
test,3416,154,118272,23716,3415104,3533376
test,3417,275,211200,75625,10890000,11101200
test,3418,402,308736,161604,23270976,23579712
test,3419,365,280320,133225,19184400,19464720
test,3420,421,323328,177241,25522704,25846032
test,3421,464,356352,215296,31002624,31358976
test,3422,137,105216,18769,2702736,2807952
test,3423,512,393216,262144,37748736,38141952
test,3424,196,150528,38416,5531904,5682432
test,3425,222,170496,49284,7096896,7267392
test,3426,366,281088,133956,19289664,19570752
test,3427,129,99072,16641,2396304,2495376
test,3428,400,307200,160000,23040000,23347200
test,3429,266,204288,70756,10188864,10393152
test,3430,391,300288,152881,22014864,22315152
test,3431,152,116736,23104,3326976,3443712
test,3432,151,115968,22801,3283344,3399312
test,3433,62,47616,3844,553536,601152
test,3434,299,229632,89401,12873744,13103376
test,3435,273,209664,74529,10732176,10941840
test,3436,368,282624,135424,19501056,19783680
test,3437,317,243456,100489,14470416,14713872
test,3438,207,158976,42849,6170256,6329232
test,3439,357,274176,127449,18352656,18626832
test,3440,512,393216,262144,37748736,38141952
test,3441,203,155904,41209,5934096,6090000
test,3442,287,220416,82369,11861136,12081552
test,3443,405,311040,164025,23619600,23930640
test,3444,196,150528,38416,5531904,5682432
test,3445,465,357120,216225,31136400,31493520
test,3446,308,236544,94864,13660416,13896960
test,3447,195,149760,38025,5475600,5625360
test,3448,272,208896,73984,10653696,10862592
test,3449,196,150528,38416,5531904,5682432
test,3450,365,280320,133225,19184400,19464720
test,3451,324,248832,104976,15116544,15365376
test,3452,205,157440,42025,6051600,6209040
test,3453,483,370944,233289,33593616,33964560
test,3454,137,105216,18769,2702736,2807952
test,3455,304,233472,92416,13307904,13541376
test,3456,427,327936,182329,26255376,26583312
test,3457,208,159744,43264,6230016,6389760
test,3458,432,331776,186624,26873856,27205632
test,3459,351,269568,123201,17740944,18010512
test,3460,143,109824,20449,2944656,3054480
test,3461,331,254208,109561,15776784,16030992
test,3462,353,271104,124609,17943696,18214800
test,3463,201,154368,40401,5817744,5972112
test,3464,512,393216,262144,37748736,38141952
test,3465,248,190464,61504,8856576,9047040
test,3466,406,311808,164836,23736384,24048192
test,3467,485,372480,235225,33872400,34244880
test,3468,214,164352,45796,6594624,6758976
test,3469,320,245760,102400,14745600,14991360
test,3470,236,181248,55696,8020224,8201472
test,3471,305,234240,93025,13395600,13629840
test,3472,281,215808,78961,11370384,11586192
test,3473,429,329472,184041,26501904,26831376
test,3474,199,152832,39601,5702544,5855376
test,3475,467,358656,218089,31404816,31763472
test,3476,264,202752,69696,10036224,10238976
test,3477,262,201216,68644,9884736,10085952
test,3478,139,106752,19321,2782224,2888976
test,3479,70,53760,4900,705600,759360
test,3480,324,248832,104976,15116544,15365376
test,3481,299,229632,89401,12873744,13103376
test,3482,275,211200,75625,10890000,11101200
test,3483,299,229632,89401,12873744,13103376
test,3484,216,165888,46656,6718464,6884352
test,3485,136,104448,18496,2663424,2767872
test,3486,371,284928,137641,19820304,20105232
test,3487,230,176640,52900,7617600,7794240
test,3488,512,393216,262144,37748736,38141952
test,3489,140,107520,19600,2822400,2929920
test,3490,425,326400,180625,26010000,26336400
test,3491,214,164352,45796,6594624,6758976
test,3492,296,227328,87616,12616704,12844032
test,3493,264,202752,69696,10036224,10238976
test,3494,512,393216,262144,37748736,38141952
test,3495,243,186624,59049,8503056,8689680
test,3496,177,135936,31329,4511376,4647312
test,3497,434,333312,188356,27123264,27456576
test,3498,512,393216,262144,37748736,38141952
test,3499,379,291072,143641,20684304,20975376
test,3500,334,256512,111556,16064064,16320576
test,3501,288,221184,82944,11943936,12165120
test,3502,154,118272,23716,3415104,3533376
test,3503,203,155904,41209,5934096,6090000
test,3504,468,359424,219024,31539456,31898880
test,3505,418,321024,174724,25160256,25481280
test,3506,131,100608,17161,2471184,2571792
test,3507,367,281856,134689,19395216,19677072
test,3508,512,393216,262144,37748736,38141952
test,3509,427,327936,182329,26255376,26583312
test,3510,251,192768,63001,9072144,9264912
test,3511,286,219648,81796,11778624,11998272
test,3512,347,266496,120409,17338896,17605392
test,3513,276,211968,76176,10969344,11181312
test,3514,215,165120,46225,6656400,6821520
test,3515,195,149760,38025,5475600,5625360
test,3516,393,301824,154449,22240656,22542480
test,3517,127,97536,16129,2322576,2420112
test,3518,98,75264,9604,1382976,1458240
test,3519,312,239616,97344,14017536,14257152
test,3520,95,72960,9025,1299600,1372560
test,3521,352,270336,123904,17842176,18112512
test,3522,512,393216,262144,37748736,38141952
test,3523,176,135168,30976,4460544,4595712
test,3524,316,242688,99856,14379264,14621952
test,3525,134,102912,17956,2585664,2688576
test,3526,237,182016,56169,8088336,8270352
test,3527,251,192768,63001,9072144,9264912
test,3528,512,393216,262144,37748736,38141952
test,3529,229,175872,52441,7551504,7727376
test,3530,380,291840,144400,20793600,21085440
test,3531,198,152064,39204,5645376,5797440
test,3532,236,181248,55696,8020224,8201472
test,3533,87,66816,7569,1089936,1156752
test,3534,435,334080,189225,27248400,27582480
test,3535,306,235008,93636,13483584,13718592
test,3536,325,249600,105625,15210000,15459600
test,3537,217,166656,47089,6780816,6947472
test,3538,351,269568,123201,17740944,18010512
test,3539,278,213504,77284,11128896,11342400
test,3540,290,222720,84100,12110400,12333120
test,3541,108,82944,11664,1679616,1762560
test,3542,125,96000,15625,2250000,2346000
test,3543,229,175872,52441,7551504,7727376
test,3544,447,343296,199809,28772496,29115792
test,3545,334,256512,111556,16064064,16320576
test,3546,381,292608,145161,20903184,21195792
test,3547,254,195072,64516,9290304,9485376
test,3548,190,145920,36100,5198400,5344320
test,3549,93,71424,8649,1245456,1316880
test,3550,68,52224,4624,665856,718080
test,3551,256,196608,65536,9437184,9633792
test,3552,429,329472,184041,26501904,26831376
test,3553,418,321024,174724,25160256,25481280
test,3554,251,192768,63001,9072144,9264912
test,3555,386,296448,148996,21455424,21751872
test,3556,325,249600,105625,15210000,15459600
test,3557,273,209664,74529,10732176,10941840
test,3558,391,300288,152881,22014864,22315152
test,3559,159,122112,25281,3640464,3762576
test,3560,38,29184,1444,207936,237120
test,3561,314,241152,98596,14197824,14438976
test,3562,199,152832,39601,5702544,5855376
test,3563,246,188928,60516,8714304,8903232
test,3564,301,231168,90601,13046544,13277712
test,3565,512,393216,262144,37748736,38141952
test,3566,214,164352,45796,6594624,6758976
test,3567,170,130560,28900,4161600,4292160
test,3568,111,85248,12321,1774224,1859472
test,3569,417,320256,173889,25040016,25360272
test,3570,290,222720,84100,12110400,12333120
test,3571,286,219648,81796,11778624,11998272
test,3572,306,235008,93636,13483584,13718592
test,3573,459,352512,210681,30338064,30690576
test,3574,369,283392,136161,19607184,19890576
test,3575,147,112896,21609,3111696,3224592
test,3576,246,188928,60516,8714304,8903232
test,3577,487,374016,237169,34152336,34526352
test,3578,365,280320,133225,19184400,19464720
test,3579,128,98304,16384,2359296,2457600
test,3580,185,142080,34225,4928400,5070480
test,3581,493,378624,243049,34999056,35377680
test,3582,329,252672,108241,15586704,15839376
test,3583,262,201216,68644,9884736,10085952
test,3584,158,121344,24964,3594816,3716160
test,3585,405,311040,164025,23619600,23930640
test,3586,190,145920,36100,5198400,5344320
test,3587,476,365568,226576,32626944,32992512
test,3588,160,122880,25600,3686400,3809280
test,3589,342,262656,116964,16842816,17105472
test,3590,198,152064,39204,5645376,5797440
test,3591,378,290304,142884,20575296,20865600
test,3592,471,361728,221841,31945104,32306832
test,3593,311,238848,96721,13927824,14166672
test,3594,266,204288,70756,10188864,10393152
test,3595,305,234240,93025,13395600,13629840
test,3596,165,126720,27225,3920400,4047120
test,3597,439,337152,192721,27751824,28088976
test,3598,195,149760,38025,5475600,5625360
test,3599,484,371712,234256,33732864,34104576
test,3600,162,124416,26244,3779136,3903552
test,3601,512,393216,262144,37748736,38141952
test,3602,296,227328,87616,12616704,12844032
test,3603,284,218112,80656,11614464,11832576
test,3604,438,336384,191844,27625536,27961920
test,3605,165,126720,27225,3920400,4047120
test,3606,255,195840,65025,9363600,9559440
test,3607,350,268800,122500,17640000,17908800
test,3608,348,267264,121104,17438976,17706240
test,3609,449,344832,201601,29030544,29375376
test,3610,472,362496,222784,32080896,32443392
test,3611,174,133632,30276,4359744,4493376
test,3612,378,290304,142884,20575296,20865600
test,3613,301,231168,90601,13046544,13277712
test,3614,277,212736,76729,11048976,11261712
test,3615,384,294912,147456,21233664,21528576
test,3616,169,129792,28561,4112784,4242576
test,3617,291,223488,84681,12194064,12417552
test,3618,128,98304,16384,2359296,2457600
test,3619,278,213504,77284,11128896,11342400
test,3620,117,89856,13689,1971216,2061072
test,3621,430,330240,184900,26625600,26955840
test,3622,199,152832,39601,5702544,5855376
test,3623,280,215040,78400,11289600,11504640
test,3624,436,334848,190096,27373824,27708672
test,3625,86,66048,7396,1065024,1131072
test,3626,178,136704,31684,4562496,4699200
test,3627,274,210432,75076,10810944,11021376
test,3628,185,142080,34225,4928400,5070480
test,3629,235,180480,55225,7952400,8132880
test,3630,397,304896,157609,22695696,23000592
test,3631,396,304128,156816,22581504,22885632
test,3632,307,235776,94249,13571856,13807632
test,3633,223,171264,49729,7160976,7332240
test,3634,326,250368,106276,15303744,15554112
test,3635,315,241920,99225,14288400,14530320
test,3636,212,162816,44944,6471936,6634752
test,3637,203,155904,41209,5934096,6090000
test,3638,512,393216,262144,37748736,38141952
test,3639,379,291072,143641,20684304,20975376
test,3640,158,121344,24964,3594816,3716160
test,3641,217,166656,47089,6780816,6947472
test,3642,180,138240,32400,4665600,4803840
test,3643,512,393216,262144,37748736,38141952
test,3644,303,232704,91809,13220496,13453200
test,3645,281,215808,78961,11370384,11586192
test,3646,163,125184,26569,3825936,3951120
test,3647,428,328704,183184,26378496,26707200
test,3648,327,251136,106929,15397776,15648912
test,3649,473,363264,223729,32216976,32580240
test,3650,311,238848,96721,13927824,14166672
test,3651,274,210432,75076,10810944,11021376
test,3652,96,73728,9216,1327104,1400832
test,3653,382,293376,145924,21013056,21306432
test,3654,512,393216,262144,37748736,38141952
test,3655,217,166656,47089,6780816,6947472
test,3656,367,281856,134689,19395216,19677072
test,3657,188,144384,35344,5089536,5233920
test,3658,175,134400,30625,4410000,4544400
test,3659,270,207360,72900,10497600,10704960
test,3660,161,123648,25921,3732624,3856272
test,3661,201,154368,40401,5817744,5972112
test,3662,279,214272,77841,11209104,11423376
test,3663,319,244992,101761,14653584,14898576
test,3664,163,125184,26569,3825936,3951120
test,3665,311,238848,96721,13927824,14166672
test,3666,257,197376,66049,9511056,9708432
test,3667,429,329472,184041,26501904,26831376
test,3668,128,98304,16384,2359296,2457600
test,3669,329,252672,108241,15586704,15839376
test,3670,444,340992,197136,28387584,28728576
test,3671,65,49920,4225,608400,658320
test,3672,240,184320,57600,8294400,8478720
test,3673,465,357120,216225,31136400,31493520
test,3674,502,385536,252004,36288576,36674112
test,3675,510,391680,260100,37454400,37846080
test,3676,179,137472,32041,4613904,4751376
test,3677,198,152064,39204,5645376,5797440
test,3678,215,165120,46225,6656400,6821520
test,3679,502,385536,252004,36288576,36674112
test,3680,375,288000,140625,20250000,20538000
test,3681,200,153600,40000,5760000,5913600
test,3682,362,278016,131044,18870336,19148352
test,3683,386,296448,148996,21455424,21751872
test,3684,311,238848,96721,13927824,14166672
test,3685,308,236544,94864,13660416,13896960
test,3686,147,112896,21609,3111696,3224592
test,3687,279,214272,77841,11209104,11423376
test,3688,87,66816,7569,1089936,1156752
test,3689,435,334080,189225,27248400,27582480
test,3690,261,200448,68121,9809424,10009872
test,3691,206,158208,42436,6110784,6268992
test,3692,338,259584,114244,16451136,16710720
test,3693,251,192768,63001,9072144,9264912
test,3694,353,271104,124609,17943696,18214800
test,3695,120,92160,14400,2073600,2165760
test,3696,170,130560,28900,4161600,4292160
test,3697,512,393216,262144,37748736,38141952
test,3698,75,57600,5625,810000,867600
test,3699,243,186624,59049,8503056,8689680
test,3700,334,256512,111556,16064064,16320576
test,3701,246,188928,60516,8714304,8903232
test,3702,350,268800,122500,17640000,17908800
test,3703,200,153600,40000,5760000,5913600
test,3704,127,97536,16129,2322576,2420112
test,3705,397,304896,157609,22695696,23000592
test,3706,344,264192,118336,17040384,17304576
test,3707,196,150528,38416,5531904,5682432
test,3708,342,262656,116964,16842816,17105472
test,3709,175,134400,30625,4410000,4544400
test,3710,231,177408,53361,7683984,7861392
test,3711,335,257280,112225,16160400,16417680
test,3712,258,198144,66564,9585216,9783360
test,3713,122,93696,14884,2143296,2236992
test,3714,220,168960,48400,6969600,7138560
test,3715,512,393216,262144,37748736,38141952
test,3716,180,138240,32400,4665600,4803840
test,3717,311,238848,96721,13927824,14166672
test,3718,237,182016,56169,8088336,8270352
test,3719,443,340224,196249,28259856,28600080
test,3720,359,275712,128881,18558864,18834576
test,3721,249,191232,62001,8928144,9119376
test,3722,512,393216,262144,37748736,38141952
test,3723,119,91392,14161,2039184,2130576
test,3724,210,161280,44100,6350400,6511680
test,3725,179,137472,32041,4613904,4751376
test,3726,99,76032,9801,1411344,1487376
test,3727,184,141312,33856,4875264,5016576
test,3728,271,208128,73441,10575504,10783632
test,3729,512,393216,262144,37748736,38141952
test,3730,112,86016,12544,1806336,1892352
test,3731,356,273408,126736,18249984,18523392
test,3732,262,201216,68644,9884736,10085952
test,3733,489,375552,239121,34433424,34808976
test,3734,310,238080,96100,13838400,14076480
test,3735,209,160512,43681,6290064,6450576
test,3736,435,334080,189225,27248400,27582480
test,3737,228,175104,51984,7485696,7660800
test,3738,104,79872,10816,1557504,1637376
test,3739,355,272640,126025,18147600,18420240
test,3740,295,226560,87025,12531600,12758160
test,3741,287,220416,82369,11861136,12081552
test,3742,413,317184,170569,24561936,24879120
test,3743,149,114432,22201,3196944,3311376
test,3744,102,78336,10404,1498176,1576512
test,3745,422,324096,178084,25644096,25968192
test,3746,94,72192,8836,1272384,1344576
test,3747,164,125952,26896,3873024,3998976
test,3748,428,328704,183184,26378496,26707200
test,3749,179,137472,32041,4613904,4751376
test,3750,271,208128,73441,10575504,10783632
test,3751,175,134400,30625,4410000,4544400
test,3752,418,321024,174724,25160256,25481280
test,3753,220,168960,48400,6969600,7138560
test,3754,360,276480,129600,18662400,18938880
test,3755,410,314880,168100,24206400,24521280
test,3756,327,251136,106929,15397776,15648912
test,3757,327,251136,106929,15397776,15648912
test,3758,231,177408,53361,7683984,7861392
test,3759,323,248064,104329,15023376,15271440
test,3760,255,195840,65025,9363600,9559440
test,3761,193,148224,37249,5363856,5512080
test,3762,259,198912,67081,9659664,9858576
test,3763,258,198144,66564,9585216,9783360
test,3764,110,84480,12100,1742400,1826880
test,3765,227,174336,51529,7420176,7594512
test,3766,480,368640,230400,33177600,33546240
test,3767,257,197376,66049,9511056,9708432
test,3768,62,47616,3844,553536,601152
test,3769,407,312576,165649,23853456,24166032
test,3770,254,195072,64516,9290304,9485376
test,3771,232,178176,53824,7750656,7928832
test,3772,118,90624,13924,2005056,2095680
test,3773,240,184320,57600,8294400,8478720
test,3774,294,225792,86436,12446784,12672576
test,3775,225,172800,50625,7290000,7462800
test,3776,269,206592,72361,10419984,10626576
test,3777,155,119040,24025,3459600,3578640
test,3778,192,147456,36864,5308416,5455872
test,3779,178,136704,31684,4562496,4699200
test,3780,306,235008,93636,13483584,13718592
test,3781,101,77568,10201,1468944,1546512
test,3782,195,149760,38025,5475600,5625360
test,3783,370,284160,136900,19713600,19997760
test,3784,288,221184,82944,11943936,12165120
test,3785,197,151296,38809,5588496,5739792
test,3786,304,233472,92416,13307904,13541376
test,3787,477,366336,227529,32764176,33130512
test,3788,164,125952,26896,3873024,3998976
test,3789,252,193536,63504,9144576,9338112
test,3790,98,75264,9604,1382976,1458240
test,3791,502,385536,252004,36288576,36674112
test,3792,144,110592,20736,2985984,3096576
test,3793,196,150528,38416,5531904,5682432
test,3794,145,111360,21025,3027600,3138960
test,3795,224,172032,50176,7225344,7397376
test,3796,70,53760,4900,705600,759360
test,3797,218,167424,47524,6843456,7010880
test,3798,84,64512,7056,1016064,1080576
test,3799,353,271104,124609,17943696,18214800
test,3800,308,236544,94864,13660416,13896960
test,3801,237,182016,56169,8088336,8270352
test,3802,96,73728,9216,1327104,1400832
test,3803,312,239616,97344,14017536,14257152
test,3804,341,261888,116281,16744464,17006352
test,3805,469,360192,219961,31674384,32034576
test,3806,198,152064,39204,5645376,5797440
test,3807,480,368640,230400,33177600,33546240
test,3808,460,353280,211600,30470400,30823680
test,3809,293,225024,85849,12362256,12587280
test,3810,282,216576,79524,11451456,11668032
test,3811,353,271104,124609,17943696,18214800
test,3812,298,228864,88804,12787776,13016640
test,3813,80,61440,6400,921600,983040
test,3814,199,152832,39601,5702544,5855376
test,3815,183,140544,33489,4822416,4962960
test,3816,512,393216,262144,37748736,38141952
test,3817,196,150528,38416,5531904,5682432
test,3818,310,238080,96100,13838400,14076480
test,3819,204,156672,41616,5992704,6149376
test,3820,354,271872,125316,18045504,18317376
test,3821,143,109824,20449,2944656,3054480
test,3822,335,257280,112225,16160400,16417680
test,3823,512,393216,262144,37748736,38141952
test,3824,199,152832,39601,5702544,5855376
test,3825,258,198144,66564,9585216,9783360
test,3826,205,157440,42025,6051600,6209040
test,3827,438,336384,191844,27625536,27961920
test,3828,142,109056,20164,2903616,3012672
test,3829,242,185856,58564,8433216,8619072
test,3830,413,317184,170569,24561936,24879120
test,3831,394,302592,155236,22353984,22656576
test,3832,221,169728,48841,7033104,7202832
test,3833,393,301824,154449,22240656,22542480
test,3834,248,190464,61504,8856576,9047040
test,3835,265,203520,70225,10112400,10315920
test,3836,321,246528,103041,14837904,15084432
test,3837,203,155904,41209,5934096,6090000
test,3838,81,62208,6561,944784,1006992
test,3839,356,273408,126736,18249984,18523392
test,3840,512,393216,262144,37748736,38141952
test,3841,315,241920,99225,14288400,14530320
test,3842,241,185088,58081,8363664,8548752
test,3843,154,118272,23716,3415104,3533376
test,3844,203,155904,41209,5934096,6090000
test,3845,247,189696,61009,8785296,8974992
test,3846,379,291072,143641,20684304,20975376
test,3847,386,296448,148996,21455424,21751872
test,3848,225,172800,50625,7290000,7462800
test,3849,202,155136,40804,5875776,6030912
test,3850,239,183552,57121,8225424,8408976
test,3851,425,326400,180625,26010000,26336400
test,3852,98,75264,9604,1382976,1458240
test,3853,405,311040,164025,23619600,23930640
test,3854,124,95232,15376,2214144,2309376
test,3855,102,78336,10404,1498176,1576512
test,3856,464,356352,215296,31002624,31358976
test,3857,264,202752,69696,10036224,10238976
test,3858,102,78336,10404,1498176,1576512
test,3859,347,266496,120409,17338896,17605392
test,3860,120,92160,14400,2073600,2165760
test,3861,420,322560,176400,25401600,25724160
test,3862,156,119808,24336,3504384,3624192
test,3863,253,194304,64009,9217296,9411600
test,3864,374,287232,139876,20142144,20429376
test,3865,196,150528,38416,5531904,5682432
test,3866,104,79872,10816,1557504,1637376
test,3867,331,254208,109561,15776784,16030992
test,3868,283,217344,80089,11532816,11750160
test,3869,397,304896,157609,22695696,23000592
test,3870,333,255744,110889,15968016,16223760
test,3871,423,324864,178929,25765776,26090640
test,3872,195,149760,38025,5475600,5625360
test,3873,297,228096,88209,12702096,12930192
test,3874,476,365568,226576,32626944,32992512
test,3875,123,94464,15129,2178576,2273040
test,3876,130,99840,16900,2433600,2533440
test,3877,185,142080,34225,4928400,5070480
test,3878,106,81408,11236,1617984,1699392
test,3879,508,390144,258064,37161216,37551360
test,3880,348,267264,121104,17438976,17706240
test,3881,320,245760,102400,14745600,14991360
test,3882,376,288768,141376,20358144,20646912
test,3883,472,362496,222784,32080896,32443392
test,3884,187,143616,34969,5035536,5179152
test,3885,383,294144,146689,21123216,21417360
test,3886,316,242688,99856,14379264,14621952
test,3887,296,227328,87616,12616704,12844032
test,3888,100,76800,10000,1440000,1516800
test,3889,358,274944,128164,18455616,18730560
test,3890,148,113664,21904,3154176,3267840
test,3891,313,240384,97969,14107536,14347920
test,3892,134,102912,17956,2585664,2688576
test,3893,288,221184,82944,11943936,12165120
test,3894,512,393216,262144,37748736,38141952
test,3895,178,136704,31684,4562496,4699200
test,3896,97,74496,9409,1354896,1429392
test,3897,249,191232,62001,8928144,9119376
test,3898,128,98304,16384,2359296,2457600
test,3899,267,205056,71289,10265616,10470672
test,3900,144,110592,20736,2985984,3096576
test,3901,205,157440,42025,6051600,6209040
test,3902,169,129792,28561,4112784,4242576
test,3903,495,380160,245025,35283600,35663760
test,3904,430,330240,184900,26625600,26955840
test,3905,197,151296,38809,5588496,5739792
test,3906,240,184320,57600,8294400,8478720
test,3907,281,215808,78961,11370384,11586192
test,3908,289,221952,83521,12027024,12248976
test,3909,512,393216,262144,37748736,38141952
test,3910,512,393216,262144,37748736,38141952
test,3911,335,257280,112225,16160400,16417680
test,3912,372,285696,138384,19927296,20212992
test,3913,226,173568,51076,7354944,7528512
test,3914,282,216576,79524,11451456,11668032
test,3915,293,225024,85849,12362256,12587280
test,3916,512,393216,262144,37748736,38141952
test,3917,91,69888,8281,1192464,1262352
test,3918,316,242688,99856,14379264,14621952
test,3919,314,241152,98596,14197824,14438976
test,3920,362,278016,131044,18870336,19148352
test,3921,417,320256,173889,25040016,25360272
test,3922,343,263424,117649,16941456,17204880
test,3923,212,162816,44944,6471936,6634752
test,3924,408,313344,166464,23970816,24284160
test,3925,179,137472,32041,4613904,4751376
test,3926,239,183552,57121,8225424,8408976
test,3927,201,154368,40401,5817744,5972112
test,3928,263,201984,69169,9960336,10162320
test,3929,331,254208,109561,15776784,16030992
test,3930,200,153600,40000,5760000,5913600
test,3931,512,393216,262144,37748736,38141952
test,3932,336,258048,112896,16257024,16515072
test,3933,373,286464,139129,20034576,20321040
test,3934,79,60672,6241,898704,959376
test,3935,284,218112,80656,11614464,11832576
test,3936,338,259584,114244,16451136,16710720
test,3937,262,201216,68644,9884736,10085952
test,3938,223,171264,49729,7160976,7332240
test,3939,224,172032,50176,7225344,7397376
test,3940,156,119808,24336,3504384,3624192
test,3941,200,153600,40000,5760000,5913600
test,3942,286,219648,81796,11778624,11998272
test,3943,340,261120,115600,16646400,16907520
test,3944,282,216576,79524,11451456,11668032
test,3945,262,201216,68644,9884736,10085952
test,3946,54,41472,2916,419904,461376
test,3947,240,184320,57600,8294400,8478720
test,3948,305,234240,93025,13395600,13629840
test,3949,217,166656,47089,6780816,6947472
test,3950,296,227328,87616,12616704,12844032
test,3951,464,356352,215296,31002624,31358976
test,3952,204,156672,41616,5992704,6149376
test,3953,223,171264,49729,7160976,7332240
test,3954,167,128256,27889,4016016,4144272
test,3955,159,122112,25281,3640464,3762576
test,3956,358,274944,128164,18455616,18730560
test,3957,372,285696,138384,19927296,20212992
test,3958,178,136704,31684,4562496,4699200
test,3959,295,226560,87025,12531600,12758160
test,3960,381,292608,145161,20903184,21195792
test,3961,512,393216,262144,37748736,38141952
test,3962,137,105216,18769,2702736,2807952
test,3963,325,249600,105625,15210000,15459600
test,3964,322,247296,103684,14930496,15177792
test,3965,88,67584,7744,1115136,1182720
test,3966,170,130560,28900,4161600,4292160
test,3967,463,355584,214369,30869136,31224720
test,3968,285,218880,81225,11696400,11915280
test,3969,165,126720,27225,3920400,4047120
test,3970,412,316416,169744,24443136,24759552
test,3971,280,215040,78400,11289600,11504640
test,3972,491,377088,241081,34715664,35092752
test,3973,512,393216,262144,37748736,38141952
test,3974,425,326400,180625,26010000,26336400
test,3975,158,121344,24964,3594816,3716160
test,3976,317,243456,100489,14470416,14713872
test,3977,317,243456,100489,14470416,14713872
test,3978,277,212736,76729,11048976,11261712
test,3979,240,184320,57600,8294400,8478720
test,3980,512,393216,262144,37748736,38141952
test,3981,190,145920,36100,5198400,5344320
test,3982,307,235776,94249,13571856,13807632
test,3983,279,214272,77841,11209104,11423376
test,3984,140,107520,19600,2822400,2929920
test,3985,366,281088,133956,19289664,19570752
test,3986,512,393216,262144,37748736,38141952
test,3987,264,202752,69696,10036224,10238976
test,3988,307,235776,94249,13571856,13807632
test,3989,403,309504,162409,23386896,23696400
test,3990,223,171264,49729,7160976,7332240
test,3991,451,346368,203401,29289744,29636112
test,3992,512,393216,262144,37748736,38141952
test,3993,394,302592,155236,22353984,22656576
test,3994,173,132864,29929,4309776,4442640
test,3995,379,291072,143641,20684304,20975376
test,3996,255,195840,65025,9363600,9559440
test,3997,150,115200,22500,3240000,3355200
test,3998,266,204288,70756,10188864,10393152
test,3999,370,284160,136900,19713600,19997760
test,4000,232,178176,53824,7750656,7928832
test,4001,419,321792,175561,25280784,25602576
test,4002,325,249600,105625,15210000,15459600
test,4003,419,321792,175561,25280784,25602576
test,4004,354,271872,125316,18045504,18317376
test,4005,328,251904,107584,15492096,15744000
test,4006,143,109824,20449,2944656,3054480
test,4007,453,347904,205209,29550096,29898000
test,4008,464,356352,215296,31002624,31358976
test,4009,330,253440,108900,15681600,15935040
test,4010,326,250368,106276,15303744,15554112
test,4011,302,231936,91204,13133376,13365312
test,4012,462,354816,213444,30735936,31090752
test,4013,148,113664,21904,3154176,3267840
test,4014,426,327168,181476,26132544,26459712
test,4015,416,319488,173056,24920064,25239552
test,4016,225,172800,50625,7290000,7462800
test,4017,246,188928,60516,8714304,8903232
test,4018,226,173568,51076,7354944,7528512
test,4019,85,65280,7225,1040400,1105680
test,4020,391,300288,152881,22014864,22315152
test,4021,336,258048,112896,16257024,16515072
test,4022,317,243456,100489,14470416,14713872
test,4023,270,207360,72900,10497600,10704960
test,4024,319,244992,101761,14653584,14898576
test,4025,209,160512,43681,6290064,6450576
test,4026,512,393216,262144,37748736,38141952
test,4027,121,92928,14641,2108304,2201232
test,4028,164,125952,26896,3873024,3998976
test,4029,288,221184,82944,11943936,12165120
test,4030,315,241920,99225,14288400,14530320
test,4031,252,193536,63504,9144576,9338112
test,4032,296,227328,87616,12616704,12844032
test,4033,485,372480,235225,33872400,34244880
test,4034,150,115200,22500,3240000,3355200
test,4035,220,168960,48400,6969600,7138560
test,4036,253,194304,64009,9217296,9411600
test,4037,157,120576,24649,3549456,3670032
test,4038,240,184320,57600,8294400,8478720
test,4039,316,242688,99856,14379264,14621952
test,4040,312,239616,97344,14017536,14257152
test,4041,439,337152,192721,27751824,28088976
test,4042,93,71424,8649,1245456,1316880
