split,index,nodes,total_values_for_nodes,edges,total_values_for_edges,total_values_for_graph
train,0,26,19968,676,97344,117312
train,1,305,234240,93025,13395600,13629840
train,2,18,13824,324,46656,60480
train,3,87,66816,7569,1089936,1156752
train,4,54,41472,2916,419904,461376
train,5,43,33024,1849,266256,299280
train,6,512,393216,262144,37748736,38141952
train,7,49,37632,2401,345744,383376
train,8,53,40704,2809,404496,445200
train,9,312,239616,97344,14017536,14257152
train,10,50,38400,2500,360000,398400
train,11,57,43776,3249,467856,511632
train,12,77,59136,5929,853776,912912
train,13,198,152064,39204,5645376,5797440
train,14,190,145920,36100,5198400,5344320
train,15,46,35328,2116,304704,340032
train,16,98,75264,9604,1382976,1458240
train,17,117,89856,13689,1971216,2061072
train,18,320,245760,102400,14745600,14991360
train,19,512,393216,262144,37748736,38141952
train,20,168,129024,28224,4064256,4193280
train,21,269,206592,72361,10419984,10626576
train,22,273,209664,74529,10732176,10941840
train,23,61,46848,3721,535824,582672
train,24,53,40704,2809,404496,445200
train,25,30,23040,900,129600,152640
train,26,83,63744,6889,992016,1055760
train,27,22,16896,484,69696,86592
train,28,62,47616,3844,553536,601152
train,29,47,36096,2209,318096,354192
train,30,61,46848,3721,535824,582672
train,31,428,328704,183184,26378496,26707200
train,32,27,20736,729,104976,125712
train,33,43,33024,1849,266256,299280
train,34,180,138240,32400,4665600,4803840
train,35,77,59136,5929,853776,912912
train,36,30,23040,900,129600,152640
train,37,29,22272,841,121104,143376
train,38,92,70656,8464,1218816,1289472
train,39,400,307200,160000,23040000,23347200
train,40,29,22272,841,121104,143376
train,41,67,51456,4489,646416,697872
train,42,47,36096,2209,318096,354192
train,43,75,57600,5625,810000,867600
train,44,50,38400,2500,360000,398400
train,45,512,393216,262144,37748736,38141952
train,46,88,67584,7744,1115136,1182720
train,47,86,66048,7396,1065024,1131072
train,48,57,43776,3249,467856,511632
train,49,27,20736,729,104976,125712
train,50,512,393216,262144,37748736,38141952
train,51,91,69888,8281,1192464,1262352
train,52,150,115200,22500,3240000,3355200
train,53,215,165120,46225,6656400,6821520
train,54,70,53760,4900,705600,759360
train,55,343,263424,117649,16941456,17204880
train,56,61,46848,3721,535824,582672
train,57,61,46848,3721,535824,582672
train,58,64,49152,4096,589824,638976
train,59,106,81408,11236,1617984,1699392
train,60,49,37632,2401,345744,383376
train,61,86,66048,7396,1065024,1131072
train,62,119,91392,14161,2039184,2130576
train,63,12,9216,144,20736,29952
train,64,72,55296,5184,746496,801792
train,65,193,148224,37249,5363856,5512080
train,66,57,43776,3249,467856,511632
train,67,100,76800,10000,1440000,1516800
train,68,173,132864,29929,4309776,4442640
train,69,69,52992,4761,685584,738576
train,70,74,56832,5476,788544,845376
train,71,27,20736,729,104976,125712
train,72,100,76800,10000,1440000,1516800
train,73,81,62208,6561,944784,1006992
train,74,54,41472,2916,419904,461376
train,75,18,13824,324,46656,60480
train,76,323,248064,104329,15023376,15271440
train,77,27,20736,729,104976,125712
train,78,68,52224,4624,665856,718080
train,79,32,24576,1024,147456,172032
train,80,122,93696,14884,2143296,2236992
train,81,73,56064,5329,767376,823440
train,82,106,81408,11236,1617984,1699392
train,83,87,66816,7569,1089936,1156752
train,84,72,55296,5184,746496,801792
train,85,83,63744,6889,992016,1055760
train,86,38,29184,1444,207936,237120
train,87,316,242688,99856,14379264,14621952
train,88,102,78336,10404,1498176,1576512
train,89,26,19968,676,97344,117312
train,90,27,20736,729,104976,125712
train,91,14,10752,196,28224,38976
train,92,84,64512,7056,1016064,1080576
train,93,203,155904,41209,5934096,6090000
train,94,51,39168,2601,374544,413712
train,95,14,10752,196,28224,38976
train,96,118,90624,13924,2005056,2095680
train,97,512,393216,262144,37748736,38141952
train,98,33,25344,1089,156816,182160
train,99,63,48384,3969,571536,619920
train,100,119,91392,14161,2039184,2130576
train,101,77,59136,5929,853776,912912
train,102,207,158976,42849,6170256,6329232
train,103,66,50688,4356,627264,677952
train,104,98,75264,9604,1382976,1458240
train,105,202,155136,40804,5875776,6030912
train,106,62,47616,3844,553536,601152
train,107,64,49152,4096,589824,638976
train,108,14,10752,196,28224,38976
train,109,47,36096,2209,318096,354192
train,110,60,46080,3600,518400,564480
train,111,35,26880,1225,176400,203280
train,112,117,89856,13689,1971216,2061072
train,113,26,19968,676,97344,117312
train,114,80,61440,6400,921600,983040
train,115,34,26112,1156,166464,192576
train,116,137,105216,18769,2702736,2807952
train,117,234,179712,54756,7884864,8064576
train,118,119,91392,14161,2039184,2130576
train,119,61,46848,3721,535824,582672
train,120,512,393216,262144,37748736,38141952
train,121,98,75264,9604,1382976,1458240
train,122,46,35328,2116,304704,340032
train,123,28,21504,784,112896,134400
train,124,65,49920,4225,608400,658320
train,125,112,86016,12544,1806336,1892352
train,126,61,46848,3721,535824,582672
train,127,123,94464,15129,2178576,2273040
train,128,203,155904,41209,5934096,6090000
train,129,45,34560,2025,291600,326160
train,130,163,125184,26569,3825936,3951120
train,131,45,34560,2025,291600,326160
train,132,56,43008,3136,451584,494592
train,133,48,36864,2304,331776,368640
train,134,71,54528,5041,725904,780432
train,135,96,73728,9216,1327104,1400832
train,136,258,198144,66564,9585216,9783360
train,137,83,63744,6889,992016,1055760
train,138,183,140544,33489,4822416,4962960
train,139,109,83712,11881,1710864,1794576
train,140,190,145920,36100,5198400,5344320
train,141,31,23808,961,138384,162192
train,142,105,80640,11025,1587600,1668240
train,143,166,127488,27556,3968064,4095552
train,144,54,41472,2916,419904,461376
train,145,103,79104,10609,1527696,1606800
train,146,112,86016,12544,1806336,1892352
train,147,244,187392,59536,8573184,8760576
train,148,18,13824,324,46656,60480
train,149,101,77568,10201,1468944,1546512
train,150,227,174336,51529,7420176,7594512
train,151,155,119040,24025,3459600,3578640
train,152,30,23040,900,129600,152640
train,153,39,29952,1521,219024,248976
train,154,46,35328,2116,304704,340032
train,155,77,59136,5929,853776,912912
train,156,59,45312,3481,501264,546576
train,157,76,58368,5776,831744,890112
train,158,104,79872,10816,1557504,1637376
train,159,143,109824,20449,2944656,3054480
train,160,43,33024,1849,266256,299280
train,161,16,12288,256,36864,49152
train,162,59,45312,3481,501264,546576
train,163,53,40704,2809,404496,445200
train,164,49,37632,2401,345744,383376
train,165,512,393216,262144,37748736,38141952
train,166,77,59136,5929,853776,912912
train,167,306,235008,93636,13483584,13718592
train,168,227,174336,51529,7420176,7594512
train,169,29,22272,841,121104,143376
train,170,40,30720,1600,230400,261120
train,171,162,124416,26244,3779136,3903552
train,172,99,76032,9801,1411344,1487376
train,173,15,11520,225,32400,43920
train,174,40,30720,1600,230400,261120
train,175,25,19200,625,90000,109200
train,176,174,133632,30276,4359744,4493376
train,177,288,221184,82944,11943936,12165120
train,178,63,48384,3969,571536,619920
train,179,175,134400,30625,4410000,4544400
train,180,395,303360,156025,22467600,22770960
train,181,151,115968,22801,3283344,3399312
train,182,276,211968,76176,10969344,11181312
train,183,349,268032,121801,17539344,17807376
train,184,53,40704,2809,404496,445200
train,185,132,101376,17424,2509056,2610432
train,186,222,170496,49284,7096896,7267392
train,187,30,23040,900,129600,152640
train,188,326,250368,106276,15303744,15554112
train,189,228,175104,51984,7485696,7660800
train,190,50,38400,2500,360000,398400
train,191,288,221184,82944,11943936,12165120
train,192,387,297216,149769,21566736,21863952
train,193,25,19200,625,90000,109200
train,194,512,393216,262144,37748736,38141952
train,195,87,66816,7569,1089936,1156752
train,196,120,92160,14400,2073600,2165760
train,197,87,66816,7569,1089936,1156752
train,198,191,146688,36481,5253264,5399952
train,199,126,96768,15876,2286144,2382912
train,200,77,59136,5929,853776,912912
train,201,331,254208,109561,15776784,16030992
train,202,121,92928,14641,2108304,2201232
train,203,112,86016,12544,1806336,1892352
train,204,63,48384,3969,571536,619920
train,205,208,159744,43264,6230016,6389760
train,206,43,33024,1849,266256,299280
train,207,62,47616,3844,553536,601152
train,208,121,92928,14641,2108304,2201232
train,209,55,42240,3025,435600,477840
train,210,26,19968,676,97344,117312
train,211,52,39936,2704,389376,429312
train,212,72,55296,5184,746496,801792
train,213,27,20736,729,104976,125712
train,214,343,263424,117649,16941456,17204880
train,215,53,40704,2809,404496,445200
train,216,26,19968,676,97344,117312
train,217,108,82944,11664,1679616,1762560
train,218,107,82176,11449,1648656,1730832
train,219,137,105216,18769,2702736,2807952
train,220,49,37632,2401,345744,383376
train,221,87,66816,7569,1089936,1156752
train,222,102,78336,10404,1498176,1576512
train,223,123,94464,15129,2178576,2273040
train,224,134,102912,17956,2585664,2688576
train,225,68,52224,4624,665856,718080
train,226,50,38400,2500,360000,398400
train,227,20,15360,400,57600,72960
train,228,47,36096,2209,318096,354192
train,229,30,23040,900,129600,152640
train,230,95,72960,9025,1299600,1372560
train,231,40,30720,1600,230400,261120
train,232,28,21504,784,112896,134400
train,233,156,119808,24336,3504384,3624192
train,234,98,75264,9604,1382976,1458240
train,235,335,257280,112225,16160400,16417680
train,236,126,96768,15876,2286144,2382912
train,237,137,105216,18769,2702736,2807952
train,238,16,12288,256,36864,49152
train,239,72,55296,5184,746496,801792
train,240,40,30720,1600,230400,261120
train,241,41,31488,1681,242064,273552
train,242,38,29184,1444,207936,237120
train,243,512,393216,262144,37748736,38141952
train,244,90,69120,8100,1166400,1235520
train,245,512,393216,262144,37748736,38141952
train,246,83,63744,6889,992016,1055760
train,247,124,95232,15376,2214144,2309376
train,248,116,89088,13456,1937664,2026752
train,249,66,50688,4356,627264,677952
train,250,78,59904,6084,876096,936000
train,251,28,21504,784,112896,134400
train,252,102,78336,10404,1498176,1576512
train,253,34,26112,1156,166464,192576
train,254,395,303360,156025,22467600,22770960
train,255,487,374016,237169,34152336,34526352
train,256,27,20736,729,104976,125712
train,257,95,72960,9025,1299600,1372560
train,258,32,24576,1024,147456,172032
train,259,83,63744,6889,992016,1055760
train,260,17,13056,289,41616,54672
train,261,56,43008,3136,451584,494592
train,262,294,225792,86436,12446784,12672576
train,263,32,24576,1024,147456,172032
train,264,102,78336,10404,1498176,1576512
train,265,218,167424,47524,6843456,7010880
train,266,164,125952,26896,3873024,3998976
train,267,64,49152,4096,589824,638976
train,268,228,175104,51984,7485696,7660800
train,269,113,86784,12769,1838736,1925520
train,270,320,245760,102400,14745600,14991360
train,271,44,33792,1936,278784,312576
train,272,67,51456,4489,646416,697872
train,273,49,37632,2401,345744,383376
train,274,115,88320,13225,1904400,1992720
train,275,65,49920,4225,608400,658320
train,276,27,20736,729,104976,125712
train,277,296,227328,87616,12616704,12844032
train,278,26,19968,676,97344,117312
train,279,120,92160,14400,2073600,2165760
train,280,36,27648,1296,186624,214272
train,281,52,39936,2704,389376,429312
train,282,309,237312,95481,13749264,13986576
train,283,75,57600,5625,810000,867600
train,284,79,60672,6241,898704,959376
train,285,64,49152,4096,589824,638976
train,286,129,99072,16641,2396304,2495376
train,287,97,74496,9409,1354896,1429392
train,288,36,27648,1296,186624,214272
train,289,101,77568,10201,1468944,1546512
train,290,70,53760,4900,705600,759360
train,291,251,192768,63001,9072144,9264912
train,292,33,25344,1089,156816,182160
train,293,102,78336,10404,1498176,1576512
train,294,307,235776,94249,13571856,13807632
train,295,27,20736,729,104976,125712
train,296,93,71424,8649,1245456,1316880
train,297,158,121344,24964,3594816,3716160
train,298,74,56832,5476,788544,845376
train,299,13,9984,169,24336,34320
train,300,73,56064,5329,767376,823440
train,301,52,39936,2704,389376,429312
train,302,277,212736,76729,11048976,11261712
train,303,17,13056,289,41616,54672
train,304,14,10752,196,28224,38976
train,305,68,52224,4624,665856,718080
train,306,51,39168,2601,374544,413712
train,307,105,80640,11025,1587600,1668240
train,308,29,22272,841,121104,143376
train,309,152,116736,23104,3326976,3443712
train,310,101,77568,10201,1468944,1546512
train,311,332,254976,110224,15872256,16127232
train,312,117,89856,13689,1971216,2061072
train,313,98,75264,9604,1382976,1458240
train,314,70,53760,4900,705600,759360
train,315,12,9216,144,20736,29952
train,316,32,24576,1024,147456,172032
train,317,100,76800,10000,1440000,1516800
train,318,69,52992,4761,685584,738576
train,319,112,86016,12544,1806336,1892352
train,320,28,21504,784,112896,134400
train,321,49,37632,2401,345744,383376
train,322,86,66048,7396,1065024,1131072
train,323,87,66816,7569,1089936,1156752
train,324,188,144384,35344,5089536,5233920
train,325,512,393216,262144,37748736,38141952
train,326,40,30720,1600,230400,261120
train,327,264,202752,69696,10036224,10238976
train,328,287,220416,82369,11861136,12081552
train,329,467,358656,218089,31404816,31763472
train,330,186,142848,34596,4981824,5124672
train,331,78,59904,6084,876096,936000
train,332,26,19968,676,97344,117312
train,333,26,19968,676,97344,117312
train,334,80,61440,6400,921600,983040
train,335,26,19968,676,97344,117312
train,336,105,80640,11025,1587600,1668240
train,337,512,393216,262144,37748736,38141952
train,338,205,157440,42025,6051600,6209040
train,339,30,23040,900,129600,152640
train,340,16,12288,256,36864,49152
train,341,98,75264,9604,1382976,1458240
train,342,129,99072,16641,2396304,2495376
train,343,86,66048,7396,1065024,1131072
train,344,163,125184,26569,3825936,3951120
train,345,129,99072,16641,2396304,2495376
train,346,109,83712,11881,1710864,1794576
train,347,177,135936,31329,4511376,4647312
train,348,32,24576,1024,147456,172032
train,349,129,99072,16641,2396304,2495376
train,350,82,62976,6724,968256,1031232
train,351,174,133632,30276,4359744,4493376
train,352,101,77568,10201,1468944,1546512
train,353,17,13056,289,41616,54672
train,354,93,71424,8649,1245456,1316880
train,355,97,74496,9409,1354896,1429392
train,356,15,11520,225,32400,43920
train,357,61,46848,3721,535824,582672
train,358,48,36864,2304,331776,368640
train,359,148,113664,21904,3154176,3267840
train,360,111,85248,12321,1774224,1859472
train,361,56,43008,3136,451584,494592
train,362,205,157440,42025,6051600,6209040
train,363,47,36096,2209,318096,354192
train,364,14,10752,196,28224,38976
train,365,122,93696,14884,2143296,2236992
train,366,512,393216,262144,37748736,38141952
train,367,98,75264,9604,1382976,1458240
train,368,18,13824,324,46656,60480
train,369,16,12288,256,36864,49152
train,370,28,21504,784,112896,134400
train,371,334,256512,111556,16064064,16320576
train,372,97,74496,9409,1354896,1429392
train,373,119,91392,14161,2039184,2130576
train,374,20,15360,400,57600,72960
train,375,289,221952,83521,12027024,12248976
train,376,41,31488,1681,242064,273552
train,377,34,26112,1156,166464,192576
train,378,17,13056,289,41616,54672
train,379,28,21504,784,112896,134400
train,380,28,21504,784,112896,134400
train,381,105,80640,11025,1587600,1668240
train,382,65,49920,4225,608400,658320
train,383,206,158208,42436,6110784,6268992
train,384,141,108288,19881,2862864,2971152
train,385,30,23040,900,129600,152640
train,386,104,79872,10816,1557504,1637376
train,387,90,69120,8100,1166400,1235520
train,388,44,33792,1936,278784,312576
train,389,80,61440,6400,921600,983040
train,390,11,8448,121,17424,25872
train,391,36,27648,1296,186624,214272
train,392,184,141312,33856,4875264,5016576
train,393,185,142080,34225,4928400,5070480
train,394,102,78336,10404,1498176,1576512
train,395,34,26112,1156,166464,192576
train,396,91,69888,8281,1192464,1262352
train,397,231,177408,53361,7683984,7861392
train,398,13,9984,169,24336,34320
train,399,116,89088,13456,1937664,2026752
train,400,74,56832,5476,788544,845376
train,401,16,12288,256,36864,49152
train,402,96,73728,9216,1327104,1400832
train,403,27,20736,729,104976,125712
train,404,27,20736,729,104976,125712
train,405,181,139008,32761,4717584,4856592
train,406,235,180480,55225,7952400,8132880
train,407,495,380160,245025,35283600,35663760
train,408,426,327168,181476,26132544,26459712
train,409,96,73728,9216,1327104,1400832
train,410,110,84480,12100,1742400,1826880
train,411,118,90624,13924,2005056,2095680
train,412,151,115968,22801,3283344,3399312
train,413,70,53760,4900,705600,759360
train,414,73,56064,5329,767376,823440
train,415,207,158976,42849,6170256,6329232
train,416,216,165888,46656,6718464,6884352
train,417,39,29952,1521,219024,248976
train,418,49,37632,2401,345744,383376
train,419,29,22272,841,121104,143376
train,420,53,40704,2809,404496,445200
train,421,159,122112,25281,3640464,3762576
train,422,54,41472,2916,419904,461376
train,423,115,88320,13225,1904400,1992720
train,424,512,393216,262144,37748736,38141952
train,425,126,96768,15876,2286144,2382912
train,426,380,291840,144400,20793600,21085440
train,427,115,88320,13225,1904400,1992720
train,428,123,94464,15129,2178576,2273040
train,429,82,62976,6724,968256,1031232
train,430,13,9984,169,24336,34320
train,431,115,88320,13225,1904400,1992720
train,432,30,23040,900,129600,152640
train,433,362,278016,131044,18870336,19148352
train,434,62,47616,3844,553536,601152
train,435,219,168192,47961,6906384,7074576
train,436,80,61440,6400,921600,983040
train,437,95,72960,9025,1299600,1372560
train,438,40,30720,1600,230400,261120
train,439,101,77568,10201,1468944,1546512
train,440,159,122112,25281,3640464,3762576
train,441,44,33792,1936,278784,312576
train,442,108,82944,11664,1679616,1762560
train,443,152,116736,23104,3326976,3443712
train,444,58,44544,3364,484416,528960
train,445,101,77568,10201,1468944,1546512
train,446,78,59904,6084,876096,936000
train,447,64,49152,4096,589824,638976
train,448,28,21504,784,112896,134400
train,449,210,161280,44100,6350400,6511680
train,450,105,80640,11025,1587600,1668240
train,451,28,21504,784,112896,134400
train,452,25,19200,625,90000,109200
train,453,105,80640,11025,1587600,1668240
train,454,130,99840,16900,2433600,2533440
train,455,188,144384,35344,5089536,5233920
train,456,201,154368,40401,5817744,5972112
train,457,124,95232,15376,2214144,2309376
train,458,18,13824,324,46656,60480
train,459,77,59136,5929,853776,912912
train,460,102,78336,10404,1498176,1576512
train,461,77,59136,5929,853776,912912
train,462,86,66048,7396,1065024,1131072
train,463,16,12288,256,36864,49152
train,464,28,21504,784,112896,134400
train,465,83,63744,6889,992016,1055760
train,466,47,36096,2209,318096,354192
train,467,15,11520,225,32400,43920
train,468,84,64512,7056,1016064,1080576
train,469,512,393216,262144,37748736,38141952
train,470,97,74496,9409,1354896,1429392
train,471,31,23808,961,138384,162192
train,472,421,323328,177241,25522704,25846032
train,473,149,114432,22201,3196944,3311376
train,474,59,45312,3481,501264,546576
train,475,208,159744,43264,6230016,6389760
train,476,291,223488,84681,12194064,12417552
train,477,72,55296,5184,746496,801792
train,478,55,42240,3025,435600,477840
train,479,53,40704,2809,404496,445200
train,480,472,362496,222784,32080896,32443392
train,481,290,222720,84100,12110400,12333120
train,482,31,23808,961,138384,162192
train,483,140,107520,19600,2822400,2929920
train,484,96,73728,9216,1327104,1400832
train,485,227,174336,51529,7420176,7594512
train,486,106,81408,11236,1617984,1699392
train,487,55,42240,3025,435600,477840
train,488,52,39936,2704,389376,429312
train,489,16,12288,256,36864,49152
train,490,429,329472,184041,26501904,26831376
train,491,37,28416,1369,197136,225552
train,492,59,45312,3481,501264,546576
train,493,196,150528,38416,5531904,5682432
train,494,50,38400,2500,360000,398400
train,495,127,97536,16129,2322576,2420112
train,496,90,69120,8100,1166400,1235520
train,497,17,13056,289,41616,54672
train,498,190,145920,36100,5198400,5344320
train,499,83,63744,6889,992016,1055760
train,500,512,393216,262144,37748736,38141952
train,501,112,86016,12544,1806336,1892352
train,502,79,60672,6241,898704,959376
train,503,107,82176,11449,1648656,1730832
train,504,14,10752,196,28224,38976
train,505,314,241152,98596,14197824,14438976
train,506,134,102912,17956,2585664,2688576
train,507,77,59136,5929,853776,912912
train,508,26,19968,676,97344,117312
train,509,122,93696,14884,2143296,2236992
train,510,76,58368,5776,831744,890112
train,511,69,52992,4761,685584,738576
train,512,117,89856,13689,1971216,2061072
train,513,145,111360,21025,3027600,3138960
train,514,27,20736,729,104976,125712
train,515,47,36096,2209,318096,354192
train,516,77,59136,5929,853776,912912
train,517,30,23040,900,129600,152640
train,518,55,42240,3025,435600,477840
train,519,60,46080,3600,518400,564480
train,520,68,52224,4624,665856,718080
train,521,40,30720,1600,230400,261120
train,522,123,94464,15129,2178576,2273040
train,523,254,195072,64516,9290304,9485376
train,524,81,62208,6561,944784,1006992
train,525,33,25344,1089,156816,182160
train,526,25,19200,625,90000,109200
train,527,87,66816,7569,1089936,1156752
train,528,119,91392,14161,2039184,2130576
train,529,18,13824,324,46656,60480
train,530,88,67584,7744,1115136,1182720
train,531,76,58368,5776,831744,890112
train,532,27,20736,729,104976,125712
train,533,17,13056,289,41616,54672
train,534,81,62208,6561,944784,1006992
train,535,512,393216,262144,37748736,38141952
train,536,145,111360,21025,3027600,3138960
train,537,110,84480,12100,1742400,1826880
train,538,97,74496,9409,1354896,1429392
train,539,87,66816,7569,1089936,1156752
train,540,125,96000,15625,2250000,2346000
train,541,75,57600,5625,810000,867600
train,542,512,393216,262144,37748736,38141952
train,543,236,181248,55696,8020224,8201472
train,544,293,225024,85849,12362256,12587280
train,545,54,41472,2916,419904,461376
train,546,44,33792,1936,278784,312576
train,547,79,60672,6241,898704,959376
train,548,101,77568,10201,1468944,1546512
train,549,407,312576,165649,23853456,24166032
train,550,40,30720,1600,230400,261120
train,551,512,393216,262144,37748736,38141952
train,552,55,42240,3025,435600,477840
train,553,244,187392,59536,8573184,8760576
train,554,100,76800,10000,1440000,1516800
train,555,191,146688,36481,5253264,5399952
train,556,130,99840,16900,2433600,2533440
train,557,206,158208,42436,6110784,6268992
train,558,65,49920,4225,608400,658320
train,559,512,393216,262144,37748736,38141952
train,560,53,40704,2809,404496,445200
train,561,85,65280,7225,1040400,1105680
train,562,313,240384,97969,14107536,14347920
train,563,73,56064,5329,767376,823440
train,564,69,52992,4761,685584,738576
train,565,108,82944,11664,1679616,1762560
train,566,82,62976,6724,968256,1031232
train,567,228,175104,51984,7485696,7660800
train,568,97,74496,9409,1354896,1429392
train,569,120,92160,14400,2073600,2165760
train,570,30,23040,900,129600,152640
train,571,43,33024,1849,266256,299280
train,572,76,58368,5776,831744,890112
train,573,15,11520,225,32400,43920
train,574,118,90624,13924,2005056,2095680
train,575,40,30720,1600,230400,261120
train,576,14,10752,196,28224,38976
train,577,34,26112,1156,166464,192576
train,578,58,44544,3364,484416,528960
train,579,153,117504,23409,3370896,3488400
train,580,55,42240,3025,435600,477840
train,581,36,27648,1296,186624,214272
train,582,87,66816,7569,1089936,1156752
train,583,26,19968,676,97344,117312
train,584,19,14592,361,51984,66576
train,585,119,91392,14161,2039184,2130576
train,586,75,57600,5625,810000,867600
train,587,38,29184,1444,207936,237120
train,588,166,127488,27556,3968064,4095552
train,589,218,167424,47524,6843456,7010880
train,590,108,82944,11664,1679616,1762560
train,591,67,51456,4489,646416,697872
train,592,108,82944,11664,1679616,1762560
train,593,250,192000,62500,9000000,9192000
train,594,18,13824,324,46656,60480
train,595,17,13056,289,41616,54672
train,596,96,73728,9216,1327104,1400832
train,597,90,69120,8100,1166400,1235520
train,598,48,36864,2304,331776,368640
train,599,109,83712,11881,1710864,1794576
train,600,45,34560,2025,291600,326160
train,601,21,16128,441,63504,79632
train,602,13,9984,169,24336,34320
train,603,338,259584,114244,16451136,16710720
train,604,364,279552,132496,19079424,19358976
train,605,128,98304,16384,2359296,2457600
train,606,57,43776,3249,467856,511632
train,607,71,54528,5041,725904,780432
train,608,24,18432,576,82944,101376
train,609,246,188928,60516,8714304,8903232
train,610,57,43776,3249,467856,511632
train,611,49,37632,2401,345744,383376
train,612,120,92160,14400,2073600,2165760
train,613,57,43776,3249,467856,511632
train,614,21,16128,441,63504,79632
train,615,103,79104,10609,1527696,1606800
train,616,136,104448,18496,2663424,2767872
train,617,159,122112,25281,3640464,3762576
train,618,32,24576,1024,147456,172032
train,619,74,56832,5476,788544,845376
train,620,28,21504,784,112896,134400
train,621,50,38400,2500,360000,398400
train,622,73,56064,5329,767376,823440
train,623,74,56832,5476,788544,845376
train,624,99,76032,9801,1411344,1487376
train,625,85,65280,7225,1040400,1105680
train,626,77,59136,5929,853776,912912
train,627,39,29952,1521,219024,248976
train,628,103,79104,10609,1527696,1606800
train,629,75,57600,5625,810000,867600
train,630,89,68352,7921,1140624,1208976
train,631,73,56064,5329,767376,823440
train,632,78,59904,6084,876096,936000
train,633,78,59904,6084,876096,936000
train,634,27,20736,729,104976,125712
train,635,117,89856,13689,1971216,2061072
train,636,40,30720,1600,230400,261120
train,637,228,175104,51984,7485696,7660800
train,638,115,88320,13225,1904400,1992720
train,639,31,23808,961,138384,162192
train,640,161,123648,25921,3732624,3856272
train,641,29,22272,841,121104,143376
train,642,28,21504,784,112896,134400
train,643,50,38400,2500,360000,398400
train,644,53,40704,2809,404496,445200
train,645,13,9984,169,24336,34320
train,646,512,393216,262144,37748736,38141952
train,647,76,58368,5776,831744,890112
train,648,28,21504,784,112896,134400
train,649,130,99840,16900,2433600,2533440
train,650,43,33024,1849,266256,299280
train,651,44,33792,1936,278784,312576
train,652,26,19968,676,97344,117312
train,653,108,82944,11664,1679616,1762560
train,654,48,36864,2304,331776,368640
train,655,49,37632,2401,345744,383376
train,656,25,19200,625,90000,109200
train,657,27,20736,729,104976,125712
train,658,61,46848,3721,535824,582672
train,659,107,82176,11449,1648656,1730832
train,660,39,29952,1521,219024,248976
train,661,62,47616,3844,553536,601152
train,662,72,55296,5184,746496,801792
train,663,27,20736,729,104976,125712
train,664,119,91392,14161,2039184,2130576
train,665,382,293376,145924,21013056,21306432
train,666,503,386304,253009,36433296,36819600
train,667,60,46080,3600,518400,564480
train,668,27,20736,729,104976,125712
train,669,85,65280,7225,1040400,1105680
train,670,35,26880,1225,176400,203280
train,671,103,79104,10609,1527696,1606800
train,672,151,115968,22801,3283344,3399312
train,673,127,97536,16129,2322576,2420112
train,674,17,13056,289,41616,54672
train,675,99,76032,9801,1411344,1487376
train,676,455,349440,207025,29811600,30161040
train,677,89,68352,7921,1140624,1208976
train,678,30,23040,900,129600,152640
train,679,49,37632,2401,345744,383376
train,680,54,41472,2916,419904,461376
train,681,30,23040,900,129600,152640
train,682,69,52992,4761,685584,738576
train,683,29,22272,841,121104,143376
train,684,97,74496,9409,1354896,1429392
train,685,17,13056,289,41616,54672
train,686,59,45312,3481,501264,546576
train,687,54,41472,2916,419904,461376
train,688,17,13056,289,41616,54672
train,689,476,365568,226576,32626944,32992512
train,690,64,49152,4096,589824,638976
train,691,68,52224,4624,665856,718080
train,692,73,56064,5329,767376,823440
train,693,230,176640,52900,7617600,7794240
train,694,57,43776,3249,467856,511632
train,695,181,139008,32761,4717584,4856592
train,696,179,137472,32041,4613904,4751376
train,697,45,34560,2025,291600,326160
train,698,29,22272,841,121104,143376
train,699,123,94464,15129,2178576,2273040
train,700,18,13824,324,46656,60480
train,701,86,66048,7396,1065024,1131072
train,702,47,36096,2209,318096,354192
train,703,59,45312,3481,501264,546576
train,704,82,62976,6724,968256,1031232
train,705,446,342528,198916,28643904,28986432
train,706,31,23808,961,138384,162192
train,707,334,256512,111556,16064064,16320576
train,708,112,86016,12544,1806336,1892352
train,709,14,10752,196,28224,38976
train,710,512,393216,262144,37748736,38141952
train,711,40,30720,1600,230400,261120
train,712,512,393216,262144,37748736,38141952
train,713,35,26880,1225,176400,203280
train,714,124,95232,15376,2214144,2309376
train,715,115,88320,13225,1904400,1992720
train,716,16,12288,256,36864,49152
train,717,94,72192,8836,1272384,1344576
train,718,122,93696,14884,2143296,2236992
train,719,116,89088,13456,1937664,2026752
train,720,61,46848,3721,535824,582672
train,721,43,33024,1849,266256,299280
train,722,43,33024,1849,266256,299280
train,723,48,36864,2304,331776,368640
train,724,84,64512,7056,1016064,1080576
train,725,53,40704,2809,404496,445200
train,726,31,23808,961,138384,162192
train,727,251,192768,63001,9072144,9264912
train,728,52,39936,2704,389376,429312
train,729,26,19968,676,97344,117312
train,730,95,72960,9025,1299600,1372560
train,731,116,89088,13456,1937664,2026752
train,732,512,393216,262144,37748736,38141952
train,733,37,28416,1369,197136,225552
train,734,75,57600,5625,810000,867600
train,735,48,36864,2304,331776,368640
train,736,346,265728,119716,17239104,17504832
train,737,113,86784,12769,1838736,1925520
train,738,83,63744,6889,992016,1055760
train,739,205,157440,42025,6051600,6209040
train,740,82,62976,6724,968256,1031232
train,741,85,65280,7225,1040400,1105680
train,742,144,110592,20736,2985984,3096576
train,743,191,146688,36481,5253264,5399952
train,744,68,52224,4624,665856,718080
train,745,205,157440,42025,6051600,6209040
train,746,76,58368,5776,831744,890112
train,747,307,235776,94249,13571856,13807632
train,748,56,43008,3136,451584,494592
train,749,105,80640,11025,1587600,1668240
train,750,96,73728,9216,1327104,1400832
train,751,107,82176,11449,1648656,1730832
train,752,322,247296,103684,14930496,15177792
train,753,51,39168,2601,374544,413712
train,754,92,70656,8464,1218816,1289472
train,755,19,14592,361,51984,66576
train,756,63,48384,3969,571536,619920
train,757,129,99072,16641,2396304,2495376
train,758,83,63744,6889,992016,1055760
train,759,215,165120,46225,6656400,6821520
train,760,83,63744,6889,992016,1055760
train,761,219,168192,47961,6906384,7074576
train,762,111,85248,12321,1774224,1859472
train,763,53,40704,2809,404496,445200
train,764,53,40704,2809,404496,445200
train,765,27,20736,729,104976,125712
train,766,512,393216,262144,37748736,38141952
train,767,51,39168,2601,374544,413712
train,768,59,45312,3481,501264,546576
train,769,213,163584,45369,6533136,6696720
train,770,107,82176,11449,1648656,1730832
train,771,74,56832,5476,788544,845376
train,772,425,326400,180625,26010000,26336400
train,773,245,188160,60025,8643600,8831760
train,774,100,76800,10000,1440000,1516800
train,775,106,81408,11236,1617984,1699392
train,776,159,122112,25281,3640464,3762576
train,777,30,23040,900,129600,152640
train,778,9,6912,81,11664,18576
train,779,16,12288,256,36864,49152
train,780,119,91392,14161,2039184,2130576
train,781,124,95232,15376,2214144,2309376
train,782,94,72192,8836,1272384,1344576
train,783,91,69888,8281,1192464,1262352
train,784,31,23808,961,138384,162192
train,785,62,47616,3844,553536,601152
train,786,116,89088,13456,1937664,2026752
train,787,101,77568,10201,1468944,1546512
train,788,63,48384,3969,571536,619920
train,789,119,91392,14161,2039184,2130576
train,790,94,72192,8836,1272384,1344576
train,791,210,161280,44100,6350400,6511680
train,792,81,62208,6561,944784,1006992
train,793,132,101376,17424,2509056,2610432
train,794,197,151296,38809,5588496,5739792
train,795,80,61440,6400,921600,983040
train,796,106,81408,11236,1617984,1699392
train,797,96,73728,9216,1327104,1400832
train,798,202,155136,40804,5875776,6030912
train,799,83,63744,6889,992016,1055760
train,800,70,53760,4900,705600,759360
train,801,48,36864,2304,331776,368640
train,802,92,70656,8464,1218816,1289472
train,803,107,82176,11449,1648656,1730832
train,804,52,39936,2704,389376,429312
train,805,33,25344,1089,156816,182160
train,806,28,21504,784,112896,134400
train,807,79,60672,6241,898704,959376
train,808,67,51456,4489,646416,697872
train,809,73,56064,5329,767376,823440
train,810,86,66048,7396,1065024,1131072
train,811,51,39168,2601,374544,413712
train,812,13,9984,169,24336,34320
train,813,139,106752,19321,2782224,2888976
train,814,26,19968,676,97344,117312
train,815,325,249600,105625,15210000,15459600
train,816,72,55296,5184,746496,801792
train,817,79,60672,6241,898704,959376
train,818,12,9216,144,20736,29952
train,819,52,39936,2704,389376,429312
train,820,26,19968,676,97344,117312
train,821,159,122112,25281,3640464,3762576
train,822,17,13056,289,41616,54672
train,823,85,65280,7225,1040400,1105680
train,824,25,19200,625,90000,109200
train,825,308,236544,94864,13660416,13896960
train,826,26,19968,676,97344,117312
train,827,64,49152,4096,589824,638976
train,828,69,52992,4761,685584,738576
train,829,49,37632,2401,345744,383376
train,830,35,26880,1225,176400,203280
train,831,30,23040,900,129600,152640
train,832,80,61440,6400,921600,983040
train,833,119,91392,14161,2039184,2130576
train,834,246,188928,60516,8714304,8903232
train,835,117,89856,13689,1971216,2061072
train,836,36,27648,1296,186624,214272
train,837,51,39168,2601,374544,413712
train,838,29,22272,841,121104,143376
train,839,133,102144,17689,2547216,2649360
train,840,512,393216,262144,37748736,38141952
train,841,140,107520,19600,2822400,2929920
train,842,79,60672,6241,898704,959376
train,843,18,13824,324,46656,60480
train,844,56,43008,3136,451584,494592
train,845,512,393216,262144,37748736,38141952
train,846,28,21504,784,112896,134400
train,847,512,393216,262144,37748736,38141952
train,848,83,63744,6889,992016,1055760
train,849,214,164352,45796,6594624,6758976
train,850,64,49152,4096,589824,638976
train,851,27,20736,729,104976,125712
train,852,110,84480,12100,1742400,1826880
train,853,185,142080,34225,4928400,5070480
train,854,121,92928,14641,2108304,2201232
train,855,18,13824,324,46656,60480
train,856,57,43776,3249,467856,511632
train,857,512,393216,262144,37748736,38141952
train,858,296,227328,87616,12616704,12844032
train,859,41,31488,1681,242064,273552
train,860,89,68352,7921,1140624,1208976
train,861,83,63744,6889,992016,1055760
train,862,31,23808,961,138384,162192
train,863,49,37632,2401,345744,383376
train,864,95,72960,9025,1299600,1372560
train,865,125,96000,15625,2250000,2346000
train,866,13,9984,169,24336,34320
train,867,52,39936,2704,389376,429312
train,868,70,53760,4900,705600,759360
train,869,70,53760,4900,705600,759360
train,870,100,76800,10000,1440000,1516800
train,871,218,167424,47524,6843456,7010880
train,872,20,15360,400,57600,72960
train,873,35,26880,1225,176400,203280
train,874,32,24576,1024,147456,172032
train,875,44,33792,1936,278784,312576
train,876,63,48384,3969,571536,619920
train,877,29,22272,841,121104,143376
train,878,81,62208,6561,944784,1006992
train,879,384,294912,147456,21233664,21528576
train,880,14,10752,196,28224,38976
train,881,212,162816,44944,6471936,6634752
train,882,34,26112,1156,166464,192576
train,883,27,20736,729,104976,125712
train,884,113,86784,12769,1838736,1925520
train,885,69,52992,4761,685584,738576
train,886,183,140544,33489,4822416,4962960
train,887,46,35328,2116,304704,340032
train,888,117,89856,13689,1971216,2061072
train,889,84,64512,7056,1016064,1080576
train,890,44,33792,1936,278784,312576
train,891,75,57600,5625,810000,867600
train,892,53,40704,2809,404496,445200
train,893,258,198144,66564,9585216,9783360
train,894,242,185856,58564,8433216,8619072
train,895,255,195840,65025,9363600,9559440
train,896,276,211968,76176,10969344,11181312
train,897,86,66048,7396,1065024,1131072
train,898,54,41472,2916,419904,461376
train,899,80,61440,6400,921600,983040
train,900,221,169728,48841,7033104,7202832
train,901,54,41472,2916,419904,461376
train,902,216,165888,46656,6718464,6884352
train,903,81,62208,6561,944784,1006992
train,904,223,171264,49729,7160976,7332240
train,905,512,393216,262144,37748736,38141952
train,906,125,96000,15625,2250000,2346000
train,907,343,263424,117649,16941456,17204880
train,908,92,70656,8464,1218816,1289472
train,909,57,43776,3249,467856,511632
train,910,228,175104,51984,7485696,7660800
train,911,125,96000,15625,2250000,2346000
train,912,62,47616,3844,553536,601152
train,913,58,44544,3364,484416,528960
train,914,125,96000,15625,2250000,2346000
train,915,150,115200,22500,3240000,3355200
train,916,82,62976,6724,968256,1031232
train,917,68,52224,4624,665856,718080
train,918,302,231936,91204,13133376,13365312
train,919,302,231936,91204,13133376,13365312
train,920,18,13824,324,46656,60480
train,921,55,42240,3025,435600,477840
train,922,111,85248,12321,1774224,1859472
train,923,104,79872,10816,1557504,1637376
train,924,441,338688,194481,28005264,28343952
train,925,105,80640,11025,1587600,1668240
train,926,51,39168,2601,374544,413712
train,927,34,26112,1156,166464,192576
train,928,512,393216,262144,37748736,38141952
train,929,94,72192,8836,1272384,1344576
train,930,28,21504,784,112896,134400
train,931,90,69120,8100,1166400,1235520
train,932,225,172800,50625,7290000,7462800
train,933,101,77568,10201,1468944,1546512
train,934,111,85248,12321,1774224,1859472
train,935,92,70656,8464,1218816,1289472
train,936,93,71424,8649,1245456,1316880
train,937,17,13056,289,41616,54672
train,938,25,19200,625,90000,109200
train,939,54,41472,2916,419904,461376
train,940,47,36096,2209,318096,354192
train,941,27,20736,729,104976,125712
train,942,129,99072,16641,2396304,2495376
train,943,58,44544,3364,484416,528960
train,944,330,253440,108900,15681600,15935040
train,945,183,140544,33489,4822416,4962960
train,946,34,26112,1156,166464,192576
train,947,16,12288,256,36864,49152
train,948,149,114432,22201,3196944,3311376
train,949,110,84480,12100,1742400,1826880
train,950,62,47616,3844,553536,601152
train,951,94,72192,8836,1272384,1344576
train,952,16,12288,256,36864,49152
train,953,125,96000,15625,2250000,2346000
train,954,28,21504,784,112896,134400
train,955,20,15360,400,57600,72960
train,956,73,56064,5329,767376,823440
train,957,19,14592,361,51984,66576
train,958,121,92928,14641,2108304,2201232
train,959,29,22272,841,121104,143376
train,960,106,81408,11236,1617984,1699392
train,961,82,62976,6724,968256,1031232
train,962,50,38400,2500,360000,398400
train,963,68,52224,4624,665856,718080
train,964,218,167424,47524,6843456,7010880
train,965,103,79104,10609,1527696,1606800
train,966,102,78336,10404,1498176,1576512
train,967,24,18432,576,82944,101376
train,968,59,45312,3481,501264,546576
train,969,33,25344,1089,156816,182160
train,970,277,212736,76729,11048976,11261712
train,971,21,16128,441,63504,79632
train,972,53,40704,2809,404496,445200
train,973,92,70656,8464,1218816,1289472
train,974,29,22272,841,121104,143376
train,975,76,58368,5776,831744,890112
train,976,85,65280,7225,1040400,1105680
train,977,16,12288,256,36864,49152
train,978,110,84480,12100,1742400,1826880
train,979,60,46080,3600,518400,564480
train,980,19,14592,361,51984,66576
train,981,60,46080,3600,518400,564480
train,982,27,20736,729,104976,125712
train,983,19,14592,361,51984,66576
train,984,46,35328,2116,304704,340032
train,985,347,266496,120409,17338896,17605392
train,986,64,49152,4096,589824,638976
train,987,362,278016,131044,18870336,19148352
train,988,239,183552,57121,8225424,8408976
train,989,266,204288,70756,10188864,10393152
train,990,27,20736,729,104976,125712
train,991,60,46080,3600,518400,564480
train,992,70,53760,4900,705600,759360
train,993,67,51456,4489,646416,697872
train,994,224,172032,50176,7225344,7397376
train,995,26,19968,676,97344,117312
train,996,56,43008,3136,451584,494592
train,997,16,12288,256,36864,49152
train,998,29,22272,841,121104,143376
train,999,41,31488,1681,242064,273552
train,1000,65,49920,4225,608400,658320
train,1001,121,92928,14641,2108304,2201232
train,1002,119,91392,14161,2039184,2130576
train,1003,183,140544,33489,4822416,4962960
train,1004,173,132864,29929,4309776,4442640
train,1005,85,65280,7225,1040400,1105680
train,1006,183,140544,33489,4822416,4962960
train,1007,67,51456,4489,646416,697872
train,1008,17,13056,289,41616,54672
train,1009,126,96768,15876,2286144,2382912
train,1010,81,62208,6561,944784,1006992
train,1011,508,390144,258064,37161216,37551360
train,1012,512,393216,262144,37748736,38141952
train,1013,114,87552,12996,1871424,1958976
train,1014,85,65280,7225,1040400,1105680
train,1015,32,24576,1024,147456,172032
train,1016,103,79104,10609,1527696,1606800
train,1017,114,87552,12996,1871424,1958976
train,1018,17,13056,289,41616,54672
train,1019,47,36096,2209,318096,354192
train,1020,177,135936,31329,4511376,4647312
train,1021,512,393216,262144,37748736,38141952
train,1022,23,17664,529,76176,93840
train,1023,367,281856,134689,19395216,19677072
train,1024,13,9984,169,24336,34320
train,1025,58,44544,3364,484416,528960
train,1026,119,91392,14161,2039184,2130576
train,1027,76,58368,5776,831744,890112
train,1028,78,59904,6084,876096,936000
train,1029,134,102912,17956,2585664,2688576
train,1030,54,41472,2916,419904,461376
train,1031,27,20736,729,104976,125712
train,1032,177,135936,31329,4511376,4647312
train,1033,50,38400,2500,360000,398400
train,1034,75,57600,5625,810000,867600
train,1035,43,33024,1849,266256,299280
train,1036,144,110592,20736,2985984,3096576
train,1037,32,24576,1024,147456,172032
train,1038,229,175872,52441,7551504,7727376
train,1039,122,93696,14884,2143296,2236992
train,1040,14,10752,196,28224,38976
train,1041,19,14592,361,51984,66576
train,1042,68,52224,4624,665856,718080
train,1043,53,40704,2809,404496,445200
train,1044,118,90624,13924,2005056,2095680
train,1045,106,81408,11236,1617984,1699392
train,1046,53,40704,2809,404496,445200
train,1047,102,78336,10404,1498176,1576512
train,1048,108,82944,11664,1679616,1762560
train,1049,30,23040,900,129600,152640
train,1050,113,86784,12769,1838736,1925520
train,1051,179,137472,32041,4613904,4751376
train,1052,91,69888,8281,1192464,1262352
train,1053,110,84480,12100,1742400,1826880
train,1054,56,43008,3136,451584,494592
train,1055,67,51456,4489,646416,697872
train,1056,116,89088,13456,1937664,2026752
train,1057,70,53760,4900,705600,759360
train,1058,119,91392,14161,2039184,2130576
train,1059,49,37632,2401,345744,383376
train,1060,22,16896,484,69696,86592
train,1061,98,75264,9604,1382976,1458240
train,1062,66,50688,4356,627264,677952
train,1063,146,112128,21316,3069504,3181632
train,1064,293,225024,85849,12362256,12587280
train,1065,33,25344,1089,156816,182160
train,1066,27,20736,729,104976,125712
train,1067,512,393216,262144,37748736,38141952
train,1068,206,158208,42436,6110784,6268992
train,1069,68,52224,4624,665856,718080
train,1070,34,26112,1156,166464,192576
train,1071,27,20736,729,104976,125712
train,1072,217,166656,47089,6780816,6947472
train,1073,87,66816,7569,1089936,1156752
train,1074,143,109824,20449,2944656,3054480
train,1075,290,222720,84100,12110400,12333120
train,1076,11,8448,121,17424,25872
train,1077,44,33792,1936,278784,312576
train,1078,41,31488,1681,242064,273552
train,1079,12,9216,144,20736,29952
train,1080,30,23040,900,129600,152640
train,1081,27,20736,729,104976,125712
train,1082,82,62976,6724,968256,1031232
train,1083,77,59136,5929,853776,912912
train,1084,362,278016,131044,18870336,19148352
train,1085,64,49152,4096,589824,638976
train,1086,308,236544,94864,13660416,13896960
train,1087,57,43776,3249,467856,511632
train,1088,32,24576,1024,147456,172032
train,1089,236,181248,55696,8020224,8201472
train,1090,46,35328,2116,304704,340032
train,1091,26,19968,676,97344,117312
train,1092,145,111360,21025,3027600,3138960
train,1093,35,26880,1225,176400,203280
train,1094,68,52224,4624,665856,718080
train,1095,228,175104,51984,7485696,7660800
train,1096,20,15360,400,57600,72960
train,1097,71,54528,5041,725904,780432
train,1098,32,24576,1024,147456,172032
train,1099,28,21504,784,112896,134400
train,1100,40,30720,1600,230400,261120
train,1101,51,39168,2601,374544,413712
train,1102,25,19200,625,90000,109200
train,1103,15,11520,225,32400,43920
train,1104,126,96768,15876,2286144,2382912
train,1105,28,21504,784,112896,134400
train,1106,156,119808,24336,3504384,3624192
train,1107,58,44544,3364,484416,528960
train,1108,183,140544,33489,4822416,4962960
train,1109,84,64512,7056,1016064,1080576
train,1110,41,31488,1681,242064,273552
train,1111,34,26112,1156,166464,192576
train,1112,78,59904,6084,876096,936000
train,1113,77,59136,5929,853776,912912
train,1114,27,20736,729,104976,125712
train,1115,286,219648,81796,11778624,11998272
train,1116,512,393216,262144,37748736,38141952
train,1117,17,13056,289,41616,54672
train,1118,177,135936,31329,4511376,4647312
train,1119,81,62208,6561,944784,1006992
train,1120,120,92160,14400,2073600,2165760
train,1121,45,34560,2025,291600,326160
train,1122,303,232704,91809,13220496,13453200
train,1123,59,45312,3481,501264,546576
train,1124,512,393216,262144,37748736,38141952
train,1125,129,99072,16641,2396304,2495376
train,1126,41,31488,1681,242064,273552
train,1127,75,57600,5625,810000,867600
train,1128,118,90624,13924,2005056,2095680
train,1129,117,89856,13689,1971216,2061072
train,1130,293,225024,85849,12362256,12587280
train,1131,22,16896,484,69696,86592
train,1132,49,37632,2401,345744,383376
train,1133,15,11520,225,32400,43920
train,1134,77,59136,5929,853776,912912
train,1135,70,53760,4900,705600,759360
train,1136,139,106752,19321,2782224,2888976
train,1137,35,26880,1225,176400,203280
train,1138,29,22272,841,121104,143376
train,1139,27,20736,729,104976,125712
train,1140,28,21504,784,112896,134400
train,1141,55,42240,3025,435600,477840
train,1142,512,393216,262144,37748736,38141952
train,1143,11,8448,121,17424,25872
train,1144,271,208128,73441,10575504,10783632
train,1145,205,157440,42025,6051600,6209040
train,1146,215,165120,46225,6656400,6821520
train,1147,101,77568,10201,1468944,1546512
train,1148,64,49152,4096,589824,638976
train,1149,55,42240,3025,435600,477840
train,1150,20,15360,400,57600,72960
train,1151,115,88320,13225,1904400,1992720
train,1152,131,100608,17161,2471184,2571792
train,1153,326,250368,106276,15303744,15554112
train,1154,114,87552,12996,1871424,1958976
train,1155,126,96768,15876,2286144,2382912
train,1156,163,125184,26569,3825936,3951120
train,1157,25,19200,625,90000,109200
train,1158,70,53760,4900,705600,759360
train,1159,110,84480,12100,1742400,1826880
train,1160,70,53760,4900,705600,759360
train,1161,42,32256,1764,254016,286272
train,1162,326,250368,106276,15303744,15554112
train,1163,53,40704,2809,404496,445200
train,1164,83,63744,6889,992016,1055760
train,1165,124,95232,15376,2214144,2309376
train,1166,104,79872,10816,1557504,1637376
train,1167,44,33792,1936,278784,312576
train,1168,31,23808,961,138384,162192
train,1169,34,26112,1156,166464,192576
train,1170,61,46848,3721,535824,582672
train,1171,158,121344,24964,3594816,3716160
train,1172,80,61440,6400,921600,983040
train,1173,144,110592,20736,2985984,3096576
train,1174,40,30720,1600,230400,261120
train,1175,81,62208,6561,944784,1006992
train,1176,51,39168,2601,374544,413712
train,1177,83,63744,6889,992016,1055760
train,1178,115,88320,13225,1904400,1992720
train,1179,50,38400,2500,360000,398400
train,1180,512,393216,262144,37748736,38141952
train,1181,31,23808,961,138384,162192
train,1182,97,74496,9409,1354896,1429392
train,1183,45,34560,2025,291600,326160
train,1184,317,243456,100489,14470416,14713872
train,1185,88,67584,7744,1115136,1182720
train,1186,76,58368,5776,831744,890112
train,1187,26,19968,676,97344,117312
train,1188,46,35328,2116,304704,340032
train,1189,297,228096,88209,12702096,12930192
train,1190,450,345600,202500,29160000,29505600
train,1191,145,111360,21025,3027600,3138960
train,1192,14,10752,196,28224,38976
train,1193,105,80640,11025,1587600,1668240
train,1194,100,76800,10000,1440000,1516800
train,1195,16,12288,256,36864,49152
train,1196,205,157440,42025,6051600,6209040
train,1197,16,12288,256,36864,49152
train,1198,25,19200,625,90000,109200
train,1199,117,89856,13689,1971216,2061072
train,1200,96,73728,9216,1327104,1400832
train,1201,81,62208,6561,944784,1006992
train,1202,150,115200,22500,3240000,3355200
train,1203,111,85248,12321,1774224,1859472
train,1204,89,68352,7921,1140624,1208976
train,1205,343,263424,117649,16941456,17204880
train,1206,512,393216,262144,37748736,38141952
train,1207,51,39168,2601,374544,413712
train,1208,512,393216,262144,37748736,38141952
train,1209,89,68352,7921,1140624,1208976
train,1210,120,92160,14400,2073600,2165760
train,1211,63,48384,3969,571536,619920
train,1212,84,64512,7056,1016064,1080576
train,1213,113,86784,12769,1838736,1925520
train,1214,142,109056,20164,2903616,3012672
train,1215,16,12288,256,36864,49152
train,1216,260,199680,67600,9734400,9934080
train,1217,49,37632,2401,345744,383376
train,1218,14,10752,196,28224,38976
train,1219,12,9216,144,20736,29952
train,1220,207,158976,42849,6170256,6329232
train,1221,92,70656,8464,1218816,1289472
train,1222,246,188928,60516,8714304,8903232
train,1223,256,196608,65536,9437184,9633792
train,1224,250,192000,62500,9000000,9192000
train,1225,54,41472,2916,419904,461376
train,1226,59,45312,3481,501264,546576
train,1227,312,239616,97344,14017536,14257152
train,1228,111,85248,12321,1774224,1859472
train,1229,304,233472,92416,13307904,13541376
train,1230,38,29184,1444,207936,237120
train,1231,333,255744,110889,15968016,16223760
train,1232,207,158976,42849,6170256,6329232
train,1233,13,9984,169,24336,34320
train,1234,51,39168,2601,374544,413712
train,1235,82,62976,6724,968256,1031232
train,1236,135,103680,18225,2624400,2728080
train,1237,14,10752,196,28224,38976
train,1238,114,87552,12996,1871424,1958976
train,1239,30,23040,900,129600,152640
train,1240,355,272640,126025,18147600,18420240
train,1241,114,87552,12996,1871424,1958976
train,1242,60,46080,3600,518400,564480
train,1243,91,69888,8281,1192464,1262352
train,1244,101,77568,10201,1468944,1546512
train,1245,212,162816,44944,6471936,6634752
train,1246,109,83712,11881,1710864,1794576
train,1247,105,80640,11025,1587600,1668240
train,1248,512,393216,262144,37748736,38141952
train,1249,135,103680,18225,2624400,2728080
train,1250,141,108288,19881,2862864,2971152
train,1251,29,22272,841,121104,143376
train,1252,83,63744,6889,992016,1055760
train,1253,202,155136,40804,5875776,6030912
train,1254,28,21504,784,112896,134400
train,1255,80,61440,6400,921600,983040
train,1256,145,111360,21025,3027600,3138960
train,1257,26,19968,676,97344,117312
train,1258,58,44544,3364,484416,528960
train,1259,193,148224,37249,5363856,5512080
train,1260,34,26112,1156,166464,192576
train,1261,58,44544,3364,484416,528960
train,1262,288,221184,82944,11943936,12165120
train,1263,34,26112,1156,166464,192576
train,1264,49,37632,2401,345744,383376
train,1265,110,84480,12100,1742400,1826880
train,1266,50,38400,2500,360000,398400
train,1267,71,54528,5041,725904,780432
train,1268,60,46080,3600,518400,564480
train,1269,51,39168,2601,374544,413712
train,1270,58,44544,3364,484416,528960
train,1271,163,125184,26569,3825936,3951120
train,1272,47,36096,2209,318096,354192
train,1273,134,102912,17956,2585664,2688576
train,1274,96,73728,9216,1327104,1400832
train,1275,127,97536,16129,2322576,2420112
train,1276,29,22272,841,121104,143376
train,1277,175,134400,30625,4410000,4544400
train,1278,380,291840,144400,20793600,21085440
train,1279,68,52224,4624,665856,718080
train,1280,105,80640,11025,1587600,1668240
train,1281,55,42240,3025,435600,477840
train,1282,18,13824,324,46656,60480
train,1283,93,71424,8649,1245456,1316880
train,1284,36,27648,1296,186624,214272
train,1285,190,145920,36100,5198400,5344320
train,1286,55,42240,3025,435600,477840
train,1287,262,201216,68644,9884736,10085952
train,1288,501,384768,251001,36144144,36528912
train,1289,294,225792,86436,12446784,12672576
train,1290,74,56832,5476,788544,845376
train,1291,48,36864,2304,331776,368640
train,1292,30,23040,900,129600,152640
train,1293,141,108288,19881,2862864,2971152
train,1294,49,37632,2401,345744,383376
train,1295,54,41472,2916,419904,461376
train,1296,111,85248,12321,1774224,1859472
train,1297,29,22272,841,121104,143376
train,1298,54,41472,2916,419904,461376
train,1299,14,10752,196,28224,38976
train,1300,67,51456,4489,646416,697872
train,1301,155,119040,24025,3459600,3578640
train,1302,31,23808,961,138384,162192
train,1303,22,16896,484,69696,86592
train,1304,31,23808,961,138384,162192
train,1305,390,299520,152100,21902400,22201920
train,1306,63,48384,3969,571536,619920
train,1307,315,241920,99225,14288400,14530320
train,1308,66,50688,4356,627264,677952
train,1309,29,22272,841,121104,143376
train,1310,36,27648,1296,186624,214272
train,1311,27,20736,729,104976,125712
train,1312,512,393216,262144,37748736,38141952
train,1313,236,181248,55696,8020224,8201472
train,1314,28,21504,784,112896,134400
train,1315,61,46848,3721,535824,582672
train,1316,69,52992,4761,685584,738576
train,1317,19,14592,361,51984,66576
train,1318,123,94464,15129,2178576,2273040
train,1319,154,118272,23716,3415104,3533376
train,1320,219,168192,47961,6906384,7074576
train,1321,66,50688,4356,627264,677952
train,1322,61,46848,3721,535824,582672
train,1323,14,10752,196,28224,38976
train,1324,111,85248,12321,1774224,1859472
train,1325,50,38400,2500,360000,398400
train,1326,109,83712,11881,1710864,1794576
train,1327,109,83712,11881,1710864,1794576
train,1328,57,43776,3249,467856,511632
train,1329,512,393216,262144,37748736,38141952
train,1330,216,165888,46656,6718464,6884352
train,1331,85,65280,7225,1040400,1105680
train,1332,233,178944,54289,7817616,7996560
train,1333,12,9216,144,20736,29952
train,1334,193,148224,37249,5363856,5512080
train,1335,106,81408,11236,1617984,1699392
train,1336,12,9216,144,20736,29952
train,1337,257,197376,66049,9511056,9708432
train,1338,38,29184,1444,207936,237120
train,1339,68,52224,4624,665856,718080
train,1340,74,56832,5476,788544,845376
train,1341,80,61440,6400,921600,983040
train,1342,155,119040,24025,3459600,3578640
train,1343,36,27648,1296,186624,214272
train,1344,81,62208,6561,944784,1006992
train,1345,72,55296,5184,746496,801792
train,1346,51,39168,2601,374544,413712
train,1347,95,72960,9025,1299600,1372560
train,1348,32,24576,1024,147456,172032
train,1349,448,344064,200704,28901376,29245440
train,1350,147,112896,21609,3111696,3224592
train,1351,315,241920,99225,14288400,14530320
train,1352,85,65280,7225,1040400,1105680
train,1353,59,45312,3481,501264,546576
train,1354,25,19200,625,90000,109200
train,1355,163,125184,26569,3825936,3951120
train,1356,44,33792,1936,278784,312576
train,1357,178,136704,31684,4562496,4699200
train,1358,53,40704,2809,404496,445200
train,1359,209,160512,43681,6290064,6450576
train,1360,45,34560,2025,291600,326160
train,1361,116,89088,13456,1937664,2026752
train,1362,80,61440,6400,921600,983040
train,1363,93,71424,8649,1245456,1316880
train,1364,223,171264,49729,7160976,7332240
train,1365,66,50688,4356,627264,677952
train,1366,123,94464,15129,2178576,2273040
train,1367,90,69120,8100,1166400,1235520
train,1368,324,248832,104976,15116544,15365376
train,1369,60,46080,3600,518400,564480
train,1370,43,33024,1849,266256,299280
train,1371,512,393216,262144,37748736,38141952
train,1372,490,376320,240100,34574400,34950720
train,1373,80,61440,6400,921600,983040
train,1374,52,39936,2704,389376,429312
train,1375,110,84480,12100,1742400,1826880
train,1376,94,72192,8836,1272384,1344576
train,1377,102,78336,10404,1498176,1576512
train,1378,83,63744,6889,992016,1055760
train,1379,48,36864,2304,331776,368640
train,1380,71,54528,5041,725904,780432
train,1381,26,19968,676,97344,117312
train,1382,34,26112,1156,166464,192576
train,1383,66,50688,4356,627264,677952
train,1384,18,13824,324,46656,60480
train,1385,452,347136,204304,29419776,29766912
train,1386,117,89856,13689,1971216,2061072
train,1387,80,61440,6400,921600,983040
train,1388,26,19968,676,97344,117312
train,1389,325,249600,105625,15210000,15459600
train,1390,25,19200,625,90000,109200
train,1391,103,79104,10609,1527696,1606800
train,1392,95,72960,9025,1299600,1372560
train,1393,137,105216,18769,2702736,2807952
train,1394,56,43008,3136,451584,494592
train,1395,512,393216,262144,37748736,38141952
train,1396,47,36096,2209,318096,354192
train,1397,283,217344,80089,11532816,11750160
train,1398,28,21504,784,112896,134400
train,1399,187,143616,34969,5035536,5179152
train,1400,90,69120,8100,1166400,1235520
train,1401,34,26112,1156,166464,192576
train,1402,235,180480,55225,7952400,8132880
train,1403,28,21504,784,112896,134400
train,1404,15,11520,225,32400,43920
train,1405,103,79104,10609,1527696,1606800
train,1406,109,83712,11881,1710864,1794576
train,1407,34,26112,1156,166464,192576
train,1408,62,47616,3844,553536,601152
train,1409,220,168960,48400,6969600,7138560
train,1410,68,52224,4624,665856,718080
train,1411,116,89088,13456,1937664,2026752
train,1412,377,289536,142129,20466576,20756112
train,1413,39,29952,1521,219024,248976
train,1414,512,393216,262144,37748736,38141952
train,1415,88,67584,7744,1115136,1182720
train,1416,209,160512,43681,6290064,6450576
train,1417,512,393216,262144,37748736,38141952
train,1418,27,20736,729,104976,125712
train,1419,92,70656,8464,1218816,1289472
train,1420,42,32256,1764,254016,286272
train,1421,72,55296,5184,746496,801792
train,1422,104,79872,10816,1557504,1637376
train,1423,66,50688,4356,627264,677952
train,1424,53,40704,2809,404496,445200
train,1425,114,87552,12996,1871424,1958976
train,1426,195,149760,38025,5475600,5625360
train,1427,55,42240,3025,435600,477840
train,1428,224,172032,50176,7225344,7397376
train,1429,82,62976,6724,968256,1031232
train,1430,62,47616,3844,553536,601152
train,1431,100,76800,10000,1440000,1516800
train,1432,189,145152,35721,5143824,5288976
train,1433,105,80640,11025,1587600,1668240
train,1434,53,40704,2809,404496,445200
train,1435,111,85248,12321,1774224,1859472
train,1436,120,92160,14400,2073600,2165760
train,1437,52,39936,2704,389376,429312
train,1438,50,38400,2500,360000,398400
train,1439,81,62208,6561,944784,1006992
train,1440,512,393216,262144,37748736,38141952
train,1441,91,69888,8281,1192464,1262352
train,1442,293,225024,85849,12362256,12587280
train,1443,16,12288,256,36864,49152
train,1444,47,36096,2209,318096,354192
train,1445,47,36096,2209,318096,354192
train,1446,94,72192,8836,1272384,1344576
train,1447,100,76800,10000,1440000,1516800
train,1448,31,23808,961,138384,162192
train,1449,403,309504,162409,23386896,23696400
train,1450,140,107520,19600,2822400,2929920
train,1451,159,122112,25281,3640464,3762576
train,1452,116,89088,13456,1937664,2026752
train,1453,56,43008,3136,451584,494592
train,1454,35,26880,1225,176400,203280
train,1455,110,84480,12100,1742400,1826880
train,1456,69,52992,4761,685584,738576
train,1457,44,33792,1936,278784,312576
train,1458,192,147456,36864,5308416,5455872
train,1459,48,36864,2304,331776,368640
train,1460,41,31488,1681,242064,273552
train,1461,148,113664,21904,3154176,3267840
train,1462,56,43008,3136,451584,494592
train,1463,55,42240,3025,435600,477840
train,1464,119,91392,14161,2039184,2130576
train,1465,24,18432,576,82944,101376
train,1466,71,54528,5041,725904,780432
train,1467,41,31488,1681,242064,273552
train,1468,305,234240,93025,13395600,13629840
train,1469,75,57600,5625,810000,867600
train,1470,51,39168,2601,374544,413712
train,1471,93,71424,8649,1245456,1316880
train,1472,111,85248,12321,1774224,1859472
train,1473,318,244224,101124,14561856,14806080
train,1474,117,89856,13689,1971216,2061072
train,1475,512,393216,262144,37748736,38141952
train,1476,33,25344,1089,156816,182160
train,1477,149,114432,22201,3196944,3311376
train,1478,61,46848,3721,535824,582672
train,1479,235,180480,55225,7952400,8132880
train,1480,87,66816,7569,1089936,1156752
train,1481,24,18432,576,82944,101376
train,1482,192,147456,36864,5308416,5455872
train,1483,11,8448,121,17424,25872
train,1484,512,393216,262144,37748736,38141952
train,1485,207,158976,42849,6170256,6329232
train,1486,9,6912,81,11664,18576
train,1487,17,13056,289,41616,54672
train,1488,44,33792,1936,278784,312576
train,1489,72,55296,5184,746496,801792
train,1490,57,43776,3249,467856,511632
train,1491,41,31488,1681,242064,273552
train,1492,117,89856,13689,1971216,2061072
train,1493,63,48384,3969,571536,619920
train,1494,81,62208,6561,944784,1006992
train,1495,73,56064,5329,767376,823440
train,1496,40,30720,1600,230400,261120
train,1497,471,361728,221841,31945104,32306832
train,1498,113,86784,12769,1838736,1925520
train,1499,40,30720,1600,230400,261120
train,1500,99,76032,9801,1411344,1487376
train,1501,19,14592,361,51984,66576
train,1502,49,37632,2401,345744,383376
train,1503,51,39168,2601,374544,413712
train,1504,172,132096,29584,4260096,4392192
train,1505,81,62208,6561,944784,1006992
train,1506,86,66048,7396,1065024,1131072
train,1507,279,214272,77841,11209104,11423376
train,1508,58,44544,3364,484416,528960
train,1509,99,76032,9801,1411344,1487376
train,1510,512,393216,262144,37748736,38141952
train,1511,236,181248,55696,8020224,8201472
train,1512,102,78336,10404,1498176,1576512
train,1513,60,46080,3600,518400,564480
train,1514,47,36096,2209,318096,354192
train,1515,107,82176,11449,1648656,1730832
train,1516,49,37632,2401,345744,383376
train,1517,103,79104,10609,1527696,1606800
train,1518,512,393216,262144,37748736,38141952
train,1519,512,393216,262144,37748736,38141952
train,1520,47,36096,2209,318096,354192
train,1521,228,175104,51984,7485696,7660800
train,1522,457,350976,208849,30074256,30425232
train,1523,70,53760,4900,705600,759360
train,1524,149,114432,22201,3196944,3311376
train,1525,277,212736,76729,11048976,11261712
train,1526,29,22272,841,121104,143376
train,1527,40,30720,1600,230400,261120
train,1528,90,69120,8100,1166400,1235520
train,1529,111,85248,12321,1774224,1859472
train,1530,198,152064,39204,5645376,5797440
train,1531,259,198912,67081,9659664,9858576
train,1532,165,126720,27225,3920400,4047120
train,1533,62,47616,3844,553536,601152
train,1534,106,81408,11236,1617984,1699392
train,1535,60,46080,3600,518400,564480
train,1536,83,63744,6889,992016,1055760
train,1537,263,201984,69169,9960336,10162320
train,1538,28,21504,784,112896,134400
train,1539,156,119808,24336,3504384,3624192
train,1540,30,23040,900,129600,152640
train,1541,62,47616,3844,553536,601152
train,1542,18,13824,324,46656,60480
train,1543,66,50688,4356,627264,677952
train,1544,203,155904,41209,5934096,6090000
train,1545,197,151296,38809,5588496,5739792
train,1546,27,20736,729,104976,125712
train,1547,131,100608,17161,2471184,2571792
train,1548,39,29952,1521,219024,248976
train,1549,101,77568,10201,1468944,1546512
train,1550,15,11520,225,32400,43920
train,1551,97,74496,9409,1354896,1429392
train,1552,113,86784,12769,1838736,1925520
train,1553,83,63744,6889,992016,1055760
train,1554,97,74496,9409,1354896,1429392
train,1555,417,320256,173889,25040016,25360272
train,1556,44,33792,1936,278784,312576
train,1557,75,57600,5625,810000,867600
train,1558,46,35328,2116,304704,340032
train,1559,100,76800,10000,1440000,1516800
train,1560,91,69888,8281,1192464,1262352
train,1561,104,79872,10816,1557504,1637376
train,1562,27,20736,729,104976,125712
train,1563,507,389376,257049,37015056,37404432
train,1564,16,12288,256,36864,49152
train,1565,145,111360,21025,3027600,3138960
train,1566,422,324096,178084,25644096,25968192
train,1567,209,160512,43681,6290064,6450576
train,1568,16,12288,256,36864,49152
train,1569,64,49152,4096,589824,638976
train,1570,65,49920,4225,608400,658320
train,1571,15,11520,225,32400,43920
train,1572,188,144384,35344,5089536,5233920
train,1573,55,42240,3025,435600,477840
train,1574,119,91392,14161,2039184,2130576
train,1575,121,92928,14641,2108304,2201232
train,1576,60,46080,3600,518400,564480
train,1577,315,241920,99225,14288400,14530320
train,1578,220,168960,48400,6969600,7138560
train,1579,106,81408,11236,1617984,1699392
train,1580,91,69888,8281,1192464,1262352
train,1581,198,152064,39204,5645376,5797440
train,1582,13,9984,169,24336,34320
train,1583,114,87552,12996,1871424,1958976
train,1584,48,36864,2304,331776,368640
train,1585,50,38400,2500,360000,398400
train,1586,107,82176,11449,1648656,1730832
train,1587,222,170496,49284,7096896,7267392
train,1588,112,86016,12544,1806336,1892352
train,1589,103,79104,10609,1527696,1606800
train,1590,59,45312,3481,501264,546576
train,1591,273,209664,74529,10732176,10941840
train,1592,99,76032,9801,1411344,1487376
train,1593,164,125952,26896,3873024,3998976
train,1594,13,9984,169,24336,34320
train,1595,176,135168,30976,4460544,4595712
train,1596,48,36864,2304,331776,368640
train,1597,47,36096,2209,318096,354192
train,1598,66,50688,4356,627264,677952
train,1599,154,118272,23716,3415104,3533376
train,1600,100,76800,10000,1440000,1516800
train,1601,336,258048,112896,16257024,16515072
train,1602,184,141312,33856,4875264,5016576
train,1603,106,81408,11236,1617984,1699392
train,1604,69,52992,4761,685584,738576
train,1605,85,65280,7225,1040400,1105680
train,1606,379,291072,143641,20684304,20975376
train,1607,54,41472,2916,419904,461376
train,1608,64,49152,4096,589824,638976
train,1609,85,65280,7225,1040400,1105680
train,1610,71,54528,5041,725904,780432
train,1611,250,192000,62500,9000000,9192000
train,1612,67,51456,4489,646416,697872
train,1613,66,50688,4356,627264,677952
train,1614,105,80640,11025,1587600,1668240
train,1615,94,72192,8836,1272384,1344576
train,1616,61,46848,3721,535824,582672
train,1617,22,16896,484,69696,86592
train,1618,32,24576,1024,147456,172032
train,1619,26,19968,676,97344,117312
train,1620,106,81408,11236,1617984,1699392
train,1621,349,268032,121801,17539344,17807376
train,1622,30,23040,900,129600,152640
train,1623,314,241152,98596,14197824,14438976
train,1624,17,13056,289,41616,54672
train,1625,95,72960,9025,1299600,1372560
train,1626,91,69888,8281,1192464,1262352
train,1627,47,36096,2209,318096,354192
train,1628,258,198144,66564,9585216,9783360
train,1629,124,95232,15376,2214144,2309376
train,1630,14,10752,196,28224,38976
train,1631,134,102912,17956,2585664,2688576
train,1632,85,65280,7225,1040400,1105680
train,1633,200,153600,40000,5760000,5913600
train,1634,79,60672,6241,898704,959376
train,1635,126,96768,15876,2286144,2382912
train,1636,56,43008,3136,451584,494592
train,1637,132,101376,17424,2509056,2610432
train,1638,27,20736,729,104976,125712
train,1639,149,114432,22201,3196944,3311376
train,1640,90,69120,8100,1166400,1235520
train,1641,144,110592,20736,2985984,3096576
train,1642,118,90624,13924,2005056,2095680
train,1643,146,112128,21316,3069504,3181632
train,1644,107,82176,11449,1648656,1730832
train,1645,70,53760,4900,705600,759360
train,1646,14,10752,196,28224,38976
train,1647,78,59904,6084,876096,936000
train,1648,79,60672,6241,898704,959376
train,1649,115,88320,13225,1904400,1992720
train,1650,73,56064,5329,767376,823440
train,1651,121,92928,14641,2108304,2201232
train,1652,29,22272,841,121104,143376
train,1653,103,79104,10609,1527696,1606800
train,1654,94,72192,8836,1272384,1344576
train,1655,78,59904,6084,876096,936000
train,1656,512,393216,262144,37748736,38141952
train,1657,57,43776,3249,467856,511632
train,1658,125,96000,15625,2250000,2346000
train,1659,162,124416,26244,3779136,3903552
train,1660,381,292608,145161,20903184,21195792
train,1661,47,36096,2209,318096,354192
train,1662,132,101376,17424,2509056,2610432
train,1663,20,15360,400,57600,72960
train,1664,70,53760,4900,705600,759360
train,1665,344,264192,118336,17040384,17304576
train,1666,31,23808,961,138384,162192
train,1667,16,12288,256,36864,49152
train,1668,129,99072,16641,2396304,2495376
train,1669,83,63744,6889,992016,1055760
train,1670,108,82944,11664,1679616,1762560
train,1671,61,46848,3721,535824,582672
train,1672,66,50688,4356,627264,677952
train,1673,60,46080,3600,518400,564480
train,1674,468,359424,219024,31539456,31898880
train,1675,17,13056,289,41616,54672
train,1676,144,110592,20736,2985984,3096576
train,1677,117,89856,13689,1971216,2061072
train,1678,427,327936,182329,26255376,26583312
train,1679,39,29952,1521,219024,248976
train,1680,75,57600,5625,810000,867600
train,1681,476,365568,226576,32626944,32992512
train,1682,27,20736,729,104976,125712
train,1683,25,19200,625,90000,109200
train,1684,86,66048,7396,1065024,1131072
train,1685,41,31488,1681,242064,273552
train,1686,29,22272,841,121104,143376
train,1687,62,47616,3844,553536,601152
train,1688,102,78336,10404,1498176,1576512
train,1689,88,67584,7744,1115136,1182720
train,1690,122,93696,14884,2143296,2236992
train,1691,58,44544,3364,484416,528960
train,1692,94,72192,8836,1272384,1344576
train,1693,20,15360,400,57600,72960
train,1694,210,161280,44100,6350400,6511680
train,1695,32,24576,1024,147456,172032
train,1696,84,64512,7056,1016064,1080576
train,1697,107,82176,11449,1648656,1730832
train,1698,45,34560,2025,291600,326160
train,1699,313,240384,97969,14107536,14347920
train,1700,235,180480,55225,7952400,8132880
train,1701,217,166656,47089,6780816,6947472
train,1702,112,86016,12544,1806336,1892352
train,1703,14,10752,196,28224,38976
train,1704,26,19968,676,97344,117312
train,1705,15,11520,225,32400,43920
train,1706,28,21504,784,112896,134400
train,1707,306,235008,93636,13483584,13718592
train,1708,13,9984,169,24336,34320
train,1709,512,393216,262144,37748736,38141952
train,1710,57,43776,3249,467856,511632
train,1711,91,69888,8281,1192464,1262352
train,1712,69,52992,4761,685584,738576
train,1713,109,83712,11881,1710864,1794576
train,1714,106,81408,11236,1617984,1699392
train,1715,106,81408,11236,1617984,1699392
train,1716,177,135936,31329,4511376,4647312
train,1717,18,13824,324,46656,60480
train,1718,167,128256,27889,4016016,4144272
train,1719,59,45312,3481,501264,546576
train,1720,26,19968,676,97344,117312
train,1721,37,28416,1369,197136,225552
train,1722,163,125184,26569,3825936,3951120
train,1723,88,67584,7744,1115136,1182720
train,1724,334,256512,111556,16064064,16320576
train,1725,34,26112,1156,166464,192576
train,1726,171,131328,29241,4210704,4342032
train,1727,199,152832,39601,5702544,5855376
train,1728,63,48384,3969,571536,619920
train,1729,160,122880,25600,3686400,3809280
train,1730,81,62208,6561,944784,1006992
train,1731,105,80640,11025,1587600,1668240
train,1732,126,96768,15876,2286144,2382912
train,1733,118,90624,13924,2005056,2095680
train,1734,25,19200,625,90000,109200
train,1735,68,52224,4624,665856,718080
train,1736,190,145920,36100,5198400,5344320
train,1737,299,229632,89401,12873744,13103376
train,1738,19,14592,361,51984,66576
train,1739,80,61440,6400,921600,983040
train,1740,70,53760,4900,705600,759360
train,1741,112,86016,12544,1806336,1892352
train,1742,101,77568,10201,1468944,1546512
train,1743,131,100608,17161,2471184,2571792
train,1744,286,219648,81796,11778624,11998272
train,1745,62,47616,3844,553536,601152
train,1746,148,113664,21904,3154176,3267840
train,1747,81,62208,6561,944784,1006992
train,1748,111,85248,12321,1774224,1859472
train,1749,77,59136,5929,853776,912912
train,1750,218,167424,47524,6843456,7010880
train,1751,14,10752,196,28224,38976
train,1752,91,69888,8281,1192464,1262352
train,1753,25,19200,625,90000,109200
train,1754,128,98304,16384,2359296,2457600
train,1755,47,36096,2209,318096,354192
train,1756,50,38400,2500,360000,398400
train,1757,46,35328,2116,304704,340032
train,1758,201,154368,40401,5817744,5972112
train,1759,30,23040,900,129600,152640
train,1760,88,67584,7744,1115136,1182720
train,1761,48,36864,2304,331776,368640
train,1762,100,76800,10000,1440000,1516800
train,1763,50,38400,2500,360000,398400
train,1764,59,45312,3481,501264,546576
train,1765,73,56064,5329,767376,823440
train,1766,25,19200,625,90000,109200
train,1767,77,59136,5929,853776,912912
train,1768,158,121344,24964,3594816,3716160
train,1769,62,47616,3844,553536,601152
train,1770,290,222720,84100,12110400,12333120
train,1771,382,293376,145924,21013056,21306432
train,1772,36,27648,1296,186624,214272
train,1773,76,58368,5776,831744,890112
train,1774,265,203520,70225,10112400,10315920
train,1775,15,11520,225,32400,43920
train,1776,28,21504,784,112896,134400
train,1777,67,51456,4489,646416,697872
train,1778,60,46080,3600,518400,564480
train,1779,97,74496,9409,1354896,1429392
train,1780,132,101376,17424,2509056,2610432
train,1781,512,393216,262144,37748736,38141952
train,1782,100,76800,10000,1440000,1516800
train,1783,116,89088,13456,1937664,2026752
train,1784,42,32256,1764,254016,286272
train,1785,88,67584,7744,1115136,1182720
train,1786,113,86784,12769,1838736,1925520
train,1787,60,46080,3600,518400,564480
train,1788,41,31488,1681,242064,273552
train,1789,210,161280,44100,6350400,6511680
train,1790,440,337920,193600,27878400,28216320
train,1791,86,66048,7396,1065024,1131072
train,1792,167,128256,27889,4016016,4144272
train,1793,56,43008,3136,451584,494592
train,1794,94,72192,8836,1272384,1344576
train,1795,240,184320,57600,8294400,8478720
train,1796,104,79872,10816,1557504,1637376
train,1797,60,46080,3600,518400,564480
train,1798,194,148992,37636,5419584,5568576
train,1799,31,23808,961,138384,162192
train,1800,303,232704,91809,13220496,13453200
train,1801,27,20736,729,104976,125712
train,1802,106,81408,11236,1617984,1699392
train,1803,48,36864,2304,331776,368640
train,1804,138,105984,19044,2742336,2848320
train,1805,227,174336,51529,7420176,7594512
train,1806,27,20736,729,104976,125712
train,1807,47,36096,2209,318096,354192
train,1808,80,61440,6400,921600,983040
train,1809,85,65280,7225,1040400,1105680
train,1810,104,79872,10816,1557504,1637376
train,1811,203,155904,41209,5934096,6090000
train,1812,90,69120,8100,1166400,1235520
train,1813,193,148224,37249,5363856,5512080
train,1814,14,10752,196,28224,38976
train,1815,18,13824,324,46656,60480
train,1816,107,82176,11449,1648656,1730832
train,1817,423,324864,178929,25765776,26090640
train,1818,353,271104,124609,17943696,18214800
train,1819,109,83712,11881,1710864,1794576
train,1820,180,138240,32400,4665600,4803840
train,1821,87,66816,7569,1089936,1156752
train,1822,114,87552,12996,1871424,1958976
train,1823,28,21504,784,112896,134400
train,1824,187,143616,34969,5035536,5179152
train,1825,32,24576,1024,147456,172032
train,1826,23,17664,529,76176,93840
train,1827,60,46080,3600,518400,564480
train,1828,59,45312,3481,501264,546576
train,1829,38,29184,1444,207936,237120
train,1830,112,86016,12544,1806336,1892352
train,1831,32,24576,1024,147456,172032
train,1832,70,53760,4900,705600,759360
train,1833,512,393216,262144,37748736,38141952
train,1834,219,168192,47961,6906384,7074576
train,1835,161,123648,25921,3732624,3856272
train,1836,90,69120,8100,1166400,1235520
train,1837,321,246528,103041,14837904,15084432
train,1838,62,47616,3844,553536,601152
train,1839,133,102144,17689,2547216,2649360
train,1840,512,393216,262144,37748736,38141952
train,1841,33,25344,1089,156816,182160
train,1842,399,306432,159201,22924944,23231376
train,1843,17,13056,289,41616,54672
train,1844,88,67584,7744,1115136,1182720
train,1845,198,152064,39204,5645376,5797440
train,1846,26,19968,676,97344,117312
train,1847,75,57600,5625,810000,867600
train,1848,129,99072,16641,2396304,2495376
train,1849,512,393216,262144,37748736,38141952
train,1850,200,153600,40000,5760000,5913600
train,1851,512,393216,262144,37748736,38141952
train,1852,512,393216,262144,37748736,38141952
train,1853,31,23808,961,138384,162192
train,1854,151,115968,22801,3283344,3399312
train,1855,110,84480,12100,1742400,1826880
train,1856,83,63744,6889,992016,1055760
train,1857,45,34560,2025,291600,326160
train,1858,35,26880,1225,176400,203280
train,1859,31,23808,961,138384,162192
train,1860,73,56064,5329,767376,823440
train,1861,29,22272,841,121104,143376
train,1862,61,46848,3721,535824,582672
train,1863,20,15360,400,57600,72960
train,1864,16,12288,256,36864,49152
train,1865,74,56832,5476,788544,845376
train,1866,42,32256,1764,254016,286272
train,1867,18,13824,324,46656,60480
train,1868,164,125952,26896,3873024,3998976
train,1869,512,393216,262144,37748736,38141952
train,1870,29,22272,841,121104,143376
train,1871,96,73728,9216,1327104,1400832
train,1872,97,74496,9409,1354896,1429392
train,1873,84,64512,7056,1016064,1080576
train,1874,16,12288,256,36864,49152
train,1875,418,321024,174724,25160256,25481280
train,1876,29,22272,841,121104,143376
train,1877,452,347136,204304,29419776,29766912
train,1878,418,321024,174724,25160256,25481280
train,1879,26,19968,676,97344,117312
train,1880,140,107520,19600,2822400,2929920
train,1881,124,95232,15376,2214144,2309376
train,1882,92,70656,8464,1218816,1289472
train,1883,174,133632,30276,4359744,4493376
train,1884,25,19200,625,90000,109200
train,1885,18,13824,324,46656,60480
train,1886,69,52992,4761,685584,738576
train,1887,18,13824,324,46656,60480
train,1888,22,16896,484,69696,86592
train,1889,102,78336,10404,1498176,1576512
train,1890,129,99072,16641,2396304,2495376
train,1891,61,46848,3721,535824,582672
train,1892,278,213504,77284,11128896,11342400
train,1893,53,40704,2809,404496,445200
train,1894,30,23040,900,129600,152640
train,1895,58,44544,3364,484416,528960
train,1896,30,23040,900,129600,152640
train,1897,110,84480,12100,1742400,1826880
train,1898,103,79104,10609,1527696,1606800
train,1899,177,135936,31329,4511376,4647312
train,1900,67,51456,4489,646416,697872
train,1901,182,139776,33124,4769856,4909632
train,1902,151,115968,22801,3283344,3399312
train,1903,102,78336,10404,1498176,1576512
train,1904,30,23040,900,129600,152640
train,1905,19,14592,361,51984,66576
train,1906,86,66048,7396,1065024,1131072
train,1907,34,26112,1156,166464,192576
train,1908,27,20736,729,104976,125712
train,1909,153,117504,23409,3370896,3488400
train,1910,80,61440,6400,921600,983040
train,1911,86,66048,7396,1065024,1131072
train,1912,58,44544,3364,484416,528960
train,1913,56,43008,3136,451584,494592
train,1914,63,48384,3969,571536,619920
train,1915,107,82176,11449,1648656,1730832
train,1916,104,79872,10816,1557504,1637376
train,1917,43,33024,1849,266256,299280
train,1918,38,29184,1444,207936,237120
train,1919,56,43008,3136,451584,494592
train,1920,279,214272,77841,11209104,11423376
train,1921,206,158208,42436,6110784,6268992
train,1922,28,21504,784,112896,134400
train,1923,205,157440,42025,6051600,6209040
train,1924,332,254976,110224,15872256,16127232
train,1925,226,173568,51076,7354944,7528512
train,1926,40,30720,1600,230400,261120
train,1927,464,356352,215296,31002624,31358976
train,1928,44,33792,1936,278784,312576
train,1929,198,152064,39204,5645376,5797440
train,1930,180,138240,32400,4665600,4803840
train,1931,115,88320,13225,1904400,1992720
train,1932,163,125184,26569,3825936,3951120
train,1933,226,173568,51076,7354944,7528512
train,1934,99,76032,9801,1411344,1487376
train,1935,132,101376,17424,2509056,2610432
train,1936,35,26880,1225,176400,203280
train,1937,72,55296,5184,746496,801792
train,1938,128,98304,16384,2359296,2457600
train,1939,56,43008,3136,451584,494592
train,1940,121,92928,14641,2108304,2201232
train,1941,280,215040,78400,11289600,11504640
train,1942,149,114432,22201,3196944,3311376
train,1943,18,13824,324,46656,60480
train,1944,36,27648,1296,186624,214272
train,1945,56,43008,3136,451584,494592
train,1946,102,78336,10404,1498176,1576512
train,1947,23,17664,529,76176,93840
train,1948,55,42240,3025,435600,477840
train,1949,83,63744,6889,992016,1055760
train,1950,66,50688,4356,627264,677952
train,1951,111,85248,12321,1774224,1859472
train,1952,31,23808,961,138384,162192
train,1953,48,36864,2304,331776,368640
train,1954,19,14592,361,51984,66576
train,1955,95,72960,9025,1299600,1372560
train,1956,398,305664,158404,22810176,23115840
train,1957,206,158208,42436,6110784,6268992
train,1958,323,248064,104329,15023376,15271440
train,1959,125,96000,15625,2250000,2346000
train,1960,29,22272,841,121104,143376
train,1961,57,43776,3249,467856,511632
train,1962,189,145152,35721,5143824,5288976
train,1963,247,189696,61009,8785296,8974992
train,1964,60,46080,3600,518400,564480
train,1965,17,13056,289,41616,54672
train,1966,63,48384,3969,571536,619920
train,1967,60,46080,3600,518400,564480
train,1968,127,97536,16129,2322576,2420112
train,1969,43,33024,1849,266256,299280
train,1970,31,23808,961,138384,162192
train,1971,219,168192,47961,6906384,7074576
train,1972,161,123648,25921,3732624,3856272
train,1973,100,76800,10000,1440000,1516800
train,1974,512,393216,262144,37748736,38141952
train,1975,158,121344,24964,3594816,3716160
train,1976,52,39936,2704,389376,429312
train,1977,69,52992,4761,685584,738576
train,1978,62,47616,3844,553536,601152
train,1979,29,22272,841,121104,143376
train,1980,112,86016,12544,1806336,1892352
train,1981,58,44544,3364,484416,528960
train,1982,48,36864,2304,331776,368640
train,1983,66,50688,4356,627264,677952
train,1984,19,14592,361,51984,66576
train,1985,115,88320,13225,1904400,1992720
train,1986,21,16128,441,63504,79632
train,1987,123,94464,15129,2178576,2273040
train,1988,29,22272,841,121104,143376
train,1989,126,96768,15876,2286144,2382912
train,1990,29,22272,841,121104,143376
train,1991,156,119808,24336,3504384,3624192
train,1992,117,89856,13689,1971216,2061072
train,1993,132,101376,17424,2509056,2610432
train,1994,53,40704,2809,404496,445200
train,1995,232,178176,53824,7750656,7928832
train,1996,258,198144,66564,9585216,9783360
train,1997,78,59904,6084,876096,936000
train,1998,69,52992,4761,685584,738576
train,1999,207,158976,42849,6170256,6329232
train,2000,12,9216,144,20736,29952
train,2001,40,30720,1600,230400,261120
train,2002,127,97536,16129,2322576,2420112
train,2003,15,11520,225,32400,43920
train,2004,218,167424,47524,6843456,7010880
train,2005,116,89088,13456,1937664,2026752
train,2006,127,97536,16129,2322576,2420112
train,2007,11,8448,121,17424,25872
train,2008,134,102912,17956,2585664,2688576
train,2009,45,34560,2025,291600,326160
train,2010,141,108288,19881,2862864,2971152
train,2011,109,83712,11881,1710864,1794576
train,2012,183,140544,33489,4822416,4962960
train,2013,203,155904,41209,5934096,6090000
train,2014,119,91392,14161,2039184,2130576
train,2015,217,166656,47089,6780816,6947472
train,2016,45,34560,2025,291600,326160
train,2017,247,189696,61009,8785296,8974992
train,2018,82,62976,6724,968256,1031232
train,2019,311,238848,96721,13927824,14166672
train,2020,52,39936,2704,389376,429312
train,2021,87,66816,7569,1089936,1156752
train,2022,29,22272,841,121104,143376
train,2023,97,74496,9409,1354896,1429392
train,2024,78,59904,6084,876096,936000
train,2025,104,79872,10816,1557504,1637376
train,2026,44,33792,1936,278784,312576
train,2027,95,72960,9025,1299600,1372560
train,2028,27,20736,729,104976,125712
train,2029,126,96768,15876,2286144,2382912
train,2030,205,157440,42025,6051600,6209040
train,2031,71,54528,5041,725904,780432
train,2032,34,26112,1156,166464,192576
train,2033,185,142080,34225,4928400,5070480
train,2034,318,244224,101124,14561856,14806080
train,2035,137,105216,18769,2702736,2807952
train,2036,19,14592,361,51984,66576
train,2037,395,303360,156025,22467600,22770960
train,2038,129,99072,16641,2396304,2495376
train,2039,60,46080,3600,518400,564480
train,2040,206,158208,42436,6110784,6268992
train,2041,19,14592,361,51984,66576
train,2042,55,42240,3025,435600,477840
train,2043,80,61440,6400,921600,983040
train,2044,80,61440,6400,921600,983040
train,2045,81,62208,6561,944784,1006992
train,2046,79,60672,6241,898704,959376
train,2047,35,26880,1225,176400,203280
train,2048,117,89856,13689,1971216,2061072
train,2049,82,62976,6724,968256,1031232
train,2050,19,14592,361,51984,66576
train,2051,68,52224,4624,665856,718080
train,2052,53,40704,2809,404496,445200
train,2053,98,75264,9604,1382976,1458240
train,2054,211,162048,44521,6411024,6573072
train,2055,96,73728,9216,1327104,1400832
train,2056,27,20736,729,104976,125712
train,2057,233,178944,54289,7817616,7996560
train,2058,14,10752,196,28224,38976
train,2059,93,71424,8649,1245456,1316880
train,2060,183,140544,33489,4822416,4962960
train,2061,61,46848,3721,535824,582672
train,2062,57,43776,3249,467856,511632
train,2063,80,61440,6400,921600,983040
train,2064,112,86016,12544,1806336,1892352
train,2065,53,40704,2809,404496,445200
train,2066,86,66048,7396,1065024,1131072
train,2067,110,84480,12100,1742400,1826880
train,2068,71,54528,5041,725904,780432
train,2069,20,15360,400,57600,72960
train,2070,27,20736,729,104976,125712
train,2071,297,228096,88209,12702096,12930192
train,2072,62,47616,3844,553536,601152
train,2073,451,346368,203401,29289744,29636112
train,2074,512,393216,262144,37748736,38141952
train,2075,83,63744,6889,992016,1055760
train,2076,94,72192,8836,1272384,1344576
train,2077,131,100608,17161,2471184,2571792
train,2078,133,102144,17689,2547216,2649360
train,2079,75,57600,5625,810000,867600
train,2080,67,51456,4489,646416,697872
train,2081,72,55296,5184,746496,801792
train,2082,29,22272,841,121104,143376
train,2083,60,46080,3600,518400,564480
train,2084,299,229632,89401,12873744,13103376
train,2085,187,143616,34969,5035536,5179152
train,2086,17,13056,289,41616,54672
train,2087,17,13056,289,41616,54672
train,2088,93,71424,8649,1245456,1316880
train,2089,86,66048,7396,1065024,1131072
train,2090,427,327936,182329,26255376,26583312
train,2091,47,36096,2209,318096,354192
train,2092,90,69120,8100,1166400,1235520
train,2093,13,9984,169,24336,34320
train,2094,183,140544,33489,4822416,4962960
train,2095,67,51456,4489,646416,697872
train,2096,45,34560,2025,291600,326160
train,2097,233,178944,54289,7817616,7996560
train,2098,25,19200,625,90000,109200
train,2099,23,17664,529,76176,93840
train,2100,16,12288,256,36864,49152
train,2101,34,26112,1156,166464,192576
train,2102,81,62208,6561,944784,1006992
train,2103,69,52992,4761,685584,738576
train,2104,96,73728,9216,1327104,1400832
train,2105,96,73728,9216,1327104,1400832
train,2106,53,40704,2809,404496,445200
train,2107,27,20736,729,104976,125712
train,2108,104,79872,10816,1557504,1637376
train,2109,121,92928,14641,2108304,2201232
train,2110,48,36864,2304,331776,368640
train,2111,93,71424,8649,1245456,1316880
train,2112,87,66816,7569,1089936,1156752
train,2113,122,93696,14884,2143296,2236992
train,2114,323,248064,104329,15023376,15271440
train,2115,141,108288,19881,2862864,2971152
train,2116,32,24576,1024,147456,172032
train,2117,133,102144,17689,2547216,2649360
train,2118,117,89856,13689,1971216,2061072
train,2119,154,118272,23716,3415104,3533376
train,2120,99,76032,9801,1411344,1487376
train,2121,72,55296,5184,746496,801792
train,2122,101,77568,10201,1468944,1546512
train,2123,318,244224,101124,14561856,14806080
train,2124,342,262656,116964,16842816,17105472
train,2125,155,119040,24025,3459600,3578640
train,2126,129,99072,16641,2396304,2495376
train,2127,113,86784,12769,1838736,1925520
train,2128,178,136704,31684,4562496,4699200
train,2129,26,19968,676,97344,117312
train,2130,19,14592,361,51984,66576
train,2131,95,72960,9025,1299600,1372560
train,2132,140,107520,19600,2822400,2929920
train,2133,143,109824,20449,2944656,3054480
train,2134,18,13824,324,46656,60480
train,2135,71,54528,5041,725904,780432
train,2136,13,9984,169,24336,34320
train,2137,21,16128,441,63504,79632
train,2138,71,54528,5041,725904,780432
train,2139,24,18432,576,82944,101376
train,2140,28,21504,784,112896,134400
train,2141,185,142080,34225,4928400,5070480
train,2142,55,42240,3025,435600,477840
train,2143,85,65280,7225,1040400,1105680
train,2144,56,43008,3136,451584,494592
train,2145,37,28416,1369,197136,225552
train,2146,19,14592,361,51984,66576
train,2147,131,100608,17161,2471184,2571792
train,2148,22,16896,484,69696,86592
train,2149,512,393216,262144,37748736,38141952
train,2150,48,36864,2304,331776,368640
train,2151,215,165120,46225,6656400,6821520
train,2152,48,36864,2304,331776,368640
train,2153,154,118272,23716,3415104,3533376
train,2154,51,39168,2601,374544,413712
train,2155,276,211968,76176,10969344,11181312
train,2156,51,39168,2601,374544,413712
train,2157,84,64512,7056,1016064,1080576
train,2158,146,112128,21316,3069504,3181632
train,2159,49,37632,2401,345744,383376
train,2160,334,256512,111556,16064064,16320576
train,2161,84,64512,7056,1016064,1080576
train,2162,52,39936,2704,389376,429312
train,2163,113,86784,12769,1838736,1925520
train,2164,99,76032,9801,1411344,1487376
train,2165,124,95232,15376,2214144,2309376
train,2166,109,83712,11881,1710864,1794576
train,2167,47,36096,2209,318096,354192
train,2168,115,88320,13225,1904400,1992720
train,2169,64,49152,4096,589824,638976
train,2170,169,129792,28561,4112784,4242576
train,2171,44,33792,1936,278784,312576
train,2172,94,72192,8836,1272384,1344576
train,2173,436,334848,190096,27373824,27708672
train,2174,512,393216,262144,37748736,38141952
train,2175,148,113664,21904,3154176,3267840
train,2176,131,100608,17161,2471184,2571792
train,2177,84,64512,7056,1016064,1080576
train,2178,67,51456,4489,646416,697872
train,2179,106,81408,11236,1617984,1699392
train,2180,297,228096,88209,12702096,12930192
train,2181,231,177408,53361,7683984,7861392
train,2182,230,176640,52900,7617600,7794240
train,2183,209,160512,43681,6290064,6450576
train,2184,149,114432,22201,3196944,3311376
train,2185,33,25344,1089,156816,182160
train,2186,135,103680,18225,2624400,2728080
train,2187,14,10752,196,28224,38976
train,2188,14,10752,196,28224,38976
train,2189,22,16896,484,69696,86592
train,2190,37,28416,1369,197136,225552
train,2191,512,393216,262144,37748736,38141952
train,2192,356,273408,126736,18249984,18523392
train,2193,485,372480,235225,33872400,34244880
train,2194,65,49920,4225,608400,658320
train,2195,116,89088,13456,1937664,2026752
train,2196,81,62208,6561,944784,1006992
train,2197,31,23808,961,138384,162192
train,2198,144,110592,20736,2985984,3096576
train,2199,349,268032,121801,17539344,17807376
train,2200,28,21504,784,112896,134400
train,2201,98,75264,9604,1382976,1458240
train,2202,73,56064,5329,767376,823440
train,2203,18,13824,324,46656,60480
train,2204,91,69888,8281,1192464,1262352
train,2205,434,333312,188356,27123264,27456576
train,2206,127,97536,16129,2322576,2420112
train,2207,94,72192,8836,1272384,1344576
train,2208,345,264960,119025,17139600,17404560
train,2209,198,152064,39204,5645376,5797440
train,2210,512,393216,262144,37748736,38141952
train,2211,85,65280,7225,1040400,1105680
train,2212,99,76032,9801,1411344,1487376
train,2213,187,143616,34969,5035536,5179152
train,2214,76,58368,5776,831744,890112
train,2215,512,393216,262144,37748736,38141952
train,2216,44,33792,1936,278784,312576
train,2217,77,59136,5929,853776,912912
train,2218,92,70656,8464,1218816,1289472
train,2219,85,65280,7225,1040400,1105680
train,2220,38,29184,1444,207936,237120
train,2221,48,36864,2304,331776,368640
train,2222,219,168192,47961,6906384,7074576
train,2223,50,38400,2500,360000,398400
train,2224,302,231936,91204,13133376,13365312
train,2225,10,7680,100,14400,22080
train,2226,32,24576,1024,147456,172032
train,2227,512,393216,262144,37748736,38141952
train,2228,50,38400,2500,360000,398400
train,2229,111,85248,12321,1774224,1859472
train,2230,17,13056,289,41616,54672
train,2231,366,281088,133956,19289664,19570752
train,2232,53,40704,2809,404496,445200
train,2233,241,185088,58081,8363664,8548752
train,2234,32,24576,1024,147456,172032
train,2235,16,12288,256,36864,49152
train,2236,50,38400,2500,360000,398400
train,2237,354,271872,125316,18045504,18317376
train,2238,24,18432,576,82944,101376
train,2239,51,39168,2601,374544,413712
train,2240,108,82944,11664,1679616,1762560
train,2241,412,316416,169744,24443136,24759552
train,2242,355,272640,126025,18147600,18420240
train,2243,243,186624,59049,8503056,8689680
train,2244,79,60672,6241,898704,959376
train,2245,28,21504,784,112896,134400
train,2246,94,72192,8836,1272384,1344576
train,2247,27,20736,729,104976,125712
train,2248,330,253440,108900,15681600,15935040
train,2249,60,46080,3600,518400,564480
train,2250,112,86016,12544,1806336,1892352
train,2251,93,71424,8649,1245456,1316880
train,2252,116,89088,13456,1937664,2026752
train,2253,61,46848,3721,535824,582672
train,2254,16,12288,256,36864,49152
train,2255,98,75264,9604,1382976,1458240
train,2256,117,89856,13689,1971216,2061072
train,2257,233,178944,54289,7817616,7996560
train,2258,419,321792,175561,25280784,25602576
train,2259,92,70656,8464,1218816,1289472
train,2260,150,115200,22500,3240000,3355200
train,2261,57,43776,3249,467856,511632
train,2262,38,29184,1444,207936,237120
train,2263,54,41472,2916,419904,461376
train,2264,155,119040,24025,3459600,3578640
train,2265,76,58368,5776,831744,890112
train,2266,106,81408,11236,1617984,1699392
train,2267,30,23040,900,129600,152640
train,2268,51,39168,2601,374544,413712
train,2269,30,23040,900,129600,152640
train,2270,14,10752,196,28224,38976
train,2271,23,17664,529,76176,93840
train,2272,64,49152,4096,589824,638976
train,2273,203,155904,41209,5934096,6090000
train,2274,145,111360,21025,3027600,3138960
train,2275,30,23040,900,129600,152640
train,2276,264,202752,69696,10036224,10238976
train,2277,259,198912,67081,9659664,9858576
train,2278,102,78336,10404,1498176,1576512
train,2279,30,23040,900,129600,152640
train,2280,66,50688,4356,627264,677952
train,2281,140,107520,19600,2822400,2929920
train,2282,110,84480,12100,1742400,1826880
train,2283,267,205056,71289,10265616,10470672
train,2284,19,14592,361,51984,66576
train,2285,30,23040,900,129600,152640
train,2286,162,124416,26244,3779136,3903552
train,2287,17,13056,289,41616,54672
train,2288,51,39168,2601,374544,413712
train,2289,512,393216,262144,37748736,38141952
train,2290,84,64512,7056,1016064,1080576
train,2291,241,185088,58081,8363664,8548752
train,2292,61,46848,3721,535824,582672
train,2293,329,252672,108241,15586704,15839376
train,2294,66,50688,4356,627264,677952
train,2295,35,26880,1225,176400,203280
train,2296,88,67584,7744,1115136,1182720
train,2297,68,52224,4624,665856,718080
train,2298,67,51456,4489,646416,697872
train,2299,54,41472,2916,419904,461376
train,2300,17,13056,289,41616,54672
train,2301,27,20736,729,104976,125712
train,2302,107,82176,11449,1648656,1730832
train,2303,314,241152,98596,14197824,14438976
train,2304,152,116736,23104,3326976,3443712
train,2305,512,393216,262144,37748736,38141952
train,2306,43,33024,1849,266256,299280
train,2307,124,95232,15376,2214144,2309376
train,2308,69,52992,4761,685584,738576
train,2309,512,393216,262144,37748736,38141952
train,2310,203,155904,41209,5934096,6090000
train,2311,99,76032,9801,1411344,1487376
train,2312,87,66816,7569,1089936,1156752
train,2313,51,39168,2601,374544,413712
train,2314,42,32256,1764,254016,286272
train,2315,28,21504,784,112896,134400
train,2316,512,393216,262144,37748736,38141952
train,2317,84,64512,7056,1016064,1080576
train,2318,298,228864,88804,12787776,13016640
train,2319,115,88320,13225,1904400,1992720
train,2320,71,54528,5041,725904,780432
train,2321,184,141312,33856,4875264,5016576
train,2322,28,21504,784,112896,134400
train,2323,118,90624,13924,2005056,2095680
train,2324,74,56832,5476,788544,845376
train,2325,30,23040,900,129600,152640
train,2326,34,26112,1156,166464,192576
train,2327,55,42240,3025,435600,477840
train,2328,49,37632,2401,345744,383376
train,2329,14,10752,196,28224,38976
train,2330,50,38400,2500,360000,398400
train,2331,40,30720,1600,230400,261120
train,2332,31,23808,961,138384,162192
train,2333,258,198144,66564,9585216,9783360
train,2334,74,56832,5476,788544,845376
train,2335,221,169728,48841,7033104,7202832
train,2336,410,314880,168100,24206400,24521280
train,2337,48,36864,2304,331776,368640
train,2338,79,60672,6241,898704,959376
train,2339,54,41472,2916,419904,461376
train,2340,56,43008,3136,451584,494592
train,2341,278,213504,77284,11128896,11342400
train,2342,40,30720,1600,230400,261120
train,2343,31,23808,961,138384,162192
train,2344,51,39168,2601,374544,413712
train,2345,245,188160,60025,8643600,8831760
train,2346,140,107520,19600,2822400,2929920
train,2347,15,11520,225,32400,43920
train,2348,135,103680,18225,2624400,2728080
train,2349,79,60672,6241,898704,959376
train,2350,29,22272,841,121104,143376
train,2351,93,71424,8649,1245456,1316880
train,2352,512,393216,262144,37748736,38141952
train,2353,17,13056,289,41616,54672
train,2354,225,172800,50625,7290000,7462800
train,2355,104,79872,10816,1557504,1637376
train,2356,62,47616,3844,553536,601152
train,2357,15,11520,225,32400,43920
train,2358,53,40704,2809,404496,445200
train,2359,103,79104,10609,1527696,1606800
train,2360,165,126720,27225,3920400,4047120
train,2361,182,139776,33124,4769856,4909632
train,2362,16,12288,256,36864,49152
train,2363,267,205056,71289,10265616,10470672
train,2364,88,67584,7744,1115136,1182720
train,2365,15,11520,225,32400,43920
train,2366,70,53760,4900,705600,759360
train,2367,135,103680,18225,2624400,2728080
train,2368,316,242688,99856,14379264,14621952
train,2369,36,27648,1296,186624,214272
train,2370,83,63744,6889,992016,1055760
train,2371,16,12288,256,36864,49152
train,2372,79,60672,6241,898704,959376
train,2373,237,182016,56169,8088336,8270352
train,2374,54,41472,2916,419904,461376
train,2375,163,125184,26569,3825936,3951120
train,2376,180,138240,32400,4665600,4803840
train,2377,235,180480,55225,7952400,8132880
train,2378,74,56832,5476,788544,845376
train,2379,85,65280,7225,1040400,1105680
train,2380,94,72192,8836,1272384,1344576
train,2381,453,347904,205209,29550096,29898000
train,2382,158,121344,24964,3594816,3716160
train,2383,242,185856,58564,8433216,8619072
train,2384,173,132864,29929,4309776,4442640
train,2385,180,138240,32400,4665600,4803840
train,2386,81,62208,6561,944784,1006992
train,2387,34,26112,1156,166464,192576
train,2388,512,393216,262144,37748736,38141952
train,2389,104,79872,10816,1557504,1637376
train,2390,41,31488,1681,242064,273552
train,2391,66,50688,4356,627264,677952
train,2392,240,184320,57600,8294400,8478720
train,2393,51,39168,2601,374544,413712
train,2394,40,30720,1600,230400,261120
train,2395,172,132096,29584,4260096,4392192
train,2396,141,108288,19881,2862864,2971152
train,2397,76,58368,5776,831744,890112
train,2398,41,31488,1681,242064,273552
train,2399,16,12288,256,36864,49152
train,2400,36,27648,1296,186624,214272
train,2401,228,175104,51984,7485696,7660800
train,2402,55,42240,3025,435600,477840
train,2403,15,11520,225,32400,43920
train,2404,37,28416,1369,197136,225552
train,2405,110,84480,12100,1742400,1826880
train,2406,26,19968,676,97344,117312
train,2407,101,77568,10201,1468944,1546512
train,2408,41,31488,1681,242064,273552
train,2409,118,90624,13924,2005056,2095680
train,2410,75,57600,5625,810000,867600
train,2411,353,271104,124609,17943696,18214800
train,2412,400,307200,160000,23040000,23347200
train,2413,52,39936,2704,389376,429312
train,2414,104,79872,10816,1557504,1637376
train,2415,335,257280,112225,16160400,16417680
train,2416,220,168960,48400,6969600,7138560
train,2417,285,218880,81225,11696400,11915280
train,2418,14,10752,196,28224,38976
train,2419,19,14592,361,51984,66576
train,2420,58,44544,3364,484416,528960
train,2421,41,31488,1681,242064,273552
train,2422,152,116736,23104,3326976,3443712
train,2423,30,23040,900,129600,152640
train,2424,117,89856,13689,1971216,2061072
train,2425,69,52992,4761,685584,738576
train,2426,258,198144,66564,9585216,9783360
train,2427,18,13824,324,46656,60480
train,2428,118,90624,13924,2005056,2095680
train,2429,175,134400,30625,4410000,4544400
train,2430,158,121344,24964,3594816,3716160
train,2431,29,22272,841,121104,143376
train,2432,87,66816,7569,1089936,1156752
train,2433,34,26112,1156,166464,192576
train,2434,15,11520,225,32400,43920
train,2435,70,53760,4900,705600,759360
train,2436,86,66048,7396,1065024,1131072
train,2437,119,91392,14161,2039184,2130576
train,2438,461,354048,212521,30603024,30957072
train,2439,35,26880,1225,176400,203280
train,2440,98,75264,9604,1382976,1458240
train,2441,61,46848,3721,535824,582672
train,2442,82,62976,6724,968256,1031232
train,2443,75,57600,5625,810000,867600
train,2444,44,33792,1936,278784,312576
train,2445,131,100608,17161,2471184,2571792
train,2446,118,90624,13924,2005056,2095680
train,2447,38,29184,1444,207936,237120
train,2448,512,393216,262144,37748736,38141952
train,2449,60,46080,3600,518400,564480
train,2450,37,28416,1369,197136,225552
train,2451,512,393216,262144,37748736,38141952
train,2452,47,36096,2209,318096,354192
train,2453,78,59904,6084,876096,936000
train,2454,218,167424,47524,6843456,7010880
train,2455,47,36096,2209,318096,354192
train,2456,71,54528,5041,725904,780432
train,2457,212,162816,44944,6471936,6634752
train,2458,82,62976,6724,968256,1031232
train,2459,268,205824,71824,10342656,10548480
train,2460,86,66048,7396,1065024,1131072
train,2461,28,21504,784,112896,134400
train,2462,96,73728,9216,1327104,1400832
train,2463,192,147456,36864,5308416,5455872
train,2464,105,80640,11025,1587600,1668240
train,2465,99,76032,9801,1411344,1487376
train,2466,114,87552,12996,1871424,1958976
train,2467,76,58368,5776,831744,890112
train,2468,88,67584,7744,1115136,1182720
train,2469,385,295680,148225,21344400,21640080
train,2470,15,11520,225,32400,43920
train,2471,15,11520,225,32400,43920
train,2472,74,56832,5476,788544,845376
train,2473,116,89088,13456,1937664,2026752
train,2474,56,43008,3136,451584,494592
train,2475,252,193536,63504,9144576,9338112
train,2476,49,37632,2401,345744,383376
train,2477,64,49152,4096,589824,638976
train,2478,16,12288,256,36864,49152
train,2479,30,23040,900,129600,152640
train,2480,126,96768,15876,2286144,2382912
train,2481,70,53760,4900,705600,759360
train,2482,77,59136,5929,853776,912912
train,2483,63,48384,3969,571536,619920
train,2484,15,11520,225,32400,43920
train,2485,27,20736,729,104976,125712
train,2486,420,322560,176400,25401600,25724160
train,2487,12,9216,144,20736,29952
train,2488,25,19200,625,90000,109200
train,2489,120,92160,14400,2073600,2165760
train,2490,260,199680,67600,9734400,9934080
train,2491,111,85248,12321,1774224,1859472
train,2492,15,11520,225,32400,43920
train,2493,118,90624,13924,2005056,2095680
train,2494,81,62208,6561,944784,1006992
train,2495,97,74496,9409,1354896,1429392
train,2496,126,96768,15876,2286144,2382912
train,2497,348,267264,121104,17438976,17706240
train,2498,107,82176,11449,1648656,1730832
train,2499,98,75264,9604,1382976,1458240
train,2500,324,248832,104976,15116544,15365376
train,2501,51,39168,2601,374544,413712
train,2502,68,52224,4624,665856,718080
train,2503,178,136704,31684,4562496,4699200
train,2504,385,295680,148225,21344400,21640080
train,2505,210,161280,44100,6350400,6511680
train,2506,76,58368,5776,831744,890112
train,2507,66,50688,4356,627264,677952
train,2508,87,66816,7569,1089936,1156752
train,2509,66,50688,4356,627264,677952
train,2510,54,41472,2916,419904,461376
train,2511,161,123648,25921,3732624,3856272
train,2512,216,165888,46656,6718464,6884352
train,2513,19,14592,361,51984,66576
train,2514,211,162048,44521,6411024,6573072
train,2515,100,76800,10000,1440000,1516800
train,2516,25,19200,625,90000,109200
train,2517,102,78336,10404,1498176,1576512
train,2518,34,26112,1156,166464,192576
train,2519,487,374016,237169,34152336,34526352
train,2520,77,59136,5929,853776,912912
train,2521,59,45312,3481,501264,546576
train,2522,92,70656,8464,1218816,1289472
train,2523,12,9216,144,20736,29952
train,2524,57,43776,3249,467856,511632
train,2525,50,38400,2500,360000,398400
train,2526,143,109824,20449,2944656,3054480
train,2527,318,244224,101124,14561856,14806080
train,2528,95,72960,9025,1299600,1372560
train,2529,70,53760,4900,705600,759360
train,2530,437,335616,190969,27499536,27835152
train,2531,203,155904,41209,5934096,6090000
train,2532,119,91392,14161,2039184,2130576
train,2533,48,36864,2304,331776,368640
train,2534,26,19968,676,97344,117312
train,2535,139,106752,19321,2782224,2888976
train,2536,121,92928,14641,2108304,2201232
train,2537,82,62976,6724,968256,1031232
train,2538,64,49152,4096,589824,638976
train,2539,92,70656,8464,1218816,1289472
train,2540,14,10752,196,28224,38976
train,2541,243,186624,59049,8503056,8689680
train,2542,114,87552,12996,1871424,1958976
train,2543,64,49152,4096,589824,638976
train,2544,15,11520,225,32400,43920
train,2545,40,30720,1600,230400,261120
train,2546,45,34560,2025,291600,326160
train,2547,91,69888,8281,1192464,1262352
train,2548,81,62208,6561,944784,1006992
train,2549,105,80640,11025,1587600,1668240
train,2550,34,26112,1156,166464,192576
train,2551,55,42240,3025,435600,477840
train,2552,27,20736,729,104976,125712
train,2553,240,184320,57600,8294400,8478720
train,2554,29,22272,841,121104,143376
train,2555,229,175872,52441,7551504,7727376
train,2556,30,23040,900,129600,152640
train,2557,176,135168,30976,4460544,4595712
train,2558,105,80640,11025,1587600,1668240
train,2559,51,39168,2601,374544,413712
train,2560,420,322560,176400,25401600,25724160
train,2561,238,182784,56644,8156736,8339520
train,2562,28,21504,784,112896,134400
train,2563,45,34560,2025,291600,326160
train,2564,58,44544,3364,484416,528960
train,2565,125,96000,15625,2250000,2346000
train,2566,164,125952,26896,3873024,3998976
train,2567,112,86016,12544,1806336,1892352
train,2568,259,198912,67081,9659664,9858576
train,2569,112,86016,12544,1806336,1892352
train,2570,139,106752,19321,2782224,2888976
train,2571,161,123648,25921,3732624,3856272
train,2572,91,69888,8281,1192464,1262352
train,2573,30,23040,900,129600,152640
train,2574,55,42240,3025,435600,477840
train,2575,15,11520,225,32400,43920
train,2576,159,122112,25281,3640464,3762576
train,2577,418,321024,174724,25160256,25481280
train,2578,17,13056,289,41616,54672
train,2579,94,72192,8836,1272384,1344576
train,2580,213,163584,45369,6533136,6696720
train,2581,223,171264,49729,7160976,7332240
train,2582,106,81408,11236,1617984,1699392
train,2583,156,119808,24336,3504384,3624192
train,2584,56,43008,3136,451584,494592
train,2585,79,60672,6241,898704,959376
train,2586,55,42240,3025,435600,477840
train,2587,16,12288,256,36864,49152
train,2588,97,74496,9409,1354896,1429392
train,2589,28,21504,784,112896,134400
train,2590,35,26880,1225,176400,203280
train,2591,88,67584,7744,1115136,1182720
train,2592,53,40704,2809,404496,445200
train,2593,27,20736,729,104976,125712
train,2594,61,46848,3721,535824,582672
train,2595,110,84480,12100,1742400,1826880
train,2596,78,59904,6084,876096,936000
train,2597,107,82176,11449,1648656,1730832
train,2598,47,36096,2209,318096,354192
train,2599,57,43776,3249,467856,511632
train,2600,124,95232,15376,2214144,2309376
train,2601,79,60672,6241,898704,959376
train,2602,215,165120,46225,6656400,6821520
train,2603,70,53760,4900,705600,759360
train,2604,88,67584,7744,1115136,1182720
train,2605,123,94464,15129,2178576,2273040
train,2606,31,23808,961,138384,162192
train,2607,89,68352,7921,1140624,1208976
train,2608,46,35328,2116,304704,340032
train,2609,46,35328,2116,304704,340032
train,2610,127,97536,16129,2322576,2420112
train,2611,206,158208,42436,6110784,6268992
train,2612,118,90624,13924,2005056,2095680
train,2613,40,30720,1600,230400,261120
train,2614,107,82176,11449,1648656,1730832
train,2615,43,33024,1849,266256,299280
train,2616,96,73728,9216,1327104,1400832
train,2617,20,15360,400,57600,72960
train,2618,165,126720,27225,3920400,4047120
train,2619,28,21504,784,112896,134400
train,2620,417,320256,173889,25040016,25360272
train,2621,116,89088,13456,1937664,2026752
train,2622,78,59904,6084,876096,936000
train,2623,60,46080,3600,518400,564480
train,2624,92,70656,8464,1218816,1289472
train,2625,159,122112,25281,3640464,3762576
train,2626,68,52224,4624,665856,718080
train,2627,456,350208,207936,29942784,30292992
train,2628,179,137472,32041,4613904,4751376
train,2629,54,41472,2916,419904,461376
train,2630,179,137472,32041,4613904,4751376
train,2631,36,27648,1296,186624,214272
train,2632,42,32256,1764,254016,286272
train,2633,112,86016,12544,1806336,1892352
train,2634,62,47616,3844,553536,601152
train,2635,119,91392,14161,2039184,2130576
train,2636,192,147456,36864,5308416,5455872
train,2637,99,76032,9801,1411344,1487376
train,2638,284,218112,80656,11614464,11832576
train,2639,121,92928,14641,2108304,2201232
train,2640,28,21504,784,112896,134400
train,2641,29,22272,841,121104,143376
train,2642,104,79872,10816,1557504,1637376
train,2643,167,128256,27889,4016016,4144272
train,2644,55,42240,3025,435600,477840
train,2645,424,325632,179776,25887744,26213376
train,2646,131,100608,17161,2471184,2571792
train,2647,59,45312,3481,501264,546576
train,2648,32,24576,1024,147456,172032
train,2649,33,25344,1089,156816,182160
train,2650,45,34560,2025,291600,326160
train,2651,90,69120,8100,1166400,1235520
train,2652,57,43776,3249,467856,511632
train,2653,74,56832,5476,788544,845376
train,2654,29,22272,841,121104,143376
train,2655,223,171264,49729,7160976,7332240
train,2656,356,273408,126736,18249984,18523392
train,2657,54,41472,2916,419904,461376
train,2658,48,36864,2304,331776,368640
train,2659,17,13056,289,41616,54672
train,2660,313,240384,97969,14107536,14347920
train,2661,199,152832,39601,5702544,5855376
train,2662,100,76800,10000,1440000,1516800
train,2663,87,66816,7569,1089936,1156752
train,2664,112,86016,12544,1806336,1892352
train,2665,82,62976,6724,968256,1031232
train,2666,17,13056,289,41616,54672
train,2667,107,82176,11449,1648656,1730832
train,2668,43,33024,1849,266256,299280
train,2669,15,11520,225,32400,43920
train,2670,265,203520,70225,10112400,10315920
train,2671,507,389376,257049,37015056,37404432
train,2672,149,114432,22201,3196944,3311376
train,2673,54,41472,2916,419904,461376
train,2674,30,23040,900,129600,152640
train,2675,235,180480,55225,7952400,8132880
train,2676,251,192768,63001,9072144,9264912
train,2677,43,33024,1849,266256,299280
train,2678,126,96768,15876,2286144,2382912
train,2679,25,19200,625,90000,109200
train,2680,160,122880,25600,3686400,3809280
train,2681,55,42240,3025,435600,477840
train,2682,153,117504,23409,3370896,3488400
train,2683,72,55296,5184,746496,801792
train,2684,89,68352,7921,1140624,1208976
train,2685,31,23808,961,138384,162192
train,2686,78,59904,6084,876096,936000
train,2687,82,62976,6724,968256,1031232
train,2688,52,39936,2704,389376,429312
train,2689,120,92160,14400,2073600,2165760
train,2690,233,178944,54289,7817616,7996560
train,2691,129,99072,16641,2396304,2495376
train,2692,66,50688,4356,627264,677952
train,2693,64,49152,4096,589824,638976
train,2694,114,87552,12996,1871424,1958976
train,2695,53,40704,2809,404496,445200
train,2696,399,306432,159201,22924944,23231376
train,2697,98,75264,9604,1382976,1458240
train,2698,57,43776,3249,467856,511632
train,2699,31,23808,961,138384,162192
train,2700,79,60672,6241,898704,959376
train,2701,53,40704,2809,404496,445200
train,2702,512,393216,262144,37748736,38141952
train,2703,15,11520,225,32400,43920
train,2704,335,257280,112225,16160400,16417680
train,2705,84,64512,7056,1016064,1080576
train,2706,27,20736,729,104976,125712
train,2707,27,20736,729,104976,125712
train,2708,60,46080,3600,518400,564480
train,2709,31,23808,961,138384,162192
train,2710,135,103680,18225,2624400,2728080
train,2711,27,20736,729,104976,125712
train,2712,140,107520,19600,2822400,2929920
train,2713,16,12288,256,36864,49152
train,2714,138,105984,19044,2742336,2848320
train,2715,13,9984,169,24336,34320
train,2716,319,244992,101761,14653584,14898576
train,2717,54,41472,2916,419904,461376
train,2718,273,209664,74529,10732176,10941840
train,2719,125,96000,15625,2250000,2346000
train,2720,93,71424,8649,1245456,1316880
train,2721,25,19200,625,90000,109200
train,2722,99,76032,9801,1411344,1487376
train,2723,232,178176,53824,7750656,7928832
train,2724,46,35328,2116,304704,340032
train,2725,292,224256,85264,12278016,12502272
train,2726,377,289536,142129,20466576,20756112
train,2727,105,80640,11025,1587600,1668240
train,2728,61,46848,3721,535824,582672
train,2729,89,68352,7921,1140624,1208976
train,2730,46,35328,2116,304704,340032
train,2731,54,41472,2916,419904,461376
train,2732,61,46848,3721,535824,582672
train,2733,106,81408,11236,1617984,1699392
train,2734,211,162048,44521,6411024,6573072
train,2735,123,94464,15129,2178576,2273040
train,2736,66,50688,4356,627264,677952
train,2737,55,42240,3025,435600,477840
train,2738,63,48384,3969,571536,619920
train,2739,106,81408,11236,1617984,1699392
train,2740,59,45312,3481,501264,546576
train,2741,38,29184,1444,207936,237120
train,2742,41,31488,1681,242064,273552
train,2743,34,26112,1156,166464,192576
train,2744,116,89088,13456,1937664,2026752
train,2745,74,56832,5476,788544,845376
train,2746,17,13056,289,41616,54672
train,2747,87,66816,7569,1089936,1156752
train,2748,106,81408,11236,1617984,1699392
train,2749,114,87552,12996,1871424,1958976
train,2750,55,42240,3025,435600,477840
train,2751,512,393216,262144,37748736,38141952
train,2752,25,19200,625,90000,109200
train,2753,13,9984,169,24336,34320
train,2754,376,288768,141376,20358144,20646912
train,2755,210,161280,44100,6350400,6511680
train,2756,136,104448,18496,2663424,2767872
train,2757,278,213504,77284,11128896,11342400
train,2758,512,393216,262144,37748736,38141952
train,2759,26,19968,676,97344,117312
train,2760,68,52224,4624,665856,718080
train,2761,14,10752,196,28224,38976
train,2762,72,55296,5184,746496,801792
train,2763,99,76032,9801,1411344,1487376
train,2764,163,125184,26569,3825936,3951120
train,2765,30,23040,900,129600,152640
train,2766,60,46080,3600,518400,564480
train,2767,69,52992,4761,685584,738576
train,2768,70,53760,4900,705600,759360
train,2769,86,66048,7396,1065024,1131072
train,2770,285,218880,81225,11696400,11915280
train,2771,314,241152,98596,14197824,14438976
train,2772,17,13056,289,41616,54672
train,2773,137,105216,18769,2702736,2807952
train,2774,211,162048,44521,6411024,6573072
train,2775,77,59136,5929,853776,912912
train,2776,30,23040,900,129600,152640
train,2777,82,62976,6724,968256,1031232
train,2778,25,19200,625,90000,109200
train,2779,28,21504,784,112896,134400
train,2780,67,51456,4489,646416,697872
train,2781,81,62208,6561,944784,1006992
train,2782,190,145920,36100,5198400,5344320
train,2783,114,87552,12996,1871424,1958976
train,2784,419,321792,175561,25280784,25602576
train,2785,256,196608,65536,9437184,9633792
train,2786,432,331776,186624,26873856,27205632
train,2787,86,66048,7396,1065024,1131072
train,2788,95,72960,9025,1299600,1372560
train,2789,155,119040,24025,3459600,3578640
train,2790,100,76800,10000,1440000,1516800
train,2791,125,96000,15625,2250000,2346000
train,2792,64,49152,4096,589824,638976
train,2793,325,249600,105625,15210000,15459600
train,2794,87,66816,7569,1089936,1156752
train,2795,57,43776,3249,467856,511632
train,2796,68,52224,4624,665856,718080
train,2797,84,64512,7056,1016064,1080576
train,2798,109,83712,11881,1710864,1794576
train,2799,512,393216,262144,37748736,38141952
train,2800,148,113664,21904,3154176,3267840
train,2801,28,21504,784,112896,134400
train,2802,214,164352,45796,6594624,6758976
train,2803,57,43776,3249,467856,511632
train,2804,221,169728,48841,7033104,7202832
train,2805,83,63744,6889,992016,1055760
train,2806,123,94464,15129,2178576,2273040
train,2807,209,160512,43681,6290064,6450576
train,2808,45,34560,2025,291600,326160
train,2809,45,34560,2025,291600,326160
train,2810,113,86784,12769,1838736,1925520
train,2811,116,89088,13456,1937664,2026752
train,2812,110,84480,12100,1742400,1826880
train,2813,138,105984,19044,2742336,2848320
train,2814,225,172800,50625,7290000,7462800
train,2815,308,236544,94864,13660416,13896960
train,2816,88,67584,7744,1115136,1182720
train,2817,50,38400,2500,360000,398400
train,2818,109,83712,11881,1710864,1794576
train,2819,99,76032,9801,1411344,1487376
train,2820,19,14592,361,51984,66576
train,2821,228,175104,51984,7485696,7660800
train,2822,225,172800,50625,7290000,7462800
train,2823,99,76032,9801,1411344,1487376
train,2824,14,10752,196,28224,38976
train,2825,68,52224,4624,665856,718080
train,2826,16,12288,256,36864,49152
train,2827,81,62208,6561,944784,1006992
train,2828,30,23040,900,129600,152640
train,2829,122,93696,14884,2143296,2236992
train,2830,338,259584,114244,16451136,16710720
train,2831,278,213504,77284,11128896,11342400
train,2832,55,42240,3025,435600,477840
train,2833,85,65280,7225,1040400,1105680
train,2834,381,292608,145161,20903184,21195792
train,2835,34,26112,1156,166464,192576
train,2836,214,164352,45796,6594624,6758976
train,2837,104,79872,10816,1557504,1637376
train,2838,99,76032,9801,1411344,1487376
train,2839,183,140544,33489,4822416,4962960
train,2840,74,56832,5476,788544,845376
train,2841,29,22272,841,121104,143376
train,2842,16,12288,256,36864,49152
train,2843,56,43008,3136,451584,494592
train,2844,40,30720,1600,230400,261120
train,2845,309,237312,95481,13749264,13986576
train,2846,29,22272,841,121104,143376
train,2847,21,16128,441,63504,79632
train,2848,389,298752,151321,21790224,22088976
train,2849,53,40704,2809,404496,445200
train,2850,160,122880,25600,3686400,3809280
train,2851,38,29184,1444,207936,237120
train,2852,110,84480,12100,1742400,1826880
train,2853,113,86784,12769,1838736,1925520
train,2854,48,36864,2304,331776,368640
train,2855,31,23808,961,138384,162192
train,2856,34,26112,1156,166464,192576
train,2857,107,82176,11449,1648656,1730832
train,2858,29,22272,841,121104,143376
train,2859,37,28416,1369,197136,225552
train,2860,235,180480,55225,7952400,8132880
train,2861,173,132864,29929,4309776,4442640
train,2862,42,32256,1764,254016,286272
train,2863,512,393216,262144,37748736,38141952
train,2864,42,32256,1764,254016,286272
train,2865,79,60672,6241,898704,959376
train,2866,47,36096,2209,318096,354192
train,2867,94,72192,8836,1272384,1344576
train,2868,77,59136,5929,853776,912912
train,2869,15,11520,225,32400,43920
train,2870,18,13824,324,46656,60480
train,2871,346,265728,119716,17239104,17504832
train,2872,78,59904,6084,876096,936000
train,2873,114,87552,12996,1871424,1958976
train,2874,50,38400,2500,360000,398400
train,2875,99,76032,9801,1411344,1487376
train,2876,105,80640,11025,1587600,1668240
train,2877,80,61440,6400,921600,983040
train,2878,101,77568,10201,1468944,1546512
train,2879,324,248832,104976,15116544,15365376
train,2880,100,76800,10000,1440000,1516800
train,2881,84,64512,7056,1016064,1080576
train,2882,27,20736,729,104976,125712
train,2883,139,106752,19321,2782224,2888976
train,2884,111,85248,12321,1774224,1859472
train,2885,34,26112,1156,166464,192576
train,2886,87,66816,7569,1089936,1156752
train,2887,48,36864,2304,331776,368640
train,2888,83,63744,6889,992016,1055760
train,2889,279,214272,77841,11209104,11423376
train,2890,29,22272,841,121104,143376
train,2891,112,86016,12544,1806336,1892352
train,2892,33,25344,1089,156816,182160
train,2893,125,96000,15625,2250000,2346000
train,2894,78,59904,6084,876096,936000
train,2895,99,76032,9801,1411344,1487376
train,2896,14,10752,196,28224,38976
train,2897,46,35328,2116,304704,340032
train,2898,78,59904,6084,876096,936000
train,2899,17,13056,289,41616,54672
train,2900,88,67584,7744,1115136,1182720
train,2901,83,63744,6889,992016,1055760
train,2902,94,72192,8836,1272384,1344576
train,2903,123,94464,15129,2178576,2273040
train,2904,19,14592,361,51984,66576
train,2905,88,67584,7744,1115136,1182720
train,2906,181,139008,32761,4717584,4856592
train,2907,59,45312,3481,501264,546576
train,2908,71,54528,5041,725904,780432
train,2909,80,61440,6400,921600,983040
train,2910,240,184320,57600,8294400,8478720
train,2911,170,130560,28900,4161600,4292160
train,2912,121,92928,14641,2108304,2201232
train,2913,145,111360,21025,3027600,3138960
train,2914,104,79872,10816,1557504,1637376
train,2915,125,96000,15625,2250000,2346000
train,2916,54,41472,2916,419904,461376
train,2917,125,96000,15625,2250000,2346000
train,2918,56,43008,3136,451584,494592
train,2919,50,38400,2500,360000,398400
train,2920,50,38400,2500,360000,398400
train,2921,30,23040,900,129600,152640
train,2922,49,37632,2401,345744,383376
train,2923,94,72192,8836,1272384,1344576
train,2924,49,37632,2401,345744,383376
train,2925,512,393216,262144,37748736,38141952
train,2926,67,51456,4489,646416,697872
train,2927,74,56832,5476,788544,845376
train,2928,52,39936,2704,389376,429312
train,2929,200,153600,40000,5760000,5913600
train,2930,11,8448,121,17424,25872
train,2931,421,323328,177241,25522704,25846032
train,2932,113,86784,12769,1838736,1925520
train,2933,15,11520,225,32400,43920
train,2934,512,393216,262144,37748736,38141952
train,2935,29,22272,841,121104,143376
train,2936,32,24576,1024,147456,172032
train,2937,42,32256,1764,254016,286272
train,2938,25,19200,625,90000,109200
train,2939,117,89856,13689,1971216,2061072
train,2940,82,62976,6724,968256,1031232
train,2941,16,12288,256,36864,49152
train,2942,25,19200,625,90000,109200
train,2943,21,16128,441,63504,79632
train,2944,105,80640,11025,1587600,1668240
train,2945,34,26112,1156,166464,192576
train,2946,115,88320,13225,1904400,1992720
train,2947,70,53760,4900,705600,759360
train,2948,140,107520,19600,2822400,2929920
train,2949,17,13056,289,41616,54672
train,2950,144,110592,20736,2985984,3096576
train,2951,146,112128,21316,3069504,3181632
train,2952,56,43008,3136,451584,494592
train,2953,83,63744,6889,992016,1055760
train,2954,45,34560,2025,291600,326160
train,2955,127,97536,16129,2322576,2420112
train,2956,17,13056,289,41616,54672
train,2957,187,143616,34969,5035536,5179152
train,2958,127,97536,16129,2322576,2420112
train,2959,89,68352,7921,1140624,1208976
train,2960,107,82176,11449,1648656,1730832
train,2961,104,79872,10816,1557504,1637376
train,2962,15,11520,225,32400,43920
train,2963,89,68352,7921,1140624,1208976
train,2964,104,79872,10816,1557504,1637376
train,2965,126,96768,15876,2286144,2382912
train,2966,26,19968,676,97344,117312
train,2967,74,56832,5476,788544,845376
train,2968,18,13824,324,46656,60480
train,2969,44,33792,1936,278784,312576
train,2970,45,34560,2025,291600,326160
train,2971,98,75264,9604,1382976,1458240
train,2972,122,93696,14884,2143296,2236992
train,2973,30,23040,900,129600,152640
train,2974,512,393216,262144,37748736,38141952
train,2975,56,43008,3136,451584,494592
train,2976,29,22272,841,121104,143376
train,2977,79,60672,6241,898704,959376
train,2978,146,112128,21316,3069504,3181632
train,2979,27,20736,729,104976,125712
train,2980,59,45312,3481,501264,546576
train,2981,383,294144,146689,21123216,21417360
train,2982,111,85248,12321,1774224,1859472
train,2983,37,28416,1369,197136,225552
train,2984,124,95232,15376,2214144,2309376
train,2985,33,25344,1089,156816,182160
train,2986,28,21504,784,112896,134400
train,2987,88,67584,7744,1115136,1182720
train,2988,31,23808,961,138384,162192
train,2989,219,168192,47961,6906384,7074576
train,2990,116,89088,13456,1937664,2026752
train,2991,53,40704,2809,404496,445200
train,2992,242,185856,58564,8433216,8619072
train,2993,25,19200,625,90000,109200
train,2994,132,101376,17424,2509056,2610432
train,2995,30,23040,900,129600,152640
train,2996,16,12288,256,36864,49152
train,2997,16,12288,256,36864,49152
train,2998,512,393216,262144,37748736,38141952
train,2999,307,235776,94249,13571856,13807632
train,3000,80,61440,6400,921600,983040
train,3001,382,293376,145924,21013056,21306432
train,3002,217,166656,47089,6780816,6947472
train,3003,27,20736,729,104976,125712
train,3004,120,92160,14400,2073600,2165760
train,3005,17,13056,289,41616,54672
train,3006,30,23040,900,129600,152640
train,3007,121,92928,14641,2108304,2201232
train,3008,113,86784,12769,1838736,1925520
train,3009,16,12288,256,36864,49152
train,3010,251,192768,63001,9072144,9264912
train,3011,102,78336,10404,1498176,1576512
train,3012,51,39168,2601,374544,413712
train,3013,134,102912,17956,2585664,2688576
train,3014,160,122880,25600,3686400,3809280
train,3015,49,37632,2401,345744,383376
train,3016,200,153600,40000,5760000,5913600
train,3017,16,12288,256,36864,49152
train,3018,139,106752,19321,2782224,2888976
train,3019,66,50688,4356,627264,677952
train,3020,80,61440,6400,921600,983040
train,3021,22,16896,484,69696,86592
train,3022,512,393216,262144,37748736,38141952
train,3023,86,66048,7396,1065024,1131072
train,3024,117,89856,13689,1971216,2061072
train,3025,104,79872,10816,1557504,1637376
train,3026,31,23808,961,138384,162192
train,3027,46,35328,2116,304704,340032
train,3028,45,34560,2025,291600,326160
train,3029,48,36864,2304,331776,368640
train,3030,28,21504,784,112896,134400
train,3031,44,33792,1936,278784,312576
train,3032,42,32256,1764,254016,286272
train,3033,175,134400,30625,4410000,4544400
train,3034,161,123648,25921,3732624,3856272
train,3035,97,74496,9409,1354896,1429392
train,3036,142,109056,20164,2903616,3012672
train,3037,28,21504,784,112896,134400
train,3038,33,25344,1089,156816,182160
train,3039,107,82176,11449,1648656,1730832
train,3040,93,71424,8649,1245456,1316880
train,3041,27,20736,729,104976,125712
train,3042,337,258816,113569,16353936,16612752
train,3043,83,63744,6889,992016,1055760
train,3044,75,57600,5625,810000,867600
train,3045,70,53760,4900,705600,759360
train,3046,12,9216,144,20736,29952
train,3047,44,33792,1936,278784,312576
train,3048,14,10752,196,28224,38976
train,3049,30,23040,900,129600,152640
train,3050,32,24576,1024,147456,172032
train,3051,40,30720,1600,230400,261120
train,3052,116,89088,13456,1937664,2026752
train,3053,42,32256,1764,254016,286272
train,3054,26,19968,676,97344,117312
train,3055,50,38400,2500,360000,398400
train,3056,64,49152,4096,589824,638976
train,3057,41,31488,1681,242064,273552
train,3058,71,54528,5041,725904,780432
train,3059,41,31488,1681,242064,273552
train,3060,102,78336,10404,1498176,1576512
train,3061,142,109056,20164,2903616,3012672
train,3062,103,79104,10609,1527696,1606800
train,3063,38,29184,1444,207936,237120
train,3064,62,47616,3844,553536,601152
train,3065,45,34560,2025,291600,326160
train,3066,149,114432,22201,3196944,3311376
train,3067,45,34560,2025,291600,326160
train,3068,114,87552,12996,1871424,1958976
train,3069,65,49920,4225,608400,658320
train,3070,237,182016,56169,8088336,8270352
train,3071,112,86016,12544,1806336,1892352
train,3072,46,35328,2116,304704,340032
train,3073,328,251904,107584,15492096,15744000
train,3074,164,125952,26896,3873024,3998976
train,3075,177,135936,31329,4511376,4647312
train,3076,76,58368,5776,831744,890112
train,3077,77,59136,5929,853776,912912
train,3078,72,55296,5184,746496,801792
train,3079,52,39936,2704,389376,429312
train,3080,75,57600,5625,810000,867600
train,3081,95,72960,9025,1299600,1372560
train,3082,13,9984,169,24336,34320
train,3083,136,104448,18496,2663424,2767872
train,3084,123,94464,15129,2178576,2273040
train,3085,263,201984,69169,9960336,10162320
train,3086,68,52224,4624,665856,718080
train,3087,234,179712,54756,7884864,8064576
train,3088,34,26112,1156,166464,192576
train,3089,62,47616,3844,553536,601152
train,3090,18,13824,324,46656,60480
train,3091,75,57600,5625,810000,867600
train,3092,105,80640,11025,1587600,1668240
train,3093,158,121344,24964,3594816,3716160
train,3094,231,177408,53361,7683984,7861392
train,3095,24,18432,576,82944,101376
train,3096,95,72960,9025,1299600,1372560
train,3097,115,88320,13225,1904400,1992720
train,3098,31,23808,961,138384,162192
train,3099,52,39936,2704,389376,429312
train,3100,139,106752,19321,2782224,2888976
train,3101,118,90624,13924,2005056,2095680
train,3102,14,10752,196,28224,38976
train,3103,106,81408,11236,1617984,1699392
train,3104,142,109056,20164,2903616,3012672
train,3105,107,82176,11449,1648656,1730832
train,3106,31,23808,961,138384,162192
train,3107,512,393216,262144,37748736,38141952
train,3108,84,64512,7056,1016064,1080576
train,3109,27,20736,729,104976,125712
train,3110,113,86784,12769,1838736,1925520
train,3111,126,96768,15876,2286144,2382912
train,3112,224,172032,50176,7225344,7397376
train,3113,121,92928,14641,2108304,2201232
train,3114,109,83712,11881,1710864,1794576
train,3115,64,49152,4096,589824,638976
train,3116,427,327936,182329,26255376,26583312
train,3117,59,45312,3481,501264,546576
train,3118,27,20736,729,104976,125712
train,3119,179,137472,32041,4613904,4751376
train,3120,54,41472,2916,419904,461376
train,3121,217,166656,47089,6780816,6947472
train,3122,70,53760,4900,705600,759360
train,3123,86,66048,7396,1065024,1131072
train,3124,87,66816,7569,1089936,1156752
train,3125,120,92160,14400,2073600,2165760
train,3126,26,19968,676,97344,117312
train,3127,109,83712,11881,1710864,1794576
train,3128,47,36096,2209,318096,354192
train,3129,104,79872,10816,1557504,1637376
train,3130,99,76032,9801,1411344,1487376
train,3131,19,14592,361,51984,66576
train,3132,135,103680,18225,2624400,2728080
train,3133,29,22272,841,121104,143376
train,3134,52,39936,2704,389376,429312
train,3135,188,144384,35344,5089536,5233920
train,3136,95,72960,9025,1299600,1372560
train,3137,26,19968,676,97344,117312
train,3138,112,86016,12544,1806336,1892352
train,3139,66,50688,4356,627264,677952
train,3140,68,52224,4624,665856,718080
train,3141,53,40704,2809,404496,445200
train,3142,48,36864,2304,331776,368640
train,3143,79,60672,6241,898704,959376
train,3144,123,94464,15129,2178576,2273040
train,3145,99,76032,9801,1411344,1487376
train,3146,132,101376,17424,2509056,2610432
train,3147,29,22272,841,121104,143376
train,3148,61,46848,3721,535824,582672
train,3149,69,52992,4761,685584,738576
train,3150,55,42240,3025,435600,477840
train,3151,15,11520,225,32400,43920
train,3152,11,8448,121,17424,25872
train,3153,58,44544,3364,484416,528960
train,3154,54,41472,2916,419904,461376
train,3155,104,79872,10816,1557504,1637376
train,3156,31,23808,961,138384,162192
train,3157,58,44544,3364,484416,528960
train,3158,31,23808,961,138384,162192
train,3159,287,220416,82369,11861136,12081552
train,3160,14,10752,196,28224,38976
train,3161,81,62208,6561,944784,1006992
train,3162,25,19200,625,90000,109200
train,3163,44,33792,1936,278784,312576
train,3164,61,46848,3721,535824,582672
train,3165,205,157440,42025,6051600,6209040
train,3166,30,23040,900,129600,152640
train,3167,57,43776,3249,467856,511632
train,3168,287,220416,82369,11861136,12081552
train,3169,130,99840,16900,2433600,2533440
train,3170,14,10752,196,28224,38976
train,3171,59,45312,3481,501264,546576
train,3172,206,158208,42436,6110784,6268992
train,3173,16,12288,256,36864,49152
train,3174,42,32256,1764,254016,286272
train,3175,117,89856,13689,1971216,2061072
train,3176,307,235776,94249,13571856,13807632
train,3177,71,54528,5041,725904,780432
train,3178,74,56832,5476,788544,845376
train,3179,29,22272,841,121104,143376
train,3180,45,34560,2025,291600,326160
train,3181,165,126720,27225,3920400,4047120
train,3182,65,49920,4225,608400,658320
train,3183,430,330240,184900,26625600,26955840
train,3184,13,9984,169,24336,34320
train,3185,240,184320,57600,8294400,8478720
train,3186,75,57600,5625,810000,867600
train,3187,27,20736,729,104976,125712
train,3188,15,11520,225,32400,43920
train,3189,190,145920,36100,5198400,5344320
train,3190,16,12288,256,36864,49152
train,3191,15,11520,225,32400,43920
train,3192,98,75264,9604,1382976,1458240
train,3193,233,178944,54289,7817616,7996560
train,3194,74,56832,5476,788544,845376
train,3195,72,55296,5184,746496,801792
train,3196,512,393216,262144,37748736,38141952
train,3197,60,46080,3600,518400,564480
train,3198,125,96000,15625,2250000,2346000
train,3199,96,73728,9216,1327104,1400832
train,3200,28,21504,784,112896,134400
train,3201,66,50688,4356,627264,677952
train,3202,206,158208,42436,6110784,6268992
train,3203,15,11520,225,32400,43920
train,3204,15,11520,225,32400,43920
train,3205,15,11520,225,32400,43920
train,3206,10,7680,100,14400,22080
train,3207,13,9984,169,24336,34320
train,3208,74,56832,5476,788544,845376
train,3209,269,206592,72361,10419984,10626576
train,3210,212,162816,44944,6471936,6634752
train,3211,63,48384,3969,571536,619920
train,3212,55,42240,3025,435600,477840
train,3213,34,26112,1156,166464,192576
train,3214,101,77568,10201,1468944,1546512
train,3215,103,79104,10609,1527696,1606800
train,3216,102,78336,10404,1498176,1576512
train,3217,109,83712,11881,1710864,1794576
train,3218,54,41472,2916,419904,461376
train,3219,160,122880,25600,3686400,3809280
train,3220,66,50688,4356,627264,677952
train,3221,13,9984,169,24336,34320
train,3222,15,11520,225,32400,43920
train,3223,335,257280,112225,16160400,16417680
train,3224,48,36864,2304,331776,368640
train,3225,449,344832,201601,29030544,29375376
train,3226,172,132096,29584,4260096,4392192
train,3227,349,268032,121801,17539344,17807376
train,3228,34,26112,1156,166464,192576
train,3229,27,20736,729,104976,125712
train,3230,360,276480,129600,18662400,18938880
train,3231,114,87552,12996,1871424,1958976
train,3232,512,393216,262144,37748736,38141952
train,3233,135,103680,18225,2624400,2728080
train,3234,28,21504,784,112896,134400
train,3235,97,74496,9409,1354896,1429392
train,3236,121,92928,14641,2108304,2201232
train,3237,34,26112,1156,166464,192576
train,3238,297,228096,88209,12702096,12930192
train,3239,161,123648,25921,3732624,3856272
train,3240,272,208896,73984,10653696,10862592
train,3241,74,56832,5476,788544,845376
train,3242,70,53760,4900,705600,759360
train,3243,104,79872,10816,1557504,1637376
train,3244,312,239616,97344,14017536,14257152
train,3245,276,211968,76176,10969344,11181312
train,3246,27,20736,729,104976,125712
train,3247,79,60672,6241,898704,959376
train,3248,106,81408,11236,1617984,1699392
train,3249,36,27648,1296,186624,214272
train,3250,215,165120,46225,6656400,6821520
train,3251,79,60672,6241,898704,959376
train,3252,25,19200,625,90000,109200
train,3253,113,86784,12769,1838736,1925520
train,3254,53,40704,2809,404496,445200
train,3255,76,58368,5776,831744,890112
train,3256,48,36864,2304,331776,368640
train,3257,26,19968,676,97344,117312
train,3258,94,72192,8836,1272384,1344576
train,3259,12,9216,144,20736,29952
train,3260,112,86016,12544,1806336,1892352
train,3261,247,189696,61009,8785296,8974992
train,3262,126,96768,15876,2286144,2382912
train,3263,107,82176,11449,1648656,1730832
train,3264,44,33792,1936,278784,312576
train,3265,56,43008,3136,451584,494592
train,3266,253,194304,64009,9217296,9411600
train,3267,16,12288,256,36864,49152
train,3268,82,62976,6724,968256,1031232
train,3269,156,119808,24336,3504384,3624192
train,3270,91,69888,8281,1192464,1262352
train,3271,320,245760,102400,14745600,14991360
train,3272,67,51456,4489,646416,697872
train,3273,51,39168,2601,374544,413712
train,3274,19,14592,361,51984,66576
train,3275,294,225792,86436,12446784,12672576
train,3276,24,18432,576,82944,101376
train,3277,44,33792,1936,278784,312576
train,3278,40,30720,1600,230400,261120
train,3279,146,112128,21316,3069504,3181632
train,3280,108,82944,11664,1679616,1762560
train,3281,121,92928,14641,2108304,2201232
train,3282,27,20736,729,104976,125712
train,3283,81,62208,6561,944784,1006992
train,3284,229,175872,52441,7551504,7727376
train,3285,84,64512,7056,1016064,1080576
train,3286,149,114432,22201,3196944,3311376
train,3287,77,59136,5929,853776,912912
train,3288,316,242688,99856,14379264,14621952
train,3289,97,74496,9409,1354896,1429392
train,3290,12,9216,144,20736,29952
train,3291,132,101376,17424,2509056,2610432
train,3292,170,130560,28900,4161600,4292160
train,3293,78,59904,6084,876096,936000
train,3294,13,9984,169,24336,34320
train,3295,98,75264,9604,1382976,1458240
train,3296,72,55296,5184,746496,801792
train,3297,196,150528,38416,5531904,5682432
train,3298,51,39168,2601,374544,413712
train,3299,52,39936,2704,389376,429312
train,3300,15,11520,225,32400,43920
train,3301,81,62208,6561,944784,1006992
train,3302,65,49920,4225,608400,658320
train,3303,231,177408,53361,7683984,7861392
train,3304,512,393216,262144,37748736,38141952
train,3305,18,13824,324,46656,60480
train,3306,90,69120,8100,1166400,1235520
train,3307,118,90624,13924,2005056,2095680
train,3308,21,16128,441,63504,79632
train,3309,99,76032,9801,1411344,1487376
train,3310,62,47616,3844,553536,601152
train,3311,370,284160,136900,19713600,19997760
train,3312,185,142080,34225,4928400,5070480
train,3313,104,79872,10816,1557504,1637376
train,3314,19,14592,361,51984,66576
train,3315,280,215040,78400,11289600,11504640
train,3316,47,36096,2209,318096,354192
train,3317,196,150528,38416,5531904,5682432
train,3318,116,89088,13456,1937664,2026752
train,3319,282,216576,79524,11451456,11668032
train,3320,99,76032,9801,1411344,1487376
train,3321,97,74496,9409,1354896,1429392
train,3322,12,9216,144,20736,29952
train,3323,81,62208,6561,944784,1006992
train,3324,64,49152,4096,589824,638976
train,3325,154,118272,23716,3415104,3533376
train,3326,46,35328,2116,304704,340032
train,3327,15,11520,225,32400,43920
train,3328,99,76032,9801,1411344,1487376
train,3329,203,155904,41209,5934096,6090000
train,3330,92,70656,8464,1218816,1289472
train,3331,14,10752,196,28224,38976
train,3332,13,9984,169,24336,34320
train,3333,177,135936,31329,4511376,4647312
train,3334,273,209664,74529,10732176,10941840
train,3335,271,208128,73441,10575504,10783632
train,3336,62,47616,3844,553536,601152
train,3337,373,286464,139129,20034576,20321040
train,3338,99,76032,9801,1411344,1487376
train,3339,104,79872,10816,1557504,1637376
train,3340,104,79872,10816,1557504,1637376
train,3341,27,20736,729,104976,125712
train,3342,13,9984,169,24336,34320
train,3343,108,82944,11664,1679616,1762560
train,3344,20,15360,400,57600,72960
train,3345,74,56832,5476,788544,845376
train,3346,75,57600,5625,810000,867600
train,3347,122,93696,14884,2143296,2236992
train,3348,206,158208,42436,6110784,6268992
train,3349,33,25344,1089,156816,182160
train,3350,14,10752,196,28224,38976
train,3351,245,188160,60025,8643600,8831760
train,3352,92,70656,8464,1218816,1289472
train,3353,32,24576,1024,147456,172032
train,3354,62,47616,3844,553536,601152
train,3355,62,47616,3844,553536,601152
train,3356,54,41472,2916,419904,461376
train,3357,236,181248,55696,8020224,8201472
train,3358,67,51456,4489,646416,697872
train,3359,238,182784,56644,8156736,8339520
train,3360,318,244224,101124,14561856,14806080
train,3361,296,227328,87616,12616704,12844032
train,3362,30,23040,900,129600,152640
train,3363,512,393216,262144,37748736,38141952
train,3364,67,51456,4489,646416,697872
train,3365,100,76800,10000,1440000,1516800
train,3366,134,102912,17956,2585664,2688576
train,3367,22,16896,484,69696,86592
train,3368,151,115968,22801,3283344,3399312
train,3369,53,40704,2809,404496,445200
train,3370,118,90624,13924,2005056,2095680
train,3371,83,63744,6889,992016,1055760
train,3372,61,46848,3721,535824,582672
train,3373,187,143616,34969,5035536,5179152
train,3374,81,62208,6561,944784,1006992
train,3375,53,40704,2809,404496,445200
train,3376,29,22272,841,121104,143376
train,3377,64,49152,4096,589824,638976
train,3378,118,90624,13924,2005056,2095680
train,3379,512,393216,262144,37748736,38141952
train,3380,50,38400,2500,360000,398400
train,3381,28,21504,784,112896,134400
train,3382,111,85248,12321,1774224,1859472
train,3383,124,95232,15376,2214144,2309376
train,3384,82,62976,6724,968256,1031232
train,3385,17,13056,289,41616,54672
train,3386,66,50688,4356,627264,677952
train,3387,109,83712,11881,1710864,1794576
train,3388,24,18432,576,82944,101376
train,3389,102,78336,10404,1498176,1576512
train,3390,51,39168,2601,374544,413712
train,3391,40,30720,1600,230400,261120
train,3392,25,19200,625,90000,109200
train,3393,102,78336,10404,1498176,1576512
train,3394,67,51456,4489,646416,697872
train,3395,315,241920,99225,14288400,14530320
train,3396,75,57600,5625,810000,867600
train,3397,32,24576,1024,147456,172032
train,3398,199,152832,39601,5702544,5855376
train,3399,17,13056,289,41616,54672
train,3400,381,292608,145161,20903184,21195792
train,3401,142,109056,20164,2903616,3012672
train,3402,269,206592,72361,10419984,10626576
train,3403,65,49920,4225,608400,658320
train,3404,68,52224,4624,665856,718080
train,3405,84,64512,7056,1016064,1080576
train,3406,384,294912,147456,21233664,21528576
train,3407,81,62208,6561,944784,1006992
train,3408,38,29184,1444,207936,237120
train,3409,97,74496,9409,1354896,1429392
train,3410,97,74496,9409,1354896,1429392
train,3411,122,93696,14884,2143296,2236992
train,3412,141,108288,19881,2862864,2971152
train,3413,64,49152,4096,589824,638976
train,3414,512,393216,262144,37748736,38141952
train,3415,116,89088,13456,1937664,2026752
train,3416,32,24576,1024,147456,172032
train,3417,120,92160,14400,2073600,2165760
train,3418,226,173568,51076,7354944,7528512
train,3419,72,55296,5184,746496,801792
train,3420,43,33024,1849,266256,299280
train,3421,197,151296,38809,5588496,5739792
train,3422,53,40704,2809,404496,445200
train,3423,63,48384,3969,571536,619920
train,3424,21,16128,441,63504,79632
train,3425,67,51456,4489,646416,697872
train,3426,111,85248,12321,1774224,1859472
train,3427,168,129024,28224,4064256,4193280
train,3428,46,35328,2116,304704,340032
train,3429,28,21504,784,112896,134400
train,3430,96,73728,9216,1327104,1400832
train,3431,143,109824,20449,2944656,3054480
train,3432,295,226560,87025,12531600,12758160
train,3433,334,256512,111556,16064064,16320576
train,3434,45,34560,2025,291600,326160
train,3435,232,178176,53824,7750656,7928832
train,3436,17,13056,289,41616,54672
train,3437,266,204288,70756,10188864,10393152
train,3438,465,357120,216225,31136400,31493520
train,3439,140,107520,19600,2822400,2929920
train,3440,89,68352,7921,1140624,1208976
train,3441,118,90624,13924,2005056,2095680
train,3442,101,77568,10201,1468944,1546512
train,3443,26,19968,676,97344,117312
train,3444,198,152064,39204,5645376,5797440
train,3445,106,81408,11236,1617984,1699392
train,3446,26,19968,676,97344,117312
train,3447,82,62976,6724,968256,1031232
train,3448,207,158976,42849,6170256,6329232
train,3449,251,192768,63001,9072144,9264912
train,3450,13,9984,169,24336,34320
train,3451,17,13056,289,41616,54672
train,3452,18,13824,324,46656,60480
train,3453,27,20736,729,104976,125712
train,3454,203,155904,41209,5934096,6090000
train,3455,13,9984,169,24336,34320
train,3456,105,80640,11025,1587600,1668240
train,3457,95,72960,9025,1299600,1372560
train,3458,140,107520,19600,2822400,2929920
train,3459,29,22272,841,121104,143376
train,3460,98,75264,9604,1382976,1458240
train,3461,49,37632,2401,345744,383376
train,3462,43,33024,1849,266256,299280
train,3463,496,380928,246016,35426304,35807232
train,3464,64,49152,4096,589824,638976
train,3465,14,10752,196,28224,38976
train,3466,124,95232,15376,2214144,2309376
train,3467,51,39168,2601,374544,413712
train,3468,108,82944,11664,1679616,1762560
train,3469,100,76800,10000,1440000,1516800
train,3470,21,16128,441,63504,79632
train,3471,16,12288,256,36864,49152
train,3472,115,88320,13225,1904400,1992720
train,3473,512,393216,262144,37748736,38141952
train,3474,31,23808,961,138384,162192
train,3475,41,31488,1681,242064,273552
train,3476,18,13824,324,46656,60480
train,3477,40,30720,1600,230400,261120
train,3478,104,79872,10816,1557504,1637376
train,3479,110,84480,12100,1742400,1826880
train,3480,103,79104,10609,1527696,1606800
train,3481,182,139776,33124,4769856,4909632
train,3482,293,225024,85849,12362256,12587280
train,3483,40,30720,1600,230400,261120
train,3484,116,89088,13456,1937664,2026752
train,3485,90,69120,8100,1166400,1235520
train,3486,160,122880,25600,3686400,3809280
train,3487,239,183552,57121,8225424,8408976
train,3488,113,86784,12769,1838736,1925520
train,3489,41,31488,1681,242064,273552
train,3490,196,150528,38416,5531904,5682432
train,3491,83,63744,6889,992016,1055760
train,3492,84,64512,7056,1016064,1080576
train,3493,38,29184,1444,207936,237120
train,3494,151,115968,22801,3283344,3399312
train,3495,15,11520,225,32400,43920
train,3496,367,281856,134689,19395216,19677072
train,3497,292,224256,85264,12278016,12502272
train,3498,77,59136,5929,853776,912912
train,3499,143,109824,20449,2944656,3054480
train,3500,18,13824,324,46656,60480
train,3501,95,72960,9025,1299600,1372560
train,3502,51,39168,2601,374544,413712
train,3503,298,228864,88804,12787776,13016640
train,3504,83,63744,6889,992016,1055760
train,3505,510,391680,260100,37454400,37846080
train,3506,107,82176,11449,1648656,1730832
train,3507,27,20736,729,104976,125712
train,3508,288,221184,82944,11943936,12165120
train,3509,20,15360,400,57600,72960
train,3510,217,166656,47089,6780816,6947472
train,3511,512,393216,262144,37748736,38141952
train,3512,279,214272,77841,11209104,11423376
train,3513,48,36864,2304,331776,368640
train,3514,19,14592,361,51984,66576
train,3515,176,135168,30976,4460544,4595712
train,3516,100,76800,10000,1440000,1516800
train,3517,195,149760,38025,5475600,5625360
train,3518,396,304128,156816,22581504,22885632
train,3519,42,32256,1764,254016,286272
train,3520,90,69120,8100,1166400,1235520
train,3521,123,94464,15129,2178576,2273040
train,3522,29,22272,841,121104,143376
train,3523,43,33024,1849,266256,299280
train,3524,236,181248,55696,8020224,8201472
train,3525,87,66816,7569,1089936,1156752
train,3526,16,12288,256,36864,49152
train,3527,78,59904,6084,876096,936000
train,3528,62,47616,3844,553536,601152
train,3529,67,51456,4489,646416,697872
train,3530,94,72192,8836,1272384,1344576
train,3531,68,52224,4624,665856,718080
train,3532,111,85248,12321,1774224,1859472
train,3533,16,12288,256,36864,49152
train,3534,255,195840,65025,9363600,9559440
train,3535,77,59136,5929,853776,912912
train,3536,106,81408,11236,1617984,1699392
train,3537,15,11520,225,32400,43920
train,3538,18,13824,324,46656,60480
train,3539,197,151296,38809,5588496,5739792
train,3540,73,56064,5329,767376,823440
train,3541,26,19968,676,97344,117312
train,3542,31,23808,961,138384,162192
train,3543,68,52224,4624,665856,718080
train,3544,74,56832,5476,788544,845376
train,3545,512,393216,262144,37748736,38141952
train,3546,70,53760,4900,705600,759360
train,3547,26,19968,676,97344,117312
train,3548,231,177408,53361,7683984,7861392
train,3549,59,45312,3481,501264,546576
train,3550,43,33024,1849,266256,299280
train,3551,17,13056,289,41616,54672
train,3552,64,49152,4096,589824,638976
train,3553,149,114432,22201,3196944,3311376
train,3554,93,71424,8649,1245456,1316880
train,3555,51,39168,2601,374544,413712
train,3556,50,38400,2500,360000,398400
train,3557,212,162816,44944,6471936,6634752
train,3558,512,393216,262144,37748736,38141952
train,3559,112,86016,12544,1806336,1892352
train,3560,52,39936,2704,389376,429312
train,3561,271,208128,73441,10575504,10783632
train,3562,100,76800,10000,1440000,1516800
train,3563,31,23808,961,138384,162192
train,3564,95,72960,9025,1299600,1372560
train,3565,252,193536,63504,9144576,9338112
train,3566,137,105216,18769,2702736,2807952
train,3567,149,114432,22201,3196944,3311376
train,3568,14,10752,196,28224,38976
train,3569,329,252672,108241,15586704,15839376
train,3570,69,52992,4761,685584,738576
train,3571,62,47616,3844,553536,601152
train,3572,62,47616,3844,553536,601152
train,3573,101,77568,10201,1468944,1546512
train,3574,317,243456,100489,14470416,14713872
train,3575,197,151296,38809,5588496,5739792
train,3576,26,19968,676,97344,117312
train,3577,27,20736,729,104976,125712
train,3578,62,47616,3844,553536,601152
train,3579,28,21504,784,112896,134400
train,3580,117,89856,13689,1971216,2061072
train,3581,29,22272,841,121104,143376
train,3582,74,56832,5476,788544,845376
train,3583,34,26112,1156,166464,192576
train,3584,191,146688,36481,5253264,5399952
train,3585,215,165120,46225,6656400,6821520
train,3586,106,81408,11236,1617984,1699392
train,3587,452,347136,204304,29419776,29766912
train,3588,289,221952,83521,12027024,12248976
train,3589,57,43776,3249,467856,511632
train,3590,40,30720,1600,230400,261120
train,3591,79,60672,6241,898704,959376
train,3592,109,83712,11881,1710864,1794576
train,3593,44,33792,1936,278784,312576
train,3594,61,46848,3721,535824,582672
train,3595,79,60672,6241,898704,959376
train,3596,61,46848,3721,535824,582672
train,3597,114,87552,12996,1871424,1958976
train,3598,79,60672,6241,898704,959376
train,3599,17,13056,289,41616,54672
train,3600,176,135168,30976,4460544,4595712
train,3601,235,180480,55225,7952400,8132880
train,3602,56,43008,3136,451584,494592
train,3603,66,50688,4356,627264,677952
train,3604,95,72960,9025,1299600,1372560
train,3605,254,195072,64516,9290304,9485376
train,3606,95,72960,9025,1299600,1372560
train,3607,430,330240,184900,26625600,26955840
train,3608,56,43008,3136,451584,494592
train,3609,137,105216,18769,2702736,2807952
train,3610,284,218112,80656,11614464,11832576
train,3611,512,393216,262144,37748736,38141952
train,3612,121,92928,14641,2108304,2201232
train,3613,52,39936,2704,389376,429312
train,3614,420,322560,176400,25401600,25724160
train,3615,120,92160,14400,2073600,2165760
train,3616,150,115200,22500,3240000,3355200
train,3617,131,100608,17161,2471184,2571792
train,3618,47,36096,2209,318096,354192
train,3619,228,175104,51984,7485696,7660800
train,3620,77,59136,5929,853776,912912
train,3621,114,87552,12996,1871424,1958976
train,3622,28,21504,784,112896,134400
train,3623,109,83712,11881,1710864,1794576
train,3624,103,79104,10609,1527696,1606800
train,3625,205,157440,42025,6051600,6209040
train,3626,37,28416,1369,197136,225552
train,3627,123,94464,15129,2178576,2273040
train,3628,55,42240,3025,435600,477840
train,3629,113,86784,12769,1838736,1925520
train,3630,56,43008,3136,451584,494592
train,3631,75,57600,5625,810000,867600
train,3632,73,56064,5329,767376,823440
train,3633,17,13056,289,41616,54672
train,3634,74,56832,5476,788544,845376
train,3635,40,30720,1600,230400,261120
train,3636,232,178176,53824,7750656,7928832
train,3637,70,53760,4900,705600,759360
train,3638,32,24576,1024,147456,172032
train,3639,512,393216,262144,37748736,38141952
train,3640,18,13824,324,46656,60480
train,3641,83,63744,6889,992016,1055760
train,3642,181,139008,32761,4717584,4856592
train,3643,26,19968,676,97344,117312
train,3644,28,21504,784,112896,134400
train,3645,62,47616,3844,553536,601152
train,3646,29,22272,841,121104,143376
train,3647,15,11520,225,32400,43920
train,3648,101,77568,10201,1468944,1546512
train,3649,122,93696,14884,2143296,2236992
train,3650,26,19968,676,97344,117312
train,3651,36,27648,1296,186624,214272
train,3652,83,63744,6889,992016,1055760
train,3653,19,14592,361,51984,66576
train,3654,157,120576,24649,3549456,3670032
train,3655,45,34560,2025,291600,326160
train,3656,79,60672,6241,898704,959376
train,3657,52,39936,2704,389376,429312
train,3658,26,19968,676,97344,117312
train,3659,173,132864,29929,4309776,4442640
train,3660,252,193536,63504,9144576,9338112
train,3661,15,11520,225,32400,43920
train,3662,283,217344,80089,11532816,11750160
train,3663,18,13824,324,46656,60480
train,3664,74,56832,5476,788544,845376
train,3665,25,19200,625,90000,109200
train,3666,196,150528,38416,5531904,5682432
train,3667,36,27648,1296,186624,214272
train,3668,29,22272,841,121104,143376
train,3669,63,48384,3969,571536,619920
train,3670,286,219648,81796,11778624,11998272
train,3671,158,121344,24964,3594816,3716160
train,3672,206,158208,42436,6110784,6268992
train,3673,27,20736,729,104976,125712
train,3674,261,200448,68121,9809424,10009872
train,3675,44,33792,1936,278784,312576
train,3676,206,158208,42436,6110784,6268992
train,3677,187,143616,34969,5035536,5179152
train,3678,59,45312,3481,501264,546576
train,3679,26,19968,676,97344,117312
train,3680,190,145920,36100,5198400,5344320
train,3681,143,109824,20449,2944656,3054480
train,3682,127,97536,16129,2322576,2420112
train,3683,76,58368,5776,831744,890112
train,3684,18,13824,324,46656,60480
train,3685,126,96768,15876,2286144,2382912
train,3686,196,150528,38416,5531904,5682432
train,3687,29,22272,841,121104,143376
train,3688,16,12288,256,36864,49152
train,3689,114,87552,12996,1871424,1958976
train,3690,29,22272,841,121104,143376
train,3691,100,76800,10000,1440000,1516800
train,3692,27,20736,729,104976,125712
train,3693,12,9216,144,20736,29952
train,3694,103,79104,10609,1527696,1606800
train,3695,117,89856,13689,1971216,2061072
train,3696,110,84480,12100,1742400,1826880
train,3697,80,61440,6400,921600,983040
train,3698,84,64512,7056,1016064,1080576
train,3699,29,22272,841,121104,143376
train,3700,41,31488,1681,242064,273552
train,3701,26,19968,676,97344,117312
train,3702,27,20736,729,104976,125712
train,3703,101,77568,10201,1468944,1546512
train,3704,84,64512,7056,1016064,1080576
train,3705,192,147456,36864,5308416,5455872
train,3706,48,36864,2304,331776,368640
train,3707,218,167424,47524,6843456,7010880
train,3708,17,13056,289,41616,54672
train,3709,222,170496,49284,7096896,7267392
train,3710,103,79104,10609,1527696,1606800
train,3711,102,78336,10404,1498176,1576512
train,3712,225,172800,50625,7290000,7462800
train,3713,187,143616,34969,5035536,5179152
train,3714,59,45312,3481,501264,546576
train,3715,55,42240,3025,435600,477840
train,3716,30,23040,900,129600,152640
train,3717,36,27648,1296,186624,214272
train,3718,15,11520,225,32400,43920
train,3719,218,167424,47524,6843456,7010880
train,3720,103,79104,10609,1527696,1606800
train,3721,75,57600,5625,810000,867600
train,3722,29,22272,841,121104,143376
train,3723,82,62976,6724,968256,1031232
train,3724,72,55296,5184,746496,801792
train,3725,105,80640,11025,1587600,1668240
train,3726,91,69888,8281,1192464,1262352
train,3727,69,52992,4761,685584,738576
train,3728,295,226560,87025,12531600,12758160
train,3729,158,121344,24964,3594816,3716160
train,3730,88,67584,7744,1115136,1182720
train,3731,35,26880,1225,176400,203280
train,3732,77,59136,5929,853776,912912
train,3733,94,72192,8836,1272384,1344576
train,3734,512,393216,262144,37748736,38141952
train,3735,88,67584,7744,1115136,1182720
train,3736,254,195072,64516,9290304,9485376
train,3737,33,25344,1089,156816,182160
train,3738,177,135936,31329,4511376,4647312
train,3739,138,105984,19044,2742336,2848320
train,3740,249,191232,62001,8928144,9119376
train,3741,15,11520,225,32400,43920
train,3742,28,21504,784,112896,134400
train,3743,68,52224,4624,665856,718080
train,3744,104,79872,10816,1557504,1637376
train,3745,205,157440,42025,6051600,6209040
train,3746,98,75264,9604,1382976,1458240
train,3747,218,167424,47524,6843456,7010880
train,3748,26,19968,676,97344,117312
train,3749,14,10752,196,28224,38976
train,3750,47,36096,2209,318096,354192
train,3751,112,86016,12544,1806336,1892352
train,3752,31,23808,961,138384,162192
train,3753,83,63744,6889,992016,1055760
train,3754,54,41472,2916,419904,461376
train,3755,175,134400,30625,4410000,4544400
train,3756,38,29184,1444,207936,237120
train,3757,72,55296,5184,746496,801792
train,3758,44,33792,1936,278784,312576
train,3759,102,78336,10404,1498176,1576512
train,3760,512,393216,262144,37748736,38141952
train,3761,512,393216,262144,37748736,38141952
train,3762,31,23808,961,138384,162192
train,3763,53,40704,2809,404496,445200
train,3764,51,39168,2601,374544,413712
train,3765,283,217344,80089,11532816,11750160
train,3766,334,256512,111556,16064064,16320576
train,3767,160,122880,25600,3686400,3809280
train,3768,198,152064,39204,5645376,5797440
train,3769,27,20736,729,104976,125712
train,3770,27,20736,729,104976,125712
train,3771,165,126720,27225,3920400,4047120
train,3772,29,22272,841,121104,143376
train,3773,59,45312,3481,501264,546576
train,3774,39,29952,1521,219024,248976
train,3775,84,64512,7056,1016064,1080576
train,3776,94,72192,8836,1272384,1344576
train,3777,132,101376,17424,2509056,2610432
train,3778,72,55296,5184,746496,801792
train,3779,53,40704,2809,404496,445200
train,3780,129,99072,16641,2396304,2495376
train,3781,103,79104,10609,1527696,1606800
train,3782,55,42240,3025,435600,477840
train,3783,200,153600,40000,5760000,5913600
train,3784,17,13056,289,41616,54672
train,3785,80,61440,6400,921600,983040
train,3786,126,96768,15876,2286144,2382912
train,3787,267,205056,71289,10265616,10470672
train,3788,55,42240,3025,435600,477840
train,3789,132,101376,17424,2509056,2610432
train,3790,134,102912,17956,2585664,2688576
train,3791,271,208128,73441,10575504,10783632
train,3792,134,102912,17956,2585664,2688576
train,3793,127,97536,16129,2322576,2420112
train,3794,317,243456,100489,14470416,14713872
train,3795,190,145920,36100,5198400,5344320
train,3796,57,43776,3249,467856,511632
train,3797,84,64512,7056,1016064,1080576
train,3798,30,23040,900,129600,152640
train,3799,38,29184,1444,207936,237120
train,3800,56,43008,3136,451584,494592
train,3801,115,88320,13225,1904400,1992720
train,3802,28,21504,784,112896,134400
train,3803,18,13824,324,46656,60480
train,3804,28,21504,784,112896,134400
train,3805,86,66048,7396,1065024,1131072
train,3806,78,59904,6084,876096,936000
train,3807,104,79872,10816,1557504,1637376
train,3808,60,46080,3600,518400,564480
train,3809,190,145920,36100,5198400,5344320
train,3810,155,119040,24025,3459600,3578640
train,3811,99,76032,9801,1411344,1487376
train,3812,14,10752,196,28224,38976
train,3813,184,141312,33856,4875264,5016576
train,3814,182,139776,33124,4769856,4909632
train,3815,136,104448,18496,2663424,2767872
train,3816,215,165120,46225,6656400,6821520
train,3817,75,57600,5625,810000,867600
train,3818,56,43008,3136,451584,494592
train,3819,94,72192,8836,1272384,1344576
train,3820,202,155136,40804,5875776,6030912
train,3821,106,81408,11236,1617984,1699392
train,3822,456,350208,207936,29942784,30292992
train,3823,15,11520,225,32400,43920
train,3824,117,89856,13689,1971216,2061072
train,3825,19,14592,361,51984,66576
train,3826,104,79872,10816,1557504,1637376
train,3827,120,92160,14400,2073600,2165760
train,3828,62,47616,3844,553536,601152
train,3829,309,237312,95481,13749264,13986576
train,3830,9,6912,81,11664,18576
train,3831,512,393216,262144,37748736,38141952
train,3832,13,9984,169,24336,34320
train,3833,86,66048,7396,1065024,1131072
train,3834,77,59136,5929,853776,912912
train,3835,94,72192,8836,1272384,1344576
train,3836,42,32256,1764,254016,286272
train,3837,183,140544,33489,4822416,4962960
train,3838,81,62208,6561,944784,1006992
train,3839,49,37632,2401,345744,383376
train,3840,116,89088,13456,1937664,2026752
train,3841,148,113664,21904,3154176,3267840
train,3842,11,8448,121,17424,25872
train,3843,57,43776,3249,467856,511632
train,3844,42,32256,1764,254016,286272
train,3845,61,46848,3721,535824,582672
train,3846,342,262656,116964,16842816,17105472
train,3847,82,62976,6724,968256,1031232
train,3848,57,43776,3249,467856,511632
train,3849,395,303360,156025,22467600,22770960
train,3850,32,24576,1024,147456,172032
train,3851,29,22272,841,121104,143376
train,3852,228,175104,51984,7485696,7660800
train,3853,93,71424,8649,1245456,1316880
train,3854,43,33024,1849,266256,299280
train,3855,15,11520,225,32400,43920
train,3856,211,162048,44521,6411024,6573072
train,3857,21,16128,441,63504,79632
train,3858,40,30720,1600,230400,261120
train,3859,146,112128,21316,3069504,3181632
train,3860,17,13056,289,41616,54672
train,3861,14,10752,196,28224,38976
train,3862,27,20736,729,104976,125712
train,3863,172,132096,29584,4260096,4392192
train,3864,221,169728,48841,7033104,7202832
train,3865,51,39168,2601,374544,413712
train,3866,67,51456,4489,646416,697872
train,3867,75,57600,5625,810000,867600
train,3868,79,60672,6241,898704,959376
train,3869,63,48384,3969,571536,619920
train,3870,30,23040,900,129600,152640
train,3871,18,13824,324,46656,60480
train,3872,64,49152,4096,589824,638976
train,3873,60,46080,3600,518400,564480
train,3874,508,390144,258064,37161216,37551360
train,3875,21,16128,441,63504,79632
train,3876,118,90624,13924,2005056,2095680
train,3877,45,34560,2025,291600,326160
train,3878,224,172032,50176,7225344,7397376
train,3879,119,91392,14161,2039184,2130576
train,3880,70,53760,4900,705600,759360
train,3881,20,15360,400,57600,72960
train,3882,16,12288,256,36864,49152
train,3883,192,147456,36864,5308416,5455872
train,3884,15,11520,225,32400,43920
train,3885,512,393216,262144,37748736,38141952
train,3886,25,19200,625,90000,109200
train,3887,39,29952,1521,219024,248976
train,3888,75,57600,5625,810000,867600
train,3889,105,80640,11025,1587600,1668240
train,3890,46,35328,2116,304704,340032
train,3891,39,29952,1521,219024,248976
train,3892,116,89088,13456,1937664,2026752
train,3893,469,360192,219961,31674384,32034576
train,3894,139,106752,19321,2782224,2888976
train,3895,38,29184,1444,207936,237120
train,3896,26,19968,676,97344,117312
train,3897,57,43776,3249,467856,511632
train,3898,106,81408,11236,1617984,1699392
train,3899,459,352512,210681,30338064,30690576
train,3900,59,45312,3481,501264,546576
train,3901,121,92928,14641,2108304,2201232
train,3902,78,59904,6084,876096,936000
train,3903,94,72192,8836,1272384,1344576
train,3904,45,34560,2025,291600,326160
train,3905,17,13056,289,41616,54672
train,3906,279,214272,77841,11209104,11423376
train,3907,191,146688,36481,5253264,5399952
train,3908,30,23040,900,129600,152640
train,3909,151,115968,22801,3283344,3399312
train,3910,34,26112,1156,166464,192576
train,3911,53,40704,2809,404496,445200
train,3912,96,73728,9216,1327104,1400832
train,3913,284,218112,80656,11614464,11832576
train,3914,112,86016,12544,1806336,1892352
train,3915,329,252672,108241,15586704,15839376
train,3916,139,106752,19321,2782224,2888976
train,3917,138,105984,19044,2742336,2848320
train,3918,275,211200,75625,10890000,11101200
train,3919,508,390144,258064,37161216,37551360
train,3920,270,207360,72900,10497600,10704960
train,3921,28,21504,784,112896,134400
train,3922,21,16128,441,63504,79632
train,3923,20,15360,400,57600,72960
train,3924,114,87552,12996,1871424,1958976
train,3925,61,46848,3721,535824,582672
train,3926,171,131328,29241,4210704,4342032
train,3927,36,27648,1296,186624,214272
train,3928,58,44544,3364,484416,528960
train,3929,94,72192,8836,1272384,1344576
train,3930,99,76032,9801,1411344,1487376
train,3931,223,171264,49729,7160976,7332240
train,3932,100,76800,10000,1440000,1516800
train,3933,33,25344,1089,156816,182160
train,3934,101,77568,10201,1468944,1546512
train,3935,480,368640,230400,33177600,33546240
train,3936,34,26112,1156,166464,192576
train,3937,32,24576,1024,147456,172032
train,3938,31,23808,961,138384,162192
train,3939,66,50688,4356,627264,677952
train,3940,301,231168,90601,13046544,13277712
train,3941,35,26880,1225,176400,203280
train,3942,512,393216,262144,37748736,38141952
train,3943,25,19200,625,90000,109200
train,3944,105,80640,11025,1587600,1668240
train,3945,145,111360,21025,3027600,3138960
train,3946,105,80640,11025,1587600,1668240
train,3947,13,9984,169,24336,34320
train,3948,53,40704,2809,404496,445200
train,3949,15,11520,225,32400,43920
train,3950,15,11520,225,32400,43920
train,3951,67,51456,4489,646416,697872
train,3952,45,34560,2025,291600,326160
train,3953,87,66816,7569,1089936,1156752
train,3954,29,22272,841,121104,143376
train,3955,220,168960,48400,6969600,7138560
train,3956,241,185088,58081,8363664,8548752
train,3957,133,102144,17689,2547216,2649360
train,3958,22,16896,484,69696,86592
train,3959,87,66816,7569,1089936,1156752
train,3960,49,37632,2401,345744,383376
train,3961,31,23808,961,138384,162192
train,3962,39,29952,1521,219024,248976
train,3963,335,257280,112225,16160400,16417680
train,3964,83,63744,6889,992016,1055760
train,3965,37,28416,1369,197136,225552
train,3966,108,82944,11664,1679616,1762560
train,3967,103,79104,10609,1527696,1606800
train,3968,124,95232,15376,2214144,2309376
train,3969,100,76800,10000,1440000,1516800
train,3970,174,133632,30276,4359744,4493376
train,3971,62,47616,3844,553536,601152
train,3972,113,86784,12769,1838736,1925520
train,3973,153,117504,23409,3370896,3488400
train,3974,36,27648,1296,186624,214272
train,3975,120,92160,14400,2073600,2165760
train,3976,123,94464,15129,2178576,2273040
train,3977,136,104448,18496,2663424,2767872
train,3978,106,81408,11236,1617984,1699392
train,3979,61,46848,3721,535824,582672
train,3980,61,46848,3721,535824,582672
train,3981,60,46080,3600,518400,564480
train,3982,146,112128,21316,3069504,3181632
train,3983,126,96768,15876,2286144,2382912
train,3984,93,71424,8649,1245456,1316880
train,3985,103,79104,10609,1527696,1606800
train,3986,246,188928,60516,8714304,8903232
train,3987,65,49920,4225,608400,658320
train,3988,48,36864,2304,331776,368640
train,3989,101,77568,10201,1468944,1546512
train,3990,363,278784,131769,18974736,19253520
train,3991,20,15360,400,57600,72960
train,3992,321,246528,103041,14837904,15084432
train,3993,227,174336,51529,7420176,7594512
train,3994,110,84480,12100,1742400,1826880
train,3995,296,227328,87616,12616704,12844032
train,3996,113,86784,12769,1838736,1925520
train,3997,28,21504,784,112896,134400
train,3998,19,14592,361,51984,66576
train,3999,67,51456,4489,646416,697872
train,4000,108,82944,11664,1679616,1762560
train,4001,100,76800,10000,1440000,1516800
train,4002,27,20736,729,104976,125712
train,4003,61,46848,3721,535824,582672
train,4004,120,92160,14400,2073600,2165760
train,4005,75,57600,5625,810000,867600
train,4006,61,46848,3721,535824,582672
train,4007,231,177408,53361,7683984,7861392
train,4008,40,30720,1600,230400,261120
train,4009,91,69888,8281,1192464,1262352
train,4010,82,62976,6724,968256,1031232
train,4011,190,145920,36100,5198400,5344320
train,4012,13,9984,169,24336,34320
train,4013,63,48384,3969,571536,619920
train,4014,477,366336,227529,32764176,33130512
train,4015,65,49920,4225,608400,658320
train,4016,137,105216,18769,2702736,2807952
train,4017,133,102144,17689,2547216,2649360
train,4018,103,79104,10609,1527696,1606800
train,4019,25,19200,625,90000,109200
train,4020,97,74496,9409,1354896,1429392
train,4021,196,150528,38416,5531904,5682432
train,4022,98,75264,9604,1382976,1458240
train,4023,81,62208,6561,944784,1006992
train,4024,512,393216,262144,37748736,38141952
train,4025,40,30720,1600,230400,261120
train,4026,214,164352,45796,6594624,6758976
train,4027,76,58368,5776,831744,890112
train,4028,264,202752,69696,10036224,10238976
train,4029,69,52992,4761,685584,738576
train,4030,80,61440,6400,921600,983040
train,4031,99,76032,9801,1411344,1487376
train,4032,37,28416,1369,197136,225552
train,4033,36,27648,1296,186624,214272
train,4034,84,64512,7056,1016064,1080576
train,4035,27,20736,729,104976,125712
train,4036,512,393216,262144,37748736,38141952
train,4037,79,60672,6241,898704,959376
train,4038,200,153600,40000,5760000,5913600
train,4039,71,54528,5041,725904,780432
train,4040,29,22272,841,121104,143376
train,4041,74,56832,5476,788544,845376
train,4042,139,106752,19321,2782224,2888976
train,4043,167,128256,27889,4016016,4144272
train,4044,512,393216,262144,37748736,38141952
train,4045,144,110592,20736,2985984,3096576
train,4046,362,278016,131044,18870336,19148352
train,4047,29,22272,841,121104,143376
train,4048,83,63744,6889,992016,1055760
train,4049,99,76032,9801,1411344,1487376
train,4050,87,66816,7569,1089936,1156752
train,4051,130,99840,16900,2433600,2533440
train,4052,325,249600,105625,15210000,15459600
train,4053,161,123648,25921,3732624,3856272
train,4054,96,73728,9216,1327104,1400832
train,4055,61,46848,3721,535824,582672
train,4056,86,66048,7396,1065024,1131072
train,4057,168,129024,28224,4064256,4193280
train,4058,53,40704,2809,404496,445200
train,4059,104,79872,10816,1557504,1637376
train,4060,299,229632,89401,12873744,13103376
train,4061,15,11520,225,32400,43920
train,4062,44,33792,1936,278784,312576
train,4063,119,91392,14161,2039184,2130576
train,4064,142,109056,20164,2903616,3012672
train,4065,223,171264,49729,7160976,7332240
train,4066,379,291072,143641,20684304,20975376
train,4067,180,138240,32400,4665600,4803840
train,4068,386,296448,148996,21455424,21751872
train,4069,57,43776,3249,467856,511632
train,4070,73,56064,5329,767376,823440
train,4071,70,53760,4900,705600,759360
train,4072,14,10752,196,28224,38976
train,4073,60,46080,3600,518400,564480
train,4074,430,330240,184900,26625600,26955840
train,4075,70,53760,4900,705600,759360
train,4076,403,309504,162409,23386896,23696400
train,4077,128,98304,16384,2359296,2457600
train,4078,30,23040,900,129600,152640
train,4079,226,173568,51076,7354944,7528512
train,4080,50,38400,2500,360000,398400
train,4081,26,19968,676,97344,117312
train,4082,64,49152,4096,589824,638976
train,4083,71,54528,5041,725904,780432
train,4084,175,134400,30625,4410000,4544400
train,4085,53,40704,2809,404496,445200
train,4086,512,393216,262144,37748736,38141952
train,4087,31,23808,961,138384,162192
train,4088,111,85248,12321,1774224,1859472
train,4089,106,81408,11236,1617984,1699392
train,4090,60,46080,3600,518400,564480
train,4091,55,42240,3025,435600,477840
train,4092,15,11520,225,32400,43920
train,4093,213,163584,45369,6533136,6696720
train,4094,512,393216,262144,37748736,38141952
train,4095,58,44544,3364,484416,528960
train,4096,40,30720,1600,230400,261120
train,4097,71,54528,5041,725904,780432
train,4098,102,78336,10404,1498176,1576512
train,4099,186,142848,34596,4981824,5124672
train,4100,122,93696,14884,2143296,2236992
train,4101,29,22272,841,121104,143376
train,4102,104,79872,10816,1557504,1637376
train,4103,87,66816,7569,1089936,1156752
train,4104,56,43008,3136,451584,494592
train,4105,46,35328,2116,304704,340032
train,4106,334,256512,111556,16064064,16320576
train,4107,86,66048,7396,1065024,1131072
train,4108,120,92160,14400,2073600,2165760
train,4109,329,252672,108241,15586704,15839376
train,4110,138,105984,19044,2742336,2848320
train,4111,26,19968,676,97344,117312
train,4112,249,191232,62001,8928144,9119376
train,4113,59,45312,3481,501264,546576
train,4114,181,139008,32761,4717584,4856592
train,4115,509,390912,259081,37307664,37698576
train,4116,512,393216,262144,37748736,38141952
train,4117,168,129024,28224,4064256,4193280
train,4118,249,191232,62001,8928144,9119376
train,4119,436,334848,190096,27373824,27708672
train,4120,114,87552,12996,1871424,1958976
train,4121,23,17664,529,76176,93840
train,4122,219,168192,47961,6906384,7074576
train,4123,47,36096,2209,318096,354192
train,4124,95,72960,9025,1299600,1372560
train,4125,27,20736,729,104976,125712
train,4126,30,23040,900,129600,152640
train,4127,172,132096,29584,4260096,4392192
train,4128,49,37632,2401,345744,383376
train,4129,512,393216,262144,37748736,38141952
train,4130,125,96000,15625,2250000,2346000
train,4131,124,95232,15376,2214144,2309376
train,4132,190,145920,36100,5198400,5344320
train,4133,86,66048,7396,1065024,1131072
train,4134,18,13824,324,46656,60480
train,4135,54,41472,2916,419904,461376
train,4136,88,67584,7744,1115136,1182720
train,4137,254,195072,64516,9290304,9485376
train,4138,79,60672,6241,898704,959376
train,4139,166,127488,27556,3968064,4095552
train,4140,424,325632,179776,25887744,26213376
train,4141,104,79872,10816,1557504,1637376
train,4142,164,125952,26896,3873024,3998976
train,4143,80,61440,6400,921600,983040
train,4144,116,89088,13456,1937664,2026752
train,4145,213,163584,45369,6533136,6696720
train,4146,89,68352,7921,1140624,1208976
train,4147,86,66048,7396,1065024,1131072
train,4148,65,49920,4225,608400,658320
train,4149,208,159744,43264,6230016,6389760
train,4150,221,169728,48841,7033104,7202832
train,4151,220,168960,48400,6969600,7138560
train,4152,78,59904,6084,876096,936000
train,4153,17,13056,289,41616,54672
train,4154,76,58368,5776,831744,890112
train,4155,26,19968,676,97344,117312
train,4156,172,132096,29584,4260096,4392192
train,4157,59,45312,3481,501264,546576
train,4158,302,231936,91204,13133376,13365312
train,4159,43,33024,1849,266256,299280
train,4160,46,35328,2116,304704,340032
train,4161,115,88320,13225,1904400,1992720
train,4162,36,27648,1296,186624,214272
train,4163,70,53760,4900,705600,759360
train,4164,52,39936,2704,389376,429312
train,4165,66,50688,4356,627264,677952
train,4166,270,207360,72900,10497600,10704960
train,4167,114,87552,12996,1871424,1958976
train,4168,29,22272,841,121104,143376
train,4169,30,23040,900,129600,152640
train,4170,30,23040,900,129600,152640
train,4171,109,83712,11881,1710864,1794576
train,4172,60,46080,3600,518400,564480
train,4173,63,48384,3969,571536,619920
train,4174,70,53760,4900,705600,759360
train,4175,154,118272,23716,3415104,3533376
train,4176,49,37632,2401,345744,383376
train,4177,31,23808,961,138384,162192
train,4178,33,25344,1089,156816,182160
train,4179,131,100608,17161,2471184,2571792
train,4180,493,378624,243049,34999056,35377680
train,4181,146,112128,21316,3069504,3181632
train,4182,116,89088,13456,1937664,2026752
train,4183,76,58368,5776,831744,890112
train,4184,166,127488,27556,3968064,4095552
train,4185,177,135936,31329,4511376,4647312
train,4186,414,317952,171396,24681024,24998976
train,4187,73,56064,5329,767376,823440
train,4188,143,109824,20449,2944656,3054480
train,4189,181,139008,32761,4717584,4856592
train,4190,164,125952,26896,3873024,3998976
train,4191,71,54528,5041,725904,780432
train,4192,58,44544,3364,484416,528960
train,4193,79,60672,6241,898704,959376
train,4194,58,44544,3364,484416,528960
train,4195,27,20736,729,104976,125712
train,4196,19,14592,361,51984,66576
train,4197,63,48384,3969,571536,619920
train,4198,63,48384,3969,571536,619920
train,4199,57,43776,3249,467856,511632
train,4200,512,393216,262144,37748736,38141952
train,4201,158,121344,24964,3594816,3716160
train,4202,110,84480,12100,1742400,1826880
train,4203,512,393216,262144,37748736,38141952
train,4204,133,102144,17689,2547216,2649360
train,4205,89,68352,7921,1140624,1208976
train,4206,107,82176,11449,1648656,1730832
train,4207,44,33792,1936,278784,312576
train,4208,44,33792,1936,278784,312576
train,4209,28,21504,784,112896,134400
train,4210,53,40704,2809,404496,445200
train,4211,44,33792,1936,278784,312576
train,4212,67,51456,4489,646416,697872
train,4213,512,393216,262144,37748736,38141952
train,4214,90,69120,8100,1166400,1235520
train,4215,49,37632,2401,345744,383376
train,4216,134,102912,17956,2585664,2688576
train,4217,13,9984,169,24336,34320
train,4218,69,52992,4761,685584,738576
train,4219,512,393216,262144,37748736,38141952
train,4220,41,31488,1681,242064,273552
train,4221,70,53760,4900,705600,759360
train,4222,64,49152,4096,589824,638976
train,4223,60,46080,3600,518400,564480
train,4224,34,26112,1156,166464,192576
train,4225,124,95232,15376,2214144,2309376
train,4226,46,35328,2116,304704,340032
train,4227,33,25344,1089,156816,182160
train,4228,49,37632,2401,345744,383376
train,4229,121,92928,14641,2108304,2201232
train,4230,42,32256,1764,254016,286272
train,4231,289,221952,83521,12027024,12248976
train,4232,512,393216,262144,37748736,38141952
train,4233,124,95232,15376,2214144,2309376
train,4234,51,39168,2601,374544,413712
train,4235,27,20736,729,104976,125712
train,4236,57,43776,3249,467856,511632
train,4237,109,83712,11881,1710864,1794576
train,4238,68,52224,4624,665856,718080
train,4239,47,36096,2209,318096,354192
train,4240,292,224256,85264,12278016,12502272
train,4241,55,42240,3025,435600,477840
train,4242,75,57600,5625,810000,867600
train,4243,258,198144,66564,9585216,9783360
train,4244,57,43776,3249,467856,511632
train,4245,41,31488,1681,242064,273552
train,4246,137,105216,18769,2702736,2807952
train,4247,71,54528,5041,725904,780432
train,4248,28,21504,784,112896,134400
train,4249,75,57600,5625,810000,867600
train,4250,26,19968,676,97344,117312
train,4251,107,82176,11449,1648656,1730832
train,4252,15,11520,225,32400,43920
train,4253,358,274944,128164,18455616,18730560
train,4254,318,244224,101124,14561856,14806080
train,4255,96,73728,9216,1327104,1400832
train,4256,216,165888,46656,6718464,6884352
train,4257,122,93696,14884,2143296,2236992
train,4258,42,32256,1764,254016,286272
train,4259,103,79104,10609,1527696,1606800
train,4260,193,148224,37249,5363856,5512080
train,4261,27,20736,729,104976,125712
train,4262,90,69120,8100,1166400,1235520
train,4263,46,35328,2116,304704,340032
train,4264,15,11520,225,32400,43920
train,4265,94,72192,8836,1272384,1344576
train,4266,132,101376,17424,2509056,2610432
train,4267,58,44544,3364,484416,528960
train,4268,160,122880,25600,3686400,3809280
train,4269,38,29184,1444,207936,237120
train,4270,232,178176,53824,7750656,7928832
train,4271,74,56832,5476,788544,845376
train,4272,174,133632,30276,4359744,4493376
train,4273,57,43776,3249,467856,511632
train,4274,144,110592,20736,2985984,3096576
train,4275,79,60672,6241,898704,959376
train,4276,14,10752,196,28224,38976
train,4277,48,36864,2304,331776,368640
train,4278,147,112896,21609,3111696,3224592
train,4279,168,129024,28224,4064256,4193280
train,4280,53,40704,2809,404496,445200
train,4281,98,75264,9604,1382976,1458240
train,4282,108,82944,11664,1679616,1762560
train,4283,26,19968,676,97344,117312
train,4284,75,57600,5625,810000,867600
train,4285,155,119040,24025,3459600,3578640
train,4286,101,77568,10201,1468944,1546512
train,4287,96,73728,9216,1327104,1400832
train,4288,124,95232,15376,2214144,2309376
train,4289,65,49920,4225,608400,658320
train,4290,232,178176,53824,7750656,7928832
train,4291,512,393216,262144,37748736,38141952
train,4292,182,139776,33124,4769856,4909632
train,4293,62,47616,3844,553536,601152
train,4294,114,87552,12996,1871424,1958976
train,4295,512,393216,262144,37748736,38141952
train,4296,213,163584,45369,6533136,6696720
train,4297,152,116736,23104,3326976,3443712
train,4298,191,146688,36481,5253264,5399952
train,4299,177,135936,31329,4511376,4647312
train,4300,39,29952,1521,219024,248976
train,4301,93,71424,8649,1245456,1316880
train,4302,15,11520,225,32400,43920
train,4303,176,135168,30976,4460544,4595712
train,4304,226,173568,51076,7354944,7528512
train,4305,242,185856,58564,8433216,8619072
train,4306,114,87552,12996,1871424,1958976
train,4307,512,393216,262144,37748736,38141952
train,4308,305,234240,93025,13395600,13629840
train,4309,200,153600,40000,5760000,5913600
train,4310,107,82176,11449,1648656,1730832
train,4311,64,49152,4096,589824,638976
train,4312,74,56832,5476,788544,845376
train,4313,42,32256,1764,254016,286272
train,4314,28,21504,784,112896,134400
train,4315,51,39168,2601,374544,413712
train,4316,60,46080,3600,518400,564480
train,4317,186,142848,34596,4981824,5124672
train,4318,225,172800,50625,7290000,7462800
train,4319,210,161280,44100,6350400,6511680
train,4320,16,12288,256,36864,49152
train,4321,26,19968,676,97344,117312
train,4322,70,53760,4900,705600,759360
train,4323,109,83712,11881,1710864,1794576
train,4324,119,91392,14161,2039184,2130576
train,4325,74,56832,5476,788544,845376
train,4326,58,44544,3364,484416,528960
train,4327,86,66048,7396,1065024,1131072
train,4328,160,122880,25600,3686400,3809280
train,4329,88,67584,7744,1115136,1182720
train,4330,81,62208,6561,944784,1006992
train,4331,69,52992,4761,685584,738576
train,4332,90,69120,8100,1166400,1235520
train,4333,121,92928,14641,2108304,2201232
train,4334,16,12288,256,36864,49152
train,4335,512,393216,262144,37748736,38141952
train,4336,96,73728,9216,1327104,1400832
train,4337,131,100608,17161,2471184,2571792
train,4338,95,72960,9025,1299600,1372560
train,4339,217,166656,47089,6780816,6947472
train,4340,40,30720,1600,230400,261120
train,4341,99,76032,9801,1411344,1487376
train,4342,224,172032,50176,7225344,7397376
train,4343,57,43776,3249,467856,511632
train,4344,128,98304,16384,2359296,2457600
train,4345,81,62208,6561,944784,1006992
train,4346,20,15360,400,57600,72960
train,4347,83,63744,6889,992016,1055760
train,4348,275,211200,75625,10890000,11101200
train,4349,54,41472,2916,419904,461376
train,4350,378,290304,142884,20575296,20865600
train,4351,24,18432,576,82944,101376
train,4352,61,46848,3721,535824,582672
train,4353,17,13056,289,41616,54672
train,4354,278,213504,77284,11128896,11342400
train,4355,19,14592,361,51984,66576
train,4356,16,12288,256,36864,49152
train,4357,512,393216,262144,37748736,38141952
train,4358,100,76800,10000,1440000,1516800
train,4359,101,77568,10201,1468944,1546512
train,4360,87,66816,7569,1089936,1156752
train,4361,63,48384,3969,571536,619920
train,4362,126,96768,15876,2286144,2382912
train,4363,34,26112,1156,166464,192576
train,4364,13,9984,169,24336,34320
train,4365,72,55296,5184,746496,801792
train,4366,73,56064,5329,767376,823440
train,4367,17,13056,289,41616,54672
train,4368,223,171264,49729,7160976,7332240
train,4369,110,84480,12100,1742400,1826880
train,4370,512,393216,262144,37748736,38141952
train,4371,149,114432,22201,3196944,3311376
train,4372,146,112128,21316,3069504,3181632
train,4373,311,238848,96721,13927824,14166672
train,4374,268,205824,71824,10342656,10548480
train,4375,19,14592,361,51984,66576
train,4376,79,60672,6241,898704,959376
train,4377,65,49920,4225,608400,658320
train,4378,62,47616,3844,553536,601152
train,4379,95,72960,9025,1299600,1372560
train,4380,61,46848,3721,535824,582672
train,4381,51,39168,2601,374544,413712
train,4382,234,179712,54756,7884864,8064576
train,4383,152,116736,23104,3326976,3443712
train,4384,93,71424,8649,1245456,1316880
train,4385,168,129024,28224,4064256,4193280
train,4386,95,72960,9025,1299600,1372560
train,4387,81,62208,6561,944784,1006992
validation,0,48,36864,2304,331776,368640
validation,1,75,57600,5625,810000,867600
validation,2,73,56064,5329,767376,823440
validation,3,77,59136,5929,853776,912912
validation,4,54,41472,2916,419904,461376
validation,5,59,45312,3481,501264,546576
validation,6,28,21504,784,112896,134400
validation,7,97,74496,9409,1354896,1429392
validation,8,46,35328,2116,304704,340032
validation,9,29,22272,841,121104,143376
validation,10,69,52992,4761,685584,738576
validation,11,35,26880,1225,176400,203280
validation,12,16,12288,256,36864,49152
validation,13,28,21504,784,112896,134400
validation,14,89,68352,7921,1140624,1208976
validation,15,148,113664,21904,3154176,3267840
validation,16,87,66816,7569,1089936,1156752
validation,17,32,24576,1024,147456,172032
validation,18,21,16128,441,63504,79632
validation,19,91,69888,8281,1192464,1262352
validation,20,103,79104,10609,1527696,1606800
validation,21,428,328704,183184,26378496,26707200
validation,22,110,84480,12100,1742400,1826880
validation,23,18,13824,324,46656,60480
validation,24,416,319488,173056,24920064,25239552
validation,25,48,36864,2304,331776,368640
validation,26,48,36864,2304,331776,368640
validation,27,86,66048,7396,1065024,1131072
validation,28,116,89088,13456,1937664,2026752
validation,29,201,154368,40401,5817744,5972112
validation,30,45,34560,2025,291600,326160
validation,31,230,176640,52900,7617600,7794240
validation,32,27,20736,729,104976,125712
validation,33,17,13056,289,41616,54672
validation,34,52,39936,2704,389376,429312
validation,35,74,56832,5476,788544,845376
validation,36,54,41472,2916,419904,461376
validation,37,16,12288,256,36864,49152
validation,38,512,393216,262144,37748736,38141952
validation,39,428,328704,183184,26378496,26707200
validation,40,90,69120,8100,1166400,1235520
validation,41,487,374016,237169,34152336,34526352
validation,42,276,211968,76176,10969344,11181312
validation,43,83,63744,6889,992016,1055760
validation,44,213,163584,45369,6533136,6696720
validation,45,360,276480,129600,18662400,18938880
validation,46,57,43776,3249,467856,511632
validation,47,42,32256,1764,254016,286272
validation,48,91,69888,8281,1192464,1262352
validation,49,72,55296,5184,746496,801792
validation,50,93,71424,8649,1245456,1316880
validation,51,92,70656,8464,1218816,1289472
validation,52,39,29952,1521,219024,248976
validation,53,512,393216,262144,37748736,38141952
validation,54,41,31488,1681,242064,273552
validation,55,80,61440,6400,921600,983040
validation,56,49,37632,2401,345744,383376
validation,57,23,17664,529,76176,93840
validation,58,277,212736,76729,11048976,11261712
validation,59,512,393216,262144,37748736,38141952
validation,60,79,60672,6241,898704,959376
validation,61,180,138240,32400,4665600,4803840
validation,62,66,50688,4356,627264,677952
validation,63,14,10752,196,28224,38976
validation,64,51,39168,2601,374544,413712
validation,65,76,58368,5776,831744,890112
validation,66,57,43776,3249,467856,511632
validation,67,57,43776,3249,467856,511632
validation,68,73,56064,5329,767376,823440
validation,69,92,70656,8464,1218816,1289472
validation,70,68,52224,4624,665856,718080
validation,71,267,205056,71289,10265616,10470672
validation,72,512,393216,262144,37748736,38141952
validation,73,367,281856,134689,19395216,19677072
validation,74,220,168960,48400,6969600,7138560
validation,75,179,137472,32041,4613904,4751376
validation,76,27,20736,729,104976,125712
validation,77,125,96000,15625,2250000,2346000
validation,78,274,210432,75076,10810944,11021376
validation,79,136,104448,18496,2663424,2767872
validation,80,396,304128,156816,22581504,22885632
validation,81,11,8448,121,17424,25872
validation,82,64,49152,4096,589824,638976
validation,83,209,160512,43681,6290064,6450576
validation,84,66,50688,4356,627264,677952
validation,85,27,20736,729,104976,125712
validation,86,304,233472,92416,13307904,13541376
validation,87,187,143616,34969,5035536,5179152
validation,88,147,112896,21609,3111696,3224592
validation,89,90,69120,8100,1166400,1235520
validation,90,61,46848,3721,535824,582672
validation,91,392,301056,153664,22127616,22428672
validation,92,76,58368,5776,831744,890112
validation,93,124,95232,15376,2214144,2309376
validation,94,512,393216,262144,37748736,38141952
validation,95,91,69888,8281,1192464,1262352
validation,96,36,27648,1296,186624,214272
validation,97,87,66816,7569,1089936,1156752
validation,98,215,165120,46225,6656400,6821520
validation,99,35,26880,1225,176400,203280
validation,100,53,40704,2809,404496,445200
validation,101,40,30720,1600,230400,261120
validation,102,314,241152,98596,14197824,14438976
validation,103,72,55296,5184,746496,801792
validation,104,512,393216,262144,37748736,38141952
validation,105,308,236544,94864,13660416,13896960
validation,106,20,15360,400,57600,72960
validation,107,121,92928,14641,2108304,2201232
validation,108,172,132096,29584,4260096,4392192
validation,109,12,9216,144,20736,29952
validation,110,100,76800,10000,1440000,1516800
validation,111,237,182016,56169,8088336,8270352
validation,112,43,33024,1849,266256,299280
validation,113,34,26112,1156,166464,192576
validation,114,48,36864,2304,331776,368640
validation,115,16,12288,256,36864,49152
validation,116,16,12288,256,36864,49152
validation,117,512,393216,262144,37748736,38141952
validation,118,491,377088,241081,34715664,35092752
validation,119,78,59904,6084,876096,936000
validation,120,132,101376,17424,2509056,2610432
validation,121,125,96000,15625,2250000,2346000
validation,122,251,192768,63001,9072144,9264912
validation,123,36,27648,1296,186624,214272
validation,124,120,92160,14400,2073600,2165760
validation,125,512,393216,262144,37748736,38141952
validation,126,64,49152,4096,589824,638976
validation,127,112,86016,12544,1806336,1892352
validation,128,360,276480,129600,18662400,18938880
validation,129,512,393216,262144,37748736,38141952
validation,130,92,70656,8464,1218816,1289472
validation,131,195,149760,38025,5475600,5625360
validation,132,100,76800,10000,1440000,1516800
validation,133,414,317952,171396,24681024,24998976
validation,134,74,56832,5476,788544,845376
validation,135,178,136704,31684,4562496,4699200
validation,136,93,71424,8649,1245456,1316880
validation,137,48,36864,2304,331776,368640
validation,138,186,142848,34596,4981824,5124672
validation,139,107,82176,11449,1648656,1730832
validation,140,180,138240,32400,4665600,4803840
validation,141,75,57600,5625,810000,867600
validation,142,182,139776,33124,4769856,4909632
validation,143,87,66816,7569,1089936,1156752
validation,144,397,304896,157609,22695696,23000592
validation,145,85,65280,7225,1040400,1105680
validation,146,15,11520,225,32400,43920
validation,147,100,76800,10000,1440000,1516800
validation,148,27,20736,729,104976,125712
validation,149,61,46848,3721,535824,582672
validation,150,31,23808,961,138384,162192
validation,151,512,393216,262144,37748736,38141952
validation,152,257,197376,66049,9511056,9708432
validation,153,296,227328,87616,12616704,12844032
validation,154,512,393216,262144,37748736,38141952
validation,155,66,50688,4356,627264,677952
validation,156,512,393216,262144,37748736,38141952
validation,157,104,79872,10816,1557504,1637376
validation,158,174,133632,30276,4359744,4493376
validation,159,15,11520,225,32400,43920
validation,160,153,117504,23409,3370896,3488400
validation,161,143,109824,20449,2944656,3054480
validation,162,104,79872,10816,1557504,1637376
validation,163,49,37632,2401,345744,383376
validation,164,82,62976,6724,968256,1031232
validation,165,114,87552,12996,1871424,1958976
validation,166,32,24576,1024,147456,172032
validation,167,13,9984,169,24336,34320
validation,168,85,65280,7225,1040400,1105680
validation,169,446,342528,198916,28643904,28986432
validation,170,76,58368,5776,831744,890112
validation,171,159,122112,25281,3640464,3762576
validation,172,41,31488,1681,242064,273552
validation,173,99,76032,9801,1411344,1487376
validation,174,67,51456,4489,646416,697872
validation,175,109,83712,11881,1710864,1794576
validation,176,97,74496,9409,1354896,1429392
validation,177,79,60672,6241,898704,959376
validation,178,144,110592,20736,2985984,3096576
validation,179,28,21504,784,112896,134400
validation,180,243,186624,59049,8503056,8689680
validation,181,97,74496,9409,1354896,1429392
validation,182,219,168192,47961,6906384,7074576
validation,183,198,152064,39204,5645376,5797440
validation,184,24,18432,576,82944,101376
validation,185,95,72960,9025,1299600,1372560
validation,186,291,223488,84681,12194064,12417552
validation,187,53,40704,2809,404496,445200
validation,188,15,11520,225,32400,43920
validation,189,76,58368,5776,831744,890112
validation,190,39,29952,1521,219024,248976
validation,191,82,62976,6724,968256,1031232
validation,192,123,94464,15129,2178576,2273040
validation,193,51,39168,2601,374544,413712
validation,194,74,56832,5476,788544,845376
validation,195,30,23040,900,129600,152640
validation,196,27,20736,729,104976,125712
validation,197,74,56832,5476,788544,845376
validation,198,98,75264,9604,1382976,1458240
validation,199,30,23040,900,129600,152640
validation,200,25,19200,625,90000,109200
validation,201,18,13824,324,46656,60480
validation,202,55,42240,3025,435600,477840
validation,203,16,12288,256,36864,49152
validation,204,360,276480,129600,18662400,18938880
validation,205,50,38400,2500,360000,398400
validation,206,126,96768,15876,2286144,2382912
validation,207,13,9984,169,24336,34320
validation,208,67,51456,4489,646416,697872
validation,209,141,108288,19881,2862864,2971152
validation,210,55,42240,3025,435600,477840
validation,211,28,21504,784,112896,134400
validation,212,62,47616,3844,553536,601152
validation,213,95,72960,9025,1299600,1372560
validation,214,117,89856,13689,1971216,2061072
validation,215,268,205824,71824,10342656,10548480
validation,216,28,21504,784,112896,134400
validation,217,63,48384,3969,571536,619920
validation,218,80,61440,6400,921600,983040
validation,219,17,13056,289,41616,54672
validation,220,91,69888,8281,1192464,1262352
validation,221,92,70656,8464,1218816,1289472
validation,222,104,79872,10816,1557504,1637376
validation,223,70,53760,4900,705600,759360
validation,224,60,46080,3600,518400,564480
validation,225,60,46080,3600,518400,564480
validation,226,79,60672,6241,898704,959376
validation,227,15,11520,225,32400,43920
validation,228,77,59136,5929,853776,912912
validation,229,79,60672,6241,898704,959376
validation,230,60,46080,3600,518400,564480
validation,231,107,82176,11449,1648656,1730832
validation,232,114,87552,12996,1871424,1958976
validation,233,86,66048,7396,1065024,1131072
validation,234,57,43776,3249,467856,511632
validation,235,16,12288,256,36864,49152
validation,236,219,168192,47961,6906384,7074576
validation,237,99,76032,9801,1411344,1487376
validation,238,47,36096,2209,318096,354192
validation,239,70,53760,4900,705600,759360
validation,240,128,98304,16384,2359296,2457600
validation,241,63,48384,3969,571536,619920
validation,242,102,78336,10404,1498176,1576512
validation,243,14,10752,196,28224,38976
validation,244,145,111360,21025,3027600,3138960
validation,245,14,10752,196,28224,38976
validation,246,187,143616,34969,5035536,5179152
validation,247,27,20736,729,104976,125712
validation,248,332,254976,110224,15872256,16127232
validation,249,153,117504,23409,3370896,3488400
validation,250,102,78336,10404,1498176,1576512
validation,251,29,22272,841,121104,143376
validation,252,128,98304,16384,2359296,2457600
validation,253,56,43008,3136,451584,494592
validation,254,66,50688,4356,627264,677952
validation,255,18,13824,324,46656,60480
validation,256,269,206592,72361,10419984,10626576
validation,257,38,29184,1444,207936,237120
validation,258,334,256512,111556,16064064,16320576
validation,259,225,172800,50625,7290000,7462800
validation,260,56,43008,3136,451584,494592
validation,261,68,52224,4624,665856,718080
validation,262,84,64512,7056,1016064,1080576
validation,263,82,62976,6724,968256,1031232
validation,264,90,69120,8100,1166400,1235520
validation,265,26,19968,676,97344,117312
validation,266,48,36864,2304,331776,368640
validation,267,41,31488,1681,242064,273552
validation,268,88,67584,7744,1115136,1182720
validation,269,440,337920,193600,27878400,28216320
validation,270,56,43008,3136,451584,494592
validation,271,110,84480,12100,1742400,1826880
validation,272,119,91392,14161,2039184,2130576
validation,273,81,62208,6561,944784,1006992
validation,274,125,96000,15625,2250000,2346000
validation,275,235,180480,55225,7952400,8132880
validation,276,102,78336,10404,1498176,1576512
validation,277,367,281856,134689,19395216,19677072
validation,278,120,92160,14400,2073600,2165760
validation,279,114,87552,12996,1871424,1958976
validation,280,13,9984,169,24336,34320
validation,281,137,105216,18769,2702736,2807952
validation,282,102,78336,10404,1498176,1576512
validation,283,66,50688,4356,627264,677952
validation,284,204,156672,41616,5992704,6149376
validation,285,117,89856,13689,1971216,2061072
validation,286,151,115968,22801,3283344,3399312
validation,287,126,96768,15876,2286144,2382912
validation,288,29,22272,841,121104,143376
validation,289,13,9984,169,24336,34320
validation,290,19,14592,361,51984,66576
validation,291,105,80640,11025,1587600,1668240
validation,292,49,37632,2401,345744,383376
validation,293,75,57600,5625,810000,867600
validation,294,73,56064,5329,767376,823440
validation,295,44,33792,1936,278784,312576
validation,296,53,40704,2809,404496,445200
validation,297,224,172032,50176,7225344,7397376
validation,298,39,29952,1521,219024,248976
validation,299,118,90624,13924,2005056,2095680
validation,300,63,48384,3969,571536,619920
validation,301,476,365568,226576,32626944,32992512
validation,302,174,133632,30276,4359744,4493376
validation,303,77,59136,5929,853776,912912
validation,304,61,46848,3721,535824,582672
validation,305,43,33024,1849,266256,299280
validation,306,95,72960,9025,1299600,1372560
validation,307,27,20736,729,104976,125712
validation,308,13,9984,169,24336,34320
validation,309,105,80640,11025,1587600,1668240
validation,310,296,227328,87616,12616704,12844032
validation,311,120,92160,14400,2073600,2165760
validation,312,46,35328,2116,304704,340032
validation,313,221,169728,48841,7033104,7202832
validation,314,85,65280,7225,1040400,1105680
validation,315,17,13056,289,41616,54672
validation,316,79,60672,6241,898704,959376
validation,317,84,64512,7056,1016064,1080576
validation,318,331,254208,109561,15776784,16030992
validation,319,13,9984,169,24336,34320
validation,320,31,23808,961,138384,162192
validation,321,25,19200,625,90000,109200
validation,322,355,272640,126025,18147600,18420240
validation,323,65,49920,4225,608400,658320
validation,324,17,13056,289,41616,54672
validation,325,81,62208,6561,944784,1006992
validation,326,30,23040,900,129600,152640
validation,327,117,89856,13689,1971216,2061072
validation,328,118,90624,13924,2005056,2095680
validation,329,512,393216,262144,37748736,38141952
validation,330,75,57600,5625,810000,867600
validation,331,109,83712,11881,1710864,1794576
validation,332,66,50688,4356,627264,677952
validation,333,31,23808,961,138384,162192
validation,334,294,225792,86436,12446784,12672576
validation,335,40,30720,1600,230400,261120
validation,336,463,355584,214369,30869136,31224720
validation,337,60,46080,3600,518400,564480
validation,338,22,16896,484,69696,86592
validation,339,57,43776,3249,467856,511632
validation,340,17,13056,289,41616,54672
validation,341,155,119040,24025,3459600,3578640
validation,342,113,86784,12769,1838736,1925520
validation,343,86,66048,7396,1065024,1131072
validation,344,70,53760,4900,705600,759360
validation,345,83,63744,6889,992016,1055760
validation,346,258,198144,66564,9585216,9783360
validation,347,44,33792,1936,278784,312576
validation,348,144,110592,20736,2985984,3096576
validation,349,52,39936,2704,389376,429312
validation,350,52,39936,2704,389376,429312
validation,351,57,43776,3249,467856,511632
validation,352,114,87552,12996,1871424,1958976
validation,353,125,96000,15625,2250000,2346000
validation,354,512,393216,262144,37748736,38141952
validation,355,171,131328,29241,4210704,4342032
validation,356,62,47616,3844,553536,601152
validation,357,29,22272,841,121104,143376
validation,358,28,21504,784,112896,134400
validation,359,96,73728,9216,1327104,1400832
validation,360,186,142848,34596,4981824,5124672
validation,361,102,78336,10404,1498176,1576512
validation,362,40,30720,1600,230400,261120
validation,363,120,92160,14400,2073600,2165760
validation,364,45,34560,2025,291600,326160
validation,365,193,148224,37249,5363856,5512080
validation,366,286,219648,81796,11778624,11998272
validation,367,336,258048,112896,16257024,16515072
validation,368,155,119040,24025,3459600,3578640
validation,369,29,22272,841,121104,143376
validation,370,316,242688,99856,14379264,14621952
validation,371,90,69120,8100,1166400,1235520
validation,372,172,132096,29584,4260096,4392192
validation,373,28,21504,784,112896,134400
validation,374,53,40704,2809,404496,445200
validation,375,33,25344,1089,156816,182160
validation,376,435,334080,189225,27248400,27582480
validation,377,27,20736,729,104976,125712
validation,378,13,9984,169,24336,34320
validation,379,219,168192,47961,6906384,7074576
validation,380,54,41472,2916,419904,461376
validation,381,102,78336,10404,1498176,1576512
validation,382,191,146688,36481,5253264,5399952
validation,383,85,65280,7225,1040400,1105680
validation,384,168,129024,28224,4064256,4193280
validation,385,491,377088,241081,34715664,35092752
validation,386,84,64512,7056,1016064,1080576
validation,387,29,22272,841,121104,143376
validation,388,122,93696,14884,2143296,2236992
validation,389,68,52224,4624,665856,718080
validation,390,123,94464,15129,2178576,2273040
validation,391,34,26112,1156,166464,192576
validation,392,66,50688,4356,627264,677952
validation,393,72,55296,5184,746496,801792
validation,394,127,97536,16129,2322576,2420112
validation,395,31,23808,961,138384,162192
validation,396,115,88320,13225,1904400,1992720
validation,397,247,189696,61009,8785296,8974992
validation,398,121,92928,14641,2108304,2201232
validation,399,61,46848,3721,535824,582672
validation,400,53,40704,2809,404496,445200
validation,401,91,69888,8281,1192464,1262352
validation,402,89,68352,7921,1140624,1208976
validation,403,76,58368,5776,831744,890112
validation,404,323,248064,104329,15023376,15271440
validation,405,104,79872,10816,1557504,1637376
validation,406,46,35328,2116,304704,340032
validation,407,195,149760,38025,5475600,5625360
validation,408,205,157440,42025,6051600,6209040
validation,409,26,19968,676,97344,117312
validation,410,60,46080,3600,518400,564480
validation,411,26,19968,676,97344,117312
validation,412,68,52224,4624,665856,718080
validation,413,114,87552,12996,1871424,1958976
validation,414,212,162816,44944,6471936,6634752
validation,415,9,6912,81,11664,18576
validation,416,48,36864,2304,331776,368640
validation,417,131,100608,17161,2471184,2571792
validation,418,28,21504,784,112896,134400
validation,419,42,32256,1764,254016,286272
validation,420,143,109824,20449,2944656,3054480
validation,421,110,84480,12100,1742400,1826880
validation,422,225,172800,50625,7290000,7462800
validation,423,65,49920,4225,608400,658320
validation,424,195,149760,38025,5475600,5625360
validation,425,92,70656,8464,1218816,1289472
validation,426,71,54528,5041,725904,780432
validation,427,212,162816,44944,6471936,6634752
validation,428,73,56064,5329,767376,823440
validation,429,146,112128,21316,3069504,3181632
validation,430,116,89088,13456,1937664,2026752
validation,431,132,101376,17424,2509056,2610432
validation,432,503,386304,253009,36433296,36819600
validation,433,47,36096,2209,318096,354192
validation,434,87,66816,7569,1089936,1156752
validation,435,72,55296,5184,746496,801792
validation,436,72,55296,5184,746496,801792
validation,437,50,38400,2500,360000,398400
validation,438,56,43008,3136,451584,494592
validation,439,15,11520,225,32400,43920
validation,440,148,113664,21904,3154176,3267840
validation,441,66,50688,4356,627264,677952
validation,442,81,62208,6561,944784,1006992
validation,443,72,55296,5184,746496,801792
validation,444,267,205056,71289,10265616,10470672
validation,445,36,27648,1296,186624,214272
validation,446,30,23040,900,129600,152640
validation,447,87,66816,7569,1089936,1156752
validation,448,52,39936,2704,389376,429312
validation,449,192,147456,36864,5308416,5455872
validation,450,63,48384,3969,571536,619920
validation,451,19,14592,361,51984,66576
validation,452,63,48384,3969,571536,619920
validation,453,214,164352,45796,6594624,6758976
validation,454,178,136704,31684,4562496,4699200
validation,455,16,12288,256,36864,49152
validation,456,124,95232,15376,2214144,2309376
validation,457,73,56064,5329,767376,823440
validation,458,30,23040,900,129600,152640
validation,459,38,29184,1444,207936,237120
validation,460,40,30720,1600,230400,261120
validation,461,49,37632,2401,345744,383376
validation,462,74,56832,5476,788544,845376
validation,463,241,185088,58081,8363664,8548752
validation,464,75,57600,5625,810000,867600
validation,465,63,48384,3969,571536,619920
validation,466,211,162048,44521,6411024,6573072
validation,467,28,21504,784,112896,134400
validation,468,26,19968,676,97344,117312
validation,469,67,51456,4489,646416,697872
validation,470,52,39936,2704,389376,429312
validation,471,76,58368,5776,831744,890112
validation,472,114,87552,12996,1871424,1958976
validation,473,29,22272,841,121104,143376
validation,474,18,13824,324,46656,60480
validation,475,14,10752,196,28224,38976
validation,476,12,9216,144,20736,29952
validation,477,101,77568,10201,1468944,1546512
validation,478,402,308736,161604,23270976,23579712
validation,479,68,52224,4624,665856,718080
validation,480,13,9984,169,24336,34320
validation,481,102,78336,10404,1498176,1576512
validation,482,116,89088,13456,1937664,2026752
validation,483,79,60672,6241,898704,959376
validation,484,126,96768,15876,2286144,2382912
validation,485,287,220416,82369,11861136,12081552
validation,486,97,74496,9409,1354896,1429392
validation,487,39,29952,1521,219024,248976
validation,488,105,80640,11025,1587600,1668240
validation,489,105,80640,11025,1587600,1668240
validation,490,15,11520,225,32400,43920
validation,491,18,13824,324,46656,60480
validation,492,16,12288,256,36864,49152
validation,493,86,66048,7396,1065024,1131072
validation,494,34,26112,1156,166464,192576
validation,495,68,52224,4624,665856,718080
validation,496,61,46848,3721,535824,582672
validation,497,243,186624,59049,8503056,8689680
validation,498,95,72960,9025,1299600,1372560
validation,499,123,94464,15129,2178576,2273040
validation,500,97,74496,9409,1354896,1429392
validation,501,53,40704,2809,404496,445200
validation,502,211,162048,44521,6411024,6573072
validation,503,22,16896,484,69696,86592
validation,504,49,37632,2401,345744,383376
validation,505,89,68352,7921,1140624,1208976
validation,506,98,75264,9604,1382976,1458240
validation,507,101,77568,10201,1468944,1546512
validation,508,512,393216,262144,37748736,38141952
validation,509,309,237312,95481,13749264,13986576
validation,510,43,33024,1849,266256,299280
validation,511,336,258048,112896,16257024,16515072
validation,512,117,89856,13689,1971216,2061072
validation,513,42,32256,1764,254016,286272
validation,514,94,72192,8836,1272384,1344576
validation,515,387,297216,149769,21566736,21863952
validation,516,74,56832,5476,788544,845376
validation,517,491,377088,241081,34715664,35092752
validation,518,130,99840,16900,2433600,2533440
validation,519,81,62208,6561,944784,1006992
validation,520,125,96000,15625,2250000,2346000
validation,521,28,21504,784,112896,134400
validation,522,47,36096,2209,318096,354192
validation,523,21,16128,441,63504,79632
validation,524,96,73728,9216,1327104,1400832
validation,525,198,152064,39204,5645376,5797440
validation,526,164,125952,26896,3873024,3998976
validation,527,85,65280,7225,1040400,1105680
validation,528,411,315648,168921,24324624,24640272
validation,529,14,10752,196,28224,38976
validation,530,154,118272,23716,3415104,3533376
validation,531,89,68352,7921,1140624,1208976
validation,532,54,41472,2916,419904,461376
validation,533,121,92928,14641,2108304,2201232
validation,534,113,86784,12769,1838736,1925520
validation,535,211,162048,44521,6411024,6573072
validation,536,58,44544,3364,484416,528960
validation,537,24,18432,576,82944,101376
validation,538,96,73728,9216,1327104,1400832
validation,539,122,93696,14884,2143296,2236992
validation,540,70,53760,4900,705600,759360
validation,541,299,229632,89401,12873744,13103376
validation,542,64,49152,4096,589824,638976
validation,543,11,8448,121,17424,25872
validation,544,26,19968,676,97344,117312
validation,545,30,23040,900,129600,152640
validation,546,106,81408,11236,1617984,1699392
validation,547,128,98304,16384,2359296,2457600
validation,548,100,76800,10000,1440000,1516800
validation,549,82,62976,6724,968256,1031232
validation,550,59,45312,3481,501264,546576
validation,551,512,393216,262144,37748736,38141952
validation,552,90,69120,8100,1166400,1235520
validation,553,65,49920,4225,608400,658320
validation,554,18,13824,324,46656,60480
validation,555,167,128256,27889,4016016,4144272
validation,556,72,55296,5184,746496,801792
validation,557,95,72960,9025,1299600,1372560
validation,558,42,32256,1764,254016,286272
validation,559,94,72192,8836,1272384,1344576
validation,560,34,26112,1156,166464,192576
validation,561,98,75264,9604,1382976,1458240
validation,562,109,83712,11881,1710864,1794576
validation,563,86,66048,7396,1065024,1131072
validation,564,132,101376,17424,2509056,2610432
validation,565,71,54528,5041,725904,780432
validation,566,99,76032,9801,1411344,1487376
validation,567,61,46848,3721,535824,582672
validation,568,28,21504,784,112896,134400
validation,569,26,19968,676,97344,117312
validation,570,57,43776,3249,467856,511632
validation,571,223,171264,49729,7160976,7332240
validation,572,31,23808,961,138384,162192
validation,573,266,204288,70756,10188864,10393152
validation,574,26,19968,676,97344,117312
validation,575,147,112896,21609,3111696,3224592
validation,576,42,32256,1764,254016,286272
validation,577,137,105216,18769,2702736,2807952
validation,578,72,55296,5184,746496,801792
validation,579,63,48384,3969,571536,619920
validation,580,81,62208,6561,944784,1006992
validation,581,27,20736,729,104976,125712
validation,582,206,158208,42436,6110784,6268992
validation,583,72,55296,5184,746496,801792
validation,584,15,11520,225,32400,43920
validation,585,104,79872,10816,1557504,1637376
validation,586,330,253440,108900,15681600,15935040
validation,587,512,393216,262144,37748736,38141952
validation,588,88,67584,7744,1115136,1182720
validation,589,23,17664,529,76176,93840
validation,590,236,181248,55696,8020224,8201472
validation,591,92,70656,8464,1218816,1289472
validation,592,335,257280,112225,16160400,16417680
validation,593,365,280320,133225,19184400,19464720
validation,594,48,36864,2304,331776,368640
validation,595,98,75264,9604,1382976,1458240
validation,596,87,66816,7569,1089936,1156752
validation,597,39,29952,1521,219024,248976
validation,598,43,33024,1849,266256,299280
validation,599,27,20736,729,104976,125712
validation,600,512,393216,262144,37748736,38141952
validation,601,114,87552,12996,1871424,1958976
validation,602,34,26112,1156,166464,192576
validation,603,131,100608,17161,2471184,2571792
validation,604,21,16128,441,63504,79632
validation,605,71,54528,5041,725904,780432
validation,606,51,39168,2601,374544,413712
validation,607,13,9984,169,24336,34320
validation,608,78,59904,6084,876096,936000
validation,609,81,62208,6561,944784,1006992
validation,610,64,49152,4096,589824,638976
validation,611,65,49920,4225,608400,658320
validation,612,35,26880,1225,176400,203280
validation,613,27,20736,729,104976,125712
validation,614,16,12288,256,36864,49152
validation,615,359,275712,128881,18558864,18834576
validation,616,86,66048,7396,1065024,1131072
validation,617,10,7680,100,14400,22080
validation,618,144,110592,20736,2985984,3096576
validation,619,48,36864,2304,331776,368640
validation,620,160,122880,25600,3686400,3809280
validation,621,214,164352,45796,6594624,6758976
validation,622,72,55296,5184,746496,801792
validation,623,93,71424,8649,1245456,1316880
validation,624,93,71424,8649,1245456,1316880
validation,625,50,38400,2500,360000,398400
validation,626,29,22272,841,121104,143376
validation,627,99,76032,9801,1411344,1487376
validation,628,338,259584,114244,16451136,16710720
validation,629,155,119040,24025,3459600,3578640
validation,630,73,56064,5329,767376,823440
validation,631,33,25344,1089,156816,182160
validation,632,308,236544,94864,13660416,13896960
validation,633,56,43008,3136,451584,494592
validation,634,68,52224,4624,665856,718080
validation,635,29,22272,841,121104,143376
validation,636,48,36864,2304,331776,368640
validation,637,302,231936,91204,13133376,13365312
validation,638,239,183552,57121,8225424,8408976
validation,639,109,83712,11881,1710864,1794576
validation,640,62,47616,3844,553536,601152
validation,641,44,33792,1936,278784,312576
validation,642,29,22272,841,121104,143376
validation,643,112,86016,12544,1806336,1892352
validation,644,101,77568,10201,1468944,1546512
validation,645,35,26880,1225,176400,203280
validation,646,141,108288,19881,2862864,2971152
validation,647,29,22272,841,121104,143376
validation,648,46,35328,2116,304704,340032
validation,649,25,19200,625,90000,109200
validation,650,101,77568,10201,1468944,1546512
validation,651,27,20736,729,104976,125712
validation,652,96,73728,9216,1327104,1400832
validation,653,34,26112,1156,166464,192576
validation,654,127,97536,16129,2322576,2420112
validation,655,118,90624,13924,2005056,2095680
validation,656,81,62208,6561,944784,1006992
validation,657,441,338688,194481,28005264,28343952
validation,658,71,54528,5041,725904,780432
validation,659,17,13056,289,41616,54672
validation,660,75,57600,5625,810000,867600
validation,661,44,33792,1936,278784,312576
validation,662,43,33024,1849,266256,299280
validation,663,132,101376,17424,2509056,2610432
validation,664,100,76800,10000,1440000,1516800
validation,665,113,86784,12769,1838736,1925520
validation,666,28,21504,784,112896,134400
validation,667,300,230400,90000,12960000,13190400
validation,668,81,62208,6561,944784,1006992
validation,669,39,29952,1521,219024,248976
validation,670,295,226560,87025,12531600,12758160
validation,671,127,97536,16129,2322576,2420112
validation,672,176,135168,30976,4460544,4595712
validation,673,98,75264,9604,1382976,1458240
validation,674,77,59136,5929,853776,912912
validation,675,87,66816,7569,1089936,1156752
validation,676,78,59904,6084,876096,936000
validation,677,120,92160,14400,2073600,2165760
validation,678,512,393216,262144,37748736,38141952
validation,679,24,18432,576,82944,101376
validation,680,72,55296,5184,746496,801792
validation,681,216,165888,46656,6718464,6884352
validation,682,382,293376,145924,21013056,21306432
validation,683,77,59136,5929,853776,912912
validation,684,253,194304,64009,9217296,9411600
validation,685,160,122880,25600,3686400,3809280
validation,686,85,65280,7225,1040400,1105680
validation,687,123,94464,15129,2178576,2273040
validation,688,113,86784,12769,1838736,1925520
validation,689,112,86016,12544,1806336,1892352
validation,690,62,47616,3844,553536,601152
validation,691,91,69888,8281,1192464,1262352
validation,692,150,115200,22500,3240000,3355200
validation,693,26,19968,676,97344,117312
validation,694,108,82944,11664,1679616,1762560
validation,695,86,66048,7396,1065024,1131072
validation,696,115,88320,13225,1904400,1992720
validation,697,119,91392,14161,2039184,2130576
validation,698,159,122112,25281,3640464,3762576
validation,699,62,47616,3844,553536,601152
validation,700,32,24576,1024,147456,172032
validation,701,71,54528,5041,725904,780432
validation,702,78,59904,6084,876096,936000
validation,703,42,32256,1764,254016,286272
validation,704,26,19968,676,97344,117312
validation,705,48,36864,2304,331776,368640
validation,706,73,56064,5329,767376,823440
validation,707,254,195072,64516,9290304,9485376
validation,708,110,84480,12100,1742400,1826880
validation,709,30,23040,900,129600,152640
validation,710,48,36864,2304,331776,368640
validation,711,301,231168,90601,13046544,13277712
validation,712,58,44544,3364,484416,528960
validation,713,16,12288,256,36864,49152
validation,714,47,36096,2209,318096,354192
validation,715,22,16896,484,69696,86592
validation,716,16,12288,256,36864,49152
validation,717,24,18432,576,82944,101376
validation,718,136,104448,18496,2663424,2767872
validation,719,66,50688,4356,627264,677952
validation,720,66,50688,4356,627264,677952
validation,721,68,52224,4624,665856,718080
validation,722,11,8448,121,17424,25872
validation,723,93,71424,8649,1245456,1316880
validation,724,214,164352,45796,6594624,6758976
validation,725,48,36864,2304,331776,368640
validation,726,114,87552,12996,1871424,1958976
validation,727,128,98304,16384,2359296,2457600
validation,728,113,86784,12769,1838736,1925520
validation,729,103,79104,10609,1527696,1606800
validation,730,185,142080,34225,4928400,5070480
validation,731,512,393216,262144,37748736,38141952
validation,732,120,92160,14400,2073600,2165760
validation,733,102,78336,10404,1498176,1576512
validation,734,77,59136,5929,853776,912912
validation,735,18,13824,324,46656,60480
validation,736,273,209664,74529,10732176,10941840
validation,737,15,11520,225,32400,43920
validation,738,72,55296,5184,746496,801792
validation,739,250,192000,62500,9000000,9192000
validation,740,188,144384,35344,5089536,5233920
validation,741,360,276480,129600,18662400,18938880
validation,742,262,201216,68644,9884736,10085952
validation,743,81,62208,6561,944784,1006992
validation,744,95,72960,9025,1299600,1372560
validation,745,201,154368,40401,5817744,5972112
validation,746,108,82944,11664,1679616,1762560
validation,747,82,62976,6724,968256,1031232
validation,748,145,111360,21025,3027600,3138960
validation,749,67,51456,4489,646416,697872
validation,750,129,99072,16641,2396304,2495376
validation,751,172,132096,29584,4260096,4392192
validation,752,40,30720,1600,230400,261120
validation,753,136,104448,18496,2663424,2767872
validation,754,44,33792,1936,278784,312576
validation,755,512,393216,262144,37748736,38141952
validation,756,40,30720,1600,230400,261120
validation,757,86,66048,7396,1065024,1131072
validation,758,19,14592,361,51984,66576
validation,759,134,102912,17956,2585664,2688576
validation,760,15,11520,225,32400,43920
validation,761,84,64512,7056,1016064,1080576
validation,762,66,50688,4356,627264,677952
validation,763,112,86016,12544,1806336,1892352
validation,764,83,63744,6889,992016,1055760
validation,765,88,67584,7744,1115136,1182720
validation,766,403,309504,162409,23386896,23696400
validation,767,47,36096,2209,318096,354192
validation,768,123,94464,15129,2178576,2273040
validation,769,58,44544,3364,484416,528960
validation,770,49,37632,2401,345744,383376
validation,771,41,31488,1681,242064,273552
validation,772,119,91392,14161,2039184,2130576
validation,773,16,12288,256,36864,49152
validation,774,101,77568,10201,1468944,1546512
validation,775,54,41472,2916,419904,461376
validation,776,70,53760,4900,705600,759360
validation,777,52,39936,2704,389376,429312
validation,778,49,37632,2401,345744,383376
validation,779,17,13056,289,41616,54672
validation,780,276,211968,76176,10969344,11181312
validation,781,66,50688,4356,627264,677952
validation,782,61,46848,3721,535824,582672
validation,783,64,49152,4096,589824,638976
validation,784,43,33024,1849,266256,299280
validation,785,51,39168,2601,374544,413712
validation,786,86,66048,7396,1065024,1131072
validation,787,17,13056,289,41616,54672
validation,788,512,393216,262144,37748736,38141952
validation,789,233,178944,54289,7817616,7996560
validation,790,43,33024,1849,266256,299280
validation,791,475,364800,225625,32490000,32854800
validation,792,86,66048,7396,1065024,1131072
validation,793,84,64512,7056,1016064,1080576
validation,794,89,68352,7921,1140624,1208976
validation,795,87,66816,7569,1089936,1156752
validation,796,65,49920,4225,608400,658320
validation,797,14,10752,196,28224,38976
validation,798,15,11520,225,32400,43920
validation,799,38,29184,1444,207936,237120
validation,800,26,19968,676,97344,117312
validation,801,32,24576,1024,147456,172032
validation,802,113,86784,12769,1838736,1925520
validation,803,56,43008,3136,451584,494592
validation,804,106,81408,11236,1617984,1699392
validation,805,75,57600,5625,810000,867600
validation,806,52,39936,2704,389376,429312
validation,807,186,142848,34596,4981824,5124672
validation,808,68,52224,4624,665856,718080
validation,809,50,38400,2500,360000,398400
validation,810,56,43008,3136,451584,494592
validation,811,171,131328,29241,4210704,4342032
validation,812,49,37632,2401,345744,383376
validation,813,135,103680,18225,2624400,2728080
validation,814,79,60672,6241,898704,959376
validation,815,88,67584,7744,1115136,1182720
validation,816,181,139008,32761,4717584,4856592
validation,817,124,95232,15376,2214144,2309376
validation,818,231,177408,53361,7683984,7861392
validation,819,209,160512,43681,6290064,6450576
validation,820,121,92928,14641,2108304,2201232
validation,821,35,26880,1225,176400,203280
validation,822,211,162048,44521,6411024,6573072
validation,823,51,39168,2601,374544,413712
validation,824,78,59904,6084,876096,936000
validation,825,59,45312,3481,501264,546576
validation,826,59,45312,3481,501264,546576
validation,827,90,69120,8100,1166400,1235520
validation,828,111,85248,12321,1774224,1859472
validation,829,237,182016,56169,8088336,8270352
validation,830,140,107520,19600,2822400,2929920
validation,831,68,52224,4624,665856,718080
validation,832,66,50688,4356,627264,677952
validation,833,54,41472,2916,419904,461376
validation,834,78,59904,6084,876096,936000
validation,835,350,268800,122500,17640000,17908800
validation,836,58,44544,3364,484416,528960
validation,837,106,81408,11236,1617984,1699392
validation,838,512,393216,262144,37748736,38141952
validation,839,25,19200,625,90000,109200
validation,840,27,20736,729,104976,125712
validation,841,77,59136,5929,853776,912912
validation,842,118,90624,13924,2005056,2095680
validation,843,32,24576,1024,147456,172032
validation,844,74,56832,5476,788544,845376
validation,845,129,99072,16641,2396304,2495376
validation,846,89,68352,7921,1140624,1208976
validation,847,48,36864,2304,331776,368640
validation,848,70,53760,4900,705600,759360
validation,849,137,105216,18769,2702736,2807952
validation,850,112,86016,12544,1806336,1892352
validation,851,61,46848,3721,535824,582672
validation,852,147,112896,21609,3111696,3224592
validation,853,156,119808,24336,3504384,3624192
validation,854,55,42240,3025,435600,477840
validation,855,94,72192,8836,1272384,1344576
validation,856,67,51456,4489,646416,697872
validation,857,512,393216,262144,37748736,38141952
validation,858,46,35328,2116,304704,340032
validation,859,112,86016,12544,1806336,1892352
validation,860,61,46848,3721,535824,582672
validation,861,90,69120,8100,1166400,1235520
validation,862,62,47616,3844,553536,601152
validation,863,98,75264,9604,1382976,1458240
validation,864,214,164352,45796,6594624,6758976
validation,865,36,27648,1296,186624,214272
validation,866,313,240384,97969,14107536,14347920
validation,867,113,86784,12769,1838736,1925520
validation,868,47,36096,2209,318096,354192
validation,869,225,172800,50625,7290000,7462800
validation,870,73,56064,5329,767376,823440
validation,871,93,71424,8649,1245456,1316880
validation,872,50,38400,2500,360000,398400
validation,873,110,84480,12100,1742400,1826880
validation,874,220,168960,48400,6969600,7138560
validation,875,68,52224,4624,665856,718080
validation,876,27,20736,729,104976,125712
validation,877,18,13824,324,46656,60480
validation,878,409,314112,167281,24088464,24402576
validation,879,51,39168,2601,374544,413712
validation,880,16,12288,256,36864,49152
validation,881,86,66048,7396,1065024,1131072
validation,882,512,393216,262144,37748736,38141952
validation,883,48,36864,2304,331776,368640
validation,884,27,20736,729,104976,125712
validation,885,59,45312,3481,501264,546576
validation,886,28,21504,784,112896,134400
validation,887,37,28416,1369,197136,225552
validation,888,107,82176,11449,1648656,1730832
validation,889,109,83712,11881,1710864,1794576
validation,890,107,82176,11449,1648656,1730832
validation,891,157,120576,24649,3549456,3670032
validation,892,72,55296,5184,746496,801792
validation,893,207,158976,42849,6170256,6329232
validation,894,48,36864,2304,331776,368640
validation,895,378,290304,142884,20575296,20865600
validation,896,287,220416,82369,11861136,12081552
validation,897,82,62976,6724,968256,1031232
validation,898,48,36864,2304,331776,368640
validation,899,73,56064,5329,767376,823440
validation,900,14,10752,196,28224,38976
validation,901,109,83712,11881,1710864,1794576
validation,902,54,41472,2916,419904,461376
validation,903,24,18432,576,82944,101376
validation,904,63,48384,3969,571536,619920
validation,905,171,131328,29241,4210704,4342032
validation,906,26,19968,676,97344,117312
validation,907,70,53760,4900,705600,759360
validation,908,31,23808,961,138384,162192
validation,909,44,33792,1936,278784,312576
validation,910,176,135168,30976,4460544,4595712
validation,911,70,53760,4900,705600,759360
validation,912,260,199680,67600,9734400,9934080
validation,913,42,32256,1764,254016,286272
validation,914,42,32256,1764,254016,286272
validation,915,67,51456,4489,646416,697872
validation,916,57,43776,3249,467856,511632
validation,917,146,112128,21316,3069504,3181632
validation,918,107,82176,11449,1648656,1730832
validation,919,44,33792,1936,278784,312576
validation,920,64,49152,4096,589824,638976
validation,921,47,36096,2209,318096,354192
validation,922,48,36864,2304,331776,368640
validation,923,28,21504,784,112896,134400
validation,924,43,33024,1849,266256,299280
validation,925,54,41472,2916,419904,461376
validation,926,26,19968,676,97344,117312
validation,927,56,43008,3136,451584,494592
validation,928,295,226560,87025,12531600,12758160
validation,929,29,22272,841,121104,143376
validation,930,55,42240,3025,435600,477840
validation,931,101,77568,10201,1468944,1546512
validation,932,76,58368,5776,831744,890112
validation,933,62,47616,3844,553536,601152
validation,934,112,86016,12544,1806336,1892352
validation,935,16,12288,256,36864,49152
validation,936,141,108288,19881,2862864,2971152
validation,937,16,12288,256,36864,49152
validation,938,76,58368,5776,831744,890112
validation,939,369,283392,136161,19607184,19890576
validation,940,86,66048,7396,1065024,1131072
validation,941,143,109824,20449,2944656,3054480
validation,942,198,152064,39204,5645376,5797440
validation,943,62,47616,3844,553536,601152
validation,944,230,176640,52900,7617600,7794240
validation,945,54,41472,2916,419904,461376
validation,946,34,26112,1156,166464,192576
validation,947,56,43008,3136,451584,494592
validation,948,75,57600,5625,810000,867600
validation,949,512,393216,262144,37748736,38141952
validation,950,133,102144,17689,2547216,2649360
validation,951,50,38400,2500,360000,398400
validation,952,189,145152,35721,5143824,5288976
validation,953,35,26880,1225,176400,203280
validation,954,90,69120,8100,1166400,1235520
validation,955,222,170496,49284,7096896,7267392
validation,956,81,62208,6561,944784,1006992
validation,957,75,57600,5625,810000,867600
validation,958,112,86016,12544,1806336,1892352
validation,959,54,41472,2916,419904,461376
validation,960,25,19200,625,90000,109200
validation,961,43,33024,1849,266256,299280
validation,962,29,22272,841,121104,143376
validation,963,68,52224,4624,665856,718080
validation,964,134,102912,17956,2585664,2688576
validation,965,98,75264,9604,1382976,1458240
validation,966,67,51456,4489,646416,697872
validation,967,23,17664,529,76176,93840
validation,968,93,71424,8649,1245456,1316880
validation,969,221,169728,48841,7033104,7202832
validation,970,34,26112,1156,166464,192576
validation,971,72,55296,5184,746496,801792
validation,972,31,23808,961,138384,162192
validation,973,61,46848,3721,535824,582672
validation,974,89,68352,7921,1140624,1208976
validation,975,107,82176,11449,1648656,1730832
validation,976,65,49920,4225,608400,658320
validation,977,200,153600,40000,5760000,5913600
validation,978,171,131328,29241,4210704,4342032
validation,979,44,33792,1936,278784,312576
validation,980,99,76032,9801,1411344,1487376
validation,981,42,32256,1764,254016,286272
validation,982,40,30720,1600,230400,261120
validation,983,103,79104,10609,1527696,1606800
validation,984,12,9216,144,20736,29952
validation,985,80,61440,6400,921600,983040
validation,986,345,264960,119025,17139600,17404560
validation,987,65,49920,4225,608400,658320
validation,988,143,109824,20449,2944656,3054480
validation,989,62,47616,3844,553536,601152
validation,990,98,75264,9604,1382976,1458240
validation,991,231,177408,53361,7683984,7861392
validation,992,74,56832,5476,788544,845376
validation,993,126,96768,15876,2286144,2382912
validation,994,76,58368,5776,831744,890112
validation,995,289,221952,83521,12027024,12248976
validation,996,31,23808,961,138384,162192
validation,997,80,61440,6400,921600,983040
validation,998,489,375552,239121,34433424,34808976
validation,999,84,64512,7056,1016064,1080576
validation,1000,313,240384,97969,14107536,14347920
validation,1001,54,41472,2916,419904,461376
validation,1002,78,59904,6084,876096,936000
validation,1003,299,229632,89401,12873744,13103376
validation,1004,29,22272,841,121104,143376
validation,1005,153,117504,23409,3370896,3488400
validation,1006,20,15360,400,57600,72960
validation,1007,70,53760,4900,705600,759360
validation,1008,406,311808,164836,23736384,24048192
validation,1009,18,13824,324,46656,60480
validation,1010,82,62976,6724,968256,1031232
validation,1011,332,254976,110224,15872256,16127232
validation,1012,159,122112,25281,3640464,3762576
validation,1013,114,87552,12996,1871424,1958976
validation,1014,115,88320,13225,1904400,1992720
validation,1015,48,36864,2304,331776,368640
validation,1016,284,218112,80656,11614464,11832576
validation,1017,149,114432,22201,3196944,3311376
validation,1018,60,46080,3600,518400,564480
validation,1019,28,21504,784,112896,134400
validation,1020,484,371712,234256,33732864,34104576
validation,1021,322,247296,103684,14930496,15177792
validation,1022,78,59904,6084,876096,936000
validation,1023,422,324096,178084,25644096,25968192
validation,1024,90,69120,8100,1166400,1235520
validation,1025,194,148992,37636,5419584,5568576
validation,1026,34,26112,1156,166464,192576
validation,1027,27,20736,729,104976,125712
validation,1028,29,22272,841,121104,143376
validation,1029,26,19968,676,97344,117312
validation,1030,83,63744,6889,992016,1055760
validation,1031,335,257280,112225,16160400,16417680
validation,1032,40,30720,1600,230400,261120
validation,1033,110,84480,12100,1742400,1826880
validation,1034,120,92160,14400,2073600,2165760
validation,1035,41,31488,1681,242064,273552
validation,1036,67,51456,4489,646416,697872
validation,1037,247,189696,61009,8785296,8974992
validation,1038,15,11520,225,32400,43920
validation,1039,68,52224,4624,665856,718080
validation,1040,512,393216,262144,37748736,38141952
validation,1041,62,47616,3844,553536,601152
validation,1042,512,393216,262144,37748736,38141952
validation,1043,123,94464,15129,2178576,2273040
validation,1044,58,44544,3364,484416,528960
validation,1045,27,20736,729,104976,125712
validation,1046,160,122880,25600,3686400,3809280
validation,1047,71,54528,5041,725904,780432
validation,1048,38,29184,1444,207936,237120
validation,1049,61,46848,3721,535824,582672
validation,1050,14,10752,196,28224,38976
validation,1051,112,86016,12544,1806336,1892352
validation,1052,95,72960,9025,1299600,1372560
validation,1053,117,89856,13689,1971216,2061072
validation,1054,30,23040,900,129600,152640
validation,1055,111,85248,12321,1774224,1859472
validation,1056,106,81408,11236,1617984,1699392
validation,1057,223,171264,49729,7160976,7332240
validation,1058,53,40704,2809,404496,445200
validation,1059,191,146688,36481,5253264,5399952
validation,1060,107,82176,11449,1648656,1730832
validation,1061,31,23808,961,138384,162192
validation,1062,66,50688,4356,627264,677952
validation,1063,238,182784,56644,8156736,8339520
validation,1064,86,66048,7396,1065024,1131072
validation,1065,169,129792,28561,4112784,4242576
validation,1066,19,14592,361,51984,66576
validation,1067,13,9984,169,24336,34320
validation,1068,17,13056,289,41616,54672
validation,1069,37,28416,1369,197136,225552
validation,1070,31,23808,961,138384,162192
validation,1071,326,250368,106276,15303744,15554112
validation,1072,72,55296,5184,746496,801792
validation,1073,53,40704,2809,404496,445200
validation,1074,30,23040,900,129600,152640
validation,1075,68,52224,4624,665856,718080
validation,1076,385,295680,148225,21344400,21640080
validation,1077,75,57600,5625,810000,867600
validation,1078,230,176640,52900,7617600,7794240
validation,1079,44,33792,1936,278784,312576
validation,1080,16,12288,256,36864,49152
validation,1081,104,79872,10816,1557504,1637376
validation,1082,16,12288,256,36864,49152
validation,1083,200,153600,40000,5760000,5913600
validation,1084,163,125184,26569,3825936,3951120
validation,1085,33,25344,1089,156816,182160
validation,1086,15,11520,225,32400,43920
validation,1087,51,39168,2601,374544,413712
validation,1088,32,24576,1024,147456,172032
validation,1089,329,252672,108241,15586704,15839376
validation,1090,41,31488,1681,242064,273552
validation,1091,85,65280,7225,1040400,1105680
validation,1092,242,185856,58564,8433216,8619072
validation,1093,87,66816,7569,1089936,1156752
validation,1094,103,79104,10609,1527696,1606800
validation,1095,26,19968,676,97344,117312
validation,1096,17,13056,289,41616,54672
test,0,106,81408,11236,1617984,1699392
test,1,100,76800,10000,1440000,1516800
test,2,85,65280,7225,1040400,1105680
test,3,55,42240,3025,435600,477840
test,4,67,51456,4489,646416,697872
test,5,37,28416,1369,197136,225552
test,6,124,95232,15376,2214144,2309376
test,7,67,51456,4489,646416,697872
test,8,61,46848,3721,535824,582672
test,9,103,79104,10609,1527696,1606800
test,10,12,9216,144,20736,29952
test,11,471,361728,221841,31945104,32306832
test,12,93,71424,8649,1245456,1316880
test,13,217,166656,47089,6780816,6947472
test,14,150,115200,22500,3240000,3355200
test,15,248,190464,61504,8856576,9047040
test,16,192,147456,36864,5308416,5455872
test,17,41,31488,1681,242064,273552
test,18,229,175872,52441,7551504,7727376
test,19,15,11520,225,32400,43920
test,20,124,95232,15376,2214144,2309376
test,21,27,20736,729,104976,125712
test,22,145,111360,21025,3027600,3138960
test,23,68,52224,4624,665856,718080
test,24,51,39168,2601,374544,413712
test,25,197,151296,38809,5588496,5739792
test,26,60,46080,3600,518400,564480
test,27,100,76800,10000,1440000,1516800
test,28,105,80640,11025,1587600,1668240
test,29,129,99072,16641,2396304,2495376
test,30,119,91392,14161,2039184,2130576
test,31,44,33792,1936,278784,312576
test,32,51,39168,2601,374544,413712
test,33,180,138240,32400,4665600,4803840
test,34,13,9984,169,24336,34320
test,35,92,70656,8464,1218816,1289472
test,36,132,101376,17424,2509056,2610432
test,37,29,22272,841,121104,143376
test,38,108,82944,11664,1679616,1762560
test,39,56,43008,3136,451584,494592
test,40,111,85248,12321,1774224,1859472
test,41,26,19968,676,97344,117312
test,42,115,88320,13225,1904400,1992720
test,43,89,68352,7921,1140624,1208976
test,44,137,105216,18769,2702736,2807952
test,45,14,10752,196,28224,38976
test,46,65,49920,4225,608400,658320
test,47,104,79872,10816,1557504,1637376
test,48,82,62976,6724,968256,1031232
test,49,71,54528,5041,725904,780432
test,50,53,40704,2809,404496,445200
test,51,109,83712,11881,1710864,1794576
test,52,49,37632,2401,345744,383376
test,53,101,77568,10201,1468944,1546512
test,54,76,58368,5776,831744,890112
test,55,17,13056,289,41616,54672
test,56,29,22272,841,121104,143376
test,57,84,64512,7056,1016064,1080576
test,58,92,70656,8464,1218816,1289472
test,59,37,28416,1369,197136,225552
test,60,17,13056,289,41616,54672
test,61,244,187392,59536,8573184,8760576
test,62,53,40704,2809,404496,445200
test,63,80,61440,6400,921600,983040
test,64,45,34560,2025,291600,326160
test,65,81,62208,6561,944784,1006992
test,66,38,29184,1444,207936,237120
test,67,107,82176,11449,1648656,1730832
test,68,65,49920,4225,608400,658320
test,69,122,93696,14884,2143296,2236992
test,70,86,66048,7396,1065024,1131072
test,71,45,34560,2025,291600,326160
test,72,67,51456,4489,646416,697872
test,73,118,90624,13924,2005056,2095680
test,74,46,35328,2116,304704,340032
test,75,61,46848,3721,535824,582672
test,76,30,23040,900,129600,152640
test,77,149,114432,22201,3196944,3311376
test,78,14,10752,196,28224,38976
test,79,97,74496,9409,1354896,1429392
test,80,65,49920,4225,608400,658320
test,81,59,45312,3481,501264,546576
test,82,159,122112,25281,3640464,3762576
test,83,55,42240,3025,435600,477840
test,84,112,86016,12544,1806336,1892352
test,85,94,72192,8836,1272384,1344576
test,86,116,89088,13456,1937664,2026752
test,87,122,93696,14884,2143296,2236992
test,88,113,86784,12769,1838736,1925520
test,89,233,178944,54289,7817616,7996560
test,90,194,148992,37636,5419584,5568576
test,91,43,33024,1849,266256,299280
test,92,54,41472,2916,419904,461376
test,93,145,111360,21025,3027600,3138960
test,94,34,26112,1156,166464,192576
test,95,170,130560,28900,4161600,4292160
test,96,84,64512,7056,1016064,1080576
test,97,60,46080,3600,518400,564480
test,98,126,96768,15876,2286144,2382912
test,99,42,32256,1764,254016,286272
test,100,30,23040,900,129600,152640
test,101,497,381696,247009,35569296,35950992
test,102,97,74496,9409,1354896,1429392
test,103,51,39168,2601,374544,413712
test,104,111,85248,12321,1774224,1859472
test,105,111,85248,12321,1774224,1859472
test,106,100,76800,10000,1440000,1516800
test,107,117,89856,13689,1971216,2061072
test,108,68,52224,4624,665856,718080
test,109,26,19968,676,97344,117312
test,110,89,68352,7921,1140624,1208976
test,111,112,86016,12544,1806336,1892352
test,112,34,26112,1156,166464,192576
test,113,52,39936,2704,389376,429312
test,114,107,82176,11449,1648656,1730832
test,115,68,52224,4624,665856,718080
test,116,200,153600,40000,5760000,5913600
test,117,214,164352,45796,6594624,6758976
test,118,162,124416,26244,3779136,3903552
test,119,103,79104,10609,1527696,1606800
test,120,93,71424,8649,1245456,1316880
test,121,19,14592,361,51984,66576
test,122,28,21504,784,112896,134400
test,123,17,13056,289,41616,54672
test,124,26,19968,676,97344,117312
test,125,28,21504,784,112896,134400
test,126,110,84480,12100,1742400,1826880
test,127,94,72192,8836,1272384,1344576
test,128,378,290304,142884,20575296,20865600
test,129,369,283392,136161,19607184,19890576
test,130,11,8448,121,17424,25872
test,131,52,39936,2704,389376,429312
test,132,77,59136,5929,853776,912912
test,133,56,43008,3136,451584,494592
test,134,50,38400,2500,360000,398400
test,135,108,82944,11664,1679616,1762560
test,136,103,79104,10609,1527696,1606800
test,137,61,46848,3721,535824,582672
test,138,306,235008,93636,13483584,13718592
test,139,51,39168,2601,374544,413712
test,140,236,181248,55696,8020224,8201472
test,141,78,59904,6084,876096,936000
test,142,149,114432,22201,3196944,3311376
test,143,65,49920,4225,608400,658320
test,144,83,63744,6889,992016,1055760
test,145,117,89856,13689,1971216,2061072
test,146,80,61440,6400,921600,983040
test,147,42,32256,1764,254016,286272
test,148,111,85248,12321,1774224,1859472
test,149,305,234240,93025,13395600,13629840
test,150,41,31488,1681,242064,273552
test,151,54,41472,2916,419904,461376
test,152,141,108288,19881,2862864,2971152
test,153,104,79872,10816,1557504,1637376
test,154,16,12288,256,36864,49152
test,155,165,126720,27225,3920400,4047120
test,156,232,178176,53824,7750656,7928832
test,157,29,22272,841,121104,143376
test,158,12,9216,144,20736,29952
test,159,269,206592,72361,10419984,10626576
test,160,200,153600,40000,5760000,5913600
test,161,36,27648,1296,186624,214272
test,162,310,238080,96100,13838400,14076480
test,163,249,191232,62001,8928144,9119376
test,164,373,286464,139129,20034576,20321040
test,165,215,165120,46225,6656400,6821520
test,166,66,50688,4356,627264,677952
test,167,44,33792,1936,278784,312576
test,168,273,209664,74529,10732176,10941840
test,169,504,387072,254016,36578304,36965376
test,170,90,69120,8100,1166400,1235520
test,171,29,22272,841,121104,143376
test,172,30,23040,900,129600,152640
test,173,77,59136,5929,853776,912912
test,174,12,9216,144,20736,29952
test,175,43,33024,1849,266256,299280
test,176,61,46848,3721,535824,582672
test,177,54,41472,2916,419904,461376
test,178,77,59136,5929,853776,912912
test,179,15,11520,225,32400,43920
test,180,78,59904,6084,876096,936000
test,181,15,11520,225,32400,43920
test,182,89,68352,7921,1140624,1208976
test,183,337,258816,113569,16353936,16612752
test,184,25,19200,625,90000,109200
test,185,59,45312,3481,501264,546576
test,186,54,41472,2916,419904,461376
test,187,15,11520,225,32400,43920
test,188,512,393216,262144,37748736,38141952
test,189,126,96768,15876,2286144,2382912
test,190,76,58368,5776,831744,890112
test,191,72,55296,5184,746496,801792
test,192,155,119040,24025,3459600,3578640
test,193,14,10752,196,28224,38976
test,194,78,59904,6084,876096,936000
test,195,92,70656,8464,1218816,1289472
test,196,494,379392,244036,35141184,35520576
test,197,121,92928,14641,2108304,2201232
test,198,130,99840,16900,2433600,2533440
test,199,45,34560,2025,291600,326160
test,200,101,77568,10201,1468944,1546512
test,201,14,10752,196,28224,38976
test,202,32,24576,1024,147456,172032
test,203,120,92160,14400,2073600,2165760
test,204,42,32256,1764,254016,286272
test,205,280,215040,78400,11289600,11504640
test,206,28,21504,784,112896,134400
test,207,77,59136,5929,853776,912912
test,208,38,29184,1444,207936,237120
test,209,512,393216,262144,37748736,38141952
test,210,33,25344,1089,156816,182160
test,211,103,79104,10609,1527696,1606800
test,212,298,228864,88804,12787776,13016640
test,213,21,16128,441,63504,79632
test,214,218,167424,47524,6843456,7010880
test,215,73,56064,5329,767376,823440
test,216,99,76032,9801,1411344,1487376
test,217,188,144384,35344,5089536,5233920
test,218,49,37632,2401,345744,383376
test,219,56,43008,3136,451584,494592
test,220,34,26112,1156,166464,192576
test,221,512,393216,262144,37748736,38141952
test,222,22,16896,484,69696,86592
test,223,16,12288,256,36864,49152
test,224,14,10752,196,28224,38976
test,225,62,47616,3844,553536,601152
test,226,401,307968,160801,23155344,23463312
test,227,62,47616,3844,553536,601152
test,228,43,33024,1849,266256,299280
test,229,99,76032,9801,1411344,1487376
test,230,95,72960,9025,1299600,1372560
test,231,77,59136,5929,853776,912912
test,232,37,28416,1369,197136,225552
test,233,38,29184,1444,207936,237120
test,234,124,95232,15376,2214144,2309376
test,235,512,393216,262144,37748736,38141952
test,236,143,109824,20449,2944656,3054480
test,237,124,95232,15376,2214144,2309376
test,238,176,135168,30976,4460544,4595712
test,239,69,52992,4761,685584,738576
test,240,184,141312,33856,4875264,5016576
test,241,149,114432,22201,3196944,3311376
test,242,28,21504,784,112896,134400
test,243,81,62208,6561,944784,1006992
test,244,73,56064,5329,767376,823440
test,245,47,36096,2209,318096,354192
test,246,151,115968,22801,3283344,3399312
test,247,254,195072,64516,9290304,9485376
test,248,216,165888,46656,6718464,6884352
test,249,86,66048,7396,1065024,1131072
test,250,34,26112,1156,166464,192576
test,251,78,59904,6084,876096,936000
test,252,25,19200,625,90000,109200
test,253,206,158208,42436,6110784,6268992
test,254,34,26112,1156,166464,192576
test,255,91,69888,8281,1192464,1262352
test,256,60,46080,3600,518400,564480
test,257,103,79104,10609,1527696,1606800
test,258,51,39168,2601,374544,413712
test,259,175,134400,30625,4410000,4544400
test,260,132,101376,17424,2509056,2610432
test,261,60,46080,3600,518400,564480
test,262,113,86784,12769,1838736,1925520
test,263,512,393216,262144,37748736,38141952
test,264,44,33792,1936,278784,312576
test,265,83,63744,6889,992016,1055760
test,266,90,69120,8100,1166400,1235520
test,267,22,16896,484,69696,86592
test,268,114,87552,12996,1871424,1958976
test,269,224,172032,50176,7225344,7397376
test,270,28,21504,784,112896,134400
test,271,13,9984,169,24336,34320
test,272,74,56832,5476,788544,845376
test,273,33,25344,1089,156816,182160
test,274,28,21504,784,112896,134400
test,275,71,54528,5041,725904,780432
test,276,61,46848,3721,535824,582672
test,277,60,46080,3600,518400,564480
test,278,14,10752,196,28224,38976
test,279,489,375552,239121,34433424,34808976
test,280,20,15360,400,57600,72960
test,281,64,49152,4096,589824,638976
test,282,26,19968,676,97344,117312
test,283,130,99840,16900,2433600,2533440
test,284,59,45312,3481,501264,546576
test,285,75,57600,5625,810000,867600
test,286,223,171264,49729,7160976,7332240
test,287,17,13056,289,41616,54672
test,288,115,88320,13225,1904400,1992720
test,289,111,85248,12321,1774224,1859472
test,290,15,11520,225,32400,43920
test,291,15,11520,225,32400,43920
test,292,35,26880,1225,176400,203280
test,293,123,94464,15129,2178576,2273040
test,294,41,31488,1681,242064,273552
test,295,37,28416,1369,197136,225552
test,296,34,26112,1156,166464,192576
test,297,18,13824,324,46656,60480
test,298,81,62208,6561,944784,1006992
test,299,15,11520,225,32400,43920
test,300,38,29184,1444,207936,237120
test,301,458,351744,209764,30206016,30557760
test,302,61,46848,3721,535824,582672
test,303,71,54528,5041,725904,780432
test,304,92,70656,8464,1218816,1289472
test,305,145,111360,21025,3027600,3138960
test,306,49,37632,2401,345744,383376
test,307,61,46848,3721,535824,582672
test,308,69,52992,4761,685584,738576
test,309,16,12288,256,36864,49152
test,310,77,59136,5929,853776,912912
test,311,52,39936,2704,389376,429312
test,312,122,93696,14884,2143296,2236992
test,313,103,79104,10609,1527696,1606800
test,314,247,189696,61009,8785296,8974992
test,315,70,53760,4900,705600,759360
test,316,48,36864,2304,331776,368640
test,317,17,13056,289,41616,54672
test,318,57,43776,3249,467856,511632
test,319,66,50688,4356,627264,677952
test,320,63,48384,3969,571536,619920
test,321,50,38400,2500,360000,398400
test,322,34,26112,1156,166464,192576
test,323,109,83712,11881,1710864,1794576
test,324,72,55296,5184,746496,801792
test,325,182,139776,33124,4769856,4909632
test,326,15,11520,225,32400,43920
test,327,62,47616,3844,553536,601152
test,328,30,23040,900,129600,152640
test,329,28,21504,784,112896,134400
test,330,322,247296,103684,14930496,15177792
test,331,98,75264,9604,1382976,1458240
test,332,183,140544,33489,4822416,4962960
test,333,120,92160,14400,2073600,2165760
test,334,113,86784,12769,1838736,1925520
test,335,98,75264,9604,1382976,1458240
test,336,110,84480,12100,1742400,1826880
test,337,347,266496,120409,17338896,17605392
test,338,103,79104,10609,1527696,1606800
test,339,69,52992,4761,685584,738576
test,340,86,66048,7396,1065024,1131072
test,341,45,34560,2025,291600,326160
test,342,44,33792,1936,278784,312576
test,343,470,360960,220900,31809600,32170560
test,344,54,41472,2916,419904,461376
test,345,67,51456,4489,646416,697872
test,346,30,23040,900,129600,152640
test,347,18,13824,324,46656,60480
test,348,123,94464,15129,2178576,2273040
test,349,75,57600,5625,810000,867600
test,350,49,37632,2401,345744,383376
test,351,40,30720,1600,230400,261120
test,352,239,183552,57121,8225424,8408976
test,353,64,49152,4096,589824,638976
test,354,72,55296,5184,746496,801792
test,355,36,27648,1296,186624,214272
test,356,28,21504,784,112896,134400
test,357,18,13824,324,46656,60480
test,358,130,99840,16900,2433600,2533440
test,359,89,68352,7921,1140624,1208976
test,360,305,234240,93025,13395600,13629840
test,361,122,93696,14884,2143296,2236992
test,362,60,46080,3600,518400,564480
test,363,120,92160,14400,2073600,2165760
test,364,16,12288,256,36864,49152
test,365,61,46848,3721,535824,582672
test,366,15,11520,225,32400,43920
test,367,181,139008,32761,4717584,4856592
test,368,201,154368,40401,5817744,5972112
test,369,38,29184,1444,207936,237120
test,370,78,59904,6084,876096,936000
test,371,55,42240,3025,435600,477840
test,372,123,94464,15129,2178576,2273040
test,373,28,21504,784,112896,134400
test,374,30,23040,900,129600,152640
test,375,110,84480,12100,1742400,1826880
test,376,20,15360,400,57600,72960
test,377,89,68352,7921,1140624,1208976
test,378,17,13056,289,41616,54672
test,379,61,46848,3721,535824,582672
test,380,150,115200,22500,3240000,3355200
test,381,35,26880,1225,176400,203280
test,382,110,84480,12100,1742400,1826880
test,383,28,21504,784,112896,134400
test,384,247,189696,61009,8785296,8974992
test,385,60,46080,3600,518400,564480
test,386,29,22272,841,121104,143376
test,387,70,53760,4900,705600,759360
test,388,128,98304,16384,2359296,2457600
test,389,99,76032,9801,1411344,1487376
test,390,54,41472,2916,419904,461376
test,391,62,47616,3844,553536,601152
test,392,209,160512,43681,6290064,6450576
test,393,33,25344,1089,156816,182160
test,394,137,105216,18769,2702736,2807952
test,395,38,29184,1444,207936,237120
test,396,45,34560,2025,291600,326160
test,397,118,90624,13924,2005056,2095680
test,398,29,22272,841,121104,143376
test,399,86,66048,7396,1065024,1131072
test,400,229,175872,52441,7551504,7727376
test,401,120,92160,14400,2073600,2165760
test,402,45,34560,2025,291600,326160
test,403,139,106752,19321,2782224,2888976
test,404,40,30720,1600,230400,261120
test,405,79,60672,6241,898704,959376
test,406,42,32256,1764,254016,286272
test,407,20,15360,400,57600,72960
test,408,65,49920,4225,608400,658320
test,409,409,314112,167281,24088464,24402576
test,410,46,35328,2116,304704,340032
test,411,43,33024,1849,266256,299280
test,412,57,43776,3249,467856,511632
test,413,74,56832,5476,788544,845376
test,414,53,40704,2809,404496,445200
test,415,116,89088,13456,1937664,2026752
test,416,52,39936,2704,389376,429312
test,417,29,22272,841,121104,143376
test,418,50,38400,2500,360000,398400
test,419,57,43776,3249,467856,511632
test,420,26,19968,676,97344,117312
test,421,26,19968,676,97344,117312
test,422,426,327168,181476,26132544,26459712
test,423,64,49152,4096,589824,638976
test,424,52,39936,2704,389376,429312
test,425,157,120576,24649,3549456,3670032
test,426,60,46080,3600,518400,564480
test,427,43,33024,1849,266256,299280
test,428,27,20736,729,104976,125712
test,429,37,28416,1369,197136,225552
test,430,53,40704,2809,404496,445200
test,431,167,128256,27889,4016016,4144272
test,432,57,43776,3249,467856,511632
test,433,18,13824,324,46656,60480
test,434,27,20736,729,104976,125712
test,435,93,71424,8649,1245456,1316880
test,436,282,216576,79524,11451456,11668032
test,437,94,72192,8836,1272384,1344576
test,438,339,260352,114921,16548624,16808976
test,439,127,97536,16129,2322576,2420112
test,440,50,38400,2500,360000,398400
test,441,177,135936,31329,4511376,4647312
test,442,61,46848,3721,535824,582672
test,443,191,146688,36481,5253264,5399952
test,444,98,75264,9604,1382976,1458240
test,445,344,264192,118336,17040384,17304576
test,446,12,9216,144,20736,29952
test,447,98,75264,9604,1382976,1458240
test,448,35,26880,1225,176400,203280
test,449,124,95232,15376,2214144,2309376
test,450,31,23808,961,138384,162192
test,451,36,27648,1296,186624,214272
test,452,37,28416,1369,197136,225552
test,453,215,165120,46225,6656400,6821520
test,454,140,107520,19600,2822400,2929920
test,455,67,51456,4489,646416,697872
test,456,243,186624,59049,8503056,8689680
test,457,44,33792,1936,278784,312576
test,458,187,143616,34969,5035536,5179152
test,459,47,36096,2209,318096,354192
test,460,52,39936,2704,389376,429312
test,461,74,56832,5476,788544,845376
test,462,88,67584,7744,1115136,1182720
test,463,119,91392,14161,2039184,2130576
test,464,95,72960,9025,1299600,1372560
test,465,15,11520,225,32400,43920
test,466,105,80640,11025,1587600,1668240
test,467,20,15360,400,57600,72960
test,468,77,59136,5929,853776,912912
test,469,49,37632,2401,345744,383376
test,470,113,86784,12769,1838736,1925520
test,471,427,327936,182329,26255376,26583312
test,472,16,12288,256,36864,49152
test,473,66,50688,4356,627264,677952
test,474,193,148224,37249,5363856,5512080
test,475,87,66816,7569,1089936,1156752
test,476,48,36864,2304,331776,368640
test,477,121,92928,14641,2108304,2201232
test,478,82,62976,6724,968256,1031232
test,479,73,56064,5329,767376,823440
test,480,15,11520,225,32400,43920
test,481,297,228096,88209,12702096,12930192
test,482,128,98304,16384,2359296,2457600
test,483,148,113664,21904,3154176,3267840
test,484,69,52992,4761,685584,738576
test,485,91,69888,8281,1192464,1262352
test,486,219,168192,47961,6906384,7074576
test,487,154,118272,23716,3415104,3533376
test,488,126,96768,15876,2286144,2382912
test,489,178,136704,31684,4562496,4699200
test,490,87,66816,7569,1089936,1156752
test,491,89,68352,7921,1140624,1208976
test,492,15,11520,225,32400,43920
test,493,57,43776,3249,467856,511632
test,494,96,73728,9216,1327104,1400832
test,495,117,89856,13689,1971216,2061072
test,496,18,13824,324,46656,60480
test,497,47,36096,2209,318096,354192
test,498,76,58368,5776,831744,890112
test,499,64,49152,4096,589824,638976
test,500,47,36096,2209,318096,354192
test,501,25,19200,625,90000,109200
test,502,60,46080,3600,518400,564480
test,503,66,50688,4356,627264,677952
test,504,370,284160,136900,19713600,19997760
test,505,139,106752,19321,2782224,2888976
test,506,48,36864,2304,331776,368640
test,507,72,55296,5184,746496,801792
test,508,185,142080,34225,4928400,5070480
test,509,280,215040,78400,11289600,11504640
test,510,322,247296,103684,14930496,15177792
test,511,305,234240,93025,13395600,13629840
test,512,15,11520,225,32400,43920
test,513,108,82944,11664,1679616,1762560
test,514,45,34560,2025,291600,326160
test,515,103,79104,10609,1527696,1606800
test,516,59,45312,3481,501264,546576
test,517,33,25344,1089,156816,182160
test,518,116,89088,13456,1937664,2026752
test,519,53,40704,2809,404496,445200
test,520,293,225024,85849,12362256,12587280
test,521,72,55296,5184,746496,801792
test,522,49,37632,2401,345744,383376
test,523,129,99072,16641,2396304,2495376
test,524,97,74496,9409,1354896,1429392
test,525,90,69120,8100,1166400,1235520
test,526,498,382464,248004,35712576,36095040
test,527,146,112128,21316,3069504,3181632
test,528,109,83712,11881,1710864,1794576
test,529,29,22272,841,121104,143376
test,530,57,43776,3249,467856,511632
test,531,50,38400,2500,360000,398400
test,532,390,299520,152100,21902400,22201920
test,533,512,393216,262144,37748736,38141952
test,534,59,45312,3481,501264,546576
test,535,55,42240,3025,435600,477840
test,536,178,136704,31684,4562496,4699200
test,537,48,36864,2304,331776,368640
test,538,45,34560,2025,291600,326160
test,539,109,83712,11881,1710864,1794576
test,540,17,13056,289,41616,54672
test,541,18,13824,324,46656,60480
test,542,12,9216,144,20736,29952
test,543,70,53760,4900,705600,759360
test,544,55,42240,3025,435600,477840
test,545,80,61440,6400,921600,983040
test,546,246,188928,60516,8714304,8903232
test,547,17,13056,289,41616,54672
test,548,68,52224,4624,665856,718080
test,549,86,66048,7396,1065024,1131072
test,550,411,315648,168921,24324624,24640272
test,551,41,31488,1681,242064,273552
test,552,120,92160,14400,2073600,2165760
test,553,47,36096,2209,318096,354192
test,554,242,185856,58564,8433216,8619072
test,555,62,47616,3844,553536,601152
test,556,66,50688,4356,627264,677952
test,557,127,97536,16129,2322576,2420112
test,558,17,13056,289,41616,54672
test,559,57,43776,3249,467856,511632
test,560,63,48384,3969,571536,619920
test,561,41,31488,1681,242064,273552
test,562,29,22272,841,121104,143376
test,563,38,29184,1444,207936,237120
test,564,94,72192,8836,1272384,1344576
test,565,73,56064,5329,767376,823440
test,566,42,32256,1764,254016,286272
test,567,18,13824,324,46656,60480
test,568,45,34560,2025,291600,326160
test,569,130,99840,16900,2433600,2533440
test,570,63,48384,3969,571536,619920
test,571,34,26112,1156,166464,192576
test,572,99,76032,9801,1411344,1487376
test,573,198,152064,39204,5645376,5797440
test,574,94,72192,8836,1272384,1344576
test,575,15,11520,225,32400,43920
test,576,50,38400,2500,360000,398400
test,577,150,115200,22500,3240000,3355200
test,578,202,155136,40804,5875776,6030912
test,579,42,32256,1764,254016,286272
test,580,57,43776,3249,467856,511632
test,581,146,112128,21316,3069504,3181632
test,582,389,298752,151321,21790224,22088976
test,583,90,69120,8100,1166400,1235520
test,584,62,47616,3844,553536,601152
test,585,512,393216,262144,37748736,38141952
test,586,51,39168,2601,374544,413712
test,587,191,146688,36481,5253264,5399952
test,588,76,58368,5776,831744,890112
test,589,27,20736,729,104976,125712
test,590,236,181248,55696,8020224,8201472
test,591,15,11520,225,32400,43920
test,592,30,23040,900,129600,152640
test,593,512,393216,262144,37748736,38141952
test,594,121,92928,14641,2108304,2201232
test,595,119,91392,14161,2039184,2130576
test,596,27,20736,729,104976,125712
test,597,80,61440,6400,921600,983040
test,598,73,56064,5329,767376,823440
test,599,27,20736,729,104976,125712
test,600,32,24576,1024,147456,172032
test,601,63,48384,3969,571536,619920
test,602,28,21504,784,112896,134400
test,603,209,160512,43681,6290064,6450576
test,604,54,41472,2916,419904,461376
test,605,38,29184,1444,207936,237120
test,606,51,39168,2601,374544,413712
test,607,58,44544,3364,484416,528960
test,608,54,41472,2916,419904,461376
test,609,84,64512,7056,1016064,1080576
test,610,176,135168,30976,4460544,4595712
test,611,117,89856,13689,1971216,2061072
test,612,43,33024,1849,266256,299280
test,613,34,26112,1156,166464,192576
test,614,87,66816,7569,1089936,1156752
test,615,82,62976,6724,968256,1031232
test,616,38,29184,1444,207936,237120
test,617,97,74496,9409,1354896,1429392
test,618,73,56064,5329,767376,823440
test,619,105,80640,11025,1587600,1668240
test,620,113,86784,12769,1838736,1925520
test,621,210,161280,44100,6350400,6511680
test,622,94,72192,8836,1272384,1344576
test,623,37,28416,1369,197136,225552
test,624,167,128256,27889,4016016,4144272
test,625,59,45312,3481,501264,546576
test,626,28,21504,784,112896,134400
test,627,81,62208,6561,944784,1006992
test,628,79,60672,6241,898704,959376
test,629,69,52992,4761,685584,738576
test,630,150,115200,22500,3240000,3355200
test,631,22,16896,484,69696,86592
test,632,30,23040,900,129600,152640
test,633,119,91392,14161,2039184,2130576
test,634,69,52992,4761,685584,738576
test,635,109,83712,11881,1710864,1794576
test,636,70,53760,4900,705600,759360
test,637,188,144384,35344,5089536,5233920
test,638,111,85248,12321,1774224,1859472
test,639,13,9984,169,24336,34320
test,640,316,242688,99856,14379264,14621952
test,641,183,140544,33489,4822416,4962960
test,642,17,13056,289,41616,54672
test,643,55,42240,3025,435600,477840
test,644,185,142080,34225,4928400,5070480
test,645,69,52992,4761,685584,738576
test,646,112,86016,12544,1806336,1892352
test,647,131,100608,17161,2471184,2571792
test,648,53,40704,2809,404496,445200
test,649,39,29952,1521,219024,248976
test,650,37,28416,1369,197136,225552
test,651,84,64512,7056,1016064,1080576
test,652,118,90624,13924,2005056,2095680
test,653,56,43008,3136,451584,494592
test,654,29,22272,841,121104,143376
test,655,512,393216,262144,37748736,38141952
test,656,210,161280,44100,6350400,6511680
test,657,140,107520,19600,2822400,2929920
test,658,56,43008,3136,451584,494592
test,659,73,56064,5329,767376,823440
test,660,138,105984,19044,2742336,2848320
test,661,81,62208,6561,944784,1006992
test,662,113,86784,12769,1838736,1925520
test,663,49,37632,2401,345744,383376
test,664,86,66048,7396,1065024,1131072
test,665,294,225792,86436,12446784,12672576
test,666,49,37632,2401,345744,383376
test,667,257,197376,66049,9511056,9708432
test,668,30,23040,900,129600,152640
test,669,143,109824,20449,2944656,3054480
test,670,112,86016,12544,1806336,1892352
test,671,22,16896,484,69696,86592
test,672,62,47616,3844,553536,601152
test,673,284,218112,80656,11614464,11832576
test,674,104,79872,10816,1557504,1637376
test,675,52,39936,2704,389376,429312
test,676,171,131328,29241,4210704,4342032
test,677,268,205824,71824,10342656,10548480
test,678,90,69120,8100,1166400,1235520
test,679,58,44544,3364,484416,528960
test,680,191,146688,36481,5253264,5399952
test,681,29,22272,841,121104,143376
test,682,74,56832,5476,788544,845376
test,683,198,152064,39204,5645376,5797440
test,684,140,107520,19600,2822400,2929920
test,685,69,52992,4761,685584,738576
test,686,62,47616,3844,553536,601152
test,687,130,99840,16900,2433600,2533440
test,688,108,82944,11664,1679616,1762560
test,689,156,119808,24336,3504384,3624192
test,690,43,33024,1849,266256,299280
test,691,82,62976,6724,968256,1031232
test,692,105,80640,11025,1587600,1668240
test,693,139,106752,19321,2782224,2888976
test,694,41,31488,1681,242064,273552
test,695,17,13056,289,41616,54672
test,696,55,42240,3025,435600,477840
test,697,56,43008,3136,451584,494592
test,698,34,26112,1156,166464,192576
test,699,50,38400,2500,360000,398400
test,700,96,73728,9216,1327104,1400832
test,701,138,105984,19044,2742336,2848320
test,702,15,11520,225,32400,43920
test,703,118,90624,13924,2005056,2095680
test,704,93,71424,8649,1245456,1316880
test,705,15,11520,225,32400,43920
test,706,129,99072,16641,2396304,2495376
test,707,66,50688,4356,627264,677952
test,708,386,296448,148996,21455424,21751872
test,709,40,30720,1600,230400,261120
test,710,293,225024,85849,12362256,12587280
test,711,306,235008,93636,13483584,13718592
test,712,46,35328,2116,304704,340032
test,713,512,393216,262144,37748736,38141952
test,714,313,240384,97969,14107536,14347920
test,715,61,46848,3721,535824,582672
test,716,157,120576,24649,3549456,3670032
test,717,98,75264,9604,1382976,1458240
test,718,216,165888,46656,6718464,6884352
test,719,83,63744,6889,992016,1055760
test,720,129,99072,16641,2396304,2495376
test,721,42,32256,1764,254016,286272
test,722,93,71424,8649,1245456,1316880
test,723,101,77568,10201,1468944,1546512
test,724,28,21504,784,112896,134400
test,725,84,64512,7056,1016064,1080576
test,726,71,54528,5041,725904,780432
test,727,25,19200,625,90000,109200
test,728,61,46848,3721,535824,582672
test,729,83,63744,6889,992016,1055760
test,730,54,41472,2916,419904,461376
test,731,512,393216,262144,37748736,38141952
test,732,45,34560,2025,291600,326160
test,733,241,185088,58081,8363664,8548752
test,734,62,47616,3844,553536,601152
test,735,55,42240,3025,435600,477840
test,736,304,233472,92416,13307904,13541376
test,737,19,14592,361,51984,66576
test,738,52,39936,2704,389376,429312
test,739,73,56064,5329,767376,823440
test,740,18,13824,324,46656,60480
test,741,512,393216,262144,37748736,38141952
test,742,57,43776,3249,467856,511632
test,743,98,75264,9604,1382976,1458240
test,744,105,80640,11025,1587600,1668240
test,745,184,141312,33856,4875264,5016576
test,746,44,33792,1936,278784,312576
test,747,39,29952,1521,219024,248976
test,748,76,58368,5776,831744,890112
test,749,200,153600,40000,5760000,5913600
test,750,12,9216,144,20736,29952
test,751,31,23808,961,138384,162192
test,752,13,9984,169,24336,34320
test,753,28,21504,784,112896,134400
test,754,103,79104,10609,1527696,1606800
test,755,220,168960,48400,6969600,7138560
test,756,279,214272,77841,11209104,11423376
test,757,287,220416,82369,11861136,12081552
test,758,51,39168,2601,374544,413712
test,759,108,82944,11664,1679616,1762560
test,760,85,65280,7225,1040400,1105680
test,761,56,43008,3136,451584,494592
test,762,13,9984,169,24336,34320
test,763,311,238848,96721,13927824,14166672
test,764,127,97536,16129,2322576,2420112
test,765,50,38400,2500,360000,398400
test,766,16,12288,256,36864,49152
test,767,53,40704,2809,404496,445200
test,768,330,253440,108900,15681600,15935040
test,769,347,266496,120409,17338896,17605392
test,770,43,33024,1849,266256,299280
test,771,46,35328,2116,304704,340032
test,772,24,18432,576,82944,101376
test,773,113,86784,12769,1838736,1925520
test,774,88,67584,7744,1115136,1182720
test,775,150,115200,22500,3240000,3355200
test,776,96,73728,9216,1327104,1400832
test,777,77,59136,5929,853776,912912
test,778,220,168960,48400,6969600,7138560
test,779,77,59136,5929,853776,912912
test,780,52,39936,2704,389376,429312
test,781,340,261120,115600,16646400,16907520
test,782,56,43008,3136,451584,494592
test,783,53,40704,2809,404496,445200
test,784,136,104448,18496,2663424,2767872
test,785,86,66048,7396,1065024,1131072
test,786,63,48384,3969,571536,619920
test,787,104,79872,10816,1557504,1637376
test,788,254,195072,64516,9290304,9485376
test,789,454,348672,206116,29680704,30029376
test,790,26,19968,676,97344,117312
test,791,66,50688,4356,627264,677952
test,792,200,153600,40000,5760000,5913600
test,793,110,84480,12100,1742400,1826880
test,794,57,43776,3249,467856,511632
test,795,122,93696,14884,2143296,2236992
test,796,23,17664,529,76176,93840
test,797,16,12288,256,36864,49152
test,798,41,31488,1681,242064,273552
test,799,70,53760,4900,705600,759360
test,800,512,393216,262144,37748736,38141952
test,801,249,191232,62001,8928144,9119376
test,802,155,119040,24025,3459600,3578640
test,803,30,23040,900,129600,152640
test,804,111,85248,12321,1774224,1859472
test,805,512,393216,262144,37748736,38141952
test,806,16,12288,256,36864,49152
test,807,88,67584,7744,1115136,1182720
test,808,191,146688,36481,5253264,5399952
test,809,52,39936,2704,389376,429312
test,810,93,71424,8649,1245456,1316880
test,811,24,18432,576,82944,101376
test,812,51,39168,2601,374544,413712
test,813,87,66816,7569,1089936,1156752
test,814,31,23808,961,138384,162192
test,815,43,33024,1849,266256,299280
test,816,63,48384,3969,571536,619920
test,817,228,175104,51984,7485696,7660800
test,818,110,84480,12100,1742400,1826880
test,819,136,104448,18496,2663424,2767872
test,820,512,393216,262144,37748736,38141952
test,821,85,65280,7225,1040400,1105680
test,822,145,111360,21025,3027600,3138960
test,823,77,59136,5929,853776,912912
test,824,110,84480,12100,1742400,1826880
test,825,84,64512,7056,1016064,1080576
test,826,48,36864,2304,331776,368640
test,827,196,150528,38416,5531904,5682432
test,828,40,30720,1600,230400,261120
test,829,96,73728,9216,1327104,1400832
test,830,70,53760,4900,705600,759360
test,831,222,170496,49284,7096896,7267392
test,832,71,54528,5041,725904,780432
test,833,254,195072,64516,9290304,9485376
test,834,62,47616,3844,553536,601152
test,835,369,283392,136161,19607184,19890576
test,836,72,55296,5184,746496,801792
test,837,15,11520,225,32400,43920
test,838,79,60672,6241,898704,959376
test,839,478,367104,228484,32901696,33268800
test,840,83,63744,6889,992016,1055760
test,841,203,155904,41209,5934096,6090000
test,842,39,29952,1521,219024,248976
test,843,51,39168,2601,374544,413712
test,844,42,32256,1764,254016,286272
test,845,134,102912,17956,2585664,2688576
test,846,107,82176,11449,1648656,1730832
test,847,15,11520,225,32400,43920
test,848,84,64512,7056,1016064,1080576
test,849,260,199680,67600,9734400,9934080
test,850,31,23808,961,138384,162192
test,851,70,53760,4900,705600,759360
test,852,54,41472,2916,419904,461376
test,853,53,40704,2809,404496,445200
test,854,152,116736,23104,3326976,3443712
test,855,103,79104,10609,1527696,1606800
test,856,17,13056,289,41616,54672
test,857,37,28416,1369,197136,225552
test,858,15,11520,225,32400,43920
test,859,60,46080,3600,518400,564480
test,860,512,393216,262144,37748736,38141952
test,861,55,42240,3025,435600,477840
test,862,82,62976,6724,968256,1031232
test,863,147,112896,21609,3111696,3224592
test,864,64,49152,4096,589824,638976
test,865,74,56832,5476,788544,845376
test,866,106,81408,11236,1617984,1699392
test,867,97,74496,9409,1354896,1429392
test,868,19,14592,361,51984,66576
test,869,45,34560,2025,291600,326160
test,870,173,132864,29929,4309776,4442640
test,871,15,11520,225,32400,43920
test,872,49,37632,2401,345744,383376
test,873,88,67584,7744,1115136,1182720
test,874,98,75264,9604,1382976,1458240
test,875,44,33792,1936,278784,312576
test,876,257,197376,66049,9511056,9708432
test,877,125,96000,15625,2250000,2346000
test,878,59,45312,3481,501264,546576
test,879,113,86784,12769,1838736,1925520
test,880,155,119040,24025,3459600,3578640
test,881,38,29184,1444,207936,237120
test,882,176,135168,30976,4460544,4595712
test,883,235,180480,55225,7952400,8132880
test,884,147,112896,21609,3111696,3224592
test,885,15,11520,225,32400,43920
test,886,99,76032,9801,1411344,1487376
test,887,63,48384,3969,571536,619920
test,888,86,66048,7396,1065024,1131072
test,889,98,75264,9604,1382976,1458240
test,890,116,89088,13456,1937664,2026752
test,891,52,39936,2704,389376,429312
test,892,94,72192,8836,1272384,1344576
test,893,107,82176,11449,1648656,1730832
test,894,104,79872,10816,1557504,1637376
test,895,41,31488,1681,242064,273552
test,896,109,83712,11881,1710864,1794576
test,897,512,393216,262144,37748736,38141952
test,898,77,59136,5929,853776,912912
test,899,43,33024,1849,266256,299280
test,900,68,52224,4624,665856,718080
test,901,78,59904,6084,876096,936000
test,902,58,44544,3364,484416,528960
test,903,65,49920,4225,608400,658320
test,904,38,29184,1444,207936,237120
test,905,64,49152,4096,589824,638976
test,906,239,183552,57121,8225424,8408976
test,907,104,79872,10816,1557504,1637376
test,908,70,53760,4900,705600,759360
test,909,91,69888,8281,1192464,1262352
test,910,43,33024,1849,266256,299280
test,911,74,56832,5476,788544,845376
test,912,118,90624,13924,2005056,2095680
test,913,54,41472,2916,419904,461376
test,914,234,179712,54756,7884864,8064576
test,915,125,96000,15625,2250000,2346000
test,916,39,29952,1521,219024,248976
test,917,86,66048,7396,1065024,1131072
test,918,56,43008,3136,451584,494592
test,919,207,158976,42849,6170256,6329232
test,920,140,107520,19600,2822400,2929920
test,921,50,38400,2500,360000,398400
test,922,155,119040,24025,3459600,3578640
test,923,220,168960,48400,6969600,7138560
test,924,66,50688,4356,627264,677952
test,925,512,393216,262144,37748736,38141952
test,926,117,89856,13689,1971216,2061072
test,927,34,26112,1156,166464,192576
test,928,47,36096,2209,318096,354192
test,929,39,29952,1521,219024,248976
test,930,15,11520,225,32400,43920
test,931,30,23040,900,129600,152640
test,932,70,53760,4900,705600,759360
test,933,67,51456,4489,646416,697872
test,934,64,49152,4096,589824,638976
test,935,127,97536,16129,2322576,2420112
test,936,16,12288,256,36864,49152
test,937,59,45312,3481,501264,546576
test,938,46,35328,2116,304704,340032
test,939,235,180480,55225,7952400,8132880
test,940,75,57600,5625,810000,867600
test,941,113,86784,12769,1838736,1925520
test,942,42,32256,1764,254016,286272
test,943,110,84480,12100,1742400,1826880
test,944,86,66048,7396,1065024,1131072
test,945,47,36096,2209,318096,354192
test,946,85,65280,7225,1040400,1105680
test,947,212,162816,44944,6471936,6634752
test,948,115,88320,13225,1904400,1992720
test,949,131,100608,17161,2471184,2571792
test,950,40,30720,1600,230400,261120
test,951,213,163584,45369,6533136,6696720
test,952,319,244992,101761,14653584,14898576
test,953,90,69120,8100,1166400,1235520
test,954,50,38400,2500,360000,398400
test,955,285,218880,81225,11696400,11915280
test,956,55,42240,3025,435600,477840
test,957,16,12288,256,36864,49152
test,958,40,30720,1600,230400,261120
test,959,58,44544,3364,484416,528960
test,960,92,70656,8464,1218816,1289472
test,961,129,99072,16641,2396304,2495376
test,962,73,56064,5329,767376,823440
test,963,119,91392,14161,2039184,2130576
test,964,512,393216,262144,37748736,38141952
test,965,189,145152,35721,5143824,5288976
test,966,65,49920,4225,608400,658320
test,967,396,304128,156816,22581504,22885632
test,968,73,56064,5329,767376,823440
test,969,66,50688,4356,627264,677952
test,970,29,22272,841,121104,143376
test,971,81,62208,6561,944784,1006992
test,972,35,26880,1225,176400,203280
test,973,277,212736,76729,11048976,11261712
test,974,329,252672,108241,15586704,15839376
test,975,65,49920,4225,608400,658320
test,976,21,16128,441,63504,79632
test,977,318,244224,101124,14561856,14806080
test,978,71,54528,5041,725904,780432
test,979,119,91392,14161,2039184,2130576
test,980,76,58368,5776,831744,890112
test,981,78,59904,6084,876096,936000
test,982,34,26112,1156,166464,192576
test,983,85,65280,7225,1040400,1105680
test,984,178,136704,31684,4562496,4699200
test,985,91,69888,8281,1192464,1262352
test,986,65,49920,4225,608400,658320
test,987,62,47616,3844,553536,601152
test,988,465,357120,216225,31136400,31493520
test,989,13,9984,169,24336,34320
test,990,83,63744,6889,992016,1055760
test,991,97,74496,9409,1354896,1429392
test,992,62,47616,3844,553536,601152
test,993,132,101376,17424,2509056,2610432
test,994,45,34560,2025,291600,326160
test,995,27,20736,729,104976,125712
test,996,124,95232,15376,2214144,2309376
test,997,83,63744,6889,992016,1055760
test,998,214,164352,45796,6594624,6758976
test,999,229,175872,52441,7551504,7727376
test,1000,77,59136,5929,853776,912912
test,1001,66,50688,4356,627264,677952
test,1002,56,43008,3136,451584,494592
test,1003,71,54528,5041,725904,780432
test,1004,30,23040,900,129600,152640
test,1005,164,125952,26896,3873024,3998976
test,1006,110,84480,12100,1742400,1826880
test,1007,109,83712,11881,1710864,1794576
test,1008,41,31488,1681,242064,273552
test,1009,71,54528,5041,725904,780432
test,1010,59,45312,3481,501264,546576
test,1011,211,162048,44521,6411024,6573072
test,1012,58,44544,3364,484416,528960
test,1013,153,117504,23409,3370896,3488400
test,1014,14,10752,196,28224,38976
test,1015,182,139776,33124,4769856,4909632
test,1016,294,225792,86436,12446784,12672576
test,1017,87,66816,7569,1089936,1156752
test,1018,225,172800,50625,7290000,7462800
test,1019,110,84480,12100,1742400,1826880
test,1020,14,10752,196,28224,38976
test,1021,449,344832,201601,29030544,29375376
test,1022,84,64512,7056,1016064,1080576
test,1023,69,52992,4761,685584,738576
test,1024,52,39936,2704,389376,429312
test,1025,91,69888,8281,1192464,1262352
test,1026,12,9216,144,20736,29952
test,1027,70,53760,4900,705600,759360
test,1028,66,50688,4356,627264,677952
test,1029,70,53760,4900,705600,759360
test,1030,27,20736,729,104976,125712
test,1031,212,162816,44944,6471936,6634752
test,1032,339,260352,114921,16548624,16808976
test,1033,137,105216,18769,2702736,2807952
test,1034,35,26880,1225,176400,203280
test,1035,88,67584,7744,1115136,1182720
test,1036,34,26112,1156,166464,192576
test,1037,36,27648,1296,186624,214272
test,1038,66,50688,4356,627264,677952
test,1039,62,47616,3844,553536,601152
test,1040,45,34560,2025,291600,326160
test,1041,75,57600,5625,810000,867600
test,1042,90,69120,8100,1166400,1235520
test,1043,306,235008,93636,13483584,13718592
test,1044,95,72960,9025,1299600,1372560
test,1045,164,125952,26896,3873024,3998976
test,1046,52,39936,2704,389376,429312
test,1047,69,52992,4761,685584,738576
test,1048,382,293376,145924,21013056,21306432
test,1049,77,59136,5929,853776,912912
test,1050,64,49152,4096,589824,638976
test,1051,35,26880,1225,176400,203280
test,1052,44,33792,1936,278784,312576
test,1053,52,39936,2704,389376,429312
test,1054,58,44544,3364,484416,528960
test,1055,124,95232,15376,2214144,2309376
test,1056,89,68352,7921,1140624,1208976
test,1057,168,129024,28224,4064256,4193280
test,1058,94,72192,8836,1272384,1344576
test,1059,273,209664,74529,10732176,10941840
test,1060,65,49920,4225,608400,658320
test,1061,172,132096,29584,4260096,4392192
test,1062,213,163584,45369,6533136,6696720
test,1063,132,101376,17424,2509056,2610432
test,1064,110,84480,12100,1742400,1826880
test,1065,500,384000,250000,36000000,36384000
test,1066,196,150528,38416,5531904,5682432
test,1067,44,33792,1936,278784,312576
test,1068,119,91392,14161,2039184,2130576
test,1069,14,10752,196,28224,38976
test,1070,68,52224,4624,665856,718080
test,1071,160,122880,25600,3686400,3809280
test,1072,113,86784,12769,1838736,1925520
test,1073,53,40704,2809,404496,445200
test,1074,92,70656,8464,1218816,1289472
test,1075,37,28416,1369,197136,225552
test,1076,16,12288,256,36864,49152
test,1077,512,393216,262144,37748736,38141952
test,1078,75,57600,5625,810000,867600
test,1079,136,104448,18496,2663424,2767872
test,1080,60,46080,3600,518400,564480
test,1081,47,36096,2209,318096,354192
test,1082,51,39168,2601,374544,413712
test,1083,82,62976,6724,968256,1031232
test,1084,140,107520,19600,2822400,2929920
test,1085,78,59904,6084,876096,936000
test,1086,123,94464,15129,2178576,2273040
test,1087,35,26880,1225,176400,203280
test,1088,96,73728,9216,1327104,1400832
test,1089,57,43776,3249,467856,511632
test,1090,95,72960,9025,1299600,1372560
test,1091,36,27648,1296,186624,214272
test,1092,22,16896,484,69696,86592
test,1093,149,114432,22201,3196944,3311376
test,1094,72,55296,5184,746496,801792
test,1095,198,152064,39204,5645376,5797440
test,1096,15,11520,225,32400,43920
test,1097,51,39168,2601,374544,413712
test,1098,101,77568,10201,1468944,1546512
test,1099,161,123648,25921,3732624,3856272
test,1100,114,87552,12996,1871424,1958976
test,1101,47,36096,2209,318096,354192
test,1102,81,62208,6561,944784,1006992
test,1103,97,74496,9409,1354896,1429392
test,1104,59,45312,3481,501264,546576
test,1105,100,76800,10000,1440000,1516800
test,1106,124,95232,15376,2214144,2309376
test,1107,251,192768,63001,9072144,9264912
test,1108,59,45312,3481,501264,546576
test,1109,79,60672,6241,898704,959376
test,1110,209,160512,43681,6290064,6450576
test,1111,43,33024,1849,266256,299280
test,1112,512,393216,262144,37748736,38141952
test,1113,129,99072,16641,2396304,2495376
test,1114,73,56064,5329,767376,823440
test,1115,389,298752,151321,21790224,22088976
test,1116,31,23808,961,138384,162192
test,1117,59,45312,3481,501264,546576
test,1118,161,123648,25921,3732624,3856272
test,1119,435,334080,189225,27248400,27582480
test,1120,111,85248,12321,1774224,1859472
test,1121,44,33792,1936,278784,312576
test,1122,106,81408,11236,1617984,1699392
test,1123,127,97536,16129,2322576,2420112
test,1124,108,82944,11664,1679616,1762560
test,1125,104,79872,10816,1557504,1637376
test,1126,60,46080,3600,518400,564480
test,1127,29,22272,841,121104,143376
test,1128,64,49152,4096,589824,638976
test,1129,295,226560,87025,12531600,12758160
test,1130,27,20736,729,104976,125712
test,1131,303,232704,91809,13220496,13453200
test,1132,29,22272,841,121104,143376
test,1133,173,132864,29929,4309776,4442640
test,1134,71,54528,5041,725904,780432
test,1135,26,19968,676,97344,117312
test,1136,46,35328,2116,304704,340032
test,1137,110,84480,12100,1742400,1826880
test,1138,17,13056,289,41616,54672
test,1139,19,14592,361,51984,66576
test,1140,61,46848,3721,535824,582672
test,1141,202,155136,40804,5875776,6030912
test,1142,40,30720,1600,230400,261120
test,1143,275,211200,75625,10890000,11101200
test,1144,97,74496,9409,1354896,1429392
test,1145,66,50688,4356,627264,677952
test,1146,54,41472,2916,419904,461376
test,1147,13,9984,169,24336,34320
test,1148,96,73728,9216,1327104,1400832
test,1149,179,137472,32041,4613904,4751376
test,1150,17,13056,289,41616,54672
test,1151,32,24576,1024,147456,172032
test,1152,63,48384,3969,571536,619920
test,1153,206,158208,42436,6110784,6268992
test,1154,83,63744,6889,992016,1055760
test,1155,34,26112,1156,166464,192576
test,1156,47,36096,2209,318096,354192
test,1157,79,60672,6241,898704,959376
test,1158,26,19968,676,97344,117312
test,1159,88,67584,7744,1115136,1182720
test,1160,284,218112,80656,11614464,11832576
test,1161,29,22272,841,121104,143376
test,1162,71,54528,5041,725904,780432
test,1163,23,17664,529,76176,93840
test,1164,103,79104,10609,1527696,1606800
test,1165,45,34560,2025,291600,326160
test,1166,61,46848,3721,535824,582672
test,1167,44,33792,1936,278784,312576
test,1168,159,122112,25281,3640464,3762576
test,1169,219,168192,47961,6906384,7074576
test,1170,58,44544,3364,484416,528960
test,1171,36,27648,1296,186624,214272
test,1172,95,72960,9025,1299600,1372560
test,1173,113,86784,12769,1838736,1925520
test,1174,441,338688,194481,28005264,28343952
test,1175,59,45312,3481,501264,546576
test,1176,63,48384,3969,571536,619920
test,1177,19,14592,361,51984,66576
test,1178,98,75264,9604,1382976,1458240
test,1179,512,393216,262144,37748736,38141952
test,1180,61,46848,3721,535824,582672
test,1181,58,44544,3364,484416,528960
test,1182,115,88320,13225,1904400,1992720
test,1183,124,95232,15376,2214144,2309376
test,1184,210,161280,44100,6350400,6511680
test,1185,63,48384,3969,571536,619920
test,1186,422,324096,178084,25644096,25968192
test,1187,321,246528,103041,14837904,15084432
test,1188,41,31488,1681,242064,273552
test,1189,154,118272,23716,3415104,3533376
test,1190,69,52992,4761,685584,738576
test,1191,212,162816,44944,6471936,6634752
test,1192,55,42240,3025,435600,477840
test,1193,28,21504,784,112896,134400
test,1194,512,393216,262144,37748736,38141952
test,1195,97,74496,9409,1354896,1429392
test,1196,149,114432,22201,3196944,3311376
test,1197,127,97536,16129,2322576,2420112
test,1198,512,393216,262144,37748736,38141952
test,1199,144,110592,20736,2985984,3096576
test,1200,89,68352,7921,1140624,1208976
test,1201,64,49152,4096,589824,638976
test,1202,387,297216,149769,21566736,21863952
test,1203,109,83712,11881,1710864,1794576
test,1204,257,197376,66049,9511056,9708432
test,1205,54,41472,2916,419904,461376
test,1206,206,158208,42436,6110784,6268992
test,1207,15,11520,225,32400,43920
test,1208,85,65280,7225,1040400,1105680
test,1209,37,28416,1369,197136,225552
test,1210,62,47616,3844,553536,601152
test,1211,38,29184,1444,207936,237120
test,1212,99,76032,9801,1411344,1487376
test,1213,80,61440,6400,921600,983040
test,1214,68,52224,4624,665856,718080
test,1215,89,68352,7921,1140624,1208976
test,1216,94,72192,8836,1272384,1344576
test,1217,69,52992,4761,685584,738576
test,1218,71,54528,5041,725904,780432
test,1219,24,18432,576,82944,101376
test,1220,90,69120,8100,1166400,1235520
test,1221,34,26112,1156,166464,192576
test,1222,54,41472,2916,419904,461376
test,1223,98,75264,9604,1382976,1458240
test,1224,78,59904,6084,876096,936000
test,1225,87,66816,7569,1089936,1156752
test,1226,126,96768,15876,2286144,2382912
test,1227,111,85248,12321,1774224,1859472
test,1228,103,79104,10609,1527696,1606800
test,1229,96,73728,9216,1327104,1400832
test,1230,100,76800,10000,1440000,1516800
test,1231,105,80640,11025,1587600,1668240
test,1232,136,104448,18496,2663424,2767872
test,1233,98,75264,9604,1382976,1458240
test,1234,56,43008,3136,451584,494592
test,1235,11,8448,121,17424,25872
test,1236,116,89088,13456,1937664,2026752
test,1237,195,149760,38025,5475600,5625360
test,1238,101,77568,10201,1468944,1546512
test,1239,52,39936,2704,389376,429312
test,1240,200,153600,40000,5760000,5913600
test,1241,70,53760,4900,705600,759360
test,1242,512,393216,262144,37748736,38141952
test,1243,77,59136,5929,853776,912912
test,1244,90,69120,8100,1166400,1235520
test,1245,87,66816,7569,1089936,1156752
test,1246,44,33792,1936,278784,312576
test,1247,512,393216,262144,37748736,38141952
test,1248,104,79872,10816,1557504,1637376
test,1249,12,9216,144,20736,29952
test,1250,77,59136,5929,853776,912912
test,1251,178,136704,31684,4562496,4699200
test,1252,302,231936,91204,13133376,13365312
test,1253,174,133632,30276,4359744,4493376
test,1254,181,139008,32761,4717584,4856592
test,1255,36,27648,1296,186624,214272
test,1256,214,164352,45796,6594624,6758976
test,1257,49,37632,2401,345744,383376
test,1258,37,28416,1369,197136,225552
test,1259,115,88320,13225,1904400,1992720
test,1260,40,30720,1600,230400,261120
test,1261,83,63744,6889,992016,1055760
test,1262,73,56064,5329,767376,823440
test,1263,36,27648,1296,186624,214272
test,1264,195,149760,38025,5475600,5625360
test,1265,192,147456,36864,5308416,5455872
test,1266,418,321024,174724,25160256,25481280
test,1267,227,174336,51529,7420176,7594512
test,1268,63,48384,3969,571536,619920
test,1269,72,55296,5184,746496,801792
test,1270,94,72192,8836,1272384,1344576
test,1271,45,34560,2025,291600,326160
test,1272,33,25344,1089,156816,182160
test,1273,64,49152,4096,589824,638976
test,1274,87,66816,7569,1089936,1156752
test,1275,85,65280,7225,1040400,1105680
test,1276,100,76800,10000,1440000,1516800
test,1277,115,88320,13225,1904400,1992720
test,1278,59,45312,3481,501264,546576
test,1279,30,23040,900,129600,152640
test,1280,36,27648,1296,186624,214272
test,1281,512,393216,262144,37748736,38141952
test,1282,70,53760,4900,705600,759360
test,1283,12,9216,144,20736,29952
test,1284,97,74496,9409,1354896,1429392
test,1285,36,27648,1296,186624,214272
test,1286,439,337152,192721,27751824,28088976
test,1287,92,70656,8464,1218816,1289472
test,1288,37,28416,1369,197136,225552
test,1289,49,37632,2401,345744,383376
test,1290,67,51456,4489,646416,697872
test,1291,36,27648,1296,186624,214272
test,1292,263,201984,69169,9960336,10162320
test,1293,221,169728,48841,7033104,7202832
test,1294,61,46848,3721,535824,582672
test,1295,21,16128,441,63504,79632
test,1296,77,59136,5929,853776,912912
test,1297,64,49152,4096,589824,638976
test,1298,57,43776,3249,467856,511632
test,1299,85,65280,7225,1040400,1105680
test,1300,122,93696,14884,2143296,2236992
test,1301,373,286464,139129,20034576,20321040
test,1302,109,83712,11881,1710864,1794576
test,1303,70,53760,4900,705600,759360
test,1304,12,9216,144,20736,29952
test,1305,75,57600,5625,810000,867600
test,1306,117,89856,13689,1971216,2061072
test,1307,58,44544,3364,484416,528960
test,1308,475,364800,225625,32490000,32854800
test,1309,49,37632,2401,345744,383376
test,1310,48,36864,2304,331776,368640
test,1311,102,78336,10404,1498176,1576512
test,1312,50,38400,2500,360000,398400
test,1313,32,24576,1024,147456,172032
test,1314,97,74496,9409,1354896,1429392
test,1315,85,65280,7225,1040400,1105680
test,1316,108,82944,11664,1679616,1762560
test,1317,44,33792,1936,278784,312576
test,1318,85,65280,7225,1040400,1105680
test,1319,30,23040,900,129600,152640
test,1320,67,51456,4489,646416,697872
test,1321,89,68352,7921,1140624,1208976
test,1322,55,42240,3025,435600,477840
test,1323,98,75264,9604,1382976,1458240
test,1324,90,69120,8100,1166400,1235520
test,1325,14,10752,196,28224,38976
test,1326,91,69888,8281,1192464,1262352
test,1327,19,14592,361,51984,66576
test,1328,512,393216,262144,37748736,38141952
test,1329,329,252672,108241,15586704,15839376
test,1330,67,51456,4489,646416,697872
test,1331,145,111360,21025,3027600,3138960
test,1332,255,195840,65025,9363600,9559440
test,1333,15,11520,225,32400,43920
test,1334,36,27648,1296,186624,214272
test,1335,60,46080,3600,518400,564480
test,1336,57,43776,3249,467856,511632
test,1337,105,80640,11025,1587600,1668240
test,1338,57,43776,3249,467856,511632
test,1339,42,32256,1764,254016,286272
test,1340,232,178176,53824,7750656,7928832
test,1341,104,79872,10816,1557504,1637376
test,1342,214,164352,45796,6594624,6758976
test,1343,246,188928,60516,8714304,8903232
test,1344,151,115968,22801,3283344,3399312
test,1345,115,88320,13225,1904400,1992720
test,1346,79,60672,6241,898704,959376
test,1347,71,54528,5041,725904,780432
test,1348,45,34560,2025,291600,326160
test,1349,75,57600,5625,810000,867600
test,1350,89,68352,7921,1140624,1208976
test,1351,73,56064,5329,767376,823440
test,1352,47,36096,2209,318096,354192
test,1353,83,63744,6889,992016,1055760
test,1354,214,164352,45796,6594624,6758976
test,1355,30,23040,900,129600,152640
test,1356,148,113664,21904,3154176,3267840
test,1357,62,47616,3844,553536,601152
test,1358,58,44544,3364,484416,528960
test,1359,165,126720,27225,3920400,4047120
test,1360,117,89856,13689,1971216,2061072
test,1361,16,12288,256,36864,49152
test,1362,38,29184,1444,207936,237120
test,1363,46,35328,2116,304704,340032
test,1364,78,59904,6084,876096,936000
test,1365,83,63744,6889,992016,1055760
test,1366,12,9216,144,20736,29952
test,1367,256,196608,65536,9437184,9633792
test,1368,117,89856,13689,1971216,2061072
test,1369,11,8448,121,17424,25872
test,1370,185,142080,34225,4928400,5070480
test,1371,43,33024,1849,266256,299280
test,1372,113,86784,12769,1838736,1925520
test,1373,87,66816,7569,1089936,1156752
test,1374,512,393216,262144,37748736,38141952
test,1375,14,10752,196,28224,38976
test,1376,210,161280,44100,6350400,6511680
test,1377,222,170496,49284,7096896,7267392
test,1378,33,25344,1089,156816,182160
test,1379,30,23040,900,129600,152640
test,1380,72,55296,5184,746496,801792
test,1381,17,13056,289,41616,54672
test,1382,83,63744,6889,992016,1055760
test,1383,304,233472,92416,13307904,13541376
test,1384,46,35328,2116,304704,340032
test,1385,52,39936,2704,389376,429312
test,1386,158,121344,24964,3594816,3716160
test,1387,70,53760,4900,705600,759360
test,1388,46,35328,2116,304704,340032
test,1389,27,20736,729,104976,125712
test,1390,65,49920,4225,608400,658320
test,1391,113,86784,12769,1838736,1925520
test,1392,80,61440,6400,921600,983040
test,1393,27,20736,729,104976,125712
test,1394,28,21504,784,112896,134400
test,1395,122,93696,14884,2143296,2236992
test,1396,113,86784,12769,1838736,1925520
test,1397,74,56832,5476,788544,845376
test,1398,18,13824,324,46656,60480
test,1399,232,178176,53824,7750656,7928832
test,1400,18,13824,324,46656,60480
test,1401,62,47616,3844,553536,601152
test,1402,71,54528,5041,725904,780432
test,1403,289,221952,83521,12027024,12248976
test,1404,497,381696,247009,35569296,35950992
test,1405,65,49920,4225,608400,658320
test,1406,218,167424,47524,6843456,7010880
test,1407,37,28416,1369,197136,225552
test,1408,96,73728,9216,1327104,1400832
test,1409,119,91392,14161,2039184,2130576
test,1410,144,110592,20736,2985984,3096576
test,1411,208,159744,43264,6230016,6389760
test,1412,64,49152,4096,589824,638976
test,1413,76,58368,5776,831744,890112
test,1414,122,93696,14884,2143296,2236992
test,1415,126,96768,15876,2286144,2382912
test,1416,163,125184,26569,3825936,3951120
test,1417,233,178944,54289,7817616,7996560
test,1418,58,44544,3364,484416,528960
test,1419,80,61440,6400,921600,983040
test,1420,52,39936,2704,389376,429312
test,1421,102,78336,10404,1498176,1576512
test,1422,47,36096,2209,318096,354192
test,1423,109,83712,11881,1710864,1794576
test,1424,57,43776,3249,467856,511632
test,1425,92,70656,8464,1218816,1289472
test,1426,108,82944,11664,1679616,1762560
test,1427,85,65280,7225,1040400,1105680
test,1428,15,11520,225,32400,43920
test,1429,19,14592,361,51984,66576
test,1430,68,52224,4624,665856,718080
test,1431,60,46080,3600,518400,564480
test,1432,44,33792,1936,278784,312576
test,1433,58,44544,3364,484416,528960
test,1434,14,10752,196,28224,38976
test,1435,109,83712,11881,1710864,1794576
test,1436,32,24576,1024,147456,172032
test,1437,106,81408,11236,1617984,1699392
test,1438,127,97536,16129,2322576,2420112
test,1439,115,88320,13225,1904400,1992720
test,1440,60,46080,3600,518400,564480
test,1441,52,39936,2704,389376,429312
test,1442,512,393216,262144,37748736,38141952
test,1443,104,79872,10816,1557504,1637376
test,1444,53,40704,2809,404496,445200
test,1445,512,393216,262144,37748736,38141952
test,1446,37,28416,1369,197136,225552
test,1447,34,26112,1156,166464,192576
test,1448,157,120576,24649,3549456,3670032
test,1449,61,46848,3721,535824,582672
test,1450,33,25344,1089,156816,182160
test,1451,95,72960,9025,1299600,1372560
test,1452,115,88320,13225,1904400,1992720
test,1453,98,75264,9604,1382976,1458240
test,1454,36,27648,1296,186624,214272
test,1455,159,122112,25281,3640464,3762576
test,1456,290,222720,84100,12110400,12333120
test,1457,47,36096,2209,318096,354192
test,1458,112,86016,12544,1806336,1892352
test,1459,71,54528,5041,725904,780432
test,1460,45,34560,2025,291600,326160
test,1461,27,20736,729,104976,125712
test,1462,50,38400,2500,360000,398400
test,1463,10,7680,100,14400,22080
test,1464,73,56064,5329,767376,823440
test,1465,103,79104,10609,1527696,1606800
test,1466,149,114432,22201,3196944,3311376
test,1467,81,62208,6561,944784,1006992
test,1468,39,29952,1521,219024,248976
test,1469,73,56064,5329,767376,823440
test,1470,63,48384,3969,571536,619920
test,1471,14,10752,196,28224,38976
test,1472,122,93696,14884,2143296,2236992
test,1473,87,66816,7569,1089936,1156752
test,1474,112,86016,12544,1806336,1892352
test,1475,103,79104,10609,1527696,1606800
test,1476,19,14592,361,51984,66576
test,1477,96,73728,9216,1327104,1400832
test,1478,214,164352,45796,6594624,6758976
test,1479,61,46848,3721,535824,582672
test,1480,154,118272,23716,3415104,3533376
test,1481,179,137472,32041,4613904,4751376
test,1482,71,54528,5041,725904,780432
test,1483,49,37632,2401,345744,383376
test,1484,23,17664,529,76176,93840
test,1485,52,39936,2704,389376,429312
test,1486,70,53760,4900,705600,759360
test,1487,95,72960,9025,1299600,1372560
test,1488,125,96000,15625,2250000,2346000
test,1489,111,85248,12321,1774224,1859472
test,1490,26,19968,676,97344,117312
test,1491,29,22272,841,121104,143376
test,1492,512,393216,262144,37748736,38141952
test,1493,152,116736,23104,3326976,3443712
test,1494,35,26880,1225,176400,203280
test,1495,178,136704,31684,4562496,4699200
test,1496,14,10752,196,28224,38976
test,1497,120,92160,14400,2073600,2165760
test,1498,73,56064,5329,767376,823440
test,1499,42,32256,1764,254016,286272
test,1500,46,35328,2116,304704,340032
test,1501,16,12288,256,36864,49152
test,1502,133,102144,17689,2547216,2649360
test,1503,410,314880,168100,24206400,24521280
test,1504,55,42240,3025,435600,477840
test,1505,71,54528,5041,725904,780432
test,1506,44,33792,1936,278784,312576
test,1507,41,31488,1681,242064,273552
test,1508,24,18432,576,82944,101376
test,1509,83,63744,6889,992016,1055760
test,1510,179,137472,32041,4613904,4751376
test,1511,39,29952,1521,219024,248976
test,1512,115,88320,13225,1904400,1992720
test,1513,149,114432,22201,3196944,3311376
test,1514,413,317184,170569,24561936,24879120
test,1515,19,14592,361,51984,66576
test,1516,105,80640,11025,1587600,1668240
test,1517,47,36096,2209,318096,354192
test,1518,248,190464,61504,8856576,9047040
test,1519,70,53760,4900,705600,759360
test,1520,42,32256,1764,254016,286272
test,1521,47,36096,2209,318096,354192
test,1522,17,13056,289,41616,54672
test,1523,372,285696,138384,19927296,20212992
test,1524,38,29184,1444,207936,237120
test,1525,46,35328,2116,304704,340032
test,1526,97,74496,9409,1354896,1429392
test,1527,16,12288,256,36864,49152
test,1528,12,9216,144,20736,29952
test,1529,512,393216,262144,37748736,38141952
test,1530,26,19968,676,97344,117312
test,1531,215,165120,46225,6656400,6821520
test,1532,39,29952,1521,219024,248976
test,1533,119,91392,14161,2039184,2130576
test,1534,47,36096,2209,318096,354192
test,1535,71,54528,5041,725904,780432
test,1536,19,14592,361,51984,66576
test,1537,54,41472,2916,419904,461376
test,1538,38,29184,1444,207936,237120
test,1539,512,393216,262144,37748736,38141952
test,1540,233,178944,54289,7817616,7996560
test,1541,43,33024,1849,266256,299280
test,1542,204,156672,41616,5992704,6149376
test,1543,42,32256,1764,254016,286272
test,1544,108,82944,11664,1679616,1762560
test,1545,32,24576,1024,147456,172032
test,1546,358,274944,128164,18455616,18730560
test,1547,51,39168,2601,374544,413712
test,1548,55,42240,3025,435600,477840
test,1549,49,37632,2401,345744,383376
test,1550,77,59136,5929,853776,912912
test,1551,224,172032,50176,7225344,7397376
test,1552,234,179712,54756,7884864,8064576
test,1553,74,56832,5476,788544,845376
test,1554,15,11520,225,32400,43920
test,1555,15,11520,225,32400,43920
test,1556,33,25344,1089,156816,182160
test,1557,158,121344,24964,3594816,3716160
test,1558,17,13056,289,41616,54672
test,1559,29,22272,841,121104,143376
test,1560,17,13056,289,41616,54672
test,1561,61,46848,3721,535824,582672
test,1562,15,11520,225,32400,43920
test,1563,53,40704,2809,404496,445200
test,1564,106,81408,11236,1617984,1699392
test,1565,143,109824,20449,2944656,3054480
test,1566,75,57600,5625,810000,867600
test,1567,68,52224,4624,665856,718080
test,1568,39,29952,1521,219024,248976
test,1569,62,47616,3844,553536,601152
test,1570,512,393216,262144,37748736,38141952
test,1571,106,81408,11236,1617984,1699392
test,1572,19,14592,361,51984,66576
test,1573,65,49920,4225,608400,658320
test,1574,193,148224,37249,5363856,5512080
test,1575,65,49920,4225,608400,658320
test,1576,25,19200,625,90000,109200
test,1577,48,36864,2304,331776,368640
test,1578,431,331008,185761,26749584,27080592
test,1579,35,26880,1225,176400,203280
test,1580,109,83712,11881,1710864,1794576
test,1581,57,43776,3249,467856,511632
test,1582,120,92160,14400,2073600,2165760
test,1583,41,31488,1681,242064,273552
test,1584,36,27648,1296,186624,214272
test,1585,34,26112,1156,166464,192576
test,1586,77,59136,5929,853776,912912
test,1587,161,123648,25921,3732624,3856272
test,1588,77,59136,5929,853776,912912
test,1589,17,13056,289,41616,54672
test,1590,154,118272,23716,3415104,3533376
test,1591,28,21504,784,112896,134400
test,1592,130,99840,16900,2433600,2533440
test,1593,31,23808,961,138384,162192
test,1594,45,34560,2025,291600,326160
test,1595,114,87552,12996,1871424,1958976
test,1596,40,30720,1600,230400,261120
test,1597,109,83712,11881,1710864,1794576
test,1598,223,171264,49729,7160976,7332240
test,1599,54,41472,2916,419904,461376
test,1600,58,44544,3364,484416,528960
test,1601,94,72192,8836,1272384,1344576
test,1602,131,100608,17161,2471184,2571792
test,1603,49,37632,2401,345744,383376
test,1604,42,32256,1764,254016,286272
test,1605,68,52224,4624,665856,718080
test,1606,88,67584,7744,1115136,1182720
test,1607,33,25344,1089,156816,182160
test,1608,39,29952,1521,219024,248976
test,1609,69,52992,4761,685584,738576
test,1610,512,393216,262144,37748736,38141952
test,1611,51,39168,2601,374544,413712
test,1612,39,29952,1521,219024,248976
test,1613,107,82176,11449,1648656,1730832
test,1614,186,142848,34596,4981824,5124672
test,1615,87,66816,7569,1089936,1156752
test,1616,131,100608,17161,2471184,2571792
test,1617,107,82176,11449,1648656,1730832
test,1618,42,32256,1764,254016,286272
test,1619,78,59904,6084,876096,936000
test,1620,86,66048,7396,1065024,1131072
test,1621,293,225024,85849,12362256,12587280
test,1622,100,76800,10000,1440000,1516800
test,1623,79,60672,6241,898704,959376
test,1624,88,67584,7744,1115136,1182720
test,1625,63,48384,3969,571536,619920
test,1626,39,29952,1521,219024,248976
test,1627,74,56832,5476,788544,845376
test,1628,69,52992,4761,685584,738576
test,1629,153,117504,23409,3370896,3488400
test,1630,202,155136,40804,5875776,6030912
test,1631,133,102144,17689,2547216,2649360
test,1632,71,54528,5041,725904,780432
test,1633,26,19968,676,97344,117312
test,1634,199,152832,39601,5702544,5855376
test,1635,123,94464,15129,2178576,2273040
test,1636,85,65280,7225,1040400,1105680
test,1637,72,55296,5184,746496,801792
test,1638,170,130560,28900,4161600,4292160
test,1639,34,26112,1156,166464,192576
test,1640,139,106752,19321,2782224,2888976
test,1641,59,45312,3481,501264,546576
test,1642,213,163584,45369,6533136,6696720
test,1643,54,41472,2916,419904,461376
test,1644,115,88320,13225,1904400,1992720
test,1645,61,46848,3721,535824,582672
test,1646,118,90624,13924,2005056,2095680
test,1647,68,52224,4624,665856,718080
test,1648,103,79104,10609,1527696,1606800
test,1649,162,124416,26244,3779136,3903552
test,1650,39,29952,1521,219024,248976
test,1651,60,46080,3600,518400,564480
test,1652,100,76800,10000,1440000,1516800
test,1653,16,12288,256,36864,49152
test,1654,75,57600,5625,810000,867600
test,1655,195,149760,38025,5475600,5625360
test,1656,90,69120,8100,1166400,1235520
test,1657,58,44544,3364,484416,528960
test,1658,12,9216,144,20736,29952
test,1659,65,49920,4225,608400,658320
test,1660,39,29952,1521,219024,248976
test,1661,376,288768,141376,20358144,20646912
test,1662,203,155904,41209,5934096,6090000
test,1663,97,74496,9409,1354896,1429392
test,1664,32,24576,1024,147456,172032
test,1665,118,90624,13924,2005056,2095680
test,1666,57,43776,3249,467856,511632
test,1667,66,50688,4356,627264,677952
test,1668,69,52992,4761,685584,738576
test,1669,156,119808,24336,3504384,3624192
test,1670,56,43008,3136,451584,494592
test,1671,36,27648,1296,186624,214272
test,1672,133,102144,17689,2547216,2649360
test,1673,506,388608,256036,36869184,37257792
test,1674,18,13824,324,46656,60480
test,1675,80,61440,6400,921600,983040
test,1676,27,20736,729,104976,125712
test,1677,263,201984,69169,9960336,10162320
test,1678,74,56832,5476,788544,845376
test,1679,116,89088,13456,1937664,2026752
test,1680,39,29952,1521,219024,248976
test,1681,38,29184,1444,207936,237120
test,1682,75,57600,5625,810000,867600
test,1683,104,79872,10816,1557504,1637376
test,1684,62,47616,3844,553536,601152
test,1685,41,31488,1681,242064,273552
test,1686,52,39936,2704,389376,429312
test,1687,130,99840,16900,2433600,2533440
test,1688,80,61440,6400,921600,983040
test,1689,78,59904,6084,876096,936000
test,1690,59,45312,3481,501264,546576
test,1691,182,139776,33124,4769856,4909632
test,1692,104,79872,10816,1557504,1637376
test,1693,51,39168,2601,374544,413712
test,1694,313,240384,97969,14107536,14347920
test,1695,249,191232,62001,8928144,9119376
test,1696,400,307200,160000,23040000,23347200
test,1697,113,86784,12769,1838736,1925520
test,1698,173,132864,29929,4309776,4442640
test,1699,62,47616,3844,553536,601152
test,1700,52,39936,2704,389376,429312
test,1701,474,364032,224676,32353344,32717376
test,1702,105,80640,11025,1587600,1668240
test,1703,98,75264,9604,1382976,1458240
test,1704,244,187392,59536,8573184,8760576
test,1705,96,73728,9216,1327104,1400832
test,1706,92,70656,8464,1218816,1289472
test,1707,61,46848,3721,535824,582672
test,1708,96,73728,9216,1327104,1400832
test,1709,395,303360,156025,22467600,22770960
test,1710,94,72192,8836,1272384,1344576
test,1711,57,43776,3249,467856,511632
test,1712,109,83712,11881,1710864,1794576
test,1713,35,26880,1225,176400,203280
test,1714,66,50688,4356,627264,677952
test,1715,15,11520,225,32400,43920
test,1716,103,79104,10609,1527696,1606800
test,1717,345,264960,119025,17139600,17404560
test,1718,92,70656,8464,1218816,1289472
test,1719,108,82944,11664,1679616,1762560
test,1720,79,60672,6241,898704,959376
test,1721,32,24576,1024,147456,172032
test,1722,111,85248,12321,1774224,1859472
test,1723,48,36864,2304,331776,368640
test,1724,252,193536,63504,9144576,9338112
test,1725,50,38400,2500,360000,398400
test,1726,56,43008,3136,451584,494592
test,1727,73,56064,5329,767376,823440
test,1728,120,92160,14400,2073600,2165760
test,1729,100,76800,10000,1440000,1516800
test,1730,75,57600,5625,810000,867600
test,1731,27,20736,729,104976,125712
test,1732,28,21504,784,112896,134400
test,1733,89,68352,7921,1140624,1208976
test,1734,111,85248,12321,1774224,1859472
test,1735,74,56832,5476,788544,845376
test,1736,116,89088,13456,1937664,2026752
test,1737,196,150528,38416,5531904,5682432
test,1738,60,46080,3600,518400,564480
test,1739,512,393216,262144,37748736,38141952
test,1740,62,47616,3844,553536,601152
test,1741,50,38400,2500,360000,398400
test,1742,46,35328,2116,304704,340032
test,1743,18,13824,324,46656,60480
test,1744,92,70656,8464,1218816,1289472
test,1745,35,26880,1225,176400,203280
test,1746,33,25344,1089,156816,182160
test,1747,36,27648,1296,186624,214272
test,1748,72,55296,5184,746496,801792
test,1749,29,22272,841,121104,143376
test,1750,61,46848,3721,535824,582672
test,1751,497,381696,247009,35569296,35950992
test,1752,215,165120,46225,6656400,6821520
test,1753,62,47616,3844,553536,601152
test,1754,431,331008,185761,26749584,27080592
test,1755,27,20736,729,104976,125712
test,1756,55,42240,3025,435600,477840
test,1757,151,115968,22801,3283344,3399312
test,1758,171,131328,29241,4210704,4342032
test,1759,125,96000,15625,2250000,2346000
test,1760,98,75264,9604,1382976,1458240
test,1761,221,169728,48841,7033104,7202832
test,1762,16,12288,256,36864,49152
test,1763,37,28416,1369,197136,225552
test,1764,79,60672,6241,898704,959376
test,1765,118,90624,13924,2005056,2095680
test,1766,49,37632,2401,345744,383376
test,1767,31,23808,961,138384,162192
test,1768,334,256512,111556,16064064,16320576
test,1769,306,235008,93636,13483584,13718592
test,1770,164,125952,26896,3873024,3998976
test,1771,48,36864,2304,331776,368640
test,1772,81,62208,6561,944784,1006992
test,1773,15,11520,225,32400,43920
test,1774,30,23040,900,129600,152640
test,1775,32,24576,1024,147456,172032
test,1776,115,88320,13225,1904400,1992720
test,1777,118,90624,13924,2005056,2095680
test,1778,60,46080,3600,518400,564480
test,1779,382,293376,145924,21013056,21306432
test,1780,115,88320,13225,1904400,1992720
test,1781,58,44544,3364,484416,528960
test,1782,106,81408,11236,1617984,1699392
test,1783,401,307968,160801,23155344,23463312
test,1784,167,128256,27889,4016016,4144272
test,1785,99,76032,9801,1411344,1487376
test,1786,64,49152,4096,589824,638976
test,1787,17,13056,289,41616,54672
test,1788,22,16896,484,69696,86592
test,1789,181,139008,32761,4717584,4856592
test,1790,104,79872,10816,1557504,1637376
test,1791,81,62208,6561,944784,1006992
test,1792,44,33792,1936,278784,312576
test,1793,98,75264,9604,1382976,1458240
test,1794,36,27648,1296,186624,214272
test,1795,43,33024,1849,266256,299280
test,1796,266,204288,70756,10188864,10393152
test,1797,83,63744,6889,992016,1055760
test,1798,32,24576,1024,147456,172032
test,1799,114,87552,12996,1871424,1958976
test,1800,102,78336,10404,1498176,1576512
test,1801,512,393216,262144,37748736,38141952
test,1802,15,11520,225,32400,43920
test,1803,358,274944,128164,18455616,18730560
test,1804,79,60672,6241,898704,959376
test,1805,81,62208,6561,944784,1006992
test,1806,320,245760,102400,14745600,14991360
test,1807,56,43008,3136,451584,494592
test,1808,13,9984,169,24336,34320
test,1809,63,48384,3969,571536,619920
test,1810,79,60672,6241,898704,959376
test,1811,123,94464,15129,2178576,2273040
test,1812,79,60672,6241,898704,959376
test,1813,182,139776,33124,4769856,4909632
test,1814,41,31488,1681,242064,273552
test,1815,82,62976,6724,968256,1031232
test,1816,356,273408,126736,18249984,18523392
test,1817,86,66048,7396,1065024,1131072
test,1818,69,52992,4761,685584,738576
test,1819,64,49152,4096,589824,638976
test,1820,94,72192,8836,1272384,1344576
test,1821,16,12288,256,36864,49152
test,1822,83,63744,6889,992016,1055760
test,1823,44,33792,1936,278784,312576
test,1824,136,104448,18496,2663424,2767872
test,1825,116,89088,13456,1937664,2026752
test,1826,45,34560,2025,291600,326160
test,1827,31,23808,961,138384,162192
test,1828,69,52992,4761,685584,738576
test,1829,50,38400,2500,360000,398400
test,1830,137,105216,18769,2702736,2807952
test,1831,105,80640,11025,1587600,1668240
test,1832,114,87552,12996,1871424,1958976
test,1833,47,36096,2209,318096,354192
test,1834,69,52992,4761,685584,738576
test,1835,213,163584,45369,6533136,6696720
test,1836,46,35328,2116,304704,340032
test,1837,43,33024,1849,266256,299280
test,1838,44,33792,1936,278784,312576
test,1839,63,48384,3969,571536,619920
test,1840,168,129024,28224,4064256,4193280
test,1841,18,13824,324,46656,60480
test,1842,53,40704,2809,404496,445200
test,1843,54,41472,2916,419904,461376
test,1844,104,79872,10816,1557504,1637376
test,1845,23,17664,529,76176,93840
test,1846,28,21504,784,112896,134400
test,1847,41,31488,1681,242064,273552
test,1848,95,72960,9025,1299600,1372560
test,1849,29,22272,841,121104,143376
test,1850,97,74496,9409,1354896,1429392
test,1851,101,77568,10201,1468944,1546512
test,1852,19,14592,361,51984,66576
test,1853,263,201984,69169,9960336,10162320
test,1854,68,52224,4624,665856,718080
test,1855,115,88320,13225,1904400,1992720
test,1856,22,16896,484,69696,86592
test,1857,15,11520,225,32400,43920
test,1858,50,38400,2500,360000,398400
test,1859,114,87552,12996,1871424,1958976
test,1860,254,195072,64516,9290304,9485376
test,1861,15,11520,225,32400,43920
test,1862,82,62976,6724,968256,1031232
test,1863,218,167424,47524,6843456,7010880
test,1864,87,66816,7569,1089936,1156752
test,1865,512,393216,262144,37748736,38141952
test,1866,146,112128,21316,3069504,3181632
test,1867,15,11520,225,32400,43920
test,1868,61,46848,3721,535824,582672
test,1869,31,23808,961,138384,162192
test,1870,107,82176,11449,1648656,1730832
test,1871,512,393216,262144,37748736,38141952
test,1872,104,79872,10816,1557504,1637376
test,1873,231,177408,53361,7683984,7861392
test,1874,55,42240,3025,435600,477840
test,1875,212,162816,44944,6471936,6634752
test,1876,33,25344,1089,156816,182160
test,1877,170,130560,28900,4161600,4292160
test,1878,180,138240,32400,4665600,4803840
test,1879,28,21504,784,112896,134400
test,1880,14,10752,196,28224,38976
test,1881,99,76032,9801,1411344,1487376
test,1882,106,81408,11236,1617984,1699392
test,1883,104,79872,10816,1557504,1637376
test,1884,15,11520,225,32400,43920
test,1885,257,197376,66049,9511056,9708432
test,1886,16,12288,256,36864,49152
test,1887,84,64512,7056,1016064,1080576
test,1888,242,185856,58564,8433216,8619072
test,1889,402,308736,161604,23270976,23579712
test,1890,75,57600,5625,810000,867600
test,1891,112,86016,12544,1806336,1892352
test,1892,54,41472,2916,419904,461376
test,1893,155,119040,24025,3459600,3578640
test,1894,75,57600,5625,810000,867600
test,1895,72,55296,5184,746496,801792
test,1896,133,102144,17689,2547216,2649360
test,1897,51,39168,2601,374544,413712
test,1898,68,52224,4624,665856,718080
test,1899,58,44544,3364,484416,528960
test,1900,120,92160,14400,2073600,2165760
test,1901,94,72192,8836,1272384,1344576
test,1902,70,53760,4900,705600,759360
test,1903,10,7680,100,14400,22080
test,1904,84,64512,7056,1016064,1080576
test,1905,391,300288,152881,22014864,22315152
test,1906,56,43008,3136,451584,494592
test,1907,117,89856,13689,1971216,2061072
test,1908,48,36864,2304,331776,368640
test,1909,91,69888,8281,1192464,1262352
test,1910,52,39936,2704,389376,429312
test,1911,50,38400,2500,360000,398400
test,1912,48,36864,2304,331776,368640
test,1913,148,113664,21904,3154176,3267840
test,1914,36,27648,1296,186624,214272
test,1915,53,40704,2809,404496,445200
test,1916,99,76032,9801,1411344,1487376
test,1917,183,140544,33489,4822416,4962960
test,1918,239,183552,57121,8225424,8408976
test,1919,483,370944,233289,33593616,33964560
test,1920,81,62208,6561,944784,1006992
test,1921,15,11520,225,32400,43920
test,1922,228,175104,51984,7485696,7660800
test,1923,124,95232,15376,2214144,2309376
test,1924,67,51456,4489,646416,697872
test,1925,155,119040,24025,3459600,3578640
test,1926,63,48384,3969,571536,619920
test,1927,32,24576,1024,147456,172032
test,1928,58,44544,3364,484416,528960
test,1929,14,10752,196,28224,38976
test,1930,57,43776,3249,467856,511632
test,1931,78,59904,6084,876096,936000
test,1932,88,67584,7744,1115136,1182720
test,1933,145,111360,21025,3027600,3138960
test,1934,69,52992,4761,685584,738576
test,1935,275,211200,75625,10890000,11101200
test,1936,26,19968,676,97344,117312
test,1937,18,13824,324,46656,60480
test,1938,131,100608,17161,2471184,2571792
test,1939,137,105216,18769,2702736,2807952
test,1940,42,32256,1764,254016,286272
test,1941,71,54528,5041,725904,780432
test,1942,119,91392,14161,2039184,2130576
test,1943,231,177408,53361,7683984,7861392
test,1944,218,167424,47524,6843456,7010880
test,1945,93,71424,8649,1245456,1316880
test,1946,434,333312,188356,27123264,27456576
test,1947,112,86016,12544,1806336,1892352
test,1948,124,95232,15376,2214144,2309376
test,1949,305,234240,93025,13395600,13629840
test,1950,106,81408,11236,1617984,1699392
test,1951,26,19968,676,97344,117312
test,1952,71,54528,5041,725904,780432
test,1953,94,72192,8836,1272384,1344576
test,1954,82,62976,6724,968256,1031232
test,1955,55,42240,3025,435600,477840
test,1956,34,26112,1156,166464,192576
test,1957,60,46080,3600,518400,564480
test,1958,90,69120,8100,1166400,1235520
test,1959,17,13056,289,41616,54672
test,1960,131,100608,17161,2471184,2571792
test,1961,148,113664,21904,3154176,3267840
test,1962,15,11520,225,32400,43920
test,1963,84,64512,7056,1016064,1080576
test,1964,221,169728,48841,7033104,7202832
test,1965,182,139776,33124,4769856,4909632
test,1966,49,37632,2401,345744,383376
test,1967,101,77568,10201,1468944,1546512
test,1968,60,46080,3600,518400,564480
test,1969,73,56064,5329,767376,823440
test,1970,69,52992,4761,685584,738576
test,1971,88,67584,7744,1115136,1182720
test,1972,68,52224,4624,665856,718080
test,1973,112,86016,12544,1806336,1892352
test,1974,167,128256,27889,4016016,4144272
test,1975,136,104448,18496,2663424,2767872
test,1976,115,88320,13225,1904400,1992720
test,1977,86,66048,7396,1065024,1131072
test,1978,342,262656,116964,16842816,17105472
test,1979,130,99840,16900,2433600,2533440
test,1980,52,39936,2704,389376,429312
test,1981,53,40704,2809,404496,445200
test,1982,82,62976,6724,968256,1031232
test,1983,58,44544,3364,484416,528960
test,1984,171,131328,29241,4210704,4342032
test,1985,93,71424,8649,1245456,1316880
test,1986,54,41472,2916,419904,461376
test,1987,50,38400,2500,360000,398400
test,1988,14,10752,196,28224,38976
test,1989,94,72192,8836,1272384,1344576
test,1990,60,46080,3600,518400,564480
test,1991,239,183552,57121,8225424,8408976
test,1992,58,44544,3364,484416,528960
test,1993,109,83712,11881,1710864,1794576
test,1994,116,89088,13456,1937664,2026752
test,1995,100,76800,10000,1440000,1516800
test,1996,233,178944,54289,7817616,7996560
test,1997,197,151296,38809,5588496,5739792
test,1998,128,98304,16384,2359296,2457600
test,1999,66,50688,4356,627264,677952
test,2000,29,22272,841,121104,143376
test,2001,47,36096,2209,318096,354192
test,2002,394,302592,155236,22353984,22656576
test,2003,44,33792,1936,278784,312576
test,2004,50,38400,2500,360000,398400
test,2005,153,117504,23409,3370896,3488400
test,2006,43,33024,1849,266256,299280
test,2007,205,157440,42025,6051600,6209040
test,2008,457,350976,208849,30074256,30425232
test,2009,173,132864,29929,4309776,4442640
test,2010,512,393216,262144,37748736,38141952
test,2011,38,29184,1444,207936,237120
test,2012,210,161280,44100,6350400,6511680
test,2013,18,13824,324,46656,60480
test,2014,53,40704,2809,404496,445200
test,2015,106,81408,11236,1617984,1699392
test,2016,78,59904,6084,876096,936000
test,2017,60,46080,3600,518400,564480
test,2018,198,152064,39204,5645376,5797440
test,2019,68,52224,4624,665856,718080
test,2020,144,110592,20736,2985984,3096576
test,2021,40,30720,1600,230400,261120
test,2022,70,53760,4900,705600,759360
test,2023,46,35328,2116,304704,340032
test,2024,133,102144,17689,2547216,2649360
test,2025,486,373248,236196,34012224,34385472
test,2026,45,34560,2025,291600,326160
test,2027,189,145152,35721,5143824,5288976
test,2028,242,185856,58564,8433216,8619072
test,2029,69,52992,4761,685584,738576
test,2030,68,52224,4624,665856,718080
test,2031,116,89088,13456,1937664,2026752
test,2032,81,62208,6561,944784,1006992
test,2033,221,169728,48841,7033104,7202832
test,2034,64,49152,4096,589824,638976
test,2035,222,170496,49284,7096896,7267392
test,2036,49,37632,2401,345744,383376
test,2037,137,105216,18769,2702736,2807952
test,2038,34,26112,1156,166464,192576
test,2039,75,57600,5625,810000,867600
test,2040,43,33024,1849,266256,299280
test,2041,103,79104,10609,1527696,1606800
test,2042,170,130560,28900,4161600,4292160
test,2043,226,173568,51076,7354944,7528512
test,2044,114,87552,12996,1871424,1958976
test,2045,65,49920,4225,608400,658320
test,2046,65,49920,4225,608400,658320
test,2047,61,46848,3721,535824,582672
test,2048,15,11520,225,32400,43920
test,2049,73,56064,5329,767376,823440
test,2050,32,24576,1024,147456,172032
test,2051,16,12288,256,36864,49152
test,2052,109,83712,11881,1710864,1794576
test,2053,173,132864,29929,4309776,4442640
test,2054,303,232704,91809,13220496,13453200
test,2055,73,56064,5329,767376,823440
test,2056,17,13056,289,41616,54672
test,2057,328,251904,107584,15492096,15744000
test,2058,59,45312,3481,501264,546576
test,2059,285,218880,81225,11696400,11915280
test,2060,512,393216,262144,37748736,38141952
test,2061,51,39168,2601,374544,413712
test,2062,76,58368,5776,831744,890112
test,2063,75,57600,5625,810000,867600
test,2064,17,13056,289,41616,54672
test,2065,118,90624,13924,2005056,2095680
test,2066,12,9216,144,20736,29952
test,2067,51,39168,2601,374544,413712
test,2068,433,332544,187489,26998416,27330960
test,2069,162,124416,26244,3779136,3903552
test,2070,53,40704,2809,404496,445200
test,2071,171,131328,29241,4210704,4342032
test,2072,110,84480,12100,1742400,1826880
test,2073,95,72960,9025,1299600,1372560
test,2074,94,72192,8836,1272384,1344576
test,2075,28,21504,784,112896,134400
test,2076,44,33792,1936,278784,312576
test,2077,104,79872,10816,1557504,1637376
test,2078,64,49152,4096,589824,638976
test,2079,42,32256,1764,254016,286272
test,2080,106,81408,11236,1617984,1699392
test,2081,67,51456,4489,646416,697872
test,2082,50,38400,2500,360000,398400
test,2083,132,101376,17424,2509056,2610432
test,2084,55,42240,3025,435600,477840
test,2085,115,88320,13225,1904400,1992720
test,2086,95,72960,9025,1299600,1372560
test,2087,39,29952,1521,219024,248976
test,2088,173,132864,29929,4309776,4442640
test,2089,79,60672,6241,898704,959376
test,2090,57,43776,3249,467856,511632
test,2091,296,227328,87616,12616704,12844032
test,2092,281,215808,78961,11370384,11586192
test,2093,67,51456,4489,646416,697872
test,2094,84,64512,7056,1016064,1080576
test,2095,59,45312,3481,501264,546576
test,2096,258,198144,66564,9585216,9783360
test,2097,190,145920,36100,5198400,5344320
test,2098,37,28416,1369,197136,225552
test,2099,16,12288,256,36864,49152
test,2100,56,43008,3136,451584,494592
test,2101,15,11520,225,32400,43920
test,2102,96,73728,9216,1327104,1400832
test,2103,103,79104,10609,1527696,1606800
test,2104,74,56832,5476,788544,845376
test,2105,39,29952,1521,219024,248976
test,2106,66,50688,4356,627264,677952
test,2107,49,37632,2401,345744,383376
test,2108,12,9216,144,20736,29952
test,2109,63,48384,3969,571536,619920
test,2110,163,125184,26569,3825936,3951120
test,2111,121,92928,14641,2108304,2201232
test,2112,85,65280,7225,1040400,1105680
test,2113,53,40704,2809,404496,445200
test,2114,107,82176,11449,1648656,1730832
test,2115,208,159744,43264,6230016,6389760
test,2116,104,79872,10816,1557504,1637376
test,2117,61,46848,3721,535824,582672
test,2118,41,31488,1681,242064,273552
test,2119,103,79104,10609,1527696,1606800
test,2120,29,22272,841,121104,143376
test,2121,49,37632,2401,345744,383376
test,2122,19,14592,361,51984,66576
test,2123,70,53760,4900,705600,759360
test,2124,14,10752,196,28224,38976
test,2125,67,51456,4489,646416,697872
test,2126,29,22272,841,121104,143376
test,2127,214,164352,45796,6594624,6758976
test,2128,48,36864,2304,331776,368640
test,2129,30,23040,900,129600,152640
test,2130,214,164352,45796,6594624,6758976
test,2131,34,26112,1156,166464,192576
test,2132,98,75264,9604,1382976,1458240
test,2133,83,63744,6889,992016,1055760
test,2134,74,56832,5476,788544,845376
test,2135,512,393216,262144,37748736,38141952
test,2136,298,228864,88804,12787776,13016640
test,2137,206,158208,42436,6110784,6268992
test,2138,51,39168,2601,374544,413712
test,2139,329,252672,108241,15586704,15839376
test,2140,47,36096,2209,318096,354192
test,2141,18,13824,324,46656,60480
test,2142,30,23040,900,129600,152640
test,2143,63,48384,3969,571536,619920
test,2144,160,122880,25600,3686400,3809280
test,2145,59,45312,3481,501264,546576
test,2146,33,25344,1089,156816,182160
test,2147,211,162048,44521,6411024,6573072
test,2148,20,15360,400,57600,72960
test,2149,100,76800,10000,1440000,1516800
test,2150,53,40704,2809,404496,445200
test,2151,78,59904,6084,876096,936000
test,2152,40,30720,1600,230400,261120
test,2153,51,39168,2601,374544,413712
test,2154,220,168960,48400,6969600,7138560
test,2155,128,98304,16384,2359296,2457600
test,2156,29,22272,841,121104,143376
test,2157,74,56832,5476,788544,845376
test,2158,179,137472,32041,4613904,4751376
test,2159,325,249600,105625,15210000,15459600
test,2160,15,11520,225,32400,43920
test,2161,16,12288,256,36864,49152
test,2162,166,127488,27556,3968064,4095552
test,2163,50,38400,2500,360000,398400
test,2164,194,148992,37636,5419584,5568576
test,2165,403,309504,162409,23386896,23696400
test,2166,88,67584,7744,1115136,1182720
test,2167,512,393216,262144,37748736,38141952
test,2168,33,25344,1089,156816,182160
test,2169,512,393216,262144,37748736,38141952
test,2170,60,46080,3600,518400,564480
test,2171,64,49152,4096,589824,638976
test,2172,118,90624,13924,2005056,2095680
test,2173,70,53760,4900,705600,759360
test,2174,66,50688,4356,627264,677952
test,2175,36,27648,1296,186624,214272
test,2176,60,46080,3600,518400,564480
test,2177,49,37632,2401,345744,383376
test,2178,42,32256,1764,254016,286272
test,2179,48,36864,2304,331776,368640
test,2180,118,90624,13924,2005056,2095680
test,2181,80,61440,6400,921600,983040
test,2182,212,162816,44944,6471936,6634752
test,2183,130,99840,16900,2433600,2533440
test,2184,103,79104,10609,1527696,1606800
test,2185,45,34560,2025,291600,326160
test,2186,89,68352,7921,1140624,1208976
test,2187,115,88320,13225,1904400,1992720
test,2188,430,330240,184900,26625600,26955840
