split,index,nodes,total_values_for_nodes,edges,total_values_for_edges,total_values_for_graph
train,0,63,48384,3969,571536,619920
train,1,17,13056,289,41616,54672
train,2,39,29952,1521,219024,248976
train,3,21,16128,441,63504,79632
train,4,44,33792,1936,278784,312576
train,5,25,19200,625,90000,109200
train,6,16,12288,256,36864,49152
train,7,23,17664,529,76176,93840
train,8,22,16896,484,69696,86592
train,9,36,27648,1296,186624,214272
train,10,36,27648,1296,186624,214272
train,11,26,19968,676,97344,117312
train,12,28,21504,784,112896,134400
train,13,12,9216,144,20736,29952
train,14,18,13824,324,46656,60480
train,15,19,14592,361,51984,66576
train,16,31,23808,961,138384,162192
train,17,11,8448,121,17424,25872
train,18,24,18432,576,82944,101376
train,19,34,26112,1156,166464,192576
train,20,14,10752,196,28224,38976
train,21,5,3840,25,3600,7440
train,22,41,31488,1681,242064,273552
train,23,20,15360,400,57600,72960
train,24,14,10752,196,28224,38976
train,25,21,16128,441,63504,79632
train,26,23,17664,529,76176,93840
train,27,34,26112,1156,166464,192576
train,28,24,18432,576,82944,101376
train,29,7,5376,49,7056,12432
train,30,34,26112,1156,166464,192576
train,31,25,19200,625,90000,109200
train,32,7,5376,49,7056,12432
train,33,25,19200,625,90000,109200
train,34,41,31488,1681,242064,273552
train,35,38,29184,1444,207936,237120
train,36,44,33792,1936,278784,312576
train,37,39,29952,1521,219024,248976
train,38,39,29952,1521,219024,248976
train,39,44,33792,1936,278784,312576
train,40,31,23808,961,138384,162192
train,41,19,14592,361,51984,66576
train,42,18,13824,324,46656,60480
train,43,17,13056,289,41616,54672
train,44,36,27648,1296,186624,214272
train,45,19,14592,361,51984,66576
train,46,27,20736,729,104976,125712
train,47,31,23808,961,138384,162192
train,48,44,33792,1936,278784,312576
train,49,19,14592,361,51984,66576
train,50,17,13056,289,41616,54672
train,51,33,25344,1089,156816,182160
train,52,33,25344,1089,156816,182160
train,53,31,23808,961,138384,162192
train,54,19,14592,361,51984,66576
train,55,28,21504,784,112896,134400
train,56,18,13824,324,46656,60480
train,57,5,3840,25,3600,7440
train,58,36,27648,1296,186624,214272
train,59,30,23040,900,129600,152640
train,60,8,6144,64,9216,15360
train,61,40,30720,1600,230400,261120
train,62,25,19200,625,90000,109200
train,63,20,15360,400,57600,72960
train,64,5,3840,25,3600,7440
train,65,20,15360,400,57600,72960
train,66,24,18432,576,82944,101376
train,67,25,19200,625,90000,109200
train,68,23,17664,529,76176,93840
train,69,46,35328,2116,304704,340032
train,70,9,6912,81,11664,18576
train,71,18,13824,324,46656,60480
train,72,25,19200,625,90000,109200
train,73,38,29184,1444,207936,237120
train,74,11,8448,121,17424,25872
train,75,23,17664,529,76176,93840
train,76,17,13056,289,41616,54672
train,77,39,29952,1521,219024,248976
train,78,27,20736,729,104976,125712
train,79,34,26112,1156,166464,192576
train,80,16,12288,256,36864,49152
train,81,14,10752,196,28224,38976
train,82,24,18432,576,82944,101376
train,83,12,9216,144,20736,29952
train,84,36,27648,1296,186624,214272
train,85,25,19200,625,90000,109200
train,86,26,19968,676,97344,117312
train,87,34,26112,1156,166464,192576
train,88,38,29184,1444,207936,237120
train,89,13,9984,169,24336,34320
train,90,8,6144,64,9216,15360
train,91,37,28416,1369,197136,225552
train,92,19,14592,361,51984,66576
train,93,19,14592,361,51984,66576
train,94,11,8448,121,17424,25872
train,95,23,17664,529,76176,93840
train,96,34,26112,1156,166464,192576
train,97,18,13824,324,46656,60480
train,98,18,13824,324,46656,60480
train,99,31,23808,961,138384,162192
train,100,23,17664,529,76176,93840
train,101,31,23808,961,138384,162192
train,102,31,23808,961,138384,162192
train,103,53,40704,2809,404496,445200
train,104,22,16896,484,69696,86592
train,105,40,30720,1600,230400,261120
train,106,20,15360,400,57600,72960
train,107,21,16128,441,63504,79632
train,108,24,18432,576,82944,101376
train,109,21,16128,441,63504,79632
train,110,19,14592,361,51984,66576
train,111,34,26112,1156,166464,192576
train,112,35,26880,1225,176400,203280
train,113,28,21504,784,112896,134400
train,114,18,13824,324,46656,60480
train,115,18,13824,324,46656,60480
train,116,7,5376,49,7056,12432
train,117,23,17664,529,76176,93840
train,118,13,9984,169,24336,34320
train,119,65,49920,4225,608400,658320
train,120,13,9984,169,24336,34320
train,121,25,19200,625,90000,109200
train,122,10,7680,100,14400,22080
train,123,30,23040,900,129600,152640
train,124,38,29184,1444,207936,237120
train,125,34,26112,1156,166464,192576
train,126,22,16896,484,69696,86592
train,127,36,27648,1296,186624,214272
train,128,26,19968,676,97344,117312
train,129,30,23040,900,129600,152640
train,130,26,19968,676,97344,117312
train,131,41,31488,1681,242064,273552
train,132,32,24576,1024,147456,172032
train,133,41,31488,1681,242064,273552
train,134,53,40704,2809,404496,445200
train,135,41,31488,1681,242064,273552
train,136,18,13824,324,46656,60480
train,137,47,36096,2209,318096,354192
train,138,40,30720,1600,230400,261120
train,139,16,12288,256,36864,49152
train,140,33,25344,1089,156816,182160
train,141,9,6912,81,11664,18576
train,142,17,13056,289,41616,54672
train,143,18,13824,324,46656,60480
train,144,20,15360,400,57600,72960
train,145,28,21504,784,112896,134400
train,146,21,16128,441,63504,79632
train,147,26,19968,676,97344,117312
train,148,34,26112,1156,166464,192576
train,149,14,10752,196,28224,38976
train,150,37,28416,1369,197136,225552
train,151,15,11520,225,32400,43920
train,152,20,15360,400,57600,72960
train,153,28,21504,784,112896,134400
train,154,15,11520,225,32400,43920
train,155,13,9984,169,24336,34320
train,156,30,23040,900,129600,152640
train,157,29,22272,841,121104,143376
train,158,35,26880,1225,176400,203280
train,159,9,6912,81,11664,18576
train,160,14,10752,196,28224,38976
train,161,28,21504,784,112896,134400
train,162,6,4608,36,5184,9792
train,163,9,6912,81,11664,18576
train,164,25,19200,625,90000,109200
train,165,14,10752,196,28224,38976
train,166,31,23808,961,138384,162192
train,167,9,6912,81,11664,18576
train,168,29,22272,841,121104,143376
train,169,21,16128,441,63504,79632
train,170,29,22272,841,121104,143376
train,171,38,29184,1444,207936,237120
train,172,22,16896,484,69696,86592
train,173,13,9984,169,24336,34320
train,174,20,15360,400,57600,72960
train,175,35,26880,1225,176400,203280
train,176,12,9216,144,20736,29952
train,177,33,25344,1089,156816,182160
train,178,12,9216,144,20736,29952
train,179,34,26112,1156,166464,192576
train,180,25,19200,625,90000,109200
train,181,44,33792,1936,278784,312576
train,182,26,19968,676,97344,117312
train,183,18,13824,324,46656,60480
train,184,24,18432,576,82944,101376
train,185,23,17664,529,76176,93840
train,186,12,9216,144,20736,29952
train,187,23,17664,529,76176,93840
train,188,31,23808,961,138384,162192
train,189,45,34560,2025,291600,326160
train,190,20,15360,400,57600,72960
train,191,12,9216,144,20736,29952
train,192,38,29184,1444,207936,237120
train,193,19,14592,361,51984,66576
train,194,34,26112,1156,166464,192576
train,195,31,23808,961,138384,162192
train,196,26,19968,676,97344,117312
train,197,13,9984,169,24336,34320
train,198,18,13824,324,46656,60480
train,199,17,13056,289,41616,54672
train,200,20,15360,400,57600,72960
train,201,34,26112,1156,166464,192576
train,202,12,9216,144,20736,29952
train,203,22,16896,484,69696,86592
train,204,8,6144,64,9216,15360
train,205,23,17664,529,76176,93840
train,206,22,16896,484,69696,86592
train,207,41,31488,1681,242064,273552
train,208,19,14592,361,51984,66576
train,209,22,16896,484,69696,86592
train,210,15,11520,225,32400,43920
train,211,40,30720,1600,230400,261120
train,212,27,20736,729,104976,125712
train,213,33,25344,1089,156816,182160
train,214,16,12288,256,36864,49152
train,215,28,21504,784,112896,134400
train,216,23,17664,529,76176,93840
train,217,31,23808,961,138384,162192
train,218,9,6912,81,11664,18576
train,219,28,21504,784,112896,134400
train,220,19,14592,361,51984,66576
train,221,33,25344,1089,156816,182160
train,222,40,30720,1600,230400,261120
train,223,30,23040,900,129600,152640
train,224,30,23040,900,129600,152640
train,225,8,6144,64,9216,15360
train,226,32,24576,1024,147456,172032
train,227,33,25344,1089,156816,182160
train,228,11,8448,121,17424,25872
train,229,55,42240,3025,435600,477840
train,230,26,19968,676,97344,117312
train,231,14,10752,196,28224,38976
train,232,19,14592,361,51984,66576
train,233,13,9984,169,24336,34320
train,234,10,7680,100,14400,22080
train,235,28,21504,784,112896,134400
train,236,17,13056,289,41616,54672
train,237,26,19968,676,97344,117312
train,238,20,15360,400,57600,72960
train,239,8,6144,64,9216,15360
train,240,38,29184,1444,207936,237120
train,241,16,12288,256,36864,49152
train,242,14,10752,196,28224,38976
train,243,15,11520,225,32400,43920
train,244,8,6144,64,9216,15360
train,245,27,20736,729,104976,125712
train,246,34,26112,1156,166464,192576
train,247,33,25344,1089,156816,182160
train,248,12,9216,144,20736,29952
train,249,29,22272,841,121104,143376
train,250,35,26880,1225,176400,203280
train,251,9,6912,81,11664,18576
train,252,27,20736,729,104976,125712
train,253,18,13824,324,46656,60480
train,254,30,23040,900,129600,152640
train,255,7,5376,49,7056,12432
train,256,24,18432,576,82944,101376
train,257,13,9984,169,24336,34320
train,258,36,27648,1296,186624,214272
train,259,16,12288,256,36864,49152
train,260,24,18432,576,82944,101376
train,261,32,24576,1024,147456,172032
train,262,43,33024,1849,266256,299280
train,263,40,30720,1600,230400,261120
train,264,9,6912,81,11664,18576
train,265,25,19200,625,90000,109200
train,266,18,13824,324,46656,60480
train,267,32,24576,1024,147456,172032
train,268,23,17664,529,76176,93840
train,269,43,33024,1849,266256,299280
train,270,35,26880,1225,176400,203280
train,271,15,11520,225,32400,43920
train,272,25,19200,625,90000,109200
train,273,37,28416,1369,197136,225552
train,274,29,22272,841,121104,143376
train,275,36,27648,1296,186624,214272
train,276,36,27648,1296,186624,214272
train,277,22,16896,484,69696,86592
train,278,32,24576,1024,147456,172032
train,279,6,4608,36,5184,9792
train,280,12,9216,144,20736,29952
train,281,25,19200,625,90000,109200
train,282,20,15360,400,57600,72960
train,283,22,16896,484,69696,86592
train,284,20,15360,400,57600,72960
train,285,32,24576,1024,147456,172032
train,286,11,8448,121,17424,25872
train,287,50,38400,2500,360000,398400
train,288,19,14592,361,51984,66576
train,289,26,19968,676,97344,117312
train,290,14,10752,196,28224,38976
train,291,41,31488,1681,242064,273552
train,292,28,21504,784,112896,134400
train,293,51,39168,2601,374544,413712
train,294,19,14592,361,51984,66576
train,295,10,7680,100,14400,22080
train,296,44,33792,1936,278784,312576
train,297,31,23808,961,138384,162192
train,298,21,16128,441,63504,79632
train,299,9,6912,81,11664,18576
train,300,30,23040,900,129600,152640
train,301,22,16896,484,69696,86592
train,302,23,17664,529,76176,93840
train,303,21,16128,441,63504,79632
train,304,11,8448,121,17424,25872
train,305,7,5376,49,7056,12432
train,306,9,6912,81,11664,18576
train,307,26,19968,676,97344,117312
train,308,20,15360,400,57600,72960
train,309,24,18432,576,82944,101376
train,310,15,11520,225,32400,43920
train,311,29,22272,841,121104,143376
train,312,41,31488,1681,242064,273552
train,313,44,33792,1936,278784,312576
train,314,12,9216,144,20736,29952
train,315,44,33792,1936,278784,312576
train,316,24,18432,576,82944,101376
train,317,25,19200,625,90000,109200
train,318,9,6912,81,11664,18576
train,319,37,28416,1369,197136,225552
train,320,30,23040,900,129600,152640
train,321,29,22272,841,121104,143376
train,322,18,13824,324,46656,60480
train,323,20,15360,400,57600,72960
train,324,32,24576,1024,147456,172032
train,325,22,16896,484,69696,86592
train,326,26,19968,676,97344,117312
train,327,26,19968,676,97344,117312
train,328,43,33024,1849,266256,299280
train,329,13,9984,169,24336,34320
train,330,37,28416,1369,197136,225552
train,331,18,13824,324,46656,60480
train,332,28,21504,784,112896,134400
train,333,29,22272,841,121104,143376
train,334,41,31488,1681,242064,273552
train,335,46,35328,2116,304704,340032
train,336,24,18432,576,82944,101376
train,337,12,9216,144,20736,29952
train,338,35,26880,1225,176400,203280
train,339,8,6144,64,9216,15360
train,340,20,15360,400,57600,72960
train,341,51,39168,2601,374544,413712
train,342,10,7680,100,14400,22080
train,343,7,5376,49,7056,12432
train,344,7,5376,49,7056,12432
train,345,36,27648,1296,186624,214272
train,346,30,23040,900,129600,152640
train,347,20,15360,400,57600,72960
train,348,11,8448,121,17424,25872
train,349,11,8448,121,17424,25872
train,350,33,25344,1089,156816,182160
train,351,20,15360,400,57600,72960
train,352,44,33792,1936,278784,312576
train,353,14,10752,196,28224,38976
train,354,30,23040,900,129600,152640
train,355,24,18432,576,82944,101376
train,356,26,19968,676,97344,117312
train,357,28,21504,784,112896,134400
train,358,41,31488,1681,242064,273552
train,359,18,13824,324,46656,60480
train,360,14,10752,196,28224,38976
train,361,26,19968,676,97344,117312
train,362,20,15360,400,57600,72960
train,363,23,17664,529,76176,93840
train,364,18,13824,324,46656,60480
train,365,24,18432,576,82944,101376
train,366,33,25344,1089,156816,182160
train,367,21,16128,441,63504,79632
train,368,38,29184,1444,207936,237120
train,369,56,43008,3136,451584,494592
train,370,46,35328,2116,304704,340032
train,371,13,9984,169,24336,34320
train,372,34,26112,1156,166464,192576
train,373,12,9216,144,20736,29952
train,374,16,12288,256,36864,49152
train,375,21,16128,441,63504,79632
train,376,26,19968,676,97344,117312
train,377,16,12288,256,36864,49152
train,378,15,11520,225,32400,43920
train,379,39,29952,1521,219024,248976
train,380,22,16896,484,69696,86592
train,381,10,7680,100,14400,22080
train,382,13,9984,169,24336,34320
train,383,12,9216,144,20736,29952
train,384,16,12288,256,36864,49152
train,385,10,7680,100,14400,22080
train,386,15,11520,225,32400,43920
train,387,10,7680,100,14400,22080
train,388,26,19968,676,97344,117312
train,389,33,25344,1089,156816,182160
train,390,25,19200,625,90000,109200
train,391,7,5376,49,7056,12432
train,392,21,16128,441,63504,79632
train,393,26,19968,676,97344,117312
train,394,13,9984,169,24336,34320
train,395,24,18432,576,82944,101376
train,396,48,36864,2304,331776,368640
train,397,15,11520,225,32400,43920
train,398,16,12288,256,36864,49152
train,399,37,28416,1369,197136,225552
train,400,11,8448,121,17424,25872
train,401,47,36096,2209,318096,354192
train,402,26,19968,676,97344,117312
train,403,41,31488,1681,242064,273552
train,404,52,39936,2704,389376,429312
train,405,46,35328,2116,304704,340032
train,406,29,22272,841,121104,143376
train,407,14,10752,196,28224,38976
train,408,31,23808,961,138384,162192
train,409,17,13056,289,41616,54672
train,410,26,19968,676,97344,117312
train,411,11,8448,121,17424,25872
train,412,24,18432,576,82944,101376
train,413,29,22272,841,121104,143376
train,414,43,33024,1849,266256,299280
train,415,11,8448,121,17424,25872
train,416,31,23808,961,138384,162192
train,417,19,14592,361,51984,66576
train,418,37,28416,1369,197136,225552
train,419,18,13824,324,46656,60480
train,420,20,15360,400,57600,72960
train,421,31,23808,961,138384,162192
train,422,12,9216,144,20736,29952
train,423,17,13056,289,41616,54672
train,424,31,23808,961,138384,162192
train,425,13,9984,169,24336,34320
train,426,26,19968,676,97344,117312
train,427,25,19200,625,90000,109200
train,428,28,21504,784,112896,134400
train,429,32,24576,1024,147456,172032
train,430,19,14592,361,51984,66576
train,431,31,23808,961,138384,162192
train,432,31,23808,961,138384,162192
train,433,20,15360,400,57600,72960
train,434,38,29184,1444,207936,237120
train,435,24,18432,576,82944,101376
train,436,37,28416,1369,197136,225552
train,437,22,16896,484,69696,86592
train,438,16,12288,256,36864,49152
train,439,16,12288,256,36864,49152
train,440,14,10752,196,28224,38976
train,441,38,29184,1444,207936,237120
train,442,43,33024,1849,266256,299280
train,443,17,13056,289,41616,54672
train,444,18,13824,324,46656,60480
train,445,37,28416,1369,197136,225552
train,446,18,13824,324,46656,60480
train,447,40,30720,1600,230400,261120
train,448,25,19200,625,90000,109200
train,449,33,25344,1089,156816,182160
train,450,36,27648,1296,186624,214272
train,451,23,17664,529,76176,93840
train,452,10,7680,100,14400,22080
train,453,16,12288,256,36864,49152
train,454,10,7680,100,14400,22080
train,455,14,10752,196,28224,38976
train,456,47,36096,2209,318096,354192
train,457,39,29952,1521,219024,248976
train,458,7,5376,49,7056,12432
train,459,31,23808,961,138384,162192
train,460,13,9984,169,24336,34320
train,461,34,26112,1156,166464,192576
train,462,49,37632,2401,345744,383376
train,463,25,19200,625,90000,109200
train,464,22,16896,484,69696,86592
train,465,36,27648,1296,186624,214272
train,466,27,20736,729,104976,125712
train,467,32,24576,1024,147456,172032
train,468,34,26112,1156,166464,192576
train,469,18,13824,324,46656,60480
train,470,25,19200,625,90000,109200
train,471,31,23808,961,138384,162192
train,472,31,23808,961,138384,162192
train,473,19,14592,361,51984,66576
train,474,35,26880,1225,176400,203280
train,475,28,21504,784,112896,134400
train,476,36,27648,1296,186624,214272
train,477,53,40704,2809,404496,445200
train,478,18,13824,324,46656,60480
train,479,25,19200,625,90000,109200
train,480,32,24576,1024,147456,172032
train,481,34,26112,1156,166464,192576
train,482,7,5376,49,7056,12432
train,483,14,10752,196,28224,38976
train,484,47,36096,2209,318096,354192
train,485,19,14592,361,51984,66576
train,486,27,20736,729,104976,125712
train,487,17,13056,289,41616,54672
train,488,31,23808,961,138384,162192
train,489,40,30720,1600,230400,261120
train,490,16,12288,256,36864,49152
train,491,33,25344,1089,156816,182160
train,492,11,8448,121,17424,25872
train,493,27,20736,729,104976,125712
train,494,9,6912,81,11664,18576
train,495,20,15360,400,57600,72960
train,496,18,13824,324,46656,60480
train,497,22,16896,484,69696,86592
train,498,37,28416,1369,197136,225552
train,499,19,14592,361,51984,66576
train,500,28,21504,784,112896,134400
train,501,10,7680,100,14400,22080
train,502,32,24576,1024,147456,172032
train,503,48,36864,2304,331776,368640
train,504,40,30720,1600,230400,261120
train,505,26,19968,676,97344,117312
train,506,25,19200,625,90000,109200
train,507,35,26880,1225,176400,203280
train,508,31,23808,961,138384,162192
train,509,33,25344,1089,156816,182160
train,510,35,26880,1225,176400,203280
train,511,20,15360,400,57600,72960
train,512,13,9984,169,24336,34320
train,513,24,18432,576,82944,101376
train,514,19,14592,361,51984,66576
train,515,17,13056,289,41616,54672
train,516,34,26112,1156,166464,192576
train,517,24,18432,576,82944,101376
train,518,18,13824,324,46656,60480
train,519,16,12288,256,36864,49152
train,520,45,34560,2025,291600,326160
train,521,22,16896,484,69696,86592
train,522,9,6912,81,11664,18576
train,523,12,9216,144,20736,29952
train,524,18,13824,324,46656,60480
train,525,11,8448,121,17424,25872
train,526,32,24576,1024,147456,172032
train,527,32,24576,1024,147456,172032
train,528,17,13056,289,41616,54672
train,529,24,18432,576,82944,101376
train,530,21,16128,441,63504,79632
train,531,25,19200,625,90000,109200
train,532,19,14592,361,51984,66576
train,533,29,22272,841,121104,143376
train,534,29,22272,841,121104,143376
train,535,23,17664,529,76176,93840
train,536,53,40704,2809,404496,445200
train,537,25,19200,625,90000,109200
train,538,11,8448,121,17424,25872
train,539,28,21504,784,112896,134400
train,540,19,14592,361,51984,66576
train,541,28,21504,784,112896,134400
train,542,7,5376,49,7056,12432
train,543,18,13824,324,46656,60480
train,544,39,29952,1521,219024,248976
train,545,47,36096,2209,318096,354192
train,546,30,23040,900,129600,152640
train,547,39,29952,1521,219024,248976
train,548,25,19200,625,90000,109200
train,549,15,11520,225,32400,43920
train,550,17,13056,289,41616,54672
train,551,39,29952,1521,219024,248976
train,552,17,13056,289,41616,54672
train,553,27,20736,729,104976,125712
train,554,25,19200,625,90000,109200
train,555,8,6144,64,9216,15360
train,556,27,20736,729,104976,125712
train,557,16,12288,256,36864,49152
train,558,32,24576,1024,147456,172032
train,559,35,26880,1225,176400,203280
train,560,16,12288,256,36864,49152
train,561,20,15360,400,57600,72960
train,562,10,7680,100,14400,22080
train,563,21,16128,441,63504,79632
train,564,36,27648,1296,186624,214272
train,565,40,30720,1600,230400,261120
train,566,47,36096,2209,318096,354192
train,567,28,21504,784,112896,134400
train,568,14,10752,196,28224,38976
train,569,13,9984,169,24336,34320
train,570,11,8448,121,17424,25872
train,571,22,16896,484,69696,86592
train,572,24,18432,576,82944,101376
train,573,40,30720,1600,230400,261120
train,574,12,9216,144,20736,29952
train,575,39,29952,1521,219024,248976
train,576,29,22272,841,121104,143376
train,577,36,27648,1296,186624,214272
train,578,23,17664,529,76176,93840
train,579,18,13824,324,46656,60480
train,580,18,13824,324,46656,60480
train,581,28,21504,784,112896,134400
train,582,27,20736,729,104976,125712
train,583,17,13056,289,41616,54672
train,584,30,23040,900,129600,152640
train,585,29,22272,841,121104,143376
train,586,19,14592,361,51984,66576
train,587,23,17664,529,76176,93840
train,588,24,18432,576,82944,101376
train,589,52,39936,2704,389376,429312
train,590,28,21504,784,112896,134400
train,591,29,22272,841,121104,143376
train,592,28,21504,784,112896,134400
train,593,19,14592,361,51984,66576
train,594,34,26112,1156,166464,192576
train,595,53,40704,2809,404496,445200
train,596,16,12288,256,36864,49152
train,597,9,6912,81,11664,18576
train,598,35,26880,1225,176400,203280
train,599,26,19968,676,97344,117312
train,600,25,19200,625,90000,109200
train,601,28,21504,784,112896,134400
train,602,9,6912,81,11664,18576
train,603,22,16896,484,69696,86592
train,604,9,6912,81,11664,18576
train,605,21,16128,441,63504,79632
train,606,13,9984,169,24336,34320
train,607,22,16896,484,69696,86592
train,608,24,18432,576,82944,101376
train,609,20,15360,400,57600,72960
train,610,15,11520,225,32400,43920
train,611,34,26112,1156,166464,192576
train,612,11,8448,121,17424,25872
train,613,38,29184,1444,207936,237120
train,614,13,9984,169,24336,34320
train,615,41,31488,1681,242064,273552
train,616,30,23040,900,129600,152640
train,617,11,8448,121,17424,25872
train,618,43,33024,1849,266256,299280
train,619,14,10752,196,28224,38976
train,620,39,29952,1521,219024,248976
train,621,5,3840,25,3600,7440
train,622,46,35328,2116,304704,340032
train,623,13,9984,169,24336,34320
train,624,23,17664,529,76176,93840
train,625,24,18432,576,82944,101376
train,626,33,25344,1089,156816,182160
train,627,36,27648,1296,186624,214272
train,628,40,30720,1600,230400,261120
train,629,13,9984,169,24336,34320
train,630,6,4608,36,5184,9792
train,631,46,35328,2116,304704,340032
train,632,24,18432,576,82944,101376
train,633,25,19200,625,90000,109200
train,634,27,20736,729,104976,125712
train,635,9,6912,81,11664,18576
train,636,22,16896,484,69696,86592
train,637,20,15360,400,57600,72960
train,638,28,21504,784,112896,134400
train,639,23,17664,529,76176,93840
train,640,30,23040,900,129600,152640
train,641,56,43008,3136,451584,494592
train,642,38,29184,1444,207936,237120
train,643,53,40704,2809,404496,445200
train,644,36,27648,1296,186624,214272
train,645,35,26880,1225,176400,203280
train,646,19,14592,361,51984,66576
train,647,17,13056,289,41616,54672
train,648,24,18432,576,82944,101376
train,649,21,16128,441,63504,79632
train,650,18,13824,324,46656,60480
train,651,45,34560,2025,291600,326160
train,652,19,14592,361,51984,66576
train,653,23,17664,529,76176,93840
train,654,15,11520,225,32400,43920
train,655,31,23808,961,138384,162192
train,656,15,11520,225,32400,43920
train,657,25,19200,625,90000,109200
train,658,29,22272,841,121104,143376
train,659,6,4608,36,5184,9792
train,660,28,21504,784,112896,134400
train,661,21,16128,441,63504,79632
train,662,26,19968,676,97344,117312
train,663,4,3072,16,2304,5376
train,664,16,12288,256,36864,49152
train,665,14,10752,196,28224,38976
train,666,19,14592,361,51984,66576
train,667,23,17664,529,76176,93840
train,668,10,7680,100,14400,22080
train,669,14,10752,196,28224,38976
train,670,38,29184,1444,207936,237120
train,671,17,13056,289,41616,54672
train,672,19,14592,361,51984,66576
train,673,10,7680,100,14400,22080
train,674,19,14592,361,51984,66576
train,675,20,15360,400,57600,72960
train,676,43,33024,1849,266256,299280
train,677,25,19200,625,90000,109200
train,678,19,14592,361,51984,66576
train,679,8,6144,64,9216,15360
train,680,14,10752,196,28224,38976
train,681,14,10752,196,28224,38976
train,682,10,7680,100,14400,22080
train,683,22,16896,484,69696,86592
train,684,20,15360,400,57600,72960
train,685,11,8448,121,17424,25872
train,686,9,6912,81,11664,18576
train,687,17,13056,289,41616,54672
train,688,15,11520,225,32400,43920
train,689,25,19200,625,90000,109200
train,690,13,9984,169,24336,34320
train,691,7,5376,49,7056,12432
train,692,14,10752,196,28224,38976
train,693,30,23040,900,129600,152640
train,694,10,7680,100,14400,22080
train,695,62,47616,3844,553536,601152
train,696,33,25344,1089,156816,182160
train,697,32,24576,1024,147456,172032
train,698,15,11520,225,32400,43920
train,699,16,12288,256,36864,49152
train,700,46,35328,2116,304704,340032
train,701,17,13056,289,41616,54672
train,702,14,10752,196,28224,38976
train,703,19,14592,361,51984,66576
train,704,27,20736,729,104976,125712
train,705,27,20736,729,104976,125712
train,706,14,10752,196,28224,38976
train,707,35,26880,1225,176400,203280
train,708,25,19200,625,90000,109200
train,709,21,16128,441,63504,79632
train,710,36,27648,1296,186624,214272
train,711,27,20736,729,104976,125712
train,712,16,12288,256,36864,49152
train,713,24,18432,576,82944,101376
train,714,51,39168,2601,374544,413712
train,715,25,19200,625,90000,109200
train,716,33,25344,1089,156816,182160
train,717,21,16128,441,63504,79632
train,718,41,31488,1681,242064,273552
train,719,35,26880,1225,176400,203280
train,720,18,13824,324,46656,60480
train,721,38,29184,1444,207936,237120
train,722,14,10752,196,28224,38976
train,723,41,31488,1681,242064,273552
train,724,22,16896,484,69696,86592
train,725,18,13824,324,46656,60480
train,726,26,19968,676,97344,117312
train,727,8,6144,64,9216,15360
train,728,33,25344,1089,156816,182160
train,729,34,26112,1156,166464,192576
train,730,25,19200,625,90000,109200
train,731,21,16128,441,63504,79632
train,732,42,32256,1764,254016,286272
train,733,33,25344,1089,156816,182160
train,734,32,24576,1024,147456,172032
train,735,40,30720,1600,230400,261120
train,736,35,26880,1225,176400,203280
train,737,6,4608,36,5184,9792
train,738,20,15360,400,57600,72960
train,739,15,11520,225,32400,43920
train,740,30,23040,900,129600,152640
train,741,14,10752,196,28224,38976
train,742,17,13056,289,41616,54672
train,743,18,13824,324,46656,60480
train,744,6,4608,36,5184,9792
train,745,14,10752,196,28224,38976
train,746,29,22272,841,121104,143376
train,747,37,28416,1369,197136,225552
train,748,19,14592,361,51984,66576
train,749,20,15360,400,57600,72960
train,750,27,20736,729,104976,125712
train,751,27,20736,729,104976,125712
train,752,13,9984,169,24336,34320
train,753,26,19968,676,97344,117312
train,754,22,16896,484,69696,86592
train,755,28,21504,784,112896,134400
train,756,32,24576,1024,147456,172032
train,757,20,15360,400,57600,72960
train,758,12,9216,144,20736,29952
train,759,28,21504,784,112896,134400
train,760,8,6144,64,9216,15360
train,761,29,22272,841,121104,143376
train,762,21,16128,441,63504,79632
train,763,41,31488,1681,242064,273552
train,764,28,21504,784,112896,134400
train,765,29,22272,841,121104,143376
train,766,18,13824,324,46656,60480
train,767,17,13056,289,41616,54672
train,768,42,32256,1764,254016,286272
train,769,25,19200,625,90000,109200
train,770,29,22272,841,121104,143376
train,771,14,10752,196,28224,38976
train,772,26,19968,676,97344,117312
train,773,29,22272,841,121104,143376
train,774,36,27648,1296,186624,214272
train,775,26,19968,676,97344,117312
train,776,49,37632,2401,345744,383376
train,777,38,29184,1444,207936,237120
train,778,43,33024,1849,266256,299280
train,779,41,31488,1681,242064,273552
train,780,37,28416,1369,197136,225552
train,781,44,33792,1936,278784,312576
train,782,34,26112,1156,166464,192576
train,783,27,20736,729,104976,125712
train,784,16,12288,256,36864,49152
train,785,13,9984,169,24336,34320
train,786,16,12288,256,36864,49152
train,787,33,25344,1089,156816,182160
train,788,54,41472,2916,419904,461376
train,789,10,7680,100,14400,22080
train,790,27,20736,729,104976,125712
train,791,13,9984,169,24336,34320
train,792,14,10752,196,28224,38976
train,793,30,23040,900,129600,152640
train,794,12,9216,144,20736,29952
train,795,41,31488,1681,242064,273552
train,796,42,32256,1764,254016,286272
train,797,10,7680,100,14400,22080
train,798,18,13824,324,46656,60480
train,799,21,16128,441,63504,79632
train,800,38,29184,1444,207936,237120
train,801,20,15360,400,57600,72960
train,802,11,8448,121,17424,25872
train,803,27,20736,729,104976,125712
train,804,16,12288,256,36864,49152
train,805,27,20736,729,104976,125712
train,806,41,31488,1681,242064,273552
train,807,37,28416,1369,197136,225552
train,808,32,24576,1024,147456,172032
train,809,7,5376,49,7056,12432
train,810,20,15360,400,57600,72960
train,811,13,9984,169,24336,34320
train,812,29,22272,841,121104,143376
train,813,39,29952,1521,219024,248976
train,814,51,39168,2601,374544,413712
train,815,45,34560,2025,291600,326160
train,816,21,16128,441,63504,79632
train,817,40,30720,1600,230400,261120
train,818,32,24576,1024,147456,172032
train,819,21,16128,441,63504,79632
train,820,20,15360,400,57600,72960
train,821,23,17664,529,76176,93840
train,822,24,18432,576,82944,101376
train,823,18,13824,324,46656,60480
train,824,31,23808,961,138384,162192
train,825,43,33024,1849,266256,299280
train,826,10,7680,100,14400,22080
train,827,42,32256,1764,254016,286272
train,828,18,13824,324,46656,60480
train,829,29,22272,841,121104,143376
train,830,46,35328,2116,304704,340032
train,831,27,20736,729,104976,125712
train,832,44,33792,1936,278784,312576
train,833,13,9984,169,24336,34320
train,834,31,23808,961,138384,162192
train,835,23,17664,529,76176,93840
train,836,41,31488,1681,242064,273552
train,837,20,15360,400,57600,72960
train,838,25,19200,625,90000,109200
train,839,29,22272,841,121104,143376
train,840,41,31488,1681,242064,273552
train,841,32,24576,1024,147456,172032
train,842,12,9216,144,20736,29952
train,843,14,10752,196,28224,38976
train,844,38,29184,1444,207936,237120
train,845,9,6912,81,11664,18576
train,846,56,43008,3136,451584,494592
train,847,29,22272,841,121104,143376
train,848,18,13824,324,46656,60480
train,849,19,14592,361,51984,66576
train,850,21,16128,441,63504,79632
train,851,11,8448,121,17424,25872
train,852,40,30720,1600,230400,261120
train,853,16,12288,256,36864,49152
train,854,26,19968,676,97344,117312
train,855,16,12288,256,36864,49152
train,856,25,19200,625,90000,109200
train,857,55,42240,3025,435600,477840
train,858,36,27648,1296,186624,214272
train,859,37,28416,1369,197136,225552
train,860,8,6144,64,9216,15360
train,861,39,29952,1521,219024,248976
train,862,21,16128,441,63504,79632
train,863,11,8448,121,17424,25872
train,864,43,33024,1849,266256,299280
train,865,21,16128,441,63504,79632
train,866,38,29184,1444,207936,237120
train,867,17,13056,289,41616,54672
train,868,22,16896,484,69696,86592
train,869,36,27648,1296,186624,214272
train,870,20,15360,400,57600,72960
train,871,25,19200,625,90000,109200
train,872,28,21504,784,112896,134400
train,873,20,15360,400,57600,72960
train,874,22,16896,484,69696,86592
train,875,45,34560,2025,291600,326160
train,876,13,9984,169,24336,34320
train,877,34,26112,1156,166464,192576
train,878,28,21504,784,112896,134400
train,879,24,18432,576,82944,101376
train,880,14,10752,196,28224,38976
train,881,14,10752,196,28224,38976
train,882,28,21504,784,112896,134400
train,883,17,13056,289,41616,54672
train,884,9,6912,81,11664,18576
train,885,10,7680,100,14400,22080
train,886,21,16128,441,63504,79632
train,887,22,16896,484,69696,86592
train,888,16,12288,256,36864,49152
train,889,22,16896,484,69696,86592
train,890,29,22272,841,121104,143376
train,891,9,6912,81,11664,18576
train,892,28,21504,784,112896,134400
train,893,23,17664,529,76176,93840
train,894,15,11520,225,32400,43920
train,895,41,31488,1681,242064,273552
train,896,37,28416,1369,197136,225552
train,897,22,16896,484,69696,86592
train,898,30,23040,900,129600,152640
train,899,20,15360,400,57600,72960
train,900,27,20736,729,104976,125712
train,901,24,18432,576,82944,101376
train,902,20,15360,400,57600,72960
train,903,22,16896,484,69696,86592
train,904,28,21504,784,112896,134400
train,905,11,8448,121,17424,25872
train,906,54,41472,2916,419904,461376
train,907,31,23808,961,138384,162192
train,908,28,21504,784,112896,134400
train,909,11,8448,121,17424,25872
train,910,10,7680,100,14400,22080
train,911,28,21504,784,112896,134400
train,912,19,14592,361,51984,66576
train,913,38,29184,1444,207936,237120
train,914,11,8448,121,17424,25872
train,915,19,14592,361,51984,66576
train,916,28,21504,784,112896,134400
train,917,27,20736,729,104976,125712
train,918,14,10752,196,28224,38976
train,919,45,34560,2025,291600,326160
train,920,15,11520,225,32400,43920
train,921,36,27648,1296,186624,214272
train,922,31,23808,961,138384,162192
train,923,12,9216,144,20736,29952
train,924,27,20736,729,104976,125712
train,925,16,12288,256,36864,49152
train,926,19,14592,361,51984,66576
train,927,27,20736,729,104976,125712
train,928,11,8448,121,17424,25872
train,929,35,26880,1225,176400,203280
train,930,10,7680,100,14400,22080
train,931,30,23040,900,129600,152640
train,932,12,9216,144,20736,29952
train,933,37,28416,1369,197136,225552
train,934,17,13056,289,41616,54672
train,935,33,25344,1089,156816,182160
train,936,17,13056,289,41616,54672
train,937,24,18432,576,82944,101376
train,938,24,18432,576,82944,101376
train,939,10,7680,100,14400,22080
train,940,28,21504,784,112896,134400
train,941,29,22272,841,121104,143376
train,942,7,5376,49,7056,12432
train,943,11,8448,121,17424,25872
train,944,21,16128,441,63504,79632
train,945,9,6912,81,11664,18576
train,946,21,16128,441,63504,79632
train,947,22,16896,484,69696,86592
train,948,28,21504,784,112896,134400
train,949,26,19968,676,97344,117312
train,950,23,17664,529,76176,93840
train,951,12,9216,144,20736,29952
train,952,26,19968,676,97344,117312
train,953,16,12288,256,36864,49152
train,954,18,13824,324,46656,60480
train,955,44,33792,1936,278784,312576
train,956,11,8448,121,17424,25872
train,957,8,6144,64,9216,15360
train,958,21,16128,441,63504,79632
train,959,27,20736,729,104976,125712
train,960,34,26112,1156,166464,192576
train,961,12,9216,144,20736,29952
train,962,34,26112,1156,166464,192576
train,963,12,9216,144,20736,29952
train,964,43,33024,1849,266256,299280
train,965,10,7680,100,14400,22080
train,966,26,19968,676,97344,117312
train,967,25,19200,625,90000,109200
train,968,34,26112,1156,166464,192576
train,969,11,8448,121,17424,25872
train,970,54,41472,2916,419904,461376
train,971,24,18432,576,82944,101376
train,972,49,37632,2401,345744,383376
train,973,34,26112,1156,166464,192576
train,974,31,23808,961,138384,162192
train,975,45,34560,2025,291600,326160
train,976,28,21504,784,112896,134400
train,977,16,12288,256,36864,49152
train,978,12,9216,144,20736,29952
train,979,33,25344,1089,156816,182160
train,980,21,16128,441,63504,79632
train,981,13,9984,169,24336,34320
train,982,35,26880,1225,176400,203280
train,983,5,3840,25,3600,7440
train,984,27,20736,729,104976,125712
train,985,33,25344,1089,156816,182160
train,986,40,30720,1600,230400,261120
train,987,44,33792,1936,278784,312576
train,988,29,22272,841,121104,143376
train,989,22,16896,484,69696,86592
train,990,23,17664,529,76176,93840
train,991,24,18432,576,82944,101376
train,992,47,36096,2209,318096,354192
train,993,6,4608,36,5184,9792
train,994,16,12288,256,36864,49152
train,995,38,29184,1444,207936,237120
train,996,17,13056,289,41616,54672
train,997,28,21504,784,112896,134400
train,998,36,27648,1296,186624,214272
train,999,38,29184,1444,207936,237120
train,1000,40,30720,1600,230400,261120
train,1001,19,14592,361,51984,66576
train,1002,19,14592,361,51984,66576
train,1003,41,31488,1681,242064,273552
train,1004,34,26112,1156,166464,192576
train,1005,17,13056,289,41616,54672
train,1006,36,27648,1296,186624,214272
train,1007,27,20736,729,104976,125712
train,1008,39,29952,1521,219024,248976
train,1009,36,27648,1296,186624,214272
train,1010,26,19968,676,97344,117312
train,1011,30,23040,900,129600,152640
train,1012,11,8448,121,17424,25872
train,1013,20,15360,400,57600,72960
train,1014,37,28416,1369,197136,225552
train,1015,18,13824,324,46656,60480
train,1016,37,28416,1369,197136,225552
train,1017,32,24576,1024,147456,172032
train,1018,41,31488,1681,242064,273552
train,1019,22,16896,484,69696,86592
train,1020,34,26112,1156,166464,192576
train,1021,14,10752,196,28224,38976
train,1022,11,8448,121,17424,25872
train,1023,22,16896,484,69696,86592
train,1024,18,13824,324,46656,60480
train,1025,27,20736,729,104976,125712
train,1026,33,25344,1089,156816,182160
train,1027,40,30720,1600,230400,261120
train,1028,9,6912,81,11664,18576
train,1029,28,21504,784,112896,134400
train,1030,15,11520,225,32400,43920
train,1031,29,22272,841,121104,143376
train,1032,31,23808,961,138384,162192
train,1033,26,19968,676,97344,117312
train,1034,12,9216,144,20736,29952
train,1035,38,29184,1444,207936,237120
train,1036,22,16896,484,69696,86592
train,1037,29,22272,841,121104,143376
train,1038,29,22272,841,121104,143376
train,1039,25,19200,625,90000,109200
train,1040,27,20736,729,104976,125712
train,1041,40,30720,1600,230400,261120
train,1042,30,23040,900,129600,152640
train,1043,25,19200,625,90000,109200
train,1044,20,15360,400,57600,72960
train,1045,15,11520,225,32400,43920
train,1046,25,19200,625,90000,109200
train,1047,19,14592,361,51984,66576
train,1048,13,9984,169,24336,34320
train,1049,25,19200,625,90000,109200
train,1050,41,31488,1681,242064,273552
train,1051,25,19200,625,90000,109200
train,1052,17,13056,289,41616,54672
train,1053,32,24576,1024,147456,172032
train,1054,20,15360,400,57600,72960
train,1055,21,16128,441,63504,79632
train,1056,22,16896,484,69696,86592
train,1057,20,15360,400,57600,72960
train,1058,16,12288,256,36864,49152
train,1059,10,7680,100,14400,22080
train,1060,27,20736,729,104976,125712
train,1061,18,13824,324,46656,60480
train,1062,30,23040,900,129600,152640
train,1063,25,19200,625,90000,109200
train,1064,41,31488,1681,242064,273552
train,1065,20,15360,400,57600,72960
train,1066,24,18432,576,82944,101376
train,1067,39,29952,1521,219024,248976
train,1068,22,16896,484,69696,86592
train,1069,31,23808,961,138384,162192
train,1070,4,3072,16,2304,5376
train,1071,25,19200,625,90000,109200
train,1072,24,18432,576,82944,101376
train,1073,35,26880,1225,176400,203280
train,1074,14,10752,196,28224,38976
train,1075,37,28416,1369,197136,225552
train,1076,35,26880,1225,176400,203280
train,1077,14,10752,196,28224,38976
train,1078,11,8448,121,17424,25872
train,1079,42,32256,1764,254016,286272
train,1080,16,12288,256,36864,49152
train,1081,21,16128,441,63504,79632
train,1082,12,9216,144,20736,29952
train,1083,9,6912,81,11664,18576
train,1084,20,15360,400,57600,72960
train,1085,31,23808,961,138384,162192
train,1086,18,13824,324,46656,60480
train,1087,22,16896,484,69696,86592
train,1088,13,9984,169,24336,34320
train,1089,28,21504,784,112896,134400
train,1090,33,25344,1089,156816,182160
train,1091,38,29184,1444,207936,237120
train,1092,32,24576,1024,147456,172032
train,1093,14,10752,196,28224,38976
train,1094,18,13824,324,46656,60480
train,1095,24,18432,576,82944,101376
train,1096,48,36864,2304,331776,368640
train,1097,33,25344,1089,156816,182160
train,1098,30,23040,900,129600,152640
train,1099,37,28416,1369,197136,225552
train,1100,24,18432,576,82944,101376
train,1101,27,20736,729,104976,125712
train,1102,34,26112,1156,166464,192576
train,1103,15,11520,225,32400,43920
train,1104,33,25344,1089,156816,182160
train,1105,30,23040,900,129600,152640
train,1106,20,15360,400,57600,72960
train,1107,6,4608,36,5184,9792
train,1108,22,16896,484,69696,86592
train,1109,12,9216,144,20736,29952
train,1110,13,9984,169,24336,34320
train,1111,43,33024,1849,266256,299280
train,1112,21,16128,441,63504,79632
train,1113,18,13824,324,46656,60480
train,1114,48,36864,2304,331776,368640
train,1115,44,33792,1936,278784,312576
train,1116,11,8448,121,17424,25872
train,1117,36,27648,1296,186624,214272
train,1118,56,43008,3136,451584,494592
train,1119,13,9984,169,24336,34320
train,1120,20,15360,400,57600,72960
train,1121,26,19968,676,97344,117312
train,1122,26,19968,676,97344,117312
train,1123,14,10752,196,28224,38976
train,1124,16,12288,256,36864,49152
train,1125,25,19200,625,90000,109200
train,1126,19,14592,361,51984,66576
train,1127,48,36864,2304,331776,368640
train,1128,33,25344,1089,156816,182160
train,1129,21,16128,441,63504,79632
train,1130,14,10752,196,28224,38976
train,1131,47,36096,2209,318096,354192
train,1132,13,9984,169,24336,34320
train,1133,41,31488,1681,242064,273552
train,1134,36,27648,1296,186624,214272
train,1135,28,21504,784,112896,134400
train,1136,36,27648,1296,186624,214272
train,1137,26,19968,676,97344,117312
train,1138,28,21504,784,112896,134400
train,1139,37,28416,1369,197136,225552
train,1140,17,13056,289,41616,54672
train,1141,9,6912,81,11664,18576
train,1142,15,11520,225,32400,43920
train,1143,8,6144,64,9216,15360
train,1144,10,7680,100,14400,22080
train,1145,20,15360,400,57600,72960
train,1146,43,33024,1849,266256,299280
train,1147,18,13824,324,46656,60480
train,1148,6,4608,36,5184,9792
train,1149,36,27648,1296,186624,214272
train,1150,8,6144,64,9216,15360
train,1151,19,14592,361,51984,66576
train,1152,12,9216,144,20736,29952
train,1153,22,16896,484,69696,86592
train,1154,22,16896,484,69696,86592
train,1155,22,16896,484,69696,86592
train,1156,49,37632,2401,345744,383376
train,1157,12,9216,144,20736,29952
train,1158,39,29952,1521,219024,248976
train,1159,23,17664,529,76176,93840
train,1160,15,11520,225,32400,43920
train,1161,28,21504,784,112896,134400
train,1162,42,32256,1764,254016,286272
train,1163,26,19968,676,97344,117312
train,1164,18,13824,324,46656,60480
train,1165,25,19200,625,90000,109200
train,1166,20,15360,400,57600,72960
train,1167,29,22272,841,121104,143376
train,1168,12,9216,144,20736,29952
train,1169,32,24576,1024,147456,172032
train,1170,40,30720,1600,230400,261120
train,1171,19,14592,361,51984,66576
train,1172,38,29184,1444,207936,237120
train,1173,20,15360,400,57600,72960
train,1174,16,12288,256,36864,49152
train,1175,12,9216,144,20736,29952
train,1176,24,18432,576,82944,101376
train,1177,12,9216,144,20736,29952
train,1178,19,14592,361,51984,66576
train,1179,11,8448,121,17424,25872
train,1180,32,24576,1024,147456,172032
train,1181,11,8448,121,17424,25872
train,1182,9,6912,81,11664,18576
train,1183,16,12288,256,36864,49152
train,1184,29,22272,841,121104,143376
train,1185,15,11520,225,32400,43920
train,1186,16,12288,256,36864,49152
train,1187,23,17664,529,76176,93840
train,1188,30,23040,900,129600,152640
train,1189,39,29952,1521,219024,248976
train,1190,23,17664,529,76176,93840
train,1191,24,18432,576,82944,101376
train,1192,45,34560,2025,291600,326160
train,1193,21,16128,441,63504,79632
train,1194,20,15360,400,57600,72960
train,1195,15,11520,225,32400,43920
train,1196,31,23808,961,138384,162192
train,1197,19,14592,361,51984,66576
train,1198,8,6144,64,9216,15360
train,1199,33,25344,1089,156816,182160
train,1200,41,31488,1681,242064,273552
train,1201,15,11520,225,32400,43920
train,1202,9,6912,81,11664,18576
train,1203,34,26112,1156,166464,192576
train,1204,40,30720,1600,230400,261120
train,1205,30,23040,900,129600,152640
train,1206,24,18432,576,82944,101376
train,1207,15,11520,225,32400,43920
train,1208,17,13056,289,41616,54672
train,1209,17,13056,289,41616,54672
train,1210,40,30720,1600,230400,261120
train,1211,29,22272,841,121104,143376
train,1212,13,9984,169,24336,34320
train,1213,36,27648,1296,186624,214272
train,1214,12,9216,144,20736,29952
train,1215,33,25344,1089,156816,182160
train,1216,13,9984,169,24336,34320
train,1217,9,6912,81,11664,18576
train,1218,17,13056,289,41616,54672
train,1219,25,19200,625,90000,109200
train,1220,19,14592,361,51984,66576
train,1221,34,26112,1156,166464,192576
train,1222,13,9984,169,24336,34320
train,1223,13,9984,169,24336,34320
train,1224,23,17664,529,76176,93840
train,1225,22,16896,484,69696,86592
train,1226,16,12288,256,36864,49152
train,1227,24,18432,576,82944,101376
train,1228,48,36864,2304,331776,368640
train,1229,44,33792,1936,278784,312576
train,1230,11,8448,121,17424,25872
train,1231,8,6144,64,9216,15360
train,1232,14,10752,196,28224,38976
train,1233,16,12288,256,36864,49152
train,1234,37,28416,1369,197136,225552
train,1235,37,28416,1369,197136,225552
train,1236,28,21504,784,112896,134400
train,1237,29,22272,841,121104,143376
train,1238,18,13824,324,46656,60480
train,1239,63,48384,3969,571536,619920
train,1240,16,12288,256,36864,49152
train,1241,8,6144,64,9216,15360
train,1242,25,19200,625,90000,109200
train,1243,26,19968,676,97344,117312
train,1244,40,30720,1600,230400,261120
train,1245,18,13824,324,46656,60480
train,1246,18,13824,324,46656,60480
train,1247,36,27648,1296,186624,214272
train,1248,26,19968,676,97344,117312
train,1249,7,5376,49,7056,12432
train,1250,6,4608,36,5184,9792
train,1251,10,7680,100,14400,22080
train,1252,17,13056,289,41616,54672
train,1253,17,13056,289,41616,54672
train,1254,28,21504,784,112896,134400
train,1255,13,9984,169,24336,34320
train,1256,20,15360,400,57600,72960
train,1257,27,20736,729,104976,125712
train,1258,32,24576,1024,147456,172032
train,1259,8,6144,64,9216,15360
train,1260,15,11520,225,32400,43920
train,1261,23,17664,529,76176,93840
train,1262,9,6912,81,11664,18576
train,1263,43,33024,1849,266256,299280
train,1264,30,23040,900,129600,152640
train,1265,34,26112,1156,166464,192576
train,1266,14,10752,196,28224,38976
train,1267,33,25344,1089,156816,182160
train,1268,29,22272,841,121104,143376
train,1269,14,10752,196,28224,38976
train,1270,28,21504,784,112896,134400
train,1271,37,28416,1369,197136,225552
train,1272,32,24576,1024,147456,172032
train,1273,28,21504,784,112896,134400
train,1274,33,25344,1089,156816,182160
train,1275,34,26112,1156,166464,192576
train,1276,29,22272,841,121104,143376
train,1277,23,17664,529,76176,93840
train,1278,22,16896,484,69696,86592
train,1279,31,23808,961,138384,162192
train,1280,33,25344,1089,156816,182160
train,1281,19,14592,361,51984,66576
train,1282,46,35328,2116,304704,340032
train,1283,27,20736,729,104976,125712
train,1284,28,21504,784,112896,134400
train,1285,12,9216,144,20736,29952
train,1286,37,28416,1369,197136,225552
train,1287,25,19200,625,90000,109200
train,1288,33,25344,1089,156816,182160
train,1289,47,36096,2209,318096,354192
train,1290,35,26880,1225,176400,203280
train,1291,13,9984,169,24336,34320
train,1292,32,24576,1024,147456,172032
train,1293,60,46080,3600,518400,564480
train,1294,24,18432,576,82944,101376
train,1295,31,23808,961,138384,162192
train,1296,25,19200,625,90000,109200
train,1297,12,9216,144,20736,29952
train,1298,26,19968,676,97344,117312
train,1299,12,9216,144,20736,29952
train,1300,39,29952,1521,219024,248976
train,1301,30,23040,900,129600,152640
train,1302,19,14592,361,51984,66576
train,1303,32,24576,1024,147456,172032
train,1304,31,23808,961,138384,162192
train,1305,17,13056,289,41616,54672
train,1306,23,17664,529,76176,93840
train,1307,28,21504,784,112896,134400
train,1308,52,39936,2704,389376,429312
train,1309,10,7680,100,14400,22080
train,1310,18,13824,324,46656,60480
train,1311,9,6912,81,11664,18576
train,1312,33,25344,1089,156816,182160
train,1313,7,5376,49,7056,12432
train,1314,25,19200,625,90000,109200
train,1315,14,10752,196,28224,38976
train,1316,13,9984,169,24336,34320
train,1317,13,9984,169,24336,34320
train,1318,18,13824,324,46656,60480
train,1319,17,13056,289,41616,54672
train,1320,5,3840,25,3600,7440
train,1321,7,5376,49,7056,12432
train,1322,19,14592,361,51984,66576
train,1323,25,19200,625,90000,109200
train,1324,20,15360,400,57600,72960
train,1325,24,18432,576,82944,101376
train,1326,26,19968,676,97344,117312
train,1327,6,4608,36,5184,9792
train,1328,27,20736,729,104976,125712
train,1329,20,15360,400,57600,72960
train,1330,16,12288,256,36864,49152
train,1331,33,25344,1089,156816,182160
train,1332,27,20736,729,104976,125712
train,1333,26,19968,676,97344,117312
train,1334,36,27648,1296,186624,214272
train,1335,17,13056,289,41616,54672
train,1336,30,23040,900,129600,152640
train,1337,18,13824,324,46656,60480
train,1338,23,17664,529,76176,93840
train,1339,37,28416,1369,197136,225552
train,1340,30,23040,900,129600,152640
train,1341,47,36096,2209,318096,354192
train,1342,19,14592,361,51984,66576
train,1343,26,19968,676,97344,117312
train,1344,11,8448,121,17424,25872
train,1345,40,30720,1600,230400,261120
train,1346,25,19200,625,90000,109200
train,1347,14,10752,196,28224,38976
train,1348,12,9216,144,20736,29952
train,1349,7,5376,49,7056,12432
train,1350,17,13056,289,41616,54672
train,1351,19,14592,361,51984,66576
train,1352,25,19200,625,90000,109200
train,1353,18,13824,324,46656,60480
train,1354,11,8448,121,17424,25872
train,1355,6,4608,36,5184,9792
train,1356,27,20736,729,104976,125712
train,1357,44,33792,1936,278784,312576
train,1358,29,22272,841,121104,143376
train,1359,24,18432,576,82944,101376
train,1360,13,9984,169,24336,34320
train,1361,29,22272,841,121104,143376
train,1362,27,20736,729,104976,125712
train,1363,6,4608,36,5184,9792
train,1364,23,17664,529,76176,93840
train,1365,36,27648,1296,186624,214272
train,1366,38,29184,1444,207936,237120
train,1367,16,12288,256,36864,49152
train,1368,53,40704,2809,404496,445200
train,1369,24,18432,576,82944,101376
train,1370,23,17664,529,76176,93840
train,1371,59,45312,3481,501264,546576
train,1372,28,21504,784,112896,134400
train,1373,13,9984,169,24336,34320
train,1374,15,11520,225,32400,43920
train,1375,21,16128,441,63504,79632
train,1376,38,29184,1444,207936,237120
train,1377,43,33024,1849,266256,299280
train,1378,15,11520,225,32400,43920
train,1379,26,19968,676,97344,117312
train,1380,29,22272,841,121104,143376
train,1381,39,29952,1521,219024,248976
train,1382,22,16896,484,69696,86592
train,1383,16,12288,256,36864,49152
train,1384,27,20736,729,104976,125712
train,1385,14,10752,196,28224,38976
train,1386,18,13824,324,46656,60480
train,1387,18,13824,324,46656,60480
train,1388,24,18432,576,82944,101376
train,1389,33,25344,1089,156816,182160
train,1390,7,5376,49,7056,12432
train,1391,16,12288,256,36864,49152
train,1392,18,13824,324,46656,60480
train,1393,39,29952,1521,219024,248976
train,1394,16,12288,256,36864,49152
train,1395,33,25344,1089,156816,182160
train,1396,35,26880,1225,176400,203280
train,1397,22,16896,484,69696,86592
train,1398,22,16896,484,69696,86592
train,1399,30,23040,900,129600,152640
train,1400,31,23808,961,138384,162192
train,1401,11,8448,121,17424,25872
train,1402,17,13056,289,41616,54672
train,1403,19,14592,361,51984,66576
train,1404,8,6144,64,9216,15360
train,1405,19,14592,361,51984,66576
train,1406,22,16896,484,69696,86592
train,1407,14,10752,196,28224,38976
train,1408,20,15360,400,57600,72960
train,1409,15,11520,225,32400,43920
train,1410,23,17664,529,76176,93840
train,1411,49,37632,2401,345744,383376
train,1412,39,29952,1521,219024,248976
train,1413,28,21504,784,112896,134400
train,1414,28,21504,784,112896,134400
train,1415,30,23040,900,129600,152640
train,1416,18,13824,324,46656,60480
train,1417,18,13824,324,46656,60480
train,1418,40,30720,1600,230400,261120
train,1419,30,23040,900,129600,152640
train,1420,22,16896,484,69696,86592
train,1421,26,19968,676,97344,117312
train,1422,19,14592,361,51984,66576
train,1423,27,20736,729,104976,125712
train,1424,29,22272,841,121104,143376
train,1425,54,41472,2916,419904,461376
train,1426,8,6144,64,9216,15360
train,1427,12,9216,144,20736,29952
train,1428,25,19200,625,90000,109200
train,1429,40,30720,1600,230400,261120
train,1430,33,25344,1089,156816,182160
train,1431,29,22272,841,121104,143376
train,1432,13,9984,169,24336,34320
train,1433,9,6912,81,11664,18576
train,1434,28,21504,784,112896,134400
train,1435,32,24576,1024,147456,172032
train,1436,20,15360,400,57600,72960
train,1437,23,17664,529,76176,93840
train,1438,27,20736,729,104976,125712
train,1439,29,22272,841,121104,143376
train,1440,18,13824,324,46656,60480
train,1441,16,12288,256,36864,49152
train,1442,26,19968,676,97344,117312
train,1443,31,23808,961,138384,162192
train,1444,22,16896,484,69696,86592
train,1445,39,29952,1521,219024,248976
train,1446,17,13056,289,41616,54672
train,1447,35,26880,1225,176400,203280
train,1448,42,32256,1764,254016,286272
train,1449,13,9984,169,24336,34320
train,1450,10,7680,100,14400,22080
train,1451,13,9984,169,24336,34320
train,1452,38,29184,1444,207936,237120
train,1453,14,10752,196,28224,38976
train,1454,33,25344,1089,156816,182160
train,1455,33,25344,1089,156816,182160
train,1456,16,12288,256,36864,49152
train,1457,41,31488,1681,242064,273552
train,1458,16,12288,256,36864,49152
train,1459,20,15360,400,57600,72960
train,1460,36,27648,1296,186624,214272
train,1461,24,18432,576,82944,101376
train,1462,20,15360,400,57600,72960
train,1463,12,9216,144,20736,29952
train,1464,23,17664,529,76176,93840
train,1465,17,13056,289,41616,54672
train,1466,39,29952,1521,219024,248976
train,1467,30,23040,900,129600,152640
train,1468,18,13824,324,46656,60480
train,1469,19,14592,361,51984,66576
train,1470,14,10752,196,28224,38976
train,1471,40,30720,1600,230400,261120
train,1472,42,32256,1764,254016,286272
train,1473,32,24576,1024,147456,172032
train,1474,30,23040,900,129600,152640
train,1475,24,18432,576,82944,101376
train,1476,20,15360,400,57600,72960
train,1477,16,12288,256,36864,49152
train,1478,38,29184,1444,207936,237120
train,1479,30,23040,900,129600,152640
train,1480,17,13056,289,41616,54672
train,1481,49,37632,2401,345744,383376
train,1482,38,29184,1444,207936,237120
train,1483,7,5376,49,7056,12432
train,1484,28,21504,784,112896,134400
train,1485,38,29184,1444,207936,237120
train,1486,37,28416,1369,197136,225552
train,1487,13,9984,169,24336,34320
train,1488,18,13824,324,46656,60480
train,1489,8,6144,64,9216,15360
train,1490,15,11520,225,32400,43920
train,1491,15,11520,225,32400,43920
train,1492,17,13056,289,41616,54672
train,1493,37,28416,1369,197136,225552
train,1494,24,18432,576,82944,101376
train,1495,10,7680,100,14400,22080
train,1496,35,26880,1225,176400,203280
train,1497,27,20736,729,104976,125712
train,1498,39,29952,1521,219024,248976
train,1499,44,33792,1936,278784,312576
train,1500,29,22272,841,121104,143376
train,1501,20,15360,400,57600,72960
train,1502,20,15360,400,57600,72960
train,1503,24,18432,576,82944,101376
train,1504,16,12288,256,36864,49152
train,1505,11,8448,121,17424,25872
train,1506,43,33024,1849,266256,299280
train,1507,8,6144,64,9216,15360
train,1508,47,36096,2209,318096,354192
train,1509,34,26112,1156,166464,192576
train,1510,19,14592,361,51984,66576
train,1511,15,11520,225,32400,43920
train,1512,17,13056,289,41616,54672
train,1513,11,8448,121,17424,25872
train,1514,33,25344,1089,156816,182160
train,1515,42,32256,1764,254016,286272
train,1516,15,11520,225,32400,43920
train,1517,24,18432,576,82944,101376
train,1518,13,9984,169,24336,34320
train,1519,14,10752,196,28224,38976
train,1520,20,15360,400,57600,72960
train,1521,15,11520,225,32400,43920
train,1522,14,10752,196,28224,38976
train,1523,17,13056,289,41616,54672
train,1524,43,33024,1849,266256,299280
train,1525,20,15360,400,57600,72960
train,1526,27,20736,729,104976,125712
train,1527,34,26112,1156,166464,192576
train,1528,41,31488,1681,242064,273552
train,1529,8,6144,64,9216,15360
train,1530,38,29184,1444,207936,237120
train,1531,27,20736,729,104976,125712
train,1532,25,19200,625,90000,109200
train,1533,39,29952,1521,219024,248976
train,1534,19,14592,361,51984,66576
train,1535,21,16128,441,63504,79632
train,1536,13,9984,169,24336,34320
train,1537,18,13824,324,46656,60480
train,1538,18,13824,324,46656,60480
train,1539,32,24576,1024,147456,172032
train,1540,13,9984,169,24336,34320
train,1541,34,26112,1156,166464,192576
train,1542,28,21504,784,112896,134400
train,1543,23,17664,529,76176,93840
train,1544,32,24576,1024,147456,172032
train,1545,31,23808,961,138384,162192
train,1546,25,19200,625,90000,109200
train,1547,43,33024,1849,266256,299280
train,1548,25,19200,625,90000,109200
train,1549,16,12288,256,36864,49152
train,1550,13,9984,169,24336,34320
train,1551,18,13824,324,46656,60480
train,1552,24,18432,576,82944,101376
train,1553,52,39936,2704,389376,429312
train,1554,10,7680,100,14400,22080
train,1555,28,21504,784,112896,134400
train,1556,12,9216,144,20736,29952
train,1557,37,28416,1369,197136,225552
train,1558,19,14592,361,51984,66576
train,1559,36,27648,1296,186624,214272
train,1560,21,16128,441,63504,79632
train,1561,8,6144,64,9216,15360
train,1562,15,11520,225,32400,43920
train,1563,11,8448,121,17424,25872
train,1564,10,7680,100,14400,22080
train,1565,43,33024,1849,266256,299280
train,1566,28,21504,784,112896,134400
train,1567,17,13056,289,41616,54672
train,1568,38,29184,1444,207936,237120
train,1569,19,14592,361,51984,66576
train,1570,38,29184,1444,207936,237120
train,1571,32,24576,1024,147456,172032
train,1572,32,24576,1024,147456,172032
train,1573,29,22272,841,121104,143376
train,1574,24,18432,576,82944,101376
train,1575,15,11520,225,32400,43920
train,1576,9,6912,81,11664,18576
train,1577,24,18432,576,82944,101376
train,1578,12,9216,144,20736,29952
train,1579,47,36096,2209,318096,354192
train,1580,48,36864,2304,331776,368640
train,1581,31,23808,961,138384,162192
train,1582,57,43776,3249,467856,511632
train,1583,7,5376,49,7056,12432
train,1584,8,6144,64,9216,15360
train,1585,16,12288,256,36864,49152
train,1586,19,14592,361,51984,66576
train,1587,45,34560,2025,291600,326160
train,1588,13,9984,169,24336,34320
train,1589,33,25344,1089,156816,182160
train,1590,16,12288,256,36864,49152
train,1591,31,23808,961,138384,162192
train,1592,29,22272,841,121104,143376
train,1593,38,29184,1444,207936,237120
train,1594,34,26112,1156,166464,192576
train,1595,12,9216,144,20736,29952
train,1596,15,11520,225,32400,43920
train,1597,13,9984,169,24336,34320
train,1598,17,13056,289,41616,54672
train,1599,37,28416,1369,197136,225552
train,1600,34,26112,1156,166464,192576
train,1601,36,27648,1296,186624,214272
train,1602,10,7680,100,14400,22080
train,1603,17,13056,289,41616,54672
train,1604,40,30720,1600,230400,261120
train,1605,17,13056,289,41616,54672
train,1606,27,20736,729,104976,125712
train,1607,24,18432,576,82944,101376
train,1608,13,9984,169,24336,34320
train,1609,23,17664,529,76176,93840
train,1610,48,36864,2304,331776,368640
train,1611,14,10752,196,28224,38976
train,1612,26,19968,676,97344,117312
train,1613,21,16128,441,63504,79632
train,1614,26,19968,676,97344,117312
train,1615,19,14592,361,51984,66576
train,1616,35,26880,1225,176400,203280
train,1617,23,17664,529,76176,93840
train,1618,19,14592,361,51984,66576
train,1619,12,9216,144,20736,29952
train,1620,41,31488,1681,242064,273552
train,1621,19,14592,361,51984,66576
train,1622,10,7680,100,14400,22080
train,1623,11,8448,121,17424,25872
train,1624,32,24576,1024,147456,172032
train,1625,44,33792,1936,278784,312576
train,1626,15,11520,225,32400,43920
train,1627,22,16896,484,69696,86592
train,1628,30,23040,900,129600,152640
train,1629,14,10752,196,28224,38976
train,1630,18,13824,324,46656,60480
train,1631,36,27648,1296,186624,214272
train,1632,24,18432,576,82944,101376
train,1633,21,16128,441,63504,79632
train,1634,5,3840,25,3600,7440
train,1635,32,24576,1024,147456,172032
train,1636,38,29184,1444,207936,237120
train,1637,12,9216,144,20736,29952
train,1638,11,8448,121,17424,25872
train,1639,14,10752,196,28224,38976
train,1640,56,43008,3136,451584,494592
train,1641,21,16128,441,63504,79632
train,1642,26,19968,676,97344,117312
train,1643,21,16128,441,63504,79632
train,1644,34,26112,1156,166464,192576
train,1645,14,10752,196,28224,38976
train,1646,41,31488,1681,242064,273552
train,1647,17,13056,289,41616,54672
train,1648,6,4608,36,5184,9792
train,1649,20,15360,400,57600,72960
train,1650,10,7680,100,14400,22080
train,1651,27,20736,729,104976,125712
train,1652,35,26880,1225,176400,203280
train,1653,56,43008,3136,451584,494592
train,1654,37,28416,1369,197136,225552
train,1655,22,16896,484,69696,86592
train,1656,15,11520,225,32400,43920
train,1657,20,15360,400,57600,72960
train,1658,23,17664,529,76176,93840
train,1659,25,19200,625,90000,109200
train,1660,12,9216,144,20736,29952
train,1661,25,19200,625,90000,109200
train,1662,13,9984,169,24336,34320
train,1663,17,13056,289,41616,54672
train,1664,20,15360,400,57600,72960
train,1665,15,11520,225,32400,43920
train,1666,14,10752,196,28224,38976
train,1667,12,9216,144,20736,29952
train,1668,20,15360,400,57600,72960
train,1669,11,8448,121,17424,25872
train,1670,19,14592,361,51984,66576
train,1671,11,8448,121,17424,25872
train,1672,17,13056,289,41616,54672
train,1673,18,13824,324,46656,60480
train,1674,26,19968,676,97344,117312
train,1675,42,32256,1764,254016,286272
train,1676,50,38400,2500,360000,398400
train,1677,36,27648,1296,186624,214272
train,1678,20,15360,400,57600,72960
train,1679,24,18432,576,82944,101376
train,1680,25,19200,625,90000,109200
train,1681,36,27648,1296,186624,214272
train,1682,17,13056,289,41616,54672
train,1683,36,27648,1296,186624,214272
train,1684,21,16128,441,63504,79632
train,1685,44,33792,1936,278784,312576
train,1686,5,3840,25,3600,7440
train,1687,12,9216,144,20736,29952
train,1688,22,16896,484,69696,86592
train,1689,32,24576,1024,147456,172032
train,1690,41,31488,1681,242064,273552
train,1691,47,36096,2209,318096,354192
train,1692,18,13824,324,46656,60480
train,1693,23,17664,529,76176,93840
train,1694,32,24576,1024,147456,172032
train,1695,33,25344,1089,156816,182160
train,1696,16,12288,256,36864,49152
train,1697,19,14592,361,51984,66576
train,1698,11,8448,121,17424,25872
train,1699,34,26112,1156,166464,192576
train,1700,7,5376,49,7056,12432
train,1701,25,19200,625,90000,109200
train,1702,28,21504,784,112896,134400
train,1703,27,20736,729,104976,125712
train,1704,43,33024,1849,266256,299280
train,1705,49,37632,2401,345744,383376
train,1706,35,26880,1225,176400,203280
train,1707,25,19200,625,90000,109200
train,1708,12,9216,144,20736,29952
train,1709,27,20736,729,104976,125712
train,1710,7,5376,49,7056,12432
train,1711,9,6912,81,11664,18576
train,1712,14,10752,196,28224,38976
train,1713,24,18432,576,82944,101376
train,1714,16,12288,256,36864,49152
train,1715,8,6144,64,9216,15360
train,1716,20,15360,400,57600,72960
train,1717,47,36096,2209,318096,354192
train,1718,6,4608,36,5184,9792
train,1719,46,35328,2116,304704,340032
train,1720,27,20736,729,104976,125712
train,1721,13,9984,169,24336,34320
train,1722,46,35328,2116,304704,340032
train,1723,26,19968,676,97344,117312
train,1724,19,14592,361,51984,66576
train,1725,11,8448,121,17424,25872
train,1726,15,11520,225,32400,43920
train,1727,46,35328,2116,304704,340032
train,1728,18,13824,324,46656,60480
train,1729,23,17664,529,76176,93840
train,1730,10,7680,100,14400,22080
train,1731,21,16128,441,63504,79632
train,1732,26,19968,676,97344,117312
train,1733,16,12288,256,36864,49152
train,1734,18,13824,324,46656,60480
train,1735,31,23808,961,138384,162192
train,1736,7,5376,49,7056,12432
train,1737,31,23808,961,138384,162192
train,1738,34,26112,1156,166464,192576
train,1739,40,30720,1600,230400,261120
train,1740,36,27648,1296,186624,214272
train,1741,42,32256,1764,254016,286272
train,1742,6,4608,36,5184,9792
train,1743,36,27648,1296,186624,214272
train,1744,14,10752,196,28224,38976
train,1745,35,26880,1225,176400,203280
train,1746,17,13056,289,41616,54672
train,1747,8,6144,64,9216,15360
train,1748,15,11520,225,32400,43920
train,1749,41,31488,1681,242064,273552
train,1750,33,25344,1089,156816,182160
train,1751,30,23040,900,129600,152640
train,1752,27,20736,729,104976,125712
train,1753,52,39936,2704,389376,429312
train,1754,27,20736,729,104976,125712
train,1755,24,18432,576,82944,101376
train,1756,41,31488,1681,242064,273552
train,1757,19,14592,361,51984,66576
train,1758,18,13824,324,46656,60480
train,1759,14,10752,196,28224,38976
train,1760,34,26112,1156,166464,192576
train,1761,23,17664,529,76176,93840
train,1762,17,13056,289,41616,54672
train,1763,36,27648,1296,186624,214272
train,1764,41,31488,1681,242064,273552
train,1765,19,14592,361,51984,66576
train,1766,47,36096,2209,318096,354192
train,1767,13,9984,169,24336,34320
train,1768,14,10752,196,28224,38976
train,1769,26,19968,676,97344,117312
train,1770,15,11520,225,32400,43920
train,1771,31,23808,961,138384,162192
train,1772,35,26880,1225,176400,203280
train,1773,19,14592,361,51984,66576
train,1774,17,13056,289,41616,54672
train,1775,20,15360,400,57600,72960
train,1776,22,16896,484,69696,86592
train,1777,5,3840,25,3600,7440
train,1778,24,18432,576,82944,101376
train,1779,28,21504,784,112896,134400
train,1780,24,18432,576,82944,101376
train,1781,37,28416,1369,197136,225552
train,1782,21,16128,441,63504,79632
train,1783,25,19200,625,90000,109200
train,1784,5,3840,25,3600,7440
train,1785,22,16896,484,69696,86592
train,1786,29,22272,841,121104,143376
train,1787,15,11520,225,32400,43920
train,1788,41,31488,1681,242064,273552
train,1789,22,16896,484,69696,86592
train,1790,22,16896,484,69696,86592
train,1791,6,4608,36,5184,9792
train,1792,18,13824,324,46656,60480
train,1793,19,14592,361,51984,66576
train,1794,25,19200,625,90000,109200
train,1795,25,19200,625,90000,109200
train,1796,12,9216,144,20736,29952
train,1797,28,21504,784,112896,134400
train,1798,20,15360,400,57600,72960
train,1799,36,27648,1296,186624,214272
train,1800,35,26880,1225,176400,203280
train,1801,48,36864,2304,331776,368640
train,1802,17,13056,289,41616,54672
train,1803,14,10752,196,28224,38976
train,1804,15,11520,225,32400,43920
train,1805,33,25344,1089,156816,182160
train,1806,10,7680,100,14400,22080
train,1807,33,25344,1089,156816,182160
train,1808,13,9984,169,24336,34320
train,1809,13,9984,169,24336,34320
train,1810,19,14592,361,51984,66576
train,1811,20,15360,400,57600,72960
train,1812,24,18432,576,82944,101376
train,1813,11,8448,121,17424,25872
train,1814,37,28416,1369,197136,225552
train,1815,27,20736,729,104976,125712
train,1816,16,12288,256,36864,49152
train,1817,23,17664,529,76176,93840
train,1818,32,24576,1024,147456,172032
train,1819,12,9216,144,20736,29952
train,1820,19,14592,361,51984,66576
train,1821,10,7680,100,14400,22080
train,1822,23,17664,529,76176,93840
train,1823,49,37632,2401,345744,383376
train,1824,21,16128,441,63504,79632
train,1825,40,30720,1600,230400,261120
train,1826,13,9984,169,24336,34320
train,1827,29,22272,841,121104,143376
train,1828,18,13824,324,46656,60480
train,1829,22,16896,484,69696,86592
train,1830,12,9216,144,20736,29952
train,1831,24,18432,576,82944,101376
train,1832,35,26880,1225,176400,203280
train,1833,16,12288,256,36864,49152
train,1834,15,11520,225,32400,43920
train,1835,9,6912,81,11664,18576
train,1836,23,17664,529,76176,93840
train,1837,23,17664,529,76176,93840
train,1838,28,21504,784,112896,134400
train,1839,22,16896,484,69696,86592
train,1840,17,13056,289,41616,54672
train,1841,16,12288,256,36864,49152
train,1842,41,31488,1681,242064,273552
train,1843,23,17664,529,76176,93840
train,1844,40,30720,1600,230400,261120
train,1845,20,15360,400,57600,72960
train,1846,11,8448,121,17424,25872
train,1847,51,39168,2601,374544,413712
train,1848,31,23808,961,138384,162192
train,1849,37,28416,1369,197136,225552
train,1850,23,17664,529,76176,93840
train,1851,24,18432,576,82944,101376
train,1852,56,43008,3136,451584,494592
train,1853,44,33792,1936,278784,312576
train,1854,28,21504,784,112896,134400
train,1855,8,6144,64,9216,15360
train,1856,28,21504,784,112896,134400
train,1857,21,16128,441,63504,79632
train,1858,35,26880,1225,176400,203280
train,1859,20,15360,400,57600,72960
train,1860,23,17664,529,76176,93840
train,1861,12,9216,144,20736,29952
train,1862,63,48384,3969,571536,619920
train,1863,12,9216,144,20736,29952
train,1864,17,13056,289,41616,54672
train,1865,22,16896,484,69696,86592
train,1866,23,17664,529,76176,93840
train,1867,28,21504,784,112896,134400
train,1868,25,19200,625,90000,109200
train,1869,49,37632,2401,345744,383376
train,1870,38,29184,1444,207936,237120
train,1871,22,16896,484,69696,86592
train,1872,6,4608,36,5184,9792
train,1873,22,16896,484,69696,86592
train,1874,33,25344,1089,156816,182160
train,1875,28,21504,784,112896,134400
train,1876,12,9216,144,20736,29952
train,1877,20,15360,400,57600,72960
train,1878,7,5376,49,7056,12432
train,1879,17,13056,289,41616,54672
train,1880,18,13824,324,46656,60480
train,1881,18,13824,324,46656,60480
train,1882,8,6144,64,9216,15360
train,1883,44,33792,1936,278784,312576
train,1884,36,27648,1296,186624,214272
train,1885,35,26880,1225,176400,203280
train,1886,35,26880,1225,176400,203280
train,1887,12,9216,144,20736,29952
train,1888,8,6144,64,9216,15360
train,1889,15,11520,225,32400,43920
train,1890,27,20736,729,104976,125712
train,1891,14,10752,196,28224,38976
train,1892,11,8448,121,17424,25872
train,1893,15,11520,225,32400,43920
train,1894,11,8448,121,17424,25872
train,1895,28,21504,784,112896,134400
train,1896,14,10752,196,28224,38976
train,1897,18,13824,324,46656,60480
train,1898,31,23808,961,138384,162192
train,1899,53,40704,2809,404496,445200
train,1900,11,8448,121,17424,25872
train,1901,30,23040,900,129600,152640
train,1902,36,27648,1296,186624,214272
train,1903,21,16128,441,63504,79632
train,1904,9,6912,81,11664,18576
train,1905,20,15360,400,57600,72960
train,1906,26,19968,676,97344,117312
train,1907,26,19968,676,97344,117312
train,1908,13,9984,169,24336,34320
train,1909,16,12288,256,36864,49152
train,1910,14,10752,196,28224,38976
train,1911,32,24576,1024,147456,172032
train,1912,6,4608,36,5184,9792
train,1913,27,20736,729,104976,125712
train,1914,26,19968,676,97344,117312
train,1915,11,8448,121,17424,25872
train,1916,15,11520,225,32400,43920
train,1917,29,22272,841,121104,143376
train,1918,7,5376,49,7056,12432
train,1919,17,13056,289,41616,54672
train,1920,12,9216,144,20736,29952
train,1921,37,28416,1369,197136,225552
train,1922,24,18432,576,82944,101376
train,1923,13,9984,169,24336,34320
train,1924,7,5376,49,7056,12432
train,1925,20,15360,400,57600,72960
train,1926,19,14592,361,51984,66576
train,1927,21,16128,441,63504,79632
train,1928,43,33024,1849,266256,299280
train,1929,34,26112,1156,166464,192576
train,1930,15,11520,225,32400,43920
train,1931,32,24576,1024,147456,172032
train,1932,43,33024,1849,266256,299280
train,1933,8,6144,64,9216,15360
train,1934,8,6144,64,9216,15360
train,1935,15,11520,225,32400,43920
train,1936,23,17664,529,76176,93840
train,1937,38,29184,1444,207936,237120
train,1938,7,5376,49,7056,12432
train,1939,39,29952,1521,219024,248976
train,1940,23,17664,529,76176,93840
train,1941,6,4608,36,5184,9792
train,1942,14,10752,196,28224,38976
train,1943,26,19968,676,97344,117312
train,1944,22,16896,484,69696,86592
train,1945,40,30720,1600,230400,261120
train,1946,16,12288,256,36864,49152
train,1947,6,4608,36,5184,9792
train,1948,27,20736,729,104976,125712
train,1949,28,21504,784,112896,134400
train,1950,14,10752,196,28224,38976
train,1951,7,5376,49,7056,12432
train,1952,45,34560,2025,291600,326160
train,1953,43,33024,1849,266256,299280
train,1954,20,15360,400,57600,72960
train,1955,29,22272,841,121104,143376
train,1956,18,13824,324,46656,60480
train,1957,18,13824,324,46656,60480
train,1958,26,19968,676,97344,117312
train,1959,24,18432,576,82944,101376
train,1960,35,26880,1225,176400,203280
train,1961,6,4608,36,5184,9792
train,1962,17,13056,289,41616,54672
train,1963,52,39936,2704,389376,429312
train,1964,32,24576,1024,147456,172032
train,1965,30,23040,900,129600,152640
train,1966,32,24576,1024,147456,172032
train,1967,19,14592,361,51984,66576
train,1968,16,12288,256,36864,49152
train,1969,36,27648,1296,186624,214272
train,1970,21,16128,441,63504,79632
train,1971,9,6912,81,11664,18576
train,1972,21,16128,441,63504,79632
train,1973,14,10752,196,28224,38976
train,1974,39,29952,1521,219024,248976
train,1975,25,19200,625,90000,109200
train,1976,47,36096,2209,318096,354192
train,1977,12,9216,144,20736,29952
train,1978,9,6912,81,11664,18576
train,1979,13,9984,169,24336,34320
train,1980,34,26112,1156,166464,192576
train,1981,45,34560,2025,291600,326160
train,1982,11,8448,121,17424,25872
train,1983,45,34560,2025,291600,326160
train,1984,28,21504,784,112896,134400
train,1985,27,20736,729,104976,125712
train,1986,18,13824,324,46656,60480
train,1987,18,13824,324,46656,60480
train,1988,23,17664,529,76176,93840
train,1989,23,17664,529,76176,93840
train,1990,9,6912,81,11664,18576
train,1991,22,16896,484,69696,86592
train,1992,11,8448,121,17424,25872
train,1993,10,7680,100,14400,22080
train,1994,10,7680,100,14400,22080
train,1995,38,29184,1444,207936,237120
train,1996,11,8448,121,17424,25872
train,1997,21,16128,441,63504,79632
train,1998,36,27648,1296,186624,214272
train,1999,25,19200,625,90000,109200
train,2000,26,19968,676,97344,117312
train,2001,18,13824,324,46656,60480
train,2002,21,16128,441,63504,79632
train,2003,34,26112,1156,166464,192576
train,2004,49,37632,2401,345744,383376
train,2005,25,19200,625,90000,109200
train,2006,45,34560,2025,291600,326160
train,2007,37,28416,1369,197136,225552
train,2008,39,29952,1521,219024,248976
train,2009,23,17664,529,76176,93840
train,2010,27,20736,729,104976,125712
train,2011,27,20736,729,104976,125712
train,2012,28,21504,784,112896,134400
train,2013,36,27648,1296,186624,214272
train,2014,7,5376,49,7056,12432
train,2015,30,23040,900,129600,152640
train,2016,40,30720,1600,230400,261120
train,2017,22,16896,484,69696,86592
train,2018,32,24576,1024,147456,172032
train,2019,41,31488,1681,242064,273552
train,2020,22,16896,484,69696,86592
train,2021,13,9984,169,24336,34320
train,2022,32,24576,1024,147456,172032
train,2023,10,7680,100,14400,22080
train,2024,29,22272,841,121104,143376
train,2025,28,21504,784,112896,134400
train,2026,42,32256,1764,254016,286272
train,2027,9,6912,81,11664,18576
train,2028,17,13056,289,41616,54672
train,2029,22,16896,484,69696,86592
train,2030,10,7680,100,14400,22080
train,2031,54,41472,2916,419904,461376
train,2032,19,14592,361,51984,66576
train,2033,30,23040,900,129600,152640
train,2034,18,13824,324,46656,60480
train,2035,12,9216,144,20736,29952
train,2036,40,30720,1600,230400,261120
train,2037,8,6144,64,9216,15360
train,2038,29,22272,841,121104,143376
train,2039,37,28416,1369,197136,225552
train,2040,18,13824,324,46656,60480
train,2041,57,43776,3249,467856,511632
train,2042,7,5376,49,7056,12432
train,2043,17,13056,289,41616,54672
train,2044,38,29184,1444,207936,237120
train,2045,19,14592,361,51984,66576
train,2046,22,16896,484,69696,86592
train,2047,17,13056,289,41616,54672
train,2048,39,29952,1521,219024,248976
train,2049,21,16128,441,63504,79632
train,2050,17,13056,289,41616,54672
train,2051,32,24576,1024,147456,172032
train,2052,66,50688,4356,627264,677952
train,2053,20,15360,400,57600,72960
train,2054,17,13056,289,41616,54672
train,2055,23,17664,529,76176,93840
train,2056,8,6144,64,9216,15360
train,2057,19,14592,361,51984,66576
train,2058,41,31488,1681,242064,273552
train,2059,17,13056,289,41616,54672
train,2060,14,10752,196,28224,38976
train,2061,18,13824,324,46656,60480
train,2062,19,14592,361,51984,66576
train,2063,26,19968,676,97344,117312
train,2064,25,19200,625,90000,109200
train,2065,29,22272,841,121104,143376
train,2066,41,31488,1681,242064,273552
train,2067,21,16128,441,63504,79632
train,2068,30,23040,900,129600,152640
train,2069,23,17664,529,76176,93840
train,2070,17,13056,289,41616,54672
train,2071,25,19200,625,90000,109200
train,2072,17,13056,289,41616,54672
train,2073,29,22272,841,121104,143376
train,2074,10,7680,100,14400,22080
train,2075,27,20736,729,104976,125712
train,2076,27,20736,729,104976,125712
train,2077,26,19968,676,97344,117312
train,2078,9,6912,81,11664,18576
train,2079,19,14592,361,51984,66576
train,2080,37,28416,1369,197136,225552
train,2081,12,9216,144,20736,29952
train,2082,27,20736,729,104976,125712
train,2083,30,23040,900,129600,152640
train,2084,37,28416,1369,197136,225552
train,2085,21,16128,441,63504,79632
train,2086,10,7680,100,14400,22080
train,2087,23,17664,529,76176,93840
train,2088,11,8448,121,17424,25872
train,2089,32,24576,1024,147456,172032
train,2090,11,8448,121,17424,25872
train,2091,24,18432,576,82944,101376
train,2092,23,17664,529,76176,93840
train,2093,12,9216,144,20736,29952
train,2094,28,21504,784,112896,134400
train,2095,6,4608,36,5184,9792
train,2096,16,12288,256,36864,49152
train,2097,7,5376,49,7056,12432
train,2098,24,18432,576,82944,101376
train,2099,44,33792,1936,278784,312576
train,2100,39,29952,1521,219024,248976
train,2101,41,31488,1681,242064,273552
train,2102,24,18432,576,82944,101376
train,2103,15,11520,225,32400,43920
train,2104,11,8448,121,17424,25872
train,2105,24,18432,576,82944,101376
train,2106,22,16896,484,69696,86592
train,2107,66,50688,4356,627264,677952
train,2108,24,18432,576,82944,101376
train,2109,6,4608,36,5184,9792
train,2110,16,12288,256,36864,49152
train,2111,21,16128,441,63504,79632
train,2112,49,37632,2401,345744,383376
train,2113,13,9984,169,24336,34320
train,2114,52,39936,2704,389376,429312
train,2115,10,7680,100,14400,22080
train,2116,29,22272,841,121104,143376
train,2117,35,26880,1225,176400,203280
train,2118,31,23808,961,138384,162192
train,2119,9,6912,81,11664,18576
train,2120,29,22272,841,121104,143376
train,2121,10,7680,100,14400,22080
train,2122,26,19968,676,97344,117312
train,2123,21,16128,441,63504,79632
train,2124,20,15360,400,57600,72960
train,2125,24,18432,576,82944,101376
train,2126,33,25344,1089,156816,182160
train,2127,42,32256,1764,254016,286272
train,2128,11,8448,121,17424,25872
train,2129,12,9216,144,20736,29952
train,2130,17,13056,289,41616,54672
train,2131,6,4608,36,5184,9792
train,2132,29,22272,841,121104,143376
train,2133,6,4608,36,5184,9792
train,2134,33,25344,1089,156816,182160
train,2135,29,22272,841,121104,143376
train,2136,34,26112,1156,166464,192576
train,2137,9,6912,81,11664,18576
train,2138,25,19200,625,90000,109200
train,2139,24,18432,576,82944,101376
train,2140,11,8448,121,17424,25872
train,2141,32,24576,1024,147456,172032
train,2142,11,8448,121,17424,25872
train,2143,30,23040,900,129600,152640
train,2144,19,14592,361,51984,66576
train,2145,34,26112,1156,166464,192576
train,2146,15,11520,225,32400,43920
train,2147,35,26880,1225,176400,203280
train,2148,25,19200,625,90000,109200
train,2149,22,16896,484,69696,86592
train,2150,34,26112,1156,166464,192576
train,2151,49,37632,2401,345744,383376
train,2152,27,20736,729,104976,125712
train,2153,14,10752,196,28224,38976
train,2154,26,19968,676,97344,117312
train,2155,16,12288,256,36864,49152
train,2156,5,3840,25,3600,7440
train,2157,9,6912,81,11664,18576
train,2158,15,11520,225,32400,43920
train,2159,36,27648,1296,186624,214272
train,2160,14,10752,196,28224,38976
train,2161,20,15360,400,57600,72960
train,2162,9,6912,81,11664,18576
train,2163,29,22272,841,121104,143376
train,2164,48,36864,2304,331776,368640
train,2165,9,6912,81,11664,18576
train,2166,15,11520,225,32400,43920
train,2167,15,11520,225,32400,43920
train,2168,27,20736,729,104976,125712
train,2169,16,12288,256,36864,49152
train,2170,29,22272,841,121104,143376
train,2171,25,19200,625,90000,109200
train,2172,26,19968,676,97344,117312
train,2173,39,29952,1521,219024,248976
train,2174,22,16896,484,69696,86592
train,2175,31,23808,961,138384,162192
train,2176,31,23808,961,138384,162192
train,2177,13,9984,169,24336,34320
train,2178,35,26880,1225,176400,203280
train,2179,11,8448,121,17424,25872
train,2180,28,21504,784,112896,134400
train,2181,22,16896,484,69696,86592
train,2182,13,9984,169,24336,34320
train,2183,29,22272,841,121104,143376
train,2184,19,14592,361,51984,66576
train,2185,5,3840,25,3600,7440
train,2186,29,22272,841,121104,143376
train,2187,18,13824,324,46656,60480
train,2188,20,15360,400,57600,72960
train,2189,30,23040,900,129600,152640
train,2190,28,21504,784,112896,134400
train,2191,45,34560,2025,291600,326160
train,2192,34,26112,1156,166464,192576
train,2193,11,8448,121,17424,25872
train,2194,30,23040,900,129600,152640
train,2195,6,4608,36,5184,9792
train,2196,31,23808,961,138384,162192
train,2197,23,17664,529,76176,93840
train,2198,20,15360,400,57600,72960
train,2199,29,22272,841,121104,143376
train,2200,17,13056,289,41616,54672
train,2201,18,13824,324,46656,60480
train,2202,23,17664,529,76176,93840
train,2203,9,6912,81,11664,18576
train,2204,13,9984,169,24336,34320
train,2205,30,23040,900,129600,152640
train,2206,25,19200,625,90000,109200
train,2207,9,6912,81,11664,18576
train,2208,38,29184,1444,207936,237120
train,2209,31,23808,961,138384,162192
train,2210,21,16128,441,63504,79632
train,2211,39,29952,1521,219024,248976
train,2212,42,32256,1764,254016,286272
train,2213,17,13056,289,41616,54672
train,2214,27,20736,729,104976,125712
train,2215,35,26880,1225,176400,203280
train,2216,40,30720,1600,230400,261120
train,2217,53,40704,2809,404496,445200
train,2218,30,23040,900,129600,152640
train,2219,13,9984,169,24336,34320
train,2220,10,7680,100,14400,22080
train,2221,12,9216,144,20736,29952
train,2222,19,14592,361,51984,66576
train,2223,19,14592,361,51984,66576
train,2224,38,29184,1444,207936,237120
train,2225,12,9216,144,20736,29952
train,2226,21,16128,441,63504,79632
train,2227,26,19968,676,97344,117312
train,2228,24,18432,576,82944,101376
train,2229,23,17664,529,76176,93840
train,2230,44,33792,1936,278784,312576
train,2231,14,10752,196,28224,38976
train,2232,27,20736,729,104976,125712
train,2233,33,25344,1089,156816,182160
train,2234,38,29184,1444,207936,237120
train,2235,23,17664,529,76176,93840
train,2236,35,26880,1225,176400,203280
train,2237,14,10752,196,28224,38976
train,2238,19,14592,361,51984,66576
train,2239,8,6144,64,9216,15360
train,2240,33,25344,1089,156816,182160
train,2241,31,23808,961,138384,162192
train,2242,29,22272,841,121104,143376
train,2243,22,16896,484,69696,86592
train,2244,12,9216,144,20736,29952
train,2245,11,8448,121,17424,25872
train,2246,36,27648,1296,186624,214272
train,2247,48,36864,2304,331776,368640
train,2248,40,30720,1600,230400,261120
train,2249,10,7680,100,14400,22080
train,2250,31,23808,961,138384,162192
train,2251,18,13824,324,46656,60480
train,2252,32,24576,1024,147456,172032
train,2253,60,46080,3600,518400,564480
train,2254,5,3840,25,3600,7440
train,2255,28,21504,784,112896,134400
train,2256,18,13824,324,46656,60480
train,2257,14,10752,196,28224,38976
train,2258,31,23808,961,138384,162192
train,2259,16,12288,256,36864,49152
train,2260,46,35328,2116,304704,340032
train,2261,9,6912,81,11664,18576
train,2262,16,12288,256,36864,49152
train,2263,33,25344,1089,156816,182160
train,2264,31,23808,961,138384,162192
train,2265,24,18432,576,82944,101376
train,2266,27,20736,729,104976,125712
train,2267,36,27648,1296,186624,214272
train,2268,27,20736,729,104976,125712
train,2269,33,25344,1089,156816,182160
train,2270,19,14592,361,51984,66576
train,2271,30,23040,900,129600,152640
train,2272,36,27648,1296,186624,214272
train,2273,31,23808,961,138384,162192
train,2274,28,21504,784,112896,134400
train,2275,25,19200,625,90000,109200
train,2276,20,15360,400,57600,72960
train,2277,43,33024,1849,266256,299280
train,2278,10,7680,100,14400,22080
train,2279,31,23808,961,138384,162192
train,2280,31,23808,961,138384,162192
train,2281,16,12288,256,36864,49152
train,2282,26,19968,676,97344,117312
train,2283,10,7680,100,14400,22080
train,2284,25,19200,625,90000,109200
train,2285,31,23808,961,138384,162192
train,2286,20,15360,400,57600,72960
train,2287,40,30720,1600,230400,261120
train,2288,25,19200,625,90000,109200
train,2289,17,13056,289,41616,54672
train,2290,33,25344,1089,156816,182160
train,2291,12,9216,144,20736,29952
train,2292,22,16896,484,69696,86592
train,2293,20,15360,400,57600,72960
train,2294,10,7680,100,14400,22080
train,2295,32,24576,1024,147456,172032
train,2296,33,25344,1089,156816,182160
train,2297,29,22272,841,121104,143376
train,2298,24,18432,576,82944,101376
train,2299,30,23040,900,129600,152640
train,2300,24,18432,576,82944,101376
train,2301,13,9984,169,24336,34320
train,2302,39,29952,1521,219024,248976
train,2303,11,8448,121,17424,25872
train,2304,36,27648,1296,186624,214272
train,2305,38,29184,1444,207936,237120
train,2306,33,25344,1089,156816,182160
train,2307,12,9216,144,20736,29952
train,2308,47,36096,2209,318096,354192
train,2309,15,11520,225,32400,43920
train,2310,22,16896,484,69696,86592
train,2311,28,21504,784,112896,134400
train,2312,10,7680,100,14400,22080
train,2313,31,23808,961,138384,162192
train,2314,17,13056,289,41616,54672
train,2315,26,19968,676,97344,117312
train,2316,33,25344,1089,156816,182160
train,2317,25,19200,625,90000,109200
train,2318,31,23808,961,138384,162192
train,2319,22,16896,484,69696,86592
train,2320,21,16128,441,63504,79632
train,2321,20,15360,400,57600,72960
train,2322,17,13056,289,41616,54672
train,2323,36,27648,1296,186624,214272
train,2324,45,34560,2025,291600,326160
train,2325,13,9984,169,24336,34320
train,2326,32,24576,1024,147456,172032
train,2327,43,33024,1849,266256,299280
train,2328,26,19968,676,97344,117312
train,2329,29,22272,841,121104,143376
train,2330,24,18432,576,82944,101376
train,2331,19,14592,361,51984,66576
train,2332,42,32256,1764,254016,286272
train,2333,13,9984,169,24336,34320
train,2334,19,14592,361,51984,66576
train,2335,32,24576,1024,147456,172032
train,2336,27,20736,729,104976,125712
train,2337,23,17664,529,76176,93840
train,2338,23,17664,529,76176,93840
train,2339,30,23040,900,129600,152640
train,2340,48,36864,2304,331776,368640
train,2341,18,13824,324,46656,60480
train,2342,18,13824,324,46656,60480
train,2343,23,17664,529,76176,93840
train,2344,27,20736,729,104976,125712
train,2345,30,23040,900,129600,152640
train,2346,34,26112,1156,166464,192576
train,2347,17,13056,289,41616,54672
train,2348,27,20736,729,104976,125712
train,2349,35,26880,1225,176400,203280
train,2350,50,38400,2500,360000,398400
train,2351,18,13824,324,46656,60480
train,2352,11,8448,121,17424,25872
train,2353,19,14592,361,51984,66576
train,2354,22,16896,484,69696,86592
train,2355,35,26880,1225,176400,203280
train,2356,38,29184,1444,207936,237120
train,2357,19,14592,361,51984,66576
train,2358,32,24576,1024,147456,172032
train,2359,13,9984,169,24336,34320
train,2360,48,36864,2304,331776,368640
train,2361,38,29184,1444,207936,237120
train,2362,9,6912,81,11664,18576
train,2363,15,11520,225,32400,43920
train,2364,42,32256,1764,254016,286272
train,2365,42,32256,1764,254016,286272
train,2366,19,14592,361,51984,66576
train,2367,13,9984,169,24336,34320
train,2368,27,20736,729,104976,125712
train,2369,14,10752,196,28224,38976
train,2370,41,31488,1681,242064,273552
train,2371,34,26112,1156,166464,192576
train,2372,23,17664,529,76176,93840
train,2373,22,16896,484,69696,86592
train,2374,16,12288,256,36864,49152
train,2375,24,18432,576,82944,101376
train,2376,8,6144,64,9216,15360
train,2377,8,6144,64,9216,15360
train,2378,36,27648,1296,186624,214272
train,2379,16,12288,256,36864,49152
train,2380,18,13824,324,46656,60480
train,2381,36,27648,1296,186624,214272
train,2382,27,20736,729,104976,125712
train,2383,19,14592,361,51984,66576
train,2384,24,18432,576,82944,101376
train,2385,36,27648,1296,186624,214272
train,2386,29,22272,841,121104,143376
train,2387,21,16128,441,63504,79632
train,2388,36,27648,1296,186624,214272
train,2389,34,26112,1156,166464,192576
train,2390,23,17664,529,76176,93840
train,2391,36,27648,1296,186624,214272
train,2392,15,11520,225,32400,43920
train,2393,27,20736,729,104976,125712
train,2394,32,24576,1024,147456,172032
train,2395,26,19968,676,97344,117312
train,2396,15,11520,225,32400,43920
train,2397,13,9984,169,24336,34320
train,2398,11,8448,121,17424,25872
train,2399,26,19968,676,97344,117312
train,2400,37,28416,1369,197136,225552
train,2401,29,22272,841,121104,143376
train,2402,23,17664,529,76176,93840
train,2403,30,23040,900,129600,152640
train,2404,26,19968,676,97344,117312
train,2405,19,14592,361,51984,66576
train,2406,22,16896,484,69696,86592
train,2407,27,20736,729,104976,125712
train,2408,17,13056,289,41616,54672
train,2409,8,6144,64,9216,15360
train,2410,12,9216,144,20736,29952
train,2411,10,7680,100,14400,22080
train,2412,18,13824,324,46656,60480
train,2413,12,9216,144,20736,29952
train,2414,29,22272,841,121104,143376
train,2415,20,15360,400,57600,72960
train,2416,33,25344,1089,156816,182160
train,2417,20,15360,400,57600,72960
train,2418,17,13056,289,41616,54672
train,2419,20,15360,400,57600,72960
train,2420,7,5376,49,7056,12432
train,2421,24,18432,576,82944,101376
train,2422,8,6144,64,9216,15360
train,2423,20,15360,400,57600,72960
train,2424,31,23808,961,138384,162192
train,2425,14,10752,196,28224,38976
train,2426,24,18432,576,82944,101376
train,2427,25,19200,625,90000,109200
train,2428,27,20736,729,104976,125712
train,2429,23,17664,529,76176,93840
train,2430,28,21504,784,112896,134400
train,2431,35,26880,1225,176400,203280
train,2432,19,14592,361,51984,66576
train,2433,9,6912,81,11664,18576
train,2434,29,22272,841,121104,143376
train,2435,32,24576,1024,147456,172032
train,2436,14,10752,196,28224,38976
train,2437,22,16896,484,69696,86592
train,2438,31,23808,961,138384,162192
train,2439,41,31488,1681,242064,273552
train,2440,32,24576,1024,147456,172032
train,2441,33,25344,1089,156816,182160
train,2442,28,21504,784,112896,134400
train,2443,31,23808,961,138384,162192
train,2444,36,27648,1296,186624,214272
train,2445,15,11520,225,32400,43920
train,2446,11,8448,121,17424,25872
train,2447,32,24576,1024,147456,172032
train,2448,11,8448,121,17424,25872
train,2449,35,26880,1225,176400,203280
train,2450,23,17664,529,76176,93840
train,2451,21,16128,441,63504,79632
train,2452,21,16128,441,63504,79632
train,2453,37,28416,1369,197136,225552
train,2454,11,8448,121,17424,25872
train,2455,24,18432,576,82944,101376
train,2456,44,33792,1936,278784,312576
train,2457,10,7680,100,14400,22080
train,2458,34,26112,1156,166464,192576
train,2459,22,16896,484,69696,86592
train,2460,13,9984,169,24336,34320
train,2461,57,43776,3249,467856,511632
train,2462,10,7680,100,14400,22080
train,2463,44,33792,1936,278784,312576
train,2464,31,23808,961,138384,162192
train,2465,26,19968,676,97344,117312
train,2466,20,15360,400,57600,72960
train,2467,23,17664,529,76176,93840
train,2468,24,18432,576,82944,101376
train,2469,20,15360,400,57600,72960
train,2470,10,7680,100,14400,22080
train,2471,14,10752,196,28224,38976
train,2472,18,13824,324,46656,60480
train,2473,28,21504,784,112896,134400
train,2474,25,19200,625,90000,109200
train,2475,21,16128,441,63504,79632
train,2476,21,16128,441,63504,79632
train,2477,36,27648,1296,186624,214272
train,2478,36,27648,1296,186624,214272
train,2479,31,23808,961,138384,162192
train,2480,51,39168,2601,374544,413712
train,2481,13,9984,169,24336,34320
train,2482,34,26112,1156,166464,192576
train,2483,53,40704,2809,404496,445200
train,2484,38,29184,1444,207936,237120
train,2485,29,22272,841,121104,143376
train,2486,25,19200,625,90000,109200
train,2487,34,26112,1156,166464,192576
train,2488,40,30720,1600,230400,261120
train,2489,32,24576,1024,147456,172032
train,2490,17,13056,289,41616,54672
train,2491,28,21504,784,112896,134400
train,2492,52,39936,2704,389376,429312
train,2493,37,28416,1369,197136,225552
train,2494,31,23808,961,138384,162192
train,2495,51,39168,2601,374544,413712
train,2496,34,26112,1156,166464,192576
train,2497,49,37632,2401,345744,383376
train,2498,17,13056,289,41616,54672
train,2499,48,36864,2304,331776,368640
train,2500,31,23808,961,138384,162192
train,2501,15,11520,225,32400,43920
train,2502,35,26880,1225,176400,203280
train,2503,45,34560,2025,291600,326160
train,2504,29,22272,841,121104,143376
train,2505,25,19200,625,90000,109200
train,2506,17,13056,289,41616,54672
train,2507,35,26880,1225,176400,203280
train,2508,43,33024,1849,266256,299280
train,2509,16,12288,256,36864,49152
train,2510,28,21504,784,112896,134400
train,2511,14,10752,196,28224,38976
train,2512,8,6144,64,9216,15360
train,2513,28,21504,784,112896,134400
train,2514,26,19968,676,97344,117312
train,2515,16,12288,256,36864,49152
train,2516,27,20736,729,104976,125712
train,2517,18,13824,324,46656,60480
train,2518,34,26112,1156,166464,192576
train,2519,31,23808,961,138384,162192
train,2520,12,9216,144,20736,29952
train,2521,23,17664,529,76176,93840
train,2522,24,18432,576,82944,101376
train,2523,44,33792,1936,278784,312576
train,2524,5,3840,25,3600,7440
train,2525,14,10752,196,28224,38976
train,2526,32,24576,1024,147456,172032
train,2527,43,33024,1849,266256,299280
train,2528,44,33792,1936,278784,312576
train,2529,18,13824,324,46656,60480
train,2530,14,10752,196,28224,38976
train,2531,26,19968,676,97344,117312
train,2532,27,20736,729,104976,125712
train,2533,26,19968,676,97344,117312
train,2534,19,14592,361,51984,66576
train,2535,26,19968,676,97344,117312
train,2536,12,9216,144,20736,29952
train,2537,32,24576,1024,147456,172032
train,2538,30,23040,900,129600,152640
train,2539,38,29184,1444,207936,237120
train,2540,13,9984,169,24336,34320
train,2541,43,33024,1849,266256,299280
train,2542,10,7680,100,14400,22080
train,2543,20,15360,400,57600,72960
train,2544,30,23040,900,129600,152640
train,2545,19,14592,361,51984,66576
train,2546,5,3840,25,3600,7440
train,2547,18,13824,324,46656,60480
train,2548,8,6144,64,9216,15360
train,2549,17,13056,289,41616,54672
train,2550,46,35328,2116,304704,340032
train,2551,40,30720,1600,230400,261120
train,2552,35,26880,1225,176400,203280
train,2553,29,22272,841,121104,143376
train,2554,32,24576,1024,147456,172032
train,2555,29,22272,841,121104,143376
train,2556,32,24576,1024,147456,172032
train,2557,58,44544,3364,484416,528960
train,2558,8,6144,64,9216,15360
train,2559,12,9216,144,20736,29952
train,2560,9,6912,81,11664,18576
train,2561,9,6912,81,11664,18576
train,2562,48,36864,2304,331776,368640
train,2563,32,24576,1024,147456,172032
train,2564,34,26112,1156,166464,192576
train,2565,24,18432,576,82944,101376
train,2566,23,17664,529,76176,93840
train,2567,14,10752,196,28224,38976
train,2568,24,18432,576,82944,101376
train,2569,12,9216,144,20736,29952
train,2570,19,14592,361,51984,66576
train,2571,12,9216,144,20736,29952
train,2572,35,26880,1225,176400,203280
train,2573,27,20736,729,104976,125712
train,2574,37,28416,1369,197136,225552
train,2575,22,16896,484,69696,86592
train,2576,23,17664,529,76176,93840
train,2577,53,40704,2809,404496,445200
train,2578,27,20736,729,104976,125712
train,2579,43,33024,1849,266256,299280
train,2580,41,31488,1681,242064,273552
train,2581,29,22272,841,121104,143376
train,2582,21,16128,441,63504,79632
train,2583,23,17664,529,76176,93840
train,2584,22,16896,484,69696,86592
train,2585,23,17664,529,76176,93840
train,2586,11,8448,121,17424,25872
train,2587,12,9216,144,20736,29952
train,2588,16,12288,256,36864,49152
train,2589,20,15360,400,57600,72960
train,2590,9,6912,81,11664,18576
train,2591,55,42240,3025,435600,477840
train,2592,17,13056,289,41616,54672
train,2593,21,16128,441,63504,79632
train,2594,28,21504,784,112896,134400
train,2595,19,14592,361,51984,66576
train,2596,37,28416,1369,197136,225552
train,2597,46,35328,2116,304704,340032
train,2598,43,33024,1849,266256,299280
train,2599,24,18432,576,82944,101376
train,2600,30,23040,900,129600,152640
train,2601,46,35328,2116,304704,340032
train,2602,22,16896,484,69696,86592
train,2603,40,30720,1600,230400,261120
train,2604,56,43008,3136,451584,494592
train,2605,12,9216,144,20736,29952
train,2606,8,6144,64,9216,15360
train,2607,29,22272,841,121104,143376
train,2608,32,24576,1024,147456,172032
train,2609,33,25344,1089,156816,182160
train,2610,23,17664,529,76176,93840
train,2611,26,19968,676,97344,117312
train,2612,21,16128,441,63504,79632
train,2613,19,14592,361,51984,66576
train,2614,11,8448,121,17424,25872
train,2615,17,13056,289,41616,54672
train,2616,25,19200,625,90000,109200
train,2617,11,8448,121,17424,25872
train,2618,41,31488,1681,242064,273552
train,2619,39,29952,1521,219024,248976
train,2620,37,28416,1369,197136,225552
train,2621,17,13056,289,41616,54672
train,2622,41,31488,1681,242064,273552
train,2623,14,10752,196,28224,38976
train,2624,12,9216,144,20736,29952
train,2625,22,16896,484,69696,86592
train,2626,45,34560,2025,291600,326160
train,2627,21,16128,441,63504,79632
train,2628,48,36864,2304,331776,368640
train,2629,22,16896,484,69696,86592
train,2630,37,28416,1369,197136,225552
train,2631,40,30720,1600,230400,261120
train,2632,34,26112,1156,166464,192576
train,2633,17,13056,289,41616,54672
train,2634,23,17664,529,76176,93840
train,2635,33,25344,1089,156816,182160
train,2636,29,22272,841,121104,143376
train,2637,15,11520,225,32400,43920
train,2638,32,24576,1024,147456,172032
train,2639,29,22272,841,121104,143376
train,2640,20,15360,400,57600,72960
train,2641,28,21504,784,112896,134400
train,2642,55,42240,3025,435600,477840
train,2643,24,18432,576,82944,101376
train,2644,14,10752,196,28224,38976
train,2645,18,13824,324,46656,60480
train,2646,21,16128,441,63504,79632
train,2647,28,21504,784,112896,134400
train,2648,17,13056,289,41616,54672
train,2649,17,13056,289,41616,54672
train,2650,34,26112,1156,166464,192576
train,2651,28,21504,784,112896,134400
train,2652,30,23040,900,129600,152640
train,2653,23,17664,529,76176,93840
train,2654,20,15360,400,57600,72960
train,2655,52,39936,2704,389376,429312
train,2656,18,13824,324,46656,60480
train,2657,18,13824,324,46656,60480
train,2658,31,23808,961,138384,162192
train,2659,18,13824,324,46656,60480
train,2660,24,18432,576,82944,101376
train,2661,14,10752,196,28224,38976
train,2662,33,25344,1089,156816,182160
train,2663,38,29184,1444,207936,237120
train,2664,19,14592,361,51984,66576
train,2665,14,10752,196,28224,38976
train,2666,46,35328,2116,304704,340032
train,2667,12,9216,144,20736,29952
train,2668,13,9984,169,24336,34320
train,2669,7,5376,49,7056,12432
train,2670,23,17664,529,76176,93840
train,2671,28,21504,784,112896,134400
train,2672,25,19200,625,90000,109200
train,2673,35,26880,1225,176400,203280
train,2674,16,12288,256,36864,49152
train,2675,34,26112,1156,166464,192576
train,2676,24,18432,576,82944,101376
train,2677,22,16896,484,69696,86592
train,2678,22,16896,484,69696,86592
train,2679,24,18432,576,82944,101376
train,2680,12,9216,144,20736,29952
train,2681,24,18432,576,82944,101376
train,2682,25,19200,625,90000,109200
train,2683,22,16896,484,69696,86592
train,2684,35,26880,1225,176400,203280
train,2685,34,26112,1156,166464,192576
train,2686,58,44544,3364,484416,528960
train,2687,36,27648,1296,186624,214272
train,2688,21,16128,441,63504,79632
train,2689,27,20736,729,104976,125712
train,2690,19,14592,361,51984,66576
train,2691,21,16128,441,63504,79632
train,2692,37,28416,1369,197136,225552
train,2693,24,18432,576,82944,101376
train,2694,19,14592,361,51984,66576
train,2695,45,34560,2025,291600,326160
train,2696,39,29952,1521,219024,248976
train,2697,33,25344,1089,156816,182160
train,2698,22,16896,484,69696,86592
train,2699,36,27648,1296,186624,214272
train,2700,18,13824,324,46656,60480
train,2701,22,16896,484,69696,86592
train,2702,7,5376,49,7056,12432
train,2703,30,23040,900,129600,152640
train,2704,29,22272,841,121104,143376
train,2705,36,27648,1296,186624,214272
train,2706,21,16128,441,63504,79632
train,2707,35,26880,1225,176400,203280
train,2708,29,22272,841,121104,143376
train,2709,24,18432,576,82944,101376
train,2710,21,16128,441,63504,79632
train,2711,35,26880,1225,176400,203280
train,2712,13,9984,169,24336,34320
train,2713,14,10752,196,28224,38976
train,2714,30,23040,900,129600,152640
train,2715,11,8448,121,17424,25872
train,2716,58,44544,3364,484416,528960
train,2717,16,12288,256,36864,49152
train,2718,25,19200,625,90000,109200
train,2719,29,22272,841,121104,143376
train,2720,52,39936,2704,389376,429312
train,2721,24,18432,576,82944,101376
train,2722,45,34560,2025,291600,326160
train,2723,27,20736,729,104976,125712
train,2724,24,18432,576,82944,101376
train,2725,23,17664,529,76176,93840
train,2726,22,16896,484,69696,86592
train,2727,25,19200,625,90000,109200
train,2728,44,33792,1936,278784,312576
train,2729,37,28416,1369,197136,225552
train,2730,17,13056,289,41616,54672
train,2731,26,19968,676,97344,117312
train,2732,17,13056,289,41616,54672
train,2733,36,27648,1296,186624,214272
train,2734,18,13824,324,46656,60480
train,2735,15,11520,225,32400,43920
train,2736,12,9216,144,20736,29952
train,2737,31,23808,961,138384,162192
train,2738,11,8448,121,17424,25872
train,2739,43,33024,1849,266256,299280
train,2740,22,16896,484,69696,86592
train,2741,14,10752,196,28224,38976
train,2742,29,22272,841,121104,143376
train,2743,19,14592,361,51984,66576
train,2744,30,23040,900,129600,152640
train,2745,14,10752,196,28224,38976
train,2746,30,23040,900,129600,152640
train,2747,28,21504,784,112896,134400
train,2748,21,16128,441,63504,79632
train,2749,20,15360,400,57600,72960
train,2750,6,4608,36,5184,9792
train,2751,22,16896,484,69696,86592
train,2752,21,16128,441,63504,79632
train,2753,14,10752,196,28224,38976
train,2754,23,17664,529,76176,93840
train,2755,36,27648,1296,186624,214272
train,2756,23,17664,529,76176,93840
train,2757,26,19968,676,97344,117312
train,2758,33,25344,1089,156816,182160
train,2759,39,29952,1521,219024,248976
train,2760,15,11520,225,32400,43920
train,2761,6,4608,36,5184,9792
train,2762,21,16128,441,63504,79632
train,2763,31,23808,961,138384,162192
train,2764,20,15360,400,57600,72960
train,2765,47,36096,2209,318096,354192
train,2766,14,10752,196,28224,38976
train,2767,29,22272,841,121104,143376
train,2768,28,21504,784,112896,134400
train,2769,20,15360,400,57600,72960
train,2770,9,6912,81,11664,18576
train,2771,7,5376,49,7056,12432
train,2772,14,10752,196,28224,38976
train,2773,26,19968,676,97344,117312
train,2774,34,26112,1156,166464,192576
train,2775,24,18432,576,82944,101376
train,2776,21,16128,441,63504,79632
train,2777,22,16896,484,69696,86592
train,2778,22,16896,484,69696,86592
train,2779,23,17664,529,76176,93840
train,2780,33,25344,1089,156816,182160
train,2781,24,18432,576,82944,101376
train,2782,23,17664,529,76176,93840
train,2783,31,23808,961,138384,162192
train,2784,15,11520,225,32400,43920
train,2785,34,26112,1156,166464,192576
train,2786,16,12288,256,36864,49152
train,2787,17,13056,289,41616,54672
train,2788,57,43776,3249,467856,511632
train,2789,28,21504,784,112896,134400
train,2790,14,10752,196,28224,38976
train,2791,25,19200,625,90000,109200
train,2792,23,17664,529,76176,93840
train,2793,5,3840,25,3600,7440
train,2794,49,37632,2401,345744,383376
train,2795,10,7680,100,14400,22080
train,2796,20,15360,400,57600,72960
train,2797,15,11520,225,32400,43920
train,2798,7,5376,49,7056,12432
train,2799,34,26112,1156,166464,192576
train,2800,14,10752,196,28224,38976
train,2801,31,23808,961,138384,162192
train,2802,19,14592,361,51984,66576
train,2803,21,16128,441,63504,79632
train,2804,30,23040,900,129600,152640
train,2805,22,16896,484,69696,86592
train,2806,11,8448,121,17424,25872
train,2807,21,16128,441,63504,79632
train,2808,10,7680,100,14400,22080
train,2809,38,29184,1444,207936,237120
train,2810,14,10752,196,28224,38976
train,2811,26,19968,676,97344,117312
train,2812,24,18432,576,82944,101376
train,2813,21,16128,441,63504,79632
train,2814,10,7680,100,14400,22080
train,2815,22,16896,484,69696,86592
train,2816,14,10752,196,28224,38976
train,2817,34,26112,1156,166464,192576
train,2818,24,18432,576,82944,101376
train,2819,32,24576,1024,147456,172032
train,2820,17,13056,289,41616,54672
train,2821,15,11520,225,32400,43920
train,2822,22,16896,484,69696,86592
train,2823,16,12288,256,36864,49152
train,2824,23,17664,529,76176,93840
train,2825,25,19200,625,90000,109200
train,2826,26,19968,676,97344,117312
train,2827,22,16896,484,69696,86592
train,2828,11,8448,121,17424,25872
train,2829,31,23808,961,138384,162192
train,2830,26,19968,676,97344,117312
train,2831,35,26880,1225,176400,203280
train,2832,19,14592,361,51984,66576
train,2833,13,9984,169,24336,34320
train,2834,20,15360,400,57600,72960
train,2835,36,27648,1296,186624,214272
train,2836,21,16128,441,63504,79632
train,2837,18,13824,324,46656,60480
train,2838,34,26112,1156,166464,192576
train,2839,15,11520,225,32400,43920
train,2840,25,19200,625,90000,109200
train,2841,30,23040,900,129600,152640
train,2842,12,9216,144,20736,29952
train,2843,23,17664,529,76176,93840
train,2844,22,16896,484,69696,86592
train,2845,17,13056,289,41616,54672
train,2846,12,9216,144,20736,29952
train,2847,13,9984,169,24336,34320
train,2848,16,12288,256,36864,49152
train,2849,23,17664,529,76176,93840
train,2850,30,23040,900,129600,152640
train,2851,29,22272,841,121104,143376
train,2852,27,20736,729,104976,125712
train,2853,21,16128,441,63504,79632
train,2854,26,19968,676,97344,117312
train,2855,28,21504,784,112896,134400
train,2856,37,28416,1369,197136,225552
train,2857,32,24576,1024,147456,172032
train,2858,12,9216,144,20736,29952
train,2859,19,14592,361,51984,66576
train,2860,41,31488,1681,242064,273552
train,2861,54,41472,2916,419904,461376
train,2862,48,36864,2304,331776,368640
train,2863,33,25344,1089,156816,182160
train,2864,25,19200,625,90000,109200
train,2865,28,21504,784,112896,134400
train,2866,15,11520,225,32400,43920
train,2867,52,39936,2704,389376,429312
train,2868,24,18432,576,82944,101376
train,2869,34,26112,1156,166464,192576
train,2870,25,19200,625,90000,109200
train,2871,25,19200,625,90000,109200
train,2872,21,16128,441,63504,79632
train,2873,9,6912,81,11664,18576
train,2874,30,23040,900,129600,152640
train,2875,16,12288,256,36864,49152
train,2876,14,10752,196,28224,38976
train,2877,19,14592,361,51984,66576
train,2878,32,24576,1024,147456,172032
train,2879,27,20736,729,104976,125712
train,2880,33,25344,1089,156816,182160
train,2881,43,33024,1849,266256,299280
train,2882,7,5376,49,7056,12432
train,2883,18,13824,324,46656,60480
train,2884,42,32256,1764,254016,286272
train,2885,13,9984,169,24336,34320
train,2886,19,14592,361,51984,66576
train,2887,22,16896,484,69696,86592
train,2888,24,18432,576,82944,101376
train,2889,44,33792,1936,278784,312576
train,2890,13,9984,169,24336,34320
train,2891,20,15360,400,57600,72960
train,2892,16,12288,256,36864,49152
train,2893,25,19200,625,90000,109200
train,2894,39,29952,1521,219024,248976
train,2895,46,35328,2116,304704,340032
train,2896,16,12288,256,36864,49152
train,2897,14,10752,196,28224,38976
train,2898,18,13824,324,46656,60480
train,2899,33,25344,1089,156816,182160
train,2900,6,4608,36,5184,9792
train,2901,16,12288,256,36864,49152
train,2902,14,10752,196,28224,38976
train,2903,23,17664,529,76176,93840
train,2904,30,23040,900,129600,152640
train,2905,14,10752,196,28224,38976
train,2906,18,13824,324,46656,60480
train,2907,20,15360,400,57600,72960
train,2908,20,15360,400,57600,72960
train,2909,27,20736,729,104976,125712
train,2910,26,19968,676,97344,117312
train,2911,25,19200,625,90000,109200
train,2912,13,9984,169,24336,34320
train,2913,19,14592,361,51984,66576
train,2914,31,23808,961,138384,162192
train,2915,15,11520,225,32400,43920
train,2916,30,23040,900,129600,152640
train,2917,16,12288,256,36864,49152
train,2918,7,5376,49,7056,12432
train,2919,28,21504,784,112896,134400
train,2920,9,6912,81,11664,18576
train,2921,37,28416,1369,197136,225552
train,2922,28,21504,784,112896,134400
train,2923,27,20736,729,104976,125712
train,2924,20,15360,400,57600,72960
train,2925,18,13824,324,46656,60480
train,2926,30,23040,900,129600,152640
train,2927,12,9216,144,20736,29952
train,2928,42,32256,1764,254016,286272
train,2929,9,6912,81,11664,18576
train,2930,28,21504,784,112896,134400
train,2931,18,13824,324,46656,60480
train,2932,26,19968,676,97344,117312
train,2933,15,11520,225,32400,43920
train,2934,43,33024,1849,266256,299280
train,2935,49,37632,2401,345744,383376
train,2936,34,26112,1156,166464,192576
train,2937,18,13824,324,46656,60480
train,2938,50,38400,2500,360000,398400
train,2939,24,18432,576,82944,101376
train,2940,17,13056,289,41616,54672
train,2941,26,19968,676,97344,117312
train,2942,18,13824,324,46656,60480
train,2943,13,9984,169,24336,34320
train,2944,11,8448,121,17424,25872
train,2945,46,35328,2116,304704,340032
train,2946,37,28416,1369,197136,225552
train,2947,28,21504,784,112896,134400
train,2948,20,15360,400,57600,72960
train,2949,29,22272,841,121104,143376
train,2950,8,6144,64,9216,15360
train,2951,20,15360,400,57600,72960
train,2952,18,13824,324,46656,60480
train,2953,33,25344,1089,156816,182160
train,2954,19,14592,361,51984,66576
train,2955,42,32256,1764,254016,286272
train,2956,32,24576,1024,147456,172032
train,2957,43,33024,1849,266256,299280
train,2958,29,22272,841,121104,143376
train,2959,31,23808,961,138384,162192
train,2960,5,3840,25,3600,7440
train,2961,18,13824,324,46656,60480
train,2962,35,26880,1225,176400,203280
train,2963,15,11520,225,32400,43920
train,2964,6,4608,36,5184,9792
train,2965,33,25344,1089,156816,182160
train,2966,29,22272,841,121104,143376
train,2967,23,17664,529,76176,93840
train,2968,32,24576,1024,147456,172032
train,2969,25,19200,625,90000,109200
train,2970,20,15360,400,57600,72960
train,2971,21,16128,441,63504,79632
train,2972,17,13056,289,41616,54672
train,2973,24,18432,576,82944,101376
train,2974,31,23808,961,138384,162192
train,2975,24,18432,576,82944,101376
train,2976,35,26880,1225,176400,203280
train,2977,47,36096,2209,318096,354192
train,2978,40,30720,1600,230400,261120
train,2979,35,26880,1225,176400,203280
train,2980,27,20736,729,104976,125712
train,2981,13,9984,169,24336,34320
train,2982,19,14592,361,51984,66576
train,2983,37,28416,1369,197136,225552
train,2984,19,14592,361,51984,66576
train,2985,16,12288,256,36864,49152
train,2986,25,19200,625,90000,109200
train,2987,38,29184,1444,207936,237120
train,2988,20,15360,400,57600,72960
train,2989,23,17664,529,76176,93840
train,2990,32,24576,1024,147456,172032
train,2991,19,14592,361,51984,66576
train,2992,13,9984,169,24336,34320
train,2993,9,6912,81,11664,18576
train,2994,19,14592,361,51984,66576
train,2995,33,25344,1089,156816,182160
train,2996,25,19200,625,90000,109200
train,2997,17,13056,289,41616,54672
train,2998,5,3840,25,3600,7440
train,2999,26,19968,676,97344,117312
train,3000,5,3840,25,3600,7440
train,3001,47,36096,2209,318096,354192
train,3002,33,25344,1089,156816,182160
train,3003,39,29952,1521,219024,248976
train,3004,9,6912,81,11664,18576
train,3005,15,11520,225,32400,43920
train,3006,42,32256,1764,254016,286272
train,3007,18,13824,324,46656,60480
train,3008,27,20736,729,104976,125712
train,3009,14,10752,196,28224,38976
train,3010,38,29184,1444,207936,237120
train,3011,6,4608,36,5184,9792
train,3012,14,10752,196,28224,38976
train,3013,16,12288,256,36864,49152
train,3014,13,9984,169,24336,34320
train,3015,8,6144,64,9216,15360
train,3016,18,13824,324,46656,60480
train,3017,8,6144,64,9216,15360
train,3018,19,14592,361,51984,66576
train,3019,4,3072,16,2304,5376
train,3020,23,17664,529,76176,93840
train,3021,22,16896,484,69696,86592
train,3022,7,5376,49,7056,12432
train,3023,17,13056,289,41616,54672
train,3024,21,16128,441,63504,79632
train,3025,33,25344,1089,156816,182160
train,3026,32,24576,1024,147456,172032
train,3027,8,6144,64,9216,15360
train,3028,25,19200,625,90000,109200
train,3029,41,31488,1681,242064,273552
train,3030,8,6144,64,9216,15360
train,3031,31,23808,961,138384,162192
train,3032,24,18432,576,82944,101376
train,3033,56,43008,3136,451584,494592
train,3034,35,26880,1225,176400,203280
train,3035,28,21504,784,112896,134400
train,3036,12,9216,144,20736,29952
train,3037,29,22272,841,121104,143376
train,3038,29,22272,841,121104,143376
train,3039,16,12288,256,36864,49152
train,3040,24,18432,576,82944,101376
train,3041,14,10752,196,28224,38976
train,3042,31,23808,961,138384,162192
train,3043,17,13056,289,41616,54672
train,3044,23,17664,529,76176,93840
train,3045,10,7680,100,14400,22080
train,3046,29,22272,841,121104,143376
train,3047,48,36864,2304,331776,368640
train,3048,16,12288,256,36864,49152
train,3049,19,14592,361,51984,66576
train,3050,16,12288,256,36864,49152
train,3051,40,30720,1600,230400,261120
train,3052,39,29952,1521,219024,248976
train,3053,53,40704,2809,404496,445200
train,3054,40,30720,1600,230400,261120
train,3055,34,26112,1156,166464,192576
train,3056,26,19968,676,97344,117312
train,3057,14,10752,196,28224,38976
train,3058,29,22272,841,121104,143376
train,3059,24,18432,576,82944,101376
train,3060,7,5376,49,7056,12432
train,3061,16,12288,256,36864,49152
train,3062,19,14592,361,51984,66576
train,3063,56,43008,3136,451584,494592
train,3064,23,17664,529,76176,93840
train,3065,39,29952,1521,219024,248976
train,3066,27,20736,729,104976,125712
train,3067,37,28416,1369,197136,225552
train,3068,26,19968,676,97344,117312
train,3069,29,22272,841,121104,143376
train,3070,35,26880,1225,176400,203280
train,3071,17,13056,289,41616,54672
train,3072,52,39936,2704,389376,429312
train,3073,12,9216,144,20736,29952
train,3074,33,25344,1089,156816,182160
train,3075,23,17664,529,76176,93840
train,3076,17,13056,289,41616,54672
train,3077,17,13056,289,41616,54672
train,3078,5,3840,25,3600,7440
train,3079,21,16128,441,63504,79632
train,3080,12,9216,144,20736,29952
train,3081,13,9984,169,24336,34320
train,3082,16,12288,256,36864,49152
train,3083,37,28416,1369,197136,225552
train,3084,16,12288,256,36864,49152
train,3085,16,12288,256,36864,49152
train,3086,15,11520,225,32400,43920
train,3087,24,18432,576,82944,101376
train,3088,35,26880,1225,176400,203280
train,3089,14,10752,196,28224,38976
train,3090,20,15360,400,57600,72960
train,3091,30,23040,900,129600,152640
train,3092,57,43776,3249,467856,511632
train,3093,18,13824,324,46656,60480
train,3094,19,14592,361,51984,66576
train,3095,9,6912,81,11664,18576
train,3096,11,8448,121,17424,25872
train,3097,32,24576,1024,147456,172032
train,3098,39,29952,1521,219024,248976
train,3099,21,16128,441,63504,79632
train,3100,10,7680,100,14400,22080
train,3101,31,23808,961,138384,162192
train,3102,39,29952,1521,219024,248976
train,3103,46,35328,2116,304704,340032
train,3104,36,27648,1296,186624,214272
train,3105,26,19968,676,97344,117312
train,3106,26,19968,676,97344,117312
train,3107,33,25344,1089,156816,182160
train,3108,11,8448,121,17424,25872
train,3109,12,9216,144,20736,29952
train,3110,29,22272,841,121104,143376
train,3111,40,30720,1600,230400,261120
train,3112,21,16128,441,63504,79632
train,3113,17,13056,289,41616,54672
train,3114,20,15360,400,57600,72960
train,3115,27,20736,729,104976,125712
train,3116,23,17664,529,76176,93840
train,3117,44,33792,1936,278784,312576
train,3118,25,19200,625,90000,109200
train,3119,12,9216,144,20736,29952
train,3120,5,3840,25,3600,7440
train,3121,24,18432,576,82944,101376
train,3122,36,27648,1296,186624,214272
train,3123,8,6144,64,9216,15360
train,3124,41,31488,1681,242064,273552
train,3125,20,15360,400,57600,72960
train,3126,18,13824,324,46656,60480
train,3127,28,21504,784,112896,134400
train,3128,30,23040,900,129600,152640
train,3129,33,25344,1089,156816,182160
train,3130,31,23808,961,138384,162192
train,3131,22,16896,484,69696,86592
train,3132,53,40704,2809,404496,445200
train,3133,18,13824,324,46656,60480
train,3134,28,21504,784,112896,134400
train,3135,29,22272,841,121104,143376
train,3136,19,14592,361,51984,66576
train,3137,38,29184,1444,207936,237120
train,3138,24,18432,576,82944,101376
train,3139,21,16128,441,63504,79632
train,3140,53,40704,2809,404496,445200
train,3141,34,26112,1156,166464,192576
train,3142,28,21504,784,112896,134400
train,3143,19,14592,361,51984,66576
train,3144,38,29184,1444,207936,237120
train,3145,40,30720,1600,230400,261120
train,3146,19,14592,361,51984,66576
train,3147,32,24576,1024,147456,172032
train,3148,7,5376,49,7056,12432
train,3149,38,29184,1444,207936,237120
train,3150,15,11520,225,32400,43920
train,3151,14,10752,196,28224,38976
train,3152,21,16128,441,63504,79632
train,3153,21,16128,441,63504,79632
train,3154,20,15360,400,57600,72960
train,3155,24,18432,576,82944,101376
train,3156,43,33024,1849,266256,299280
train,3157,25,19200,625,90000,109200
train,3158,31,23808,961,138384,162192
train,3159,23,17664,529,76176,93840
train,3160,38,29184,1444,207936,237120
train,3161,31,23808,961,138384,162192
train,3162,14,10752,196,28224,38976
train,3163,13,9984,169,24336,34320
train,3164,26,19968,676,97344,117312
train,3165,11,8448,121,17424,25872
train,3166,46,35328,2116,304704,340032
train,3167,27,20736,729,104976,125712
train,3168,28,21504,784,112896,134400
train,3169,24,18432,576,82944,101376
train,3170,47,36096,2209,318096,354192
train,3171,18,13824,324,46656,60480
train,3172,14,10752,196,28224,38976
train,3173,29,22272,841,121104,143376
train,3174,14,10752,196,28224,38976
train,3175,13,9984,169,24336,34320
train,3176,27,20736,729,104976,125712
train,3177,63,48384,3969,571536,619920
train,3178,36,27648,1296,186624,214272
train,3179,18,13824,324,46656,60480
train,3180,27,20736,729,104976,125712
train,3181,19,14592,361,51984,66576
train,3182,26,19968,676,97344,117312
train,3183,36,27648,1296,186624,214272
train,3184,16,12288,256,36864,49152
train,3185,19,14592,361,51984,66576
train,3186,33,25344,1089,156816,182160
train,3187,25,19200,625,90000,109200
train,3188,8,6144,64,9216,15360
train,3189,31,23808,961,138384,162192
train,3190,22,16896,484,69696,86592
train,3191,30,23040,900,129600,152640
train,3192,18,13824,324,46656,60480
train,3193,19,14592,361,51984,66576
train,3194,37,28416,1369,197136,225552
train,3195,8,6144,64,9216,15360
train,3196,16,12288,256,36864,49152
train,3197,17,13056,289,41616,54672
train,3198,30,23040,900,129600,152640
train,3199,12,9216,144,20736,29952
train,3200,28,21504,784,112896,134400
train,3201,11,8448,121,17424,25872
train,3202,31,23808,961,138384,162192
train,3203,15,11520,225,32400,43920
train,3204,58,44544,3364,484416,528960
train,3205,14,10752,196,28224,38976
train,3206,20,15360,400,57600,72960
train,3207,41,31488,1681,242064,273552
train,3208,26,19968,676,97344,117312
train,3209,7,5376,49,7056,12432
train,3210,47,36096,2209,318096,354192
train,3211,29,22272,841,121104,143376
train,3212,9,6912,81,11664,18576
train,3213,15,11520,225,32400,43920
train,3214,30,23040,900,129600,152640
train,3215,28,21504,784,112896,134400
train,3216,22,16896,484,69696,86592
train,3217,29,22272,841,121104,143376
train,3218,27,20736,729,104976,125712
train,3219,19,14592,361,51984,66576
train,3220,13,9984,169,24336,34320
train,3221,25,19200,625,90000,109200
train,3222,6,4608,36,5184,9792
train,3223,45,34560,2025,291600,326160
train,3224,10,7680,100,14400,22080
train,3225,43,33024,1849,266256,299280
train,3226,12,9216,144,20736,29952
train,3227,23,17664,529,76176,93840
train,3228,23,17664,529,76176,93840
train,3229,23,17664,529,76176,93840
train,3230,23,17664,529,76176,93840
train,3231,9,6912,81,11664,18576
train,3232,23,17664,529,76176,93840
train,3233,14,10752,196,28224,38976
train,3234,19,14592,361,51984,66576
train,3235,17,13056,289,41616,54672
train,3236,17,13056,289,41616,54672
train,3237,34,26112,1156,166464,192576
train,3238,10,7680,100,14400,22080
train,3239,32,24576,1024,147456,172032
train,3240,12,9216,144,20736,29952
train,3241,12,9216,144,20736,29952
train,3242,19,14592,361,51984,66576
train,3243,27,20736,729,104976,125712
train,3244,23,17664,529,76176,93840
train,3245,13,9984,169,24336,34320
train,3246,34,26112,1156,166464,192576
train,3247,24,18432,576,82944,101376
train,3248,18,13824,324,46656,60480
train,3249,21,16128,441,63504,79632
train,3250,19,14592,361,51984,66576
train,3251,38,29184,1444,207936,237120
train,3252,8,6144,64,9216,15360
train,3253,48,36864,2304,331776,368640
train,3254,44,33792,1936,278784,312576
train,3255,46,35328,2116,304704,340032
train,3256,35,26880,1225,176400,203280
train,3257,36,27648,1296,186624,214272
train,3258,17,13056,289,41616,54672
train,3259,40,30720,1600,230400,261120
train,3260,36,27648,1296,186624,214272
train,3261,20,15360,400,57600,72960
train,3262,39,29952,1521,219024,248976
train,3263,22,16896,484,69696,86592
train,3264,23,17664,529,76176,93840
train,3265,21,16128,441,63504,79632
train,3266,32,24576,1024,147456,172032
train,3267,16,12288,256,36864,49152
train,3268,24,18432,576,82944,101376
train,3269,38,29184,1444,207936,237120
train,3270,30,23040,900,129600,152640
train,3271,28,21504,784,112896,134400
train,3272,17,13056,289,41616,54672
train,3273,16,12288,256,36864,49152
train,3274,21,16128,441,63504,79632
train,3275,19,14592,361,51984,66576
train,3276,6,4608,36,5184,9792
train,3277,50,38400,2500,360000,398400
train,3278,34,26112,1156,166464,192576
train,3279,41,31488,1681,242064,273552
train,3280,28,21504,784,112896,134400
train,3281,24,18432,576,82944,101376
train,3282,10,7680,100,14400,22080
train,3283,33,25344,1089,156816,182160
train,3284,10,7680,100,14400,22080
train,3285,17,13056,289,41616,54672
train,3286,17,13056,289,41616,54672
train,3287,23,17664,529,76176,93840
train,3288,19,14592,361,51984,66576
train,3289,29,22272,841,121104,143376
train,3290,18,13824,324,46656,60480
train,3291,42,32256,1764,254016,286272
train,3292,32,24576,1024,147456,172032
train,3293,9,6912,81,11664,18576
train,3294,20,15360,400,57600,72960
train,3295,54,41472,2916,419904,461376
train,3296,7,5376,49,7056,12432
train,3297,18,13824,324,46656,60480
train,3298,15,11520,225,32400,43920
train,3299,11,8448,121,17424,25872
train,3300,58,44544,3364,484416,528960
train,3301,26,19968,676,97344,117312
train,3302,19,14592,361,51984,66576
train,3303,23,17664,529,76176,93840
train,3304,23,17664,529,76176,93840
train,3305,32,24576,1024,147456,172032
train,3306,21,16128,441,63504,79632
train,3307,30,23040,900,129600,152640
train,3308,7,5376,49,7056,12432
train,3309,10,7680,100,14400,22080
train,3310,9,6912,81,11664,18576
train,3311,13,9984,169,24336,34320
train,3312,9,6912,81,11664,18576
train,3313,38,29184,1444,207936,237120
train,3314,12,9216,144,20736,29952
train,3315,6,4608,36,5184,9792
train,3316,19,14592,361,51984,66576
train,3317,37,28416,1369,197136,225552
train,3318,14,10752,196,28224,38976
train,3319,33,25344,1089,156816,182160
train,3320,32,24576,1024,147456,172032
train,3321,27,20736,729,104976,125712
train,3322,32,24576,1024,147456,172032
train,3323,15,11520,225,32400,43920
train,3324,28,21504,784,112896,134400
train,3325,21,16128,441,63504,79632
train,3326,28,21504,784,112896,134400
train,3327,52,39936,2704,389376,429312
train,3328,38,29184,1444,207936,237120
train,3329,20,15360,400,57600,72960
train,3330,15,11520,225,32400,43920
train,3331,14,10752,196,28224,38976
train,3332,30,23040,900,129600,152640
train,3333,24,18432,576,82944,101376
train,3334,37,28416,1369,197136,225552
train,3335,26,19968,676,97344,117312
train,3336,28,21504,784,112896,134400
train,3337,28,21504,784,112896,134400
train,3338,35,26880,1225,176400,203280
train,3339,43,33024,1849,266256,299280
train,3340,23,17664,529,76176,93840
train,3341,16,12288,256,36864,49152
train,3342,25,19200,625,90000,109200
train,3343,23,17664,529,76176,93840
train,3344,17,13056,289,41616,54672
train,3345,19,14592,361,51984,66576
train,3346,13,9984,169,24336,34320
train,3347,22,16896,484,69696,86592
train,3348,12,9216,144,20736,29952
train,3349,42,32256,1764,254016,286272
train,3350,6,4608,36,5184,9792
train,3351,38,29184,1444,207936,237120
train,3352,8,6144,64,9216,15360
train,3353,52,39936,2704,389376,429312
train,3354,16,12288,256,36864,49152
train,3355,19,14592,361,51984,66576
train,3356,22,16896,484,69696,86592
train,3357,20,15360,400,57600,72960
train,3358,41,31488,1681,242064,273552
train,3359,13,9984,169,24336,34320
train,3360,23,17664,529,76176,93840
train,3361,26,19968,676,97344,117312
train,3362,9,6912,81,11664,18576
train,3363,44,33792,1936,278784,312576
train,3364,22,16896,484,69696,86592
train,3365,19,14592,361,51984,66576
train,3366,6,4608,36,5184,9792
train,3367,19,14592,361,51984,66576
train,3368,39,29952,1521,219024,248976
train,3369,34,26112,1156,166464,192576
train,3370,15,11520,225,32400,43920
train,3371,57,43776,3249,467856,511632
train,3372,15,11520,225,32400,43920
train,3373,38,29184,1444,207936,237120
train,3374,23,17664,529,76176,93840
train,3375,32,24576,1024,147456,172032
train,3376,43,33024,1849,266256,299280
train,3377,10,7680,100,14400,22080
train,3378,44,33792,1936,278784,312576
train,3379,32,24576,1024,147456,172032
train,3380,17,13056,289,41616,54672
train,3381,10,7680,100,14400,22080
train,3382,23,17664,529,76176,93840
train,3383,29,22272,841,121104,143376
train,3384,30,23040,900,129600,152640
train,3385,38,29184,1444,207936,237120
train,3386,8,6144,64,9216,15360
train,3387,26,19968,676,97344,117312
train,3388,26,19968,676,97344,117312
train,3389,24,18432,576,82944,101376
train,3390,20,15360,400,57600,72960
train,3391,39,29952,1521,219024,248976
train,3392,21,16128,441,63504,79632
train,3393,20,15360,400,57600,72960
train,3394,17,13056,289,41616,54672
train,3395,23,17664,529,76176,93840
train,3396,22,16896,484,69696,86592
train,3397,44,33792,1936,278784,312576
train,3398,22,16896,484,69696,86592
train,3399,32,24576,1024,147456,172032
train,3400,23,17664,529,76176,93840
train,3401,20,15360,400,57600,72960
train,3402,21,16128,441,63504,79632
train,3403,37,28416,1369,197136,225552
train,3404,24,18432,576,82944,101376
train,3405,23,17664,529,76176,93840
train,3406,5,3840,25,3600,7440
train,3407,10,7680,100,14400,22080
train,3408,29,22272,841,121104,143376
train,3409,26,19968,676,97344,117312
train,3410,34,26112,1156,166464,192576
train,3411,49,37632,2401,345744,383376
train,3412,16,12288,256,36864,49152
train,3413,14,10752,196,28224,38976
train,3414,45,34560,2025,291600,326160
train,3415,24,18432,576,82944,101376
train,3416,21,16128,441,63504,79632
train,3417,46,35328,2116,304704,340032
train,3418,40,30720,1600,230400,261120
train,3419,9,6912,81,11664,18576
train,3420,29,22272,841,121104,143376
train,3421,6,4608,36,5184,9792
train,3422,33,25344,1089,156816,182160
train,3423,40,30720,1600,230400,261120
train,3424,45,34560,2025,291600,326160
train,3425,28,21504,784,112896,134400
train,3426,36,27648,1296,186624,214272
train,3427,15,11520,225,32400,43920
train,3428,19,14592,361,51984,66576
train,3429,8,6144,64,9216,15360
train,3430,24,18432,576,82944,101376
train,3431,6,4608,36,5184,9792
train,3432,34,26112,1156,166464,192576
train,3433,37,28416,1369,197136,225552
train,3434,18,13824,324,46656,60480
train,3435,18,13824,324,46656,60480
train,3436,30,23040,900,129600,152640
train,3437,33,25344,1089,156816,182160
train,3438,20,15360,400,57600,72960
train,3439,9,6912,81,11664,18576
train,3440,20,15360,400,57600,72960
train,3441,35,26880,1225,176400,203280
train,3442,21,16128,441,63504,79632
train,3443,21,16128,441,63504,79632
train,3444,16,12288,256,36864,49152
train,3445,25,19200,625,90000,109200
train,3446,24,18432,576,82944,101376
train,3447,42,32256,1764,254016,286272
train,3448,29,22272,841,121104,143376
train,3449,4,3072,16,2304,5376
train,3450,18,13824,324,46656,60480
train,3451,43,33024,1849,266256,299280
train,3452,21,16128,441,63504,79632
train,3453,11,8448,121,17424,25872
train,3454,34,26112,1156,166464,192576
train,3455,32,24576,1024,147456,172032
train,3456,12,9216,144,20736,29952
train,3457,18,13824,324,46656,60480
train,3458,10,7680,100,14400,22080
train,3459,39,29952,1521,219024,248976
train,3460,46,35328,2116,304704,340032
train,3461,30,23040,900,129600,152640
train,3462,29,22272,841,121104,143376
train,3463,19,14592,361,51984,66576
train,3464,15,11520,225,32400,43920
train,3465,40,30720,1600,230400,261120
train,3466,32,24576,1024,147456,172032
train,3467,33,25344,1089,156816,182160
train,3468,19,14592,361,51984,66576
train,3469,16,12288,256,36864,49152
train,3470,15,11520,225,32400,43920
train,3471,25,19200,625,90000,109200
train,3472,36,27648,1296,186624,214272
train,3473,8,6144,64,9216,15360
train,3474,41,31488,1681,242064,273552
train,3475,14,10752,196,28224,38976
train,3476,12,9216,144,20736,29952
train,3477,31,23808,961,138384,162192
train,3478,34,26112,1156,166464,192576
train,3479,23,17664,529,76176,93840
train,3480,12,9216,144,20736,29952
train,3481,42,32256,1764,254016,286272
train,3482,29,22272,841,121104,143376
train,3483,34,26112,1156,166464,192576
train,3484,20,15360,400,57600,72960
train,3485,34,26112,1156,166464,192576
train,3486,34,26112,1156,166464,192576
train,3487,19,14592,361,51984,66576
train,3488,38,29184,1444,207936,237120
train,3489,17,13056,289,41616,54672
train,3490,41,31488,1681,242064,273552
train,3491,41,31488,1681,242064,273552
train,3492,10,7680,100,14400,22080
train,3493,44,33792,1936,278784,312576
train,3494,16,12288,256,36864,49152
train,3495,7,5376,49,7056,12432
train,3496,15,11520,225,32400,43920
train,3497,26,19968,676,97344,117312
train,3498,21,16128,441,63504,79632
train,3499,20,15360,400,57600,72960
train,3500,22,16896,484,69696,86592
train,3501,26,19968,676,97344,117312
train,3502,19,14592,361,51984,66576
train,3503,33,25344,1089,156816,182160
train,3504,40,30720,1600,230400,261120
train,3505,22,16896,484,69696,86592
train,3506,28,21504,784,112896,134400
train,3507,45,34560,2025,291600,326160
train,3508,11,8448,121,17424,25872
train,3509,18,13824,324,46656,60480
train,3510,21,16128,441,63504,79632
train,3511,21,16128,441,63504,79632
train,3512,30,23040,900,129600,152640
train,3513,24,18432,576,82944,101376
train,3514,32,24576,1024,147456,172032
train,3515,10,7680,100,14400,22080
train,3516,36,27648,1296,186624,214272
train,3517,33,25344,1089,156816,182160
train,3518,10,7680,100,14400,22080
train,3519,11,8448,121,17424,25872
train,3520,18,13824,324,46656,60480
train,3521,26,19968,676,97344,117312
train,3522,11,8448,121,17424,25872
train,3523,11,8448,121,17424,25872
train,3524,14,10752,196,28224,38976
train,3525,23,17664,529,76176,93840
train,3526,33,25344,1089,156816,182160
train,3527,10,7680,100,14400,22080
train,3528,10,7680,100,14400,22080
train,3529,30,23040,900,129600,152640
train,3530,23,17664,529,76176,93840
train,3531,8,6144,64,9216,15360
train,3532,24,18432,576,82944,101376
train,3533,20,15360,400,57600,72960
train,3534,9,6912,81,11664,18576
train,3535,8,6144,64,9216,15360
train,3536,25,19200,625,90000,109200
train,3537,25,19200,625,90000,109200
train,3538,31,23808,961,138384,162192
train,3539,18,13824,324,46656,60480
train,3540,51,39168,2601,374544,413712
train,3541,24,18432,576,82944,101376
train,3542,21,16128,441,63504,79632
train,3543,36,27648,1296,186624,214272
train,3544,9,6912,81,11664,18576
train,3545,25,19200,625,90000,109200
train,3546,16,12288,256,36864,49152
train,3547,7,5376,49,7056,12432
train,3548,25,19200,625,90000,109200
train,3549,19,14592,361,51984,66576
train,3550,40,30720,1600,230400,261120
train,3551,28,21504,784,112896,134400
train,3552,15,11520,225,32400,43920
train,3553,30,23040,900,129600,152640
train,3554,35,26880,1225,176400,203280
train,3555,39,29952,1521,219024,248976
train,3556,16,12288,256,36864,49152
train,3557,27,20736,729,104976,125712
train,3558,21,16128,441,63504,79632
train,3559,8,6144,64,9216,15360
train,3560,30,23040,900,129600,152640
train,3561,12,9216,144,20736,29952
train,3562,24,18432,576,82944,101376
train,3563,35,26880,1225,176400,203280
train,3564,24,18432,576,82944,101376
train,3565,27,20736,729,104976,125712
train,3566,25,19200,625,90000,109200
train,3567,20,15360,400,57600,72960
train,3568,8,6144,64,9216,15360
train,3569,33,25344,1089,156816,182160
train,3570,25,19200,625,90000,109200
train,3571,19,14592,361,51984,66576
train,3572,17,13056,289,41616,54672
train,3573,32,24576,1024,147456,172032
train,3574,14,10752,196,28224,38976
train,3575,27,20736,729,104976,125712
train,3576,38,29184,1444,207936,237120
train,3577,31,23808,961,138384,162192
train,3578,10,7680,100,14400,22080
train,3579,16,12288,256,36864,49152
train,3580,29,22272,841,121104,143376
train,3581,20,15360,400,57600,72960
train,3582,25,19200,625,90000,109200
train,3583,10,7680,100,14400,22080
train,3584,20,15360,400,57600,72960
train,3585,16,12288,256,36864,49152
train,3586,23,17664,529,76176,93840
train,3587,16,12288,256,36864,49152
train,3588,27,20736,729,104976,125712
train,3589,21,16128,441,63504,79632
train,3590,12,9216,144,20736,29952
train,3591,8,6144,64,9216,15360
train,3592,46,35328,2116,304704,340032
train,3593,40,30720,1600,230400,261120
train,3594,37,28416,1369,197136,225552
train,3595,21,16128,441,63504,79632
train,3596,18,13824,324,46656,60480
train,3597,18,13824,324,46656,60480
train,3598,32,24576,1024,147456,172032
train,3599,10,7680,100,14400,22080
train,3600,25,19200,625,90000,109200
train,3601,26,19968,676,97344,117312
train,3602,12,9216,144,20736,29952
train,3603,33,25344,1089,156816,182160
train,3604,52,39936,2704,389376,429312
train,3605,17,13056,289,41616,54672
train,3606,44,33792,1936,278784,312576
train,3607,57,43776,3249,467856,511632
train,3608,22,16896,484,69696,86592
train,3609,12,9216,144,20736,29952
train,3610,21,16128,441,63504,79632
train,3611,21,16128,441,63504,79632
train,3612,28,21504,784,112896,134400
train,3613,35,26880,1225,176400,203280
train,3614,36,27648,1296,186624,214272
train,3615,25,19200,625,90000,109200
train,3616,25,19200,625,90000,109200
train,3617,26,19968,676,97344,117312
train,3618,32,24576,1024,147456,172032
train,3619,42,32256,1764,254016,286272
train,3620,28,21504,784,112896,134400
train,3621,17,13056,289,41616,54672
train,3622,32,24576,1024,147456,172032
train,3623,32,24576,1024,147456,172032
train,3624,15,11520,225,32400,43920
train,3625,17,13056,289,41616,54672
train,3626,22,16896,484,69696,86592
train,3627,38,29184,1444,207936,237120
train,3628,29,22272,841,121104,143376
train,3629,24,18432,576,82944,101376
train,3630,13,9984,169,24336,34320
train,3631,13,9984,169,24336,34320
train,3632,14,10752,196,28224,38976
train,3633,11,8448,121,17424,25872
train,3634,24,18432,576,82944,101376
train,3635,15,11520,225,32400,43920
train,3636,23,17664,529,76176,93840
train,3637,41,31488,1681,242064,273552
train,3638,21,16128,441,63504,79632
train,3639,28,21504,784,112896,134400
train,3640,15,11520,225,32400,43920
train,3641,33,25344,1089,156816,182160
train,3642,33,25344,1089,156816,182160
train,3643,30,23040,900,129600,152640
train,3644,36,27648,1296,186624,214272
train,3645,9,6912,81,11664,18576
train,3646,18,13824,324,46656,60480
train,3647,40,30720,1600,230400,261120
train,3648,12,9216,144,20736,29952
train,3649,23,17664,529,76176,93840
train,3650,10,7680,100,14400,22080
train,3651,22,16896,484,69696,86592
train,3652,26,19968,676,97344,117312
train,3653,34,26112,1156,166464,192576
train,3654,12,9216,144,20736,29952
train,3655,23,17664,529,76176,93840
train,3656,29,22272,841,121104,143376
train,3657,26,19968,676,97344,117312
train,3658,36,27648,1296,186624,214272
train,3659,28,21504,784,112896,134400
train,3660,24,18432,576,82944,101376
train,3661,5,3840,25,3600,7440
train,3662,34,26112,1156,166464,192576
train,3663,23,17664,529,76176,93840
train,3664,14,10752,196,28224,38976
train,3665,20,15360,400,57600,72960
train,3666,29,22272,841,121104,143376
train,3667,48,36864,2304,331776,368640
train,3668,26,19968,676,97344,117312
train,3669,24,18432,576,82944,101376
train,3670,24,18432,576,82944,101376
train,3671,20,15360,400,57600,72960
train,3672,33,25344,1089,156816,182160
train,3673,34,26112,1156,166464,192576
train,3674,45,34560,2025,291600,326160
train,3675,22,16896,484,69696,86592
train,3676,29,22272,841,121104,143376
train,3677,8,6144,64,9216,15360
train,3678,9,6912,81,11664,18576
train,3679,16,12288,256,36864,49152
train,3680,36,27648,1296,186624,214272
train,3681,19,14592,361,51984,66576
train,3682,12,9216,144,20736,29952
train,3683,16,12288,256,36864,49152
train,3684,26,19968,676,97344,117312
train,3685,26,19968,676,97344,117312
train,3686,12,9216,144,20736,29952
train,3687,30,23040,900,129600,152640
train,3688,38,29184,1444,207936,237120
train,3689,22,16896,484,69696,86592
train,3690,31,23808,961,138384,162192
train,3691,37,28416,1369,197136,225552
train,3692,18,13824,324,46656,60480
train,3693,49,37632,2401,345744,383376
train,3694,16,12288,256,36864,49152
train,3695,27,20736,729,104976,125712
train,3696,34,26112,1156,166464,192576
train,3697,31,23808,961,138384,162192
train,3698,15,11520,225,32400,43920
train,3699,21,16128,441,63504,79632
train,3700,21,16128,441,63504,79632
train,3701,32,24576,1024,147456,172032
train,3702,41,31488,1681,242064,273552
train,3703,43,33024,1849,266256,299280
train,3704,21,16128,441,63504,79632
train,3705,40,30720,1600,230400,261120
train,3706,19,14592,361,51984,66576
train,3707,34,26112,1156,166464,192576
train,3708,16,12288,256,36864,49152
train,3709,37,28416,1369,197136,225552
train,3710,36,27648,1296,186624,214272
train,3711,21,16128,441,63504,79632
train,3712,16,12288,256,36864,49152
train,3713,41,31488,1681,242064,273552
train,3714,29,22272,841,121104,143376
train,3715,32,24576,1024,147456,172032
train,3716,20,15360,400,57600,72960
train,3717,56,43008,3136,451584,494592
train,3718,26,19968,676,97344,117312
train,3719,20,15360,400,57600,72960
train,3720,25,19200,625,90000,109200
train,3721,27,20736,729,104976,125712
train,3722,17,13056,289,41616,54672
train,3723,19,14592,361,51984,66576
train,3724,23,17664,529,76176,93840
train,3725,40,30720,1600,230400,261120
train,3726,33,25344,1089,156816,182160
train,3727,6,4608,36,5184,9792
train,3728,11,8448,121,17424,25872
train,3729,20,15360,400,57600,72960
train,3730,55,42240,3025,435600,477840
train,3731,23,17664,529,76176,93840
train,3732,22,16896,484,69696,86592
train,3733,24,18432,576,82944,101376
train,3734,36,27648,1296,186624,214272
train,3735,21,16128,441,63504,79632
train,3736,53,40704,2809,404496,445200
train,3737,26,19968,676,97344,117312
train,3738,27,20736,729,104976,125712
train,3739,24,18432,576,82944,101376
train,3740,22,16896,484,69696,86592
train,3741,33,25344,1089,156816,182160
train,3742,32,24576,1024,147456,172032
train,3743,33,25344,1089,156816,182160
train,3744,49,37632,2401,345744,383376
train,3745,25,19200,625,90000,109200
train,3746,28,21504,784,112896,134400
train,3747,44,33792,1936,278784,312576
train,3748,11,8448,121,17424,25872
train,3749,28,21504,784,112896,134400
train,3750,12,9216,144,20736,29952
train,3751,36,27648,1296,186624,214272
train,3752,41,31488,1681,242064,273552
train,3753,19,14592,361,51984,66576
train,3754,26,19968,676,97344,117312
train,3755,22,16896,484,69696,86592
train,3756,21,16128,441,63504,79632
train,3757,10,7680,100,14400,22080
train,3758,11,8448,121,17424,25872
train,3759,52,39936,2704,389376,429312
train,3760,15,11520,225,32400,43920
train,3761,23,17664,529,76176,93840
train,3762,11,8448,121,17424,25872
train,3763,27,20736,729,104976,125712
train,3764,11,8448,121,17424,25872
train,3765,38,29184,1444,207936,237120
train,3766,36,27648,1296,186624,214272
train,3767,33,25344,1089,156816,182160
train,3768,22,16896,484,69696,86592
train,3769,28,21504,784,112896,134400
train,3770,12,9216,144,20736,29952
train,3771,19,14592,361,51984,66576
train,3772,33,25344,1089,156816,182160
train,3773,13,9984,169,24336,34320
train,3774,14,10752,196,28224,38976
train,3775,38,29184,1444,207936,237120
train,3776,26,19968,676,97344,117312
train,3777,55,42240,3025,435600,477840
train,3778,59,45312,3481,501264,546576
train,3779,29,22272,841,121104,143376
train,3780,29,22272,841,121104,143376
train,3781,35,26880,1225,176400,203280
train,3782,35,26880,1225,176400,203280
train,3783,28,21504,784,112896,134400
train,3784,49,37632,2401,345744,383376
train,3785,14,10752,196,28224,38976
train,3786,19,14592,361,51984,66576
train,3787,19,14592,361,51984,66576
train,3788,35,26880,1225,176400,203280
train,3789,47,36096,2209,318096,354192
train,3790,19,14592,361,51984,66576
train,3791,23,17664,529,76176,93840
train,3792,15,11520,225,32400,43920
train,3793,45,34560,2025,291600,326160
train,3794,32,24576,1024,147456,172032
train,3795,40,30720,1600,230400,261120
train,3796,26,19968,676,97344,117312
train,3797,10,7680,100,14400,22080
train,3798,18,13824,324,46656,60480
train,3799,38,29184,1444,207936,237120
train,3800,18,13824,324,46656,60480
train,3801,22,16896,484,69696,86592
train,3802,20,15360,400,57600,72960
train,3803,57,43776,3249,467856,511632
train,3804,24,18432,576,82944,101376
train,3805,6,4608,36,5184,9792
train,3806,23,17664,529,76176,93840
train,3807,15,11520,225,32400,43920
train,3808,14,10752,196,28224,38976
train,3809,22,16896,484,69696,86592
train,3810,30,23040,900,129600,152640
train,3811,47,36096,2209,318096,354192
train,3812,23,17664,529,76176,93840
train,3813,18,13824,324,46656,60480
train,3814,20,15360,400,57600,72960
train,3815,45,34560,2025,291600,326160
train,3816,36,27648,1296,186624,214272
train,3817,11,8448,121,17424,25872
train,3818,11,8448,121,17424,25872
train,3819,40,30720,1600,230400,261120
train,3820,29,22272,841,121104,143376
train,3821,18,13824,324,46656,60480
train,3822,16,12288,256,36864,49152
train,3823,30,23040,900,129600,152640
train,3824,24,18432,576,82944,101376
train,3825,24,18432,576,82944,101376
train,3826,20,15360,400,57600,72960
train,3827,28,21504,784,112896,134400
train,3828,24,18432,576,82944,101376
train,3829,32,24576,1024,147456,172032
train,3830,19,14592,361,51984,66576
train,3831,13,9984,169,24336,34320
train,3832,18,13824,324,46656,60480
train,3833,41,31488,1681,242064,273552
train,3834,19,14592,361,51984,66576
train,3835,6,4608,36,5184,9792
train,3836,15,11520,225,32400,43920
train,3837,15,11520,225,32400,43920
train,3838,54,41472,2916,419904,461376
train,3839,23,17664,529,76176,93840
train,3840,29,22272,841,121104,143376
train,3841,35,26880,1225,176400,203280
train,3842,31,23808,961,138384,162192
train,3843,27,20736,729,104976,125712
train,3844,47,36096,2209,318096,354192
train,3845,12,9216,144,20736,29952
train,3846,31,23808,961,138384,162192
train,3847,24,18432,576,82944,101376
train,3848,62,47616,3844,553536,601152
train,3849,14,10752,196,28224,38976
train,3850,28,21504,784,112896,134400
train,3851,25,19200,625,90000,109200
train,3852,25,19200,625,90000,109200
train,3853,29,22272,841,121104,143376
train,3854,13,9984,169,24336,34320
train,3855,14,10752,196,28224,38976
train,3856,27,20736,729,104976,125712
train,3857,33,25344,1089,156816,182160
train,3858,25,19200,625,90000,109200
train,3859,16,12288,256,36864,49152
train,3860,26,19968,676,97344,117312
train,3861,45,34560,2025,291600,326160
train,3862,29,22272,841,121104,143376
train,3863,37,28416,1369,197136,225552
train,3864,17,13056,289,41616,54672
train,3865,26,19968,676,97344,117312
train,3866,41,31488,1681,242064,273552
train,3867,42,32256,1764,254016,286272
train,3868,31,23808,961,138384,162192
train,3869,19,14592,361,51984,66576
train,3870,38,29184,1444,207936,237120
train,3871,22,16896,484,69696,86592
train,3872,14,10752,196,28224,38976
train,3873,5,3840,25,3600,7440
train,3874,8,6144,64,9216,15360
train,3875,10,7680,100,14400,22080
train,3876,20,15360,400,57600,72960
train,3877,25,19200,625,90000,109200
train,3878,12,9216,144,20736,29952
train,3879,29,22272,841,121104,143376
train,3880,9,6912,81,11664,18576
train,3881,16,12288,256,36864,49152
train,3882,5,3840,25,3600,7440
train,3883,24,18432,576,82944,101376
train,3884,42,32256,1764,254016,286272
train,3885,31,23808,961,138384,162192
train,3886,19,14592,361,51984,66576
train,3887,39,29952,1521,219024,248976
train,3888,36,27648,1296,186624,214272
train,3889,21,16128,441,63504,79632
train,3890,22,16896,484,69696,86592
train,3891,14,10752,196,28224,38976
train,3892,21,16128,441,63504,79632
train,3893,8,6144,64,9216,15360
train,3894,22,16896,484,69696,86592
train,3895,40,30720,1600,230400,261120
train,3896,53,40704,2809,404496,445200
train,3897,13,9984,169,24336,34320
train,3898,31,23808,961,138384,162192
train,3899,23,17664,529,76176,93840
train,3900,7,5376,49,7056,12432
train,3901,27,20736,729,104976,125712
train,3902,24,18432,576,82944,101376
train,3903,19,14592,361,51984,66576
train,3904,23,17664,529,76176,93840
train,3905,12,9216,144,20736,29952
train,3906,26,19968,676,97344,117312
train,3907,11,8448,121,17424,25872
train,3908,30,23040,900,129600,152640
train,3909,8,6144,64,9216,15360
train,3910,22,16896,484,69696,86592
train,3911,15,11520,225,32400,43920
train,3912,30,23040,900,129600,152640
train,3913,8,6144,64,9216,15360
train,3914,21,16128,441,63504,79632
train,3915,30,23040,900,129600,152640
train,3916,13,9984,169,24336,34320
train,3917,34,26112,1156,166464,192576
train,3918,15,11520,225,32400,43920
train,3919,32,24576,1024,147456,172032
train,3920,9,6912,81,11664,18576
train,3921,35,26880,1225,176400,203280
train,3922,17,13056,289,41616,54672
train,3923,37,28416,1369,197136,225552
train,3924,21,16128,441,63504,79632
train,3925,37,28416,1369,197136,225552
train,3926,43,33024,1849,266256,299280
train,3927,15,11520,225,32400,43920
train,3928,23,17664,529,76176,93840
train,3929,12,9216,144,20736,29952
train,3930,33,25344,1089,156816,182160
train,3931,32,24576,1024,147456,172032
train,3932,9,6912,81,11664,18576
train,3933,21,16128,441,63504,79632
train,3934,32,24576,1024,147456,172032
train,3935,31,23808,961,138384,162192
train,3936,32,24576,1024,147456,172032
train,3937,34,26112,1156,166464,192576
train,3938,19,14592,361,51984,66576
train,3939,13,9984,169,24336,34320
train,3940,36,27648,1296,186624,214272
train,3941,35,26880,1225,176400,203280
train,3942,23,17664,529,76176,93840
train,3943,15,11520,225,32400,43920
train,3944,37,28416,1369,197136,225552
train,3945,26,19968,676,97344,117312
train,3946,29,22272,841,121104,143376
train,3947,11,8448,121,17424,25872
train,3948,11,8448,121,17424,25872
train,3949,47,36096,2209,318096,354192
train,3950,35,26880,1225,176400,203280
train,3951,21,16128,441,63504,79632
train,3952,24,18432,576,82944,101376
train,3953,15,11520,225,32400,43920
train,3954,24,18432,576,82944,101376
train,3955,16,12288,256,36864,49152
train,3956,20,15360,400,57600,72960
train,3957,30,23040,900,129600,152640
train,3958,44,33792,1936,278784,312576
train,3959,23,17664,529,76176,93840
train,3960,29,22272,841,121104,143376
train,3961,15,11520,225,32400,43920
train,3962,22,16896,484,69696,86592
train,3963,9,6912,81,11664,18576
train,3964,36,27648,1296,186624,214272
train,3965,23,17664,529,76176,93840
train,3966,39,29952,1521,219024,248976
train,3967,27,20736,729,104976,125712
train,3968,16,12288,256,36864,49152
train,3969,13,9984,169,24336,34320
train,3970,41,31488,1681,242064,273552
train,3971,13,9984,169,24336,34320
train,3972,33,25344,1089,156816,182160
train,3973,17,13056,289,41616,54672
train,3974,32,24576,1024,147456,172032
train,3975,23,17664,529,76176,93840
train,3976,50,38400,2500,360000,398400
train,3977,37,28416,1369,197136,225552
train,3978,31,23808,961,138384,162192
train,3979,10,7680,100,14400,22080
train,3980,26,19968,676,97344,117312
train,3981,16,12288,256,36864,49152
train,3982,35,26880,1225,176400,203280
train,3983,44,33792,1936,278784,312576
train,3984,33,25344,1089,156816,182160
train,3985,20,15360,400,57600,72960
train,3986,40,30720,1600,230400,261120
train,3987,25,19200,625,90000,109200
train,3988,39,29952,1521,219024,248976
train,3989,22,16896,484,69696,86592
train,3990,35,26880,1225,176400,203280
train,3991,30,23040,900,129600,152640
train,3992,39,29952,1521,219024,248976
train,3993,23,17664,529,76176,93840
train,3994,25,19200,625,90000,109200
train,3995,34,26112,1156,166464,192576
train,3996,46,35328,2116,304704,340032
train,3997,19,14592,361,51984,66576
train,3998,26,19968,676,97344,117312
train,3999,33,25344,1089,156816,182160
train,4000,14,10752,196,28224,38976
train,4001,25,19200,625,90000,109200
train,4002,36,27648,1296,186624,214272
train,4003,33,25344,1089,156816,182160
train,4004,16,12288,256,36864,49152
train,4005,11,8448,121,17424,25872
train,4006,26,19968,676,97344,117312
train,4007,27,20736,729,104976,125712
train,4008,34,26112,1156,166464,192576
train,4009,22,16896,484,69696,86592
train,4010,26,19968,676,97344,117312
train,4011,12,9216,144,20736,29952
train,4012,7,5376,49,7056,12432
train,4013,28,21504,784,112896,134400
train,4014,32,24576,1024,147456,172032
train,4015,35,26880,1225,176400,203280
train,4016,29,22272,841,121104,143376
train,4017,13,9984,169,24336,34320
train,4018,15,11520,225,32400,43920
train,4019,37,28416,1369,197136,225552
train,4020,44,33792,1936,278784,312576
train,4021,40,30720,1600,230400,261120
train,4022,38,29184,1444,207936,237120
train,4023,23,17664,529,76176,93840
train,4024,41,31488,1681,242064,273552
train,4025,37,28416,1369,197136,225552
train,4026,37,28416,1369,197136,225552
train,4027,23,17664,529,76176,93840
train,4028,27,20736,729,104976,125712
train,4029,45,34560,2025,291600,326160
train,4030,15,11520,225,32400,43920
train,4031,4,3072,16,2304,5376
train,4032,15,11520,225,32400,43920
train,4033,10,7680,100,14400,22080
train,4034,59,45312,3481,501264,546576
train,4035,21,16128,441,63504,79632
train,4036,39,29952,1521,219024,248976
train,4037,21,16128,441,63504,79632
train,4038,29,22272,841,121104,143376
train,4039,33,25344,1089,156816,182160
train,4040,23,17664,529,76176,93840
train,4041,34,26112,1156,166464,192576
train,4042,7,5376,49,7056,12432
train,4043,29,22272,841,121104,143376
train,4044,23,17664,529,76176,93840
train,4045,16,12288,256,36864,49152
train,4046,21,16128,441,63504,79632
train,4047,7,5376,49,7056,12432
train,4048,10,7680,100,14400,22080
train,4049,30,23040,900,129600,152640
train,4050,23,17664,529,76176,93840
train,4051,26,19968,676,97344,117312
train,4052,9,6912,81,11664,18576
train,4053,18,13824,324,46656,60480
train,4054,28,21504,784,112896,134400
train,4055,25,19200,625,90000,109200
train,4056,11,8448,121,17424,25872
train,4057,34,26112,1156,166464,192576
train,4058,23,17664,529,76176,93840
train,4059,27,20736,729,104976,125712
train,4060,9,6912,81,11664,18576
train,4061,34,26112,1156,166464,192576
train,4062,29,22272,841,121104,143376
train,4063,13,9984,169,24336,34320
train,4064,23,17664,529,76176,93840
train,4065,28,21504,784,112896,134400
train,4066,13,9984,169,24336,34320
train,4067,9,6912,81,11664,18576
train,4068,53,40704,2809,404496,445200
train,4069,11,8448,121,17424,25872
train,4070,13,9984,169,24336,34320
train,4071,7,5376,49,7056,12432
train,4072,22,16896,484,69696,86592
train,4073,15,11520,225,32400,43920
train,4074,30,23040,900,129600,152640
train,4075,12,9216,144,20736,29952
train,4076,32,24576,1024,147456,172032
train,4077,40,30720,1600,230400,261120
train,4078,14,10752,196,28224,38976
train,4079,23,17664,529,76176,93840
train,4080,17,13056,289,41616,54672
train,4081,35,26880,1225,176400,203280
train,4082,37,28416,1369,197136,225552
train,4083,27,20736,729,104976,125712
train,4084,22,16896,484,69696,86592
train,4085,57,43776,3249,467856,511632
train,4086,38,29184,1444,207936,237120
train,4087,29,22272,841,121104,143376
train,4088,32,24576,1024,147456,172032
train,4089,12,9216,144,20736,29952
train,4090,14,10752,196,28224,38976
train,4091,25,19200,625,90000,109200
train,4092,23,17664,529,76176,93840
train,4093,11,8448,121,17424,25872
train,4094,35,26880,1225,176400,203280
train,4095,29,22272,841,121104,143376
train,4096,10,7680,100,14400,22080
train,4097,15,11520,225,32400,43920
train,4098,32,24576,1024,147456,172032
train,4099,50,38400,2500,360000,398400
train,4100,37,28416,1369,197136,225552
train,4101,42,32256,1764,254016,286272
train,4102,5,3840,25,3600,7440
train,4103,26,19968,676,97344,117312
train,4104,40,30720,1600,230400,261120
train,4105,18,13824,324,46656,60480
train,4106,4,3072,16,2304,5376
train,4107,23,17664,529,76176,93840
train,4108,17,13056,289,41616,54672
train,4109,53,40704,2809,404496,445200
train,4110,28,21504,784,112896,134400
train,4111,38,29184,1444,207936,237120
train,4112,30,23040,900,129600,152640
train,4113,32,24576,1024,147456,172032
train,4114,11,8448,121,17424,25872
train,4115,19,14592,361,51984,66576
train,4116,34,26112,1156,166464,192576
train,4117,14,10752,196,28224,38976
train,4118,44,33792,1936,278784,312576
train,4119,29,22272,841,121104,143376
train,4120,14,10752,196,28224,38976
train,4121,27,20736,729,104976,125712
train,4122,43,33024,1849,266256,299280
train,4123,22,16896,484,69696,86592
train,4124,23,17664,529,76176,93840
train,4125,41,31488,1681,242064,273552
train,4126,16,12288,256,36864,49152
train,4127,11,8448,121,17424,25872
train,4128,33,25344,1089,156816,182160
train,4129,46,35328,2116,304704,340032
train,4130,44,33792,1936,278784,312576
train,4131,30,23040,900,129600,152640
train,4132,14,10752,196,28224,38976
train,4133,23,17664,529,76176,93840
train,4134,28,21504,784,112896,134400
train,4135,16,12288,256,36864,49152
train,4136,32,24576,1024,147456,172032
train,4137,38,29184,1444,207936,237120
train,4138,28,21504,784,112896,134400
train,4139,43,33024,1849,266256,299280
train,4140,13,9984,169,24336,34320
train,4141,21,16128,441,63504,79632
train,4142,36,27648,1296,186624,214272
train,4143,44,33792,1936,278784,312576
train,4144,11,8448,121,17424,25872
train,4145,42,32256,1764,254016,286272
train,4146,13,9984,169,24336,34320
train,4147,48,36864,2304,331776,368640
train,4148,33,25344,1089,156816,182160
train,4149,12,9216,144,20736,29952
train,4150,30,23040,900,129600,152640
train,4151,29,22272,841,121104,143376
train,4152,34,26112,1156,166464,192576
train,4153,34,26112,1156,166464,192576
train,4154,42,32256,1764,254016,286272
train,4155,28,21504,784,112896,134400
train,4156,20,15360,400,57600,72960
train,4157,8,6144,64,9216,15360
train,4158,11,8448,121,17424,25872
train,4159,19,14592,361,51984,66576
train,4160,14,10752,196,28224,38976
train,4161,27,20736,729,104976,125712
train,4162,19,14592,361,51984,66576
train,4163,49,37632,2401,345744,383376
train,4164,26,19968,676,97344,117312
train,4165,15,11520,225,32400,43920
train,4166,16,12288,256,36864,49152
train,4167,21,16128,441,63504,79632
train,4168,26,19968,676,97344,117312
train,4169,32,24576,1024,147456,172032
train,4170,35,26880,1225,176400,203280
train,4171,19,14592,361,51984,66576
train,4172,40,30720,1600,230400,261120
train,4173,31,23808,961,138384,162192
train,4174,33,25344,1089,156816,182160
train,4175,30,23040,900,129600,152640
train,4176,41,31488,1681,242064,273552
train,4177,19,14592,361,51984,66576
train,4178,31,23808,961,138384,162192
train,4179,26,19968,676,97344,117312
train,4180,24,18432,576,82944,101376
train,4181,33,25344,1089,156816,182160
train,4182,22,16896,484,69696,86592
train,4183,18,13824,324,46656,60480
train,4184,14,10752,196,28224,38976
train,4185,36,27648,1296,186624,214272
train,4186,34,26112,1156,166464,192576
train,4187,17,13056,289,41616,54672
train,4188,20,15360,400,57600,72960
train,4189,46,35328,2116,304704,340032
train,4190,39,29952,1521,219024,248976
train,4191,28,21504,784,112896,134400
train,4192,25,19200,625,90000,109200
train,4193,35,26880,1225,176400,203280
train,4194,38,29184,1444,207936,237120
train,4195,16,12288,256,36864,49152
train,4196,24,18432,576,82944,101376
train,4197,37,28416,1369,197136,225552
train,4198,50,38400,2500,360000,398400
train,4199,20,15360,400,57600,72960
train,4200,13,9984,169,24336,34320
train,4201,23,17664,529,76176,93840
train,4202,18,13824,324,46656,60480
train,4203,29,22272,841,121104,143376
train,4204,37,28416,1369,197136,225552
train,4205,13,9984,169,24336,34320
train,4206,18,13824,324,46656,60480
train,4207,34,26112,1156,166464,192576
train,4208,52,39936,2704,389376,429312
train,4209,16,12288,256,36864,49152
train,4210,47,36096,2209,318096,354192
train,4211,12,9216,144,20736,29952
train,4212,36,27648,1296,186624,214272
train,4213,21,16128,441,63504,79632
train,4214,33,25344,1089,156816,182160
train,4215,14,10752,196,28224,38976
train,4216,30,23040,900,129600,152640
train,4217,37,28416,1369,197136,225552
train,4218,10,7680,100,14400,22080
train,4219,41,31488,1681,242064,273552
train,4220,31,23808,961,138384,162192
train,4221,10,7680,100,14400,22080
train,4222,28,21504,784,112896,134400
train,4223,44,33792,1936,278784,312576
train,4224,23,17664,529,76176,93840
train,4225,12,9216,144,20736,29952
train,4226,49,37632,2401,345744,383376
train,4227,13,9984,169,24336,34320
train,4228,19,14592,361,51984,66576
train,4229,37,28416,1369,197136,225552
train,4230,30,23040,900,129600,152640
train,4231,25,19200,625,90000,109200
train,4232,18,13824,324,46656,60480
train,4233,17,13056,289,41616,54672
train,4234,20,15360,400,57600,72960
train,4235,39,29952,1521,219024,248976
train,4236,22,16896,484,69696,86592
train,4237,16,12288,256,36864,49152
train,4238,27,20736,729,104976,125712
train,4239,40,30720,1600,230400,261120
train,4240,20,15360,400,57600,72960
train,4241,8,6144,64,9216,15360
train,4242,15,11520,225,32400,43920
train,4243,20,15360,400,57600,72960
train,4244,25,19200,625,90000,109200
train,4245,6,4608,36,5184,9792
train,4246,29,22272,841,121104,143376
train,4247,32,24576,1024,147456,172032
train,4248,9,6912,81,11664,18576
train,4249,20,15360,400,57600,72960
train,4250,29,22272,841,121104,143376
train,4251,18,13824,324,46656,60480
train,4252,29,22272,841,121104,143376
train,4253,18,13824,324,46656,60480
train,4254,9,6912,81,11664,18576
train,4255,13,9984,169,24336,34320
train,4256,27,20736,729,104976,125712
train,4257,22,16896,484,69696,86592
train,4258,31,23808,961,138384,162192
train,4259,38,29184,1444,207936,237120
train,4260,10,7680,100,14400,22080
train,4261,15,11520,225,32400,43920
train,4262,11,8448,121,17424,25872
train,4263,17,13056,289,41616,54672
train,4264,11,8448,121,17424,25872
train,4265,19,14592,361,51984,66576
train,4266,20,15360,400,57600,72960
train,4267,11,8448,121,17424,25872
train,4268,21,16128,441,63504,79632
train,4269,27,20736,729,104976,125712
train,4270,25,19200,625,90000,109200
train,4271,44,33792,1936,278784,312576
train,4272,16,12288,256,36864,49152
train,4273,25,19200,625,90000,109200
train,4274,22,16896,484,69696,86592
train,4275,12,9216,144,20736,29952
train,4276,33,25344,1089,156816,182160
train,4277,17,13056,289,41616,54672
train,4278,51,39168,2601,374544,413712
train,4279,22,16896,484,69696,86592
train,4280,16,12288,256,36864,49152
train,4281,27,20736,729,104976,125712
train,4282,5,3840,25,3600,7440
train,4283,34,26112,1156,166464,192576
train,4284,20,15360,400,57600,72960
train,4285,22,16896,484,69696,86592
train,4286,21,16128,441,63504,79632
train,4287,34,26112,1156,166464,192576
train,4288,20,15360,400,57600,72960
train,4289,16,12288,256,36864,49152
train,4290,28,21504,784,112896,134400
train,4291,11,8448,121,17424,25872
train,4292,5,3840,25,3600,7440
train,4293,32,24576,1024,147456,172032
train,4294,37,28416,1369,197136,225552
train,4295,8,6144,64,9216,15360
train,4296,20,15360,400,57600,72960
train,4297,13,9984,169,24336,34320
train,4298,32,24576,1024,147456,172032
train,4299,20,15360,400,57600,72960
train,4300,4,3072,16,2304,5376
train,4301,26,19968,676,97344,117312
train,4302,47,36096,2209,318096,354192
train,4303,27,20736,729,104976,125712
train,4304,16,12288,256,36864,49152
train,4305,28,21504,784,112896,134400
train,4306,49,37632,2401,345744,383376
train,4307,7,5376,49,7056,12432
train,4308,15,11520,225,32400,43920
train,4309,48,36864,2304,331776,368640
train,4310,28,21504,784,112896,134400
train,4311,34,26112,1156,166464,192576
train,4312,35,26880,1225,176400,203280
train,4313,19,14592,361,51984,66576
train,4314,30,23040,900,129600,152640
train,4315,32,24576,1024,147456,172032
train,4316,18,13824,324,46656,60480
train,4317,16,12288,256,36864,49152
train,4318,18,13824,324,46656,60480
train,4319,27,20736,729,104976,125712
train,4320,41,31488,1681,242064,273552
train,4321,17,13056,289,41616,54672
train,4322,6,4608,36,5184,9792
train,4323,19,14592,361,51984,66576
train,4324,19,14592,361,51984,66576
train,4325,10,7680,100,14400,22080
train,4326,13,9984,169,24336,34320
train,4327,18,13824,324,46656,60480
train,4328,44,33792,1936,278784,312576
train,4329,30,23040,900,129600,152640
train,4330,10,7680,100,14400,22080
train,4331,24,18432,576,82944,101376
train,4332,44,33792,1936,278784,312576
train,4333,34,26112,1156,166464,192576
train,4334,10,7680,100,14400,22080
train,4335,21,16128,441,63504,79632
train,4336,8,6144,64,9216,15360
train,4337,43,33024,1849,266256,299280
train,4338,41,31488,1681,242064,273552
train,4339,39,29952,1521,219024,248976
train,4340,13,9984,169,24336,34320
train,4341,21,16128,441,63504,79632
train,4342,29,22272,841,121104,143376
train,4343,12,9216,144,20736,29952
train,4344,35,26880,1225,176400,203280
train,4345,11,8448,121,17424,25872
train,4346,34,26112,1156,166464,192576
train,4347,24,18432,576,82944,101376
train,4348,53,40704,2809,404496,445200
train,4349,20,15360,400,57600,72960
train,4350,41,31488,1681,242064,273552
train,4351,29,22272,841,121104,143376
train,4352,22,16896,484,69696,86592
train,4353,36,27648,1296,186624,214272
train,4354,53,40704,2809,404496,445200
train,4355,17,13056,289,41616,54672
train,4356,16,12288,256,36864,49152
train,4357,35,26880,1225,176400,203280
train,4358,23,17664,529,76176,93840
train,4359,29,22272,841,121104,143376
train,4360,34,26112,1156,166464,192576
train,4361,10,7680,100,14400,22080
train,4362,18,13824,324,46656,60480
train,4363,35,26880,1225,176400,203280
train,4364,27,20736,729,104976,125712
train,4365,16,12288,256,36864,49152
train,4366,28,21504,784,112896,134400
train,4367,11,8448,121,17424,25872
train,4368,43,33024,1849,266256,299280
train,4369,19,14592,361,51984,66576
train,4370,4,3072,16,2304,5376
train,4371,20,15360,400,57600,72960
train,4372,13,9984,169,24336,34320
train,4373,36,27648,1296,186624,214272
train,4374,15,11520,225,32400,43920
train,4375,35,26880,1225,176400,203280
train,4376,31,23808,961,138384,162192
train,4377,33,25344,1089,156816,182160
train,4378,31,23808,961,138384,162192
train,4379,9,6912,81,11664,18576
train,4380,28,21504,784,112896,134400
train,4381,9,6912,81,11664,18576
train,4382,17,13056,289,41616,54672
train,4383,15,11520,225,32400,43920
train,4384,24,18432,576,82944,101376
train,4385,26,19968,676,97344,117312
train,4386,28,21504,784,112896,134400
train,4387,33,25344,1089,156816,182160
train,4388,10,7680,100,14400,22080
train,4389,20,15360,400,57600,72960
train,4390,30,23040,900,129600,152640
train,4391,47,36096,2209,318096,354192
train,4392,42,32256,1764,254016,286272
train,4393,27,20736,729,104976,125712
train,4394,28,21504,784,112896,134400
train,4395,15,11520,225,32400,43920
train,4396,17,13056,289,41616,54672
train,4397,22,16896,484,69696,86592
train,4398,34,26112,1156,166464,192576
train,4399,41,31488,1681,242064,273552
train,4400,32,24576,1024,147456,172032
train,4401,17,13056,289,41616,54672
train,4402,15,11520,225,32400,43920
train,4403,6,4608,36,5184,9792
train,4404,38,29184,1444,207936,237120
train,4405,14,10752,196,28224,38976
train,4406,34,26112,1156,166464,192576
train,4407,16,12288,256,36864,49152
train,4408,35,26880,1225,176400,203280
train,4409,20,15360,400,57600,72960
train,4410,23,17664,529,76176,93840
train,4411,20,15360,400,57600,72960
train,4412,28,21504,784,112896,134400
train,4413,22,16896,484,69696,86592
train,4414,19,14592,361,51984,66576
train,4415,39,29952,1521,219024,248976
train,4416,18,13824,324,46656,60480
train,4417,31,23808,961,138384,162192
train,4418,11,8448,121,17424,25872
train,4419,11,8448,121,17424,25872
train,4420,58,44544,3364,484416,528960
train,4421,48,36864,2304,331776,368640
train,4422,38,29184,1444,207936,237120
train,4423,30,23040,900,129600,152640
train,4424,12,9216,144,20736,29952
train,4425,18,13824,324,46656,60480
train,4426,29,22272,841,121104,143376
train,4427,15,11520,225,32400,43920
train,4428,17,13056,289,41616,54672
train,4429,22,16896,484,69696,86592
train,4430,16,12288,256,36864,49152
train,4431,29,22272,841,121104,143376
train,4432,33,25344,1089,156816,182160
train,4433,26,19968,676,97344,117312
train,4434,16,12288,256,36864,49152
train,4435,20,15360,400,57600,72960
train,4436,14,10752,196,28224,38976
train,4437,33,25344,1089,156816,182160
train,4438,28,21504,784,112896,134400
train,4439,22,16896,484,69696,86592
train,4440,65,49920,4225,608400,658320
train,4441,21,16128,441,63504,79632
train,4442,21,16128,441,63504,79632
train,4443,36,27648,1296,186624,214272
train,4444,25,19200,625,90000,109200
train,4445,35,26880,1225,176400,203280
train,4446,25,19200,625,90000,109200
train,4447,26,19968,676,97344,117312
train,4448,11,8448,121,17424,25872
train,4449,48,36864,2304,331776,368640
train,4450,18,13824,324,46656,60480
train,4451,30,23040,900,129600,152640
train,4452,27,20736,729,104976,125712
train,4453,25,19200,625,90000,109200
train,4454,16,12288,256,36864,49152
train,4455,55,42240,3025,435600,477840
train,4456,27,20736,729,104976,125712
train,4457,24,18432,576,82944,101376
train,4458,29,22272,841,121104,143376
train,4459,26,19968,676,97344,117312
train,4460,21,16128,441,63504,79632
train,4461,59,45312,3481,501264,546576
train,4462,22,16896,484,69696,86592
train,4463,28,21504,784,112896,134400
train,4464,15,11520,225,32400,43920
train,4465,10,7680,100,14400,22080
train,4466,32,24576,1024,147456,172032
train,4467,35,26880,1225,176400,203280
train,4468,19,14592,361,51984,66576
train,4469,28,21504,784,112896,134400
train,4470,27,20736,729,104976,125712
train,4471,26,19968,676,97344,117312
train,4472,16,12288,256,36864,49152
train,4473,26,19968,676,97344,117312
train,4474,11,8448,121,17424,25872
train,4475,20,15360,400,57600,72960
train,4476,32,24576,1024,147456,172032
train,4477,12,9216,144,20736,29952
train,4478,32,24576,1024,147456,172032
train,4479,22,16896,484,69696,86592
train,4480,12,9216,144,20736,29952
train,4481,16,12288,256,36864,49152
train,4482,36,27648,1296,186624,214272
train,4483,14,10752,196,28224,38976
train,4484,13,9984,169,24336,34320
train,4485,27,20736,729,104976,125712
train,4486,25,19200,625,90000,109200
train,4487,35,26880,1225,176400,203280
train,4488,19,14592,361,51984,66576
train,4489,28,21504,784,112896,134400
train,4490,33,25344,1089,156816,182160
train,4491,14,10752,196,28224,38976
train,4492,26,19968,676,97344,117312
train,4493,19,14592,361,51984,66576
train,4494,9,6912,81,11664,18576
train,4495,26,19968,676,97344,117312
train,4496,24,18432,576,82944,101376
train,4497,23,17664,529,76176,93840
train,4498,39,29952,1521,219024,248976
train,4499,27,20736,729,104976,125712
train,4500,18,13824,324,46656,60480
train,4501,27,20736,729,104976,125712
train,4502,6,4608,36,5184,9792
train,4503,44,33792,1936,278784,312576
train,4504,11,8448,121,17424,25872
train,4505,31,23808,961,138384,162192
train,4506,7,5376,49,7056,12432
train,4507,17,13056,289,41616,54672
train,4508,17,13056,289,41616,54672
train,4509,20,15360,400,57600,72960
train,4510,8,6144,64,9216,15360
train,4511,35,26880,1225,176400,203280
train,4512,44,33792,1936,278784,312576
train,4513,20,15360,400,57600,72960
train,4514,27,20736,729,104976,125712
train,4515,10,7680,100,14400,22080
train,4516,9,6912,81,11664,18576
train,4517,19,14592,361,51984,66576
train,4518,13,9984,169,24336,34320
train,4519,35,26880,1225,176400,203280
train,4520,45,34560,2025,291600,326160
train,4521,33,25344,1089,156816,182160
train,4522,22,16896,484,69696,86592
train,4523,32,24576,1024,147456,172032
train,4524,30,23040,900,129600,152640
train,4525,21,16128,441,63504,79632
train,4526,25,19200,625,90000,109200
train,4527,22,16896,484,69696,86592
train,4528,46,35328,2116,304704,340032
train,4529,12,9216,144,20736,29952
train,4530,25,19200,625,90000,109200
train,4531,19,14592,361,51984,66576
train,4532,37,28416,1369,197136,225552
train,4533,21,16128,441,63504,79632
train,4534,41,31488,1681,242064,273552
train,4535,9,6912,81,11664,18576
train,4536,7,5376,49,7056,12432
train,4537,13,9984,169,24336,34320
train,4538,18,13824,324,46656,60480
train,4539,27,20736,729,104976,125712
train,4540,22,16896,484,69696,86592
train,4541,30,23040,900,129600,152640
train,4542,54,41472,2916,419904,461376
train,4543,25,19200,625,90000,109200
train,4544,28,21504,784,112896,134400
train,4545,16,12288,256,36864,49152
train,4546,29,22272,841,121104,143376
train,4547,31,23808,961,138384,162192
train,4548,29,22272,841,121104,143376
train,4549,25,19200,625,90000,109200
train,4550,22,16896,484,69696,86592
train,4551,43,33024,1849,266256,299280
train,4552,19,14592,361,51984,66576
train,4553,30,23040,900,129600,152640
train,4554,22,16896,484,69696,86592
train,4555,42,32256,1764,254016,286272
train,4556,27,20736,729,104976,125712
train,4557,30,23040,900,129600,152640
train,4558,41,31488,1681,242064,273552
train,4559,17,13056,289,41616,54672
train,4560,37,28416,1369,197136,225552
train,4561,21,16128,441,63504,79632
train,4562,37,28416,1369,197136,225552
train,4563,5,3840,25,3600,7440
train,4564,43,33024,1849,266256,299280
train,4565,9,6912,81,11664,18576
train,4566,35,26880,1225,176400,203280
train,4567,28,21504,784,112896,134400
train,4568,23,17664,529,76176,93840
train,4569,28,21504,784,112896,134400
train,4570,30,23040,900,129600,152640
train,4571,16,12288,256,36864,49152
train,4572,20,15360,400,57600,72960
train,4573,22,16896,484,69696,86592
train,4574,31,23808,961,138384,162192
train,4575,36,27648,1296,186624,214272
train,4576,27,20736,729,104976,125712
train,4577,36,27648,1296,186624,214272
train,4578,44,33792,1936,278784,312576
train,4579,29,22272,841,121104,143376
train,4580,17,13056,289,41616,54672
train,4581,35,26880,1225,176400,203280
train,4582,24,18432,576,82944,101376
train,4583,19,14592,361,51984,66576
train,4584,26,19968,676,97344,117312
train,4585,30,23040,900,129600,152640
train,4586,13,9984,169,24336,34320
train,4587,35,26880,1225,176400,203280
train,4588,44,33792,1936,278784,312576
train,4589,34,26112,1156,166464,192576
train,4590,26,19968,676,97344,117312
train,4591,10,7680,100,14400,22080
train,4592,11,8448,121,17424,25872
train,4593,31,23808,961,138384,162192
train,4594,27,20736,729,104976,125712
train,4595,22,16896,484,69696,86592
train,4596,13,9984,169,24336,34320
train,4597,22,16896,484,69696,86592
train,4598,6,4608,36,5184,9792
train,4599,12,9216,144,20736,29952
train,4600,39,29952,1521,219024,248976
train,4601,7,5376,49,7056,12432
train,4602,40,30720,1600,230400,261120
train,4603,15,11520,225,32400,43920
train,4604,21,16128,441,63504,79632
train,4605,13,9984,169,24336,34320
train,4606,25,19200,625,90000,109200
train,4607,38,29184,1444,207936,237120
train,4608,41,31488,1681,242064,273552
train,4609,4,3072,16,2304,5376
train,4610,26,19968,676,97344,117312
train,4611,10,7680,100,14400,22080
train,4612,23,17664,529,76176,93840
train,4613,38,29184,1444,207936,237120
train,4614,17,13056,289,41616,54672
train,4615,23,17664,529,76176,93840
train,4616,26,19968,676,97344,117312
train,4617,41,31488,1681,242064,273552
train,4618,25,19200,625,90000,109200
train,4619,31,23808,961,138384,162192
train,4620,33,25344,1089,156816,182160
train,4621,14,10752,196,28224,38976
train,4622,21,16128,441,63504,79632
train,4623,7,5376,49,7056,12432
train,4624,42,32256,1764,254016,286272
train,4625,33,25344,1089,156816,182160
train,4626,24,18432,576,82944,101376
train,4627,21,16128,441,63504,79632
train,4628,38,29184,1444,207936,237120
train,4629,44,33792,1936,278784,312576
train,4630,21,16128,441,63504,79632
train,4631,33,25344,1089,156816,182160
train,4632,46,35328,2116,304704,340032
train,4633,27,20736,729,104976,125712
train,4634,24,18432,576,82944,101376
train,4635,17,13056,289,41616,54672
train,4636,31,23808,961,138384,162192
train,4637,15,11520,225,32400,43920
train,4638,10,7680,100,14400,22080
train,4639,37,28416,1369,197136,225552
train,4640,8,6144,64,9216,15360
train,4641,25,19200,625,90000,109200
train,4642,8,6144,64,9216,15360
train,4643,25,19200,625,90000,109200
train,4644,11,8448,121,17424,25872
train,4645,27,20736,729,104976,125712
train,4646,18,13824,324,46656,60480
train,4647,14,10752,196,28224,38976
train,4648,24,18432,576,82944,101376
train,4649,23,17664,529,76176,93840
train,4650,22,16896,484,69696,86592
train,4651,34,26112,1156,166464,192576
train,4652,46,35328,2116,304704,340032
train,4653,9,6912,81,11664,18576
train,4654,14,10752,196,28224,38976
train,4655,38,29184,1444,207936,237120
train,4656,28,21504,784,112896,134400
train,4657,12,9216,144,20736,29952
train,4658,32,24576,1024,147456,172032
train,4659,18,13824,324,46656,60480
train,4660,25,19200,625,90000,109200
train,4661,19,14592,361,51984,66576
train,4662,19,14592,361,51984,66576
train,4663,24,18432,576,82944,101376
train,4664,39,29952,1521,219024,248976
train,4665,28,21504,784,112896,134400
train,4666,18,13824,324,46656,60480
train,4667,15,11520,225,32400,43920
train,4668,27,20736,729,104976,125712
train,4669,43,33024,1849,266256,299280
train,4670,22,16896,484,69696,86592
train,4671,20,15360,400,57600,72960
train,4672,22,16896,484,69696,86592
train,4673,31,23808,961,138384,162192
train,4674,11,8448,121,17424,25872
train,4675,33,25344,1089,156816,182160
train,4676,6,4608,36,5184,9792
train,4677,37,28416,1369,197136,225552
train,4678,13,9984,169,24336,34320
train,4679,50,38400,2500,360000,398400
train,4680,27,20736,729,104976,125712
train,4681,18,13824,324,46656,60480
train,4682,24,18432,576,82944,101376
train,4683,10,7680,100,14400,22080
train,4684,13,9984,169,24336,34320
train,4685,25,19200,625,90000,109200
train,4686,13,9984,169,24336,34320
train,4687,27,20736,729,104976,125712
train,4688,13,9984,169,24336,34320
train,4689,18,13824,324,46656,60480
train,4690,31,23808,961,138384,162192
train,4691,27,20736,729,104976,125712
train,4692,27,20736,729,104976,125712
train,4693,43,33024,1849,266256,299280
train,4694,23,17664,529,76176,93840
train,4695,25,19200,625,90000,109200
train,4696,26,19968,676,97344,117312
train,4697,41,31488,1681,242064,273552
train,4698,23,17664,529,76176,93840
train,4699,27,20736,729,104976,125712
train,4700,24,18432,576,82944,101376
train,4701,31,23808,961,138384,162192
train,4702,11,8448,121,17424,25872
train,4703,14,10752,196,28224,38976
train,4704,43,33024,1849,266256,299280
train,4705,22,16896,484,69696,86592
train,4706,24,18432,576,82944,101376
train,4707,42,32256,1764,254016,286272
train,4708,41,31488,1681,242064,273552
train,4709,21,16128,441,63504,79632
train,4710,13,9984,169,24336,34320
train,4711,25,19200,625,90000,109200
train,4712,27,20736,729,104976,125712
train,4713,16,12288,256,36864,49152
train,4714,24,18432,576,82944,101376
train,4715,34,26112,1156,166464,192576
train,4716,13,9984,169,24336,34320
train,4717,17,13056,289,41616,54672
train,4718,32,24576,1024,147456,172032
train,4719,23,17664,529,76176,93840
train,4720,46,35328,2116,304704,340032
train,4721,8,6144,64,9216,15360
train,4722,23,17664,529,76176,93840
train,4723,15,11520,225,32400,43920
train,4724,37,28416,1369,197136,225552
train,4725,39,29952,1521,219024,248976
train,4726,4,3072,16,2304,5376
train,4727,10,7680,100,14400,22080
train,4728,27,20736,729,104976,125712
train,4729,25,19200,625,90000,109200
train,4730,22,16896,484,69696,86592
train,4731,25,19200,625,90000,109200
train,4732,31,23808,961,138384,162192
train,4733,35,26880,1225,176400,203280
train,4734,21,16128,441,63504,79632
train,4735,15,11520,225,32400,43920
train,4736,12,9216,144,20736,29952
train,4737,33,25344,1089,156816,182160
train,4738,54,41472,2916,419904,461376
train,4739,42,32256,1764,254016,286272
train,4740,13,9984,169,24336,34320
train,4741,19,14592,361,51984,66576
train,4742,42,32256,1764,254016,286272
train,4743,30,23040,900,129600,152640
train,4744,27,20736,729,104976,125712
train,4745,22,16896,484,69696,86592
train,4746,21,16128,441,63504,79632
train,4747,52,39936,2704,389376,429312
train,4748,25,19200,625,90000,109200
train,4749,37,28416,1369,197136,225552
train,4750,48,36864,2304,331776,368640
train,4751,14,10752,196,28224,38976
train,4752,19,14592,361,51984,66576
train,4753,9,6912,81,11664,18576
train,4754,25,19200,625,90000,109200
train,4755,51,39168,2601,374544,413712
train,4756,27,20736,729,104976,125712
train,4757,44,33792,1936,278784,312576
train,4758,18,13824,324,46656,60480
train,4759,16,12288,256,36864,49152
train,4760,24,18432,576,82944,101376
train,4761,37,28416,1369,197136,225552
train,4762,16,12288,256,36864,49152
train,4763,17,13056,289,41616,54672
train,4764,26,19968,676,97344,117312
train,4765,39,29952,1521,219024,248976
train,4766,22,16896,484,69696,86592
train,4767,26,19968,676,97344,117312
train,4768,28,21504,784,112896,134400
train,4769,43,33024,1849,266256,299280
train,4770,19,14592,361,51984,66576
train,4771,17,13056,289,41616,54672
train,4772,11,8448,121,17424,25872
train,4773,49,37632,2401,345744,383376
train,4774,19,14592,361,51984,66576
train,4775,44,33792,1936,278784,312576
train,4776,40,30720,1600,230400,261120
train,4777,20,15360,400,57600,72960
train,4778,17,13056,289,41616,54672
train,4779,23,17664,529,76176,93840
train,4780,12,9216,144,20736,29952
train,4781,20,15360,400,57600,72960
train,4782,15,11520,225,32400,43920
train,4783,16,12288,256,36864,49152
train,4784,19,14592,361,51984,66576
train,4785,15,11520,225,32400,43920
train,4786,17,13056,289,41616,54672
train,4787,26,19968,676,97344,117312
train,4788,56,43008,3136,451584,494592
train,4789,28,21504,784,112896,134400
train,4790,30,23040,900,129600,152640
train,4791,34,26112,1156,166464,192576
train,4792,35,26880,1225,176400,203280
train,4793,27,20736,729,104976,125712
train,4794,41,31488,1681,242064,273552
train,4795,26,19968,676,97344,117312
train,4796,25,19200,625,90000,109200
train,4797,15,11520,225,32400,43920
train,4798,25,19200,625,90000,109200
train,4799,24,18432,576,82944,101376
train,4800,27,20736,729,104976,125712
train,4801,11,8448,121,17424,25872
train,4802,37,28416,1369,197136,225552
train,4803,7,5376,49,7056,12432
train,4804,8,6144,64,9216,15360
train,4805,18,13824,324,46656,60480
train,4806,35,26880,1225,176400,203280
train,4807,8,6144,64,9216,15360
train,4808,17,13056,289,41616,54672
train,4809,26,19968,676,97344,117312
train,4810,20,15360,400,57600,72960
train,4811,32,24576,1024,147456,172032
train,4812,43,33024,1849,266256,299280
train,4813,17,13056,289,41616,54672
train,4814,10,7680,100,14400,22080
train,4815,26,19968,676,97344,117312
train,4816,30,23040,900,129600,152640
train,4817,32,24576,1024,147456,172032
train,4818,32,24576,1024,147456,172032
train,4819,22,16896,484,69696,86592
train,4820,14,10752,196,28224,38976
train,4821,28,21504,784,112896,134400
train,4822,28,21504,784,112896,134400
train,4823,40,30720,1600,230400,261120
train,4824,14,10752,196,28224,38976
train,4825,37,28416,1369,197136,225552
train,4826,20,15360,400,57600,72960
train,4827,25,19200,625,90000,109200
train,4828,30,23040,900,129600,152640
train,4829,57,43776,3249,467856,511632
train,4830,22,16896,484,69696,86592
train,4831,31,23808,961,138384,162192
train,4832,38,29184,1444,207936,237120
train,4833,17,13056,289,41616,54672
train,4834,24,18432,576,82944,101376
train,4835,9,6912,81,11664,18576
train,4836,16,12288,256,36864,49152
train,4837,27,20736,729,104976,125712
train,4838,17,13056,289,41616,54672
train,4839,18,13824,324,46656,60480
train,4840,10,7680,100,14400,22080
train,4841,9,6912,81,11664,18576
train,4842,16,12288,256,36864,49152
train,4843,29,22272,841,121104,143376
train,4844,27,20736,729,104976,125712
train,4845,31,23808,961,138384,162192
train,4846,38,29184,1444,207936,237120
train,4847,22,16896,484,69696,86592
train,4848,30,23040,900,129600,152640
train,4849,15,11520,225,32400,43920
train,4850,38,29184,1444,207936,237120
train,4851,18,13824,324,46656,60480
train,4852,31,23808,961,138384,162192
train,4853,50,38400,2500,360000,398400
train,4854,28,21504,784,112896,134400
train,4855,20,15360,400,57600,72960
train,4856,35,26880,1225,176400,203280
train,4857,19,14592,361,51984,66576
train,4858,36,27648,1296,186624,214272
train,4859,13,9984,169,24336,34320
train,4860,16,12288,256,36864,49152
train,4861,18,13824,324,46656,60480
train,4862,30,23040,900,129600,152640
train,4863,19,14592,361,51984,66576
train,4864,20,15360,400,57600,72960
train,4865,28,21504,784,112896,134400
train,4866,11,8448,121,17424,25872
train,4867,40,30720,1600,230400,261120
train,4868,22,16896,484,69696,86592
train,4869,55,42240,3025,435600,477840
train,4870,34,26112,1156,166464,192576
train,4871,17,13056,289,41616,54672
train,4872,13,9984,169,24336,34320
train,4873,29,22272,841,121104,143376
train,4874,13,9984,169,24336,34320
train,4875,10,7680,100,14400,22080
train,4876,25,19200,625,90000,109200
train,4877,17,13056,289,41616,54672
train,4878,19,14592,361,51984,66576
train,4879,26,19968,676,97344,117312
train,4880,34,26112,1156,166464,192576
train,4881,30,23040,900,129600,152640
train,4882,22,16896,484,69696,86592
train,4883,50,38400,2500,360000,398400
train,4884,20,15360,400,57600,72960
train,4885,13,9984,169,24336,34320
train,4886,29,22272,841,121104,143376
train,4887,18,13824,324,46656,60480
train,4888,25,19200,625,90000,109200
train,4889,27,20736,729,104976,125712
train,4890,10,7680,100,14400,22080
train,4891,25,19200,625,90000,109200
train,4892,30,23040,900,129600,152640
train,4893,9,6912,81,11664,18576
train,4894,36,27648,1296,186624,214272
train,4895,35,26880,1225,176400,203280
train,4896,18,13824,324,46656,60480
train,4897,27,20736,729,104976,125712
train,4898,36,27648,1296,186624,214272
train,4899,44,33792,1936,278784,312576
train,4900,32,24576,1024,147456,172032
train,4901,22,16896,484,69696,86592
train,4902,22,16896,484,69696,86592
train,4903,18,13824,324,46656,60480
train,4904,15,11520,225,32400,43920
train,4905,13,9984,169,24336,34320
train,4906,30,23040,900,129600,152640
train,4907,18,13824,324,46656,60480
train,4908,34,26112,1156,166464,192576
train,4909,49,37632,2401,345744,383376
train,4910,29,22272,841,121104,143376
train,4911,24,18432,576,82944,101376
train,4912,38,29184,1444,207936,237120
train,4913,53,40704,2809,404496,445200
train,4914,6,4608,36,5184,9792
train,4915,32,24576,1024,147456,172032
train,4916,10,7680,100,14400,22080
train,4917,4,3072,16,2304,5376
train,4918,33,25344,1089,156816,182160
train,4919,28,21504,784,112896,134400
train,4920,61,46848,3721,535824,582672
train,4921,30,23040,900,129600,152640
train,4922,29,22272,841,121104,143376
train,4923,28,21504,784,112896,134400
train,4924,44,33792,1936,278784,312576
train,4925,18,13824,324,46656,60480
train,4926,11,8448,121,17424,25872
train,4927,40,30720,1600,230400,261120
train,4928,21,16128,441,63504,79632
train,4929,22,16896,484,69696,86592
train,4930,20,15360,400,57600,72960
train,4931,31,23808,961,138384,162192
train,4932,10,7680,100,14400,22080
train,4933,25,19200,625,90000,109200
train,4934,13,9984,169,24336,34320
train,4935,19,14592,361,51984,66576
train,4936,40,30720,1600,230400,261120
train,4937,4,3072,16,2304,5376
train,4938,14,10752,196,28224,38976
train,4939,25,19200,625,90000,109200
train,4940,23,17664,529,76176,93840
train,4941,37,28416,1369,197136,225552
train,4942,22,16896,484,69696,86592
train,4943,36,27648,1296,186624,214272
train,4944,22,16896,484,69696,86592
train,4945,23,17664,529,76176,93840
train,4946,27,20736,729,104976,125712
train,4947,22,16896,484,69696,86592
train,4948,23,17664,529,76176,93840
train,4949,19,14592,361,51984,66576
train,4950,31,23808,961,138384,162192
train,4951,12,9216,144,20736,29952
train,4952,17,13056,289,41616,54672
train,4953,20,15360,400,57600,72960
train,4954,22,16896,484,69696,86592
train,4955,15,11520,225,32400,43920
train,4956,30,23040,900,129600,152640
train,4957,25,19200,625,90000,109200
train,4958,28,21504,784,112896,134400
train,4959,9,6912,81,11664,18576
train,4960,11,8448,121,17424,25872
train,4961,12,9216,144,20736,29952
train,4962,25,19200,625,90000,109200
train,4963,32,24576,1024,147456,172032
train,4964,26,19968,676,97344,117312
train,4965,27,20736,729,104976,125712
train,4966,23,17664,529,76176,93840
train,4967,33,25344,1089,156816,182160
train,4968,28,21504,784,112896,134400
train,4969,27,20736,729,104976,125712
train,4970,44,33792,1936,278784,312576
train,4971,22,16896,484,69696,86592
train,4972,34,26112,1156,166464,192576
train,4973,36,27648,1296,186624,214272
train,4974,27,20736,729,104976,125712
train,4975,10,7680,100,14400,22080
train,4976,36,27648,1296,186624,214272
train,4977,18,13824,324,46656,60480
train,4978,24,18432,576,82944,101376
train,4979,24,18432,576,82944,101376
train,4980,32,24576,1024,147456,172032
train,4981,12,9216,144,20736,29952
train,4982,34,26112,1156,166464,192576
train,4983,9,6912,81,11664,18576
train,4984,18,13824,324,46656,60480
train,4985,22,16896,484,69696,86592
train,4986,22,16896,484,69696,86592
train,4987,31,23808,961,138384,162192
train,4988,35,26880,1225,176400,203280
train,4989,20,15360,400,57600,72960
train,4990,31,23808,961,138384,162192
train,4991,27,20736,729,104976,125712
train,4992,27,20736,729,104976,125712
train,4993,44,33792,1936,278784,312576
train,4994,20,15360,400,57600,72960
train,4995,32,24576,1024,147456,172032
train,4996,28,21504,784,112896,134400
train,4997,29,22272,841,121104,143376
train,4998,14,10752,196,28224,38976
train,4999,55,42240,3025,435600,477840
train,5000,43,33024,1849,266256,299280
train,5001,6,4608,36,5184,9792
train,5002,31,23808,961,138384,162192
train,5003,15,11520,225,32400,43920
train,5004,16,12288,256,36864,49152
train,5005,47,36096,2209,318096,354192
train,5006,8,6144,64,9216,15360
train,5007,6,4608,36,5184,9792
train,5008,30,23040,900,129600,152640
train,5009,15,11520,225,32400,43920
train,5010,32,24576,1024,147456,172032
train,5011,15,11520,225,32400,43920
train,5012,23,17664,529,76176,93840
train,5013,34,26112,1156,166464,192576
train,5014,17,13056,289,41616,54672
train,5015,23,17664,529,76176,93840
train,5016,11,8448,121,17424,25872
train,5017,8,6144,64,9216,15360
train,5018,20,15360,400,57600,72960
train,5019,37,28416,1369,197136,225552
train,5020,11,8448,121,17424,25872
train,5021,41,31488,1681,242064,273552
train,5022,31,23808,961,138384,162192
train,5023,29,22272,841,121104,143376
train,5024,18,13824,324,46656,60480
train,5025,18,13824,324,46656,60480
train,5026,33,25344,1089,156816,182160
train,5027,11,8448,121,17424,25872
train,5028,26,19968,676,97344,117312
train,5029,21,16128,441,63504,79632
train,5030,23,17664,529,76176,93840
train,5031,23,17664,529,76176,93840
train,5032,25,19200,625,90000,109200
train,5033,16,12288,256,36864,49152
train,5034,49,37632,2401,345744,383376
train,5035,35,26880,1225,176400,203280
train,5036,25,19200,625,90000,109200
train,5037,35,26880,1225,176400,203280
train,5038,15,11520,225,32400,43920
train,5039,21,16128,441,63504,79632
train,5040,36,27648,1296,186624,214272
train,5041,30,23040,900,129600,152640
train,5042,26,19968,676,97344,117312
train,5043,56,43008,3136,451584,494592
train,5044,10,7680,100,14400,22080
train,5045,36,27648,1296,186624,214272
train,5046,40,30720,1600,230400,261120
train,5047,11,8448,121,17424,25872
train,5048,18,13824,324,46656,60480
train,5049,16,12288,256,36864,49152
train,5050,9,6912,81,11664,18576
train,5051,26,19968,676,97344,117312
train,5052,17,13056,289,41616,54672
train,5053,18,13824,324,46656,60480
train,5054,25,19200,625,90000,109200
train,5055,29,22272,841,121104,143376
train,5056,44,33792,1936,278784,312576
train,5057,40,30720,1600,230400,261120
train,5058,20,15360,400,57600,72960
train,5059,21,16128,441,63504,79632
train,5060,17,13056,289,41616,54672
train,5061,44,33792,1936,278784,312576
train,5062,34,26112,1156,166464,192576
train,5063,13,9984,169,24336,34320
train,5064,52,39936,2704,389376,429312
train,5065,33,25344,1089,156816,182160
train,5066,16,12288,256,36864,49152
train,5067,34,26112,1156,166464,192576
train,5068,19,14592,361,51984,66576
train,5069,23,17664,529,76176,93840
train,5070,23,17664,529,76176,93840
train,5071,36,27648,1296,186624,214272
train,5072,29,22272,841,121104,143376
train,5073,37,28416,1369,197136,225552
train,5074,10,7680,100,14400,22080
train,5075,22,16896,484,69696,86592
train,5076,18,13824,324,46656,60480
train,5077,17,13056,289,41616,54672
train,5078,27,20736,729,104976,125712
train,5079,37,28416,1369,197136,225552
train,5080,18,13824,324,46656,60480
train,5081,9,6912,81,11664,18576
train,5082,17,13056,289,41616,54672
train,5083,39,29952,1521,219024,248976
train,5084,30,23040,900,129600,152640
train,5085,34,26112,1156,166464,192576
train,5086,11,8448,121,17424,25872
train,5087,20,15360,400,57600,72960
train,5088,32,24576,1024,147456,172032
train,5089,23,17664,529,76176,93840
train,5090,42,32256,1764,254016,286272
train,5091,33,25344,1089,156816,182160
train,5092,8,6144,64,9216,15360
train,5093,21,16128,441,63504,79632
train,5094,19,14592,361,51984,66576
train,5095,15,11520,225,32400,43920
train,5096,32,24576,1024,147456,172032
train,5097,29,22272,841,121104,143376
train,5098,21,16128,441,63504,79632
train,5099,24,18432,576,82944,101376
train,5100,10,7680,100,14400,22080
train,5101,40,30720,1600,230400,261120
train,5102,14,10752,196,28224,38976
train,5103,17,13056,289,41616,54672
train,5104,9,6912,81,11664,18576
train,5105,16,12288,256,36864,49152
train,5106,24,18432,576,82944,101376
train,5107,36,27648,1296,186624,214272
train,5108,23,17664,529,76176,93840
train,5109,52,39936,2704,389376,429312
train,5110,44,33792,1936,278784,312576
train,5111,48,36864,2304,331776,368640
train,5112,12,9216,144,20736,29952
train,5113,29,22272,841,121104,143376
train,5114,41,31488,1681,242064,273552
train,5115,10,7680,100,14400,22080
train,5116,36,27648,1296,186624,214272
train,5117,27,20736,729,104976,125712
train,5118,18,13824,324,46656,60480
train,5119,20,15360,400,57600,72960
train,5120,53,40704,2809,404496,445200
train,5121,51,39168,2601,374544,413712
train,5122,25,19200,625,90000,109200
train,5123,19,14592,361,51984,66576
train,5124,14,10752,196,28224,38976
train,5125,14,10752,196,28224,38976
train,5126,23,17664,529,76176,93840
train,5127,14,10752,196,28224,38976
train,5128,35,26880,1225,176400,203280
train,5129,21,16128,441,63504,79632
train,5130,23,17664,529,76176,93840
train,5131,29,22272,841,121104,143376
train,5132,11,8448,121,17424,25872
train,5133,34,26112,1156,166464,192576
train,5134,47,36096,2209,318096,354192
train,5135,17,13056,289,41616,54672
train,5136,24,18432,576,82944,101376
train,5137,13,9984,169,24336,34320
train,5138,25,19200,625,90000,109200
train,5139,12,9216,144,20736,29952
train,5140,24,18432,576,82944,101376
train,5141,12,9216,144,20736,29952
train,5142,39,29952,1521,219024,248976
train,5143,17,13056,289,41616,54672
train,5144,28,21504,784,112896,134400
train,5145,39,29952,1521,219024,248976
train,5146,22,16896,484,69696,86592
train,5147,36,27648,1296,186624,214272
train,5148,26,19968,676,97344,117312
train,5149,52,39936,2704,389376,429312
train,5150,18,13824,324,46656,60480
train,5151,20,15360,400,57600,72960
train,5152,32,24576,1024,147456,172032
train,5153,26,19968,676,97344,117312
train,5154,20,15360,400,57600,72960
train,5155,26,19968,676,97344,117312
train,5156,33,25344,1089,156816,182160
train,5157,25,19200,625,90000,109200
train,5158,24,18432,576,82944,101376
train,5159,18,13824,324,46656,60480
train,5160,39,29952,1521,219024,248976
train,5161,30,23040,900,129600,152640
train,5162,42,32256,1764,254016,286272
train,5163,27,20736,729,104976,125712
train,5164,28,21504,784,112896,134400
train,5165,14,10752,196,28224,38976
train,5166,20,15360,400,57600,72960
train,5167,26,19968,676,97344,117312
train,5168,14,10752,196,28224,38976
train,5169,20,15360,400,57600,72960
train,5170,38,29184,1444,207936,237120
train,5171,10,7680,100,14400,22080
train,5172,14,10752,196,28224,38976
train,5173,14,10752,196,28224,38976
train,5174,22,16896,484,69696,86592
train,5175,22,16896,484,69696,86592
train,5176,18,13824,324,46656,60480
train,5177,15,11520,225,32400,43920
train,5178,11,8448,121,17424,25872
train,5179,20,15360,400,57600,72960
train,5180,48,36864,2304,331776,368640
train,5181,32,24576,1024,147456,172032
train,5182,34,26112,1156,166464,192576
train,5183,28,21504,784,112896,134400
train,5184,34,26112,1156,166464,192576
train,5185,54,41472,2916,419904,461376
train,5186,36,27648,1296,186624,214272
train,5187,31,23808,961,138384,162192
train,5188,31,23808,961,138384,162192
train,5189,35,26880,1225,176400,203280
train,5190,15,11520,225,32400,43920
train,5191,15,11520,225,32400,43920
train,5192,36,27648,1296,186624,214272
train,5193,10,7680,100,14400,22080
train,5194,5,3840,25,3600,7440
train,5195,53,40704,2809,404496,445200
train,5196,13,9984,169,24336,34320
train,5197,26,19968,676,97344,117312
train,5198,42,32256,1764,254016,286272
train,5199,18,13824,324,46656,60480
train,5200,11,8448,121,17424,25872
train,5201,16,12288,256,36864,49152
train,5202,11,8448,121,17424,25872
train,5203,38,29184,1444,207936,237120
train,5204,5,3840,25,3600,7440
train,5205,35,26880,1225,176400,203280
train,5206,44,33792,1936,278784,312576
train,5207,41,31488,1681,242064,273552
train,5208,29,22272,841,121104,143376
train,5209,36,27648,1296,186624,214272
train,5210,30,23040,900,129600,152640
train,5211,12,9216,144,20736,29952
train,5212,17,13056,289,41616,54672
train,5213,12,9216,144,20736,29952
train,5214,16,12288,256,36864,49152
train,5215,14,10752,196,28224,38976
train,5216,35,26880,1225,176400,203280
train,5217,28,21504,784,112896,134400
train,5218,18,13824,324,46656,60480
train,5219,42,32256,1764,254016,286272
train,5220,16,12288,256,36864,49152
train,5221,10,7680,100,14400,22080
train,5222,28,21504,784,112896,134400
train,5223,8,6144,64,9216,15360
train,5224,26,19968,676,97344,117312
train,5225,52,39936,2704,389376,429312
train,5226,23,17664,529,76176,93840
train,5227,42,32256,1764,254016,286272
train,5228,34,26112,1156,166464,192576
train,5229,32,24576,1024,147456,172032
train,5230,27,20736,729,104976,125712
train,5231,23,17664,529,76176,93840
train,5232,29,22272,841,121104,143376
train,5233,17,13056,289,41616,54672
train,5234,46,35328,2116,304704,340032
train,5235,16,12288,256,36864,49152
train,5236,10,7680,100,14400,22080
train,5237,22,16896,484,69696,86592
train,5238,31,23808,961,138384,162192
train,5239,36,27648,1296,186624,214272
train,5240,48,36864,2304,331776,368640
train,5241,17,13056,289,41616,54672
train,5242,26,19968,676,97344,117312
train,5243,30,23040,900,129600,152640
train,5244,25,19200,625,90000,109200
train,5245,22,16896,484,69696,86592
train,5246,15,11520,225,32400,43920
train,5247,13,9984,169,24336,34320
train,5248,19,14592,361,51984,66576
train,5249,33,25344,1089,156816,182160
train,5250,18,13824,324,46656,60480
train,5251,24,18432,576,82944,101376
train,5252,23,17664,529,76176,93840
train,5253,26,19968,676,97344,117312
train,5254,17,13056,289,41616,54672
train,5255,35,26880,1225,176400,203280
train,5256,16,12288,256,36864,49152
train,5257,17,13056,289,41616,54672
train,5258,10,7680,100,14400,22080
train,5259,12,9216,144,20736,29952
train,5260,40,30720,1600,230400,261120
train,5261,13,9984,169,24336,34320
train,5262,38,29184,1444,207936,237120
train,5263,44,33792,1936,278784,312576
train,5264,29,22272,841,121104,143376
train,5265,18,13824,324,46656,60480
train,5266,24,18432,576,82944,101376
train,5267,22,16896,484,69696,86592
train,5268,55,42240,3025,435600,477840
train,5269,10,7680,100,14400,22080
train,5270,11,8448,121,17424,25872
train,5271,37,28416,1369,197136,225552
train,5272,19,14592,361,51984,66576
train,5273,27,20736,729,104976,125712
train,5274,49,37632,2401,345744,383376
train,5275,21,16128,441,63504,79632
train,5276,44,33792,1936,278784,312576
train,5277,28,21504,784,112896,134400
train,5278,16,12288,256,36864,49152
train,5279,23,17664,529,76176,93840
train,5280,28,21504,784,112896,134400
train,5281,40,30720,1600,230400,261120
train,5282,29,22272,841,121104,143376
train,5283,17,13056,289,41616,54672
train,5284,29,22272,841,121104,143376
train,5285,18,13824,324,46656,60480
train,5286,23,17664,529,76176,93840
train,5287,43,33024,1849,266256,299280
train,5288,25,19200,625,90000,109200
train,5289,24,18432,576,82944,101376
train,5290,20,15360,400,57600,72960
train,5291,28,21504,784,112896,134400
train,5292,15,11520,225,32400,43920
train,5293,16,12288,256,36864,49152
train,5294,30,23040,900,129600,152640
train,5295,39,29952,1521,219024,248976
train,5296,30,23040,900,129600,152640
train,5297,18,13824,324,46656,60480
train,5298,25,19200,625,90000,109200
train,5299,25,19200,625,90000,109200
train,5300,15,11520,225,32400,43920
train,5301,13,9984,169,24336,34320
train,5302,9,6912,81,11664,18576
train,5303,16,12288,256,36864,49152
train,5304,20,15360,400,57600,72960
train,5305,30,23040,900,129600,152640
train,5306,31,23808,961,138384,162192
train,5307,32,24576,1024,147456,172032
train,5308,15,11520,225,32400,43920
train,5309,10,7680,100,14400,22080
train,5310,30,23040,900,129600,152640
train,5311,5,3840,25,3600,7440
train,5312,18,13824,324,46656,60480
train,5313,18,13824,324,46656,60480
train,5314,44,33792,1936,278784,312576
train,5315,16,12288,256,36864,49152
train,5316,26,19968,676,97344,117312
train,5317,22,16896,484,69696,86592
train,5318,32,24576,1024,147456,172032
train,5319,38,29184,1444,207936,237120
train,5320,45,34560,2025,291600,326160
train,5321,22,16896,484,69696,86592
train,5322,26,19968,676,97344,117312
train,5323,37,28416,1369,197136,225552
train,5324,15,11520,225,32400,43920
train,5325,17,13056,289,41616,54672
train,5326,20,15360,400,57600,72960
train,5327,20,15360,400,57600,72960
train,5328,7,5376,49,7056,12432
train,5329,38,29184,1444,207936,237120
train,5330,7,5376,49,7056,12432
train,5331,42,32256,1764,254016,286272
train,5332,25,19200,625,90000,109200
train,5333,11,8448,121,17424,25872
train,5334,20,15360,400,57600,72960
train,5335,15,11520,225,32400,43920
train,5336,17,13056,289,41616,54672
train,5337,25,19200,625,90000,109200
train,5338,10,7680,100,14400,22080
train,5339,21,16128,441,63504,79632
train,5340,12,9216,144,20736,29952
train,5341,45,34560,2025,291600,326160
train,5342,29,22272,841,121104,143376
train,5343,15,11520,225,32400,43920
train,5344,28,21504,784,112896,134400
train,5345,20,15360,400,57600,72960
train,5346,27,20736,729,104976,125712
train,5347,6,4608,36,5184,9792
train,5348,15,11520,225,32400,43920
train,5349,22,16896,484,69696,86592
train,5350,27,20736,729,104976,125712
train,5351,34,26112,1156,166464,192576
train,5352,28,21504,784,112896,134400
train,5353,22,16896,484,69696,86592
train,5354,30,23040,900,129600,152640
train,5355,42,32256,1764,254016,286272
train,5356,8,6144,64,9216,15360
train,5357,12,9216,144,20736,29952
train,5358,8,6144,64,9216,15360
train,5359,21,16128,441,63504,79632
train,5360,26,19968,676,97344,117312
train,5361,30,23040,900,129600,152640
train,5362,39,29952,1521,219024,248976
train,5363,18,13824,324,46656,60480
train,5364,26,19968,676,97344,117312
train,5365,21,16128,441,63504,79632
train,5366,20,15360,400,57600,72960
train,5367,16,12288,256,36864,49152
train,5368,30,23040,900,129600,152640
train,5369,14,10752,196,28224,38976
train,5370,23,17664,529,76176,93840
train,5371,21,16128,441,63504,79632
train,5372,22,16896,484,69696,86592
train,5373,25,19200,625,90000,109200
train,5374,24,18432,576,82944,101376
train,5375,9,6912,81,11664,18576
train,5376,48,36864,2304,331776,368640
train,5377,19,14592,361,51984,66576
train,5378,50,38400,2500,360000,398400
train,5379,7,5376,49,7056,12432
train,5380,35,26880,1225,176400,203280
train,5381,26,19968,676,97344,117312
train,5382,21,16128,441,63504,79632
train,5383,37,28416,1369,197136,225552
train,5384,23,17664,529,76176,93840
train,5385,11,8448,121,17424,25872
train,5386,22,16896,484,69696,86592
train,5387,21,16128,441,63504,79632
train,5388,38,29184,1444,207936,237120
train,5389,37,28416,1369,197136,225552
train,5390,19,14592,361,51984,66576
train,5391,30,23040,900,129600,152640
train,5392,18,13824,324,46656,60480
train,5393,27,20736,729,104976,125712
train,5394,13,9984,169,24336,34320
train,5395,10,7680,100,14400,22080
train,5396,14,10752,196,28224,38976
train,5397,31,23808,961,138384,162192
train,5398,16,12288,256,36864,49152
train,5399,15,11520,225,32400,43920
train,5400,12,9216,144,20736,29952
train,5401,29,22272,841,121104,143376
train,5402,10,7680,100,14400,22080
train,5403,5,3840,25,3600,7440
train,5404,30,23040,900,129600,152640
train,5405,14,10752,196,28224,38976
train,5406,39,29952,1521,219024,248976
train,5407,30,23040,900,129600,152640
train,5408,24,18432,576,82944,101376
train,5409,8,6144,64,9216,15360
train,5410,34,26112,1156,166464,192576
train,5411,28,21504,784,112896,134400
train,5412,21,16128,441,63504,79632
train,5413,16,12288,256,36864,49152
train,5414,21,16128,441,63504,79632
train,5415,25,19200,625,90000,109200
train,5416,54,41472,2916,419904,461376
train,5417,44,33792,1936,278784,312576
train,5418,33,25344,1089,156816,182160
train,5419,29,22272,841,121104,143376
train,5420,25,19200,625,90000,109200
train,5421,41,31488,1681,242064,273552
train,5422,24,18432,576,82944,101376
train,5423,11,8448,121,17424,25872
train,5424,22,16896,484,69696,86592
train,5425,20,15360,400,57600,72960
train,5426,24,18432,576,82944,101376
train,5427,9,6912,81,11664,18576
train,5428,34,26112,1156,166464,192576
train,5429,17,13056,289,41616,54672
train,5430,14,10752,196,28224,38976
train,5431,47,36096,2209,318096,354192
train,5432,17,13056,289,41616,54672
train,5433,20,15360,400,57600,72960
train,5434,20,15360,400,57600,72960
train,5435,12,9216,144,20736,29952
train,5436,22,16896,484,69696,86592
train,5437,32,24576,1024,147456,172032
train,5438,17,13056,289,41616,54672
train,5439,42,32256,1764,254016,286272
train,5440,20,15360,400,57600,72960
train,5441,39,29952,1521,219024,248976
train,5442,49,37632,2401,345744,383376
train,5443,15,11520,225,32400,43920
train,5444,33,25344,1089,156816,182160
train,5445,22,16896,484,69696,86592
train,5446,28,21504,784,112896,134400
train,5447,8,6144,64,9216,15360
train,5448,16,12288,256,36864,49152
train,5449,26,19968,676,97344,117312
train,5450,36,27648,1296,186624,214272
train,5451,22,16896,484,69696,86592
train,5452,46,35328,2116,304704,340032
train,5453,36,27648,1296,186624,214272
train,5454,30,23040,900,129600,152640
train,5455,47,36096,2209,318096,354192
train,5456,14,10752,196,28224,38976
train,5457,29,22272,841,121104,143376
train,5458,29,22272,841,121104,143376
train,5459,37,28416,1369,197136,225552
train,5460,31,23808,961,138384,162192
train,5461,22,16896,484,69696,86592
train,5462,23,17664,529,76176,93840
train,5463,30,23040,900,129600,152640
train,5464,33,25344,1089,156816,182160
train,5465,11,8448,121,17424,25872
train,5466,28,21504,784,112896,134400
train,5467,6,4608,36,5184,9792
train,5468,16,12288,256,36864,49152
train,5469,20,15360,400,57600,72960
train,5470,30,23040,900,129600,152640
train,5471,12,9216,144,20736,29952
train,5472,41,31488,1681,242064,273552
train,5473,22,16896,484,69696,86592
train,5474,30,23040,900,129600,152640
train,5475,11,8448,121,17424,25872
train,5476,37,28416,1369,197136,225552
train,5477,47,36096,2209,318096,354192
train,5478,20,15360,400,57600,72960
train,5479,4,3072,16,2304,5376
train,5480,37,28416,1369,197136,225552
train,5481,11,8448,121,17424,25872
train,5482,28,21504,784,112896,134400
train,5483,16,12288,256,36864,49152
train,5484,20,15360,400,57600,72960
train,5485,25,19200,625,90000,109200
train,5486,46,35328,2116,304704,340032
train,5487,15,11520,225,32400,43920
train,5488,10,7680,100,14400,22080
train,5489,40,30720,1600,230400,261120
train,5490,17,13056,289,41616,54672
train,5491,36,27648,1296,186624,214272
train,5492,23,17664,529,76176,93840
train,5493,32,24576,1024,147456,172032
train,5494,46,35328,2116,304704,340032
train,5495,27,20736,729,104976,125712
train,5496,14,10752,196,28224,38976
train,5497,38,29184,1444,207936,237120
train,5498,22,16896,484,69696,86592
train,5499,16,12288,256,36864,49152
train,5500,18,13824,324,46656,60480
train,5501,28,21504,784,112896,134400
train,5502,23,17664,529,76176,93840
train,5503,36,27648,1296,186624,214272
train,5504,6,4608,36,5184,9792
train,5505,17,13056,289,41616,54672
train,5506,10,7680,100,14400,22080
train,5507,51,39168,2601,374544,413712
train,5508,33,25344,1089,156816,182160
train,5509,25,19200,625,90000,109200
train,5510,33,25344,1089,156816,182160
train,5511,34,26112,1156,166464,192576
train,5512,29,22272,841,121104,143376
train,5513,29,22272,841,121104,143376
train,5514,26,19968,676,97344,117312
train,5515,16,12288,256,36864,49152
train,5516,15,11520,225,32400,43920
train,5517,20,15360,400,57600,72960
train,5518,16,12288,256,36864,49152
train,5519,42,32256,1764,254016,286272
train,5520,48,36864,2304,331776,368640
train,5521,34,26112,1156,166464,192576
train,5522,28,21504,784,112896,134400
train,5523,26,19968,676,97344,117312
train,5524,24,18432,576,82944,101376
train,5525,19,14592,361,51984,66576
train,5526,21,16128,441,63504,79632
train,5527,27,20736,729,104976,125712
train,5528,21,16128,441,63504,79632
train,5529,31,23808,961,138384,162192
train,5530,32,24576,1024,147456,172032
train,5531,21,16128,441,63504,79632
train,5532,14,10752,196,28224,38976
train,5533,15,11520,225,32400,43920
train,5534,9,6912,81,11664,18576
train,5535,15,11520,225,32400,43920
train,5536,43,33024,1849,266256,299280
train,5537,6,4608,36,5184,9792
train,5538,10,7680,100,14400,22080
train,5539,16,12288,256,36864,49152
train,5540,35,26880,1225,176400,203280
train,5541,38,29184,1444,207936,237120
train,5542,40,30720,1600,230400,261120
train,5543,28,21504,784,112896,134400
train,5544,33,25344,1089,156816,182160
train,5545,11,8448,121,17424,25872
train,5546,36,27648,1296,186624,214272
train,5547,43,33024,1849,266256,299280
train,5548,26,19968,676,97344,117312
train,5549,15,11520,225,32400,43920
train,5550,29,22272,841,121104,143376
train,5551,44,33792,1936,278784,312576
train,5552,48,36864,2304,331776,368640
train,5553,12,9216,144,20736,29952
train,5554,26,19968,676,97344,117312
train,5555,12,9216,144,20736,29952
train,5556,19,14592,361,51984,66576
train,5557,30,23040,900,129600,152640
train,5558,34,26112,1156,166464,192576
train,5559,44,33792,1936,278784,312576
train,5560,15,11520,225,32400,43920
train,5561,40,30720,1600,230400,261120
train,5562,45,34560,2025,291600,326160
train,5563,18,13824,324,46656,60480
train,5564,16,12288,256,36864,49152
train,5565,25,19200,625,90000,109200
train,5566,12,9216,144,20736,29952
train,5567,29,22272,841,121104,143376
train,5568,13,9984,169,24336,34320
train,5569,20,15360,400,57600,72960
train,5570,27,20736,729,104976,125712
train,5571,13,9984,169,24336,34320
train,5572,36,27648,1296,186624,214272
train,5573,44,33792,1936,278784,312576
train,5574,42,32256,1764,254016,286272
train,5575,19,14592,361,51984,66576
train,5576,10,7680,100,14400,22080
train,5577,21,16128,441,63504,79632
train,5578,12,9216,144,20736,29952
train,5579,34,26112,1156,166464,192576
train,5580,9,6912,81,11664,18576
train,5581,26,19968,676,97344,117312
train,5582,26,19968,676,97344,117312
train,5583,39,29952,1521,219024,248976
train,5584,17,13056,289,41616,54672
train,5585,29,22272,841,121104,143376
train,5586,15,11520,225,32400,43920
train,5587,15,11520,225,32400,43920
train,5588,33,25344,1089,156816,182160
train,5589,34,26112,1156,166464,192576
train,5590,42,32256,1764,254016,286272
train,5591,19,14592,361,51984,66576
train,5592,31,23808,961,138384,162192
train,5593,31,23808,961,138384,162192
train,5594,13,9984,169,24336,34320
train,5595,45,34560,2025,291600,326160
train,5596,23,17664,529,76176,93840
train,5597,17,13056,289,41616,54672
train,5598,26,19968,676,97344,117312
train,5599,12,9216,144,20736,29952
train,5600,19,14592,361,51984,66576
train,5601,21,16128,441,63504,79632
train,5602,28,21504,784,112896,134400
train,5603,28,21504,784,112896,134400
train,5604,18,13824,324,46656,60480
train,5605,31,23808,961,138384,162192
train,5606,12,9216,144,20736,29952
train,5607,19,14592,361,51984,66576
train,5608,30,23040,900,129600,152640
train,5609,22,16896,484,69696,86592
train,5610,24,18432,576,82944,101376
train,5611,19,14592,361,51984,66576
train,5612,20,15360,400,57600,72960
train,5613,36,27648,1296,186624,214272
train,5614,33,25344,1089,156816,182160
train,5615,19,14592,361,51984,66576
train,5616,14,10752,196,28224,38976
train,5617,23,17664,529,76176,93840
train,5618,17,13056,289,41616,54672
train,5619,11,8448,121,17424,25872
train,5620,8,6144,64,9216,15360
train,5621,7,5376,49,7056,12432
train,5622,15,11520,225,32400,43920
train,5623,29,22272,841,121104,143376
train,5624,27,20736,729,104976,125712
train,5625,43,33024,1849,266256,299280
train,5626,23,17664,529,76176,93840
train,5627,40,30720,1600,230400,261120
train,5628,20,15360,400,57600,72960
train,5629,28,21504,784,112896,134400
train,5630,38,29184,1444,207936,237120
train,5631,17,13056,289,41616,54672
train,5632,13,9984,169,24336,34320
train,5633,10,7680,100,14400,22080
train,5634,28,21504,784,112896,134400
train,5635,29,22272,841,121104,143376
train,5636,33,25344,1089,156816,182160
train,5637,20,15360,400,57600,72960
train,5638,21,16128,441,63504,79632
train,5639,26,19968,676,97344,117312
train,5640,28,21504,784,112896,134400
train,5641,33,25344,1089,156816,182160
train,5642,13,9984,169,24336,34320
train,5643,13,9984,169,24336,34320
train,5644,23,17664,529,76176,93840
train,5645,19,14592,361,51984,66576
train,5646,10,7680,100,14400,22080
train,5647,32,24576,1024,147456,172032
train,5648,24,18432,576,82944,101376
train,5649,36,27648,1296,186624,214272
train,5650,24,18432,576,82944,101376
train,5651,26,19968,676,97344,117312
train,5652,18,13824,324,46656,60480
train,5653,26,19968,676,97344,117312
train,5654,27,20736,729,104976,125712
train,5655,4,3072,16,2304,5376
train,5656,8,6144,64,9216,15360
train,5657,45,34560,2025,291600,326160
train,5658,41,31488,1681,242064,273552
train,5659,33,25344,1089,156816,182160
train,5660,28,21504,784,112896,134400
train,5661,33,25344,1089,156816,182160
train,5662,21,16128,441,63504,79632
train,5663,19,14592,361,51984,66576
train,5664,31,23808,961,138384,162192
train,5665,47,36096,2209,318096,354192
train,5666,35,26880,1225,176400,203280
train,5667,16,12288,256,36864,49152
train,5668,13,9984,169,24336,34320
train,5669,14,10752,196,28224,38976
train,5670,21,16128,441,63504,79632
train,5671,9,6912,81,11664,18576
train,5672,20,15360,400,57600,72960
train,5673,26,19968,676,97344,117312
train,5674,29,22272,841,121104,143376
train,5675,16,12288,256,36864,49152
train,5676,22,16896,484,69696,86592
train,5677,24,18432,576,82944,101376
train,5678,27,20736,729,104976,125712
train,5679,29,22272,841,121104,143376
train,5680,22,16896,484,69696,86592
train,5681,28,21504,784,112896,134400
train,5682,13,9984,169,24336,34320
train,5683,47,36096,2209,318096,354192
train,5684,24,18432,576,82944,101376
train,5685,13,9984,169,24336,34320
train,5686,31,23808,961,138384,162192
train,5687,18,13824,324,46656,60480
train,5688,26,19968,676,97344,117312
train,5689,44,33792,1936,278784,312576
train,5690,39,29952,1521,219024,248976
train,5691,23,17664,529,76176,93840
train,5692,7,5376,49,7056,12432
train,5693,26,19968,676,97344,117312
train,5694,35,26880,1225,176400,203280
train,5695,34,26112,1156,166464,192576
train,5696,46,35328,2116,304704,340032
train,5697,15,11520,225,32400,43920
train,5698,38,29184,1444,207936,237120
train,5699,32,24576,1024,147456,172032
train,5700,29,22272,841,121104,143376
train,5701,5,3840,25,3600,7440
train,5702,13,9984,169,24336,34320
train,5703,18,13824,324,46656,60480
train,5704,21,16128,441,63504,79632
train,5705,5,3840,25,3600,7440
train,5706,24,18432,576,82944,101376
train,5707,22,16896,484,69696,86592
train,5708,29,22272,841,121104,143376
train,5709,38,29184,1444,207936,237120
train,5710,37,28416,1369,197136,225552
train,5711,4,3072,16,2304,5376
train,5712,17,13056,289,41616,54672
train,5713,35,26880,1225,176400,203280
train,5714,28,21504,784,112896,134400
train,5715,9,6912,81,11664,18576
train,5716,32,24576,1024,147456,172032
train,5717,16,12288,256,36864,49152
train,5718,25,19200,625,90000,109200
train,5719,15,11520,225,32400,43920
train,5720,40,30720,1600,230400,261120
train,5721,28,21504,784,112896,134400
train,5722,13,9984,169,24336,34320
train,5723,26,19968,676,97344,117312
train,5724,22,16896,484,69696,86592
train,5725,17,13056,289,41616,54672
train,5726,20,15360,400,57600,72960
train,5727,11,8448,121,17424,25872
train,5728,37,28416,1369,197136,225552
train,5729,26,19968,676,97344,117312
train,5730,35,26880,1225,176400,203280
train,5731,9,6912,81,11664,18576
train,5732,9,6912,81,11664,18576
train,5733,39,29952,1521,219024,248976
train,5734,20,15360,400,57600,72960
train,5735,17,13056,289,41616,54672
train,5736,23,17664,529,76176,93840
train,5737,33,25344,1089,156816,182160
train,5738,26,19968,676,97344,117312
train,5739,35,26880,1225,176400,203280
train,5740,9,6912,81,11664,18576
train,5741,24,18432,576,82944,101376
train,5742,21,16128,441,63504,79632
train,5743,7,5376,49,7056,12432
train,5744,17,13056,289,41616,54672
train,5745,20,15360,400,57600,72960
train,5746,11,8448,121,17424,25872
train,5747,24,18432,576,82944,101376
train,5748,57,43776,3249,467856,511632
train,5749,31,23808,961,138384,162192
train,5750,17,13056,289,41616,54672
train,5751,44,33792,1936,278784,312576
train,5752,43,33024,1849,266256,299280
train,5753,7,5376,49,7056,12432
train,5754,45,34560,2025,291600,326160
train,5755,21,16128,441,63504,79632
train,5756,34,26112,1156,166464,192576
train,5757,37,28416,1369,197136,225552
train,5758,16,12288,256,36864,49152
train,5759,28,21504,784,112896,134400
train,5760,20,15360,400,57600,72960
train,5761,43,33024,1849,266256,299280
train,5762,39,29952,1521,219024,248976
train,5763,18,13824,324,46656,60480
train,5764,19,14592,361,51984,66576
train,5765,14,10752,196,28224,38976
train,5766,34,26112,1156,166464,192576
train,5767,5,3840,25,3600,7440
train,5768,34,26112,1156,166464,192576
train,5769,35,26880,1225,176400,203280
train,5770,27,20736,729,104976,125712
train,5771,15,11520,225,32400,43920
train,5772,24,18432,576,82944,101376
train,5773,24,18432,576,82944,101376
train,5774,29,22272,841,121104,143376
train,5775,21,16128,441,63504,79632
train,5776,35,26880,1225,176400,203280
train,5777,42,32256,1764,254016,286272
train,5778,18,13824,324,46656,60480
train,5779,23,17664,529,76176,93840
train,5780,50,38400,2500,360000,398400
train,5781,10,7680,100,14400,22080
train,5782,13,9984,169,24336,34320
train,5783,32,24576,1024,147456,172032
train,5784,20,15360,400,57600,72960
train,5785,17,13056,289,41616,54672
train,5786,11,8448,121,17424,25872
train,5787,54,41472,2916,419904,461376
train,5788,33,25344,1089,156816,182160
train,5789,42,32256,1764,254016,286272
train,5790,38,29184,1444,207936,237120
train,5791,13,9984,169,24336,34320
train,5792,8,6144,64,9216,15360
train,5793,15,11520,225,32400,43920
train,5794,11,8448,121,17424,25872
train,5795,14,10752,196,28224,38976
train,5796,30,23040,900,129600,152640
train,5797,44,33792,1936,278784,312576
train,5798,35,26880,1225,176400,203280
train,5799,24,18432,576,82944,101376
train,5800,37,28416,1369,197136,225552
train,5801,5,3840,25,3600,7440
train,5802,37,28416,1369,197136,225552
train,5803,17,13056,289,41616,54672
train,5804,31,23808,961,138384,162192
train,5805,25,19200,625,90000,109200
train,5806,25,19200,625,90000,109200
train,5807,17,13056,289,41616,54672
train,5808,27,20736,729,104976,125712
train,5809,11,8448,121,17424,25872
train,5810,35,26880,1225,176400,203280
train,5811,29,22272,841,121104,143376
train,5812,21,16128,441,63504,79632
train,5813,32,24576,1024,147456,172032
train,5814,18,13824,324,46656,60480
train,5815,8,6144,64,9216,15360
train,5816,35,26880,1225,176400,203280
train,5817,38,29184,1444,207936,237120
train,5818,9,6912,81,11664,18576
train,5819,29,22272,841,121104,143376
train,5820,30,23040,900,129600,152640
train,5821,6,4608,36,5184,9792
train,5822,22,16896,484,69696,86592
train,5823,20,15360,400,57600,72960
train,5824,25,19200,625,90000,109200
train,5825,10,7680,100,14400,22080
train,5826,24,18432,576,82944,101376
train,5827,20,15360,400,57600,72960
train,5828,30,23040,900,129600,152640
train,5829,21,16128,441,63504,79632
train,5830,25,19200,625,90000,109200
train,5831,23,17664,529,76176,93840
train,5832,28,21504,784,112896,134400
train,5833,31,23808,961,138384,162192
train,5834,27,20736,729,104976,125712
train,5835,51,39168,2601,374544,413712
train,5836,45,34560,2025,291600,326160
train,5837,41,31488,1681,242064,273552
train,5838,31,23808,961,138384,162192
train,5839,33,25344,1089,156816,182160
train,5840,40,30720,1600,230400,261120
train,5841,25,19200,625,90000,109200
train,5842,24,18432,576,82944,101376
train,5843,25,19200,625,90000,109200
train,5844,5,3840,25,3600,7440
train,5845,20,15360,400,57600,72960
train,5846,23,17664,529,76176,93840
train,5847,14,10752,196,28224,38976
train,5848,19,14592,361,51984,66576
train,5849,8,6144,64,9216,15360
train,5850,48,36864,2304,331776,368640
train,5851,28,21504,784,112896,134400
train,5852,25,19200,625,90000,109200
train,5853,14,10752,196,28224,38976
train,5854,11,8448,121,17424,25872
train,5855,17,13056,289,41616,54672
train,5856,21,16128,441,63504,79632
train,5857,21,16128,441,63504,79632
train,5858,32,24576,1024,147456,172032
train,5859,36,27648,1296,186624,214272
train,5860,16,12288,256,36864,49152
train,5861,35,26880,1225,176400,203280
train,5862,33,25344,1089,156816,182160
train,5863,18,13824,324,46656,60480
train,5864,9,6912,81,11664,18576
train,5865,10,7680,100,14400,22080
train,5866,12,9216,144,20736,29952
train,5867,56,43008,3136,451584,494592
train,5868,17,13056,289,41616,54672
train,5869,28,21504,784,112896,134400
train,5870,31,23808,961,138384,162192
train,5871,34,26112,1156,166464,192576
train,5872,18,13824,324,46656,60480
train,5873,13,9984,169,24336,34320
train,5874,28,21504,784,112896,134400
train,5875,20,15360,400,57600,72960
train,5876,37,28416,1369,197136,225552
train,5877,49,37632,2401,345744,383376
train,5878,27,20736,729,104976,125712
train,5879,38,29184,1444,207936,237120
train,5880,14,10752,196,28224,38976
train,5881,45,34560,2025,291600,326160
train,5882,11,8448,121,17424,25872
train,5883,20,15360,400,57600,72960
train,5884,21,16128,441,63504,79632
train,5885,23,17664,529,76176,93840
train,5886,26,19968,676,97344,117312
train,5887,26,19968,676,97344,117312
train,5888,45,34560,2025,291600,326160
train,5889,28,21504,784,112896,134400
train,5890,18,13824,324,46656,60480
train,5891,45,34560,2025,291600,326160
train,5892,17,13056,289,41616,54672
train,5893,13,9984,169,24336,34320
train,5894,15,11520,225,32400,43920
train,5895,35,26880,1225,176400,203280
train,5896,21,16128,441,63504,79632
train,5897,43,33024,1849,266256,299280
train,5898,26,19968,676,97344,117312
train,5899,30,23040,900,129600,152640
train,5900,29,22272,841,121104,143376
train,5901,27,20736,729,104976,125712
train,5902,11,8448,121,17424,25872
train,5903,33,25344,1089,156816,182160
train,5904,18,13824,324,46656,60480
train,5905,41,31488,1681,242064,273552
train,5906,29,22272,841,121104,143376
train,5907,24,18432,576,82944,101376
train,5908,11,8448,121,17424,25872
train,5909,19,14592,361,51984,66576
train,5910,16,12288,256,36864,49152
train,5911,32,24576,1024,147456,172032
train,5912,12,9216,144,20736,29952
train,5913,43,33024,1849,266256,299280
train,5914,28,21504,784,112896,134400
train,5915,16,12288,256,36864,49152
train,5916,20,15360,400,57600,72960
train,5917,28,21504,784,112896,134400
train,5918,13,9984,169,24336,34320
train,5919,13,9984,169,24336,34320
train,5920,19,14592,361,51984,66576
train,5921,35,26880,1225,176400,203280
train,5922,34,26112,1156,166464,192576
train,5923,8,6144,64,9216,15360
train,5924,8,6144,64,9216,15360
train,5925,42,32256,1764,254016,286272
train,5926,23,17664,529,76176,93840
train,5927,5,3840,25,3600,7440
train,5928,30,23040,900,129600,152640
train,5929,31,23808,961,138384,162192
train,5930,35,26880,1225,176400,203280
train,5931,13,9984,169,24336,34320
train,5932,25,19200,625,90000,109200
train,5933,10,7680,100,14400,22080
train,5934,24,18432,576,82944,101376
train,5935,26,19968,676,97344,117312
train,5936,22,16896,484,69696,86592
train,5937,11,8448,121,17424,25872
train,5938,24,18432,576,82944,101376
train,5939,26,19968,676,97344,117312
train,5940,44,33792,1936,278784,312576
train,5941,28,21504,784,112896,134400
train,5942,27,20736,729,104976,125712
train,5943,21,16128,441,63504,79632
train,5944,36,27648,1296,186624,214272
train,5945,10,7680,100,14400,22080
train,5946,19,14592,361,51984,66576
train,5947,31,23808,961,138384,162192
train,5948,18,13824,324,46656,60480
train,5949,25,19200,625,90000,109200
train,5950,13,9984,169,24336,34320
train,5951,30,23040,900,129600,152640
train,5952,20,15360,400,57600,72960
train,5953,24,18432,576,82944,101376
train,5954,36,27648,1296,186624,214272
train,5955,37,28416,1369,197136,225552
train,5956,43,33024,1849,266256,299280
train,5957,27,20736,729,104976,125712
train,5958,22,16896,484,69696,86592
train,5959,30,23040,900,129600,152640
train,5960,20,15360,400,57600,72960
train,5961,24,18432,576,82944,101376
train,5962,32,24576,1024,147456,172032
train,5963,53,40704,2809,404496,445200
train,5964,16,12288,256,36864,49152
train,5965,25,19200,625,90000,109200
train,5966,18,13824,324,46656,60480
train,5967,36,27648,1296,186624,214272
train,5968,21,16128,441,63504,79632
train,5969,24,18432,576,82944,101376
train,5970,50,38400,2500,360000,398400
train,5971,29,22272,841,121104,143376
train,5972,13,9984,169,24336,34320
train,5973,30,23040,900,129600,152640
train,5974,24,18432,576,82944,101376
train,5975,20,15360,400,57600,72960
train,5976,23,17664,529,76176,93840
train,5977,26,19968,676,97344,117312
train,5978,29,22272,841,121104,143376
train,5979,48,36864,2304,331776,368640
train,5980,25,19200,625,90000,109200
train,5981,42,32256,1764,254016,286272
train,5982,38,29184,1444,207936,237120
train,5983,12,9216,144,20736,29952
train,5984,29,22272,841,121104,143376
train,5985,31,23808,961,138384,162192
train,5986,22,16896,484,69696,86592
train,5987,40,30720,1600,230400,261120
train,5988,28,21504,784,112896,134400
train,5989,33,25344,1089,156816,182160
train,5990,29,22272,841,121104,143376
train,5991,26,19968,676,97344,117312
train,5992,9,6912,81,11664,18576
train,5993,16,12288,256,36864,49152
train,5994,38,29184,1444,207936,237120
train,5995,21,16128,441,63504,79632
train,5996,21,16128,441,63504,79632
train,5997,12,9216,144,20736,29952
train,5998,36,27648,1296,186624,214272
train,5999,35,26880,1225,176400,203280
train,6000,48,36864,2304,331776,368640
train,6001,19,14592,361,51984,66576
train,6002,37,28416,1369,197136,225552
train,6003,27,20736,729,104976,125712
train,6004,23,17664,529,76176,93840
train,6005,41,31488,1681,242064,273552
train,6006,28,21504,784,112896,134400
train,6007,21,16128,441,63504,79632
train,6008,18,13824,324,46656,60480
train,6009,35,26880,1225,176400,203280
train,6010,40,30720,1600,230400,261120
train,6011,38,29184,1444,207936,237120
train,6012,27,20736,729,104976,125712
train,6013,9,6912,81,11664,18576
train,6014,53,40704,2809,404496,445200
train,6015,26,19968,676,97344,117312
train,6016,24,18432,576,82944,101376
train,6017,28,21504,784,112896,134400
train,6018,26,19968,676,97344,117312
train,6019,29,22272,841,121104,143376
train,6020,35,26880,1225,176400,203280
train,6021,15,11520,225,32400,43920
train,6022,25,19200,625,90000,109200
train,6023,13,9984,169,24336,34320
train,6024,23,17664,529,76176,93840
train,6025,24,18432,576,82944,101376
train,6026,38,29184,1444,207936,237120
train,6027,12,9216,144,20736,29952
train,6028,22,16896,484,69696,86592
train,6029,27,20736,729,104976,125712
train,6030,7,5376,49,7056,12432
train,6031,23,17664,529,76176,93840
train,6032,13,9984,169,24336,34320
train,6033,28,21504,784,112896,134400
train,6034,18,13824,324,46656,60480
train,6035,34,26112,1156,166464,192576
train,6036,22,16896,484,69696,86592
train,6037,49,37632,2401,345744,383376
train,6038,10,7680,100,14400,22080
train,6039,17,13056,289,41616,54672
train,6040,39,29952,1521,219024,248976
train,6041,13,9984,169,24336,34320
train,6042,29,22272,841,121104,143376
train,6043,19,14592,361,51984,66576
train,6044,25,19200,625,90000,109200
train,6045,49,37632,2401,345744,383376
train,6046,51,39168,2601,374544,413712
train,6047,19,14592,361,51984,66576
train,6048,36,27648,1296,186624,214272
train,6049,25,19200,625,90000,109200
train,6050,30,23040,900,129600,152640
train,6051,17,13056,289,41616,54672
train,6052,13,9984,169,24336,34320
train,6053,29,22272,841,121104,143376
train,6054,24,18432,576,82944,101376
train,6055,14,10752,196,28224,38976
train,6056,37,28416,1369,197136,225552
train,6057,12,9216,144,20736,29952
train,6058,26,19968,676,97344,117312
train,6059,11,8448,121,17424,25872
train,6060,27,20736,729,104976,125712
train,6061,21,16128,441,63504,79632
train,6062,32,24576,1024,147456,172032
train,6063,33,25344,1089,156816,182160
train,6064,27,20736,729,104976,125712
train,6065,24,18432,576,82944,101376
train,6066,34,26112,1156,166464,192576
train,6067,17,13056,289,41616,54672
train,6068,21,16128,441,63504,79632
train,6069,31,23808,961,138384,162192
train,6070,14,10752,196,28224,38976
train,6071,14,10752,196,28224,38976
train,6072,34,26112,1156,166464,192576
train,6073,24,18432,576,82944,101376
train,6074,36,27648,1296,186624,214272
train,6075,23,17664,529,76176,93840
train,6076,52,39936,2704,389376,429312
train,6077,7,5376,49,7056,12432
train,6078,10,7680,100,14400,22080
train,6079,23,17664,529,76176,93840
train,6080,18,13824,324,46656,60480
train,6081,15,11520,225,32400,43920
train,6082,33,25344,1089,156816,182160
train,6083,24,18432,576,82944,101376
train,6084,16,12288,256,36864,49152
train,6085,8,6144,64,9216,15360
train,6086,27,20736,729,104976,125712
train,6087,32,24576,1024,147456,172032
train,6088,27,20736,729,104976,125712
train,6089,11,8448,121,17424,25872
train,6090,11,8448,121,17424,25872
train,6091,26,19968,676,97344,117312
train,6092,16,12288,256,36864,49152
train,6093,23,17664,529,76176,93840
train,6094,19,14592,361,51984,66576
train,6095,34,26112,1156,166464,192576
train,6096,20,15360,400,57600,72960
train,6097,24,18432,576,82944,101376
train,6098,36,27648,1296,186624,214272
train,6099,15,11520,225,32400,43920
train,6100,8,6144,64,9216,15360
train,6101,21,16128,441,63504,79632
train,6102,27,20736,729,104976,125712
train,6103,11,8448,121,17424,25872
train,6104,20,15360,400,57600,72960
train,6105,25,19200,625,90000,109200
train,6106,31,23808,961,138384,162192
train,6107,19,14592,361,51984,66576
train,6108,13,9984,169,24336,34320
train,6109,42,32256,1764,254016,286272
train,6110,28,21504,784,112896,134400
train,6111,9,6912,81,11664,18576
train,6112,35,26880,1225,176400,203280
train,6113,13,9984,169,24336,34320
train,6114,17,13056,289,41616,54672
train,6115,26,19968,676,97344,117312
train,6116,25,19200,625,90000,109200
train,6117,24,18432,576,82944,101376
train,6118,44,33792,1936,278784,312576
train,6119,37,28416,1369,197136,225552
train,6120,26,19968,676,97344,117312
train,6121,7,5376,49,7056,12432
train,6122,25,19200,625,90000,109200
train,6123,34,26112,1156,166464,192576
train,6124,43,33024,1849,266256,299280
train,6125,34,26112,1156,166464,192576
train,6126,18,13824,324,46656,60480
train,6127,14,10752,196,28224,38976
train,6128,27,20736,729,104976,125712
train,6129,15,11520,225,32400,43920
train,6130,19,14592,361,51984,66576
train,6131,23,17664,529,76176,93840
train,6132,10,7680,100,14400,22080
train,6133,28,21504,784,112896,134400
train,6134,15,11520,225,32400,43920
train,6135,19,14592,361,51984,66576
train,6136,22,16896,484,69696,86592
train,6137,29,22272,841,121104,143376
train,6138,26,19968,676,97344,117312
train,6139,25,19200,625,90000,109200
train,6140,22,16896,484,69696,86592
train,6141,18,13824,324,46656,60480
train,6142,17,13056,289,41616,54672
train,6143,28,21504,784,112896,134400
train,6144,19,14592,361,51984,66576
train,6145,16,12288,256,36864,49152
train,6146,22,16896,484,69696,86592
train,6147,32,24576,1024,147456,172032
train,6148,33,25344,1089,156816,182160
train,6149,16,12288,256,36864,49152
train,6150,38,29184,1444,207936,237120
train,6151,10,7680,100,14400,22080
train,6152,26,19968,676,97344,117312
train,6153,21,16128,441,63504,79632
train,6154,23,17664,529,76176,93840
train,6155,43,33024,1849,266256,299280
train,6156,28,21504,784,112896,134400
train,6157,29,22272,841,121104,143376
train,6158,37,28416,1369,197136,225552
train,6159,32,24576,1024,147456,172032
train,6160,42,32256,1764,254016,286272
train,6161,26,19968,676,97344,117312
train,6162,43,33024,1849,266256,299280
train,6163,19,14592,361,51984,66576
train,6164,26,19968,676,97344,117312
train,6165,37,28416,1369,197136,225552
train,6166,10,7680,100,14400,22080
train,6167,9,6912,81,11664,18576
train,6168,14,10752,196,28224,38976
train,6169,26,19968,676,97344,117312
train,6170,30,23040,900,129600,152640
train,6171,18,13824,324,46656,60480
train,6172,31,23808,961,138384,162192
train,6173,12,9216,144,20736,29952
train,6174,20,15360,400,57600,72960
train,6175,31,23808,961,138384,162192
train,6176,19,14592,361,51984,66576
train,6177,10,7680,100,14400,22080
train,6178,30,23040,900,129600,152640
train,6179,22,16896,484,69696,86592
train,6180,17,13056,289,41616,54672
train,6181,33,25344,1089,156816,182160
train,6182,15,11520,225,32400,43920
train,6183,16,12288,256,36864,49152
train,6184,33,25344,1089,156816,182160
train,6185,42,32256,1764,254016,286272
train,6186,51,39168,2601,374544,413712
train,6187,24,18432,576,82944,101376
train,6188,5,3840,25,3600,7440
train,6189,20,15360,400,57600,72960
train,6190,22,16896,484,69696,86592
train,6191,33,25344,1089,156816,182160
train,6192,20,15360,400,57600,72960
train,6193,12,9216,144,20736,29952
train,6194,22,16896,484,69696,86592
train,6195,20,15360,400,57600,72960
train,6196,7,5376,49,7056,12432
train,6197,17,13056,289,41616,54672
train,6198,50,38400,2500,360000,398400
train,6199,31,23808,961,138384,162192
train,6200,40,30720,1600,230400,261120
train,6201,24,18432,576,82944,101376
train,6202,32,24576,1024,147456,172032
train,6203,53,40704,2809,404496,445200
train,6204,25,19200,625,90000,109200
train,6205,22,16896,484,69696,86592
train,6206,34,26112,1156,166464,192576
train,6207,27,20736,729,104976,125712
train,6208,40,30720,1600,230400,261120
train,6209,23,17664,529,76176,93840
train,6210,22,16896,484,69696,86592
train,6211,25,19200,625,90000,109200
train,6212,28,21504,784,112896,134400
train,6213,13,9984,169,24336,34320
train,6214,16,12288,256,36864,49152
train,6215,31,23808,961,138384,162192
train,6216,47,36096,2209,318096,354192
train,6217,27,20736,729,104976,125712
train,6218,34,26112,1156,166464,192576
train,6219,31,23808,961,138384,162192
train,6220,28,21504,784,112896,134400
train,6221,31,23808,961,138384,162192
train,6222,22,16896,484,69696,86592
train,6223,19,14592,361,51984,66576
train,6224,33,25344,1089,156816,182160
train,6225,32,24576,1024,147456,172032
train,6226,36,27648,1296,186624,214272
train,6227,29,22272,841,121104,143376
train,6228,23,17664,529,76176,93840
train,6229,23,17664,529,76176,93840
train,6230,44,33792,1936,278784,312576
train,6231,13,9984,169,24336,34320
train,6232,8,6144,64,9216,15360
train,6233,13,9984,169,24336,34320
train,6234,12,9216,144,20736,29952
train,6235,38,29184,1444,207936,237120
train,6236,34,26112,1156,166464,192576
train,6237,9,6912,81,11664,18576
train,6238,20,15360,400,57600,72960
train,6239,39,29952,1521,219024,248976
train,6240,26,19968,676,97344,117312
train,6241,47,36096,2209,318096,354192
train,6242,29,22272,841,121104,143376
train,6243,16,12288,256,36864,49152
train,6244,18,13824,324,46656,60480
train,6245,24,18432,576,82944,101376
train,6246,12,9216,144,20736,29952
train,6247,29,22272,841,121104,143376
train,6248,38,29184,1444,207936,237120
train,6249,33,25344,1089,156816,182160
train,6250,35,26880,1225,176400,203280
train,6251,8,6144,64,9216,15360
train,6252,35,26880,1225,176400,203280
train,6253,8,6144,64,9216,15360
train,6254,20,15360,400,57600,72960
train,6255,22,16896,484,69696,86592
train,6256,10,7680,100,14400,22080
train,6257,13,9984,169,24336,34320
train,6258,24,18432,576,82944,101376
train,6259,25,19200,625,90000,109200
train,6260,9,6912,81,11664,18576
train,6261,34,26112,1156,166464,192576
train,6262,28,21504,784,112896,134400
train,6263,43,33024,1849,266256,299280
train,6264,39,29952,1521,219024,248976
train,6265,7,5376,49,7056,12432
train,6266,16,12288,256,36864,49152
train,6267,30,23040,900,129600,152640
train,6268,54,41472,2916,419904,461376
train,6269,24,18432,576,82944,101376
train,6270,33,25344,1089,156816,182160
train,6271,22,16896,484,69696,86592
train,6272,28,21504,784,112896,134400
train,6273,23,17664,529,76176,93840
train,6274,13,9984,169,24336,34320
train,6275,33,25344,1089,156816,182160
train,6276,14,10752,196,28224,38976
train,6277,23,17664,529,76176,93840
train,6278,14,10752,196,28224,38976
train,6279,12,9216,144,20736,29952
train,6280,30,23040,900,129600,152640
train,6281,19,14592,361,51984,66576
train,6282,46,35328,2116,304704,340032
train,6283,29,22272,841,121104,143376
train,6284,28,21504,784,112896,134400
train,6285,8,6144,64,9216,15360
train,6286,41,31488,1681,242064,273552
train,6287,40,30720,1600,230400,261120
train,6288,48,36864,2304,331776,368640
train,6289,46,35328,2116,304704,340032
train,6290,31,23808,961,138384,162192
train,6291,38,29184,1444,207936,237120
train,6292,8,6144,64,9216,15360
train,6293,32,24576,1024,147456,172032
train,6294,26,19968,676,97344,117312
train,6295,30,23040,900,129600,152640
train,6296,27,20736,729,104976,125712
train,6297,13,9984,169,24336,34320
train,6298,20,15360,400,57600,72960
train,6299,30,23040,900,129600,152640
train,6300,30,23040,900,129600,152640
train,6301,10,7680,100,14400,22080
train,6302,24,18432,576,82944,101376
train,6303,25,19200,625,90000,109200
train,6304,28,21504,784,112896,134400
train,6305,15,11520,225,32400,43920
train,6306,29,22272,841,121104,143376
train,6307,34,26112,1156,166464,192576
train,6308,18,13824,324,46656,60480
train,6309,29,22272,841,121104,143376
train,6310,47,36096,2209,318096,354192
train,6311,37,28416,1369,197136,225552
train,6312,29,22272,841,121104,143376
train,6313,8,6144,64,9216,15360
train,6314,30,23040,900,129600,152640
train,6315,42,32256,1764,254016,286272
train,6316,25,19200,625,90000,109200
train,6317,34,26112,1156,166464,192576
train,6318,13,9984,169,24336,34320
train,6319,15,11520,225,32400,43920
train,6320,12,9216,144,20736,29952
train,6321,36,27648,1296,186624,214272
train,6322,45,34560,2025,291600,326160
train,6323,14,10752,196,28224,38976
train,6324,25,19200,625,90000,109200
train,6325,26,19968,676,97344,117312
train,6326,19,14592,361,51984,66576
train,6327,23,17664,529,76176,93840
train,6328,13,9984,169,24336,34320
train,6329,15,11520,225,32400,43920
train,6330,27,20736,729,104976,125712
train,6331,51,39168,2601,374544,413712
train,6332,44,33792,1936,278784,312576
train,6333,33,25344,1089,156816,182160
train,6334,38,29184,1444,207936,237120
train,6335,13,9984,169,24336,34320
train,6336,18,13824,324,46656,60480
train,6337,28,21504,784,112896,134400
train,6338,19,14592,361,51984,66576
train,6339,30,23040,900,129600,152640
train,6340,48,36864,2304,331776,368640
train,6341,31,23808,961,138384,162192
train,6342,28,21504,784,112896,134400
train,6343,15,11520,225,32400,43920
train,6344,14,10752,196,28224,38976
train,6345,23,17664,529,76176,93840
train,6346,19,14592,361,51984,66576
train,6347,25,19200,625,90000,109200
train,6348,13,9984,169,24336,34320
train,6349,35,26880,1225,176400,203280
train,6350,46,35328,2116,304704,340032
train,6351,34,26112,1156,166464,192576
train,6352,24,18432,576,82944,101376
train,6353,18,13824,324,46656,60480
train,6354,28,21504,784,112896,134400
train,6355,41,31488,1681,242064,273552
train,6356,33,25344,1089,156816,182160
train,6357,25,19200,625,90000,109200
train,6358,31,23808,961,138384,162192
train,6359,17,13056,289,41616,54672
train,6360,33,25344,1089,156816,182160
train,6361,40,30720,1600,230400,261120
train,6362,23,17664,529,76176,93840
train,6363,5,3840,25,3600,7440
train,6364,12,9216,144,20736,29952
train,6365,37,28416,1369,197136,225552
train,6366,16,12288,256,36864,49152
train,6367,12,9216,144,20736,29952
train,6368,10,7680,100,14400,22080
train,6369,44,33792,1936,278784,312576
train,6370,9,6912,81,11664,18576
train,6371,24,18432,576,82944,101376
train,6372,39,29952,1521,219024,248976
train,6373,20,15360,400,57600,72960
train,6374,26,19968,676,97344,117312
train,6375,29,22272,841,121104,143376
train,6376,31,23808,961,138384,162192
train,6377,13,9984,169,24336,34320
train,6378,18,13824,324,46656,60480
train,6379,17,13056,289,41616,54672
train,6380,42,32256,1764,254016,286272
train,6381,17,13056,289,41616,54672
train,6382,22,16896,484,69696,86592
train,6383,26,19968,676,97344,117312
train,6384,8,6144,64,9216,15360
train,6385,22,16896,484,69696,86592
train,6386,26,19968,676,97344,117312
train,6387,44,33792,1936,278784,312576
train,6388,40,30720,1600,230400,261120
train,6389,17,13056,289,41616,54672
train,6390,30,23040,900,129600,152640
train,6391,35,26880,1225,176400,203280
train,6392,17,13056,289,41616,54672
train,6393,50,38400,2500,360000,398400
train,6394,10,7680,100,14400,22080
train,6395,31,23808,961,138384,162192
train,6396,13,9984,169,24336,34320
train,6397,31,23808,961,138384,162192
train,6398,20,15360,400,57600,72960
train,6399,14,10752,196,28224,38976
train,6400,42,32256,1764,254016,286272
train,6401,33,25344,1089,156816,182160
train,6402,12,9216,144,20736,29952
train,6403,11,8448,121,17424,25872
train,6404,15,11520,225,32400,43920
train,6405,15,11520,225,32400,43920
train,6406,9,6912,81,11664,18576
train,6407,13,9984,169,24336,34320
train,6408,10,7680,100,14400,22080
train,6409,29,22272,841,121104,143376
train,6410,40,30720,1600,230400,261120
train,6411,17,13056,289,41616,54672
train,6412,39,29952,1521,219024,248976
train,6413,28,21504,784,112896,134400
train,6414,20,15360,400,57600,72960
train,6415,38,29184,1444,207936,237120
train,6416,37,28416,1369,197136,225552
train,6417,27,20736,729,104976,125712
train,6418,21,16128,441,63504,79632
train,6419,19,14592,361,51984,66576
train,6420,25,19200,625,90000,109200
train,6421,20,15360,400,57600,72960
train,6422,21,16128,441,63504,79632
train,6423,10,7680,100,14400,22080
train,6424,16,12288,256,36864,49152
train,6425,21,16128,441,63504,79632
train,6426,33,25344,1089,156816,182160
train,6427,37,28416,1369,197136,225552
train,6428,24,18432,576,82944,101376
train,6429,9,6912,81,11664,18576
train,6430,20,15360,400,57600,72960
train,6431,24,18432,576,82944,101376
train,6432,9,6912,81,11664,18576
train,6433,48,36864,2304,331776,368640
train,6434,15,11520,225,32400,43920
train,6435,25,19200,625,90000,109200
train,6436,29,22272,841,121104,143376
train,6437,24,18432,576,82944,101376
train,6438,46,35328,2116,304704,340032
train,6439,46,35328,2116,304704,340032
train,6440,35,26880,1225,176400,203280
train,6441,28,21504,784,112896,134400
train,6442,19,14592,361,51984,66576
train,6443,47,36096,2209,318096,354192
train,6444,14,10752,196,28224,38976
train,6445,9,6912,81,11664,18576
train,6446,7,5376,49,7056,12432
train,6447,10,7680,100,14400,22080
train,6448,29,22272,841,121104,143376
train,6449,26,19968,676,97344,117312
train,6450,27,20736,729,104976,125712
train,6451,12,9216,144,20736,29952
train,6452,31,23808,961,138384,162192
train,6453,15,11520,225,32400,43920
train,6454,7,5376,49,7056,12432
train,6455,16,12288,256,36864,49152
train,6456,23,17664,529,76176,93840
train,6457,23,17664,529,76176,93840
train,6458,40,30720,1600,230400,261120
train,6459,28,21504,784,112896,134400
train,6460,18,13824,324,46656,60480
train,6461,14,10752,196,28224,38976
train,6462,26,19968,676,97344,117312
train,6463,8,6144,64,9216,15360
train,6464,21,16128,441,63504,79632
train,6465,16,12288,256,36864,49152
train,6466,17,13056,289,41616,54672
train,6467,51,39168,2601,374544,413712
train,6468,12,9216,144,20736,29952
train,6469,27,20736,729,104976,125712
train,6470,32,24576,1024,147456,172032
train,6471,27,20736,729,104976,125712
train,6472,15,11520,225,32400,43920
train,6473,11,8448,121,17424,25872
train,6474,12,9216,144,20736,29952
train,6475,51,39168,2601,374544,413712
train,6476,15,11520,225,32400,43920
train,6477,32,24576,1024,147456,172032
train,6478,26,19968,676,97344,117312
train,6479,28,21504,784,112896,134400
train,6480,13,9984,169,24336,34320
train,6481,40,30720,1600,230400,261120
train,6482,25,19200,625,90000,109200
train,6483,15,11520,225,32400,43920
train,6484,53,40704,2809,404496,445200
train,6485,25,19200,625,90000,109200
train,6486,26,19968,676,97344,117312
train,6487,44,33792,1936,278784,312576
train,6488,18,13824,324,46656,60480
train,6489,6,4608,36,5184,9792
train,6490,26,19968,676,97344,117312
train,6491,42,32256,1764,254016,286272
train,6492,31,23808,961,138384,162192
train,6493,47,36096,2209,318096,354192
train,6494,22,16896,484,69696,86592
train,6495,26,19968,676,97344,117312
train,6496,39,29952,1521,219024,248976
train,6497,28,21504,784,112896,134400
train,6498,19,14592,361,51984,66576
train,6499,53,40704,2809,404496,445200
train,6500,25,19200,625,90000,109200
train,6501,37,28416,1369,197136,225552
train,6502,6,4608,36,5184,9792
train,6503,31,23808,961,138384,162192
train,6504,28,21504,784,112896,134400
train,6505,23,17664,529,76176,93840
train,6506,34,26112,1156,166464,192576
train,6507,14,10752,196,28224,38976
train,6508,13,9984,169,24336,34320
train,6509,31,23808,961,138384,162192
train,6510,17,13056,289,41616,54672
train,6511,23,17664,529,76176,93840
train,6512,19,14592,361,51984,66576
train,6513,27,20736,729,104976,125712
train,6514,29,22272,841,121104,143376
train,6515,9,6912,81,11664,18576
train,6516,28,21504,784,112896,134400
train,6517,25,19200,625,90000,109200
train,6518,11,8448,121,17424,25872
train,6519,7,5376,49,7056,12432
train,6520,11,8448,121,17424,25872
train,6521,5,3840,25,3600,7440
train,6522,24,18432,576,82944,101376
train,6523,22,16896,484,69696,86592
train,6524,22,16896,484,69696,86592
train,6525,18,13824,324,46656,60480
train,6526,9,6912,81,11664,18576
train,6527,20,15360,400,57600,72960
train,6528,4,3072,16,2304,5376
train,6529,19,14592,361,51984,66576
train,6530,20,15360,400,57600,72960
train,6531,27,20736,729,104976,125712
train,6532,21,16128,441,63504,79632
train,6533,18,13824,324,46656,60480
train,6534,37,28416,1369,197136,225552
train,6535,30,23040,900,129600,152640
train,6536,20,15360,400,57600,72960
train,6537,35,26880,1225,176400,203280
train,6538,50,38400,2500,360000,398400
train,6539,9,6912,81,11664,18576
train,6540,30,23040,900,129600,152640
train,6541,25,19200,625,90000,109200
train,6542,11,8448,121,17424,25872
train,6543,24,18432,576,82944,101376
train,6544,36,27648,1296,186624,214272
train,6545,41,31488,1681,242064,273552
train,6546,17,13056,289,41616,54672
train,6547,31,23808,961,138384,162192
train,6548,39,29952,1521,219024,248976
train,6549,16,12288,256,36864,49152
train,6550,14,10752,196,28224,38976
train,6551,13,9984,169,24336,34320
train,6552,6,4608,36,5184,9792
train,6553,22,16896,484,69696,86592
train,6554,23,17664,529,76176,93840
train,6555,14,10752,196,28224,38976
train,6556,20,15360,400,57600,72960
train,6557,16,12288,256,36864,49152
train,6558,26,19968,676,97344,117312
train,6559,40,30720,1600,230400,261120
train,6560,12,9216,144,20736,29952
train,6561,11,8448,121,17424,25872
train,6562,8,6144,64,9216,15360
train,6563,6,4608,36,5184,9792
train,6564,9,6912,81,11664,18576
train,6565,7,5376,49,7056,12432
train,6566,44,33792,1936,278784,312576
train,6567,34,26112,1156,166464,192576
train,6568,32,24576,1024,147456,172032
train,6569,22,16896,484,69696,86592
train,6570,55,42240,3025,435600,477840
train,6571,14,10752,196,28224,38976
train,6572,21,16128,441,63504,79632
train,6573,31,23808,961,138384,162192
train,6574,39,29952,1521,219024,248976
train,6575,34,26112,1156,166464,192576
train,6576,13,9984,169,24336,34320
train,6577,13,9984,169,24336,34320
train,6578,18,13824,324,46656,60480
train,6579,28,21504,784,112896,134400
train,6580,15,11520,225,32400,43920
train,6581,48,36864,2304,331776,368640
train,6582,7,5376,49,7056,12432
train,6583,18,13824,324,46656,60480
train,6584,19,14592,361,51984,66576
train,6585,32,24576,1024,147456,172032
train,6586,25,19200,625,90000,109200
train,6587,33,25344,1089,156816,182160
train,6588,32,24576,1024,147456,172032
train,6589,16,12288,256,36864,49152
train,6590,15,11520,225,32400,43920
train,6591,18,13824,324,46656,60480
train,6592,28,21504,784,112896,134400
train,6593,14,10752,196,28224,38976
train,6594,16,12288,256,36864,49152
train,6595,31,23808,961,138384,162192
train,6596,52,39936,2704,389376,429312
train,6597,14,10752,196,28224,38976
train,6598,21,16128,441,63504,79632
train,6599,29,22272,841,121104,143376
train,6600,18,13824,324,46656,60480
train,6601,9,6912,81,11664,18576
train,6602,13,9984,169,24336,34320
train,6603,22,16896,484,69696,86592
train,6604,28,21504,784,112896,134400
train,6605,6,4608,36,5184,9792
train,6606,14,10752,196,28224,38976
train,6607,37,28416,1369,197136,225552
train,6608,19,14592,361,51984,66576
train,6609,19,14592,361,51984,66576
train,6610,23,17664,529,76176,93840
train,6611,21,16128,441,63504,79632
train,6612,29,22272,841,121104,143376
train,6613,29,22272,841,121104,143376
train,6614,5,3840,25,3600,7440
train,6615,20,15360,400,57600,72960
train,6616,19,14592,361,51984,66576
train,6617,21,16128,441,63504,79632
train,6618,43,33024,1849,266256,299280
train,6619,29,22272,841,121104,143376
train,6620,30,23040,900,129600,152640
train,6621,23,17664,529,76176,93840
train,6622,29,22272,841,121104,143376
train,6623,34,26112,1156,166464,192576
train,6624,10,7680,100,14400,22080
train,6625,21,16128,441,63504,79632
train,6626,20,15360,400,57600,72960
train,6627,42,32256,1764,254016,286272
train,6628,22,16896,484,69696,86592
train,6629,8,6144,64,9216,15360
train,6630,35,26880,1225,176400,203280
train,6631,16,12288,256,36864,49152
train,6632,27,20736,729,104976,125712
train,6633,20,15360,400,57600,72960
train,6634,21,16128,441,63504,79632
train,6635,30,23040,900,129600,152640
train,6636,26,19968,676,97344,117312
train,6637,21,16128,441,63504,79632
train,6638,6,4608,36,5184,9792
train,6639,17,13056,289,41616,54672
train,6640,8,6144,64,9216,15360
train,6641,19,14592,361,51984,66576
train,6642,45,34560,2025,291600,326160
train,6643,12,9216,144,20736,29952
train,6644,25,19200,625,90000,109200
train,6645,10,7680,100,14400,22080
train,6646,42,32256,1764,254016,286272
train,6647,44,33792,1936,278784,312576
train,6648,34,26112,1156,166464,192576
train,6649,25,19200,625,90000,109200
train,6650,27,20736,729,104976,125712
train,6651,15,11520,225,32400,43920
train,6652,32,24576,1024,147456,172032
train,6653,31,23808,961,138384,162192
train,6654,14,10752,196,28224,38976
train,6655,27,20736,729,104976,125712
train,6656,34,26112,1156,166464,192576
train,6657,25,19200,625,90000,109200
train,6658,16,12288,256,36864,49152
train,6659,27,20736,729,104976,125712
train,6660,31,23808,961,138384,162192
train,6661,13,9984,169,24336,34320
train,6662,13,9984,169,24336,34320
train,6663,32,24576,1024,147456,172032
train,6664,23,17664,529,76176,93840
train,6665,13,9984,169,24336,34320
train,6666,15,11520,225,32400,43920
train,6667,8,6144,64,9216,15360
train,6668,39,29952,1521,219024,248976
train,6669,31,23808,961,138384,162192
train,6670,29,22272,841,121104,143376
train,6671,35,26880,1225,176400,203280
train,6672,19,14592,361,51984,66576
train,6673,44,33792,1936,278784,312576
train,6674,15,11520,225,32400,43920
train,6675,15,11520,225,32400,43920
train,6676,9,6912,81,11664,18576
train,6677,19,14592,361,51984,66576
train,6678,32,24576,1024,147456,172032
train,6679,26,19968,676,97344,117312
train,6680,30,23040,900,129600,152640
train,6681,23,17664,529,76176,93840
train,6682,27,20736,729,104976,125712
train,6683,60,46080,3600,518400,564480
train,6684,31,23808,961,138384,162192
train,6685,25,19200,625,90000,109200
train,6686,15,11520,225,32400,43920
train,6687,5,3840,25,3600,7440
train,6688,16,12288,256,36864,49152
train,6689,14,10752,196,28224,38976
train,6690,19,14592,361,51984,66576
train,6691,35,26880,1225,176400,203280
train,6692,28,21504,784,112896,134400
train,6693,17,13056,289,41616,54672
train,6694,24,18432,576,82944,101376
train,6695,48,36864,2304,331776,368640
train,6696,44,33792,1936,278784,312576
train,6697,37,28416,1369,197136,225552
train,6698,41,31488,1681,242064,273552
train,6699,14,10752,196,28224,38976
train,6700,28,21504,784,112896,134400
train,6701,7,5376,49,7056,12432
train,6702,30,23040,900,129600,152640
train,6703,16,12288,256,36864,49152
train,6704,28,21504,784,112896,134400
train,6705,6,4608,36,5184,9792
train,6706,18,13824,324,46656,60480
train,6707,24,18432,576,82944,101376
train,6708,14,10752,196,28224,38976
train,6709,19,14592,361,51984,66576
train,6710,26,19968,676,97344,117312
train,6711,38,29184,1444,207936,237120
train,6712,48,36864,2304,331776,368640
train,6713,37,28416,1369,197136,225552
train,6714,26,19968,676,97344,117312
train,6715,28,21504,784,112896,134400
train,6716,23,17664,529,76176,93840
train,6717,35,26880,1225,176400,203280
train,6718,11,8448,121,17424,25872
train,6719,20,15360,400,57600,72960
train,6720,11,8448,121,17424,25872
train,6721,16,12288,256,36864,49152
train,6722,37,28416,1369,197136,225552
train,6723,11,8448,121,17424,25872
train,6724,22,16896,484,69696,86592
train,6725,20,15360,400,57600,72960
train,6726,30,23040,900,129600,152640
train,6727,40,30720,1600,230400,261120
train,6728,16,12288,256,36864,49152
train,6729,15,11520,225,32400,43920
train,6730,6,4608,36,5184,9792
train,6731,7,5376,49,7056,12432
train,6732,43,33024,1849,266256,299280
train,6733,22,16896,484,69696,86592
train,6734,33,25344,1089,156816,182160
train,6735,44,33792,1936,278784,312576
train,6736,25,19200,625,90000,109200
train,6737,16,12288,256,36864,49152
train,6738,15,11520,225,32400,43920
train,6739,21,16128,441,63504,79632
train,6740,42,32256,1764,254016,286272
train,6741,36,27648,1296,186624,214272
train,6742,16,12288,256,36864,49152
train,6743,33,25344,1089,156816,182160
train,6744,21,16128,441,63504,79632
train,6745,18,13824,324,46656,60480
train,6746,29,22272,841,121104,143376
train,6747,11,8448,121,17424,25872
train,6748,7,5376,49,7056,12432
train,6749,18,13824,324,46656,60480
train,6750,41,31488,1681,242064,273552
train,6751,22,16896,484,69696,86592
train,6752,30,23040,900,129600,152640
train,6753,32,24576,1024,147456,172032
train,6754,28,21504,784,112896,134400
train,6755,6,4608,36,5184,9792
train,6756,19,14592,361,51984,66576
train,6757,27,20736,729,104976,125712
train,6758,23,17664,529,76176,93840
train,6759,24,18432,576,82944,101376
train,6760,21,16128,441,63504,79632
train,6761,12,9216,144,20736,29952
train,6762,42,32256,1764,254016,286272
train,6763,26,19968,676,97344,117312
train,6764,37,28416,1369,197136,225552
train,6765,47,36096,2209,318096,354192
train,6766,42,32256,1764,254016,286272
train,6767,22,16896,484,69696,86592
train,6768,32,24576,1024,147456,172032
train,6769,8,6144,64,9216,15360
train,6770,11,8448,121,17424,25872
train,6771,9,6912,81,11664,18576
train,6772,14,10752,196,28224,38976
train,6773,9,6912,81,11664,18576
train,6774,6,4608,36,5184,9792
train,6775,39,29952,1521,219024,248976
train,6776,7,5376,49,7056,12432
train,6777,17,13056,289,41616,54672
train,6778,30,23040,900,129600,152640
train,6779,33,25344,1089,156816,182160
train,6780,34,26112,1156,166464,192576
train,6781,26,19968,676,97344,117312
train,6782,41,31488,1681,242064,273552
train,6783,33,25344,1089,156816,182160
train,6784,44,33792,1936,278784,312576
train,6785,34,26112,1156,166464,192576
train,6786,14,10752,196,28224,38976
train,6787,14,10752,196,28224,38976
train,6788,34,26112,1156,166464,192576
train,6789,25,19200,625,90000,109200
train,6790,10,7680,100,14400,22080
train,6791,43,33024,1849,266256,299280
train,6792,30,23040,900,129600,152640
train,6793,43,33024,1849,266256,299280
train,6794,23,17664,529,76176,93840
train,6795,24,18432,576,82944,101376
train,6796,13,9984,169,24336,34320
train,6797,22,16896,484,69696,86592
train,6798,11,8448,121,17424,25872
train,6799,29,22272,841,121104,143376
train,6800,8,6144,64,9216,15360
train,6801,15,11520,225,32400,43920
train,6802,16,12288,256,36864,49152
train,6803,18,13824,324,46656,60480
train,6804,27,20736,729,104976,125712
train,6805,12,9216,144,20736,29952
train,6806,43,33024,1849,266256,299280
train,6807,12,9216,144,20736,29952
train,6808,21,16128,441,63504,79632
train,6809,13,9984,169,24336,34320
train,6810,23,17664,529,76176,93840
train,6811,29,22272,841,121104,143376
train,6812,25,19200,625,90000,109200
train,6813,27,20736,729,104976,125712
train,6814,10,7680,100,14400,22080
train,6815,43,33024,1849,266256,299280
train,6816,27,20736,729,104976,125712
train,6817,35,26880,1225,176400,203280
train,6818,22,16896,484,69696,86592
train,6819,20,15360,400,57600,72960
train,6820,35,26880,1225,176400,203280
train,6821,26,19968,676,97344,117312
train,6822,9,6912,81,11664,18576
train,6823,20,15360,400,57600,72960
train,6824,13,9984,169,24336,34320
train,6825,42,32256,1764,254016,286272
train,6826,52,39936,2704,389376,429312
train,6827,30,23040,900,129600,152640
train,6828,11,8448,121,17424,25872
train,6829,34,26112,1156,166464,192576
train,6830,33,25344,1089,156816,182160
train,6831,13,9984,169,24336,34320
train,6832,31,23808,961,138384,162192
train,6833,45,34560,2025,291600,326160
train,6834,48,36864,2304,331776,368640
train,6835,23,17664,529,76176,93840
train,6836,27,20736,729,104976,125712
train,6837,18,13824,324,46656,60480
train,6838,24,18432,576,82944,101376
train,6839,26,19968,676,97344,117312
train,6840,8,6144,64,9216,15360
train,6841,15,11520,225,32400,43920
train,6842,31,23808,961,138384,162192
train,6843,10,7680,100,14400,22080
train,6844,26,19968,676,97344,117312
train,6845,33,25344,1089,156816,182160
train,6846,27,20736,729,104976,125712
train,6847,36,27648,1296,186624,214272
train,6848,18,13824,324,46656,60480
train,6849,33,25344,1089,156816,182160
train,6850,51,39168,2601,374544,413712
train,6851,39,29952,1521,219024,248976
train,6852,25,19200,625,90000,109200
train,6853,21,16128,441,63504,79632
train,6854,19,14592,361,51984,66576
train,6855,28,21504,784,112896,134400
train,6856,22,16896,484,69696,86592
train,6857,25,19200,625,90000,109200
train,6858,19,14592,361,51984,66576
train,6859,20,15360,400,57600,72960
train,6860,30,23040,900,129600,152640
train,6861,25,19200,625,90000,109200
train,6862,23,17664,529,76176,93840
train,6863,18,13824,324,46656,60480
train,6864,36,27648,1296,186624,214272
train,6865,41,31488,1681,242064,273552
train,6866,30,23040,900,129600,152640
train,6867,36,27648,1296,186624,214272
train,6868,51,39168,2601,374544,413712
train,6869,24,18432,576,82944,101376
train,6870,27,20736,729,104976,125712
train,6871,19,14592,361,51984,66576
train,6872,24,18432,576,82944,101376
train,6873,21,16128,441,63504,79632
train,6874,18,13824,324,46656,60480
train,6875,30,23040,900,129600,152640
train,6876,46,35328,2116,304704,340032
train,6877,21,16128,441,63504,79632
train,6878,30,23040,900,129600,152640
train,6879,9,6912,81,11664,18576
train,6880,18,13824,324,46656,60480
train,6881,43,33024,1849,266256,299280
train,6882,15,11520,225,32400,43920
train,6883,19,14592,361,51984,66576
train,6884,25,19200,625,90000,109200
train,6885,29,22272,841,121104,143376
train,6886,33,25344,1089,156816,182160
train,6887,33,25344,1089,156816,182160
train,6888,37,28416,1369,197136,225552
train,6889,48,36864,2304,331776,368640
train,6890,20,15360,400,57600,72960
train,6891,36,27648,1296,186624,214272
train,6892,16,12288,256,36864,49152
train,6893,21,16128,441,63504,79632
train,6894,24,18432,576,82944,101376
train,6895,11,8448,121,17424,25872
train,6896,23,17664,529,76176,93840
train,6897,30,23040,900,129600,152640
train,6898,37,28416,1369,197136,225552
train,6899,30,23040,900,129600,152640
train,6900,24,18432,576,82944,101376
train,6901,12,9216,144,20736,29952
train,6902,14,10752,196,28224,38976
train,6903,22,16896,484,69696,86592
train,6904,30,23040,900,129600,152640
train,6905,20,15360,400,57600,72960
train,6906,10,7680,100,14400,22080
train,6907,28,21504,784,112896,134400
train,6908,19,14592,361,51984,66576
train,6909,17,13056,289,41616,54672
train,6910,13,9984,169,24336,34320
train,6911,22,16896,484,69696,86592
train,6912,24,18432,576,82944,101376
train,6913,22,16896,484,69696,86592
train,6914,22,16896,484,69696,86592
train,6915,32,24576,1024,147456,172032
train,6916,25,19200,625,90000,109200
train,6917,14,10752,196,28224,38976
train,6918,23,17664,529,76176,93840
train,6919,37,28416,1369,197136,225552
validation,0,26,19968,676,97344,117312
validation,1,35,26880,1225,176400,203280
validation,2,35,26880,1225,176400,203280
validation,3,36,27648,1296,186624,214272
validation,4,29,22272,841,121104,143376
validation,5,26,19968,676,97344,117312
validation,6,21,16128,441,63504,79632
validation,7,26,19968,676,97344,117312
validation,8,22,16896,484,69696,86592
validation,9,35,26880,1225,176400,203280
validation,10,29,22272,841,121104,143376
validation,11,17,13056,289,41616,54672
validation,12,25,19200,625,90000,109200
validation,13,54,41472,2916,419904,461376
validation,14,25,19200,625,90000,109200
validation,15,16,12288,256,36864,49152
validation,16,12,9216,144,20736,29952
validation,17,14,10752,196,28224,38976
validation,18,24,18432,576,82944,101376
validation,19,14,10752,196,28224,38976
validation,20,38,29184,1444,207936,237120
validation,21,32,24576,1024,147456,172032
validation,22,12,9216,144,20736,29952
validation,23,9,6912,81,11664,18576
validation,24,30,23040,900,129600,152640
validation,25,53,40704,2809,404496,445200
validation,26,15,11520,225,32400,43920
validation,27,15,11520,225,32400,43920
validation,28,45,34560,2025,291600,326160
validation,29,18,13824,324,46656,60480
validation,30,18,13824,324,46656,60480
validation,31,49,37632,2401,345744,383376
validation,32,23,17664,529,76176,93840
validation,33,39,29952,1521,219024,248976
validation,34,20,15360,400,57600,72960
validation,35,40,30720,1600,230400,261120
validation,36,33,25344,1089,156816,182160
validation,37,25,19200,625,90000,109200
validation,38,24,18432,576,82944,101376
validation,39,33,25344,1089,156816,182160
validation,40,37,28416,1369,197136,225552
validation,41,14,10752,196,28224,38976
validation,42,34,26112,1156,166464,192576
validation,43,14,10752,196,28224,38976
validation,44,32,24576,1024,147456,172032
validation,45,36,27648,1296,186624,214272
validation,46,20,15360,400,57600,72960
validation,47,15,11520,225,32400,43920
validation,48,9,6912,81,11664,18576
validation,49,14,10752,196,28224,38976
validation,50,27,20736,729,104976,125712
validation,51,34,26112,1156,166464,192576
validation,52,20,15360,400,57600,72960
validation,53,12,9216,144,20736,29952
validation,54,23,17664,529,76176,93840
validation,55,30,23040,900,129600,152640
validation,56,21,16128,441,63504,79632
validation,57,21,16128,441,63504,79632
validation,58,18,13824,324,46656,60480
validation,59,21,16128,441,63504,79632
validation,60,7,5376,49,7056,12432
validation,61,16,12288,256,36864,49152
validation,62,14,10752,196,28224,38976
validation,63,22,16896,484,69696,86592
validation,64,13,9984,169,24336,34320
validation,65,27,20736,729,104976,125712
validation,66,34,26112,1156,166464,192576
validation,67,9,6912,81,11664,18576
validation,68,15,11520,225,32400,43920
validation,69,32,24576,1024,147456,172032
validation,70,20,15360,400,57600,72960
validation,71,31,23808,961,138384,162192
validation,72,18,13824,324,46656,60480
validation,73,27,20736,729,104976,125712
validation,74,30,23040,900,129600,152640
validation,75,19,14592,361,51984,66576
validation,76,34,26112,1156,166464,192576
validation,77,29,22272,841,121104,143376
validation,78,19,14592,361,51984,66576
validation,79,30,23040,900,129600,152640
validation,80,48,36864,2304,331776,368640
validation,81,17,13056,289,41616,54672
validation,82,25,19200,625,90000,109200
validation,83,44,33792,1936,278784,312576
validation,84,35,26880,1225,176400,203280
validation,85,24,18432,576,82944,101376
validation,86,16,12288,256,36864,49152
validation,87,22,16896,484,69696,86592
validation,88,19,14592,361,51984,66576
validation,89,34,26112,1156,166464,192576
validation,90,17,13056,289,41616,54672
validation,91,28,21504,784,112896,134400
validation,92,28,21504,784,112896,134400
validation,93,20,15360,400,57600,72960
validation,94,27,20736,729,104976,125712
validation,95,34,26112,1156,166464,192576
validation,96,52,39936,2704,389376,429312
validation,97,38,29184,1444,207936,237120
validation,98,23,17664,529,76176,93840
validation,99,21,16128,441,63504,79632
validation,100,44,33792,1936,278784,312576
validation,101,20,15360,400,57600,72960
validation,102,22,16896,484,69696,86592
validation,103,49,37632,2401,345744,383376
validation,104,24,18432,576,82944,101376
validation,105,20,15360,400,57600,72960
validation,106,29,22272,841,121104,143376
validation,107,47,36096,2209,318096,354192
validation,108,14,10752,196,28224,38976
validation,109,21,16128,441,63504,79632
validation,110,35,26880,1225,176400,203280
validation,111,41,31488,1681,242064,273552
validation,112,34,26112,1156,166464,192576
validation,113,27,20736,729,104976,125712
validation,114,34,26112,1156,166464,192576
validation,115,8,6144,64,9216,15360
validation,116,43,33024,1849,266256,299280
validation,117,33,25344,1089,156816,182160
validation,118,21,16128,441,63504,79632
validation,119,21,16128,441,63504,79632
validation,120,29,22272,841,121104,143376
validation,121,38,29184,1444,207936,237120
validation,122,29,22272,841,121104,143376
validation,123,12,9216,144,20736,29952
validation,124,36,27648,1296,186624,214272
validation,125,14,10752,196,28224,38976
validation,126,24,18432,576,82944,101376
validation,127,27,20736,729,104976,125712
validation,128,47,36096,2209,318096,354192
validation,129,36,27648,1296,186624,214272
validation,130,34,26112,1156,166464,192576
validation,131,30,23040,900,129600,152640
validation,132,41,31488,1681,242064,273552
validation,133,46,35328,2116,304704,340032
validation,134,32,24576,1024,147456,172032
validation,135,30,23040,900,129600,152640
validation,136,23,17664,529,76176,93840
validation,137,44,33792,1936,278784,312576
validation,138,30,23040,900,129600,152640
validation,139,17,13056,289,41616,54672
validation,140,36,27648,1296,186624,214272
validation,141,45,34560,2025,291600,326160
validation,142,33,25344,1089,156816,182160
validation,143,22,16896,484,69696,86592
validation,144,22,16896,484,69696,86592
validation,145,39,29952,1521,219024,248976
validation,146,39,29952,1521,219024,248976
validation,147,30,23040,900,129600,152640
validation,148,39,29952,1521,219024,248976
validation,149,20,15360,400,57600,72960
validation,150,44,33792,1936,278784,312576
validation,151,28,21504,784,112896,134400
validation,152,11,8448,121,17424,25872
validation,153,14,10752,196,28224,38976
validation,154,23,17664,529,76176,93840
validation,155,9,6912,81,11664,18576
validation,156,13,9984,169,24336,34320
validation,157,25,19200,625,90000,109200
validation,158,27,20736,729,104976,125712
validation,159,14,10752,196,28224,38976
validation,160,18,13824,324,46656,60480
validation,161,21,16128,441,63504,79632
validation,162,22,16896,484,69696,86592
validation,163,37,28416,1369,197136,225552
validation,164,11,8448,121,17424,25872
validation,165,22,16896,484,69696,86592
validation,166,32,24576,1024,147456,172032
validation,167,33,25344,1089,156816,182160
validation,168,16,12288,256,36864,49152
validation,169,12,9216,144,20736,29952
validation,170,23,17664,529,76176,93840
validation,171,24,18432,576,82944,101376
validation,172,26,19968,676,97344,117312
validation,173,27,20736,729,104976,125712
validation,174,27,20736,729,104976,125712
validation,175,44,33792,1936,278784,312576
validation,176,13,9984,169,24336,34320
validation,177,27,20736,729,104976,125712
validation,178,35,26880,1225,176400,203280
validation,179,23,17664,529,76176,93840
validation,180,27,20736,729,104976,125712
validation,181,39,29952,1521,219024,248976
validation,182,25,19200,625,90000,109200
validation,183,21,16128,441,63504,79632
validation,184,29,22272,841,121104,143376
validation,185,11,8448,121,17424,25872
validation,186,26,19968,676,97344,117312
validation,187,34,26112,1156,166464,192576
validation,188,22,16896,484,69696,86592
validation,189,16,12288,256,36864,49152
validation,190,39,29952,1521,219024,248976
validation,191,29,22272,841,121104,143376
validation,192,34,26112,1156,166464,192576
validation,193,18,13824,324,46656,60480
validation,194,17,13056,289,41616,54672
validation,195,14,10752,196,28224,38976
validation,196,13,9984,169,24336,34320
validation,197,20,15360,400,57600,72960
validation,198,42,32256,1764,254016,286272
validation,199,19,14592,361,51984,66576
validation,200,40,30720,1600,230400,261120
validation,201,36,27648,1296,186624,214272
validation,202,10,7680,100,14400,22080
validation,203,12,9216,144,20736,29952
validation,204,30,23040,900,129600,152640
validation,205,19,14592,361,51984,66576
validation,206,17,13056,289,41616,54672
validation,207,33,25344,1089,156816,182160
validation,208,53,40704,2809,404496,445200
validation,209,5,3840,25,3600,7440
validation,210,22,16896,484,69696,86592
validation,211,12,9216,144,20736,29952
validation,212,14,10752,196,28224,38976
validation,213,31,23808,961,138384,162192
validation,214,22,16896,484,69696,86592
validation,215,12,9216,144,20736,29952
validation,216,37,28416,1369,197136,225552
validation,217,40,30720,1600,230400,261120
validation,218,30,23040,900,129600,152640
validation,219,28,21504,784,112896,134400
validation,220,26,19968,676,97344,117312
validation,221,19,14592,361,51984,66576
validation,222,22,16896,484,69696,86592
validation,223,43,33024,1849,266256,299280
validation,224,47,36096,2209,318096,354192
validation,225,28,21504,784,112896,134400
validation,226,27,20736,729,104976,125712
validation,227,24,18432,576,82944,101376
validation,228,37,28416,1369,197136,225552
validation,229,18,13824,324,46656,60480
validation,230,25,19200,625,90000,109200
validation,231,14,10752,196,28224,38976
validation,232,7,5376,49,7056,12432
validation,233,28,21504,784,112896,134400
validation,234,13,9984,169,24336,34320
validation,235,25,19200,625,90000,109200
validation,236,28,21504,784,112896,134400
validation,237,27,20736,729,104976,125712
validation,238,15,11520,225,32400,43920
validation,239,21,16128,441,63504,79632
validation,240,18,13824,324,46656,60480
validation,241,19,14592,361,51984,66576
validation,242,15,11520,225,32400,43920
validation,243,9,6912,81,11664,18576
validation,244,12,9216,144,20736,29952
validation,245,27,20736,729,104976,125712
validation,246,10,7680,100,14400,22080
validation,247,20,15360,400,57600,72960
validation,248,19,14592,361,51984,66576
validation,249,51,39168,2601,374544,413712
validation,250,20,15360,400,57600,72960
validation,251,39,29952,1521,219024,248976
validation,252,25,19200,625,90000,109200
validation,253,37,28416,1369,197136,225552
validation,254,25,19200,625,90000,109200
validation,255,18,13824,324,46656,60480
validation,256,15,11520,225,32400,43920
validation,257,47,36096,2209,318096,354192
validation,258,18,13824,324,46656,60480
validation,259,26,19968,676,97344,117312
validation,260,38,29184,1444,207936,237120
validation,261,20,15360,400,57600,72960
validation,262,29,22272,841,121104,143376
validation,263,20,15360,400,57600,72960
validation,264,19,14592,361,51984,66576
validation,265,10,7680,100,14400,22080
validation,266,35,26880,1225,176400,203280
validation,267,25,19200,625,90000,109200
validation,268,25,19200,625,90000,109200
validation,269,27,20736,729,104976,125712
validation,270,25,19200,625,90000,109200
validation,271,14,10752,196,28224,38976
validation,272,20,15360,400,57600,72960
validation,273,21,16128,441,63504,79632
validation,274,8,6144,64,9216,15360
validation,275,10,7680,100,14400,22080
validation,276,29,22272,841,121104,143376
validation,277,31,23808,961,138384,162192
validation,278,41,31488,1681,242064,273552
validation,279,24,18432,576,82944,101376
validation,280,20,15360,400,57600,72960
validation,281,41,31488,1681,242064,273552
validation,282,28,21504,784,112896,134400
validation,283,11,8448,121,17424,25872
validation,284,19,14592,361,51984,66576
validation,285,41,31488,1681,242064,273552
validation,286,14,10752,196,28224,38976
validation,287,22,16896,484,69696,86592
validation,288,29,22272,841,121104,143376
validation,289,29,22272,841,121104,143376
validation,290,26,19968,676,97344,117312
validation,291,21,16128,441,63504,79632
validation,292,10,7680,100,14400,22080
validation,293,15,11520,225,32400,43920
validation,294,29,22272,841,121104,143376
validation,295,35,26880,1225,176400,203280
validation,296,30,23040,900,129600,152640
validation,297,12,9216,144,20736,29952
validation,298,18,13824,324,46656,60480
validation,299,25,19200,625,90000,109200
validation,300,14,10752,196,28224,38976
validation,301,25,19200,625,90000,109200
validation,302,13,9984,169,24336,34320
validation,303,32,24576,1024,147456,172032
validation,304,28,21504,784,112896,134400
validation,305,9,6912,81,11664,18576
validation,306,20,15360,400,57600,72960
validation,307,24,18432,576,82944,101376
validation,308,36,27648,1296,186624,214272
validation,309,16,12288,256,36864,49152
validation,310,16,12288,256,36864,49152
validation,311,24,18432,576,82944,101376
validation,312,26,19968,676,97344,117312
validation,313,19,14592,361,51984,66576
validation,314,24,18432,576,82944,101376
validation,315,21,16128,441,63504,79632
validation,316,17,13056,289,41616,54672
validation,317,27,20736,729,104976,125712
validation,318,28,21504,784,112896,134400
validation,319,26,19968,676,97344,117312
validation,320,37,28416,1369,197136,225552
validation,321,16,12288,256,36864,49152
validation,322,11,8448,121,17424,25872
validation,323,20,15360,400,57600,72960
validation,324,18,13824,324,46656,60480
validation,325,31,23808,961,138384,162192
validation,326,37,28416,1369,197136,225552
validation,327,16,12288,256,36864,49152
validation,328,15,11520,225,32400,43920
validation,329,17,13056,289,41616,54672
validation,330,20,15360,400,57600,72960
validation,331,31,23808,961,138384,162192
validation,332,25,19200,625,90000,109200
validation,333,20,15360,400,57600,72960
validation,334,30,23040,900,129600,152640
validation,335,27,20736,729,104976,125712
validation,336,32,24576,1024,147456,172032
validation,337,18,13824,324,46656,60480
validation,338,40,30720,1600,230400,261120
validation,339,42,32256,1764,254016,286272
validation,340,7,5376,49,7056,12432
validation,341,25,19200,625,90000,109200
validation,342,28,21504,784,112896,134400
validation,343,29,22272,841,121104,143376
validation,344,11,8448,121,17424,25872
validation,345,22,16896,484,69696,86592
validation,346,12,9216,144,20736,29952
validation,347,16,12288,256,36864,49152
validation,348,10,7680,100,14400,22080
validation,349,22,16896,484,69696,86592
validation,350,25,19200,625,90000,109200
validation,351,21,16128,441,63504,79632
validation,352,28,21504,784,112896,134400
validation,353,15,11520,225,32400,43920
validation,354,14,10752,196,28224,38976
validation,355,4,3072,16,2304,5376
validation,356,8,6144,64,9216,15360
validation,357,39,29952,1521,219024,248976
validation,358,17,13056,289,41616,54672
validation,359,35,26880,1225,176400,203280
validation,360,25,19200,625,90000,109200
validation,361,10,7680,100,14400,22080
validation,362,43,33024,1849,266256,299280
validation,363,24,18432,576,82944,101376
validation,364,19,14592,361,51984,66576
validation,365,46,35328,2116,304704,340032
validation,366,10,7680,100,14400,22080
validation,367,54,41472,2916,419904,461376
validation,368,10,7680,100,14400,22080
validation,369,30,23040,900,129600,152640
validation,370,18,13824,324,46656,60480
validation,371,28,21504,784,112896,134400
validation,372,30,23040,900,129600,152640
validation,373,36,27648,1296,186624,214272
validation,374,25,19200,625,90000,109200
validation,375,41,31488,1681,242064,273552
validation,376,27,20736,729,104976,125712
validation,377,31,23808,961,138384,162192
validation,378,7,5376,49,7056,12432
validation,379,23,17664,529,76176,93840
validation,380,36,27648,1296,186624,214272
validation,381,26,19968,676,97344,117312
validation,382,43,33024,1849,266256,299280
validation,383,21,16128,441,63504,79632
validation,384,20,15360,400,57600,72960
validation,385,50,38400,2500,360000,398400
validation,386,16,12288,256,36864,49152
validation,387,16,12288,256,36864,49152
validation,388,8,6144,64,9216,15360
validation,389,22,16896,484,69696,86592
validation,390,14,10752,196,28224,38976
validation,391,25,19200,625,90000,109200
validation,392,8,6144,64,9216,15360
validation,393,35,26880,1225,176400,203280
validation,394,28,21504,784,112896,134400
validation,395,40,30720,1600,230400,261120
validation,396,21,16128,441,63504,79632
validation,397,19,14592,361,51984,66576
validation,398,32,24576,1024,147456,172032
validation,399,10,7680,100,14400,22080
validation,400,8,6144,64,9216,15360
validation,401,41,31488,1681,242064,273552
validation,402,33,25344,1089,156816,182160
validation,403,31,23808,961,138384,162192
validation,404,28,21504,784,112896,134400
validation,405,23,17664,529,76176,93840
validation,406,14,10752,196,28224,38976
validation,407,20,15360,400,57600,72960
validation,408,29,22272,841,121104,143376
validation,409,7,5376,49,7056,12432
validation,410,19,14592,361,51984,66576
validation,411,34,26112,1156,166464,192576
validation,412,24,18432,576,82944,101376
validation,413,8,6144,64,9216,15360
validation,414,15,11520,225,32400,43920
validation,415,39,29952,1521,219024,248976
validation,416,38,29184,1444,207936,237120
validation,417,14,10752,196,28224,38976
validation,418,32,24576,1024,147456,172032
validation,419,22,16896,484,69696,86592
validation,420,36,27648,1296,186624,214272
validation,421,25,19200,625,90000,109200
validation,422,40,30720,1600,230400,261120
validation,423,35,26880,1225,176400,203280
validation,424,34,26112,1156,166464,192576
validation,425,16,12288,256,36864,49152
validation,426,33,25344,1089,156816,182160
validation,427,28,21504,784,112896,134400
validation,428,54,41472,2916,419904,461376
validation,429,20,15360,400,57600,72960
validation,430,40,30720,1600,230400,261120
validation,431,25,19200,625,90000,109200
validation,432,11,8448,121,17424,25872
validation,433,22,16896,484,69696,86592
validation,434,18,13824,324,46656,60480
validation,435,27,20736,729,104976,125712
validation,436,16,12288,256,36864,49152
validation,437,26,19968,676,97344,117312
validation,438,17,13056,289,41616,54672
validation,439,18,13824,324,46656,60480
validation,440,12,9216,144,20736,29952
validation,441,23,17664,529,76176,93840
validation,442,10,7680,100,14400,22080
validation,443,24,18432,576,82944,101376
validation,444,41,31488,1681,242064,273552
validation,445,41,31488,1681,242064,273552
validation,446,19,14592,361,51984,66576
validation,447,15,11520,225,32400,43920
validation,448,16,12288,256,36864,49152
validation,449,10,7680,100,14400,22080
validation,450,41,31488,1681,242064,273552
validation,451,34,26112,1156,166464,192576
validation,452,36,27648,1296,186624,214272
validation,453,39,29952,1521,219024,248976
validation,454,22,16896,484,69696,86592
validation,455,16,12288,256,36864,49152
validation,456,27,20736,729,104976,125712
validation,457,12,9216,144,20736,29952
validation,458,31,23808,961,138384,162192
validation,459,36,27648,1296,186624,214272
validation,460,17,13056,289,41616,54672
validation,461,18,13824,324,46656,60480
validation,462,39,29952,1521,219024,248976
validation,463,22,16896,484,69696,86592
validation,464,20,15360,400,57600,72960
validation,465,23,17664,529,76176,93840
validation,466,24,18432,576,82944,101376
validation,467,15,11520,225,32400,43920
validation,468,11,8448,121,17424,25872
validation,469,34,26112,1156,166464,192576
validation,470,38,29184,1444,207936,237120
validation,471,30,23040,900,129600,152640
validation,472,11,8448,121,17424,25872
validation,473,25,19200,625,90000,109200
validation,474,33,25344,1089,156816,182160
validation,475,24,18432,576,82944,101376
validation,476,32,24576,1024,147456,172032
validation,477,37,28416,1369,197136,225552
validation,478,28,21504,784,112896,134400
validation,479,23,17664,529,76176,93840
validation,480,29,22272,841,121104,143376
validation,481,37,28416,1369,197136,225552
validation,482,10,7680,100,14400,22080
validation,483,25,19200,625,90000,109200
validation,484,44,33792,1936,278784,312576
validation,485,24,18432,576,82944,101376
validation,486,9,6912,81,11664,18576
validation,487,34,26112,1156,166464,192576
validation,488,13,9984,169,24336,34320
validation,489,25,19200,625,90000,109200
validation,490,19,14592,361,51984,66576
validation,491,10,7680,100,14400,22080
validation,492,28,21504,784,112896,134400
validation,493,21,16128,441,63504,79632
validation,494,24,18432,576,82944,101376
validation,495,19,14592,361,51984,66576
validation,496,37,28416,1369,197136,225552
validation,497,19,14592,361,51984,66576
validation,498,41,31488,1681,242064,273552
validation,499,37,28416,1369,197136,225552
validation,500,26,19968,676,97344,117312
validation,501,28,21504,784,112896,134400
validation,502,12,9216,144,20736,29952
validation,503,23,17664,529,76176,93840
validation,504,26,19968,676,97344,117312
validation,505,25,19200,625,90000,109200
validation,506,12,9216,144,20736,29952
validation,507,30,23040,900,129600,152640
validation,508,22,16896,484,69696,86592
validation,509,42,32256,1764,254016,286272
validation,510,25,19200,625,90000,109200
validation,511,27,20736,729,104976,125712
validation,512,23,17664,529,76176,93840
validation,513,16,12288,256,36864,49152
validation,514,30,23040,900,129600,152640
validation,515,11,8448,121,17424,25872
validation,516,17,13056,289,41616,54672
validation,517,17,13056,289,41616,54672
validation,518,21,16128,441,63504,79632
validation,519,52,39936,2704,389376,429312
validation,520,40,30720,1600,230400,261120
validation,521,13,9984,169,24336,34320
validation,522,34,26112,1156,166464,192576
validation,523,35,26880,1225,176400,203280
validation,524,32,24576,1024,147456,172032
validation,525,24,18432,576,82944,101376
validation,526,30,23040,900,129600,152640
validation,527,10,7680,100,14400,22080
validation,528,22,16896,484,69696,86592
validation,529,20,15360,400,57600,72960
validation,530,29,22272,841,121104,143376
validation,531,25,19200,625,90000,109200
validation,532,48,36864,2304,331776,368640
validation,533,41,31488,1681,242064,273552
validation,534,26,19968,676,97344,117312
validation,535,34,26112,1156,166464,192576
validation,536,29,22272,841,121104,143376
validation,537,33,25344,1089,156816,182160
validation,538,19,14592,361,51984,66576
validation,539,21,16128,441,63504,79632
validation,540,27,20736,729,104976,125712
validation,541,20,15360,400,57600,72960
validation,542,18,13824,324,46656,60480
validation,543,15,11520,225,32400,43920
validation,544,20,15360,400,57600,72960
validation,545,21,16128,441,63504,79632
validation,546,25,19200,625,90000,109200
validation,547,17,13056,289,41616,54672
validation,548,12,9216,144,20736,29952
validation,549,40,30720,1600,230400,261120
validation,550,21,16128,441,63504,79632
validation,551,38,29184,1444,207936,237120
validation,552,22,16896,484,69696,86592
validation,553,35,26880,1225,176400,203280
validation,554,28,21504,784,112896,134400
validation,555,39,29952,1521,219024,248976
validation,556,42,32256,1764,254016,286272
validation,557,38,29184,1444,207936,237120
validation,558,25,19200,625,90000,109200
validation,559,18,13824,324,46656,60480
validation,560,32,24576,1024,147456,172032
validation,561,23,17664,529,76176,93840
validation,562,33,25344,1089,156816,182160
validation,563,22,16896,484,69696,86592
validation,564,4,3072,16,2304,5376
validation,565,12,9216,144,20736,29952
validation,566,17,13056,289,41616,54672
validation,567,14,10752,196,28224,38976
validation,568,21,16128,441,63504,79632
validation,569,41,31488,1681,242064,273552
validation,570,19,14592,361,51984,66576
validation,571,19,14592,361,51984,66576
validation,572,14,10752,196,28224,38976
validation,573,30,23040,900,129600,152640
validation,574,22,16896,484,69696,86592
validation,575,29,22272,841,121104,143376
validation,576,30,23040,900,129600,152640
validation,577,7,5376,49,7056,12432
validation,578,30,23040,900,129600,152640
validation,579,23,17664,529,76176,93840
validation,580,29,22272,841,121104,143376
validation,581,8,6144,64,9216,15360
validation,582,49,37632,2401,345744,383376
validation,583,25,19200,625,90000,109200
validation,584,31,23808,961,138384,162192
validation,585,14,10752,196,28224,38976
validation,586,26,19968,676,97344,117312
validation,587,44,33792,1936,278784,312576
validation,588,15,11520,225,32400,43920
validation,589,8,6144,64,9216,15360
validation,590,26,19968,676,97344,117312
validation,591,20,15360,400,57600,72960
validation,592,24,18432,576,82944,101376
validation,593,16,12288,256,36864,49152
validation,594,22,16896,484,69696,86592
validation,595,13,9984,169,24336,34320
validation,596,11,8448,121,17424,25872
validation,597,20,15360,400,57600,72960
validation,598,21,16128,441,63504,79632
validation,599,7,5376,49,7056,12432
validation,600,31,23808,961,138384,162192
validation,601,37,28416,1369,197136,225552
validation,602,12,9216,144,20736,29952
validation,603,27,20736,729,104976,125712
validation,604,28,21504,784,112896,134400
validation,605,21,16128,441,63504,79632
validation,606,16,12288,256,36864,49152
validation,607,29,22272,841,121104,143376
validation,608,32,24576,1024,147456,172032
validation,609,40,30720,1600,230400,261120
validation,610,27,20736,729,104976,125712
validation,611,31,23808,961,138384,162192
validation,612,40,30720,1600,230400,261120
validation,613,17,13056,289,41616,54672
validation,614,13,9984,169,24336,34320
validation,615,40,30720,1600,230400,261120
validation,616,27,20736,729,104976,125712
validation,617,34,26112,1156,166464,192576
validation,618,17,13056,289,41616,54672
validation,619,13,9984,169,24336,34320
validation,620,26,19968,676,97344,117312
validation,621,13,9984,169,24336,34320
validation,622,27,20736,729,104976,125712
validation,623,28,21504,784,112896,134400
validation,624,26,19968,676,97344,117312
validation,625,15,11520,225,32400,43920
validation,626,48,36864,2304,331776,368640
validation,627,29,22272,841,121104,143376
validation,628,12,9216,144,20736,29952
validation,629,31,23808,961,138384,162192
validation,630,14,10752,196,28224,38976
validation,631,35,26880,1225,176400,203280
validation,632,35,26880,1225,176400,203280
validation,633,18,13824,324,46656,60480
validation,634,22,16896,484,69696,86592
validation,635,10,7680,100,14400,22080
validation,636,10,7680,100,14400,22080
validation,637,26,19968,676,97344,117312
validation,638,30,23040,900,129600,152640
validation,639,40,30720,1600,230400,261120
validation,640,37,28416,1369,197136,225552
validation,641,25,19200,625,90000,109200
validation,642,31,23808,961,138384,162192
validation,643,14,10752,196,28224,38976
validation,644,32,24576,1024,147456,172032
validation,645,22,16896,484,69696,86592
validation,646,42,32256,1764,254016,286272
validation,647,18,13824,324,46656,60480
validation,648,12,9216,144,20736,29952
validation,649,40,30720,1600,230400,261120
validation,650,35,26880,1225,176400,203280
validation,651,33,25344,1089,156816,182160
validation,652,47,36096,2209,318096,354192
validation,653,9,6912,81,11664,18576
validation,654,34,26112,1156,166464,192576
validation,655,33,25344,1089,156816,182160
validation,656,24,18432,576,82944,101376
validation,657,55,42240,3025,435600,477840
validation,658,18,13824,324,46656,60480
validation,659,44,33792,1936,278784,312576
validation,660,38,29184,1444,207936,237120
validation,661,53,40704,2809,404496,445200
validation,662,32,24576,1024,147456,172032
validation,663,31,23808,961,138384,162192
validation,664,35,26880,1225,176400,203280
validation,665,32,24576,1024,147456,172032
validation,666,21,16128,441,63504,79632
validation,667,15,11520,225,32400,43920
validation,668,28,21504,784,112896,134400
validation,669,36,27648,1296,186624,214272
validation,670,19,14592,361,51984,66576
validation,671,24,18432,576,82944,101376
validation,672,9,6912,81,11664,18576
validation,673,9,6912,81,11664,18576
validation,674,24,18432,576,82944,101376
validation,675,40,30720,1600,230400,261120
validation,676,26,19968,676,97344,117312
validation,677,45,34560,2025,291600,326160
validation,678,28,21504,784,112896,134400
validation,679,16,12288,256,36864,49152
validation,680,13,9984,169,24336,34320
validation,681,32,24576,1024,147456,172032
validation,682,40,30720,1600,230400,261120
validation,683,34,26112,1156,166464,192576
validation,684,35,26880,1225,176400,203280
validation,685,36,27648,1296,186624,214272
validation,686,25,19200,625,90000,109200
validation,687,15,11520,225,32400,43920
validation,688,13,9984,169,24336,34320
validation,689,12,9216,144,20736,29952
validation,690,22,16896,484,69696,86592
validation,691,18,13824,324,46656,60480
validation,692,17,13056,289,41616,54672
validation,693,26,19968,676,97344,117312
validation,694,10,7680,100,14400,22080
validation,695,31,23808,961,138384,162192
validation,696,32,24576,1024,147456,172032
validation,697,29,22272,841,121104,143376
validation,698,29,22272,841,121104,143376
validation,699,17,13056,289,41616,54672
validation,700,6,4608,36,5184,9792
validation,701,42,32256,1764,254016,286272
validation,702,19,14592,361,51984,66576
validation,703,25,19200,625,90000,109200
validation,704,20,15360,400,57600,72960
validation,705,12,9216,144,20736,29952
validation,706,20,15360,400,57600,72960
validation,707,28,21504,784,112896,134400
validation,708,27,20736,729,104976,125712
validation,709,17,13056,289,41616,54672
validation,710,11,8448,121,17424,25872
validation,711,19,14592,361,51984,66576
validation,712,27,20736,729,104976,125712
validation,713,32,24576,1024,147456,172032
validation,714,14,10752,196,28224,38976
validation,715,26,19968,676,97344,117312
validation,716,20,15360,400,57600,72960
validation,717,32,24576,1024,147456,172032
validation,718,23,17664,529,76176,93840
validation,719,41,31488,1681,242064,273552
validation,720,21,16128,441,63504,79632
validation,721,23,17664,529,76176,93840
validation,722,25,19200,625,90000,109200
validation,723,13,9984,169,24336,34320
validation,724,22,16896,484,69696,86592
validation,725,13,9984,169,24336,34320
validation,726,44,33792,1936,278784,312576
validation,727,31,23808,961,138384,162192
validation,728,11,8448,121,17424,25872
validation,729,27,20736,729,104976,125712
validation,730,23,17664,529,76176,93840
validation,731,24,18432,576,82944,101376
validation,732,26,19968,676,97344,117312
validation,733,39,29952,1521,219024,248976
validation,734,6,4608,36,5184,9792
validation,735,31,23808,961,138384,162192
validation,736,8,6144,64,9216,15360
validation,737,19,14592,361,51984,66576
validation,738,23,17664,529,76176,93840
validation,739,18,13824,324,46656,60480
validation,740,20,15360,400,57600,72960
validation,741,44,33792,1936,278784,312576
validation,742,27,20736,729,104976,125712
validation,743,9,6912,81,11664,18576
validation,744,44,33792,1936,278784,312576
validation,745,49,37632,2401,345744,383376
validation,746,38,29184,1444,207936,237120
validation,747,30,23040,900,129600,152640
validation,748,33,25344,1089,156816,182160
validation,749,33,25344,1089,156816,182160
validation,750,25,19200,625,90000,109200
validation,751,31,23808,961,138384,162192
validation,752,10,7680,100,14400,22080
validation,753,35,26880,1225,176400,203280
validation,754,26,19968,676,97344,117312
validation,755,41,31488,1681,242064,273552
validation,756,23,17664,529,76176,93840
validation,757,18,13824,324,46656,60480
validation,758,26,19968,676,97344,117312
validation,759,18,13824,324,46656,60480
validation,760,20,15360,400,57600,72960
validation,761,28,21504,784,112896,134400
validation,762,15,11520,225,32400,43920
validation,763,38,29184,1444,207936,237120
validation,764,32,24576,1024,147456,172032
validation,765,11,8448,121,17424,25872
validation,766,41,31488,1681,242064,273552
validation,767,46,35328,2116,304704,340032
validation,768,17,13056,289,41616,54672
validation,769,12,9216,144,20736,29952
validation,770,41,31488,1681,242064,273552
validation,771,31,23808,961,138384,162192
validation,772,17,13056,289,41616,54672
validation,773,21,16128,441,63504,79632
validation,774,40,30720,1600,230400,261120
validation,775,15,11520,225,32400,43920
validation,776,22,16896,484,69696,86592
validation,777,14,10752,196,28224,38976
validation,778,23,17664,529,76176,93840
validation,779,18,13824,324,46656,60480
validation,780,25,19200,625,90000,109200
validation,781,21,16128,441,63504,79632
validation,782,26,19968,676,97344,117312
validation,783,49,37632,2401,345744,383376
validation,784,24,18432,576,82944,101376
validation,785,32,24576,1024,147456,172032
validation,786,23,17664,529,76176,93840
validation,787,8,6144,64,9216,15360
validation,788,31,23808,961,138384,162192
validation,789,10,7680,100,14400,22080
validation,790,16,12288,256,36864,49152
validation,791,32,24576,1024,147456,172032
validation,792,50,38400,2500,360000,398400
validation,793,22,16896,484,69696,86592
validation,794,11,8448,121,17424,25872
validation,795,28,21504,784,112896,134400
validation,796,24,18432,576,82944,101376
validation,797,23,17664,529,76176,93840
validation,798,15,11520,225,32400,43920
validation,799,18,13824,324,46656,60480
validation,800,38,29184,1444,207936,237120
validation,801,13,9984,169,24336,34320
validation,802,39,29952,1521,219024,248976
validation,803,20,15360,400,57600,72960
validation,804,11,8448,121,17424,25872
validation,805,13,9984,169,24336,34320
validation,806,44,33792,1936,278784,312576
validation,807,12,9216,144,20736,29952
validation,808,18,13824,324,46656,60480
validation,809,26,19968,676,97344,117312
validation,810,30,23040,900,129600,152640
validation,811,30,23040,900,129600,152640
validation,812,27,20736,729,104976,125712
validation,813,32,24576,1024,147456,172032
validation,814,18,13824,324,46656,60480
validation,815,24,18432,576,82944,101376
validation,816,18,13824,324,46656,60480
validation,817,15,11520,225,32400,43920
validation,818,29,22272,841,121104,143376
validation,819,19,14592,361,51984,66576
validation,820,31,23808,961,138384,162192
validation,821,12,9216,144,20736,29952
validation,822,26,19968,676,97344,117312
validation,823,17,13056,289,41616,54672
validation,824,19,14592,361,51984,66576
validation,825,12,9216,144,20736,29952
validation,826,44,33792,1936,278784,312576
validation,827,20,15360,400,57600,72960
validation,828,20,15360,400,57600,72960
validation,829,35,26880,1225,176400,203280
validation,830,43,33024,1849,266256,299280
validation,831,33,25344,1089,156816,182160
validation,832,26,19968,676,97344,117312
validation,833,39,29952,1521,219024,248976
validation,834,18,13824,324,46656,60480
validation,835,19,14592,361,51984,66576
validation,836,36,27648,1296,186624,214272
validation,837,39,29952,1521,219024,248976
validation,838,12,9216,144,20736,29952
validation,839,8,6144,64,9216,15360
validation,840,13,9984,169,24336,34320
validation,841,9,6912,81,11664,18576
validation,842,27,20736,729,104976,125712
validation,843,16,12288,256,36864,49152
validation,844,30,23040,900,129600,152640
validation,845,15,11520,225,32400,43920
validation,846,34,26112,1156,166464,192576
validation,847,39,29952,1521,219024,248976
validation,848,23,17664,529,76176,93840
validation,849,27,20736,729,104976,125712
validation,850,35,26880,1225,176400,203280
validation,851,11,8448,121,17424,25872
validation,852,13,9984,169,24336,34320
validation,853,19,14592,361,51984,66576
validation,854,10,7680,100,14400,22080
validation,855,14,10752,196,28224,38976
validation,856,26,19968,676,97344,117312
validation,857,18,13824,324,46656,60480
validation,858,19,14592,361,51984,66576
validation,859,24,18432,576,82944,101376
validation,860,26,19968,676,97344,117312
validation,861,10,7680,100,14400,22080
validation,862,31,23808,961,138384,162192
validation,863,12,9216,144,20736,29952
validation,864,42,32256,1764,254016,286272
validation,865,44,33792,1936,278784,312576
validation,866,16,12288,256,36864,49152
validation,867,20,15360,400,57600,72960
validation,868,30,23040,900,129600,152640
validation,869,41,31488,1681,242064,273552
validation,870,48,36864,2304,331776,368640
validation,871,30,23040,900,129600,152640
test,0,21,16128,441,63504,79632
test,1,15,11520,225,32400,43920
test,2,43,33024,1849,266256,299280
test,3,28,21504,784,112896,134400
test,4,24,18432,576,82944,101376
test,5,34,26112,1156,166464,192576
test,6,31,23808,961,138384,162192
test,7,10,7680,100,14400,22080
test,8,12,9216,144,20736,29952
test,9,28,21504,784,112896,134400
test,10,22,16896,484,69696,86592
test,11,23,17664,529,76176,93840
test,12,7,5376,49,7056,12432
test,13,25,19200,625,90000,109200
test,14,39,29952,1521,219024,248976
test,15,40,30720,1600,230400,261120
test,16,13,9984,169,24336,34320
test,17,7,5376,49,7056,12432
test,18,44,33792,1936,278784,312576
test,19,29,22272,841,121104,143376
test,20,29,22272,841,121104,143376
test,21,18,13824,324,46656,60480
test,22,18,13824,324,46656,60480
test,23,16,12288,256,36864,49152
test,24,31,23808,961,138384,162192
test,25,24,18432,576,82944,101376
test,26,28,21504,784,112896,134400
test,27,12,9216,144,20736,29952
test,28,9,6912,81,11664,18576
test,29,16,12288,256,36864,49152
test,30,17,13056,289,41616,54672
test,31,17,13056,289,41616,54672
test,32,12,9216,144,20736,29952
test,33,27,20736,729,104976,125712
test,34,21,16128,441,63504,79632
test,35,26,19968,676,97344,117312
test,36,12,9216,144,20736,29952
test,37,17,13056,289,41616,54672
test,38,41,31488,1681,242064,273552
test,39,17,13056,289,41616,54672
test,40,33,25344,1089,156816,182160
test,41,10,7680,100,14400,22080
test,42,42,32256,1764,254016,286272
test,43,30,23040,900,129600,152640
test,44,30,23040,900,129600,152640
test,45,32,24576,1024,147456,172032
test,46,35,26880,1225,176400,203280
test,47,18,13824,324,46656,60480
test,48,24,18432,576,82944,101376
test,49,35,26880,1225,176400,203280
test,50,16,12288,256,36864,49152
test,51,22,16896,484,69696,86592
test,52,42,32256,1764,254016,286272
test,53,24,18432,576,82944,101376
test,54,33,25344,1089,156816,182160
test,55,27,20736,729,104976,125712
test,56,30,23040,900,129600,152640
test,57,12,9216,144,20736,29952
test,58,32,24576,1024,147456,172032
test,59,10,7680,100,14400,22080
test,60,20,15360,400,57600,72960
test,61,25,19200,625,90000,109200
test,62,28,21504,784,112896,134400
test,63,18,13824,324,46656,60480
test,64,33,25344,1089,156816,182160
test,65,40,30720,1600,230400,261120
test,66,22,16896,484,69696,86592
test,67,27,20736,729,104976,125712
test,68,24,18432,576,82944,101376
test,69,13,9984,169,24336,34320
test,70,43,33024,1849,266256,299280
test,71,29,22272,841,121104,143376
test,72,12,9216,144,20736,29952
test,73,14,10752,196,28224,38976
test,74,18,13824,324,46656,60480
test,75,27,20736,729,104976,125712
test,76,28,21504,784,112896,134400
test,77,19,14592,361,51984,66576
test,78,10,7680,100,14400,22080
test,79,9,6912,81,11664,18576
test,80,28,21504,784,112896,134400
test,81,32,24576,1024,147456,172032
test,82,27,20736,729,104976,125712
test,83,39,29952,1521,219024,248976
test,84,9,6912,81,11664,18576
test,85,36,27648,1296,186624,214272
test,86,33,25344,1089,156816,182160
test,87,24,18432,576,82944,101376
test,88,14,10752,196,28224,38976
test,89,26,19968,676,97344,117312
test,90,36,27648,1296,186624,214272
test,91,31,23808,961,138384,162192
test,92,37,28416,1369,197136,225552
test,93,16,12288,256,36864,49152
test,94,17,13056,289,41616,54672
test,95,21,16128,441,63504,79632
test,96,35,26880,1225,176400,203280
test,97,34,26112,1156,166464,192576
test,98,35,26880,1225,176400,203280
test,99,18,13824,324,46656,60480
test,100,30,23040,900,129600,152640
test,101,28,21504,784,112896,134400
test,102,35,26880,1225,176400,203280
test,103,25,19200,625,90000,109200
test,104,26,19968,676,97344,117312
test,105,35,26880,1225,176400,203280
test,106,38,29184,1444,207936,237120
test,107,12,9216,144,20736,29952
test,108,24,18432,576,82944,101376
test,109,22,16896,484,69696,86592
test,110,38,29184,1444,207936,237120
test,111,43,33024,1849,266256,299280
test,112,25,19200,625,90000,109200
test,113,50,38400,2500,360000,398400
test,114,20,15360,400,57600,72960
test,115,16,12288,256,36864,49152
test,116,9,6912,81,11664,18576
test,117,14,10752,196,28224,38976
test,118,32,24576,1024,147456,172032
test,119,16,12288,256,36864,49152
test,120,28,21504,784,112896,134400
test,121,22,16896,484,69696,86592
test,122,14,10752,196,28224,38976
test,123,34,26112,1156,166464,192576
test,124,18,13824,324,46656,60480
test,125,51,39168,2601,374544,413712
test,126,33,25344,1089,156816,182160
test,127,23,17664,529,76176,93840
test,128,18,13824,324,46656,60480
test,129,18,13824,324,46656,60480
test,130,11,8448,121,17424,25872
test,131,14,10752,196,28224,38976
test,132,13,9984,169,24336,34320
test,133,20,15360,400,57600,72960
test,134,39,29952,1521,219024,248976
test,135,27,20736,729,104976,125712
test,136,12,9216,144,20736,29952
test,137,31,23808,961,138384,162192
test,138,37,28416,1369,197136,225552
test,139,24,18432,576,82944,101376
test,140,14,10752,196,28224,38976
test,141,40,30720,1600,230400,261120
test,142,17,13056,289,41616,54672
test,143,25,19200,625,90000,109200
test,144,20,15360,400,57600,72960
test,145,10,7680,100,14400,22080
test,146,23,17664,529,76176,93840
test,147,28,21504,784,112896,134400
test,148,50,38400,2500,360000,398400
test,149,25,19200,625,90000,109200
test,150,24,18432,576,82944,101376
test,151,41,31488,1681,242064,273552
test,152,22,16896,484,69696,86592
test,153,26,19968,676,97344,117312
test,154,14,10752,196,28224,38976
test,155,23,17664,529,76176,93840
test,156,27,20736,729,104976,125712
test,157,15,11520,225,32400,43920
test,158,34,26112,1156,166464,192576
test,159,34,26112,1156,166464,192576
test,160,16,12288,256,36864,49152
test,161,39,29952,1521,219024,248976
test,162,31,23808,961,138384,162192
test,163,14,10752,196,28224,38976
test,164,29,22272,841,121104,143376
test,165,58,44544,3364,484416,528960
test,166,18,13824,324,46656,60480
test,167,7,5376,49,7056,12432
test,168,18,13824,324,46656,60480
test,169,11,8448,121,17424,25872
test,170,16,12288,256,36864,49152
test,171,14,10752,196,28224,38976
test,172,48,36864,2304,331776,368640
test,173,27,20736,729,104976,125712
test,174,22,16896,484,69696,86592
test,175,33,25344,1089,156816,182160
test,176,15,11520,225,32400,43920
test,177,47,36096,2209,318096,354192
test,178,28,21504,784,112896,134400
test,179,31,23808,961,138384,162192
test,180,26,19968,676,97344,117312
test,181,45,34560,2025,291600,326160
test,182,26,19968,676,97344,117312
test,183,31,23808,961,138384,162192
test,184,28,21504,784,112896,134400
test,185,39,29952,1521,219024,248976
test,186,26,19968,676,97344,117312
test,187,29,22272,841,121104,143376
test,188,14,10752,196,28224,38976
test,189,19,14592,361,51984,66576
test,190,32,24576,1024,147456,172032
test,191,53,40704,2809,404496,445200
test,192,33,25344,1089,156816,182160
test,193,13,9984,169,24336,34320
test,194,46,35328,2116,304704,340032
test,195,15,11520,225,32400,43920
test,196,14,10752,196,28224,38976
test,197,29,22272,841,121104,143376
test,198,13,9984,169,24336,34320
test,199,41,31488,1681,242064,273552
test,200,27,20736,729,104976,125712
test,201,14,10752,196,28224,38976
test,202,12,9216,144,20736,29952
test,203,14,10752,196,28224,38976
test,204,34,26112,1156,166464,192576
test,205,31,23808,961,138384,162192
test,206,16,12288,256,36864,49152
test,207,37,28416,1369,197136,225552
test,208,21,16128,441,63504,79632
test,209,12,9216,144,20736,29952
test,210,7,5376,49,7056,12432
test,211,30,23040,900,129600,152640
test,212,42,32256,1764,254016,286272
test,213,20,15360,400,57600,72960
test,214,36,27648,1296,186624,214272
test,215,11,8448,121,17424,25872
test,216,41,31488,1681,242064,273552
test,217,9,6912,81,11664,18576
test,218,35,26880,1225,176400,203280
test,219,9,6912,81,11664,18576
test,220,21,16128,441,63504,79632
test,221,22,16896,484,69696,86592
test,222,12,9216,144,20736,29952
test,223,41,31488,1681,242064,273552
test,224,8,6144,64,9216,15360
test,225,41,31488,1681,242064,273552
test,226,13,9984,169,24336,34320
test,227,28,21504,784,112896,134400
test,228,23,17664,529,76176,93840
test,229,18,13824,324,46656,60480
test,230,31,23808,961,138384,162192
test,231,15,11520,225,32400,43920
test,232,16,12288,256,36864,49152
test,233,31,23808,961,138384,162192
test,234,13,9984,169,24336,34320
test,235,17,13056,289,41616,54672
test,236,32,24576,1024,147456,172032
test,237,14,10752,196,28224,38976
test,238,9,6912,81,11664,18576
test,239,24,18432,576,82944,101376
test,240,25,19200,625,90000,109200
test,241,41,31488,1681,242064,273552
test,242,17,13056,289,41616,54672
test,243,40,30720,1600,230400,261120
test,244,11,8448,121,17424,25872
test,245,24,18432,576,82944,101376
test,246,29,22272,841,121104,143376
test,247,34,26112,1156,166464,192576
test,248,21,16128,441,63504,79632
test,249,6,4608,36,5184,9792
test,250,21,16128,441,63504,79632
test,251,18,13824,324,46656,60480
test,252,35,26880,1225,176400,203280
test,253,35,26880,1225,176400,203280
test,254,24,18432,576,82944,101376
test,255,9,6912,81,11664,18576
test,256,9,6912,81,11664,18576
test,257,26,19968,676,97344,117312
test,258,33,25344,1089,156816,182160
test,259,34,26112,1156,166464,192576
test,260,25,19200,625,90000,109200
test,261,28,21504,784,112896,134400
test,262,31,23808,961,138384,162192
test,263,11,8448,121,17424,25872
test,264,26,19968,676,97344,117312
test,265,45,34560,2025,291600,326160
test,266,28,21504,784,112896,134400
test,267,26,19968,676,97344,117312
test,268,17,13056,289,41616,54672
test,269,21,16128,441,63504,79632
test,270,24,18432,576,82944,101376
test,271,26,19968,676,97344,117312
test,272,44,33792,1936,278784,312576
test,273,28,21504,784,112896,134400
test,274,22,16896,484,69696,86592
test,275,19,14592,361,51984,66576
test,276,30,23040,900,129600,152640
test,277,11,8448,121,17424,25872
test,278,17,13056,289,41616,54672
test,279,43,33024,1849,266256,299280
test,280,20,15360,400,57600,72960
test,281,36,27648,1296,186624,214272
test,282,22,16896,484,69696,86592
test,283,37,28416,1369,197136,225552
test,284,11,8448,121,17424,25872
test,285,40,30720,1600,230400,261120
test,286,38,29184,1444,207936,237120
test,287,18,13824,324,46656,60480
test,288,12,9216,144,20736,29952
test,289,22,16896,484,69696,86592
test,290,15,11520,225,32400,43920
test,291,15,11520,225,32400,43920
test,292,21,16128,441,63504,79632
test,293,9,6912,81,11664,18576
test,294,41,31488,1681,242064,273552
test,295,28,21504,784,112896,134400
test,296,38,29184,1444,207936,237120
test,297,38,29184,1444,207936,237120
test,298,41,31488,1681,242064,273552
test,299,25,19200,625,90000,109200
test,300,28,21504,784,112896,134400
test,301,57,43776,3249,467856,511632
test,302,32,24576,1024,147456,172032
test,303,11,8448,121,17424,25872
test,304,28,21504,784,112896,134400
test,305,30,23040,900,129600,152640
test,306,32,24576,1024,147456,172032
test,307,29,22272,841,121104,143376
test,308,24,18432,576,82944,101376
test,309,19,14592,361,51984,66576
test,310,12,9216,144,20736,29952
test,311,19,14592,361,51984,66576
test,312,31,23808,961,138384,162192
test,313,20,15360,400,57600,72960
test,314,21,16128,441,63504,79632
test,315,25,19200,625,90000,109200
test,316,25,19200,625,90000,109200
test,317,35,26880,1225,176400,203280
test,318,31,23808,961,138384,162192
test,319,20,15360,400,57600,72960
test,320,22,16896,484,69696,86592
test,321,17,13056,289,41616,54672
test,322,32,24576,1024,147456,172032
test,323,18,13824,324,46656,60480
test,324,30,23040,900,129600,152640
test,325,28,21504,784,112896,134400
test,326,28,21504,784,112896,134400
test,327,9,6912,81,11664,18576
test,328,28,21504,784,112896,134400
test,329,24,18432,576,82944,101376
test,330,31,23808,961,138384,162192
test,331,20,15360,400,57600,72960
test,332,12,9216,144,20736,29952
test,333,12,9216,144,20736,29952
test,334,20,15360,400,57600,72960
test,335,24,18432,576,82944,101376
test,336,17,13056,289,41616,54672
test,337,19,14592,361,51984,66576
test,338,43,33024,1849,266256,299280
test,339,48,36864,2304,331776,368640
test,340,21,16128,441,63504,79632
test,341,14,10752,196,28224,38976
test,342,34,26112,1156,166464,192576
test,343,56,43008,3136,451584,494592
test,344,32,24576,1024,147456,172032
test,345,19,14592,361,51984,66576
test,346,37,28416,1369,197136,225552
test,347,16,12288,256,36864,49152
test,348,26,19968,676,97344,117312
test,349,39,29952,1521,219024,248976
test,350,29,22272,841,121104,143376
test,351,36,27648,1296,186624,214272
test,352,38,29184,1444,207936,237120
test,353,33,25344,1089,156816,182160
test,354,18,13824,324,46656,60480
test,355,18,13824,324,46656,60480
test,356,29,22272,841,121104,143376
test,357,42,32256,1764,254016,286272
test,358,26,19968,676,97344,117312
test,359,20,15360,400,57600,72960
test,360,43,33024,1849,266256,299280
test,361,20,15360,400,57600,72960
test,362,32,24576,1024,147456,172032
test,363,26,19968,676,97344,117312
test,364,12,9216,144,20736,29952
test,365,17,13056,289,41616,54672
test,366,38,29184,1444,207936,237120
test,367,10,7680,100,14400,22080
test,368,19,14592,361,51984,66576
test,369,25,19200,625,90000,109200
test,370,41,31488,1681,242064,273552
test,371,19,14592,361,51984,66576
test,372,22,16896,484,69696,86592
test,373,24,18432,576,82944,101376
test,374,31,23808,961,138384,162192
test,375,32,24576,1024,147456,172032
test,376,26,19968,676,97344,117312
test,377,31,23808,961,138384,162192
test,378,28,21504,784,112896,134400
test,379,14,10752,196,28224,38976
test,380,21,16128,441,63504,79632
test,381,24,18432,576,82944,101376
test,382,20,15360,400,57600,72960
test,383,14,10752,196,28224,38976
test,384,14,10752,196,28224,38976
test,385,21,16128,441,63504,79632
test,386,21,16128,441,63504,79632
test,387,35,26880,1225,176400,203280
test,388,19,14592,361,51984,66576
test,389,18,13824,324,46656,60480
test,390,36,27648,1296,186624,214272
test,391,32,24576,1024,147456,172032
test,392,13,9984,169,24336,34320
test,393,33,25344,1089,156816,182160
test,394,23,17664,529,76176,93840
test,395,25,19200,625,90000,109200
test,396,15,11520,225,32400,43920
test,397,23,17664,529,76176,93840
test,398,41,31488,1681,242064,273552
test,399,14,10752,196,28224,38976
test,400,33,25344,1089,156816,182160
test,401,22,16896,484,69696,86592
test,402,22,16896,484,69696,86592
test,403,6,4608,36,5184,9792
test,404,22,16896,484,69696,86592
test,405,37,28416,1369,197136,225552
test,406,27,20736,729,104976,125712
test,407,6,4608,36,5184,9792
test,408,28,21504,784,112896,134400
test,409,14,10752,196,28224,38976
test,410,24,18432,576,82944,101376
test,411,15,11520,225,32400,43920
test,412,23,17664,529,76176,93840
test,413,27,20736,729,104976,125712
test,414,12,9216,144,20736,29952
test,415,14,10752,196,28224,38976
test,416,41,31488,1681,242064,273552
test,417,30,23040,900,129600,152640
test,418,21,16128,441,63504,79632
test,419,12,9216,144,20736,29952
test,420,31,23808,961,138384,162192
test,421,17,13056,289,41616,54672
test,422,35,26880,1225,176400,203280
test,423,21,16128,441,63504,79632
test,424,39,29952,1521,219024,248976
test,425,24,18432,576,82944,101376
test,426,21,16128,441,63504,79632
test,427,10,7680,100,14400,22080
test,428,26,19968,676,97344,117312
test,429,39,29952,1521,219024,248976
test,430,20,15360,400,57600,72960
test,431,12,9216,144,20736,29952
test,432,27,20736,729,104976,125712
test,433,11,8448,121,17424,25872
test,434,37,28416,1369,197136,225552
test,435,9,6912,81,11664,18576
test,436,18,13824,324,46656,60480
test,437,12,9216,144,20736,29952
test,438,35,26880,1225,176400,203280
test,439,35,26880,1225,176400,203280
test,440,10,7680,100,14400,22080
test,441,22,16896,484,69696,86592
test,442,34,26112,1156,166464,192576
test,443,17,13056,289,41616,54672
test,444,22,16896,484,69696,86592
test,445,15,11520,225,32400,43920
test,446,20,15360,400,57600,72960
test,447,36,27648,1296,186624,214272
test,448,10,7680,100,14400,22080
test,449,33,25344,1089,156816,182160
test,450,19,14592,361,51984,66576
test,451,11,8448,121,17424,25872
test,452,55,42240,3025,435600,477840
test,453,45,34560,2025,291600,326160
test,454,26,19968,676,97344,117312
test,455,21,16128,441,63504,79632
test,456,25,19200,625,90000,109200
test,457,17,13056,289,41616,54672
test,458,19,14592,361,51984,66576
test,459,36,27648,1296,186624,214272
test,460,14,10752,196,28224,38976
test,461,20,15360,400,57600,72960
test,462,27,20736,729,104976,125712
test,463,25,19200,625,90000,109200
test,464,13,9984,169,24336,34320
test,465,16,12288,256,36864,49152
test,466,25,19200,625,90000,109200
test,467,10,7680,100,14400,22080
test,468,24,18432,576,82944,101376
test,469,21,16128,441,63504,79632
test,470,23,17664,529,76176,93840
test,471,44,33792,1936,278784,312576
test,472,38,29184,1444,207936,237120
test,473,31,23808,961,138384,162192
test,474,21,16128,441,63504,79632
test,475,41,31488,1681,242064,273552
test,476,10,7680,100,14400,22080
test,477,35,26880,1225,176400,203280
test,478,31,23808,961,138384,162192
test,479,24,18432,576,82944,101376
test,480,18,13824,324,46656,60480
test,481,42,32256,1764,254016,286272
test,482,26,19968,676,97344,117312
test,483,46,35328,2116,304704,340032
test,484,25,19200,625,90000,109200
test,485,26,19968,676,97344,117312
test,486,24,18432,576,82944,101376
test,487,11,8448,121,17424,25872
test,488,19,14592,361,51984,66576
test,489,29,22272,841,121104,143376
test,490,21,16128,441,63504,79632
test,491,15,11520,225,32400,43920
test,492,15,11520,225,32400,43920
test,493,43,33024,1849,266256,299280
test,494,11,8448,121,17424,25872
test,495,44,33792,1936,278784,312576
test,496,14,10752,196,28224,38976
test,497,18,13824,324,46656,60480
test,498,25,19200,625,90000,109200
test,499,31,23808,961,138384,162192
test,500,20,15360,400,57600,72960
test,501,39,29952,1521,219024,248976
test,502,30,23040,900,129600,152640
test,503,15,11520,225,32400,43920
test,504,14,10752,196,28224,38976
test,505,19,14592,361,51984,66576
test,506,43,33024,1849,266256,299280
test,507,9,6912,81,11664,18576
test,508,24,18432,576,82944,101376
test,509,32,24576,1024,147456,172032
test,510,36,27648,1296,186624,214272
test,511,14,10752,196,28224,38976
test,512,17,13056,289,41616,54672
test,513,28,21504,784,112896,134400
test,514,35,26880,1225,176400,203280
test,515,13,9984,169,24336,34320
test,516,38,29184,1444,207936,237120
test,517,20,15360,400,57600,72960
test,518,37,28416,1369,197136,225552
test,519,15,11520,225,32400,43920
test,520,13,9984,169,24336,34320
test,521,36,27648,1296,186624,214272
test,522,18,13824,324,46656,60480
test,523,20,15360,400,57600,72960
test,524,27,20736,729,104976,125712
test,525,12,9216,144,20736,29952
test,526,30,23040,900,129600,152640
test,527,16,12288,256,36864,49152
test,528,19,14592,361,51984,66576
test,529,20,15360,400,57600,72960
test,530,33,25344,1089,156816,182160
test,531,30,23040,900,129600,152640
test,532,42,32256,1764,254016,286272
test,533,13,9984,169,24336,34320
test,534,57,43776,3249,467856,511632
test,535,24,18432,576,82944,101376
test,536,31,23808,961,138384,162192
test,537,10,7680,100,14400,22080
test,538,25,19200,625,90000,109200
test,539,17,13056,289,41616,54672
test,540,43,33024,1849,266256,299280
test,541,27,20736,729,104976,125712
test,542,20,15360,400,57600,72960
test,543,21,16128,441,63504,79632
test,544,26,19968,676,97344,117312
test,545,35,26880,1225,176400,203280
test,546,43,33024,1849,266256,299280
test,547,25,19200,625,90000,109200
test,548,14,10752,196,28224,38976
test,549,44,33792,1936,278784,312576
test,550,39,29952,1521,219024,248976
test,551,10,7680,100,14400,22080
test,552,14,10752,196,28224,38976
test,553,29,22272,841,121104,143376
test,554,25,19200,625,90000,109200
test,555,32,24576,1024,147456,172032
test,556,30,23040,900,129600,152640
test,557,45,34560,2025,291600,326160
test,558,34,26112,1156,166464,192576
test,559,20,15360,400,57600,72960
test,560,18,13824,324,46656,60480
test,561,16,12288,256,36864,49152
test,562,38,29184,1444,207936,237120
test,563,12,9216,144,20736,29952
test,564,7,5376,49,7056,12432
test,565,17,13056,289,41616,54672
test,566,9,6912,81,11664,18576
test,567,9,6912,81,11664,18576
test,568,34,26112,1156,166464,192576
test,569,23,17664,529,76176,93840
test,570,12,9216,144,20736,29952
test,571,14,10752,196,28224,38976
test,572,9,6912,81,11664,18576
test,573,16,12288,256,36864,49152
test,574,25,19200,625,90000,109200
test,575,25,19200,625,90000,109200
test,576,30,23040,900,129600,152640
test,577,10,7680,100,14400,22080
test,578,9,6912,81,11664,18576
test,579,25,19200,625,90000,109200
test,580,10,7680,100,14400,22080
test,581,29,22272,841,121104,143376
test,582,20,15360,400,57600,72960
test,583,33,25344,1089,156816,182160
test,584,9,6912,81,11664,18576
test,585,21,16128,441,63504,79632
test,586,8,6144,64,9216,15360
test,587,45,34560,2025,291600,326160
test,588,26,19968,676,97344,117312
test,589,27,20736,729,104976,125712
test,590,22,16896,484,69696,86592
test,591,53,40704,2809,404496,445200
test,592,52,39936,2704,389376,429312
test,593,31,23808,961,138384,162192
test,594,21,16128,441,63504,79632
test,595,29,22272,841,121104,143376
test,596,23,17664,529,76176,93840
test,597,13,9984,169,24336,34320
test,598,14,10752,196,28224,38976
test,599,9,6912,81,11664,18576
test,600,36,27648,1296,186624,214272
test,601,30,23040,900,129600,152640
test,602,11,8448,121,17424,25872
test,603,39,29952,1521,219024,248976
test,604,12,9216,144,20736,29952
test,605,12,9216,144,20736,29952
test,606,21,16128,441,63504,79632
test,607,24,18432,576,82944,101376
test,608,28,21504,784,112896,134400
test,609,30,23040,900,129600,152640
test,610,16,12288,256,36864,49152
test,611,14,10752,196,28224,38976
test,612,12,9216,144,20736,29952
test,613,24,18432,576,82944,101376
test,614,54,41472,2916,419904,461376
test,615,10,7680,100,14400,22080
test,616,33,25344,1089,156816,182160
test,617,14,10752,196,28224,38976
test,618,11,8448,121,17424,25872
test,619,10,7680,100,14400,22080
test,620,16,12288,256,36864,49152
test,621,10,7680,100,14400,22080
test,622,25,19200,625,90000,109200
test,623,27,20736,729,104976,125712
test,624,27,20736,729,104976,125712
test,625,36,27648,1296,186624,214272
test,626,14,10752,196,28224,38976
test,627,20,15360,400,57600,72960
test,628,25,19200,625,90000,109200
test,629,19,14592,361,51984,66576
test,630,32,24576,1024,147456,172032
test,631,30,23040,900,129600,152640
test,632,19,14592,361,51984,66576
test,633,33,25344,1089,156816,182160
test,634,27,20736,729,104976,125712
test,635,31,23808,961,138384,162192
test,636,34,26112,1156,166464,192576
test,637,9,6912,81,11664,18576
test,638,12,9216,144,20736,29952
test,639,29,22272,841,121104,143376
test,640,14,10752,196,28224,38976
test,641,40,30720,1600,230400,261120
test,642,17,13056,289,41616,54672
test,643,15,11520,225,32400,43920
test,644,20,15360,400,57600,72960
test,645,16,12288,256,36864,49152
test,646,21,16128,441,63504,79632
test,647,14,10752,196,28224,38976
test,648,42,32256,1764,254016,286272
test,649,14,10752,196,28224,38976
test,650,26,19968,676,97344,117312
test,651,21,16128,441,63504,79632
test,652,34,26112,1156,166464,192576
test,653,20,15360,400,57600,72960
test,654,21,16128,441,63504,79632
test,655,42,32256,1764,254016,286272
test,656,43,33024,1849,266256,299280
test,657,13,9984,169,24336,34320
test,658,21,16128,441,63504,79632
test,659,17,13056,289,41616,54672
test,660,16,12288,256,36864,49152
test,661,29,22272,841,121104,143376
test,662,29,22272,841,121104,143376
test,663,52,39936,2704,389376,429312
test,664,20,15360,400,57600,72960
test,665,36,27648,1296,186624,214272
test,666,28,21504,784,112896,134400
test,667,29,22272,841,121104,143376
test,668,34,26112,1156,166464,192576
test,669,19,14592,361,51984,66576
test,670,13,9984,169,24336,34320
test,671,26,19968,676,97344,117312
test,672,25,19200,625,90000,109200
test,673,10,7680,100,14400,22080
test,674,23,17664,529,76176,93840
test,675,24,18432,576,82944,101376
test,676,30,23040,900,129600,152640
test,677,17,13056,289,41616,54672
test,678,24,18432,576,82944,101376
test,679,34,26112,1156,166464,192576
test,680,27,20736,729,104976,125712
test,681,28,21504,784,112896,134400
test,682,32,24576,1024,147456,172032
test,683,7,5376,49,7056,12432
test,684,16,12288,256,36864,49152
test,685,15,11520,225,32400,43920
test,686,31,23808,961,138384,162192
test,687,62,47616,3844,553536,601152
test,688,27,20736,729,104976,125712
test,689,15,11520,225,32400,43920
test,690,38,29184,1444,207936,237120
test,691,29,22272,841,121104,143376
test,692,24,18432,576,82944,101376
test,693,39,29952,1521,219024,248976
test,694,25,19200,625,90000,109200
test,695,32,24576,1024,147456,172032
test,696,16,12288,256,36864,49152
test,697,16,12288,256,36864,49152
test,698,25,19200,625,90000,109200
test,699,33,25344,1089,156816,182160
test,700,18,13824,324,46656,60480
test,701,24,18432,576,82944,101376
test,702,13,9984,169,24336,34320
test,703,25,19200,625,90000,109200
test,704,16,12288,256,36864,49152
test,705,30,23040,900,129600,152640
test,706,59,45312,3481,501264,546576
test,707,10,7680,100,14400,22080
test,708,13,9984,169,24336,34320
test,709,24,18432,576,82944,101376
test,710,50,38400,2500,360000,398400
test,711,36,27648,1296,186624,214272
test,712,13,9984,169,24336,34320
test,713,11,8448,121,17424,25872
test,714,34,26112,1156,166464,192576
test,715,28,21504,784,112896,134400
test,716,21,16128,441,63504,79632
test,717,7,5376,49,7056,12432
test,718,22,16896,484,69696,86592
test,719,21,16128,441,63504,79632
test,720,24,18432,576,82944,101376
test,721,25,19200,625,90000,109200
test,722,14,10752,196,28224,38976
test,723,11,8448,121,17424,25872
test,724,24,18432,576,82944,101376
test,725,35,26880,1225,176400,203280
test,726,39,29952,1521,219024,248976
test,727,27,20736,729,104976,125712
test,728,17,13056,289,41616,54672
test,729,22,16896,484,69696,86592
test,730,20,15360,400,57600,72960
test,731,12,9216,144,20736,29952
test,732,24,18432,576,82944,101376
test,733,19,14592,361,51984,66576
test,734,24,18432,576,82944,101376
test,735,11,8448,121,17424,25872
test,736,18,13824,324,46656,60480
test,737,10,7680,100,14400,22080
test,738,18,13824,324,46656,60480
test,739,28,21504,784,112896,134400
test,740,11,8448,121,17424,25872
test,741,27,20736,729,104976,125712
test,742,38,29184,1444,207936,237120
test,743,23,17664,529,76176,93840
test,744,36,27648,1296,186624,214272
test,745,24,18432,576,82944,101376
test,746,38,29184,1444,207936,237120
test,747,19,14592,361,51984,66576
test,748,21,16128,441,63504,79632
test,749,14,10752,196,28224,38976
test,750,28,21504,784,112896,134400
test,751,46,35328,2116,304704,340032
test,752,50,38400,2500,360000,398400
test,753,10,7680,100,14400,22080
test,754,17,13056,289,41616,54672
test,755,48,36864,2304,331776,368640
test,756,16,12288,256,36864,49152
test,757,38,29184,1444,207936,237120
test,758,31,23808,961,138384,162192
test,759,19,14592,361,51984,66576
test,760,34,26112,1156,166464,192576
test,761,37,28416,1369,197136,225552
test,762,27,20736,729,104976,125712
test,763,31,23808,961,138384,162192
test,764,23,17664,529,76176,93840
test,765,49,37632,2401,345744,383376
test,766,12,9216,144,20736,29952
test,767,22,16896,484,69696,86592
test,768,27,20736,729,104976,125712
test,769,14,10752,196,28224,38976
test,770,25,19200,625,90000,109200
test,771,7,5376,49,7056,12432
test,772,25,19200,625,90000,109200
test,773,14,10752,196,28224,38976
test,774,35,26880,1225,176400,203280
test,775,16,12288,256,36864,49152
test,776,16,12288,256,36864,49152
test,777,37,28416,1369,197136,225552
test,778,13,9984,169,24336,34320
test,779,33,25344,1089,156816,182160
test,780,13,9984,169,24336,34320
test,781,30,23040,900,129600,152640
test,782,19,14592,361,51984,66576
test,783,29,22272,841,121104,143376
test,784,15,11520,225,32400,43920
test,785,50,38400,2500,360000,398400
test,786,17,13056,289,41616,54672
test,787,23,17664,529,76176,93840
test,788,25,19200,625,90000,109200
test,789,28,21504,784,112896,134400
test,790,17,13056,289,41616,54672
test,791,19,14592,361,51984,66576
test,792,15,11520,225,32400,43920
test,793,27,20736,729,104976,125712
test,794,22,16896,484,69696,86592
test,795,16,12288,256,36864,49152
test,796,23,17664,529,76176,93840
test,797,9,6912,81,11664,18576
test,798,11,8448,121,17424,25872
test,799,19,14592,361,51984,66576
test,800,38,29184,1444,207936,237120
test,801,26,19968,676,97344,117312
test,802,45,34560,2025,291600,326160
test,803,18,13824,324,46656,60480
test,804,13,9984,169,24336,34320
test,805,10,7680,100,14400,22080
test,806,21,16128,441,63504,79632
test,807,10,7680,100,14400,22080
test,808,21,16128,441,63504,79632
test,809,18,13824,324,46656,60480
test,810,22,16896,484,69696,86592
test,811,35,26880,1225,176400,203280
test,812,33,25344,1089,156816,182160
test,813,20,15360,400,57600,72960
test,814,26,19968,676,97344,117312
test,815,6,4608,36,5184,9792
test,816,21,16128,441,63504,79632
test,817,37,28416,1369,197136,225552
test,818,22,16896,484,69696,86592
test,819,11,8448,121,17424,25872
test,820,4,3072,16,2304,5376
test,821,21,16128,441,63504,79632
test,822,14,10752,196,28224,38976
test,823,16,12288,256,36864,49152
test,824,23,17664,529,76176,93840
test,825,25,19200,625,90000,109200
test,826,27,20736,729,104976,125712
test,827,30,23040,900,129600,152640
test,828,22,16896,484,69696,86592
test,829,25,19200,625,90000,109200
test,830,12,9216,144,20736,29952
test,831,31,23808,961,138384,162192
test,832,21,16128,441,63504,79632
test,833,13,9984,169,24336,34320
test,834,47,36096,2209,318096,354192
test,835,24,18432,576,82944,101376
test,836,39,29952,1521,219024,248976
test,837,18,13824,324,46656,60480
test,838,9,6912,81,11664,18576
test,839,16,12288,256,36864,49152
test,840,18,13824,324,46656,60480
test,841,27,20736,729,104976,125712
test,842,35,26880,1225,176400,203280
test,843,43,33024,1849,266256,299280
test,844,24,18432,576,82944,101376
test,845,34,26112,1156,166464,192576
test,846,14,10752,196,28224,38976
test,847,15,11520,225,32400,43920
test,848,22,16896,484,69696,86592
test,849,20,15360,400,57600,72960
test,850,40,30720,1600,230400,261120
test,851,45,34560,2025,291600,326160
test,852,24,18432,576,82944,101376
test,853,9,6912,81,11664,18576
test,854,26,19968,676,97344,117312
test,855,41,31488,1681,242064,273552
test,856,41,31488,1681,242064,273552
test,857,28,21504,784,112896,134400
test,858,16,12288,256,36864,49152
test,859,20,15360,400,57600,72960
test,860,25,19200,625,90000,109200
test,861,25,19200,625,90000,109200
test,862,44,33792,1936,278784,312576
test,863,29,22272,841,121104,143376
test,864,33,25344,1089,156816,182160
test,865,26,19968,676,97344,117312
test,866,37,28416,1369,197136,225552
test,867,59,45312,3481,501264,546576
test,868,18,13824,324,46656,60480
test,869,24,18432,576,82944,101376
test,870,12,9216,144,20736,29952
test,871,37,28416,1369,197136,225552
test,872,10,7680,100,14400,22080
test,873,22,16896,484,69696,86592
test,874,41,31488,1681,242064,273552
test,875,23,17664,529,76176,93840
test,876,18,13824,324,46656,60480
test,877,43,33024,1849,266256,299280
test,878,40,30720,1600,230400,261120
test,879,29,22272,841,121104,143376
test,880,37,28416,1369,197136,225552
test,881,7,5376,49,7056,12432
test,882,40,30720,1600,230400,261120
test,883,34,26112,1156,166464,192576
test,884,11,8448,121,17424,25872
test,885,32,24576,1024,147456,172032
test,886,11,8448,121,17424,25872
test,887,13,9984,169,24336,34320
test,888,22,16896,484,69696,86592
test,889,29,22272,841,121104,143376
test,890,18,13824,324,46656,60480
test,891,33,25344,1089,156816,182160
test,892,31,23808,961,138384,162192
test,893,37,28416,1369,197136,225552
test,894,29,22272,841,121104,143376
test,895,7,5376,49,7056,12432
test,896,26,19968,676,97344,117312
test,897,32,24576,1024,147456,172032
test,898,20,15360,400,57600,72960
test,899,14,10752,196,28224,38976
test,900,19,14592,361,51984,66576
test,901,31,23808,961,138384,162192
test,902,39,29952,1521,219024,248976
test,903,42,32256,1764,254016,286272
test,904,18,13824,324,46656,60480
test,905,27,20736,729,104976,125712
test,906,21,16128,441,63504,79632
test,907,16,12288,256,36864,49152
test,908,15,11520,225,32400,43920
test,909,17,13056,289,41616,54672
test,910,29,22272,841,121104,143376
test,911,44,33792,1936,278784,312576
test,912,10,7680,100,14400,22080
test,913,20,15360,400,57600,72960
test,914,24,18432,576,82944,101376
test,915,29,22272,841,121104,143376
test,916,29,22272,841,121104,143376
test,917,34,26112,1156,166464,192576
test,918,20,15360,400,57600,72960
test,919,18,13824,324,46656,60480
test,920,18,13824,324,46656,60480
test,921,32,24576,1024,147456,172032
test,922,38,29184,1444,207936,237120
test,923,13,9984,169,24336,34320
test,924,37,28416,1369,197136,225552
test,925,44,33792,1936,278784,312576
test,926,44,33792,1936,278784,312576
test,927,40,30720,1600,230400,261120
test,928,11,8448,121,17424,25872
test,929,23,17664,529,76176,93840
test,930,47,36096,2209,318096,354192
test,931,22,16896,484,69696,86592
test,932,20,15360,400,57600,72960
test,933,10,7680,100,14400,22080
test,934,52,39936,2704,389376,429312
test,935,17,13056,289,41616,54672
test,936,22,16896,484,69696,86592
test,937,11,8448,121,17424,25872
test,938,17,13056,289,41616,54672
test,939,56,43008,3136,451584,494592
test,940,28,21504,784,112896,134400
test,941,43,33024,1849,266256,299280
test,942,35,26880,1225,176400,203280
test,943,22,16896,484,69696,86592
test,944,26,19968,676,97344,117312
test,945,26,19968,676,97344,117312
test,946,51,39168,2601,374544,413712
test,947,44,33792,1936,278784,312576
test,948,38,29184,1444,207936,237120
test,949,18,13824,324,46656,60480
test,950,35,26880,1225,176400,203280
test,951,28,21504,784,112896,134400
test,952,25,19200,625,90000,109200
test,953,22,16896,484,69696,86592
test,954,13,9984,169,24336,34320
test,955,37,28416,1369,197136,225552
test,956,19,14592,361,51984,66576
test,957,32,24576,1024,147456,172032
test,958,32,24576,1024,147456,172032
test,959,36,27648,1296,186624,214272
test,960,17,13056,289,41616,54672
test,961,11,8448,121,17424,25872
test,962,22,16896,484,69696,86592
test,963,27,20736,729,104976,125712
test,964,17,13056,289,41616,54672
test,965,14,10752,196,28224,38976
test,966,30,23040,900,129600,152640
test,967,26,19968,676,97344,117312
test,968,26,19968,676,97344,117312
test,969,10,7680,100,14400,22080
test,970,9,6912,81,11664,18576
test,971,41,31488,1681,242064,273552
test,972,37,28416,1369,197136,225552
test,973,25,19200,625,90000,109200
test,974,11,8448,121,17424,25872
test,975,12,9216,144,20736,29952
test,976,8,6144,64,9216,15360
test,977,23,17664,529,76176,93840
test,978,19,14592,361,51984,66576
test,979,22,16896,484,69696,86592
test,980,29,22272,841,121104,143376
test,981,47,36096,2209,318096,354192
test,982,36,27648,1296,186624,214272
test,983,9,6912,81,11664,18576
test,984,14,10752,196,28224,38976
test,985,11,8448,121,17424,25872
test,986,14,10752,196,28224,38976
test,987,36,27648,1296,186624,214272
test,988,14,10752,196,28224,38976
test,989,27,20736,729,104976,125712
test,990,38,29184,1444,207936,237120
test,991,18,13824,324,46656,60480
test,992,27,20736,729,104976,125712
test,993,49,37632,2401,345744,383376
test,994,16,12288,256,36864,49152
test,995,39,29952,1521,219024,248976
test,996,20,15360,400,57600,72960
test,997,15,11520,225,32400,43920
test,998,20,15360,400,57600,72960
test,999,39,29952,1521,219024,248976
test,1000,16,12288,256,36864,49152
test,1001,24,18432,576,82944,101376
test,1002,12,9216,144,20736,29952
test,1003,15,11520,225,32400,43920
test,1004,34,26112,1156,166464,192576
test,1005,42,32256,1764,254016,286272
test,1006,32,24576,1024,147456,172032
test,1007,22,16896,484,69696,86592
test,1008,28,21504,784,112896,134400
test,1009,36,27648,1296,186624,214272
test,1010,11,8448,121,17424,25872
test,1011,24,18432,576,82944,101376
test,1012,9,6912,81,11664,18576
test,1013,11,8448,121,17424,25872
test,1014,14,10752,196,28224,38976
test,1015,14,10752,196,28224,38976
test,1016,28,21504,784,112896,134400
test,1017,12,9216,144,20736,29952
test,1018,11,8448,121,17424,25872
test,1019,45,34560,2025,291600,326160
test,1020,41,31488,1681,242064,273552
test,1021,32,24576,1024,147456,172032
test,1022,27,20736,729,104976,125712
test,1023,5,3840,25,3600,7440
test,1024,25,19200,625,90000,109200
test,1025,12,9216,144,20736,29952
test,1026,23,17664,529,76176,93840
test,1027,15,11520,225,32400,43920
test,1028,15,11520,225,32400,43920
test,1029,17,13056,289,41616,54672
test,1030,21,16128,441,63504,79632
test,1031,43,33024,1849,266256,299280
test,1032,31,23808,961,138384,162192
test,1033,26,19968,676,97344,117312
test,1034,24,18432,576,82944,101376
test,1035,18,13824,324,46656,60480
test,1036,27,20736,729,104976,125712
test,1037,30,23040,900,129600,152640
test,1038,28,21504,784,112896,134400
test,1039,19,14592,361,51984,66576
test,1040,22,16896,484,69696,86592
test,1041,11,8448,121,17424,25872
test,1042,29,22272,841,121104,143376
test,1043,36,27648,1296,186624,214272
test,1044,19,14592,361,51984,66576
test,1045,24,18432,576,82944,101376
test,1046,27,20736,729,104976,125712
test,1047,19,14592,361,51984,66576
test,1048,12,9216,144,20736,29952
test,1049,42,32256,1764,254016,286272
test,1050,17,13056,289,41616,54672
test,1051,30,23040,900,129600,152640
test,1052,41,31488,1681,242064,273552
test,1053,53,40704,2809,404496,445200
test,1054,32,24576,1024,147456,172032
test,1055,11,8448,121,17424,25872
test,1056,14,10752,196,28224,38976
test,1057,8,6144,64,9216,15360
test,1058,9,6912,81,11664,18576
test,1059,5,3840,25,3600,7440
test,1060,32,24576,1024,147456,172032
test,1061,23,17664,529,76176,93840
test,1062,16,12288,256,36864,49152
test,1063,25,19200,625,90000,109200
test,1064,24,18432,576,82944,101376
test,1065,25,19200,625,90000,109200
test,1066,19,14592,361,51984,66576
test,1067,30,23040,900,129600,152640
test,1068,27,20736,729,104976,125712
test,1069,34,26112,1156,166464,192576
test,1070,23,17664,529,76176,93840
test,1071,40,30720,1600,230400,261120
test,1072,30,23040,900,129600,152640
test,1073,46,35328,2116,304704,340032
test,1074,25,19200,625,90000,109200
test,1075,13,9984,169,24336,34320
test,1076,21,16128,441,63504,79632
test,1077,17,13056,289,41616,54672
test,1078,20,15360,400,57600,72960
test,1079,32,24576,1024,147456,172032
test,1080,16,12288,256,36864,49152
test,1081,24,18432,576,82944,101376
test,1082,5,3840,25,3600,7440
test,1083,13,9984,169,24336,34320
test,1084,29,22272,841,121104,143376
test,1085,5,3840,25,3600,7440
test,1086,21,16128,441,63504,79632
test,1087,37,28416,1369,197136,225552
test,1088,29,22272,841,121104,143376
test,1089,27,20736,729,104976,125712
test,1090,24,18432,576,82944,101376
test,1091,11,8448,121,17424,25872
test,1092,22,16896,484,69696,86592
test,1093,8,6144,64,9216,15360
test,1094,23,17664,529,76176,93840
test,1095,12,9216,144,20736,29952
test,1096,22,16896,484,69696,86592
test,1097,21,16128,441,63504,79632
test,1098,53,40704,2809,404496,445200
test,1099,15,11520,225,32400,43920
test,1100,16,12288,256,36864,49152
test,1101,25,19200,625,90000,109200
test,1102,27,20736,729,104976,125712
test,1103,39,29952,1521,219024,248976
test,1104,20,15360,400,57600,72960
test,1105,14,10752,196,28224,38976
test,1106,30,23040,900,129600,152640
test,1107,36,27648,1296,186624,214272
test,1108,27,20736,729,104976,125712
test,1109,14,10752,196,28224,38976
test,1110,20,15360,400,57600,72960
test,1111,31,23808,961,138384,162192
test,1112,28,21504,784,112896,134400
test,1113,38,29184,1444,207936,237120
test,1114,28,21504,784,112896,134400
test,1115,10,7680,100,14400,22080
test,1116,27,20736,729,104976,125712
test,1117,24,18432,576,82944,101376
test,1118,11,8448,121,17424,25872
test,1119,32,24576,1024,147456,172032
test,1120,10,7680,100,14400,22080
test,1121,18,13824,324,46656,60480
test,1122,34,26112,1156,166464,192576
test,1123,33,25344,1089,156816,182160
test,1124,37,28416,1369,197136,225552
test,1125,30,23040,900,129600,152640
test,1126,12,9216,144,20736,29952
test,1127,19,14592,361,51984,66576
test,1128,12,9216,144,20736,29952
test,1129,24,18432,576,82944,101376
test,1130,28,21504,784,112896,134400
test,1131,16,12288,256,36864,49152
test,1132,23,17664,529,76176,93840
test,1133,5,3840,25,3600,7440
test,1134,19,14592,361,51984,66576
test,1135,33,25344,1089,156816,182160
test,1136,42,32256,1764,254016,286272
test,1137,18,13824,324,46656,60480
test,1138,27,20736,729,104976,125712
test,1139,40,30720,1600,230400,261120
test,1140,14,10752,196,28224,38976
test,1141,22,16896,484,69696,86592
test,1142,25,19200,625,90000,109200
test,1143,31,23808,961,138384,162192
test,1144,55,42240,3025,435600,477840
test,1145,47,36096,2209,318096,354192
test,1146,19,14592,361,51984,66576
test,1147,46,35328,2116,304704,340032
test,1148,21,16128,441,63504,79632
test,1149,12,9216,144,20736,29952
test,1150,28,21504,784,112896,134400
test,1151,24,18432,576,82944,101376
test,1152,29,22272,841,121104,143376
test,1153,15,11520,225,32400,43920
test,1154,36,27648,1296,186624,214272
test,1155,22,16896,484,69696,86592
test,1156,9,6912,81,11664,18576
test,1157,14,10752,196,28224,38976
test,1158,40,30720,1600,230400,261120
test,1159,43,33024,1849,266256,299280
test,1160,14,10752,196,28224,38976
test,1161,21,16128,441,63504,79632
test,1162,25,19200,625,90000,109200
test,1163,10,7680,100,14400,22080
test,1164,36,27648,1296,186624,214272
test,1165,35,26880,1225,176400,203280
test,1166,33,25344,1089,156816,182160
test,1167,36,27648,1296,186624,214272
test,1168,16,12288,256,36864,49152
test,1169,30,23040,900,129600,152640
test,1170,47,36096,2209,318096,354192
test,1171,37,28416,1369,197136,225552
test,1172,39,29952,1521,219024,248976
test,1173,29,22272,841,121104,143376
test,1174,21,16128,441,63504,79632
test,1175,16,12288,256,36864,49152
test,1176,30,23040,900,129600,152640
test,1177,35,26880,1225,176400,203280
test,1178,27,20736,729,104976,125712
test,1179,15,11520,225,32400,43920
test,1180,12,9216,144,20736,29952
test,1181,23,17664,529,76176,93840
test,1182,20,15360,400,57600,72960
test,1183,27,20736,729,104976,125712
test,1184,18,13824,324,46656,60480
test,1185,31,23808,961,138384,162192
test,1186,20,15360,400,57600,72960
test,1187,20,15360,400,57600,72960
test,1188,28,21504,784,112896,134400
test,1189,26,19968,676,97344,117312
test,1190,29,22272,841,121104,143376
test,1191,9,6912,81,11664,18576
test,1192,16,12288,256,36864,49152
test,1193,25,19200,625,90000,109200
test,1194,17,13056,289,41616,54672
test,1195,27,20736,729,104976,125712
test,1196,29,22272,841,121104,143376
test,1197,12,9216,144,20736,29952
test,1198,16,12288,256,36864,49152
test,1199,26,19968,676,97344,117312
test,1200,16,12288,256,36864,49152
test,1201,20,15360,400,57600,72960
test,1202,19,14592,361,51984,66576
test,1203,34,26112,1156,166464,192576
test,1204,48,36864,2304,331776,368640
test,1205,15,11520,225,32400,43920
test,1206,37,28416,1369,197136,225552
test,1207,22,16896,484,69696,86592
test,1208,35,26880,1225,176400,203280
test,1209,42,32256,1764,254016,286272
test,1210,29,22272,841,121104,143376
test,1211,33,25344,1089,156816,182160
test,1212,9,6912,81,11664,18576
test,1213,46,35328,2116,304704,340032
test,1214,30,23040,900,129600,152640
test,1215,29,22272,841,121104,143376
test,1216,30,23040,900,129600,152640
test,1217,8,6144,64,9216,15360
test,1218,46,35328,2116,304704,340032
test,1219,18,13824,324,46656,60480
test,1220,17,13056,289,41616,54672
test,1221,12,9216,144,20736,29952
test,1222,55,42240,3025,435600,477840
test,1223,11,8448,121,17424,25872
test,1224,23,17664,529,76176,93840
test,1225,28,21504,784,112896,134400
test,1226,37,28416,1369,197136,225552
test,1227,48,36864,2304,331776,368640
test,1228,37,28416,1369,197136,225552
test,1229,7,5376,49,7056,12432
test,1230,23,17664,529,76176,93840
test,1231,28,21504,784,112896,134400
test,1232,20,15360,400,57600,72960
test,1233,31,23808,961,138384,162192
test,1234,16,12288,256,36864,49152
test,1235,15,11520,225,32400,43920
test,1236,29,22272,841,121104,143376
test,1237,33,25344,1089,156816,182160
test,1238,16,12288,256,36864,49152
test,1239,31,23808,961,138384,162192
test,1240,15,11520,225,32400,43920
test,1241,21,16128,441,63504,79632
test,1242,29,22272,841,121104,143376
test,1243,41,31488,1681,242064,273552
test,1244,31,23808,961,138384,162192
test,1245,47,36096,2209,318096,354192
test,1246,22,16896,484,69696,86592
test,1247,16,12288,256,36864,49152
test,1248,40,30720,1600,230400,261120
test,1249,22,16896,484,69696,86592
test,1250,22,16896,484,69696,86592
test,1251,27,20736,729,104976,125712
test,1252,14,10752,196,28224,38976
test,1253,30,23040,900,129600,152640
test,1254,38,29184,1444,207936,237120
test,1255,24,18432,576,82944,101376
test,1256,25,19200,625,90000,109200
test,1257,10,7680,100,14400,22080
test,1258,38,29184,1444,207936,237120
test,1259,20,15360,400,57600,72960
test,1260,18,13824,324,46656,60480
test,1261,11,8448,121,17424,25872
test,1262,20,15360,400,57600,72960
test,1263,38,29184,1444,207936,237120
test,1264,35,26880,1225,176400,203280
test,1265,32,24576,1024,147456,172032
test,1266,33,25344,1089,156816,182160
test,1267,18,13824,324,46656,60480
test,1268,19,14592,361,51984,66576
test,1269,33,25344,1089,156816,182160
test,1270,14,10752,196,28224,38976
test,1271,18,13824,324,46656,60480
test,1272,14,10752,196,28224,38976
test,1273,26,19968,676,97344,117312
test,1274,31,23808,961,138384,162192
test,1275,32,24576,1024,147456,172032
test,1276,30,23040,900,129600,152640
test,1277,37,28416,1369,197136,225552
test,1278,8,6144,64,9216,15360
test,1279,17,13056,289,41616,54672
test,1280,25,19200,625,90000,109200
test,1281,18,13824,324,46656,60480
test,1282,17,13056,289,41616,54672
test,1283,20,15360,400,57600,72960
test,1284,15,11520,225,32400,43920
test,1285,38,29184,1444,207936,237120
test,1286,21,16128,441,63504,79632
test,1287,38,29184,1444,207936,237120
test,1288,38,29184,1444,207936,237120
test,1289,9,6912,81,11664,18576
test,1290,40,30720,1600,230400,261120
test,1291,23,17664,529,76176,93840
test,1292,28,21504,784,112896,134400
test,1293,24,18432,576,82944,101376
test,1294,5,3840,25,3600,7440
test,1295,23,17664,529,76176,93840
test,1296,12,9216,144,20736,29952
test,1297,32,24576,1024,147456,172032
test,1298,19,14592,361,51984,66576
test,1299,45,34560,2025,291600,326160
test,1300,27,20736,729,104976,125712
test,1301,26,19968,676,97344,117312
test,1302,21,16128,441,63504,79632
test,1303,20,15360,400,57600,72960
test,1304,11,8448,121,17424,25872
test,1305,34,26112,1156,166464,192576
test,1306,27,20736,729,104976,125712
test,1307,20,15360,400,57600,72960
test,1308,10,7680,100,14400,22080
test,1309,15,11520,225,32400,43920
test,1310,10,7680,100,14400,22080
test,1311,39,29952,1521,219024,248976
test,1312,21,16128,441,63504,79632
test,1313,15,11520,225,32400,43920
test,1314,26,19968,676,97344,117312
test,1315,31,23808,961,138384,162192
test,1316,38,29184,1444,207936,237120
test,1317,26,19968,676,97344,117312
test,1318,13,9984,169,24336,34320
test,1319,27,20736,729,104976,125712
test,1320,33,25344,1089,156816,182160
test,1321,18,13824,324,46656,60480
test,1322,17,13056,289,41616,54672
test,1323,38,29184,1444,207936,237120
test,1324,20,15360,400,57600,72960
test,1325,9,6912,81,11664,18576
test,1326,49,37632,2401,345744,383376
test,1327,7,5376,49,7056,12432
test,1328,20,15360,400,57600,72960
test,1329,21,16128,441,63504,79632
test,1330,23,17664,529,76176,93840
test,1331,12,9216,144,20736,29952
test,1332,15,11520,225,32400,43920
test,1333,42,32256,1764,254016,286272
test,1334,21,16128,441,63504,79632
test,1335,28,21504,784,112896,134400
test,1336,45,34560,2025,291600,326160
test,1337,12,9216,144,20736,29952
test,1338,25,19200,625,90000,109200
test,1339,22,16896,484,69696,86592
test,1340,18,13824,324,46656,60480
test,1341,30,23040,900,129600,152640
test,1342,12,9216,144,20736,29952
test,1343,28,21504,784,112896,134400
test,1344,14,10752,196,28224,38976
test,1345,23,17664,529,76176,93840
test,1346,42,32256,1764,254016,286272
test,1347,24,18432,576,82944,101376
test,1348,28,21504,784,112896,134400
test,1349,33,25344,1089,156816,182160
test,1350,19,14592,361,51984,66576
test,1351,32,24576,1024,147456,172032
test,1352,24,18432,576,82944,101376
test,1353,23,17664,529,76176,93840
test,1354,18,13824,324,46656,60480
test,1355,10,7680,100,14400,22080
test,1356,18,13824,324,46656,60480
test,1357,25,19200,625,90000,109200
test,1358,31,23808,961,138384,162192
test,1359,57,43776,3249,467856,511632
test,1360,22,16896,484,69696,86592
test,1361,23,17664,529,76176,93840
test,1362,7,5376,49,7056,12432
test,1363,35,26880,1225,176400,203280
test,1364,11,8448,121,17424,25872
test,1365,27,20736,729,104976,125712
test,1366,14,10752,196,28224,38976
test,1367,25,19200,625,90000,109200
test,1368,25,19200,625,90000,109200
test,1369,17,13056,289,41616,54672
test,1370,23,17664,529,76176,93840
test,1371,34,26112,1156,166464,192576
test,1372,28,21504,784,112896,134400
test,1373,25,19200,625,90000,109200
test,1374,27,20736,729,104976,125712
test,1375,13,9984,169,24336,34320
test,1376,13,9984,169,24336,34320
test,1377,46,35328,2116,304704,340032
test,1378,33,25344,1089,156816,182160
test,1379,30,23040,900,129600,152640
test,1380,21,16128,441,63504,79632
test,1381,25,19200,625,90000,109200
test,1382,33,25344,1089,156816,182160
test,1383,34,26112,1156,166464,192576
test,1384,17,13056,289,41616,54672
test,1385,21,16128,441,63504,79632
test,1386,23,17664,529,76176,93840
test,1387,28,21504,784,112896,134400
test,1388,18,13824,324,46656,60480
test,1389,8,6144,64,9216,15360
test,1390,24,18432,576,82944,101376
test,1391,8,6144,64,9216,15360
test,1392,18,13824,324,46656,60480
test,1393,49,37632,2401,345744,383376
test,1394,34,26112,1156,166464,192576
test,1395,16,12288,256,36864,49152
test,1396,14,10752,196,28224,38976
test,1397,15,11520,225,32400,43920
test,1398,24,18432,576,82944,101376
test,1399,17,13056,289,41616,54672
test,1400,14,10752,196,28224,38976
test,1401,16,12288,256,36864,49152
test,1402,29,22272,841,121104,143376
test,1403,32,24576,1024,147456,172032
test,1404,32,24576,1024,147456,172032
test,1405,32,24576,1024,147456,172032
test,1406,29,22272,841,121104,143376
test,1407,12,9216,144,20736,29952
test,1408,28,21504,784,112896,134400
test,1409,29,22272,841,121104,143376
test,1410,22,16896,484,69696,86592
test,1411,21,16128,441,63504,79632
test,1412,32,24576,1024,147456,172032
test,1413,10,7680,100,14400,22080
test,1414,18,13824,324,46656,60480
test,1415,9,6912,81,11664,18576
test,1416,26,19968,676,97344,117312
test,1417,28,21504,784,112896,134400
test,1418,29,22272,841,121104,143376
test,1419,19,14592,361,51984,66576
test,1420,14,10752,196,28224,38976
test,1421,45,34560,2025,291600,326160
test,1422,14,10752,196,28224,38976
test,1423,27,20736,729,104976,125712
test,1424,27,20736,729,104976,125712
test,1425,18,13824,324,46656,60480
test,1426,21,16128,441,63504,79632
test,1427,27,20736,729,104976,125712
test,1428,13,9984,169,24336,34320
test,1429,25,19200,625,90000,109200
test,1430,29,22272,841,121104,143376
test,1431,15,11520,225,32400,43920
test,1432,41,31488,1681,242064,273552
test,1433,22,16896,484,69696,86592
test,1434,53,40704,2809,404496,445200
test,1435,24,18432,576,82944,101376
test,1436,38,29184,1444,207936,237120
test,1437,32,24576,1024,147456,172032
test,1438,33,25344,1089,156816,182160
test,1439,25,19200,625,90000,109200
test,1440,35,26880,1225,176400,203280
test,1441,21,16128,441,63504,79632
test,1442,16,12288,256,36864,49152
test,1443,11,8448,121,17424,25872
test,1444,27,20736,729,104976,125712
test,1445,64,49152,4096,589824,638976
test,1446,50,38400,2500,360000,398400
test,1447,23,17664,529,76176,93840
test,1448,17,13056,289,41616,54672
test,1449,34,26112,1156,166464,192576
test,1450,28,21504,784,112896,134400
test,1451,42,32256,1764,254016,286272
test,1452,42,32256,1764,254016,286272
test,1453,35,26880,1225,176400,203280
test,1454,36,27648,1296,186624,214272
test,1455,20,15360,400,57600,72960
test,1456,33,25344,1089,156816,182160
test,1457,9,6912,81,11664,18576
test,1458,27,20736,729,104976,125712
test,1459,9,6912,81,11664,18576
test,1460,40,30720,1600,230400,261120
test,1461,14,10752,196,28224,38976
test,1462,28,21504,784,112896,134400
test,1463,21,16128,441,63504,79632
test,1464,18,13824,324,46656,60480
test,1465,35,26880,1225,176400,203280
test,1466,49,37632,2401,345744,383376
test,1467,27,20736,729,104976,125712
test,1468,32,24576,1024,147456,172032
test,1469,39,29952,1521,219024,248976
test,1470,17,13056,289,41616,54672
test,1471,20,15360,400,57600,72960
test,1472,10,7680,100,14400,22080
test,1473,31,23808,961,138384,162192
test,1474,18,13824,324,46656,60480
test,1475,17,13056,289,41616,54672
test,1476,23,17664,529,76176,93840
test,1477,24,18432,576,82944,101376
test,1478,16,12288,256,36864,49152
test,1479,29,22272,841,121104,143376
test,1480,23,17664,529,76176,93840
test,1481,16,12288,256,36864,49152
test,1482,31,23808,961,138384,162192
test,1483,22,16896,484,69696,86592
test,1484,27,20736,729,104976,125712
test,1485,13,9984,169,24336,34320
test,1486,14,10752,196,28224,38976
test,1487,23,17664,529,76176,93840
test,1488,34,26112,1156,166464,192576
test,1489,22,16896,484,69696,86592
test,1490,17,13056,289,41616,54672
test,1491,37,28416,1369,197136,225552
test,1492,39,29952,1521,219024,248976
test,1493,30,23040,900,129600,152640
test,1494,31,23808,961,138384,162192
test,1495,9,6912,81,11664,18576
test,1496,11,8448,121,17424,25872
test,1497,7,5376,49,7056,12432
test,1498,26,19968,676,97344,117312
test,1499,11,8448,121,17424,25872
test,1500,11,8448,121,17424,25872
test,1501,58,44544,3364,484416,528960
test,1502,27,20736,729,104976,125712
test,1503,27,20736,729,104976,125712
test,1504,51,39168,2601,374544,413712
test,1505,18,13824,324,46656,60480
test,1506,6,4608,36,5184,9792
test,1507,39,29952,1521,219024,248976
test,1508,28,21504,784,112896,134400
test,1509,30,23040,900,129600,152640
test,1510,23,17664,529,76176,93840
test,1511,31,23808,961,138384,162192
test,1512,14,10752,196,28224,38976
test,1513,18,13824,324,46656,60480
test,1514,12,9216,144,20736,29952
test,1515,29,22272,841,121104,143376
test,1516,20,15360,400,57600,72960
test,1517,19,14592,361,51984,66576
test,1518,55,42240,3025,435600,477840
test,1519,32,24576,1024,147456,172032
test,1520,40,30720,1600,230400,261120
test,1521,40,30720,1600,230400,261120
test,1522,32,24576,1024,147456,172032
test,1523,11,8448,121,17424,25872
test,1524,33,25344,1089,156816,182160
test,1525,9,6912,81,11664,18576
test,1526,34,26112,1156,166464,192576
test,1527,16,12288,256,36864,49152
test,1528,30,23040,900,129600,152640
test,1529,17,13056,289,41616,54672
test,1530,32,24576,1024,147456,172032
test,1531,10,7680,100,14400,22080
test,1532,49,37632,2401,345744,383376
test,1533,27,20736,729,104976,125712
test,1534,21,16128,441,63504,79632
test,1535,30,23040,900,129600,152640
test,1536,19,14592,361,51984,66576
test,1537,19,14592,361,51984,66576
test,1538,23,17664,529,76176,93840
test,1539,29,22272,841,121104,143376
test,1540,13,9984,169,24336,34320
test,1541,28,21504,784,112896,134400
test,1542,24,18432,576,82944,101376
test,1543,20,15360,400,57600,72960
test,1544,25,19200,625,90000,109200
test,1545,14,10752,196,28224,38976
test,1546,19,14592,361,51984,66576
test,1547,19,14592,361,51984,66576
test,1548,31,23808,961,138384,162192
test,1549,24,18432,576,82944,101376
test,1550,13,9984,169,24336,34320
test,1551,28,21504,784,112896,134400
test,1552,24,18432,576,82944,101376
test,1553,28,21504,784,112896,134400
test,1554,15,11520,225,32400,43920
test,1555,40,30720,1600,230400,261120
test,1556,12,9216,144,20736,29952
test,1557,18,13824,324,46656,60480
test,1558,59,45312,3481,501264,546576
test,1559,23,17664,529,76176,93840
test,1560,9,6912,81,11664,18576
test,1561,21,16128,441,63504,79632
test,1562,14,10752,196,28224,38976
test,1563,54,41472,2916,419904,461376
test,1564,11,8448,121,17424,25872
test,1565,20,15360,400,57600,72960
test,1566,21,16128,441,63504,79632
test,1567,15,11520,225,32400,43920
test,1568,15,11520,225,32400,43920
test,1569,13,9984,169,24336,34320
test,1570,18,13824,324,46656,60480
test,1571,12,9216,144,20736,29952
test,1572,24,18432,576,82944,101376
test,1573,35,26880,1225,176400,203280
test,1574,42,32256,1764,254016,286272
test,1575,13,9984,169,24336,34320
test,1576,33,25344,1089,156816,182160
test,1577,14,10752,196,28224,38976
test,1578,20,15360,400,57600,72960
test,1579,33,25344,1089,156816,182160
test,1580,9,6912,81,11664,18576
test,1581,24,18432,576,82944,101376
test,1582,23,17664,529,76176,93840
test,1583,26,19968,676,97344,117312
test,1584,29,22272,841,121104,143376
test,1585,10,7680,100,14400,22080
test,1586,26,19968,676,97344,117312
test,1587,19,14592,361,51984,66576
test,1588,21,16128,441,63504,79632
test,1589,29,22272,841,121104,143376
test,1590,22,16896,484,69696,86592
test,1591,17,13056,289,41616,54672
test,1592,37,28416,1369,197136,225552
test,1593,15,11520,225,32400,43920
test,1594,30,23040,900,129600,152640
test,1595,30,23040,900,129600,152640
test,1596,15,11520,225,32400,43920
test,1597,12,9216,144,20736,29952
test,1598,44,33792,1936,278784,312576
test,1599,32,24576,1024,147456,172032
test,1600,20,15360,400,57600,72960
test,1601,20,15360,400,57600,72960
test,1602,18,13824,324,46656,60480
test,1603,8,6144,64,9216,15360
test,1604,9,6912,81,11664,18576
test,1605,23,17664,529,76176,93840
test,1606,11,8448,121,17424,25872
test,1607,19,14592,361,51984,66576
test,1608,15,11520,225,32400,43920
test,1609,16,12288,256,36864,49152
test,1610,20,15360,400,57600,72960
test,1611,14,10752,196,28224,38976
test,1612,30,23040,900,129600,152640
test,1613,26,19968,676,97344,117312
test,1614,22,16896,484,69696,86592
test,1615,21,16128,441,63504,79632
test,1616,30,23040,900,129600,152640
test,1617,16,12288,256,36864,49152
test,1618,38,29184,1444,207936,237120
test,1619,31,23808,961,138384,162192
test,1620,23,17664,529,76176,93840
test,1621,9,6912,81,11664,18576
test,1622,28,21504,784,112896,134400
test,1623,39,29952,1521,219024,248976
test,1624,12,9216,144,20736,29952
test,1625,24,18432,576,82944,101376
test,1626,29,22272,841,121104,143376
test,1627,24,18432,576,82944,101376
test,1628,33,25344,1089,156816,182160
test,1629,46,35328,2116,304704,340032
test,1630,27,20736,729,104976,125712
test,1631,23,17664,529,76176,93840
test,1632,33,25344,1089,156816,182160
test,1633,20,15360,400,57600,72960
test,1634,41,31488,1681,242064,273552
test,1635,26,19968,676,97344,117312
test,1636,54,41472,2916,419904,461376
test,1637,15,11520,225,32400,43920
test,1638,29,22272,841,121104,143376
test,1639,14,10752,196,28224,38976
test,1640,29,22272,841,121104,143376
test,1641,11,8448,121,17424,25872
test,1642,48,36864,2304,331776,368640
test,1643,21,16128,441,63504,79632
test,1644,38,29184,1444,207936,237120
test,1645,20,15360,400,57600,72960
test,1646,18,13824,324,46656,60480
test,1647,34,26112,1156,166464,192576
test,1648,27,20736,729,104976,125712
test,1649,23,17664,529,76176,93840
test,1650,38,29184,1444,207936,237120
test,1651,30,23040,900,129600,152640
test,1652,27,20736,729,104976,125712
test,1653,28,21504,784,112896,134400
test,1654,15,11520,225,32400,43920
test,1655,38,29184,1444,207936,237120
test,1656,40,30720,1600,230400,261120
test,1657,7,5376,49,7056,12432
test,1658,12,9216,144,20736,29952
test,1659,36,27648,1296,186624,214272
test,1660,29,22272,841,121104,143376
test,1661,40,30720,1600,230400,261120
test,1662,28,21504,784,112896,134400
test,1663,17,13056,289,41616,54672
test,1664,26,19968,676,97344,117312
test,1665,21,16128,441,63504,79632
test,1666,21,16128,441,63504,79632
test,1667,44,33792,1936,278784,312576
test,1668,48,36864,2304,331776,368640
test,1669,21,16128,441,63504,79632
test,1670,34,26112,1156,166464,192576
test,1671,20,15360,400,57600,72960
test,1672,35,26880,1225,176400,203280
test,1673,30,23040,900,129600,152640
test,1674,39,29952,1521,219024,248976
test,1675,24,18432,576,82944,101376
test,1676,30,23040,900,129600,152640
test,1677,39,29952,1521,219024,248976
test,1678,12,9216,144,20736,29952
test,1679,31,23808,961,138384,162192
test,1680,5,3840,25,3600,7440
test,1681,21,16128,441,63504,79632
test,1682,44,33792,1936,278784,312576
test,1683,36,27648,1296,186624,214272
test,1684,20,15360,400,57600,72960
test,1685,11,8448,121,17424,25872
test,1686,37,28416,1369,197136,225552
test,1687,43,33024,1849,266256,299280
test,1688,17,13056,289,41616,54672
test,1689,34,26112,1156,166464,192576
test,1690,19,14592,361,51984,66576
test,1691,9,6912,81,11664,18576
test,1692,35,26880,1225,176400,203280
test,1693,43,33024,1849,266256,299280
test,1694,23,17664,529,76176,93840
test,1695,11,8448,121,17424,25872
test,1696,40,30720,1600,230400,261120
test,1697,27,20736,729,104976,125712
test,1698,21,16128,441,63504,79632
test,1699,17,13056,289,41616,54672
test,1700,23,17664,529,76176,93840
test,1701,28,21504,784,112896,134400
test,1702,28,21504,784,112896,134400
test,1703,16,12288,256,36864,49152
test,1704,26,19968,676,97344,117312
test,1705,29,22272,841,121104,143376
test,1706,32,24576,1024,147456,172032
test,1707,25,19200,625,90000,109200
test,1708,20,15360,400,57600,72960
test,1709,40,30720,1600,230400,261120
test,1710,9,6912,81,11664,18576
test,1711,32,24576,1024,147456,172032
test,1712,25,19200,625,90000,109200
test,1713,16,12288,256,36864,49152
test,1714,29,22272,841,121104,143376
test,1715,24,18432,576,82944,101376
test,1716,33,25344,1089,156816,182160
test,1717,25,19200,625,90000,109200
test,1718,9,6912,81,11664,18576
test,1719,17,13056,289,41616,54672
test,1720,39,29952,1521,219024,248976
test,1721,10,7680,100,14400,22080
test,1722,28,21504,784,112896,134400
test,1723,22,16896,484,69696,86592
test,1724,8,6144,64,9216,15360
test,1725,35,26880,1225,176400,203280
test,1726,12,9216,144,20736,29952
test,1727,8,6144,64,9216,15360
test,1728,39,29952,1521,219024,248976
test,1729,28,21504,784,112896,134400
test,1730,20,15360,400,57600,72960
test,1731,22,16896,484,69696,86592
test,1732,27,20736,729,104976,125712
test,1733,5,3840,25,3600,7440
test,1734,18,13824,324,46656,60480
test,1735,24,18432,576,82944,101376
test,1736,15,11520,225,32400,43920
test,1737,35,26880,1225,176400,203280
test,1738,20,15360,400,57600,72960
test,1739,26,19968,676,97344,117312
test,1740,48,36864,2304,331776,368640
test,1741,27,20736,729,104976,125712
test,1742,35,26880,1225,176400,203280
test,1743,17,13056,289,41616,54672
test,1744,32,24576,1024,147456,172032
test,1745,26,19968,676,97344,117312
test,1746,53,40704,2809,404496,445200
test,1747,36,27648,1296,186624,214272
test,1748,26,19968,676,97344,117312
test,1749,37,28416,1369,197136,225552
test,1750,26,19968,676,97344,117312
test,1751,5,3840,25,3600,7440
test,1752,42,32256,1764,254016,286272
test,1753,40,30720,1600,230400,261120
test,1754,9,6912,81,11664,18576
test,1755,26,19968,676,97344,117312
test,1756,8,6144,64,9216,15360
test,1757,12,9216,144,20736,29952
test,1758,18,13824,324,46656,60480
test,1759,25,19200,625,90000,109200
test,1760,8,6144,64,9216,15360
test,1761,38,29184,1444,207936,237120
test,1762,22,16896,484,69696,86592
test,1763,15,11520,225,32400,43920
test,1764,19,14592,361,51984,66576
test,1765,26,19968,676,97344,117312
test,1766,23,17664,529,76176,93840
test,1767,20,15360,400,57600,72960
test,1768,36,27648,1296,186624,214272
test,1769,39,29952,1521,219024,248976
test,1770,22,16896,484,69696,86592
test,1771,15,11520,225,32400,43920
test,1772,29,22272,841,121104,143376
test,1773,22,16896,484,69696,86592
test,1774,29,22272,841,121104,143376
test,1775,39,29952,1521,219024,248976
test,1776,8,6144,64,9216,15360
test,1777,39,29952,1521,219024,248976
test,1778,22,16896,484,69696,86592
test,1779,31,23808,961,138384,162192
test,1780,32,24576,1024,147456,172032
test,1781,18,13824,324,46656,60480
test,1782,20,15360,400,57600,72960
test,1783,10,7680,100,14400,22080
test,1784,16,12288,256,36864,49152
test,1785,16,12288,256,36864,49152
test,1786,21,16128,441,63504,79632
test,1787,49,37632,2401,345744,383376
test,1788,24,18432,576,82944,101376
test,1789,42,32256,1764,254016,286272
test,1790,34,26112,1156,166464,192576
test,1791,39,29952,1521,219024,248976
test,1792,17,13056,289,41616,54672
test,1793,35,26880,1225,176400,203280
test,1794,11,8448,121,17424,25872
test,1795,45,34560,2025,291600,326160
test,1796,42,32256,1764,254016,286272
test,1797,38,29184,1444,207936,237120
test,1798,29,22272,841,121104,143376
test,1799,16,12288,256,36864,49152
test,1800,11,8448,121,17424,25872
test,1801,21,16128,441,63504,79632
test,1802,9,6912,81,11664,18576
test,1803,36,27648,1296,186624,214272
test,1804,44,33792,1936,278784,312576
test,1805,17,13056,289,41616,54672
test,1806,31,23808,961,138384,162192
test,1807,32,24576,1024,147456,172032
test,1808,8,6144,64,9216,15360
test,1809,11,8448,121,17424,25872
test,1810,23,17664,529,76176,93840
test,1811,38,29184,1444,207936,237120
test,1812,43,33024,1849,266256,299280
test,1813,31,23808,961,138384,162192
test,1814,16,12288,256,36864,49152
test,1815,36,27648,1296,186624,214272
test,1816,41,31488,1681,242064,273552
test,1817,21,16128,441,63504,79632
test,1818,33,25344,1089,156816,182160
test,1819,6,4608,36,5184,9792
test,1820,31,23808,961,138384,162192
